V decembri boli služby Božie v ústave s prisluhovaním sviatosti Večere Pánovej .	Pánovej	11	Gen
Jeho dej sa odohráva vo fiktívnom mužstve Miami Sharks .	fiktívnom	5	Loc
Do horúcich pekiel , pomyslel si .	horúcich	1	Gen
A svoje veľké zadosťučinenie strčil do záchodovej misy .	záchodovej	6	Gen
Z takýchto listín je zaujímavý predovšetkým nález , datovaný zhruba polovicou trinásteho storočia .	zaujímavý	4	Nom
Medzi tieto nedovolené zamestnania patrilo i krčmárstvo , ktorého vykonávanie zakázali aj ostrihomskí synodálni otcovia .	nedovolené	2	Acc
A Hádov prízrak .	Hádov	1	Nom
Zviera síce svojím výzorom naháňalo hrôzu , no Gaston bol presvedčený , že ho aj tak zabije a Bela oľutuje deň , keď sa zaňho odmietla vydať .	presvedčený	10	Nom
Najvyšší čas prebehnúť sa po čerstvom vzduchu !	čerstvom	5	Loc
ZLÁ VÍLA NETRPEZLIVO ČAKALA NA ZÁPAD SLNKA vo vlhkých tmavých rozvalinách kamenného hradu , ktorý stál na vysokom brale .	kamenného	11	Gen
Vláda pripraví nový zákon o prírodných liečivých zdrojoch , o prírodných liečebných kúpeľoch a o prírodných minerálnych vodách .	prírodných	10	Loc
Pri stene bola posteľ , na stole lampa s hlboko stiahnutým tienidlom .	stiahnutým	10	Ins
V ich rámci budeme na prvom mieste hovoriť o výnimočnom postavení uhorského kráľa voči domácej cirkvi .	výnimočnom	9	Loc
Primeraná pozornosť bude venovaná rozvíjaniu vzťahov s krajinami Ázie , Afriky a Latinskej Ameriky .	Primeraná	0	Nom
Dňa 15 . 2 . 2004 sa v našom cirkevnom zbore konal výročný zborový konvent .	výročný	12	Nom
Hodiny a hodiny zabíjam vylepovaním tých ich gebuzín po celom Londýne .	celom	9	Loc
Aj keď to bolo nebezpečné , nebola to otázka života a smrti .	nebezpečné	4	Nom
Vláda vytvorí legislatívne , administratívne a kontrolné mechanizmy pre efektívne čerpanie zdrojov z fondov EÚ .	legislatívne	2	Acc
Reformátori 11 . storočia však už dospeli k precíznejšej formulácii , ktorá , podľa nás , reprezentuje nimi presadzovanú snahu o čo najpresnejšie vymedzenie sfér vplyvu svetskej a cirkevnej moci .	precíznejšej	8	Dat
Chorvátsko sa totiž od Zvonimirovej komendácie považovalo za pápežské léno .	pápežské	8	Acc
Akékoľvek doklady o Fulbertovom ideovom vplyve na Boniperta však chýbajú .	ideovom	4	Loc
Žiarlivá kráľovná sa hrozne nahnevala , že jej nevlastná dcéra je krajšia ako ona , a prikázala poľovníkovi , aby princeznú zabil .	krajšia	11	Nom
Už tretíkrát sme sa mohli stretnúť na neformálnej úrovni a prebrať pálčivé problémy , s ktorými sa stretávame na chodbách našej školy .	neformálnej	7	Loc
Maja s úžasom obdivovala jeho veľké krídla s červeným vzorom .	červeným	8	Ins
Intenzívne sa pamätám na prístavbu javiska k cirkevnej sieni na evanjelickej fare .	cirkevnej	7	Dat
Prečo lovíme zelené kravičky ?	zelené	2	Acc
Pôvodným povolaním právnik .	Pôvodným	0	Ins
To je tretia brutalita marketingu .	tretia	2	Nom
Záchranu som našiel v telefónnom čísle 09 .	telefónnom	4	Loc
Celý dojem nie je nijako uchvacujúci až do chvíle , keď požiadate o jedálny lístok .	jedálny	13	Acc
Vláda bude presadzovať takú reformu Ozbrojených síl Slovenskej republiky , ktorá bude najefektívnejšie zabezpečovať ochranu pred možným ohrozením nášho štátu a jeho občanov .	možným	16	Ins
Po putovaní rôznymi bratislavskými krčmami sa slovenské večery vrátili do Véčka .	rôznymi	2	Ins
Slovenská republika sa zapojí do snáh medzinárodného spoločenstva zameraných na riešenie globálnych problémov , ako sú boj proti organizovanému zločinu , medzinárodný terorizmus , ekologické riziká .	organizovanému	18	Dat
V Čarodejníckej vile sa nikto netešil takému privilégiu .	Čarodejníckej	1	Loc
Na druhej strane je zaujímavé , že v sledovaných cirkevnoprávnych zbierkach sme nenašli žiadne ustanovenia o podmienkach využívania azylu .	sledovaných	8	Loc
Keď práve nemala v ústach štipec na bielizeň , mohutným kontraaltom spievala :	mohutným	9	Ins
Niekedy je to nevyhnutné .	nevyhnutné	3	Nom
Napokon vstal , tackavo a hojdavo prešiel celou , hlboko ponoril ruku do vrecka na kombinéze a s rozpačitým výrazom podal mužovi s umrlčou tvárou ufúľaný kúsok chleba .	umrlčou	23	Ins
Podľa N . M . Tichomirova ide len o označenie ich sociálneho postavenia , my však vyslovujeme domnienku , že ide o pozostatok matriarchátu , zvlášť silného u ugrofínskych plemien .	ugrofínskych	28	Gen
Potom Maju nežne pohladila po hlávke a vraví : “ Spoznáš krásny veľký svet , Maja , hrejivé slniečko a nádherné lúky plné kvetov .	hrejivé	17	Acc
Prežívali sme požehnané chvíle .	požehnané	2	Acc
Spytovaní náhodní chodci i sociológovia a ďalší odborníci sa vzácne zhodli .	náhodní	1	Nom
Vo Winstonovi zápasili zvláštne pocity .	zvláštne	3	Nom
V oblasti vodovodov a kanalizácií sa vytvoria podmienky pre podporu rozvojových aktivít v regiónoch s nedostatkom prirodzených zdrojov pitnej vody .	prirodzených	16	Gen
Šance na zachovanie výsledkov tunajších reforiem boli lepšie ako v Dolnom Lotrinsku , lebo tieto reformné strediská požívali citeľnú podporu svetskej aristokracie .	svetskej	20	Gen
Kvalifikovanú odpoveď na tuto otázku však budeme môcť priniesť až po dôkladnej komparácii s dobovými východnými právnymi pamiatkami .	dobovými	14	Ins
Každý nerozvážny čin mohol znamenať nebezpečenstvo .	nerozvážny	1	Nom
Zvŕtala som sa pred zrkadlom a spomínala na Chrisov bozk .	Chrisov	8	Acc
Medzi hereckými kandidátmi sú Humphrey Bogart , Sidney Poitier , Kirk Douglas , Harold Lloyd , Sir Laurence Olivier a John Belushi .	hereckými	1	Ins
Obrázkovým telefónom som zavolal kováča Kováčika a ten bez dlhých rečí koníka okoval .	dlhých	9	Gen
Tá za desaťročia sústredeného výskumu vyprodukovala stovky monografických a časopiseckých spracovaní danej témy .	časopiseckých	9	Gen
Len spomedzi študentov náročnej školy vzídu študenti , ktorí sa dokážu presadiť v silnej konkurencii .	silnej	13	Loc
Mal som pocit , že za známymi črtami tváre , ktorých som sa vo sne neraz dotýkal , sa skrýva akési tajomstvo .	známymi	6	Ins
Keď dohovoril , usmial sa svojím záhadným úsmevom a ustúpil nabok , aby uvoľnil cestu Lori .	záhadným	6	Ins
“ Už som sa premenil , “ oznámil prekvapenej Maji a dal jej pusu .	prekvapenej	8	Dat
Drobná žena s pieskovými vlasmi zružovela a ústa otvárala a zatvárala ako ryba na suchu .	pieskovými	3	Ins
Oznámili mi to raz večer aj moje postavy v slávnostných čiernych dvojradových oblekoch .	slávnostných	9	Loc
Vo svätoštefanských zákonoch je prítomná už spomínaná kombinovaná sankcia za tento zločin .	spomínaná	6	Nom
Budete mať tri či štyri kontakty , ktoré príležitostne nahradíme novými .	novými	10	Ins
Od tých čias bola mojím najvzácnejším pokladom , i keď miestami zodratým , ale na okrajoch som cítila šampónovú vôňu jeho vlasov .	najvzácnejším	5	Ins
Vláda pripraví podmienky pre sústredenie kompetencií v oblasti regulácie a koordinácie elektronickej komunikácie a rozvoja informačnej spoločnosti z rôznych orgánov na jeden regulačný orgán .	informačnej	15	Gen
Pôvodný scenár : Zamilovaný Shakespeare	Pôvodný	0	Nom
Oba tieto kánony zodpovedajú dávnej praxi latinskej cirkvi .	dávnej	4	Dat
Napokon vstal , tackavo a hojdavo prešiel celou , hlboko ponoril ruku do vrecka na kombinéze a s rozpačitým výrazom podal mužovi s umrlčou tvárou ufúľaný kúsok chleba .	rozpačitým	18	Ins
Skutočnosť bola jednoduchšia .	jednoduchšia	2	Nom
Odborným prekladom z nemeckého jazyka nám poslúžil Mikuláš Lipták .	Odborným	0	Ins
Povedal som to nezrozumiteľnou , smiešnou ruštinou .	smiešnou	5	Ins
Teória „ protorepubliikánskej decentralizácie “ .	protorepubliikánskej	2	Gen
Na jeho základe sa bude financovať tzv . solidárny balík , ktorého súčasťou bude aj financovanie siete rýchlej zdravotnej pomoci .	zdravotnej	18	Gen
Vláda prijme strednodobý komplexný programový dokument rozvoja regiónov , zabezpečí prípravu , prerokovanie a schválenie plánovacích a programových dokumentov v oblasti regionálnej politiky s dôrazom na zlepšenie ekonomickej a sociálnej súdržnosti a prehĺbi uplatňovanie princípu partnerstva .	strednodobý	2	Acc
Tieto funkcie sú nápadne podobné funkcii kléru na starej Rusi — pri kláštoroch boli útulky pre chorých a existovali dokonca „ kláštorní lekári “ , ktorí spadali do kompetencie cirkevného práva .	kláštorní	21	Nom
To bola tá zločinecká časť komunistickej strany .	zločinecká	3	Nom
Náklady na sociálnu solidaritu budú hradené z jasne pomenovaných zdrojov .	hradené	5	Nom
Oblasť severovýchodnú , rostovsko ‐ suzdaľskú , s nižším stupňom rozvoja ekonomiky a s podmienkami pre dlhšie udržanie konzervatívnych , starých názorov .	nižším	8	Ins
Veštkyňa uprene hľadela do sklenej gule .	sklenej	4	Gen
Rovnakú spoluprácu so svetským sudcom predpokladajú v citovaných ustanoveniach aj sledované súdobé cirkevnoprávne príručky .	cirkevnoprávne	12	Nom
V podstate som nedúfala , že príde , no keď som ho zbadala na opačnom konci preplnenej a zadymenej telocvične , myslela som si , že sa mi marí .	opačnom	14	Loc
S ťažkým srdcom sa Herkules lúčil s rodičmi a oni ho s ťažkým srdcom púšťali .	ťažkým	1	Ins
Prepáčila by mi to , aj keby vedela , že som to odkladala kvôli nočnému astronomickému klubu s Chrisom ?	nočnému	14	Dat
Z čiernej nočnej oblohy sa spustil lejak .	nočnej	2	Gen
Stál tam v otrhaných šatách , aké nosieval , keď sa túlal po uliciach .	otrhaných	3	Loc
Ja som vedel , že jej portrét sa nachádza medzi viečkami medailónu v skrini , kde sú uložené aj biele svadobné šaty so závojom .	svadobné	20	Nom
Posledný szabolcsský kánon , ktorý sa venuje kláštornému životu nariaďuje opátom a mníchom , aby sa nezúčastňovali na kalendových sedeniach , ale aby prijímali oblácie ich účastníkov v kláštoroch .	kláštornému	7	Dat
Môže ísť o toporčeky s predĺženým poriskom , ktoré boli v Škandinávií predmetom symbolizujúcim hromy vrhajúceho Thora .	symbolizujúcim	13	Ins
A po ďalšej minúte sa opäť rozburácal divoký rev davu .	divoký	7	Nom
V poslednom čase sa už mnohému naučila .	mnohému	5	Dat
Netušili , čo to znamená a čoskoro sa dostali do úzkych .	úzkych	10	Gen
Jeho kláštor musel mať dobrú povesť , lebo ako lotrinský vojvoda , tak aj flámsky markgróf mu odovzdali viaceré kláštory , aby v nich obnovil rehoľný život podľa reformných princípov .	lotrinský	9	Nom
" Niektoré z nových trendov sú veľmi dômyselné .	dômyselné	7	Nom
To sú krásne nohavičky !	krásne	2	Nom
V ich národnom epose Kalevala nájdeme napr . starobylý výklad o pôvode sveta z vajca .	starobylý	8	Acc
Dodržiaval som toto pravidlo , odkedy som napísal prvú hlúposť z toho cyklu , krátku esej s dlhým názvom Orgazmus alebo Hrôza zo sexuálneho vyčerpania .	dlhým	17	Ins
Jeho prítomnosť vnáša do útvaru už spomenuté prvky hrdinskej epiky — mýtický boj za odstránenie chaosu sa mení na ochranu štátu a viery proti cudzím pohanom .	hrdinskej	8	Gen
Pod rokom 1092 sa nachádza zmienka o „ polockom zázraku “ .	polockom	8	Loc
Bývali to chvíle fantastickej radosti .	fantastickej	3	Gen
Na mieste , kde sedelo , ostala vlhká , tmavá škvrna .	vlhká	7	Nom
Začul prekrásny hlas Šípkovej Ruženky , ktorý sa niesol lesom .	Šípkovej	3	Gen
Ďakujte Hospodinu , lebo je dobrý , lebo naveky trvá jeho milosť .	dobrý	5	Nom
Pri stanovení termínu veľkého pôstu siahli uhorskí zákonodarcovia k jeho starej východnej podobe ešte spred 7 . storočia , ktorá sa v 11 . storočí nepoužívala už ani na kresťanskom východe ani na západe .	kresťanskom	29	Loc
Tvár mala bledú .	bledú	2	Acc
“ Má ťažký otras mozgu , “ určila sestra diagnózu .	ťažký	2	Acc
V reformnom hnutí v 10 . a 11 . storočí musíme zreteľne odlíšiť dve základné línie – staršiu reformu monastickú a mladšiu reformu rímsku , resp . pápežskú .	reformnom	1	Loc
Deti si obľúbia veľký zobák pelikánej slečny a radi sa s ním zahrajú , keď uvidia slová KLIP ‐ KLAP !	pelikánej	5	Gen
Podobný význam mal aj spev kohúta v čase začiatku Ježišovho utrpenia .	Ježišovho	9	Gen
Bolo horúco a ja som bol veľmi hladný .	hladný	7	Nom
Poviem jej , že autorom tej pekne ilustrovanej poviedky som ja .	ilustrovanej	7	Gen
O niekoľko dní zmenila pracovné miesto : z kravínov prešla do kancelárií na družstve , stala sa upratovačkou .	pracovné	4	Acc
Vytvorí podmienky pre elektronický obchod a bude posilňovať dôveru verejnosti k elektronickému obchodovaniu .	elektronický	3	Acc
Ich bojový pokrik prilákal spústu divákov .	bojový	1	Nom
v prioritných oblastiach verejného záujmu musí byť verejný sektor schopný konkurovať súkromnému sektoru pri získavaní a udržaní kvalitných ľudských zdrojov	súkromnému	11	Dat
“ Si ten najstatočnejší a najbystrejší mladý muž , akého poznám , “ povedal vďačne .	najbystrejší	5	Nom
I ja mám občas dojem , že môj život riadia mamine nesplnené sny .	mamine	10	Nom
Obsiahly vlastivedný úvod ( Praefatio ) k Doležalovej gramatike napísal o generáciu starší Matej Bel .	vlastivedný	1	Acc
Ako sedemnásťročný sa stal okresným zakladateľom Antisexuálnej ligy mládeže , ako devätnásťročný navrhol nový druh ručného granátu , ktorý zaradilo do výzbroje Ministerstvo mieru a ktorý už pri prvej skúške jediným výbuchom zabil tridsaťjeden euroázijských zajatcov .	jediným	30	Ins
Mám tu jednu dvojposteľovú izbu , kde bude sama .	dvojposteľovú	3	Acc
V prvých troch kapitolách sa teda pokúsime o prieskum problematiky v celoruskom rámci , odhliadnuc od jemnejších miestnych odlišností .	miestnych	17	Gen
Vláda vytvorí podmienky pre uskutočnenie úspešného referenda o vstupe do EÚ , ktoré bude dokumentovať udržanie širokej podpory verejnosti tomuto historickému kroku .	historickému	20	Dat
Džafar sa naňho opäť zahnal čarodejnou palicou .	čarodejnou	5	Ins
Vláda vytvorí legislatívne a ekonomické podmienky pre ochranu a sprístupnenie audiovizuálneho dedičstva v súlade s príslušnými medzinárodnými dohovormi .	príslušnými	15	Ins
Vytvorí podmienky pre elektronický obchod a bude posilňovať dôveru verejnosti k elektronickému obchodovaniu .	elektronickému	11	Dat
Zdalo by sa teda , že Somogyvárske opátstvo bude vďaka zväzku so svojím materským opátstvom súčasťou clunyjskej „ kongregácie “ .	materským	13	Ins
V obrovských presýpacích hodinách princeznú Jazmínu zatiaľ zasypával piesok .	obrovských	1	Loc
Nie si moja stará mama . . .	stará	3	Nom
Chudáčik nešťastný Pinocchio si v klietke bezmocne sadol .	nešťastný	1	Nom
Zároveň navrhne zákonné riešenie ochrany práv detí .	zákonné	2	Acc
V skalnatej zátoke v Jonufëri som to mal jednoduchšie .	skalnatej	1	Loc
V každom prípade aj text jeho úvodu dal Doležalovej gramatike punc najautoritatívnejšieho zdroja poznania vtedajšieho spisovného jazyka Čechov i Slovákov .	Doležalovej	8	Dat
Flauta hrala zložitú melódiu .	zložitú	2	Acc
“ Dostanem najjemnejší hodváb .	najjemnejší	2	Acc
Po ľubečskom zjazde sa mesto napokon dostalo do Monomachových rúk .	ľubečskom	1	Loc
Na moje „ haló “ sa ozval doktorov známy hlas .	doktorov	7	Nom
Z televíznej obrazovky zaznel zúrivý , ohlušujúci rev .	televíznej	1	Gen
Vláda vytvorí legislatívne , administratívne a kontrolné mechanizmy pre efektívne čerpanie zdrojov z fondov EÚ .	administratívne	4	Acc
Odolné proti drsnému zaobchádzaniu a nejaká tá diera neuberie z ich dobrých vlastností .	drsnému	2	Dat
Na chvíľu ožiarilo murény oslnivé hrôzostrašné svetlo , no po chvíli sa rozprskli na tisíc márnych kusov .	márnych	15	Gen
Vláda pripraví program zameraný na ekonomický rozvoj , v rámci tohto programu vypracuje podprogramy pre jednotlivé sektory .	jednotlivé	15	Acc
“ Aký milý chlapec to býval . “	milý	2	Nom
Novgorodské brezové listiny sú dnes uznávané ako neoceniteľný prameň pre poznanie života v tomto stredovekom meste .	neoceniteľný	7	Nom
V ten deň som sa ho nedozvedel , lebo dievčatko ku mne opäť zaujalo nepriateľský postoj drobnej šelmy .	nepriateľský	14	Acc
V trhovej ekonomike je všetko na predaj .	trhovej	1	Loc
V chodbe páchla varená kapusta a staré handrové rohožky .	handrové	7	Nom
Vzdelanie sa stáva kľúčom k životnému úspechu , najlepšou investíciou do budúcnosti , účinnou prevenciou pred nezamestnanosťou , zločinnosťou , drogami .	životnému	5	Dat
Splývali pred mojím duševným zrakom v podobe Lori , ktorá bola ich poslednou metamorfózou .	poslednou	12	Ins
Videla som ju zopár ráz na plaveckých pretekoch , lenže nikdy nás nikto nepredstavil .	plaveckých	6	Loc
„ Ypsilon ako hláska nie je funkčný a v slovenskom jazyku takej hlásky niet .	slovenskom	9	Loc
Zakrátko zhotovil pekné a pevné nosidlá .	pevné	4	Acc
Vláda bude podporovať vývoj a šírenie výrobkov i služieb šetriacich životné prostredie a v rámci legitímnych trhových nástrojov hľadať možnosti podpory malým a stredným podnikateľom zvyšovať investície do „ čistej “ výroby a environmentálnych podnikateľských aktivít .	malým	21	Dat
Už sme spomenuli , že pápežský úrad bol v desaťročiach pred reformou v hlbokej kríze .	pápežský	5	Nom
O chvíľu prišiel k stánku chlapec v otrhaných zaplátaných šatách .	zaplátaných	8	Loc
Motýľ Emanuel ostal ako obarený .	obarený	4	Nom
Tak u mnohých národov existujú tzv . bieli šamani , spájaní s nebeskými silami a svetom hore a šamani čierni , zviazaní s podsvetím .	nebeskými	12	Ins
Ten nebol pri profesorovom zatknutí .	profesorovom	3	Loc
V oblasti nemocenského poistenia prijme vláda opatrenia zamedzujúce zneužívaniu systému .	zamedzujúce	7	Acc
Keď sa neskôr vracali domov a pozorovali hviezdy , vystrašil ich hrozný krik .	hrozný	11	Nom
Len tak môže byť človek bezpečný . "	bezpečný	5	Nom
Najmiernejším prívlastkom , ktorý by mi vmietla do tváre , by bolo slovo „ gauner “ .	Najmiernejším	0	Ins
“ Ale ja som nevinný ! “ vykríkol som .	nevinný	4	Nom
S prekvapujúcou dôvernosťou .	prekvapujúcou	1	Ins
Na stole ležala strieborná tabatierka .	strieborná	3	Nom
Cieľom Diskusného klubu je budovanie občianskej spoločnosti na kresťanskom morálnom základe .	morálnom	9	Loc
Tak je po Jaroslavovom víťazstve položený základ novgorodských výsad , ktorí Novgorodcom garantujú ochranu pred kniežacími družiníkmi a Varjagmi / no zároveň zabezpečujú kniežaciu družinu pred ľudom / .	novgorodských	7	Gen
Hugovi životopisci nás informujú o dobrom výsledku účinkovania opáta v Uhorsku .	dobrom	5	Loc
Výsady sice majú formu udeľovanej listiny , no v skutočnosti ide o zmluvný zápis , tvoriaci kostru tzv . najstaršej Pravdy .	najstaršej	19	Gen
Jednou z podmienok vysoko profesionálneho výkonu zahraničnej služby je pritom realizácia kvalitnej personálnej politiky v rezorte zahraničných vecí .	profesionálneho	4	Gen
Títo reformne naladení klerici sa stali najbližšími pápežovými spolupracovníkmi a poradcami .	najbližšími	6	Ins
Jediným uznávaným zmyslom manželstva bolo splodiť deti , ktoré mali slúžiť Strane .	Jediným	0	Ins
Škola sa musí stať v regióne kultúrnym , športovým a spoločenským centrom obecnej komunity .	športovým	8	Ins
O výške trestu mala rozhodnúť odkvitnutá púpava .	odkvitnutá	5	Nom
Dostal novú spodnú bielizeň a čistú súpravu kombinézy .	čistú	5	Acc
Drsný koniec srbského " partizána "	srbského	2	Gen
Podľa viery ugrofínskych Čuvašov výšivka konskej hlavy na ženskej hrudi chráni pred nebezpečím pôrodu .	ženskej	8	Loc
Chvíľu leteli , až pristáli v spustnutej záhrade , kde bola pod obrovskou smutnou vŕbou hlbočizná studňa .	spustnutej	6	Loc
“ Kto si ? “ spýtala sa očarená Maja .	očarená	7	Nom
Ochrannú funkciu mal krížik , zakončujúci ihlicu z mosadze .	Ochrannú	0	Acc
Dvojtvárnosť trickstera súvisí s celkovým dualizmom , prítomným v systéme prírodného polyteizmu .	celkovým	4	Ins
Medzitým prišlo na plaváreň zopár deciek z oddielu a ich hlasy sa ozývali po vykachličkovanom priestore .	vykachličkovanom	14	Loc
V posledných dňoch sa dokázal sústrediť len nakrátko .	posledných	1	Loc
Hlúpa tvár pod svetlými vlasmi ho vítala s rozžiareným úsmevom .	rozžiareným	8	Ins
Kvalitná a pevná čepeľ musí byť samozrejmosťou .	Kvalitná	0	Nom
Kde si , spýtal som sa po dlhej odmlke .	dlhej	7	Loc
Vo Francúzsku už počas panovania posledných Karolovcov zanikla silná ústredná panovnícka moc .	posledných	5	Gen
Bol som jej štvrtým tridsaťpercentníkom .	štvrtým	3	Ins
Šírila sa z veľkého červeného kvetu s tmavozelenými listami .	veľkého	3	Gen
Datácia pečate vychádza z hypotetického predpokladu Izjaslavovej vlády v Novgorode v rokoch 1052 ‐ 1054 .	Izjaslavovej	6	Gen
Obsiahly vlastivedný úvod ( Praefatio ) k Doležalovej gramatike napísal o generáciu starší Matej Bel .	starší	12	Nom
Nazlostený Flip sa jediným obrovským skokom preniesol k pavučine .	jediným	3	Ins
Bol teplý podvečer a Maja zaliezla do svojej škáročky v strome .	teplý	1	Nom
Potom hudba stíchla , a keď Maja znovu otvorila oči , uvidela cvrčka , ako odlieta do jasnej mesačnej noci .	mesačnej	18	Gen
Pôvodne sa nachádzal na freske severozápadnej veže .	severozápadnej	5	Gen
Poletíš ponad strieborné jazerá a zurčiace potoky , pod jasným nebom a vysokými zelenými stromami .	vysokými	12	Ins
Nič nie je skutočné , usúdil som nakoniec .	skutočné	3	Nom
Našiel prastarý turban a knihu .	prastarý	1	Acc
Na jeho tvári viseli matkine ustráchané oči .	ustráchané	5	Nom
Vláda bude podporovať podnikanie a zlepšovať podnikateľské prostredie .	podnikateľské	6	Acc
Len nedávno mali v banke celoročné hodnotenie a dnes sa dozvedela , že jej riaditeľ zvýšil plat .	celoročné	5	Acc
" V internáte o jedenástej .	jedenástej	4	Loc
Podporíme urýchlenie legislatívneho , inštitucionálneho a administratívneho dobudovania štruktúr potrebných na výkon Spoločnej poľnohospodárskej politiky .	Spoločnej	12	Gen
Zvíťazila som v najdôležitejších pretekoch .	najdôležitejších	3	Loc
Po celý čas som sa díval smerom k osvetlenému pásmu , kde sa zástup žien tlačil pred skleným priečelím obchodu .	skleným	17	Ins
S kŕdľami strák , ktoré poletovali po pustom parku pri Domove dôstojníkov .	pustom	7	Loc
Vlak sa šinul svojou slimačou pomalosťou .	slimačou	4	Ins
Pre potreby rozvíjajúcej sa cirkevnej organizácie bol na základe tohto štatútu okolo roku 1100 vytvorený štatút nový , ktorý sa stal základným archetypom pre všetky neskoršie odpisy .	vytvorený	14	Nom
Po rokom 1044 sa nachádza správa o narodení Vseslava , ktorému matka na radu volchvov uviazala amulet , spôsobiaci že z chlapca vyrástol krutý a nemilosrdný človek .	nemilosrdný	25	Nom
A plagát s akousi kubistickou maľbou .	kubistickou	4	Ins
Nejaký riaditeľ podniku alebo vedúci brigády na družstve , kde som absolvoval pravidelný mesiac fyzickej práce .	pravidelný	12	Acc
Lori popíjala pomarančový džús .	pomarančový	2	Acc
Tyranizuje nás ťaživou krásou obrazov .	ťaživou	2	Ins
Na okraji studne sedel zelený žabiak s kockovaným klobúkom na hlave .	zelený	4	Nom
Podporením priestupnosti školského systému v oblasti prechodu žiakov na vyšší stupeň školy bez prijímacích skúšok , vláda minimalizuje podmienky na korupciu v školstve .	školského	2	Gen
V konečnom dôsledku je takto ohrozené spasenie veriaceho ľudu .	konečnom	1	Loc
Zároveň svetská časť vládnúcej vrstvy prestáva mať záujem o monoteizmus vyjadrujúci myšlienku — jeden boh , jeden panovník .	vyjadrujúci	10	Acc
Vláda považuje štíhlejší , funkčnejší a menej náročný verejný sektor za nevyhnutnú podmienku úspešnej správy vecí verejných .	náročný	7	Acc
Bola tu celá reťaz zvláštnych oddelení , ktoré sa zaoberali proletárskou literatúrou , hudbou , dramatickým umením a vôbec zábavou .	zvláštnych	4	Gen
Preto predpokladáme , že žili pomerne izolovane od ostatného uhorského mníšstva .	ostatného	8	Gen
Jedného dňa stretla na malinčí čudného tvora .	čudného	5	Acc
Skupina kánonov I . ostrihomskej synody sa venuje stanoveniu obsahu bohoslužieb a príbuzným kultovým predpisom .	príbuzným	12	Dat
Slnečný svit , ktorý prenikal nespočetným lístím , ich ešte stále pálil na tvárach .	nespočetným	5	Ins
Vzápätí pribehli mandelinčatá s boľavými bruchami , takže musela ošetriť aj ich .	boľavými	4	Ins
Bolo významným strediskom na ceste do rostovsko ‐ suzdaľskej oblasti .	suzdaľskej	8	Gen
Jedného letného popoludnia sa na Makovej lúke zjavila obluda , akú ešte nikto nevidel .	Makovej	5	Loc
Slovná zásoba A sa vôbec nedala použiť na literárne účely a na politické a filozofické dišputy .	filozofické	14	Acc
Iba na začiatku textu zbierky je akýsi tematický zoznam , pri jednotlivých častiach ktorého sú uvedené čísla „ kánonov ” , vzťahujúcich sa k tomu - ktorému tematickému okruhu .	tematickému	27	Dat
Uznal som za vhodné požiadať ich , aby ma zobudili o pol piatej .	piatej	12	Loc
Zaujímavý je v tejto súvislosti nález z vykopávok z roku 1960 z Iľjinej ulice .	Iľjinej	12	Gen
Margin predčasný odchod z tohto sveta som pripravoval ja .	predčasný	1	Acc
Pre skúmané obdobie sú nápisy v najstaršom novgorodskom chráme neobyčajne cenným prameňom .	novgorodskom	7	Loc
Vzápätí stál na balkóne Džafar oblečený v sultánovom rúchu .	sultánovom	7	Loc
Nado mnou sa ukladá tisícročná náplava .	tisícročná	4	Nom
Z takýchto listín je zaujímavý predovšetkým nález , datovaný zhruba polovicou trinásteho storočia .	trinásteho	11	Gen
Chrobák zmizol medzi okvetnými lístkami .	okvetnými	3	Ins
Okolo nej , nad ňou i pod ňou boli ďalšie davy pracovníkov s nepredstaviteľným množstvom úloh .	nepredstaviteľným	13	Ins
U nás jeme to , čo sa objedná cez donášku alebo mrazené jedlá , “ povedal Chris .	mrazené	11	Acc
Keď však Maja s Fridolínom krepčili v divom tanci , stala sa ďalšia katastrofa .	divom	7	Loc
Pre skúmané obdobie sú nápisy v najstaršom novgorodskom chráme neobyčajne cenným prameňom .	cenným	10	Ins
Napokon usúdil , že najbezpečnejším miestom je kantína .	najbezpečnejším	4	Ins
Zváži motivačné pravidlá pre využívanie domácich primárnych energetických zdrojov , vrátane využívania obnoviteľných zdrojov energie .	obnoviteľných	12	Gen
Bolo to to dievča s tmavými vlasmi .	tmavými	5	Ins
Nazlostený Flip sa jediným obrovským skokom preniesol k pavučine .	obrovským	4	Ins
Sprevádzali ho ďalší štyria strážcovia s vytasenými mečmi .	vytasenými	6	Ins
Prešiel z izby do stiesnenej kuchynky .	stiesnenej	4	Gen
Veľa včiel opustilo mesto s novou kráľovnou , aby niekde vo veľkom šírom svete založili nové včelstvo .	šírom	12	Loc
Kántrové pôstne dni sa spomínajú aj v Ladislavových a Kolomanových zákonoch .	Kolomanových	9	Loc
Hlavným motívom výletu bola rozprávka .	Hlavným	0	Ins
Zdravý rozum je záležitosť štatistiky .	Zdravý	0	Nom
Newspeak bol oficiálnym jazykom Oceánie , vytvorený kvôli ideologickým potrebám angsocu , teda anglického socializmu .	ideologickým	8	Dat
Zažiješ neuveriteľné dobrodružstvá .	neuveriteľné	1	Acc
Prikázali mi , aby som bol na druhý deň okolo poludnia v hotelovej hale , odkiaľ pôjdeme do kostola na svadobný obrad .	hotelovej	12	Loc
Namiesto nich mal drobnú kartónovú škatuľku a v nej dva chrústy .	drobnú	3	Acc
Najväčšiu životnú záľubu nachádzal Winston v práci .	Najväčšiu	0	Acc
Zároveň však Cluny urobilo veľký krok na ceste k libertas , lebo vytvorilo spoločenstvo ( zväčša ) úplne slobodných kláštorov , ktoré nepodliehali laikom .	slobodných	18	Gen
Mladí nastúpili do Lorinho auta .	Lorinho	3	Gen
Práve zachytil O ' Brienov pohľad .	Brienov	4	Acc
" To všetko patrí Vnútornej strane .	Vnútornej	4	Dat
Našla osí roj , ktorý mal včelí palác zničiť .	osí	1	Acc
V širších súvislostiach to zasa podľa nás poukazuje na podobnosť postavenia franských panovníkov a Štefana I . vo svojich štátnych cirkvách .	širších	1	Loc
Zakrátko si Makulienka obliekala novú sukničku s volánikmi a motýľ Emanuel frak s dlhými krídlami .	dlhými	13	Ins
Odolné proti drsnému zaobchádzaniu a nejaká tá diera neuberie z ich dobrých vlastností .	dobrých	11	Gen
Vláda bude podporovať vývoj a šírenie výrobkov i služieb šetriacich životné prostredie a v rámci legitímnych trhových nástrojov hľadať možnosti podpory malým a stredným podnikateľom zvyšovať investície do „ čistej “ výroby a environmentálnych podnikateľských aktivít .	environmentálnych	33	Gen
Aladin sa zatiaľ usadil so skríženými nohami pred krištáľovou guľou .	krištáľovou	8	Ins
Vláda pripraví nový zákon o prírodných liečivých zdrojoch , o prírodných liečebných kúpeľoch a o prírodných minerálnych vodách .	minerálnych	16	Loc
Winston sa začal obliekať pomalými , strnulými pohybmi .	strnulými	6	Ins
V oblasti manželského práva je teda uhorské ranoarpádovské zákonodarstvo , ak ho porovnávame s dobovým kánonickým právom , nejednoznačné .	uhorské	6	Nom
Nemecký kráľ Henrich III . sa v lete nasledujúceho roku vydal do Ríma , aby sa dal korunovať za cisára .	Nemecký	0	Nom
Osvetovú kampaň Nádej pre život podporili Svetová zdravotnícka organizácia , minister zdravotníctva , Slovenská geriatrická a gerontologická spoločnosť , Slovenská lekárska spoločnosť , Slovenská internistická spoločnosť a Slovenská kardiologická spoločnosť .	Slovenská	13	Nom
Prijme systém finančnej podpory preventívnych projektov .	finančnej	2	Gen
Už sme spomenuli , že pápežský úrad bol v desaťročiach pred reformou v hlbokej kríze .	hlbokej	13	Loc
Potom si kráľovná opäť zastala pred oválne zrkadlo v zlatom ráme .	zlatom	9	Loc
Príčiny svojich neúspechov musí človek hľadať vo vlastnom vnútri a ja som tak robil .	vlastnom	7	Loc
Prsty sa jej skrivili a nechty sa premenili na zahnuté pazúriská .	zahnuté	9	Acc
V oblasti vodného hospodárstva bude vláda legislatívnymi a organizačnými opatreniami zabezpečovať racionalizáciu a efektívnosť pôdohospodárskych činností .	legislatívnymi	6	Ins
Koncepciu Slovenských večerov vymyslel Igor Medlen , vtedajší tajomník Folklórneho festivalu vo Východnej .	Folklórneho	9	Gen
Do chrobákovho obydlia dopadalo tlmené červené svetlo a sladká vôňa bola oveľa prenikavejšia .	chrobákovho	1	Gen
Akýsi drevorubač sa vraj musel počas jednej zimnej noci vrátiť domov .	zimnej	7	Gen
Bola noc a biele tváre a šarlátové transparenty zalievalo zlovestné svetlo .	šarlátové	6	Acc
V takomto prípade hovoríme o tzv . primárnej prevencii .	primárnej	7	Loc
" Pintu tekutého moku !	tekutého	2	Gen
Boj proti hospodárskej korupcii	hospodárskej	2	Dat
Pred okienkom do pivnice ležal lesklý tvor s červenými očami a nahlas funel .	lesklý	5	Nom
Rozčuľujúce sa a provokujúce typy .	provokujúce	3	Acc
Z televíznych obrazoviek zaznievala tuctová hudba .	televíznych	1	Gen
Nimi vysvätení kňazi teda nie sú právoplatne vysvätenými a nemôžu teda veriacim sprostredkovať dary Ducha Svätého .	Svätého	15	Gen
“ Môjmu kráľovskému uchu sa donieslo , že chceš ostať v džungli . “	kráľovskému	2	Dat
Vyzerajú ako šťastná dvojica ! “ zvolala prekvapená Sandra .	šťastná	2	Nom
To je nevyhnutné .	nevyhnutné	2	Nom
Celý týždeň som bol náchylný uveriť , že to všetko bol iba sen .	Celý	0	Acc
Jeho zbierka totiž , podľa nás , predstavuje prechodný typ cirkevnoprávnej zbierky , ktorý stojí medzi cirkevnoprávnymi zbierkami vzniknuvšími v období dominancie germánskeho práva a zbierkami reformnými , ktoré sú predstupňom diel klasickej kánonistiky .	reformnými	26	Ins
V poviedke s prevzatým názvom Prípad z praxe som mu dal meno Vehap .	prevzatým	3	Ins
Odhrnula som mokré plavky , prázdne kokakolové plechovice , ceruzky , listy vytrhnuté z notesa a knižku Kto chytá v žite so somárskymi ušami .	vytrhnuté	12	Acc
Z nálezov nefigurálneho charakteru je zaujímavý nález troch hlinených kraslíc .	hlinených	8	Gen
Poznal som naspamäť všetky Čechovove poviedky a novely , ktoré vyšli v albánčine .	Čechovove	4	Acc
Pri slávnostných obradoch ju potom niesol jej najuznávanejší člen .	slávnostných	1	Loc
Z Pobaltia pochádzajú náušnice podľa tvaru zvané vlčí zub .	vlčí	7	Nom
Rovnakú spoluprácu so svetským sudcom predpokladajú v citovaných ustanoveniach aj sledované súdobé cirkevnoprávne príručky .	svetským	3	Ins
Jej vládcov nespájajú pokrvné zväzky , ale príslušnosť k spoločnému učeniu .	spoločnému	9	Dat
Vo všeobecnosti to boli dôchodcovia s plstenými klobúkmi alebo čiapkami , ktoré ich chránili pred slnkom .	plstenými	6	Ins
Znak potom môžme vykladať ako zobrazenie vtáka s roztiahnutými krídlami a hlavou vysunutou dopredu .	vysunutou	12	Ins
Na spoločnom výlete niekde v Kente zablúdili .	spoločnom	1	Loc
Najväčším pôstnym obdobím cirkevného roka je predveľkonočný štyridsaťdňový veľký pôst – Quadragesima .	pôstnym	1	Ins
Herkules medzitým navštívil v chráme Dia a predviedol milovanému otcovi svoje víťazstvá .	milovanému	8	Dat
Toto , spolu s predchádzajúcou svätoštefanskou právnou normou , dobre korešponduje s popisovaným výnimočným postavením uhorského kráľa v krajinskej cirkvi .	krajinskej	18	Loc
Od tých čias bola mojím najvzácnejším pokladom , i keď miestami zodratým , ale na okrajoch som cítila šampónovú vôňu jeho vlasov .	zodratým	11	Ins
Vláda sa bude usilovať o postupné zapájanie kapacít nášho obranného priemyslu do štruktúr európskeho obranného priemyslu .	postupné	5	Acc
Mal vysokú , štíhlu , ale svalnatú postavu a pophyboval sa s nesmiernou ľahkosťou .	nesmiernou	12	Ins
Vláda podporí rozvoj základného a aplikovaného výskumu na vysokých školách ako nevyhnutnej podmienky na poskytovanie kvalitného vysokoškolského vzdelávania a na zabezpečenie dlhodobo udržateľného rozvoja spoločnosti .	vysokoškolského	16	Gen
Pálčivá bolesť mu preletela celým telom .	Pálčivá	0	Nom
Bude pokračovať v napĺňaní národného programu , prijme nové opatrenia v legislatívnej , inštitucionálnej aj organizačnej oblasti .	inštitucionálnej	13	Loc
Na trhovisku ho zarazilo množstvo čudných vecí a kadejakých vôní .	čudných	5	Gen
Osobitne by sme si chceli povšimnúť právne normy , v ktorých ide o odvádzanie desiatku klérom .	právne	6	Acc
Veronika sa najprv urazila , ale keď jej Ferdo vysvetlil , že rehotanie je taká zvláštna psia choroba , trochu sa upokojila .	zvláštna	15	Nom
Na kozubovej rímse tikali starodávne hodiny s dvanásťhodinovým ciferníkom .	starodávne	4	Nom
Na oslavu prišli všetci olympskí bohovia a priniesli množstvo nádherných darov .	nádherných	9	Gen
V popoludňajšej tíši prekvapovala hlasitosť jeho zvuku .	popoludňajšej	1	Loc
Jazmína sa vyštverala na vysokánsky štíhly kmeň jednej z najvyšších datľových paliem v kráľovskej záhrade .	vysokánsky	4	Acc
S ťažkým nákladom sa vliekli po lesnej ceste .	lesnej	6	Loc
Touto syntézou môžme vysvetliť mnohé osobitosti hospodárskeho i politického života oblasti .	politického	8	Gen
V obrovských presýpacích hodinách princeznú Jazmínu zatiaľ zasypával piesok .	presýpacích	2	Loc
Uvedená pasáž býva často vykladaná ako vplyv bogomilstva .	vykladaná	4	Nom
V niektorých ohľadoch bola oveľa kritickejšia ako Winston a oveľa menej ochotná prijímať stranícku propagandu .	ochotná	11	Nom
Tento národ teda kládol zúrivý odpor kolonizačným snahám ruských kniežat .	ruských	8	Gen
Namrzený Mauglí si sadol na opačný koniec .	opačný	5	Acc
Špecifické skupiny nálezov , vyskytujúcich sa vo väčšom množstve , budú rozoberané v osobitnch kapitolách .	osobitnch	13	Loc
Bolo to v jeden januárový deň , z popolavej oblohy padal jemný dážď .	januárový	4	Acc
Vláda bude klásť dôraz na racionalizáciu nákladov spojených s realizáciou výkonov vo verejnom záujme v železničnej osobnej doprave a verejnej autobusovej doprave .	verejnej	19	Loc
Náhlila som sa do kabínky pri bazéne , napchala som mokré veci do vaku , obula si mokré tenisky a vybehla von .	mokré	10	Acc
Najskôr sa na hornej časti schodišťa objavila drobná starena v širokých nohaviciach .	širokých	10	Loc
Máme spoločnú príležitosť napísať vynikajúcu kapitolu slovenských dejín .	vynikajúcu	4	Acc
Viete , koľko tu stojí 1 - izbový byt ?	izbový	7	Nom
A tu či inde sa v úplnej tajnosti nachádzali riadiace mozgy , ktoré koordinovali toto úsilie a určovali politickú líniu : rozhodovali o tom , že tento fragment minulosti sa zachová , tento sa sfalšuje a ďalší prestane jestvovať .	úplnej	6	Loc
Vzápätí stál na balkóne Džafar oblečený v sultánovom rúchu .	oblečený	5	Nom
Špecifické skupiny nálezov , vyskytujúcich sa vo väčšom množstve , budú rozoberané v osobitnch kapitolách .	Špecifické	0	Nom
Vláda bude podporovať programy v horších pôdnych a klimatických podmienkach a orientovať sa na mimoprodukčné funkcie poľnohospodárstva a agroturistiky .	klimatických	8	Loc
Nie sú ani pekné , ani obľúbené .	obľúbené	6	Nom
Datácia pečate vychádza z hypotetického predpokladu Izjaslavovej vlády v Novgorode v rokoch 1052 ‐ 1054 .	hypotetického	4	Gen
Taktáto blízkosť funkcií vedie k ľahkej zameniteľnosti šamana za mnícha .	ľahkej	5	Dat
“ Musíš byť statočný , ako bol Balú , “ odvetil .	Balú	7	Acc
Nepatrí teda k spomenutému typu „ poľnohospodárskych miest “ .	poľnohospodárskych	6	Gen
Nevznikla sama od seba , jej náväznosť na vierouku z desiateho storočia / i keď došlo k zrejmým posunom / svedčí o kontinuite jej vývoja .	desiateho	10	Gen
Vláda pripraví nový zákon o prírodných liečivých zdrojoch , o prírodných liečebných kúpeľoch a o prírodných minerálnych vodách .	prírodných	15	Loc
Pre Lizu by bolo katastrofou , keby som rozpovedal ostatným , čo som videl v Profesorovej izbe .	Profesorovej	15	Loc
Za finančnú podporu sa chcem poďakovať Ekumenickej rade cirkví , nášmu drahému zboru a „ staršej “ mládeži ECAV v Prešove , modlitebnému spoločenstvu , kamarátom z tréningu Rovesník a jednotlivcom .	modlitebnému	22	Dat
Dnes večer mal ísť do Spoločenského strediska .	Spoločenského	5	Gen
Fil sa svedomito pustil do Herkulovej prípravy .	Herkulovej	5	Gen
Kráčal som za ním po tichej chodbe nemocničného pavilónu a ani som si nevšimol , že Irma nie je s nami .	tichej	5	Loc
“ To je super ! “ zvolala som .	super	3	Nom
Miznem v temnej priepasti , v roztvorených ústach pohlcujúcich rieku času .	pohlcujúcich	8	Loc
Pomaly kráčali po dlhom schodišti , ktoré viedlo na strechu , kde bývali , a boli hladní , unavení a veľmi sklamaní .	sklamaní	21	Nom
Okolo hučal a bzučal najrôznejší hmyz a v stromoch na plné hrdlo vyspevovali vtáci .	plné	10	Acc
Do cely vošiel mladý dôstojník s chladnou tvárou .	chladnou	6	Ins
Bohatstvo a privilégiá sa najľahšie ochraňujú , keď majú spoločného vlastníka .	spoločného	9	Acc
Primeraná pozornosť bude venovaná rozvíjaniu vzťahov s krajinami Ázie , Afriky a Latinskej Ameriky .	Latinskej	12	Gen
Drobná žena s pieskovými vlasmi zakvičala a v jej hlase sa miešala hrôza s odporom .	pieskovými	3	Ins
Ľudská postava vcelku s kniežacou čiapkou , alebo korunou držiacou atribúty moci .	kniežacou	4	Ins
A dospeli k paradoxným poznatkom .	paradoxným	3	Dat
Winston si prečítal nevhodný článok .	nevhodný	3	Acc
Pod jeho lakťom bol dievčí pás mäkký a teplý .	teplý	8	Nom
Prvým výskumníkom , zaoberajúcim sa novgorodskými pečaťami bol P . Lichačev , ktorý do roku 1917 objavil šesťsto kusov .	novgorodskými	5	Ins
Zbierka uvádza pravé i nepravé dekretály viacerých pápežov , ako aj početné dokumenty pojednávajúce o výnimočných právach rímskeho biskupa .	výnimočných	15	Loc
Vláda pripraví nový zákon o prírodných liečivých zdrojoch , o prírodných liečebných kúpeľoch a o prírodných minerálnych vodách .	liečebných	11	Loc
Aj oni mali pred sebou lepšiu a krajšiu budúcnosť a máme ju aj my .	lepšiu	5	Acc
Keď však Winston opravoval pôvodný plán , znížil číslo na 57 miliónov , aby vyhovel bežným požiadavkám na prekročenie kvóty .	bežným	15	Dat
Vždy som mal podozrenie , že v mojich vzťahoch s neznámou ženou vycítil čosi nečisté .	neznámou	10	Ins
S višňovou vôňou tela .	višňovou	1	Ins
Maja si zatiaľ hladkala boľavé plece .	boľavé	4	Acc
Otec veľa rozprával o svojom literárnovednom výskume , ale nevyhýbali sme sa , samozrejme , ani súčasným problémom .	literárnovednom	5	Loc
On – Kristus je novou možnosťou orientácie , cestou znovuzrodenia , novej nádeje a lásky , ktorá hľadá tých , ktorí sú na ceste rezignácie , ubití ľudským egoizmom a hriechom .	ubití	26	Nom
Srdce ťa ešte stále ťahá k oldspeaku s celou jeho neurčitosťou a zbytočnými významovými odtieňmi .	zbytočnými	12	Ins
Priplietol sa tam iný blázon : Plné gate .	Plné	6	Nom
S veľkými vreckami .	veľkými	1	Ins
Ako sme vychádzali z miestnosti , nastal v triede všeobecný ruch .	všeobecný	9	Nom
Bola to vysoká plavovláska s rozpustenými vlasmi a modrými očami , pery mala trochu hrubé a namaľované na tmavočerveno .	rozpustenými	5	Ins
Sadol som si do podniku pri kine a čakal , kým príde určená hodina .	určená	12	Nom
Všetko prebehlo v tichosti , vedenie fakulty nevydalo nijaké oficiálne vyhlásenie .	oficiálne	9	Acc
Do slovenských častí Uhorska sa vtedy utiahla jedna časť českých emigrovaných protestantov a tu našli v používaní svoj vlastný spisovný jazyk presne tak , ako vo svojej českej vlasti .	vlastný	18	Acc
Šance na zachovanie výsledkov tunajších reforiem boli lepšie ako v Dolnom Lotrinsku , lebo tieto reformné strediská požívali citeľnú podporu svetskej aristokracie .	Dolnom	10	Loc
Listina je o šesťsto rokov staršia než iné zo známych písomných pamiatok v karelčine .	písomných	10	Gen
Jednoznačne ide o účelovú mystifikáciu s cieľom zmanipulovať konanie bežného občana a obrať ho o posledné základné životné istoty .	bežného	9	Gen
Finančne podporí rozvoj ľudských zdrojov a inštitucionálnej infraštruktúry regiónov , slúžiacej na realizáciu komplexnej regionálnej politiky .	slúžiacej	10	Gen
Majine jemné krídelká sa jagali ako perly a zlatisté telíčko na slnku len tak žiarilo .	Majine	0	Nom
Vzniknutý kódex sa stáva základom tzv . Krátkej redakcie pravdy / kým kódex , vzniknutý roku 1037 v Kyjeve sa stáva základom pravdy priestrannej / .	vzniknutý	14	Nom
Potrebovali sme istý čas , kým sme pochopili , že takáto pretvárka znamená zbytočné utrpenie .	zbytočné	13	Acc
Strhla aj mladšiu sestru a s rachotom prevrhli otcovu stoličku .	otcovu	8	Acc
Máme spoločnú príležitosť napísať vynikajúcu kapitolu slovenských dejín .	spoločnú	1	Acc
Alebo s pridlhým ?	pridlhým	2	Ins
STROMBOLI NEVERIL VLASTNÝM OČIAM , keď pred sebou zbadal dreveného panáčika .	VLASTNÝM	2	Dat
Základným prvkom reformy verejných financií bude zavedenie tvrdého rozpočtového obmedzenia v celom okruhu verejných financií .	celom	11	Loc
V širších súvislostiach to zasa podľa nás poukazuje na podobnosť postavenia franských panovníkov a Štefana I . vo svojich štátnych cirkvách .	štátnych	19	Loc
Situáciu umožňujú skompletizovať archeologické vykopávky v Timerevskom hradisku .	Timerevskom	6	Loc
Hneď na úvod som urobil niečo veľmi nerozumné : dal som si dvojitý koňak .	nerozumné	7	Acc
Film bol nakrútený podľa skutočnej udalosti .	nakrútený	2	Nom
Po kráľovskej hostine , na ktorú mravce priniesli obrie porcie špagiet s voškovou omáčkou , si všetci políhali na slniečko , aby si oddýchli .	kráľovskej	1	Loc
Musím rešpektovať Marginu požiadavku , aby som deťom nič nepovedal , a zároveň musím nájsť pre Irmu nejaké presvedčivé vysvetlenie .	presvedčivé	18	Acc
Ako šesťročného ( o rok skôr , než bolo zvykom ) ho na základe zvláštnej výnimky prijali medzi Zvedov a ako deväťročný sa stal vedúcim skupiny .	zvláštnej	14	Gen
Čo bolo v listoch posielaných nahor , nikdy som sa nedozvedel .	posielaných	4	Loc
Mnohých som už predtým veľakrát videla na štartovacích blokoch .	Mnohých	0	Acc
Winston zdvihol šálku džinu , chvíľku naberal odvahu a potom obrátil do seba to tekuté svinstvo , ktoré malo pachuť oleja .	tekuté	14	Acc
Marga zomrela v posledných minútach decembra .	posledných	3	Loc
Vláda bude realizovať opatrenia zamerané na zvýšenie efektívnosti využívania verejných zdrojov .	zamerané	4	Acc
Grifony zapriahnuté v nebeských záprahoch božstiev fungovali ako zjednotitelia neba a zeme .	záprahoch	4	Loc
Rovnakého problému sa týka i posledný z ostrihomských kánonov , ktorý sa venuje vlastnému ordinačnému právu .	ordinačnému	14	Dat
Nechal som ho deň predtým na hotelovej recepcii .	hotelovej	6	Loc
Zlej víle pohrával na červených perách zlovestný úsmev .	zlovestný	6	Nom
Spomínaní clunyjskí opáti boli osobnosťami s mimoriadnymi osobnostnými kvalitami a veľkou morálnou autoritou .	morálnou	11	Ins
Vláda považuje za jednu zo svojich priorít dôslednú reformu súdnictva , posilňovanie vymožiteľnosť práva a zásadnú zmenu v trestnej politike štátu .	trestnej	18	Loc
Dom bol v predstave vtedajších ľudí akýmsi mikrokozmom , svetom samým osebe s prepracovaným systémom magickej obrany pred zlými silami vonku .	vtedajších	4	Gen
“ Je trochu pomätená , bláznivá . “	bláznivá	5	Nom
Blízka existencia dvoch stredísk rozdielnych národov svedčí o možnosti ich vzájomného ovplyvňovania , o etnickej nerovnorodosti základu , z ktorého vznikol Rostov .	etnickej	14	Loc
Roku 1966 pri vykopávkach v Iľjinskom rajóne bol nájdený stredný trám s tlamou draka .	Iľjinskom	5	Loc
Vláda bude presadzovať zrušenie systému maximálnych cien a zmenu kategorizácie úhrady liekov tak , aby obsahom solidárneho balíka bola v každej anatomicko - terapeutickej skupine aspoň jedna účinná látka .	solidárneho	16	Gen
Pálčivá bolesť mu preletela celým telom .	celým	4	Ins
Tak je po Jaroslavovom víťazstve položený základ novgorodských výsad , ktorí Novgorodcom garantujú ochranu pred kniežacími družiníkmi a Varjagmi / no zároveň zabezpečujú kniežaciu družinu pred ľudom / .	kniežaciu	23	Acc
Usadila sa na leknovom liste a začala sa umývať .	leknovom	3	Loc
So zvyšnými dvoma tretinami som išiel do izby .	zvyšnými	1	Ins
Obrátila som sa a zbadala som to prekrásne staré autíčko .	prekrásne	7	Acc
Žiarlivá kráľovná sa hrozne nahnevala , že jej nevlastná dcéra je krajšia ako ona , a prikázala poľovníkovi , aby princeznú zabil .	Žiarlivá	0	Nom
Vláda pripraví nový zákon o prírodných liečivých zdrojoch , o prírodných liečebných kúpeľoch a o prírodných minerálnych vodách .	liečivých	6	Loc
V tej chvíli sa ponáhľala za Aladinom mladá žena .	mladá	7	Nom
O chvíľu ich už viedli k najlepšiemu stolu v záhrade Amirovej slávnej reštaurácie Kebab .	najlepšiemu	6	Dat
Na stenách viseli zaprášené police s prastarými knihami zaklínadiel a čarov .	zaprášené	3	Nom
Shepherdovci bývali v luxusnej štvrti , kde boli samé honosné domy .	luxusnej	3	Loc
Tá myšlienka mu v skutočnosti v mysli skrsla v podobe vidiny , skleného ťažidla , ktoré sa zrkadlilo na povrchu sklápacieho stola .	sklápacieho	20	Gen
Prvky prírodného polyteizmu v Pateriku kyjevsko ‐ pečerského kláštora .	pečerského	7	Gen
V ranoarpádovských zákonníkoch nachádzame aj ustanovenia o Božích súdoch , iracionálnom dôkaznom prostriedku , ktorý sa v stredovekom súdnom konaní hojne aplikoval .	stredovekom	17	Loc
Pri ceste postávali stopári a z fľašiek popíjali osviežujúce nápoje .	osviežujúce	8	Acc
Samo Gorze sa na začiatku 11 . storočia dostalo vďaka zásahu svojho diecézneho biskupa do rúk clunyjského reformátora Viliama z Dijonu .	diecézneho	12	Gen
Napriek mojej nezrozumiteľnej ruštine opäť pochopila .	nezrozumiteľnej	2	Dat
Abdullah bol zaskočený .	zaskočený	2	Nom
Uvedené komplexy sa vyznačujú zmiešaným osídlením Slovanov s inými etnikami a tvrdošijným zachovávaním archaických prežitkov rodového zriadenia , kým mestá sú čisto slovanskými sídlami , určenými na pacifikáciu a christianizáciu kolonizovaných oblastí .	zmiešaným	4	Ins
O chvíľu prišiel k stánku chlapec v otrhaných zaplátaných šatách .	otrhaných	7	Loc
Spratal neuveriteľné množstvo kukuričných placiek a mľaskal pritom a navyše ich zlostil híkavým smiechom .	kukuričných	3	Gen
Koniec sa blížil , ale Wendy bola pokojná a statočná .	statočná	9	Nom
Niečo dopadlo na posteľ za Winstonovým chrbtom .	Winstonovým	5	Ins
Brat kantor pre vážne osobné dôvody nemohol prísť , preto brat farár sprevádzal nábožný spev na gitare spolu s mládežníkmi , ktorí poslúžili programom a vystúpili aj s osobným vyznaním .	osobným	28	Ins
Vláda pripraví legislatívne opatrenia , ktoré zjednodušia sankčný systém v daňovej oblasti .	legislatívne	2	Acc
Vláda je pritom presvedčená o nevyhnutnosti zavádzať do rezortu pôdohospodárstva , pri rešpektovaní niektorých špecifík , trhové podmienky a slobodnú konkurenciu .	slobodnú	19	Acc
Na okraji makového poľa sedel motýľ s malým oranžovým cylindrom na hlave .	oranžovým	8	Ins
Cieľom fiškálnej politiky vlády bude zníženie podielu verejného dlhu na hrubom domácom produkte počas volebného obdobia .	fiškálnej	1	Gen
On a zopár jemu podobných boli poslednými živými spojovacími článkami so zašlým kapitalizmom .	zašlým	11	Ins
Ukázalo sa , že v jednom stánku predávali plechové panvice .	plechové	8	Acc
Maja s Vilkom sedeli na lesnej čistine a vymýšľali si o nich príbehy .	lesnej	5	Loc
Pre skúmané obdobie sú nápisy v najstaršom novgorodskom chráme neobyčajne cenným prameňom .	najstaršom	6	Loc
Ľudská postava vcelku s kniežacou čiapkou , alebo korunou držiacou atribúty moci .	Ľudská	0	Nom
Vládol tu čulý ruch , no Chrisa nevyrušil zo sústredenia .	čulý	2	Nom
Navrhli im , že ak chcú prežiť v nových podmienkach trhového hospodárstva , môžu predávať po tiranských chodníkoch cigarety alebo banány .	tiranských	16	Loc
Odporná extáza strachu a pomstychtivosti , túžba zabíjať , mučiť , drúzgať tváre kováčskym mlátom akoby preskočila sťa elektrický prúd na všetkých a premenila každého aj proti jeho vôli na vrieskajúceho pomätenca s pokrivenou tvárou .	kováčskym	13	Ins
Následky nárazu bývali rovnako kruté .	kruté	4	Nom
Naproti Hádovej vile .	Hádovej	1	Dat
Dnes priniesla zebre a medvedíkovi plnú škatuľu šťavnatých jabĺk .	šťavnatých	7	Gen
Keď zaznela hymna , po lícach vyčerpaných hráčov sa kotúľali slzy .	vyčerpaných	6	Gen
Poďakovanie patrí aj posudzovateľom rukopisu – pánovi prof . PhDr . Richardovi Marsinovi , DrSc . a pánovi PhDr . Jánovi Steinhübelovi , CSc . , ktorí mi pomohli vylepšiť text svojimi cennými postrehmi .	cennými	32	Ins
Nedbal na to , že sa ocitol v nebezpečnej blízkosti kravského chvosta .	nebezpečnej	8	Loc
Mnohých som už predtým veľakrát videla na štartovacích blokoch .	štartovacích	7	Loc
Bola noc a biele tváre a šarlátové transparenty zalievalo zlovestné svetlo .	biele	3	Acc
Kedy sa zmenili Rickove city ku mne a prečo som si to nevšimla ?	Rickove	3	Nom
Svedčí o tom podobnosť pečatí č . 4 a 5 s pečaťami č . 6 až 9 patriacimi Izjaslavovým bratom Svjatopolkovi a Vsevolodovi .	Izjaslavovým	18	Dat
Pegas naletel každej krásnej hrive a nasledoval kobylu do neďalekej stajne .	krásnej	3	Dat
Pracuje na Medzinárodnom letisku J . F . Kennedyho a volá sa Tom .	Medzinárodnom	2	Loc
Takže nacionalisticko - sociálny populizmus Mečiarov je , povedal by som , prirodzeným plodom stáročného vývinu slovenskej spoločnosti .	prirodzeným	12	Ins
Najznámejším príkladom sú interrupcie .	Najznámejším	0	Ins
Nastolíme po voľbách zmenu - odhalením zbohatlíkov , mafiánov , delikventov , korupčníkov a lobistov pri stálom sledovaní blaha občana .	stálom	16	Loc
“ Džungľa preňho nie je vhodným miestom . “	vhodným	5	Ins
Z nešikovného mladíka sa stal šikovný vrtký chlapík , ochotný ukázať , čo vie .	nešikovného	1	Gen
Na tretí raz sa s ohlušujúcim rachotom rozletela dokorán .	ohlušujúcim	5	Ins
Na Makovej lúke panovalo ticho .	Makovej	1	Loc
A hrozilo by , že sa stratí čaro našich ľúbostných stretnutí .	ľúbostných	9	Gen
Na jeho základe sa bude financovať zdravotná starostlivosť nad rámec tzv . solidárneho balíka .	solidárneho	12	Gen
Pripomínala mi nejakú literárnu hrdinku .	literárnu	3	Acc
Zdalo by sa teda , že Somogyvárske opátstvo bude vďaka zväzku so svojím materským opátstvom súčasťou clunyjskej „ kongregácie “ .	clunyjskej	16	Gen
Pevnejšie pritlačila veko košíka a odháňala Syreetinu zvedavú opičku .	zvedavú	7	Acc
Použitie tohto mena pri televíznom uvedení hraného filmu známeho z kín je nezvyčajné .	známeho	8	Gen
Pri rešpektovaní špecifík poľnohospodárskej výroby vláda bude podporovať rozvoj voľného trhu s agropotravinovými výrobkami a slobodnú konkurenciu v poľnohospodárskom podnikaní .	poľnohospodárskom	18	Loc
Ten sa mu bude hodiť do bábkového divadla !	bábkového	6	Gen
Kvalifikovanú odpoveď na tuto otázku však budeme môcť priniesť až po dôkladnej komparácii s dobovými východnými právnymi pamiatkami .	východnými	15	Ins
“ O siedmej prídem po teba . “	siedmej	2	Loc
Za finančnú podporu sa chcem poďakovať Ekumenickej rade cirkví , nášmu drahému zboru a „ staršej “ mládeži ECAV v Prešove , modlitebnému spoločenstvu , kamarátom z tréningu Rovesník a jednotlivcom .	drahému	11	Dat
Milá cirkev !	Milá	0	Nom
Musí osloviť Amplefortha aj za cenu okríknutia z televíznej obrazovky .	televíznej	8	Gen
Pohanské povstania na Rusi v 11 storočí	Pohanské	0	Nom
Svoju neforemnú topánku presunula o pár centimetrov a naschvál dodrúzgala konárik .	neforemnú	1	Acc
Najradšej obhrýzalo Džafarove obľúbené topánky z najjemnejšej kože .	Džafarove	2	Acc
Na to neboli obyvatelia Makovej lúky zvyknutí a znervózňovalo ich to .	zvyknutí	6	Nom
Iba Jazmína nebola veselá .	veselá	3	Nom
Kapitoly vytvoria protiváhu hlboko miestne ukotveného archeologicko ‐ historického prehľadu a predkladajú nový zorný uhol na skúmanú tému .	zorný	13	Acc
Bojoval proti vykorisťovaniu v indickej spoločnosti , proti krviprelievaniu medzi hinduistami a moslimami , proti vojne , za politickú nezávislosť svojej krajiny .	politickú	18	Acc
Vláda pripraví komplexnú analýzu zadlženosti verejného sektora .	komplexnú	2	Acc
Základným východiskom pre elimináciu environmentálnych rizík je kontrola chemickej , biologickej a jadrovej bezpečnosti .	biologickej	10	Gen
Aj ja som rada , prehodila Lori , aj ja som bola otrávená až na smrť .	rada	3	Nom
Návšteva v panskom dome	panskom	2	Loc
Všetci s údivom pozerali na obrovské šalátové hlavy .	šalátové	6	Acc
O nich , ako aj o charakteristike ranoarpádovských zákonníkov a synodálnych uznesení hovoríme konkrétnejšie v samostatných kapitolách .	samostatných	15	Loc
V prijímacej sieni to vyzeralo , akoby sa tadiaľ prehnala búrka .	prijímacej	1	Loc
Navyše , koniec 9 . a veľká časť 10 . storočia predstavujú aj vrchol úpadku stredovekého pápežstva .	stredovekého	15	Gen
V Tayerleho teste nemala romantika miesto .	Tayerleho	1	Loc
Poletíš ponad strieborné jazerá a zurčiace potoky , pod jasným nebom a vysokými zelenými stromami .	jasným	9	Ins
Základnými požiadavkami na všetky druhy podložiek na spanie sú tepelná izolácia a izolácia od vlhkosti .	Základnými	0	Ins
Cez kombinézu cítil jej prsníky , zrelé , ale pevné .	pevné	9	Acc
Detský biblický tábor pripravujeme v prekrásnom prostredí Žiarskej doliny v dňoch 31 . 7 . až 7 . 8 . 2004	prekrásnom	5	Loc
Samo Gorze sa na začiatku 11 . storočia dostalo vďaka zásahu svojho diecézneho biskupa do rúk clunyjského reformátora Viliama z Dijonu .	clunyjského	16	Gen
Obsiahly vlastivedný úvod ( Praefatio ) k Doležalovej gramatike napísal o generáciu starší Matej Bel .	Doležalovej	7	Dat
A komentovali ste tvoje veľdiela o sexuálnych nenásytníkoch .	sexuálnych	6	Loc
Ferdo a zelené kravy	zelené	2	Nom
Zrejme čítali nejakú veľmi dôležitú správu .	dôležitú	4	Acc
Z nešikovného mladíka sa stal šikovný vrtký chlapík , ochotný ukázať , čo vie .	ochotný	9	Nom
Vláda vytvorí legislatívne a ekonomické podmienky pre ochranu a sprístupnenie audiovizuálneho dedičstva v súlade s príslušnými medzinárodnými dohovormi .	audiovizuálneho	10	Gen
Po kráľovskej hostine , na ktorú mravce priniesli obrie porcie špagiet s voškovou omáčkou , si všetci políhali na slniečko , aby si oddýchli .	voškovou	12	Ins
Zavrela znútra dvere na školskej budove , zastrčila závoru , vzala ma za ruku a viedla za sebou .	školskej	4	Loc
Nosí otrhaný šat a smútok v duši , vari aj napriek tomu jej to sluší ?	otrhaný	1	Acc
Vláda vypracuje a realizuje projekt transformácie štátnych podnikov lesného hospodárstva v pôsobnosti Ministerstva pôdohospodárstva SR na štátnu akciovú spoločnosť založenú podľa osobitného zákona .	založenú	19	Acc
Vláda SR predloží nový zákon o rozpočtových pravidlách a pravidlách rozpočtového hospodárenia územnej samosprávy .	územnej	12	Gen
Dňa 15 . 2 . 2004 sa v našom cirkevnom zbore konal výročný zborový konvent .	zborový	13	Nom
Môj potôčik vyrazil von , rozlial sa a ja som zostal zahalený v horúcej pare sauny .	horúcej	13	Loc
Vláda pripraví legislatívny rámec pre zabezpečenie efektívnej činnosti zahraničnej služby , čo predpokladá aj zohľadnenie jej špecifík .	efektívnej	6	Gen
O prípadnom sobáši nedebatovali .	prípadnom	1	Loc
Myslím však , že vysoká škola má dve významné úlohy , ktoré so spomínanou rovnicou priamo nesúvisia .	spomínanou	13	Ins
Samozrejme , že Maja s Vilkom zablúdili v jesennej hmle ako prví .	prví	11	Nom
Pred okienkom do pivnice ležal lesklý tvor s červenými očami a nahlas funel .	červenými	8	Ins
Takáto logická úvaha bola nakoniec zbytočná .	zbytočná	5	Nom
Maja s Vilkom si však našli lepšiu zábavu .	lepšiu	6	Acc
" Nechoď na voľné priestranstvo !	voľné	3	Acc
Vyskočil na rovné nohy a Gaston užasnuto hľadel na mohutnú postavu , ktorá sa nad ním vztýčila .	mohutnú	9	Acc
Stiahli si zo seba šaty a vliezli do mohutnej mahagónovej postele .	mohutnej	8	Gen
V každom prípade aj text jeho úvodu dal Doležalovej gramatike punc najautoritatívnejšieho zdroja poznania vtedajšieho spisovného jazyka Čechov i Slovákov .	najautoritatívnejšieho	11	Gen
Výsady sice majú formu udeľovanej listiny , no v skutočnosti ide o zmluvný zápis , tvoriaci kostru tzv . najstaršej Pravdy .	tvoriaci	15	Acc
Podstatou clunyjskej reformy bolo spočiatku ( za Bernona ) obnovenie bezvýhradného dodržiavania princípov Regule sv . Benedikta .	clunyjskej	1	Gen
Televízor bol zapnutý , stále nastavený na pornografický kanál .	nastavený	5	Nom
Zišli sa tu všetci tunajší obyvatelia .	tunajší	4	Nom
V bruchu cítil tupú bolesť .	tupú	3	Acc
Na letisko nás prišiel čakať Sergejov priateľ .	Sergejov	5	Nom
Zbierka uvádza pravé i nepravé dekretály viacerých pápežov , ako aj početné dokumenty pojednávajúce o výnimočných právach rímskeho biskupa .	pravé	2	Acc
Vtedy sa prítomným naskytol pohľad na Gimov obrovský penis .	Gimov	6	Acc
Maja zletela dole a po prvý raz vo svojom živote uvidela svätojánsku mušku .	svätojánsku	11	Acc
Vláda prehodnotí doterajší spôsob podpory malého a stredného podnikania s akcentom na územnú samosprávu a prihraničnú spoluprácu .	stredného	7	Gen
Vedel , že ho má vo svojej hadej moci , ktorou môže zhypnotizovať aj to najživšie zviera .	hadej	7	Loc
Lorine prsia ma zľahka tlačili na hrudníku , a o poschodie vyššie ležala v studenej izbe mŕtva Marga .	studenej	14	Loc
Stál pred verejným súdom , priznával všetko , každého obviňoval .	verejným	2	Ins
V procese obstarávania bude vláda dbať na transparentný systém nakladania s majetkom štátu .	transparentný	7	Acc
Kvôli nutnosti ich lepšieho uchopenia je potrebné vopred určiť , z akého hľadiska budeme pramene skúmať .	lepšieho	3	Gen
Vláda vypracuje a realizuje projekt transformácie štátnych podnikov lesného hospodárstva v pôsobnosti Ministerstva pôdohospodárstva SR na štátnu akciovú spoločnosť založenú podľa osobitného zákona .	štátnych	6	Gen
Anjelovi cirkevného zboru v Prešove napíš :	cirkevného	1	Gen
Ide o unikátny nález brezovej listiny v karelčine , s využitím ruskej abecedy .	brezovej	4	Gen
Keď pozrela pod seba , zistila , že uviazla v pavúčej sieti .	pavúčej	10	Loc
Tí prašiví tuláci nedajú pokoj ! “	prašiví	1	Nom
Zrejme mala akúsi praktickú ostrieľanosť , ktorá Winstonovi chýbala a podľa všetkého vďaka nespočítateľným spoločenským výletom výborne poznala okolie Londýna .	spoločenským	14	Dat
Neskoro večer , keď bandy surových proletov vyvádzali na uliciach , vládla v meste zvláštna horúčkovitá atmosféra .	surových	5	Gen
V podobnom duchu sa vyjadrovali aj prezident KOZ Ivan Saktor a jeho kolega Svetozár Korbel .	podobnom	1	Loc
Správne sa nazdávala , že , práve prišiel do chalúpky učupenej v horskom údolí .	učupenej	10	Gen
Na festivale sa predstavia rómske aj nerómske hudobné zoskupenia z celého Slovenska .	rómske	4	Nom
Takéto zistenie zaujímavo dopĺňa a modifikuje pohľad na najvyspelejšie mesto stredovekej Rusi , mesto majúce bohaté styky s civilizačným okruhom západnej Európy .	civilizačným	18	Ins
Kapitoly vytvoria protiváhu hlboko miestne ukotveného archeologicko ‐ historického prehľadu a predkladajú nový zorný uhol na skúmanú tému .	historického	8	Gen
V úvode pasáže volchvi symbolizujú bielych šamanov , vysporiadávajúcich sa s čiernymi šamanmi .	čiernymi	11	Ins
Jeho monotónny hlas mi pripadal znesiteľný až dovčera , keď Chris povedal , že mu chýba iskra .	znesiteľný	5	Nom
Po celý čas som sa díval smerom k osvetlenému pásmu , kde sa zástup žien tlačil pred skleným priečelím obchodu .	osvetlenému	8	Dat
Bol som Faikiným rukojemníkom .	Faikiným	2	Ins
Nejaký neznámy súper v ľúbostných dobrodružstvách .	ľúbostných	4	Loc
Neodpustiteľným hriechom však bola promiskuita medzi straníkmi .	Neodpustiteľným	0	Ins
Som spokojný so značkou " spoľahlivý , rovnocenný , monogamný vzťah " .	spokojný	1	Nom
Napríklad súkromná televízia Sírius , ktorá najčastejšie vysielala filmy nakrútené podľa mojich scenárov .	súkromná	1	Nom
“ Naozaj ? “ zvolala prekvapená Snehulienka .	prekvapená	5	Nom
Náš dnešný spisovný jazyk je skutočným kompromisom medzi radikálnou normou štúrovcov a požiadavkami bernolákovcov i tradíciou českou či československou .	českou	16	Ins
Keď leteli okolo sladko rozvoniavajúceho jazmínového kra , neodolali a sadli si naň .	rozvoniavajúceho	4	Gen
Winston sa začal obliekať pomalými , strnulými pohybmi .	pomalými	4	Ins
Vláda bude klásť dôraz na racionalizáciu nákladov spojených s realizáciou výkonov vo verejnom záujme v železničnej osobnej doprave a verejnej autobusovej doprave .	osobnej	16	Loc
Roztvoril dvere a odporný kyslastý zápach zvetraného piva mu vrazil do nosa .	kyslastý	4	Nom
Nemala som najmenšiu chuť rozoberať pred ním svoje zmätené pocity a zbabraný test .	zbabraný	11	Acc
Základným východiskom pre elimináciu environmentálnych rizík je kontrola chemickej , biologickej a jadrovej bezpečnosti .	environmentálnych	4	Gen
Na líci sa nachádza ruža so štyrmi lupienkami , obkolesená zložitou dekoratívnou obrubou .	dekoratívnou	11	Ins
O nich , ako aj o charakteristike ranoarpádovských zákonníkov a synodálnych uznesení hovoríme konkrétnejšie v samostatných kapitolách .	ranoarpádovských	7	Gen
Taká krutá irónia osudu .	krutá	1	Nom
V estónskej rozprávke Hromovládcové gajdy je zasa zachovaný obraz starobylého dualizmu v postavách vládcu hromov Pikneho a vrchného čerta Vanatuhiho .	estónskej	1	Loc
Lykožrút Fridolín potom odniesol víťaza medzi jasajúcich divákov .	jasajúcich	6	Gen
Hlúpa tvár pod svetlými vlasmi ho vítala s rozžiareným úsmevom .	svetlými	3	Ins
Cez kombinézu cítil jej prsníky , zrelé , ale pevné .	zrelé	6	Acc
Mohutná posteľ pri okne bola zastlaná dotrhanými prikrývkami a na poduške chýbala obliečka .	Mohutná	0	Nom
Na kozubovej rímse tikali starodávne hodiny s dvanásťhodinovým ciferníkom .	kozubovej	1	Loc
Je veľmi pravdepodobné , že uhorskí zákonodarcovia formulovali príslušné právne normy o celibáte pod vplyvom výziev reformátorov .	príslušné	8	Acc
Ihneď ho zaliala teplá vlna úľavy .	teplá	3	Nom
Minule sa môj kolega Rado Ondřejíček fejtónovým perom pustil do problému hlupákov medzi nami .	fejtónovým	6	Ins
Nedbal na to , že sa ocitol v nebezpečnej blízkosti kravského chvosta .	kravského	10	Gen
Tento zdanlivo hypoteticko ‐ špekulatívny prístup „ náhodného výberu “ sa bude opierať o už spomínané empirické zázemie sumy archeologických a etnografických faktov .	empirické	16	Acc
Teraz ma už niekoľko dní sprevádzal letmý dotyk Faikiných pŕs , dotyk jej rúk .	Faikiných	8	Gen
Špecifické skupiny nálezov , vyskytujúcich sa vo väčšom množstve , budú rozoberané v osobitnch kapitolách .	väčšom	7	Loc
Správne sa nazdávala , že , práve prišiel do chalúpky učupenej v horskom údolí .	horskom	12	Loc
Tento komplex otázok – teda vzťah uhorskej cirkvi ku tzv . gregoriánskej reforme tvorí širší rámec našej práce .	gregoriánskej	11	Dat
Okolo pohrebnej jamy boli nájdené stopy stĺpov .	pohrebnej	1	Gen
Dňa 15 . 2 . 2004 sa v našom cirkevnom zbore konal výročný zborový konvent .	cirkevnom	9	Loc
Právne normy prijaté počas Kolomanovho panovania predstavujú vrchol ranoarpádovského cirkevnoprávneho zákonodarstva .	ranoarpádovského	8	Gen
Prikázal dopravnej čate , aby ju premiestnila , ale keďže bola veľmi ťažká , robotníci ju občas postavili na zem .	dopravnej	1	Dat
Bola nefalšovane na smrť vystrašená , čo sa dalo pochopiť .	vystrašená	4	Nom
Tieto kritické postrehy Soni vyslovila pri našom poslednom prázdninovom stretnutí pred začiatkom tretieho ročníka .	prázdninovom	8	Loc
Skúste siahnuť po nejakej knižnej novinke , zoznam nájdete v Knižnom katalógu .	knižnej	4	Loc
Vláda bude využívať štátne záruky iba v nevyhnutných prípadoch na prefinancovanie splatných úverov so štátnymi zárukami , ak to umožní zákon o štátnej pomoci a ak hrozí realizácia záruk z prostriedkov verejných financií .	nevyhnutných	7	Loc
“ Bude tam titulok : Slávna rekordérka fotografuje reportérov , “ povedala Blythe .	Slávna	5	Nom
Práve poletovala medzi bielymi jazmínovými kvetmi a nevšimla si jemnulinké a tenulinké vlákna napnuté medzi konárikmi .	bielymi	3	Ins
Napokon usúdil , že najbezpečnejším miestom je kantína .	najbezpečnejším	4	Ins
Stále padal hustý sneh s veľkými vločkami .	veľkými	5	Ins
V druhej ruke držala zelené jabĺčko .	zelené	4	Acc
V reformnom hnutí v 10 . a 11 . storočí musíme zreteľne odlíšiť dve základné línie – staršiu reformu monastickú a mladšiu reformu rímsku , resp . pápežskú .	mladšiu	21	Acc
Vietor hvízdal v konároch a trápil sporadické , ufúľané krókusy .	ufúľané	8	Acc
Stiahol kombinézu nabok a prezeral si jej hladký , biely bok .	hladký	7	Acc
Hra na hudobné nástroje , vozy ako prostriedok na prekonávanie vzdialeností by mohli svedčiť i o narážke na potulných hudcov ‐ igricov , ktorí sú chápaní v celoeurópskom kontexte ako elementy , rušiace zabehaný poriadok .	celoeurópskom	27	Loc
Chlapci sa smiali , keď mocný pirát napol svaly na ruke , až sa mu na ramene zachvel vytetovaný pirátsky znak ‐ lebka so skríženými hnátmi .	skríženými	24	Ins
Jedlo je na stole za necelú polhodinu .	necelú	5	Acc
V tieni stromu s veľkými listami bol príjemný chládok .	veľkými	4	Ins
Fridolín bol malý hnedý chlapík so silným náprsným štítom a krátkymi krovkami .	náprsným	7	Ins
V dvanástom storočí spolu s Vladimírom Zaleským zatienila Rostov a usilovala sa o kolonizáciu severovýchodných území .	dvanástom	1	Loc
Náhradné batérie a aspoň jedna rezervná žiarovka by mali byť samozrejmosťou .	Náhradné	0	Nom
Symbolickú úlohu má i výzdoba koníka — krúžky s bodkou uprostred sú ďalšou z mnohých modifikácií solárnych znakov .	solárnych	16	Gen
V estónskej rozprávke Hromovládcové gajdy je zasa zachovaný obraz starobylého dualizmu v postavách vládcu hromov Pikneho a vrchného čerta Vanatuhiho .	Hromovládcové	3	Nom
Raňajky sa podávajú na prízemí , do deviatej .	deviatej	7	Gen
Pripadalo by mi znesiteľnejšie , keby kvôli nemu nespal ani Chris .	znesiteľnejšie	3	Nom
Dnes tu však mali návštevu , sedeli na terase a jedli lahodne rozvoniavajúci ovocný koláč .	rozvoniavajúci	12	Acc
V roku 1977 kvôli zdravotným ťažkostiam odchádza do dôchodku po náročnej a požehnanej práci na vinici Pánovej .	náročnej	10	Loc
Alebo si v pamäti vybavím knihu o arabskej kultúre ?	arabskej	7	Loc
Foto je len ilustračné .	ilustračné	3	Nom
Pritom je známe , že remeslo kováčske bolo spájané s magickými šamanskými praktikami u mnohých národov — kováč a šaman sú z jedného rodu hovorí jakutské príslovie .	magickými	10	Ins
Splývali pred mojím duševným zrakom v podobe Lori , ktorá bola ich poslednou metamorfózou .	duševným	3	Ins
Odpoveď je zdanlivo jednoduchá .	jednoduchá	3	Nom
Kým sme sa dostali k ruskému kolesu , boli sme unavení , presladení a vysmiati .	unavení	10	Nom
Robili tak skôr mocní šľachtici , usilujúci sa o odtrhnutie časti krajiny / najpríhodnejším príkladom je tu uhorské povstanie Vathu roku 1046 v Bekeszi / .	mocní	3	Nom
Smutným hlasom im Kasandra oznámila , že v noci navšítvili komoru s medom zlodeji a spôsobili im veľkú škodu .	Smutným	0	Ins
Toto ministerstvo však nemuselo uspokojovať mnohoraké potreby straníkov , ale opakovať celú operáciu na nižšej úrovni pre blaho proletariátu .	mnohoraké	5	Acc
Predavači tu núkali všeličo od výmyslu sveta — mosadzný riad , sladké datle i čerstvé ryby .	mosadzný	8	Acc
Chris sa zasmial a pomrvil sa na tvrdých hranatých škridlách .	tvrdých	7	Loc
“ Musíš mať fotografickú pamäť . “	fotografickú	3	Acc
Zaujímavú skupinu tvoria vyobrazenia s rastlinnými motívmi .	rastlinnými	5	Ins
Ihneď ho ohúrila jej zmena k horšiemu .	horšiemu	6	Dat
Bol v cele bez okien , s vysokým stropom a so stenami z lesklého bieleho porcelánu .	vysokým	7	Ins
Mimoriadne príjemným spestrením je izolácia od terénnych nerovností .	príjemným	1	Ins
Jasajúci diváci ho odniesli na pleciach domov .	Jasajúci	0	Nom
So žiarivým trojzubcom v mohutnej ruke sa nad nimi týčila ako predzvesť smrteľných bleskov .	smrteľných	12	Gen
Zasiahnutý netvor sa zmietal od bolesti a zletel zo skaly .	Zasiahnutý	0	Nom
Vláda bude preto v tomto volebnom období osobitne dbať na schopnosť komunikácie , výcvik , vyzbrojenie , zabezpečenie strategickej prepravy a udržateľnosť špeciálnych jednotiek rýchlej reakcie .	špeciálnych	22	Gen
Vláda v spolupráci s predstaviteľmi územnej samosprávy vytvorí transparentný inštitucionálny a finančný návrh na kofinancovanie regionálneho rozvoja z prostriedkov štátneho rozpočtu a z fondov EÚ .	transparentný	8	Acc
Platba je elegantne vyriešená internetbankingom najznámejších slovenských bánk .	najznámejších	5	Gen
Ako sedemnásťročný sa stal okresným zakladateľom Antisexuálnej ligy mládeže , ako devätnásťročný navrhol nový druh ručného granátu , ktorý zaradilo do výzbroje Ministerstvo mieru a ktorý už pri prvej skúške jediným výbuchom zabil tridsaťjeden euroázijských zajatcov .	devätnásťročný	11	Nom
Rutherford mal mohutnú postavu , hrivu mastných , sivých vlasov , zjazvenú tvár s vačkami pod očami a hrubé negroidné pery .	zjazvenú	11	Acc
To vie len múdra rosnička .	múdra	3	Nom
Vláda si uvedomuje výzvy informačného veku .	informačného	4	Gen
Mala prísť o pol ôsmej .	ôsmej	4	Loc
Položil mi poslednú otázku .	poslednú	2	Acc
Vláda v spolupráci s predstaviteľmi územnej samosprávy vytvorí transparentný inštitucionálny a finančný návrh na kofinancovanie regionálneho rozvoja z prostriedkov štátneho rozpočtu a z fondov EÚ .	inštitucionálny	9	Acc
V tej chvíli mi bolo všetko jasné , vedela som , v čom je problém .	jasné	6	Nom
Hlavnými aktérmi tohto procesu boli cisár Oto III . a pápež Silvester II .	Hlavnými	0	Ins
Vláda bude podporovať vývoj a šírenie výrobkov i služieb šetriacich životné prostredie a v rámci legitímnych trhových nástrojov hľadať možnosti podpory malým a stredným podnikateľom zvyšovať investície do „ čistej “ výroby a environmentálnych podnikateľských aktivít .	stredným	23	Dat
Sergej mi takisto povedal , že zatiaľ sa môžem ísť poprechádzať po Nevskom prospekte .	Nevskom	12	Loc
Keď Ferdovi muži zajali celé nepriateľské vojsko , aj hlavný veliteľ otrokárov vyšiel z podzemnej chodby .	Ferdovi	1	Nom
Dnes by som povedala , že som bola zhypnotizovaná .	zhypnotizovaná	8	Nom
Za finančnú podporu sa chcem poďakovať Ekumenickej rade cirkví , nášmu drahému zboru a „ staršej “ mládeži ECAV v Prešove , modlitebnému spoločenstvu , kamarátom z tréningu Rovesník a jednotlivcom .	Ekumenickej	6	Dat
Bolesť zaplavila Winstonovo telo .	Winstonovo	2	Acc
Keď bol bohatý , pripadali mu tie jagavé vežičky akosi bližšie .	bohatý	2	Nom
Každý pokus o systematizáciu tejto otázky totiž nevyhnutne naráža na kolíziu metódy vedeckého prístupu s rozumovo nedefinovateľným fenoménom náboženstva a viery .	vedeckého	12	Gen
Viem o vašej veľkej finančnej štedrosti .	finančnej	4	Loc
Veľavravným svedectvom sú nálezy belozerskej lepenej keramiky .	lepenej	5	Gen
Ďakujeme Ti za všetko dobré i ťažké , radostné i smutné , povzbudzujúce i skľučujúce , čo s Tvojou pomocou zvládli a prijali vo svojom živote .	smutné	10	Acc
“ Počkaj , až ochutnáš Safiyinu špecialitu , “ nadšene vravel , keď sluhovia kládli na stôl ťažký strieborný podnos s polguľovitým vrchnákom .	polguľovitým	21	Ins
Rýchlo vyčarila drevený kolovrátok so zradným zeleným vretenom .	drevený	2	Acc
Tam oslávili Majino vyslobodenie .	Majino	2	Acc
Zadnými nohami držal pavúka v šachu a prednými trhal sieť okolo napoly zadusenej Maji .	prednými	7	Ins
Keďže sa prvýkrát vyskytuje počas Jaroslavovho námestníctva v Novgorode , nie je vylúčená možnosť nápodoby všemocného novgorodského vodného jaštera .	Jaroslavovho	5	Gen
Jediný kanál s jasným obrazom vysielal pornografické scény .	pornografické	6	Acc
Nehybnú princeznú nechala ležať na studenej kamennej dlážke .	studenej	5	Loc
Dvojtvárnosť trickstera súvisí s celkovým dualizmom , prítomným v systéme prírodného polyteizmu .	prítomným	7	Ins
V polovici minulého storočia ich slávny albánsky agrárny proletariát pripravil o všetko bohatstvo .	minulého	2	Gen
Vláda predloží zákon o zdravotníckych povolaniach a zariadeniach definujúci úlohy poskytovateľov a zdravotníckych pracovníkov .	definujúci	8	Acc
Kráľovná sa premenila na starú škaredú bosorku .	škaredú	5	Acc
Nedávno som odovzdal do skalického Záhorského múzea otcove denníky .	Záhorského	5	Gen
Nechal som televízor zapnutý a privliekol som sa k dverám bytu .	zapnutý	3	Acc
Osvetovú kampaň Nádej pre život podporili Svetová zdravotnícka organizácia , minister zdravotníctva , Slovenská geriatrická a gerontologická spoločnosť , Slovenská lekárska spoločnosť , Slovenská internistická spoločnosť a Slovenská kardiologická spoločnosť .	geriatrická	14	Nom
“ To je idiotský nápad ! “ zvolal , ale videla som , že sa mu to páči .	idiotský	3	Nom
Jedného dňa povysávala všetky kancelárie s vypnutým vysávačom .	vypnutým	6	Ins
Ako len tvrdohlavo a zaťato hľadal úkryt pred tou láskavou náručou !	láskavou	9	Ins
Bavilo ma písať kompozície a na vynikajúcom skalickom gymnáziu boli veľmi dobré podmienky pre kultúru .	skalickom	7	Loc
Príliš náročnú po sexuálnej stránke .	sexuálnej	3	Loc
Na kozubovej rímse tikali starodávne hodiny s dvanásťhodinovým ciferníkom .	dvanásťhodinovým	7	Ins
Tigríča jej nešikovne skočilo do náručia a princezná zacítila mäkulinkú teplú guľku s hodvábnou srsťou .	mäkulinkú	9	Acc
Ustanovenia o predpokladoch na získanie svätenia sú bežnou súčasťou stredovekých zbierok cirkevného práva .	bežnou	7	Ins
" Ozajstný cukor .	Ozajstný	1	Nom
Ráno sa Alfonz za bratovo správanie všetkým ospravedlňoval .	bratovo	4	Acc
Dvere zamkla znútra na kľúč a cez temnú chodbu – svetlo nebolo zažaté – ma zaviedla do izby , kde sme zastali oproti sebe .	temnú	7	Acc
Omar ležal chvíľu roztiahnutý na zemi .	roztiahnutý	3	Nom
Ekonomická i politická moc sa dostáva z rúk starej aristokracie do rúk novej buržoázie a literatúra sa usiluje vyhovieť potrebám novej vládnúcej vrstvy .	politická	2	Nom
Na Jazmínino prekvapenie predavač vytiahol obrovský ostrý dlhý nôž .	Jazmínino	1	Acc
Amulet teda posilňuje určité črty jeho charakteru do neobvyklých až nadprirodzených polôh , Vseslav sa stáva vyvolencom — podľa kresťanského kronikára — temných síl .	neobvyklých	8	Gen
Navyše sú nepoužiteľné vzhľadom na tlačiarenskú farbu , ktorá môže nepríjemne poškodiť istú chúlostivú časť tela .	nepoužiteľné	2	Nom
Jeho vyduté biele bruško pripomínalo huňatý kopček .	huňatý	5	Acc
Pod jeho lakťom bol dievčí pás mäkký a teplý .	mäkký	6	Nom
Pred priateľovou ordináciou čakalo zo dvadsať ľudí , lavice pri stene boli obsadené .	priateľovou	1	Ins
Budúci pápež však podmienil svoj nástup do úradu – a to bolo v súdobých podmienkach niečím úplne novým – vykonaním regulárnej voľby klérom a ľudom Ríma .	súdobých	13	Loc
Ide tu o tzv „ stavebnú obetu “ .	stavebnú	5	Acc
Blahoželám , slečna , povedal som s predstieraným nadšením , využijúc všetky svoje herecké schopnosti .	herecké	13	Acc
Zasa som bola malé dievčatko v bezpečí maminho náručia .	maminho	7	Gen
Napriek tomu je však i domnienka o zobrazení samotnej kňažnej na pečati mýlna .	samotnej	8	Gen
Nárast služobných činností sa zabezpečí najmä prehodnotením existujúcich funkčných miest zo zabezpečovacích služieb .	zabezpečovacích	11	Gen
List Polikarpa igumenovi Pečorského kláštora Akindinovi .	Pečorského	3	Gen
Zároveň dochádza k postupnému vyprázdňovaniu symboliky pohanských obyčajov .	postupnému	3	Dat
Vláda upraví rámcové podmienky regionálneho rozvoja decentralizáciou verejných financií a zavedie nový , efektívnejší systém finančného vyrovnávania sociálno - ekonomických rozdielov vyšších územných celkov .	efektívnejší	13	Acc
Po obidvoch stranách chodby boli dvere vedúce do izieb so štvorcifernými číslami .	štvorcifernými	10	Ins
Ale ten namyslený chvastúň nemá nijaké sérum proti hadiemu jedu .	hadiemu	8	Dat
Uvedené komplexy sa vyznačujú zmiešaným osídlením Slovanov s inými etnikami a tvrdošijným zachovávaním archaických prežitkov rodového zriadenia , kým mestá sú čisto slovanskými sídlami , určenými na pacifikáciu a christianizáciu kolonizovaných oblastí .	určenými	25	Ins
Mohutná posteľ pri okne bola zastlaná dotrhanými prikrývkami a na poduške chýbala obliečka .	dotrhanými	6	Ins
Návrh systému finančného vyrovnávania bude zohľadňovať princíp solidarity a motivácie .	finančného	2	Gen
Nie je to ľahké .	ľahké	3	Nom
Možno tu rozlíšiť viacero sfragistických typov A .	sfragistických	4	Gen
V tomto prestrojení si ma počkala pri Truhlíkovej posteli .	Truhlíkovej	7	Loc
“ Na tú som alergický , “ zastonal Wayne .	alergický	4	Nom
Nahol sa ku mne a odhrnul mi z tváre mokré vlasy .	mokré	9	Acc
Rovnakú spoluprácu so svetským sudcom predpokladajú v citovaných ustanoveniach aj sledované súdobé cirkevnoprávne príručky .	citovaných	7	Loc
Tak je po Jaroslavovom víťazstve položený základ novgorodských výsad , ktorí Novgorodcom garantujú ochranu pred kniežacími družiníkmi a Varjagmi / no zároveň zabezpečujú kniežaciu družinu pred ľudom / .	Jaroslavovom	3	Loc
Na Námestí víťazstva bol Winston ešte pred stanoveným časom .	stanoveným	7	Ins
V uplynulých rokoch ukázalo silný vzťah k demokratickým hodnotám a silu riešiť mnohé problémy .	demokratickým	7	Dat
Bežali kľukatými cestičkami , až prišli k prijímacej sieni .	kľukatými	1	Ins
Spomenul som si na dve veci : na hysterickú eufóriu učiteľov po incidente , pri ktorom sa spomenulo meno mytologického božstva záhrobného sveta .	mytologického	19	Gen
Teória etnicko ‐ ideová .	ideová	3	Nom
Vyšiel som von a chvíľu som nerozhodne postával : mám celkom odísť , alebo mám poslúchnuť chlapcovu radu a ísť do toho podniku ?	chlapcovu	16	Acc
Profesor rozprával historku o anglickej vojenskej misii , ktorú cez vojnu zhodili na padákoch .	anglickej	4	Loc
V tom sne najsilnejší bol pocit sebaklamu , lebo v skutočnosti vedel , čo je za tým temným múrom .	temným	17	Ins
V obvodnom kine , vzdialenom od centra , obyčajne premietali staré filmy .	vzdialenom	4	Loc
Nadpisy , nájdené v rokoch 1898 ‐ 99 boli odtlačené do „ matríc “ z plastelíny a architektonickej hliny .	architektonickej	17	Gen
Za týchto okolností bola akási tenká strieborná retiazka na jej krku celkom bezvýznamná .	bezvýznamná	12	Nom
Prioritami vlády v sociálnej oblasti je zníženie nezamestnanosti a zvýšenie efektívnosti sociálneho systému .	sociálnej	3	Loc
Malá Maja sa začervenala .	Malá	0	Nom
Vláda považuje za jednu zo svojich priorít dôslednú reformu súdnictva , posilňovanie vymožiteľnosť práva a zásadnú zmenu v trestnej politike štátu .	dôslednú	7	Acc
Vláda bude preto v tomto volebnom období osobitne dbať na schopnosť komunikácie , výcvik , vyzbrojenie , zabezpečenie strategickej prepravy a udržateľnosť špeciálnych jednotiek rýchlej reakcie .	rýchlej	24	Gen
Vzhľadom na dôležitosť kvality verejných zamestnancov a význam osobných nákladov vláda bude pokračovať v reforme verejnej a štátnej služby .	verejnej	15	Gen
Irma bola neskúsená , Lori už mala všeličo za sebou .	neskúsená	2	Nom
“ Si výnimočné dievča , Jazmína . “	výnimočné	2	Nom
Zaujímavým javom je veľké množstvo hrebeňov .	Zaujímavým	0	Ins
Takže ak sa myšlienky zorganizovať rockový festival chytí skúsenejší organizátor , veríme , že festival , ktorému je dedina a ľudia v nej naklonení , sa bude znova konať .	skúsenejší	8	Nom
Na preklenutie rozdielov vo vzdelanostnej úrovni a štruktúre sa vláda zaväzuje v prvom roku volebného obdobia k vytvoreniu univerzity pre vysokoškolskú prípravu občanov maďarskej národnosti .	vzdelanostnej	4	Loc
Celý svet vyvalí oči , keď Belu a Gastona zbadá taký pár málokde zočí , krásavci jedna balada .	Celý	0	Nom
Osobitnú pozornosť bude vláda venovať vytváraniu podmienok pre činnosť Hasičského a záchranného zboru ako základnej zložky integrovaného záchranného systému .	Hasičského	9	Gen
Veru , Ferdo sa ocitol v peknej kaši .	peknej	6	Loc
Pozdvihol zrak nahor k tej obrovskej tvári .	obrovskej	5	Dat
Koruna Sv . Štefana a ostrihomský Primas Hungariae sa stali symbolom Uhorského štátu .	Uhorského	11	Gen
Zelený tvor sa na Maju bezočivo díval veľkými , ale dobrosrdečnými očami .	veľkými	7	Ins
Bola to veľmi pekná žena , pracovala v materskej škole .	pekná	3	Nom
Mamina silueta stála vo dverách a obaja sme vycítili , že sa hnevá .	Mamina	0	Nom
Z televíznej obrazovky zaznel zúrivý , ohlušujúci rev .	ohlušujúci	6	Nom
Vedela som , že obaja túžime , aby táto čarovná noc trvala večne .	čarovná	9	Nom
Podobný význam mal aj spev kohúta v čase začiatku Ježišovho utrpenia .	Podobný	0	Acc
Jej priebeh je možné zrekonštruovať zhruba takto — Pred obradom samotným bolo postavené obetisko s pôdorysom štvoruholníka so štyrmi stĺpmi v rohoch .	samotným	10	Ins
Zakrátko bola unavená noha ‐ kontrabas v najlepšom poriadku .	najlepšom	7	Loc
Veď nás Duchom Svätým a pomáhaj nám prekonávať všetko , čo v EÚ a našom svete bude slúžiť smrti a zániku .	Svätým	3	Ins
Škola sa musí stať v regióne kultúrnym , športovým a spoločenským centrom obecnej komunity .	kultúrnym	6	Ins
Novgorodské brezové listiny sú dnes uznávané ako neoceniteľný prameň pre poznanie života v tomto stredovekom meste .	stredovekom	14	Loc
Od straníkov sa vyžadoval podobný názor , aký mali starovekí Židia , ktorí síce vedeli , že všetky iné národy uctievajú nepravých bohov , ale to bolo všetko , čo o nich vedeli .	nepravých	21	Acc
v prioritných oblastiach verejného záujmu musí byť verejný sektor schopný konkurovať súkromnému sektoru pri získavaní a udržaní kvalitných ľudských zdrojov	prioritných	1	Loc
Na dne oceána sa otriasali vraky lodí a potopené poklady .	potopené	8	Nom
JACKIE CHAN AN DIVOKOM ZÁPADE	DIVOKOM	3	Loc
Novgorodské brezové listiny .	Novgorodské	0	Nom
KDH v januári 2000 zablokovalo vstup SMK do Európskej demokratickej únie .	demokratickej	9	Gen
Odhrnula som mokré plavky , prázdne kokakolové plechovice , ceruzky , listy vytrhnuté z notesa a knižku Kto chytá v žite so somárskymi ušami .	mokré	2	Acc
Foto je len ilustračné .	ilustračné	3	Nom
Základom väčšiny dnes známych letopisov je tzv . Rozprávanie o dávnych časoch .	dávnych	10	Loc
Najdôležitejšie informácie v marketingovej spoločnosti sú napísané na okraji a malými písmenami .	malými	10	Ins
Predkladaná publikácia je doplneným a čiastočne prepracovaným textom dizertačnej práce , ktorú som v odbore Všeobecné dejiny obhájil na jar roku 2000 na pôde Filozofickej fakulty Univerzity Komenského v Bratislave .	Filozofickej	24	Gen
Najdôležitejšie informácie v marketingovej spoločnosti sú napísané na okraji a malými písmenami .	Najdôležitejšie	0	Nom
Otočila som sa a medzi divákmi som zazrela Jilliných rodičov .	Jilliných	8	Acc
Práve došli na okraj malého lesíka .	malého	4	Gen
I vlasy ti vypadávajú v celých chuchvalcoch .	celých	5	Loc
Zmeravela som , keď na druhý deň Chris meškal celých desať minút na hodinu astronómie .	celých	9	Acc
Vláda vypracuje a realizuje projekt transformácie štátnych podnikov lesného hospodárstva v pôsobnosti Ministerstva pôdohospodárstva SR na štátnu akciovú spoločnosť založenú podľa osobitného zákona .	štátnu	16	Acc
Duchovné osoby boli ideálnymi parlamenármi , lebo podľa dobových predstáv majú osobitnú ochranu boha pred nebezpečím .	dobových	8	Gen
V oblasti nemocenského poistenia prijme vláda opatrenia zamedzujúce zneužívaniu systému .	nemocenského	2	Gen
S odporom hľadel na bielu masu pred sebou .	bielu	4	Acc
Kačka bola u ugrofínskeho národa Mordovcov posvätným zvieraťom .	ugrofínskeho	3	Gen
V otrokárskom mravenisku	otrokárskom	1	Loc
Celou cestou domov som sa dívala z okna do tmavej prázdnoty .	tmavej	9	Gen
V období vzniku uhorskej cirkevnej organizácie problém , či si uhorský kráľ uzurpoval práva prináležiace Apoštolskému stolcu , ešte nehral rozhodujúcu úlohu .	uhorský	10	Nom
Vláda upraví rámcové podmienky regionálneho rozvoja decentralizáciou verejných financií a zavedie nový , efektívnejší systém finančného vyrovnávania sociálno - ekonomických rozdielov vyšších územných celkov .	ekonomických	19	Gen
Vtom som zazrel červené auto .	červené	3	Acc
Na nebi ani mráčka a z blankytného neba hrialo slnko .	blankytného	6	Gen
Prednosta podzemnej dráhy náhodou našiel starú čižmu , ktorá sa na tento účel výborne hodila .	podzemnej	1	Gen
V sledovaných zbierkach kánonického práva nachádzame celý rad podobných ustanovení .	sledovaných	1	Loc
“ Bude najsilnejší zo všetkých bohov , “ hrdo vyhlásil Zeus .	najsilnejší	2	Nom
Bol starý , maličký , zvláštny a trochu zodratý .	zvláštny	5	Nom
Náš program je plánom , aby Slovensko využilo svoju veľkú príležitosť a zaujalo v európskom spoločenstve dôstojné , rešpektované a zodpovedné postavenie .	dôstojné	16	Acc
Kým sme sa dostali k ruskému kolesu , boli sme unavení , presladení a vysmiati .	vysmiati	14	Nom
Náš dnešný spisovný jazyk je skutočným kompromisom medzi radikálnou normou štúrovcov a požiadavkami bernolákovcov i tradíciou českou či československou .	československou	18	Ins
Delikvent , ktorý tento zákaz poruší , má byť exkomunikovaný .	exkomunikovaný	9	Nom
Vpredu sedel mohutný , ospalo vyzerajúci muž .	vyzerajúci	5	Nom
Technologické spracovanie vychádza z ľahkého špeciálneho penového plastu s otvorenými pórmi , ktorý je uzatvorený vo vzduchotesnom obale .	vzduchotesnom	16	Loc
Išlo to ako na bežiacom páse .	bežiacom	4	Loc
Presne takúto podobu , teda jednoduché príkazy či predpisy , majú i príslušné nariadenia v sledovaných kánonickoprávnych zbierkach .	kánonickoprávnych	16	Loc
V tom omámení som zabudol na niečo podstatné .	podstatné	7	Acc
Môže ísť o toporčeky s predĺženým poriskom , ktoré boli v Škandinávií predmetom symbolizujúcim hromy vrhajúceho Thora .	predĺženým	5	Ins
Naďalej som tam stál so spustenými rukami a na Lorino objatie som neodpovedal .	spustenými	5	Ins
Wilsher , blondiak s nasprostastým výrazom na tvári , ktorého takmer nepoznal , ho s úsmevom pozýval na voľné miesto pri svojom stole .	nasprostastým	4	Ins
Tak je to i vo viacerých ranoarpádovských právnych normách .	právnych	7	Loc
Spomínaní clunyjskí opáti boli osobnosťami s mimoriadnymi osobnostnými kvalitami a veľkou morálnou autoritou .	clunyjskí	1	Nom
Ide o akciu , ktorá je v slovenskom kontexte unikátna .	slovenskom	7	Loc
Vláda sa zaväzuje naďalej garantovať občianske slobody a všestranný rozvoj ľudských práv .	všestranný	8	Acc
“ Prevediete nás podzemnými chrobačími chodbami ? “	chrobačími	4	Ins
Rovnakého problému sa týka i posledný z ostrihomských kánonov , ktorý sa venuje vlastnému ordinačnému právu .	vlastnému	13	Dat
Dal priniesť koše kvetov , podnosy so sladkými včelími špicmi a jazmínové koláčiky .	sladkými	7	Ins
Spôsoboval mi najväčšie utrpenie .	najväčšie	2	Acc
A opäť som zamieril kameru na Lorinu tvár .	Lorinu	6	Acc
Hmla je vlastne len jednou z podôb pary , vznikajúcej v parnom kúpeli , spomínanom v rozprávaní o vzniku sveta .	vznikajúcej	9	Gen
Zákon sprehľadní pravidlá pre plnenie úloh prenesených zo štátnej správy na územnú samosprávu a doplní sústavu zákonov týkajúcich sa územnej samosprávy .	prenesených	6	Gen
Nimi vysvätení kňazi teda nie sú právoplatne vysvätenými a nemôžu teda veriacim sprostredkovať dary Ducha Svätého .	vysvätenými	7	Ins
V 11 storočí však tieto vrstvy , stelesňujúce štátnu moc zastávali postoj výrazne odlišný — čoho najpregnantnejším prejavom bol kódex svetského práva — Ruská Pravda .	Ruská	23	Nom
Takže teraz veľmi čakám , či niekto z mienkotvorných hláv Bútorovho elektorátu urobí sebakritickú analýzu tohto svojho fatálneho politického omylu .	Bútorovho	10	Gen
V súlade s medzinárodnými trendmi pripraví novú koncepciu celoživotného vzdelávania .	medzinárodnými	3	Ins
Musím niečo urobiť , inak hrozí , že sa nezúčastním na Lorinom svadobnom obrade .	Lorinom	11	Loc
Po poslednej hodine , ktorá sa skončila o tretej , som bežala na plaváreň .	tretej	8	Loc
Žiadne údaje o prípadných ďalších tunajších aktivitách Leva IX . , napríklad o snahách presadzovť refory , k dispozícii nemáme .	prípadných	3	Loc
Je ťažké nenávidieť niekoho , kto si natoľko neverí , že sa opičí po druhých .	druhých	14	Loc
A uzlovým bodom všetkých právnych formúl , ktoré sa týkajú rozoberaných hnutí , je vzťah tohto spoločenstva k štátnej moci , t . j . stret sveta šamanistického dualizmu s predstaviteľmi kniežacej moci , zjednocujúcimi krajinu .	zjednocujúcimi	34	Ins
Vzájomné porovnanie takto vytvorených jednotiek umožní plastickejší pohľad na danú problematiku a odhalí nové súvislosti dávno známych faktov .	danú	9	Acc
PREČ S VEĽKÝM BRATOM !	VEĽKÝM	2	Ins
Po známej zrážke s okrajom bazéna ma boleli päty a prestala som si veriť .	známej	1	Loc
Slovenská republika prekonala obdobie spochybňovania demokratických inštitúcií a ohrozovania demokratických slobôd .	demokratických	5	Gen
So zlovestným úškľabkom na tvári Uršuľa chrlila na Arielu hromy ‐ blesky .	zlovestným	1	Ins
Úzky ružový pás na oblohe ohlasoval príchod nového dňa .	ružový	1	Nom
Autobusy sú pohodlím na európskej úrovni .	európskej	4	Loc
Bol rehoľníkom v niekoľkých kláštoroch v Itálii i Hispánii , no oveľa viac ho priťahoval eremitský spôsob života .	eremitský	15	Nom
Bol to riskantný nápad , lebo nemusel vyjsť .	riskantný	2	Nom
Ide o autografy Kosťu a Vojatu so schematicky načrtnutými krížmi .	načrtnutými	8	Ins
Keď sa však priblížila , uvidela v tráve svetlovlasé spiace dievčatko v červených šatôčkach .	spiace	9	Acc
Strata slobody na platnosť uzavretého manželstva podľa všetkého vplyv nemala a manželstvo zostalo právoplatné .	právoplatné	13	Nom
Aj oni mali pred sebou lepšiu a krajšiu budúcnosť a máme ju aj my .	krajšiu	7	Acc
“ Určite je to lepšie ako tu , “ vravel Aladin zahĺbený do vlastných myšlienok .	vlastných	13	Gen
Na pokojnej hladine plával medený odraz mesiaca .	pokojnej	1	Loc
Majina a Vilkova podarená hra	Vilkova	2	Nom
V rohu na sklápacom stole v pološere sa jasne lesklo sklené ťažidlo , ktoré tam kúpil na poslednej návšteve .	sklápacom	3	Loc
Preleteli sme cez oddelenie topánok , kozmetiky , vyhli sme sa nápadne namaľovaným predavačkám , ktoré ponúkali masky , líčidlá a vzorky kolínskej .	kolínskej	22	Gen
Pokračovali v pomalej chôdzi po chodbe , keď vtom sa O ' Brien zastavil .	pomalej	2	Loc
V nami sledovanom období ho nemala vôbec , žijúc zo spomenutého desatinného systému dôb pohanských / pozri 2 kapitolu druhej časti / .	sledovanom	2	Loc
Sebecký pocit , že sme opäť o čosi starší .	starší	8	Nom
S veľkými vreckami .	veľkými	1	Ins
Zastal pri Jazmíninom okne .	Jazmíninom	2	Loc
Aj bez ďalšieho vysvetľovania O ' Brien vedel , ako to myslí .	ďalšieho	2	Gen
Je to cenná a zaujímavá pamiatka o 20 . storočí .	cenná	2	Nom
Podstatou clunyjskej reformy bolo spočiatku ( za Bernona ) obnovenie bezvýhradného dodržiavania princípov Regule sv . Benedikta .	bezvýhradného	10	Gen
“ Spomínam si , Ferdo , “ povedal tenkým hláskom .	tenkým	8	Ins
* Niektorým poslancom padlo zaťažko zverejniť svoje majetkové priznanie .	majetkové	7	Acc
Na nič spred začiatku šesťdesiatych rokov sa nepamätala a ( zo všetkých známych ) jediný človek , ktorý často rozprával o rokoch pred Revolúciou , bol jej starý otec .	starý	27	Nom
Blízka existencia dvoch stredísk rozdielnych národov svedčí o možnosti ich vzájomného ovplyvňovania , o etnickej nerovnorodosti základu , z ktorého vznikol Rostov .	rozdielnych	4	Gen
Keď sa však priblížila , uvidela v tráve svetlovlasé spiace dievčatko v červených šatôčkach .	červených	12	Loc
Vláda pripraví transformáciu štátnych zdravotných ústavov na inštitúcie verejného zdravotníctva so zvýraznením opatrení zameraných na zníženie , resp . vylúčenie rizika poškodenia zdravia .	zdravotných	4	Gen
Našla osí roj , ktorý mal včelí palác zničiť .	včelí	6	Acc
Tigríča jej nešikovne skočilo do náručia a princezná zacítila mäkulinkú teplú guľku s hodvábnou srsťou .	hodvábnou	13	Ins
Kvalifikovanú odpoveď na tuto otázku však budeme môcť priniesť až po dôkladnej komparácii s dobovými východnými právnymi pamiatkami .	dôkladnej	11	Loc
V prvých troch kapitolách sa teda pokúsime o prieskum problematiky v celoruskom rámci , odhliadnuc od jemnejších miestnych odlišností .	jemnejších	16	Gen
K tomu sa podávalo trnkové víno a deťom ponúkli fialovú malinovku .	fialovú	9	Acc
Na okraji studne sedel zelený žabiak s kockovaným klobúkom na hlave .	kockovaným	7	Ins
Na jeho ľavom konci bola stará studňa bez vody , pred studňou rástla marhuľa .	ľavom	2	Loc
V oblasti aktívnej politiky trhu práce bude vláda presadzovať princíp návratnosti a projektového financovania .	aktívnej	2	Gen
Prítomnosť nálezov kačacích príveskov sa vysvetľuje tiež importom zo Škandinávie , prostredníctvom nápodoby laponských a karelských kovolejárov .	karelských	15	Gen
Vždy mala vynikajúcu povesť .	vynikajúcu	2	Acc
Teraz sa v noci budievam zo spánku a hrdlo mi zviera úzkosť : trápi ma nočná mora , že aj ja som v dave , ktorý ženie mamu v ústrety smrti .	nočná	15	Nom
Postupne mu však Balúove šaškoviny pripadali zábavné .	zábavné	6	Nom
Decentralizáciou kompetencií sa presunula podstatná časť zodpovednosti za rozvoj bývania na obce .	podstatná	4	Nom
Bol tu nájdený rituálne pochovaný kôň .	pochovaný	4	Nom
Presne takúto podobu , teda jednoduché príkazy či predpisy , majú i príslušné nariadenia v sledovaných kánonickoprávnych zbierkach .	sledovaných	15	Loc
Zmeny budú navrhnuté v súlade s európskou legislatívou tak , aby tieto zákony neboli prekážkou zvyšovania zamestnanosti a ekonomického rastu a zvýšili flexibilitu trhu práce .	európskou	6	Ins
Obyvatelia Makovej lúky to hneď využili .	Makovej	1	Gen
Pohyb z jednej skupiny do druhej je oveľa vzácnejší , než bol v kapitalizme či dokonca v predindustriálnom veku .	predindustriálnom	17	Loc
Potom leteli ponad lúkou , až sa dostali k topoľovej aleji .	topoľovej	9	Dat
Za očami matne rozoznala biely ňufáčik a zlato ‐ čierny pásikavý kožuštek .	pásikavý	10	Acc
Symbolickú úlohu má i výzdoba koníka — krúžky s bodkou uprostred sú ďalšou z mnohých modifikácií solárnych znakov .	ďalšou	12	Ins
“ Prevediete nás podzemnými chrobačími chodbami ? “	podzemnými	3	Ins
V prvých listoch reaguje na uhorskú vnútropolitickú situáciu , keď prebiehali boje medzi Gejzom a Šalamúnom o uhorský trón .	uhorskú	5	Acc
Symbolika fúza je v už spomenutom severoamerickom mýte spojená s vyvolaním hmly .	spomenutom	5	Loc
Duchovné osoby boli ideálnymi parlamenármi , lebo podľa dobových predstáv majú osobitnú ochranu boha pred nebezpečím .	ideálnymi	3	Ins
Starec zrejme zabudol na predsudky , ktoré mal proti celému litru .	celému	9	Dat
Kým sme sa dostali k ruskému kolesu , boli sme unavení , presladení a vysmiati .	ruskému	5	Dat
Zaujímavým náleziskom sú timerevské mohyly .	Zaujímavým	0	Ins
Vláda bude naďalej podporovať účasť Ozbrojených síl SR v mierových misiách a operáciách na podporu mieru a na boji proti terorizmu , s dôrazom na operácie pod vedením NATO .	Ozbrojených	5	Gen
Ženské bábky aj mužské bábky .	mužské	3	Nom
Centrom vladimírskych mohýl bolo Pleščejevské jazero , osídlené zmiešaným slovansko ‐ ugrofínskym obyvateľstvom .	zmiešaným	8	Ins
Hlúpa tvár pod svetlými vlasmi ho vítala s rozžiareným úsmevom .	svetlými	3	Ins
Na temnú chvíľu hrôzy už sčasti zabudol .	temnú	1	Acc
Neodvážil som sa pohnúť , zdvihnúť ruky , odpovedať na Lorino objatie .	Lorino	10	Acc
Vzájomné porovnanie takto vytvorených jednotiek umožní plastickejší pohľad na danú problematiku a odhalí nové súvislosti dávno známych faktov .	známych	16	Gen
Poznali sme ho podľa klopania , boli to tri ľahké údery .	ľahké	9	Nom
Pri susedných stoloch ma počuli .	susedných	1	Loc
“ Máte Baghírovo slovo , “ dodal .	Baghírovo	2	Acc
Inak to bola príjemná zábava pri ľudovej hudbe .	ľudovej	6	Loc
Abu sa zamračil a poodišiel nabok od krištáľovej gule .	krištáľovej	7	Gen
Všade bolo ticho , až na jemné ale prenikavé cvrlikanie .	jemné	6	Acc
V sledovaných cirkevnoprávnych zbierkach sme pendanty k uhorským úpravám nenašli .	cirkevnoprávnych	2	Loc
V Teklinej pavučine	Teklinej	1	Loc
Tam na kamennom tróne sedel sám kráľ opíc .	kamennom	2	Loc
V popoludňajšej tíši prekvapovala hlasitosť jeho zvuku .	popoludňajšej	1	Loc
Ako sedemnásťročný sa stal okresným zakladateľom Antisexuálnej ligy mládeže , ako devätnásťročný navrhol nový druh ručného granátu , ktorý zaradilo do výzbroje Ministerstvo mieru a ktorý už pri prvej skúške jediným výbuchom zabil tridsaťjeden euroázijských zajatcov .	okresným	4	Ins
V uplynulých rokoch ukázalo silný vzťah k demokratickým hodnotám a silu riešiť mnohé problémy .	uplynulých	1	Loc
Medzi tieto nedovolené zamestnania patrilo i krčmárstvo , ktorého vykonávanie zakázali aj ostrihomskí synodálni otcovia .	synodálni	13	Nom
Zničená som si prisahala , že si cez obedňajšiu prestávku zaplávam a budem trénovať obrátky dovtedy , kým ich nezvládnem .	obedňajšiu	8	Acc
Chvíľu leteli , až pristáli v spustnutej záhrade , kde bola pod obrovskou smutnou vŕbou hlbočizná studňa .	smutnou	13	Ins
Radšej zomreli , akoby mali Krista zradiť a zaprieť .	Radšej	0	Nom
Emanuel s Makulienkou tak ‐ tak stačili preskočiť na najbližšie lekno .	najbližšie	9	Acc
Nevznikla sama od seba , jej náväznosť na vierouku z desiateho storočia / i keď došlo k zrejmým posunom / svedčí o kontinuite jej vývoja .	zrejmým	17	Dat
Ochrana kultúrneho dedičstva a duševného vlastníctva	duševného	4	Gen
Winston sedel na svojom mieste a civel do prázdneho pohára .	prázdneho	8	Gen
Zrazu začul akýsi zachrípnutý hlas .	zachrípnutý	3	Acc
Cieľom reformy je zastaviť demograficky podmienené zvyšovanie vnútorného dlhu priebežne financovaného dôchodkového systému a zvýšiť zaangažovanosť občanov na svojej životnej úrovni v dôchodkovom veku .	dôchodkovom	22	Loc
Nenadarmo platí " Sýty hladnému neverí " a zároveň neexistuje žiadne porekadlo typu " Ukojený nadržanému neverí " .	Ukojený	14	Nom
Nikto z nich nevie nič o mojom ruskom dobrodružstve .	ruskom	7	Loc
Súčasná spoločnosť je marketingovou spoločnosťou .	marketingovou	3	Ins
Zaburácal silný výbuch , ktorý akoby zodvihol vydláždený chodník ; na chrbát mu dopadla spŕška ľahkých predmetov .	ľahkých	15	Gen
Najskôr sa na hornej časti schodišťa objavila drobná starena v širokých nohaviciach .	hornej	3	Loc
Vedel , že ho má vo svojej hadej moci , ktorou môže zhypnotizovať aj to najživšie zviera .	najživšie	15	Acc
Ostatné , okrem jeho nešťastnej lásky k Faike , som si vymyslel .	nešťastnej	4	Gen
Musí byť pohodlný , viem , aby sa v ňom Lienke dobre sedelo a dobre pérovaný , aby nedostala kočovú chorobu .	kočovú	19	Acc
A najpevnejšou niťou bude niektorá televízna stanica .	televízna	5	Nom
Priplávala som ku kovovým schodíkom a s námahou som vystupovala von , keď ma striaslo .	kovovým	3	Dat
Navrhneme zmeny , ktoré sú nevyhnutné pre vybudovanie moderného sociálneho systému .	sociálneho	9	Gen
Prvý z apoštolov patril v celom kresťanskom svete k mimoriadne uctievaným svätcom .	uctievaným	10	Dat
Naši žiaci a rodičia sú pobúrení .	pobúrení	5	Nom
Prebúdzal som sa o druhej v noci na zvonenie mechanického budíka čínskej výroby , ktorý som mal na nočnom stolíku pri záhlaví postele .	mechanického	9	Gen
Zrejme obsahoval nejaký písomný odkaz .	písomný	3	Acc
Vláda využije všetky možnosti na zintenzívnenie stykov s Poľskom a Maďarskom a je pripravená aktívne sa podieľať na efektívnom a pragmatickom fungovaní vyšehradskej spolupráce .	pragmatickom	20	Loc
Druhou vrstvou bol letopis z rokov 1037 — 1039 .	Druhou	0	Ins
Vláda zabezpečí harmonizáciu a štandardizáciu informačných technológií a dátových štruktúr s cieľom vytvorenia podmienok pre prepojenie informačných systémov dopravy , pôšt a telekomunikácií s EÚ	informačných	16	Gen
S pohľadom upretým na vchod do televízie Sírius .	upretým	2	Ins
Začínali sa aj pochôdzky chlapa v zelenom vojenskom kabáte .	vojenskom	7	Loc
Keď dedinskí nafúkanci z môjho ročníka uverejnili na jeho stránkach nejakú báseň , naparovali sa celý mesiac .	dedinskí	1	Nom
Prítomnosť nálezov kačacích príveskov sa vysvetľuje tiež importom zo Škandinávie , prostredníctvom nápodoby laponských a karelských kovolejárov .	kačacích	2	Gen
A obchody , ktoré chcú predávať zaručene čerstvý , v noci upečený a nezabalený chlieb , musia ho držať v osobitných zasklených policiach , takže skôr nebalenie chlieb zdražuje .	osobitných	20	Loc
Pri štvrtej obrátke sa mi stužka s kľúčikom z krku vyvliekla .	štvrtej	1	Loc
Sily sú vyrovnané — a tak sa začína „ mýtická súťaž “ .	vyrovnané	2	Nom
Vláda zlepší súčasný stav nedostatočnej ochrany slovenského spotrebiteľa a výrobkov vyrábaných na území SR .	vyrábaných	10	Gen
Kerchak bránil rodinu proti zákernej mačke , zatiaľ čo ostatní členovia ho pozorovali zo stromov .	zákernej	4	Dat
Fridolín bol malý hnedý chlapík so silným náprsným štítom a krátkymi krovkami .	silným	6	Ins
Deti sú v prevažnej miere rímokatolíci .	prevažnej	3	Loc
Spev kohúta máva aj vo všednom , obyčajnom živote dvojaký význam .	všednom	5	Loc
Niet pochýb , že nikdy nemohlo jestvovať obdobie , keď to bolo celkom bežné .	bežné	13	Nom
Symbolika fúza je v už spomenutom severoamerickom mýte spojená s vyvolaním hmly .	severoamerickom	6	Loc
Zväčša to boli obyčajní zločinci , ale našla sa tam aj hŕstka politických väzňov .	obyčajní	3	Nom
Právo na prístup ku kultúrnym hodnotám je jedným z dôležitých práv všetkých občanov .	kultúrnym	4	Dat
Vláda bude presadzovať zrušenie systému maximálnych cien a zmenu kategorizácie úhrady liekov tak , aby obsahom solidárneho balíka bola v každej anatomicko - terapeutickej skupine aspoň jedna účinná látka .	terapeutickej	23	Loc
Netrvalo dlho a vedľa nej sa pod veľkým černicovým kríkom zjavil tučný svetlohnedý pavúk .	černicovým	8	Ins
Mimoriadne škaredú , s mimoriadne škaredým a nepriateľským pohľadom .	nepriateľským	7	Ins
Scenár - adaptácia : Tenká červená čiara	Tenká	4	Nom
Na ôsmich tenkých chlpatých nohách spočívalo nemotorné telo a na ňom trónila malá hlava .	chlpatých	3	Loc
A vtedy dobráckemu panterovi čosi napadlo .	dobráckemu	2	Dat
A uvedomovať si , že som na tomto svete jediným Loriným zástupcom .	Loriným	10	Ins
Ľudstvo svojou usilovnosťou prispelo k zrodu dvoch svetových vojen , ba v niektorých kútoch Zeme vojny pokračujú .	svetových	7	Gen
Bola tu celá reťaz zvláštnych oddelení , ktoré sa zaoberali proletárskou literatúrou , hudbou , dramatickým umením a vôbec zábavou .	proletárskou	10	Ins
Vláda zvýši mieru informovania verejnosti v oblasti regionálnej politiky .	regionálnej	7	Gen
Kravy bučali a zo slamy utekalo všetko živé .	živé	7	Nom
S mojimi úbohými postavami .	úbohými	2	Ins
Tri uvedené stupne výskumu nás vedú ku konštatovaniu , potvrdzujúcemu úvodnú tézu o tesnej prepletenosti oboch systémov , obohatenému však poznaním vnútornej dynamiky jej vývoja .	potvrdzujúcemu	9	Dat
Tieto kritické postrehy Soni vyslovila pri našom poslednom prázdninovom stretnutí pred začiatkom tretieho ročníka .	tretieho	12	Gen
musí byť dôsledne uplatňované	uplatňované	3	Nom
Pegas naletel každej krásnej hrive a nasledoval kobylu do neďalekej stajne .	neďalekej	9	Gen
Faikiným rukojemníkom som zostal až do chvíle , keď sa rozhodla , že odíde , a vydala sa .	Faikiným	0	Ins
v prioritných oblastiach verejného záujmu musí byť verejný sektor schopný konkurovať súkromnému sektoru pri získavaní a udržaní kvalitných ľudských zdrojov	kvalitných	17	Gen
Vláda bude podporovať aj zriadenie cezhraničných chránených území .	chránených	6	Gen
V dobrej kondícii .	dobrej	1	Loc
Zmienky o skúmanom fenoméne .	skúmanom	2	Loc
Na schodišti som mal opäť zvláštny pocit , že ma niekto sleduje , a znova som rýchlym pohybom otočil hlavu , akoby som ho chcel nečakane prekvapiť .	rýchlym	16	Ins
Isté výhrady voči Závodszkého dielu sme pojali aj my .	Závodszkého	3	Dat
Sprístupnením informácií o poskytnutých dotáciách výrazne obmedzí priestor pre korupciu a klientelizmus v podpornej politike štátu .	poskytnutých	3	Loc
Jillina mama s otcom tam zamračení meravo sedeli , ako keby chceli silou vôle dotlačiť dcéru na stupienok víťazov .	zamračení	5	Nom
Hravo obopínal jednou rukou celý Júliin pružný pás .	Júliin	5	Acc
Vzdelanie sa stáva kľúčom k životnému úspechu , najlepšou investíciou do budúcnosti , účinnou prevenciou pred nezamestnanosťou , zločinnosťou , drogami .	účinnou	13	Ins
Kvalifikovanú odpoveď na tuto otázku však budeme môcť priniesť až po dôkladnej komparácii s dobovými východnými právnymi pamiatkami .	Kvalifikovanú	0	Acc
Do sklenej nádoby , v ktorej varila zázračný nápoj , pridávala čarovné prísady , a pritom čítala .	sklenej	1	Gen
Najprv zavládlo neprirodzené ticho .	neprirodzené	2	Nom
Postupne sa zdvíhanie a klesanie ich hrudí spomalilo a prešlo do normálneho rytmu a s príjemným pocitom bezmocnosti sa od seba oddelili .	normálneho	11	Gen
A tu či inde sa v úplnej tajnosti nachádzali riadiace mozgy , ktoré koordinovali toto úsilie a určovali politickú líniu : rozhodovali o tom , že tento fragment minulosti sa zachová , tento sa sfalšuje a ďalší prestane jestvovať .	politickú	18	Acc
Vláda bude klásť dôraz na racionalizáciu nákladov spojených s realizáciou výkonov vo verejnom záujme v železničnej osobnej doprave a verejnej autobusovej doprave .	železničnej	15	Loc
" Sme mŕtvi , " povedal .	mŕtvi	2	Nom
On a zopár jemu podobných boli poslednými živými spojovacími článkami so zašlým kapitalizmom .	poslednými	6	Ins
Amulet teda posilňuje určité črty jeho charakteru do neobvyklých až nadprirodzených polôh , Vseslav sa stáva vyvolencom — podľa kresťanského kronikára — temných síl .	kresťanského	19	Gen
Vo svätoštefanských zákonoch je prítomná už spomínaná kombinovaná sankcia za tento zločin .	svätoštefanských	1	Loc
Dúfala som , že sa nápadne zablyští na slnku , ale , žiaľ , v ten deň bolo zatiahnuté .	zatiahnuté	18	Nom
V ďalšom potom budeme identifikovať odraz tejto jeho pozície v sledovaných právnych normách .	sledovaných	10	Loc
Dej obidvoch týchto románov sa odohráva na bengálskom vidieku .	bengálskom	7	Loc
Vláda pripraví legislatívne opatrenia , ktoré zjednodušia sankčný systém v daňovej oblasti .	daňovej	10	Loc
v prioritných oblastiach verejného záujmu musí byť verejný sektor schopný konkurovať súkromnému sektoru pri získavaní a udržaní kvalitných ľudských zdrojov	verejný	7	Nom
Tento spor nemal priamy dopad na reformu .	priamy	3	Acc
" Je to zvláštne , nazdala som sa , že je plný .	plný	11	Nom
Na rube sa nachádza postava vcelku s vladárskou korunou , kopiou a štítom , obkolesená zrkadlovým gréckym nápisom „ Dimitrij “ .	zrkadlovým	15	Ins
V ranoarpádovských zákonníkoch nachádzame aj ustanovenia o Božích súdoch , iracionálnom dôkaznom prostriedku , ktorý sa v stredovekom súdnom konaní hojne aplikoval .	iracionálnom	10	Loc
Napokon sme z kríkov vybrali Chrisov bicykel a pomaly sme vyšli na ulicu .	Chrisov	5	Acc
Zaľúbil som sa do nej akousi zvláštnou láskou , ktorá ma nepobádala písať verše , ako som ich písal pre Teutu .	zvláštnou	6	Ins
Bude pokračovať v napĺňaní národného programu , prijme nové opatrenia v legislatívnej , inštitucionálnej aj organizačnej oblasti .	organizačnej	15	Loc
Z politického hľadiska Koloman pápežovi vyhovel .	politického	1	Gen
Pripravovali sme definitívne vydanie Kiplingovho básnického diela .	básnického	5	Gen
V tom okamihu bolo po vysokoškolských plánoch .	vysokoškolských	5	Loc
Vedela , že Erik s Arielou sa zachytili o cípy jej obrovitej koruny .	obrovitej	11	Gen
Zákon sprehľadní pravidlá pre plnenie úloh prenesených zo štátnej správy na územnú samosprávu a doplní sústavu zákonov týkajúcich sa územnej samosprávy .	územnej	19	Gen
Neviditeľní jazdci na koňoch sú vyjadrením predstavy o zlých duchoch , schopných ubližovať človeku odnesením jeho duše do podsvetia .	schopných	11	Loc
Jej vládcov nespájajú pokrvné zväzky , ale príslušnosť k spoločnému učeniu .	pokrvné	3	Nom
Veľa včiel opustilo mesto s novou kráľovnou , aby niekde vo veľkom šírom svete založili nové včelstvo .	veľkom	11	Loc
V tom majú prsty Goldsteinovi agenti !	Goldsteinovi	4	Nom
V tom čase bol taký postoj niečím úplne novým .	novým	8	Ins
Veľká noc 2004 a dejinné udalosti	dejinné	4	Nom
Rozčúlil sa , že ho vyrušujem po pracovnom čase .	pracovnom	7	Loc
Obzvlášť odvtedy , čo som sa presťahovala do prízemného bytu po mojej starej tete , ktorá chovala a vykrmovala túlavé mačky z celého sídliska .	túlavé	19	Acc
Druhá Doležalova inovácia je v gramatickom popise tohto jazyka .	gramatickom	5	Loc
Koordináciu európskej politiky štátu ako súčasti zahraničnej politiky bude zabezpečovať MZV SR v úzkej spolupráci s ostatnými ústrednými orgánmi štátnej správy .	európskej	1	Gen
Pri príležitosti svojho odchodu a ukončenia zimného obdobia som vyhlásil , že zaplatím koňak všetkým , ktorí budú od dvanástej až do tretej poobede v kaviarenskej časti obchodu .	zimného	6	Gen
Bola presadzovaná hlavne sovietskou marxistickou historiografiou .	marxistickou	4	Ins
U dovážaných produktov zabezpečí elimináciu tých , ktoré nespĺňajú kritériá kvality a ktoré neprešli colným a daňovým vysporiadaním .	colným	14	Ins
Po ľubečskom zjazde sa mesto napokon dostalo do Monomachových rúk .	Monomachových	8	Gen
Takže teraz veľmi čakám , či niekto z mienkotvorných hláv Bútorovho elektorátu urobí sebakritickú analýzu tohto svojho fatálneho politického omylu .	politického	18	Gen
Veľavravným svedectvom sú nálezy belozerskej lepenej keramiky .	Veľavravným	0	Ins
V škole bola kapitánkou hokejového družstva a dva roky po sebe získala trofej v gymnastike .	hokejového	4	Gen
Prinesie na oltár lásky obeť tým , že odpoveď začne najhorším .	najhorším	10	Ins
Vtedy sa naraz ukázalo , že komunistická strana s jej zločineckými spôsobmi skrachovala .	zločineckými	10	Ins
Svätoštefanský zákon pripúšťa , aby sa žena , ktorú manžel za istých okolností opustí , znovu vydala .	Svätoštefanský	0	Nom
V ranoarpádovských zákonníkoch nachádzame aj ustanovenia o Božích súdoch , iracionálnom dôkaznom prostriedku , ktorý sa v stredovekom súdnom konaní hojne aplikoval .	ranoarpádovských	1	Loc
Prijatie novely zákona o štátnej službe umožní okrem iného zamestnanie špičkových odborníkov v ústredných štátnych orgánoch za adekvátneho mzdového ohodnotenia a odstráni nepružnosť zamestnávania v štátnej službe .	ústredných	13	Loc
Ostrihomská synoda tiež zakázala , aby bol za kňaza vysvätený otrok ( sluha ) .	Ostrihomská	0	Nom
Nenadarmo platí " Sýty hladnému neverí " a zároveň neexistuje žiadne porekadlo typu " Ukojený nadržanému neverí " .	nadržanému	15	Dat
Vláda zásadnejšie prehodnotí doteraz platný dotačný systém podľa kritérií EÚ .	dotačný	5	Acc
Miznú tak i zvyšky existencie predkresťanskej náhrady za škodu , nahradzujúce prechodne krvnú pomstu .	krvnú	12	Acc
Súčasne podporí profesionalizáciu štátnej školskej inšpekcie .	školskej	4	Gen
Chodbu , po ktorej ich viedol , pokrýval jemný koberec , na stenách boli krémové tapety , biele drevené obloženie , všetko neskutočne čisté .	jemný	8	Nom
Títo reformne naladení klerici sa stali najbližšími pápežovými spolupracovníkmi a poradcami .	pápežovými	7	Ins
V Policajnom zbore sa zmení systém hodnotenia práce , ktorý bude akcentovať mieru spokojnosti občanov s činnosťou polície .	Policajnom	1	Loc
S pocitom prihlúpleho vidiečana som prešiel po asfaltovej ceste , ktorá viedla k zhluku novopostavených budov .	asfaltovej	7	Loc
Všimnime si audiotextové reklamy .	audiotextové	2	Acc
Oči mi na chvíľu zastali na tenkej retiazke , na odhalenej časti pŕs .	odhalenej	10	Loc
Základnými požiadavkami na všetky druhy podložiek na spanie sú tepelná izolácia a izolácia od vlhkosti .	tepelná	9	Nom
Svätojánska muška mala tenulinký hlások a Maja ju takmer nepočula .	Svätojánska	0	Nom
Vzťahy so susednými štátmi a cezhraničná spolupráca	susednými	2	Ins
V straníckych obchodoch každú chvíľu niečo chýbalo .	straníckych	1	Loc
“ Výborný nápad , “ súhlasila som .	Výborný	1	Nom
Podľa mojich predstáv sa vracali do pekných domov s vyhrievanými bazénmi .	vyhrievanými	9	Ins
Ďakujeme vám , bratia a sestry , za vaše modlitby , pomoc s potravinami , za vaše rady a inú praktickú pomoc !	praktickú	20	Acc
Potom sa pomaly pobral opačným smerom .	opačným	4	Ins
Mimoriadne škaredú , s mimoriadne škaredým a nepriateľským pohľadom .	škaredým	5	Ins
Ich sústredený pohľad nemohol neupútať moju pozornosť .	sústredený	1	Nom
Nilus bol skôr predstaviteľom východného typu mnícha , v osobe ktorého sa spájala vysoká miera asketizmu s rovnako vysokou úrovňou vzdelanosti a kvality duchovného života .	vysokou	18	Ins
Vláda prehodnotí platné znenie zákona o sociálnom poistení ešte pred nadobudnutím jeho účinnosti .	sociálnom	6	Loc
Tieto právomoci platili i v nami sledovanom období .	sledovanom	6	Loc
Okolo pohrebnej jamy boli nájdené stopy stĺpov .	nájdené	4	Nom
Zišlo mu na um , že až doteraz ho zrejme nevidela na voľnom priestranstve v plnom dennom svetle .	plnom	15	Loc
Ostražito sa zakrádala k neznámemu miestu , keď začula plač .	neznámemu	4	Dat
Niekedy sa objavovali obyvatelia Čarodejníckej vily , všetkých som poznala a vedela som , aký bol osud každého z nich .	Čarodejníckej	4	Gen
A stiahol zlatý náprstok naspäť pod čiernu zem .	zlatý	2	Acc
Mal neuveriteľne dlhé , tenké nohy a smiešne , malé , hnedé a guľaté telíčko .	tenké	4	Acc
Nález železného kľúča od visiaceho zámku mohol súvisieť s už spomenutou ochrannou funkciou .	spomenutou	10	Ins
Princezná Jazmína pozerala z okna do hlbokej púštnej noci .	púštnej	7	Gen
Pred nimi sa zjavil zarastený a špinavý tvor .	špinavý	6	Nom
Do tváre sa mu opieral príjemný letný vzduch .	letný	6	Nom
Vedľa v sieni sa zatiaľ zhromaždenie skončilo a v sršňom meste zavládol pokoj .	sršňom	9	Loc
V meste včiel pri starej striebornej jedli panoval čulý ruch .	striebornej	5	Loc
Pretože Jumbo bol mierumilovný , nikto nenamietal .	mierumilovný	3	Nom
V krátkom čase v rokoch 1989 – 1990 bol členom Generálneho presbyterstva .	krátkom	1	Loc
Vláda zruší poplatky za vyňatie pôdy z poľnohospodárskeho pôdneho fondu .	poľnohospodárskeho	7	Gen
V piaty deň každého mesiaca išla Irma na poštu s príslušným kódom a priniesla domov sto dolárov .	piaty	1	Acc
Schytilo dievčinku labkami a vraví : “ Ty moja krásna dievčinka , odnesiem si ťa do hniezda ! “	krásna	9	Nom
Koruna Sv . Štefana a ostrihomský Primas Hungariae sa stali symbolom Uhorského štátu .	ostrihomský	5	Nom
Pravdivá je jeho negácia .	Pravdivá	0	Nom
V živote každého človeka sú okamihy a udalosti , ktoré majú zvláštnu moc .	zvláštnu	11	Acc
Myslím , že o sebe urobili veľmi pekný obraz , že aj Rómovia a deti z detského domova sa vedia správať na úrovni .	detského	16	Gen
Keď prehovoril , bolo to v ľahkom , konverzačnom tóne .	ľahkom	6	Loc
Potom vložila ten lístok do zásuvky , vytiahla z nej kľúč s ťažkým bronzovým štítkom , na ktorom bolo číslo izby , a strčila mi ho do ruky .	bronzovým	13	Ins
Do Winstonovej ruky sa zapichla ihla .	Winstonovej	1	Gen
Náš dnešný spisovný jazyk je skutočným kompromisom medzi radikálnou normou štúrovcov a požiadavkami bernolákovcov i tradíciou českou či československou .	skutočným	5	Ins
Pre potreby rozvíjajúcej sa cirkevnej organizácie bol na základe tohto štatútu okolo roku 1100 vytvorený štatút nový , ktorý sa stal základným archetypom pre všetky neskoršie odpisy .	rozvíjajúcej	2	Gen
Hrozne mi chýbal a pocítila som priam fyzickú bolesť .	fyzickú	7	Acc
Prečo je dnešný humor suchý ?	suchý	4	Nom
V období vzniku uhorskej cirkevnej organizácie problém , či si uhorský kráľ uzurpoval práva prináležiace Apoštolskému stolcu , ešte nehral rozhodujúcu úlohu .	Apoštolskému	15	Dat
Pozvala na ňu Blythe a Ricka a podávala moje obľúbené jedlá : zemiakovú kašu , pizzu , celozrnný chlieb , španielske chimichangas , makaróny so syrom a orechový koláč .	obľúbené	9	Acc
Pre svoju krátkosť a úryvkovitosť sa nedajú podrobiť podrobnejšej analýze .	podrobnejšej	8	Dat
Pamätajte na Ježišove slová : Kto vytrvá do konca , bude spasený .	Ježišove	2	Acc
“ Tu je diera , “ zašepkala som a vybrala trs trávy , ktorý zakrýval vyčnievajúci stupienok z palmového dreva .	vyčnievajúci	15	Acc
Všetci sme sa podobali na postavy absurdného divadla .	absurdného	6	Gen
Sú vhodné do teplého letného počasia , od jesene do jari ich použitie neodporúčam .	teplého	3	Gen
Vrátila sa domov skôr ako ja a zdalo sa , že je pokojná .	pokojná	12	Nom
Negatívnych stránok je množstvo .	Negatívnych	0	Gen
Samozrejme , že Maja s Vilkom zablúdili v jesennej hmle ako prví .	jesennej	8	Loc
Podporíme urýchlenie legislatívneho , inštitucionálneho a administratívneho dobudovania štruktúr potrebných na výkon Spoločnej poľnohospodárskej politiky .	potrebných	9	Gen
Je známe , že hlinené nápodoby medvedích láb , slúžili na ochranu domáceho krbu .	medvedích	6	Gen
Súčasnému vedúcemu katery doc . M . Danišovi patrí okrem toho aj moje srdečné poďakovanie za vytrvalú a všestrannú podporu pri vydaní tejto knihy .	Súčasnému	0	Dat
Vzala si kráľov trojzubec a jeho zlatá žiara sa jej rozliala po tvári .	zlatá	6	Nom
Vláda pripraví program zameraný na ekonomický rozvoj , v rámci tohto programu vypracuje podprogramy pre jednotlivé sektory .	zameraný	3	Acc
Bezprostredne za skúmanou pasážou nasleduje zmienka o založení novgorodského chrámu sv . Sofie .	skúmanou	2	Ins
Je to chronologicky prvá zbierka , ktorú zostavil neznámy autor z rímskych reformných kruhov .	reformných	12	Gen
Jeho monotónny hlas mi pripadal znesiteľný až dovčera , keď Chris povedal , že mu chýba iskra .	monotónny	1	Nom
Stráca svoj vidiecky a náboženský charakter a stáva sa mestskou a svetskou .	svetskou	11	Ins
Súčasnému vedúcemu katery doc . M . Danišovi patrí okrem toho aj moje srdečné poďakovanie za vytrvalú a všestrannú podporu pri vydaní tejto knihy .	vytrvalú	16	Acc
V jeho krásnej vile bude určite príjemne .	krásnej	2	Loc
“ Pomôžem ti , “ povedala Chris , keď som sa snažila udržať rovnováhu na okennom parapete .	okennom	15	Loc
Druhou činnosťou , ktorú v Ostrihome klerikom zakázali , bolo úžerníctvo .	Druhou	0	Ins
To malo obrovský národnozáchovný význam v druhej polovici XIX . storočia , keď maďarizácia reálne ohrozovala samotnú existenciu slovenského národa .	národnozáchovný	3	Acc
Buď to spôsobil príval jej vďačnosti , alebo slovo „ ujo “ , ktoré vyslovila s akousi sexuálnou dôvernosťou .	sexuálnou	17	Ins
Cieľom fiškálnej politiky vlády bude zníženie podielu verejného dlhu na hrubom domácom produkte počas volebného obdobia .	domácom	11	Loc
Maja si z celého srdca vydýchla a náhlila sa k potoku , aby tú radostnú novinu oznámila ostatným .	ostatným	17	Dat
Vlčia rodinka prijala ľudské mláďa .	Vlčia	0	Nom
Sú vhodné do teplého letného počasia , od jesene do jari ich použitie neodporúčam .	letného	4	Gen
Niektoré sú vzdialené milióny svetelných rokov .	svetelných	4	Gen
Na stenách viseli zaprášené police s prastarými knihami zaklínadiel a čarov .	prastarými	6	Ins
Vláda pripraví legislatívny rámec inštitucionálneho vzdelávania zdravotníckych pracovníkov prostredníctvom rezortu školstva s možnosťou postgraduálnej prípravy pracovníkov v zdravotníctve v školách a inštitúciách , ktoré získajú akreditáciu pre príslušný typ vzdelávania .	zdravotníckych	6	Gen
V zápale hry Maja prihrala Vilkovi , ten prudko kopol do lopty a lopta zmizla v kroví .	kroví	16	Loc
Predkladaná publikácia je doplneným a čiastočne prepracovaným textom dizertačnej práce , ktorú som v odbore Všeobecné dejiny obhájil na jar roku 2000 na pôde Filozofickej fakulty Univerzity Komenského v Bratislave .	Všeobecné	15	Nom
PREČ S VEĽKÝM BRATOM !	VEĽKÝM	2	Ins
Vláda bude klásť dôraz na prehľadnosť , výkonnosť , spoľahlivosť a efektívnosť monitorovacieho a hodnotiaceho systému .	monitorovacieho	12	Gen
Nie sú ani pekné , ani obľúbené .	pekné	3	Nom
Napriek maminým radám som pil .	maminým	1	Dat
Pred Slovenskou republikou sú historické chvíle .	Slovenskou	1	Ins
Podobalo sa to pokusu o ťah v šachovej partii , keď už má človek mat .	šachovej	7	Loc
Nespomínali moje ruské dobrodružstvo .	ruské	2	Acc
So zovretým hrdlom som sa rozhliadol okolo seba .	zovretým	1	Ins
Integrovaná územná ochrana	Integrovaná	0	Nom
Po analýze a vyhodnotení doterajších skúseností s pilotnými prevádzkami vláda vytvorí podmienky na jeho rozšírenie na všetky súdy .	doterajších	4	Gen
“ Choď preč , daj mi pokoj ! “ skríkol , keď sa vyslobodil z hadieho chvosta a odvrátil hlavu .	hadieho	15	Gen
Podporí v rámci krajín EÚ kompatibilnosť v oblasti vzájomného uznávania dokladov o dosiahnutí určitého stupňa vzdelania .	určitého	13	Gen
Tekla vychrlila niekoľko oplzlých pavúčich nadávok , ale na silného Chrabroša si netrúfla , a tak kľajúc zaliezla pod vädnúci list .	oplzlých	3	Gen
Okno bolo len zámienkou a ona to svojou ženskou intuíciou vytušila .	ženskou	8	Ins
Sklo je prirodzene náchylné rozbiť sa a plech nezaručuje odolnosť voči vlhkosti .	náchylné	3	Nom
Zelený tvor sa na Maju bezočivo díval veľkými , ale dobrosrdečnými očami .	dobrosrdečnými	10	Ins
Bavilo ma písať kompozície a na vynikajúcom skalickom gymnáziu boli veľmi dobré podmienky pre kultúru .	vynikajúcom	6	Loc
Ďalším charakteristickým znakom gramatiky newspeaku bola jej pravidelnosť .	charakteristickým	1	Ins
Dodnes s určitosťou nevedel , či je matka mŕtva .	mŕtva	8	Nom
Bol ním koncert kresťanskej country skupiny z Batizoviec a okolia .	kresťanskej	3	Gen
V kapitole o Novgorode sme už rozobrali súvis tzv . Najstaršej Pravdy s protivarjažskými nepokojmi .	protivarjažskými	13	Ins
Osvetovú kampaň Nádej pre život podporili Svetová zdravotnícka organizácia , minister zdravotníctva , Slovenská geriatrická a gerontologická spoločnosť , Slovenská lekárska spoločnosť , Slovenská internistická spoločnosť a Slovenská kardiologická spoločnosť .	gerontologická	16	Nom
Krútiace sa duše mŕtvych stiahli pána podsvetia medzi seba .	Krútiace	0	Nom
Boli to dvaja muži v civilnom obleku .	civilnom	5	Loc
Nadpisy , nájdené v rokoch 1898 ‐ 99 boli odtlačené do „ matríc “ z plastelíny a architektonickej hliny .	nájdené	2	Nom
Ešte mal zalepené hlasivky a nemohol rozprávať .	zalepené	2	Acc
Keďže sa prvýkrát vyskytuje počas Jaroslavovho námestníctva v Novgorode , nie je vylúčená možnosť nápodoby všemocného novgorodského vodného jaštera .	novgorodského	16	Gen
Program služieb Božích do konca školského roka	Božích	2	Gen
Zoskočili sme do mäkkej trávy .	mäkkej	3	Gen
Roztvoril dvere a odporný kyslastý zápach zvetraného piva mu vrazil do nosa .	odporný	3	Nom
Uvedené komplexy sa vyznačujú zmiešaným osídlením Slovanov s inými etnikami a tvrdošijným zachovávaním archaických prežitkov rodového zriadenia , kým mestá sú čisto slovanskými sídlami , určenými na pacifikáciu a christianizáciu kolonizovaných oblastí .	slovanskými	22	Ins
Newspeak bol oficiálnym jazykom Oceánie , vytvorený kvôli ideologickým potrebám angsocu , teda anglického socializmu .	oficiálnym	2	Ins
Potom sa všetko vyvinulo nečakaným smerom .	nečakaným	4	Ins
Možno sme tak urobili vo vzájomnom súlade .	vzájomnom	5	Loc
Navrhneme zmeny , ktoré sú nevyhnutné pre vybudovanie moderného sociálneho systému .	moderného	8	Gen
Potrebujeme ľudí , ktorí budú ochotní počúvať svojho partnera , budú dostatočne vzdelaní na to , aby dokázali zaujať jasné stanovisko k mnohým problémom súčasnosti .	jasné	19	Acc
Predkladaná publikácia je doplneným a čiastočne prepracovaným textom dizertačnej práce , ktorú som v odbore Všeobecné dejiny obhájil na jar roku 2000 na pôde Filozofickej fakulty Univerzity Komenského v Bratislave .	doplneným	3	Ins
Práve poletovala medzi bielymi jazmínovými kvetmi a nevšimla si jemnulinké a tenulinké vlákna napnuté medzi konárikmi .	tenulinké	11	Acc
Napokon vstal , tackavo a hojdavo prešiel celou , hlboko ponoril ruku do vrecka na kombinéze a s rozpačitým výrazom podal mužovi s umrlčou tvárou ufúľaný kúsok chleba .	ufúľaný	25	Acc
Napokon sa striga rozhodla , že s morskou vílou skoncuje raz a navždy .	morskou	7	Ins
Posledný szabolcsský kánon , ktorý sa venuje kláštornému životu nariaďuje opátom a mníchom , aby sa nezúčastňovali na kalendových sedeniach , ale aby prijímali oblácie ich účastníkov v kláštoroch .	kalendových	18	Loc
Asi hnedú , lenže tmavovlasí ľudia mávajú aj belasé oči .	hnedú	1	Acc
Vláda bude klásť dôraz na prehľadnosť , výkonnosť , spoľahlivosť a efektívnosť monitorovacieho a hodnotiaceho systému .	hodnotiaceho	14	Gen
O malú chvíľočku si na Mauglího miesto sadla iná opica .	malú	1	Acc
Ako som počúval otcove husle , pred očami sa mi zjavil portrét ženy z medailónu .	otcove	3	Acc
Potrebujeme ľudí , ktorí budú ochotní počúvať svojho partnera , budú dostatočne vzdelaní na to , aby dokázali zaujať jasné stanovisko k mnohým problémom súčasnosti .	mnohým	22	Dat
Súčasťou reformy verejných financií bude aj zásadné sprísnenie poskytovania štátnych záruk .	štátnych	9	Gen
V jeden z tých dní som sa vrátil k svojmu pracovnému stolu .	pracovnému	10	Dat
Na utierke ostala svetielkujúca zelená farba a na všeobecné prekvapenie stál pred nimi pavúk Karol .	zelená	4	Nom
Prívesky podobného typu boli nájdené vo vladimírskych kurganoch a v Jaroslavli .	vladimírskych	6	Loc
Rozsiahla a pomerne dobre organizovaná archeologická práca na teritóriu bývalého ZSSR , detailne zachytená v materiáloch časopisu „ Sovetskaja Archeologija “ / od roku 1990 Rosijskaja Archeologia / ho dáva k dispozícií veľké množstvo .	bývalého	9	Gen
Skupina kánonov I . ostrihomskej synody sa venuje stanoveniu obsahu bohoslužieb a príbuzným kultovým predpisom .	kultovým	13	Dat
Nepočetní mladí muži v našom prefeminizovanom ročníku boli zväčša básnici .	prefeminizovanom	5	Loc
Ďalším dôkazom samosprávy týchto plemien bola paralelná existencia novgorodského a vodského daňového okruhu v Koporí .	novgorodského	8	Gen
Dlho som býval v brečtane , ktorý rástol na záhradnom domčeku .	záhradnom	9	Loc
Spomenul si , že sedí s drevenou bábkou , na ktorej zarobí milióny .	drevenou	6	Ins
Dnes však človek nemôže mať čistú lásku alebo čistú zmyselnosť .	čistú	5	Acc
Nasledovali ďalšie veci , ktoré boli podľa Sergeja podpichovaním na Cerberovu adresu , hoci jeho meno sa tam nespomínalo .	Cerberovu	10	Acc
“ Tisíckrát sa ospravedlňujem , drahá slečna , “ povedal s predstieranou galantnosťou .	predstieranou	11	Ins
Mladým včielkam pripadal dážď spočiatku zábavný .	Mladým	0	Dat
Miestnosť bola priveľmi stiesnená , lebo všetky steny dookola podopierali nespočítateľné množstvo zaprášených rámov naukladaných jeden na druhý .	nespočítateľné	10	Acc
Vzniknutý kódex sa stáva základom tzv . Krátkej redakcie pravdy / kým kódex , vzniknutý roku 1037 v Kyjeve sa stáva základom pravdy priestrannej / .	priestrannej	23	Gen
Na zemi ležal obrázok s prasknutým rámom .	prasknutým	5	Ins
Vedel dôvod . Šírila okolo seba atmosféru hokejového ihriska , studených kúpeľov , spoločného stopovania a akejsi všeobecnej čistoty mysle .	studených	10	Gen
Zároveň svetská časť vládnúcej vrstvy prestáva mať záujem o monoteizmus vyjadrujúci myšlienku — jeden boh , jeden panovník .	vládnúcej	3	Gen
Zdôraznený je teda celoruský charakter zmätkov .	celoruský	3	Nom
V prvých troch kapitolách sa teda pokúsime o prieskum problematiky v celoruskom rámci , odhliadnuc od jemnejších miestnych odlišností .	celoruskom	11	Loc
Vláda bude i naďalej venovať sústredenú pozornosť podpore efektívnych programov boja proti drogám .	sústredenú	5	Acc
Pod gaštanom stálo niekoľko stolov a stoličiek a za živým plotom presvitala tehlová budova hostinca .	tehlová	12	Nom
Vysoko na oblohe uprostred jasných hviezd žiaril guľatý mesiac .	jasných	4	Gen
V nasledujúcej chvíli nastal obrovský rozruch .	nasledujúcej	1	Loc
Vtedy nás poslali na brigádu do Jonufëru pri Vlore , kde sme mesiac budovali terasové polia .	terasové	14	Acc
Aladin začal byť netrpezlivý .	netrpezlivý	3	Nom
Toto , spolu s predchádzajúcou svätoštefanskou právnou normou , dobre korešponduje s popisovaným výnimočným postavením uhorského kráľa v krajinskej cirkvi .	výnimočným	13	Ins
Prvý , druhý , tretí aj štvrý odkaz mi nechala Blythe a zneli čoraz rozčúlenejšie .	štvrý	6	Acc
V Gregorovom ponímaní by to znamenalo komendovanie Uhorska sv . Petrovi , ktorého nástupca by vládcovi krajiny udelil kráľovskú korunu .	Gregorovom	1	Loc
Po drevenom schodišti som zišiel do salóna na prízemí .	drevenom	1	Loc
Nestrácal som čas a priložil som oko k škáre v podlahovej doske .	podlahovej	10	Loc
Musí to byť nejaký starý známy , uvažoval som .	starý	4	Nom
Všetci len oddychovali pod slnečníkmi z ďatelinových lístočkov .	ďatelinových	6	Gen
Dôvodom bol práve nevyriešený problém umiestnenia štyri metre vysokého súsošia sv . Cyrila a Metoda v Komárne .	nevyriešený	3	Nom
Namiesto neho som objavil dve nečakané veci : svadobné šaty aj s vencom a fotografiu akejsi ženy .	svadobné	8	Acc
Makroekonomika a verejné financie	verejné	2	Nom
“ Predstavujem si , ako prekonávam krajský rekord v prsiach , “ vysvetľoval mi .	krajský	6	Acc
Dal priniesť koše kvetov , podnosy so sladkými včelími špicmi a jazmínové koláčiky .	včelími	8	Ins
Preskúmal jej dlhé prsty , pekne vytvarované nechty , dlaň zatvrdnutú ťažkou prácou s množstvom mozoľov , hladkú pokožku pod zápästím .	ťažkou	11	Ins
Zlý stav pečate znemožňuje podrobnejšiu analýzu .	podrobnejšiu	4	Acc
Makovej lúky sa totiž chceli zmocniť lúpežné mravce .	Makovej	0	Gen
Protiprávna vojna v Iraku , ktorú rozpútala nesvätá aliancia náboženských fundamentalistov , megalománov a kšeftárov , je cynickým výsmechom všetkých hodnôt , ktoré naša západná civilizácia pokladá za nedotknuteľné .	Protiprávna	0	Nom
Prežila dobrodružnú a namáhavú noc .	namáhavú	3	Acc
Celá táto história bola trochu zamotaná .	zamotaná	5	Nom
Na takomto mieste prelínania sa dvoch kultúr sa ľahšie uchovávajú archaické prežitky .	archaické	10	Nom
Jeden sa volal Plné gate .	Plné	3	Nom
Opäť som zmenil názor , k čomu ma priviedlo niečo neočakávané .	neočakávané	10	Nom
Mladým som vyrozumel z tváre , že ani oni sa dobre nevyspali .	Mladým	0	Dat
Vtedy bola zároveň jedným z hlavných nástrojov , vďaka ktorému udržiavali ľudské spoločnosti kontakt s hmotnou skutočnosťou .	hmotnou	15	Ins
Brat kantor pre vážne osobné dôvody nemohol prísť , preto brat farár sprevádzal nábožný spev na gitare spolu s mládežníkmi , ktorí poslúžili programom a vystúpili aj s osobným vyznaním .	nábožný	13	Acc
" My sme mŕtvi , " povedal .	mŕtvi	3	Nom
V ústach cítil lepkavú a odpornú pachuť .	odpornú	5	Acc
Svetové ríše , silné krajiny , politické systémy vznikajú a zanikajú , nič netrvá večne .	Svetové	0	Nom
Vláda považuje štíhlejší , funkčnejší a menej náročný verejný sektor za nevyhnutnú podmienku úspešnej správy vecí verejných .	štíhlejší	2	Acc
Vchádzala na parkovacie miesto , kde trhane zastala .	parkovacie	2	Acc
Celý zvyšok predpoludnia sa mu pracovalo veľmi ťažko .	Celý	0	Acc
Prvý z nich bol Zhlúpnutý Sokrates .	Zhlúpnutý	4	Nom
Predkladaná publikácia je doplneným a čiastočne prepracovaným textom dizertačnej práce , ktorú som v odbore Všeobecné dejiny obhájil na jar roku 2000 na pôde Filozofickej fakulty Univerzity Komenského v Bratislave .	prepracovaným	6	Ins
Jej pohľad nebol vyčítavý .	vyčítavý	3	Nom
Nechodieval k nemu nikto okrem stareny v širokých nohaviciach .	širokých	7	Loc
Zdôrazňoval pritom výsadné postavenie apoštolom Petrom založenej rímskej cirkvi a Apoštolského stolca .	založenej	6	Gen
Vybudovanie environmentálnej infraštruktúry je nevyhnutnou podmienkou pre vstup do EÚ .	nevyhnutnou	4	Ins
Aladina raz z Rahimovho obchodu vyhnali , keď sa Abu usiloval chvostom potiahnuť trs banánov .	Rahimovho	3	Gen
Winston vyzrel von spoza mušelínovej záclony , ktorá ho bezpečne skrývala .	mušelínovej	4	Gen
Vláda prijme opatrenia , ktoré zabránia možnosti subjektívneho rozhodovania štátneho zamestnanca vo všetkých oblastiach podnikania .	subjektívneho	7	Gen
Cirkevnoprávne zbierky naproti tomu obsahujú iba všeobecne formulované zákazy nedeľnej práce bez udania sankcií .	nedeľnej	9	Gen
Znak potom môžme vykladať ako zobrazenie vtáka s roztiahnutými krídlami a hlavou vysunutou dopredu .	roztiahnutými	8	Ins
Vláda bude i naďalej venovať sústredenú pozornosť podpore efektívnych programov boja proti drogám .	efektívnych	8	Gen
Vyzeráte úžasne ! “ vravel trom zošúvereným babizniam .	zošúvereným	6	Dat
Zapojte sa aktívne do zborového života , príjmite pozvanie mládeže , navštevujte tento chrám , prichádzajte k Večeri Pánovej .	Pánovej	18	Dat
Prijatie novely zákona o štátnej službe umožní okrem iného zamestnanie špičkových odborníkov v ústredných štátnych orgánoch za adekvátneho mzdového ohodnotenia a odstráni nepružnosť zamestnávania v štátnej službe .	štátnych	14	Loc
Slovenská republika sa zapojí do snáh medzinárodného spoločenstva zameraných na riešenie globálnych problémov , ako sú boj proti organizovanému zločinu , medzinárodný terorizmus , ekologické riziká .	zameraných	8	Gen
Na okraje slohového zošita mi písal ľúbostné odkazy , alebo ma chcel bozkávať , kým som čítala .	ľúbostné	6	Acc
Vtom sa vrátil chrobák Truhlík aj so svojím filmovým časopsom .	filmovým	8	Ins
Zišlo mu na um , že až doteraz ho zrejme nevidela na voľnom priestranstve v plnom dennom svetle .	voľnom	12	Loc
Bežali kľukatými cestičkami , až prišli k prijímacej sieni .	prijímacej	7	Dat
Dnes stojí súsošie bez podstavca provizórne na dvore evanjelickej fary medzi detskými preliezačkami .	detskými	11	Ins
Odjakživa som bola mamin poklad .	mamin	3	Nom
Zavedie štátnu maturitnú skúšku na stredných školách .	stredných	5	Loc
Musí byť pohodlný , viem , aby sa v ňom Lienke dobre sedelo a dobre pérovaný , aby nedostala kočovú chorobu .	pérovaný	15	Nom
ZLÁ VÍLA NETRPEZLIVO ČAKALA NA ZÁPAD SLNKA vo vlhkých tmavých rozvalinách kamenného hradu , ktorý stál na vysokom brale .	vlhkých	8	Loc
A táto skvelá žena vyšla v mojom prípade navnivoč ako maslo v psej koži .	psej	12	Loc
Podráždene meditoval o materiálnych stránkach života .	materiálnych	3	Loc
Autografy — nápisy obsahujúce predovšetkým meno píšuceho .	píšuceho	6	Gen
Aké je však jeho miesto v dnešnej kresťanskej obci ?	kresťanskej	7	Loc
Gil Mars , najbohatší muž sveta , je majiteľom počítačovej spoločnosti MarsTech , ktorá vyrába aj hračky pre deti tretieho tisícročia .	počítačovej	9	Gen
Nedovolím to ani jednému , ani druhému .	druhému	6	Dat
Už sme spomenuli , že za Ladislavovej vlády prichádza k postupnej konsolidácii pomerov v krajine .	postupnej	10	Dat
V okne na prvom poschodí zbadala uväznenú cvrčicu .	uväznenú	6	Acc
Cítila som , aké má teplé dlane .	teplé	5	Acc
Za pôvodcu Otovej politiky Renovatia , ako aj jeho politiky voči krajinám ležiacim na východ od ríšskych hraníc sa pokladá Gerbert z Aurillacu .	ríšskych	16	Gen
Z balkóna utiekla , až keď som k odháňacím pohybom pridala aj hlasité zvukové efekty .	odháňacím	8	Dat
S cieľom zefektívnenia správy rozpočtových prostriedkov a správy finančných prostriedkov štátu vláda uskutoční kroky na urýchlené dobudovanie systému štátnej pokladnice .	urýchlené	15	Acc
Otvorila oči a pred sebou uvidela svätojánsku mušku Svetlanku .	svätojánsku	6	Acc
Zhlboka sa nadýchla , poriadne si vydrhla predné nohy a ostala nehybne sedieť na liste ako prikovaná .	prikovaná	16	Nom
Drobné žieňa s pieskovými vlasmi sa vrhlo na operadlo stoličky pred ňou .	pieskovými	3	Ins
Zdravotná starostlivosť a zdravotné poistenie	Zdravotná	0	Nom
“ Ten šakalí syn !	šakalí	2	Nom
Chvíľu sme stáli vo dverách , pretože nás ovalil svieži závan klimatizovaného vzduchu .	klimatizovaného	11	Gen
Nenadarmo platí " Sýty hladnému neverí " a zároveň neexistuje žiadne porekadlo typu " Ukojený nadržanému neverí " .	hladnému	4	Dat
Starcova pamäť bola len kopa bezcenných detailov .	bezcenných	5	Gen
“ Vidíš tú maličkú žltú hviezdu ?	žltú	4	Acc
Lavdim Lavdoshaj sa konečne rozhodol , že mi uverejní jednu poviedku v poslednom septembrovom čísle .	septembrovom	13	Loc
S úsmevom vstal a oprašoval si zodraté , vyblednuté levisky .	vyblednuté	8	Acc
Herkules prišiel do podsvetia vo chvíli , keď Megina duša vošla do Hádesovej jaskyne smrti .	Hádesovej	12	Gen
Zlej víle pohrával na červených perách zlovestný úsmev .	Zlej	0	Dat
Zrejme nepostrehol Winstonovu belasú kombinézu .	belasú	3	Acc
Odložil som pohár a očami som opäť zablúdil k protiľahlým stolom , pri ktorých sedeli spomínaní ľudia .	protiľahlým	9	Dat
Musí sa veľa učiť a Kasandrinou úlohou bolo vychovať ju a pripraviť na život včely .	Kasandrinou	5	Ins
Komárno nechce Cyrila a Metoda na verejnom priestranstve	verejnom	6	Loc
Spomínaní clunyjskí opáti boli osobnosťami s mimoriadnymi osobnostnými kvalitami a veľkou morálnou autoritou .	osobnostnými	7	Ins
Skvelá novinka pre fanúšikov hororej klasiky z roku 1973 .	Skvelá	0	Nom
Beztak tie pracovité mravce nemohol ani cítiť .	pracovité	2	Acc
Pocítil som na hrudi tlak jej pevných okrúhlych pŕs .	pevných	6	Gen
Vzájomné porovnanie takto vytvorených jednotiek umožní plastickejší pohľad na danú problematiku a odhalí nové súvislosti dávno známych faktov .	plastickejší	6	Acc
Popri Rostove bol druhým , konkurečným centrom krajiny a v nasledujúcich storočiach zatienil jeho vplyv .	konkurečným	5	Ins
Pre potreby rozvíjajúcej sa cirkevnej organizácie bol na základe tohto štatútu okolo roku 1100 vytvorený štatút nový , ktorý sa stal základným archetypom pre všetky neskoršie odpisy .	cirkevnej	4	Gen
Jeho meno vzniklo od chlpatosti silných mužov , vodcov .	silných	5	Gen
Jeho zbierka totiž , podľa nás , predstavuje prechodný typ cirkevnoprávnej zbierky , ktorý stojí medzi cirkevnoprávnymi zbierkami vzniknuvšími v období dominancie germánskeho práva a zbierkami reformnými , ktoré sú predstupňom diel klasickej kánonistiky .	vzniknuvšími	18	Ins
Ďalšou decentralizáciou verejných financií vláda vytvorí na úrovni obcí lepšie podmienky pre napĺňanie miestnej bytovej politiky .	bytovej	14	Gen
Správu aktív bude v tomto systéme zabezpečovať súkromný sektor , výber správcu bude v plnej kompetencii občana .	plnej	14	Loc
Zaslané médium vám vrátime spolu s vyvolanými fotkami .	Zaslané	0	Acc
Nedokázala som urobiť jedinú slušnú obrátku .	slušnú	4	Acc
Dal im zvláštnu ponuku .	zvláštnu	2	Acc
Táto povinnosť sa však nevzťahovala na produkty , ktoré sa jednak priamo a jednak symbolicky týkali základných prejavov kresťanského kultu .	základných	16	Gen
Bolo to účinnejšie ako putá .	účinnejšie	2	Nom
Asi verili svojim po zuby ozbrojeným bojovníkom , pred ktorými sa všetci trasú .	ozbrojeným	5	Dat
Ich vystúpenie malo náramný úspech .	náramný	3	Acc
Stráca svoj vidiecky a náboženský charakter a stáva sa mestskou a svetskou .	mestskou	9	Ins
Uhorskí zákonodarcovia vytvárali zákony a kánony v prvom rade s ohľadom na konkrétne domáce podmienky a snaženia reformátorov boli pre nich druhoradé .	Uhorskí	0	Nom
Gregor VII . , aby toto presvedčenie ešte zdôraznil a aby mohol vyžadovať poslušnosť od uhorských kráľov , vytvoril konštrukciu o Štefanovom komendovaní krajiny sv . Petrovi .	Štefanovom	21	Loc
“ Slávna trojka opäť v akcii .	Slávna	1	Nom
Navyše sú nepoužiteľné vzhľadom na tlačiarenskú farbu , ktorá môže nepríjemne poškodiť istú chúlostivú časť tela .	tlačiarenskú	5	Acc
Vzdelanie sa stáva kľúčom k životnému úspechu , najlepšou investíciou do budúcnosti , účinnou prevenciou pred nezamestnanosťou , zločinnosťou , drogami .	najlepšou	8	Ins
Cieľom fiškálnej politiky vlády bude zníženie podielu verejného dlhu na hrubom domácom produkte počas volebného obdobia .	verejného	7	Gen
Najvýraznejšie sa prvky predkresťanských systémov prejavil v severoruských oblastich .	severoruských	7	Loc
Lietajúca lavica ?	Lietajúca	0	Nom
Prebehli sme okolo nich a prešmykli sa dozadu k dvojmetrovému múru .	dvojmetrovému	9	Dat
Do slovenských častí Uhorska sa vtedy utiahla jedna časť českých emigrovaných protestantov a tu našli v používaní svoj vlastný spisovný jazyk presne tak , ako vo svojej českej vlasti .	českej	27	Loc
Zabili ho spolu s ďalším odsúdencom pri pokuse o útek z väzenia .	ďalším	4	Ins
Netrvalo dlho a vedľa nej sa pod veľkým černicovým kríkom zjavil tučný svetlohnedý pavúk .	svetlohnedý	12	Nom
Na líci sa nachádza ruža so štyrmi lupienkami , obkolesená zložitou dekoratívnou obrubou .	zložitou	10	Ins
V ten deň som zaplávala osobný rekord .	osobný	5	Acc
V šalátovej mise zmiešajte olej , korenie , soľ , uhorku , cibuľu , petržlenovú vňať a bazalku .	šalátovej	1	Loc
Vytvoríme kapitálotvornú vrstvu , ktorá bude zárukou blaha ľudu , presvedčivo hlásal tvorca blaha svojich prívržencov .	kapitálotvornú	1	Acc
Škola sa musí stať v regióne kultúrnym , športovým a spoločenským centrom obecnej komunity .	spoločenským	10	Ins
Cieľom rekodifikácie trestného práva bude prísnejší postih páchateľov násilných trestných činov a moderný trestný proces , ktorý bude rýchly a efektívny .	prísnejší	5	Nom
Napriek tomu nerob unáhlené závery .	unáhlené	3	Acc
Najprv vybojovali pri brehu víťaznú vodnú bitvu .	víťaznú	4	Acc
Svätoštefanská legislácia predpokladá , že veriaci budú v nedeľu chodiť do kostola .	Svätoštefanská	0	Nom
Šéf vypustil dušu vo chvíli , keď dosiahol orgazmus , a ona sa nemohla zbaviť prežitej hrôzy .	prežitej	15	Gen
“ TUŠÍM MÁŠ DOBRÚ NÁLADU , “ podozrievavo povedala mama , keď som sa ponúkla , že jej umyjem auto , kým pôjde do práce .	DOBRÚ	3	Acc
Vláda upraví rámcové podmienky regionálneho rozvoja decentralizáciou verejných financií a zavedie nový , efektívnejší systém finančného vyrovnávania sociálno - ekonomických rozdielov vyšších územných celkov .	regionálneho	4	Gen
Zistil som však , že nie som schopný písať v humornom duchu .	humornom	10	Loc
Pozostáva z krátkych pasáží o jednotlivých mníchoch , v ktorých sa neopakovateľným spôsobom preplieta fantastika s reálnym videním sveta .	reálnym	16	Ins
Tento národ teda kládol zúrivý odpor kolonizačným snahám ruských kniežat .	kolonizačným	6	Dat
Si smiešny . “	smiešny	1	Nom
Chris sa zasmial a pomrvil sa na tvrdých hranatých škridlách .	hranatých	8	Loc
Jediným mávnutím zázračnej palice premenil reťaze na zlatú korunku .	Jediným	0	Ins
Na ôsmich tenkých chlpatých nohách spočívalo nemotorné telo a na ňom trónila malá hlava .	tenkých	2	Loc
Bol v cele bez okien , s vysokým stropom a so stenami z lesklého bieleho porcelánu .	bieleho	14	Gen
Rutherford mal mohutnú postavu , hrivu mastných , sivých vlasov , zjazvenú tvár s vačkami pod očami a hrubé negroidné pery .	sivých	8	Gen
Osobitnú pozornosť bude vláda venovať vytváraniu podmienok pre činnosť Hasičského a záchranného zboru ako základnej zložky integrovaného záchranného systému .	základnej	14	Gen
“ Tomuto ja hovorím najpotrebnejšie veci , “ výsmešne škriekala opica .	najpotrebnejšie	4	Nom
Niekedy jej rozprával o Oddelení záznamov a o nehanebných falzifikátoch , ktoré v ňom fabrikuje .	nehanebných	8	Loc
Ženskú časť tejto tretej delegácie tvorili ženy v prechode .	tretej	3	Gen
Celý personál ministerstva postupoval rovnako .	Celý	0	Nom
Slovenská republika sa nachádza v tomto globálnom bezpečnostnom prostredí .	bezpečnostnom	7	Loc
Mal dlhý kabát , zdvihnutý golier , okuliare so strieborným rámom , červenastú tvár a husté šedivé vlasy .	šedivé	16	Acc
O chvíľu sa pri nej s hlasným bzučaním usadil komár .	hlasným	6	Ins
Krtko prečesával ľan až z neho vyčesal jemné vlákna .	jemné	7	Acc
“ Určite je to lepšie ako tu , “ vravel Aladin zahĺbený do vlastných myšlienok .	zahĺbený	11	Nom
Ďalšie zasadnutie zborového presbyterstva sa konalo dňa 16 . 5 . 2004 .	zborového	2	Gen
Chodbu , po ktorej ich viedol , pokrýval jemný koberec , na stenách boli krémové tapety , biele drevené obloženie , všetko neskutočne čisté .	drevené	18	Nom
Koordináciu európskej politiky štátu ako súčasti zahraničnej politiky bude zabezpečovať MZV SR v úzkej spolupráci s ostatnými ústrednými orgánmi štátnej správy .	úzkej	13	Loc
V kolíske bolo zvláštne bábätko bez srste .	zvláštne	3	Nom
Konkrétnym príspevkom k prevencii konfliktov a k udržaniu mieru bude aj naďalej aktívna účasť v medzinárodných mierových operáciách .	mierových	16	Loc
Medzi Ladislavovými zákonmi máme cirkevnú sankciu doloženú v prípade zabitia nevernej ženy a znásilnenia .	cirkevnú	4	Acc
Súviselo to jednak s už spomenutým rozvinutým fungovaním systému vlastníckych kostolov a kláštorov a jednak s existenciou otónsko - sálskeho ríšskeho cirkevného systému v Nemecku .	spomenutým	5	Ins
Prítomný je celý panteon vladimírovej pohanskej reformy .	vladimírovej	4	Gen
Symbolika kniežacieho znaku .	kniežacieho	1	Gen
Vláda prehodnotí doterajší spôsob podpory malého a stredného podnikania s akcentom na územnú samosprávu a prihraničnú spoluprácu .	doterajší	2	Acc
Tá relácia , i keď varovala pred známymi dôsledkami zbožšťovania jedla , ma definitívne presvedčia o tom , čo som už dávnejšie tušil .	známymi	7	Ins
Tento komplex otázok – teda vzťah uhorskej cirkvi ku tzv . gregoriánskej reforme tvorí širší rámec našej práce .	širší	14	Acc
Strana má vždy patent na absolútnu pravdu a je jasné , že absolútno nemohlo byť nikdy iné , než je teraz .	absolútnu	5	Acc
Vtedy sa prítomným naskytol pohľad na Gimov obrovský penis .	obrovský	7	Acc
Zaujímavú skupinu tvoria vyobrazenia s rastlinnými motívmi .	Zaujímavú	0	Acc
Peter vyšiel z hriešnej spoločnosti .	hriešnej	3	Gen
Je to jedno z tých zaujímavých slov , ktoré majú dva protikladné významy .	zaujímavých	5	Gen
Pozostáva z krátkych pasáží o jednotlivých mníchoch , v ktorých sa neopakovateľným spôsobom preplieta fantastika s reálnym videním sveta .	neopakovateľným	11	Ins
Stráca svoj vidiecky a náboženský charakter a stáva sa mestskou a svetskou .	náboženský	4	Acc
Vláda sa zaväzuje v praxi realizovať už schválenú dikciu Európskej charty regionálnych alebo menšinových jazykov .	schválenú	7	Acc
Väčšina neskorších bádateľov sa uspokojila s jednoduchým reprodukovaním tohto zistenia .	jednoduchým	6	Ins
Trestajúci boh ním vládne	Trestajúci	0	Nom
Rutherford mal mohutnú postavu , hrivu mastných , sivých vlasov , zjazvenú tvár s vačkami pod očami a hrubé negroidné pery .	negroidné	19	Acc
Popoludní o tretej sa začínali Majstrovstvá Makovej lúky v skákaní .	tretej	2	Loc
Vláda bude hľadať spôsoby legislatívnej úpravy , aby v Národnej rade SR neboli prijímané zákony s nekrytými rozpočtovými dôsledkami .	nekrytými	16	Ins
Vzájomné porovnanie takto vytvorených jednotiek umožní plastickejší pohľad na danú problematiku a odhalí nové súvislosti dávno známych faktov .	vytvorených	3	Gen
Tak je po Jaroslavovom víťazstve položený základ novgorodských výsad , ktorí Novgorodcom garantujú ochranu pred kniežacími družiníkmi a Varjagmi / no zároveň zabezpečujú kniežaciu družinu pred ľudom / .	kniežacími	15	Ins
Tri uvedené stupne výskumu nás vedú ku konštatovaniu , potvrdzujúcemu úvodnú tézu o tesnej prepletenosti oboch systémov , obohatenému však poznaním vnútornej dynamiky jej vývoja .	obohatenému	18	Dat
Mimoriadne príjemným spestrením je izolácia od terénnych nerovností .	terénnych	6	Gen
Sopky vreli , vyčíňali búrky a zemetrasenia , svet bol plný zmätku a veľkého zdesenia .	veľkého	13	Gen
Rýchlo vyčarila drevený kolovrátok so zradným zeleným vretenom .	zradným	5	Ins
A s týmito neskutočnými útrapami v duši . . .	neskutočnými	3	Ins
Bolo tu pododdelenie televíznych programov s inžiniermi , producentmi a s celými tímami špeciálne vybraných hercov , lebo dokázali imitovať hlasy .	celými	11	Ins
Zrejme mala akúsi praktickú ostrieľanosť , ktorá Winstonovi chýbala a podľa všetkého vďaka nespočítateľným spoločenským výletom výborne poznala okolie Londýna .	nespočítateľným	13	Dat
Podľa Irminých pokynov – samotná Irma vybavovala všelijaké formality – ma poprosili , aby som odišiel z domu a vrátil sa podľa možnosti až večer .	samotná	4	Nom
O chvíľu ich už viedli k najlepšiemu stolu v záhrade Amirovej slávnej reštaurácie Kebab .	slávnej	11	Gen
Chcela som zaplniť ticho , čo medzi nami zavládlo , a tresla som parádnu hlúposť .	parádnu	13	Acc
Keď prehovoril , bolo to v ľahkom , konverzačnom tóne .	konverzačnom	8	Loc
Fridolín bol malý hnedý chlapík so silným náprsným štítom a krátkymi krovkami .	krátkymi	10	Ins
Amaris zdvihla parádny ružový šašovský kostým .	kostým	5	Ins
Mala Lizine oči .	Lizine	1	Acc
Strategickým cieľom SR je členstvo v EÚ .	Strategickým	0	Ins
Zachvátil ma jeden z mojich depresívnych stavov a prepadol som sa do hlbín absurdnosti .	depresívnych	5	Gen
Zapojte sa aktívne do zborového života , príjmite pozvanie mládeže , navštevujte tento chrám , prichádzajte k Večeri Pánovej .	zborového	4	Gen
Skúste siahnuť po nejakej knižnej novinke , zoznam nájdete v Knižnom katalógu .	Knižnom	10	Loc
Jej román Vášeň je však skvelý .	skvelý	5	Nom
Bežala k otvorenému oknu .	otvorenému	2	Dat
Začínali sa aj pochôdzky chlapa v zelenom vojenskom kabáte .	zelenom	6	Loc
V náprotivnej stene bol pamäťový otvor .	náprotivnej	1	Loc
Amaris zdvihla parádny ružový šašovský kostým .	ružový	3	Nom
Blythe má dlhé lesklé plavé vlasy a bohovskú postavu .	bohovskú	7	Acc
V oblasti vodného hospodárstva bude vláda legislatívnymi a organizačnými opatreniami zabezpečovať racionalizáciu a efektívnosť pôdohospodárskych činností .	organizačnými	8	Ins
Medzitým som zanechal poéziu , v severnom i v južnom nárečí .	severnom	6	Loc
Pôjde najmä o precíznejšiu personálnu prácu , efektívnejšie využitie ich vlastných kontrolných a inšpekčných mechanizmov , ale tiež o uplatňovanie nových špecifických protikorupčných postupov .	kontrolných	11	Gen
Na Makovej lúke bolo plno národa .	Makovej	1	Loc
Potom som stlačil kľučku na dverách vedúcich do Profesorovej izby .	vedúcich	6	Loc
V prípade , ak si poslanci odsúhlasia platených sekretárov , môže sa stať , že " Ringom Čechom " budú poslanci a efekt bude mať sekretár .	platených	7	Acc
Herkules skočil do jaskyne smrti , aby zachránil Meginu dušu , a z mládenca sa razom stal starec na pokraji smrti .	Meginu	8	Acc
Morská víla a smrteľné nebezpečenstvo	smrteľné	3	Nom
V nasledujúcej chvíli nastal obrovský rozruch .	nasledujúcej	1	Loc
Ako sedemnásťročný sa stal okresným zakladateľom Antisexuálnej ligy mládeže , ako devätnásťročný navrhol nový druh ručného granátu , ktorý zaradilo do výzbroje Ministerstvo mieru a ktorý už pri prvej skúške jediným výbuchom zabil tridsaťjeden euroázijských zajatcov .	euroázijských	34	Gen
Reformátori 11 . storočia však už dospeli k precíznejšej formulácii , ktorá , podľa nás , reprezentuje nimi presadzovanú snahu o čo najpresnejšie vymedzenie sfér vplyvu svetskej a cirkevnej moci .	svetskej	26	Gen
Pretekáme s tromi dobrými plavkyňami z Octilla , a mňa tu deptá vlastná kolegyňa .	dobrými	3	Ins
Tú báseň som napísal v štvrtej triede základnej školy , chcel som napodobniť jedného básnika , ktorý bol otcovým priateľom .	otcovým	18	Ins
S hrdinským úsmevom povedala , že uvíta každú kritickú pripomienku , lebo doteraz jej nikto nič konkrétne nepovedal .	hrdinským	1	Ins
Ukazuje sa teda , že tým stredoslovenským nárečím , ktorÉ Štúrovci povýšili na spisovný JAZYK , bol prestížny liptovský mestský jazyk .	stredoslovenským	6	Ins
Odtrhol som lesnú jahodu a položil ju ku kamennému prístrešku .	lesnú	2	Acc
Mestské zastupiteľstvo schválilo umiestnenie menších sôch šiestich patrónov Európy na Nádvorie Európy , ktoré je vo výstavbe .	menších	4	Gen
“ Pochodujeme naprieč celým územím ! “	celým	3	Ins
Slnečný svit , ktorý prenikal nespočetným lístím , ich ešte stále pálil na tvárach .	Slnečný	0	Nom
Vážka , čo krúžila vysoko nad čistinou , ponúkala vyhliadkový let .	vyhliadkový	9	Acc
S ťažkým srdcom sa Herkules lúčil s rodičmi a oni ho s ťažkým srdcom púšťali .	ťažkým	12	Ins
Počula som tikanie nástenných hodín a vlastný dych .	vlastný	6	Acc
Veď je to cesta plná rôznych prekážok , zvodov a pokušení .	plná	4	Nom
Súviselo to jednak s už spomenutým rozvinutým fungovaním systému vlastníckych kostolov a kláštorov a jednak s existenciou otónsko - sálskeho ríšskeho cirkevného systému v Nemecku .	sálskeho	19	Gen
Spomenul som si na dve veci : na hysterickú eufóriu učiteľov po incidente , pri ktorom sa spomenulo meno mytologického božstva záhrobného sveta .	záhrobného	21	Gen
Osobitnú pozornosť bude vláda venovať vytváraniu podmienok pre činnosť Hasičského a záchranného zboru ako základnej zložky integrovaného záchranného systému .	integrovaného	16	Gen
“ Chyť volant , “ povedal a otočil sa k zadnému sedadlu , kde mal športový vak .	zadnému	10	Dat
Jeho prítomnosť vnáša do útvaru už spomenuté prvky hrdinskej epiky — mýtický boj za odstránenie chaosu sa mení na ochranu štátu a viery proti cudzím pohanom .	cudzím	24	Dat
Bol symbolom dažďa a jeho životodarnej , plodivej sily .	životodarnej	5	Gen
Nemajú čas ani myseľ na spory , ktoré by mohli vyplynúť z ich odlišných vyznaní .	odlišných	13	Gen
Bez Ducha Svätého nebudeme schopní ničoho .	Svätého	2	Gen
Za pôvodcu Otovej politiky Renovatia , ako aj jeho politiky voči krajinám ležiacim na východ od ríšskych hraníc sa pokladá Gerbert z Aurillacu .	Otovej	2	Gen
Teda je prirodzené , že zobrazenia dračích papúľ sú na novgorodských pamiatkach mimoriadne časté .	novgorodských	10	Loc
Vtedy vyšla moja KNIHA Paradigmatika spisovnej ruštiny , ktorá sa stala celoštátnou univerzitnou učebnicou ruskej TEORETICKEJ morfológie .	univerzitnou	12	Ins
Dom bol v predstave vtedajších ľudí akýmsi mikrokozmom , svetom samým osebe s prepracovaným systémom magickej obrany pred zlými silami vonku .	zlými	18	Ins
Zlej víle ostávala posledná nádej — havran .	Zlej	0	Dat
Na príjazdovej ceste pred Taco Villa stál dlhočizný rad áut , v ktorých sedeli decká z našej školy .	príjazdovej	1	Loc
Prišiel na to niekto iný : Zelené oči .	Zelené	6	Nom
Miznem v temnej priepasti , v roztvorených ústach pohlcujúcich rieku času .	roztvorených	6	Loc
Istým spôsobom sa mi tam oddávala , v sále bábkového divadla .	bábkového	9	Gen
Pomsta je sladká	sladká	2	Nom
Dlho sedela na kraji lesa a pozerala , ako zlaté klasy zľahka povievajú v letnom vánku .	letnom	14	Loc
Konkrétnym formám tohto boja za slobodu cirkvi počas reformy sa budeme venovať neskôr .	Konkrétnym	0	Dat
Začiatkom 11 storočia bolo pomerne málo významným sídlom — nespomína sa napr . pri delení údelov Vladimírovým synom .	Vladimírovým	16	Dat
Chcela zistiť , odkiaľ pochádza tá zvláštna neznáma hudba .	zvláštna	6	Nom
Jeho kláštor musel mať dobrú povesť , lebo ako lotrinský vojvoda , tak aj flámsky markgróf mu odovzdali viaceré kláštory , aby v nich obnovil rehoľný život podľa reformných princípov .	dobrú	4	Acc
Moje oči márne hľadali pri okne so železnými prútmi nejaký rám s oficiálnym portrétom .	železnými	7	Ins
Nemal som zvlášť dobrý dojem .	dobrý	3	Acc
Nateraz sa uzavrel pred vzdialenejšími zvukmi a počúval len kvákanie , ktoré sa valilo z obrazovky .	vzdialenejšími	4	Ins
Uršuľa sa usmievala , keď princa ťahali na morské dno .	morské	8	Acc
Toto , spolu s predchádzajúcou svätoštefanskou právnou normou , dobre korešponduje s popisovaným výnimočným postavením uhorského kráľa v krajinskej cirkvi .	predchádzajúcou	4	Ins
Na rube sa nachádza postava vcelku s vladárskou korunou , kopiou a štítom , obkolesená zrkadlovým gréckym nápisom „ Dimitrij “ .	gréckym	16	Ins
Na Sibíri bol medveď ústredným hrdinom zvieracieho eposu .	ústredným	4	Ins
Od tejto chvíle si môžete ľubovoľne vytvárať fotoalbumy s neobmedzeným počtom fotiek .	neobmedzeným	9	Ins
V ranoarpádovských zákonníkoch nachádzame aj ustanovenia o Božích súdoch , iracionálnom dôkaznom prostriedku , ktorý sa v stredovekom súdnom konaní hojne aplikoval .	dôkaznom	11	Loc
Vytieňoval lícne kosti a tmavé obočie .	lícne	1	Acc
V kinematografickom období môjho života mi to hovorili všetci .	kinematografickom	1	Loc
Si euroázijský špión !	euroázijský	1	Nom
Táto činnosť , čiže roztrhanie lístka a jeho likvidácia , bola zbytočná .	zbytočná	11	Nom
Na jeho ľavom konci bola stará studňa bez vody , pred studňou rástla marhuľa .	stará	5	Nom
Vo svojom blaženom sne Winston nevenoval nijakú pozornosť tomu , že mu nalieva pohár .	blaženom	2	Loc
Pripravovali sme definitívne vydanie Kiplingovho básnického diela .	Kiplingovho	4	Gen
Pred mojím duševným zrakom sa čosi zablyslo .	duševným	2	Ins
Má netradičnú grafickú podobu a svojimi malými rozmermi sa zmestí do každej tašky a ku každému počítaču .	netradičnú	1	Acc
Zastali sme na červenú a Chris sa na mňa usmial .	červenú	3	Acc
Kláštory a ich opáti sú tu podriadení diecéznym biskupom , ktorých povinnosťou je kláštory často vizitovať .	diecéznym	7	Dat
PREČ S VEĽKÝM BRATOM !	VEĽKÝM	2	Ins
Takže ak sa myšlienky zorganizovať rockový festival chytí skúsenejší organizátor , veríme , že festival , ktorému je dedina a ľudia v nej naklonení , sa bude znova konať .	rockový	5	Acc
Roztvoril dvere a odporný kyslastý zápach zvetraného piva mu vrazil do nosa .	zvetraného	6	Gen
Vznikla v tretej štvrtine 11 . storočia ( medzi rokmi 1050 – 1076 ) a bola určená na používanie v rímskej kúrii a pre pápežských legátov .	určená	16	Nom
Slovenská republika sa nachádza v tomto globálnom bezpečnostnom prostredí .	globálnom	6	Loc
Postupne sa zdvíhanie a klesanie ich hrudí spomalilo a prešlo do normálneho rytmu a s príjemným pocitom bezmocnosti sa od seba oddelili .	príjemným	15	Ins
Kresťanská cirkev nemala v prvom storočí svojej existencie nejaký jednotný právny systém .	právny	10	Acc
Na okraji makového poľa sedel motýľ s malým oranžovým cylindrom na hlave .	malým	7	Ins
Naším zámerom je odstrániť najmä deformácie , ktoré zakladajú neopodstatnené nerovnosti medzi občanmi alebo zavádzajú do sociálneho systému cudzorodé prvky , akým je napríklad nesystémové včlenenie kúpeľnej starostlivosti do sociálneho poistenia .	sociálneho	29	Gen
Vláda však v tejto súvislosti zastáva názor , že NATO i naďalej zostane hlavnou inštitúciou , prostredníctvom ktorej budú európski a severoamerickí spojenci i naďalej riešiť bezpečnostné otázky transatlantického rozmeru .	európski	19	Nom
V konečnom dôsledku je takto ohrozené spasenie veriaceho ľudu .	veriaceho	7	Gen
Vraj pri takých veľkonočných oblievačkách chlapci najviac a najčastejšie oblievali najkrajšie dievčatá z dediny .	veľkonočných	3	Loc
Tá epizóda mohla mať len jediný zmysel .	jediný	5	Acc
Nočným ovzduším sa nieslo vzrušenie .	Nočným	0	Ins
Zároveň sa pred mojím duševným zrakom naraz objavilo dievčatko .	duševným	4	Ins
Keď vystúpila z pásma žltkastého svitu a na chvíľu zastala na rozhraní medzi svetlom a temnotou , nemyslel som na to , že ide priamo ku mne , aby napravila chybnú interpretáciu vecí , ktorú vyprodukoval môj mozog .	chybnú	30	Acc
Jazmína sa vyštverala na vysokánsky štíhly kmeň jednej z najvyšších datľových paliem v kráľovskej záhrade .	kráľovskej	13	Loc
Všetci traja sme sa hystericky rehotali na pozadí čudných tropických rastlín v plastových črepníkoch .	plastových	12	Loc
Pred voľbami bolo – v neposlednom rade v Mostoch – mnoho krásnych vzletných výkladov , prečo treba voliť Martina Bútoru .	vzletných	12	Gen
Vláda vytvorí legislatívne a ekonomické podmienky pre ochranu a sprístupnenie audiovizuálneho dedičstva v súlade s príslušnými medzinárodnými dohovormi .	medzinárodnými	16	Ins
Dochádza k revitalizácií pohanstva v bojarských kruhoch .	bojarských	5	Loc
“ Určite ťa zaskočila moja výnimočná krása , “ zašveholilo .	výnimočná	5	Nom
Touto syntézou môžme vysvetliť mnohé osobitosti hospodárskeho i politického života oblasti .	hospodárskeho	6	Gen
A zvolil som ten najdrsnejší spôsob .	najdrsnejší	4	Acc
Kým odletím do nebeského pekla , musím si odčiniť nejaké hriechy tu , v pozemskom pekle .	nebeského	3	Gen
Ťahal voz dovrchu naložený melónmi .	naložený	3	Acc
A po rozlúčke s ním som mal zvláštny pocit .	zvláštny	7	Acc
Oznámili mi to raz večer aj moje postavy v slávnostných čiernych dvojradových oblekoch .	dvojradových	11	Loc
Radža je veľmi nedôverčivý .	nedôverčivý	3	Nom
A Winstona najviac deprimovalo vedomie jeho vlastnej intelektuálnej menejcennosti .	intelektuálnej	7	Gen
Podľa Marginých predstáv by som bol nemravnou ženou .	nemravnou	6	Ins
Napriek všetkému bol Aladin trochu sklamaný .	sklamaný	5	Nom
Viedli ma polámané vetvičky a udupaná tráva .	udupaná	5	Nom
Princezná Jazmína pozerala z okna do hlbokej púštnej noci .	hlbokej	6	Gen
Prvý z apoštolov patril v celom kresťanskom svete k mimoriadne uctievaným svätcom .	celom	5	Loc
Vláda považuje pružný trh práce schopný reagovať na hospodársky vývoj za nevyhnutnú podmienku znižovania nezamestnanosti .	nevyhnutnú	11	Acc
Videl , ako Júlia zodvihla pohár a privoňala k nemu s úprimnou zvedavosťou .	úprimnou	11	Ins
To bola chvíľa druhého knokdaunu .	druhého	3	Gen
V ľudských obydliach je veľa okien .	ľudských	1	Loc
Sporná je funkcia nachádzaných zobrazení ľudí .	nachádzaných	3	Gen
Robili tak skôr mocní šľachtici , usilujúci sa o odtrhnutie časti krajiny / najpríhodnejším príkladom je tu uhorské povstanie Vathu roku 1046 v Bekeszi / .	najpríhodnejším	13	Ins
Alan Smithee je meno , ktoré sa používa v titulkoch , keď ražisér z rôznych príčin nesúhlasí s uvedením vlastného mena .	vlastného	19	Gen
Samonafukovačky sa pýšia výbornými izolačnými schopnosťami , vysokým komfortom pri ležaní a neprepúšťaním vlhkosti .	vysokým	7	Ins
Pri cieli sa skrýval osiak Boris a zrkadielkom oslňoval ostatných pretekárov , len aby pomohol svojmu zmrzačenému kamarátovi zvíťaziť .	zmrzačenému	16	Dat
V polovici minulého storočia ich slávny albánsky agrárny proletariát pripravil o všetko bohatstvo .	slávny	5	Nom
Výsady sice majú formu udeľovanej listiny , no v skutočnosti ide o zmluvný zápis , tvoriaci kostru tzv . najstaršej Pravdy .	udeľovanej	4	Gen
Dobrovoľníci z rôznych organizácií pripravili bohatý program : divadelné , umelecké a hudobné dielne aj súťaže .	hudobné	12	Acc
Drúk s newyorskou čiapkou , ktorý prišiel na túto svetovú križovatku , aby sa tu vymočil .	svetovú	9	Acc
V nami sledovanom období ho nemala vôbec , žijúc zo spomenutého desatinného systému dôb pohanských / pozri 2 kapitolu druhej časti / .	desatinného	11	Gen
Pomaly vstala a po niekoľkých knísavých krokoch zasa našla rovnováhu .	knísavých	5	Loc
Milí konfirmandi , dnes sa stanete dospelými členmi nášho cirkevného zboru .	cirkevného	9	Gen
V tejto časti práce podávam prehľad zmienok o prvkoch pohanstva v skúmanej oblasti .	skúmanej	11	Loc
Vláda bude klásť dôraz na racionalizáciu nákladov spojených s realizáciou výkonov vo verejnom záujme v železničnej osobnej doprave a verejnej autobusovej doprave .	autobusovej	20	Loc
V zrkadle sa znovu zjavila akási nejasná tajomná tvár .	nejasná	6	Nom
Preleteli sme cez oddelenie topánok , kozmetiky , vyhli sme sa nápadne namaľovaným predavačkám , ktoré ponúkali masky , líčidlá a vzorky kolínskej .	namaľovaným	12	Dat
Vláda pripraví legislatívny rámec inštitucionálneho vzdelávania zdravotníckych pracovníkov prostredníctvom rezortu školstva s možnosťou postgraduálnej prípravy pracovníkov v zdravotníctve v školách a inštitúciách , ktoré získajú akreditáciu pre príslušný typ vzdelávania .	príslušný	27	Acc
Za pôvodcu Otovej politiky Renovatia , ako aj jeho politiky voči krajinám ležiacim na východ od ríšskych hraníc sa pokladá Gerbert z Aurillacu .	ležiacim	12	Dat
Toto ministerstvo však nemuselo uspokojovať mnohoraké potreby straníkov , ale opakovať celú operáciu na nižšej úrovni pre blaho proletariátu .	nižšej	14	Loc
Skutočnosť , ktorú mi Lori oznámila , bola jednoduchá .	jednoduchá	8	Nom
A on stále striehol na mramorových schodoch podstavca bez sochy .	mramorových	5	Loc
Povedala mi , že užíva antikoncepčné tabletky .	antikoncepčné	5	Acc
Naproti Hádovej vile .	Hádovej	1	Dat
Prvý z apoštolov patril v celom kresťanskom svete k mimoriadne uctievaným svätcom .	kresťanskom	6	Loc
Na Makovej lúke sa nič nedialo , a tak zamierila do lesa .	Makovej	1	Loc
Tu sa jeho snahy stretávali s úsilím miest rostovsko ‐ suzdaľskej oblasti .	suzdaľskej	10	Gen
Šaty boli dlhé , biele a viseli medzi Profesorovými oblekmi .	Profesorovými	8	Ins
Pred voľbami bolo – v neposlednom rade v Mostoch – mnoho krásnych vzletných výkladov , prečo treba voliť Martina Bútoru .	neposlednom	5	Loc
Takto sme priviedli kravičky do mravčích chlievov .	mravčích	5	Gen
Bola to druhá krásna tvár , ktorú mi ukázal svet .	druhá	2	Nom
Pri príležitosti svojho odchodu a ukončenia zimného obdobia som vyhlásil , že zaplatím koňak všetkým , ktorí budú od dvanástej až do tretej poobede v kaviarenskej časti obchodu .	tretej	22	Gen
“ Si ten najstatočnejší a najbystrejší mladý muž , akého poznám , “ povedal vďačne .	najstatočnejší	3	Nom
Tento národ teda kládol zúrivý odpor kolonizačným snahám ruských kniežat .	zúrivý	4	Acc
V tom prípade však ide o veľmi zaujímavý príklad prenosu archaických právnych zvyklostí do uhorského práva a ich pretrvania aj v podmienkach reforiem .	uhorského	14	Gen
Unavený , otrávený .	Unavený	0	Nom
S odporným škrekotom z nej stúpali čarodejné výpary .	odporným	1	Ins
V roku 1977 kvôli zdravotným ťažkostiam odchádza do dôchodku po náročnej a požehnanej práci na vinici Pánovej .	požehnanej	12	Loc
Popáliť sa na jedinom písmene je klasický prípad , ktorý sa môže vyskytnúť v rôznych podobách .	jedinom	3	Loc
Na cudzej planéte	cudzej	1	Loc
Neuspokojme sa s tým , že sme poslali svojím blízkym veľkonočný pozdrav , ale ukážme im ako vyzerá život v nádeji vzkriesenia a víťazstva v Kristu .	blízkym	9	Dat
Spomínaní clunyjskí opáti boli osobnosťami s mimoriadnymi osobnostnými kvalitami a veľkou morálnou autoritou .	mimoriadnymi	6	Ins
Vláda predloží zákon o zdravotníckych povolaniach a zariadeniach definujúci úlohy poskytovateľov a zdravotníckych pracovníkov .	zdravotníckych	4	Loc
Vláda sprehľadní pravidlá dotačnej politiky a zároveň dokončí realizáciu schválenej licenčnej politiky .	licenčnej	10	Gen
Z nálezov nefigurálneho charakteru je zaujímavý nález troch hlinených kraslíc .	zaujímavý	5	Nom
Keďže ide o individuálnu záležitosť , škola v tomto dieťaťu veľmi nepomôže .	individuálnu	3	Acc
Všetci obyvatelia Makovej lúky sa zišli na čistine , kde Rudko poriadal letecké preteky .	Makovej	2	Gen
Opisuje ich neobyčajne presvedčivo , pútavo a s hlbokým porozumením .	hlbokým	8	Ins
V Piacenze sa stretol s novým pápežom ( Gregorom VI . ) a prijal ho s náležitými poctami .	náležitými	16	Ins
Rozvinutie tohto nariadenia nachádzame v prvom Kolomanovom zákonníku .	Kolomanovom	6	Loc
Chytil ma za zápästie a ja som zacítila jeho mocné prsty .	mocné	9	Acc
Pozrime sa , teraz , ktoré z týchto statí sú relevantné pre našu tému .	relevantné	10	Nom
Ale špirála úvah ma vedie k nejasnému záveru .	nejasnému	6	Dat
Z tohto hľadiska bol Lavdim Lavdoshaj najnevyspytateľnejším človekom , akého som kedy poznal .	najnevyspytateľnejším	6	Ins
Na hlave mal klobúk a na krídlach vzácny vzor .	vzácny	7	Acc
Mešťania sa nazlostili a upozornili Herkulovho otca , nech ho viac do mesta nepúšťa .	Herkulovho	5	Acc
A strechu Džahijovej chatrče strhla púštna búrka .	Džahijovej	2	Gen
Posledný kánon II . kolomanovskej synody o celibáte sa svojím obsahom vymyká prísnejšiemu tónu uznesení tohto cirkevného snemu .	prísnejšiemu	12	Dat
Rozochvený som odstúpil od okna .	Rozochvený	0	Nom
Z hľadiska reformátorov bol tento fakt jednou z najvážnejších prekážok na ceste k dosiahnutiu slobody cirkvi .	najvážnejších	8	Gen
Panterov nápad však zabral .	Panterov	0	Nom
Vyspevovali sme odrhovačky , občas sme lúštili krížovky alebo sa hrali slovné hry .	slovné	11	Acc
Bytová politika a príprava územia pre rozvoj bývania je prioritne úlohou obcí a miest .	Bytová	0	Nom
Aladin hodil Rasoulovi horúcu špajľu a ten ju bez rozmýšľania chytil .	horúcu	3	Acc
V oblasti manželského práva je teda uhorské ranoarpádovské zákonodarstvo , ak ho porovnávame s dobovým kánonickým právom , nejednoznačné .	dobovým	14	Ins
Výlet konfirmandov I . ročníka na Kráľovu hoľu 19 . 6 . 2004	Kráľovu	6	Acc
Ani môj štart nie je v teoretickej rovine vylúčený .	vylúčený	8	Nom
“ Správne , “ odvetil Džafar so zlovestným úškrnom .	zlovestným	7	Ins
Intenzívne sa pamätám na prístavbu javiska k cirkevnej sieni na evanjelickej fare .	evanjelickej	10	Loc
Poletíš ponad strieborné jazerá a zurčiace potoky , pod jasným nebom a vysokými zelenými stromami .	strieborné	2	Acc
Dodržiaval som toto pravidlo , odkedy som napísal prvú hlúposť z toho cyklu , krátku esej s dlhým názvom Orgazmus alebo Hrôza zo sexuálneho vyčerpania .	sexuálneho	23	Gen
Popáliť sa na jedinom písmene je klasický prípad , ktorý sa môže vyskytnúť v rôznych podobách .	klasický	6	Nom
Taniere obložte hlávkovým šalátom , na ktorý servírujte kuskus a zeleninovú zmes .	hlávkovým	2	Ins
Najbližšie číslo časopisu Patmos pripravíme ku koncu školského roku .	školského	7	Gen
Aby som mohol stvoriť Delinu , mal som pred svojím duševným zrakom Faiku .	duševným	10	Ins
" Figu borovú vo februári !	borovú	2	Acc
Všetci traja sme sa hystericky rehotali na pozadí čudných tropických rastlín v plastových črepníkoch .	čudných	8	Gen
Rovnako bolo zrejmé , aký druh ľudí ovládne tento svet .	zrejmé	2	Nom
Ružové listy sú oveľa chutnejšie .	Ružové	0	Nom
Blahoželám , slečna , povedal som s predstieraným nadšením , využijúc všetky svoje herecké schopnosti .	predstieraným	7	Ins
kríž zo štyrmi bodkami na prekrížení znamená zasiate pole , symbol plodnosti .	zasiate	7	Acc
Táto výsada pannonhalmského opáta mohla byť už súčasťou originálej listiny .	originálej	8	Gen
Pre Lizu by bolo katastrofou , keby som rozpovedal ostatným , čo som videl v Profesorovej izbe .	ostatným	9	Dat
Navyše sú nepoužiteľné vzhľadom na tlačiarenskú farbu , ktorá môže nepríjemne poškodiť istú chúlostivú časť tela .	istú	12	Acc
Tým bola narušená klasická štruktúra ruského mesta s oddeleným posadom a hradiskom .	oddeleným	8	Ins
S ťažkým nákladom sa vliekli po lesnej ceste .	ťažkým	1	Ins
Najdôležitejšie informácie v marketingovej spoločnosti sú napísané na okraji a malými písmenami .	marketingovej	3	Loc
Prítomný je celý panteon vladimírovej pohanskej reformy .	pohanskej	5	Gen
Rozbujnená vegetácia na mieste , kde pred rokmi bola udržiavaná záhrada ?	udržiavaná	9	Nom
Vyrába umelé potreby , ktoré nás aktivujú , vyprázdňujú , ničia a zotročujú .	umelé	1	Acc
Inštitút zahladenia odsúdenia by nemal mať účinok opätovného nadobudnutia " bezúhonnosti " .	opätovného	7	Gen
S očividným uspokojením dokázal rozprávať o náletoch vrtuľníkov na nepriateľské dediny , o procesoch s ideozločincami , o ich priznaniach a o popravách v katakombách Ministerstva lásky .	očividným	1	Ins
Medzi Ladislavovými zákonmi máme cirkevnú sankciu doloženú v prípade zabitia nevernej ženy a znásilnenia .	doloženú	6	Acc
Spokojne som sedela na trávniku pred domom , vdychovala eukalyptovú vôňu a chladnejší vzduch i sledovala som , ako nado mnou vetrík povieva palmovými listami .	palmovými	23	Ins
Podľa nich klerici sa nielenže nesmeli opíjať , ale mali aj povinnosť brániť veriacim v prehnanom požívaní opojných nápojov .	prehnanom	15	Loc
Kým odletím do nebeského pekla , musím si odčiniť nejaké hriechy tu , v pozemskom pekle .	pozemskom	14	Loc
Nemala som najmenšiu chuť rozoberať pred ním svoje zmätené pocity a zbabraný test .	zmätené	8	Acc
V šalátovej mise zmiešajte olej , korenie , soľ , uhorku , cibuľu , petržlenovú vňať a bazalku .	petržlenovú	14	Acc
Občas si spomenula na svoj roj vo včelom meste .	včelom	7	Loc
Usadili sme sa pripravení sledovať oblohu .	pripravení	3	Nom
Epizóda s uštipnutou ženou je pravdivá .	uštipnutou	2	Ins
No bol z toho poriadne zmätený .	zmätený	5	Nom
Nepatrí teda k spomenutému typu „ poľnohospodárskych miest “ .	spomenutému	3	Dat
“ To je nespravodlivé ! “ namietla som .	nespravodlivé	3	Nom
Na záver tohto pamätného dňa dala princezná otcovi pusu na dobrú noc a mravčie vojsko vymenovalo kráľa za svojho čestného člena .	čestného	19	Acc
Ihneď som spoznala zvuk maminho auta .	maminho	4	Gen
Vláda zabezpečí prepojenie národného obranného plánovania s obranným plánovaním NATO .	obranným	7	Ins
Samonafukovačky sa pýšia výbornými izolačnými schopnosťami , vysokým komfortom pri ležaní a neprepúšťaním vlhkosti .	výbornými	3	Ins
V hrobovom tichu .	hrobovom	1	Loc
Cieľom Diskusného klubu je budovanie občianskej spoločnosti na kresťanskom morálnom základe .	kresťanskom	8	Loc
Vláda zabezpečí novelu Zákonníka práce a zákona o verejnej službe tak , aby umožnila individuálnu diferenciáciu miezd a mobilitu zamestnancov v zdravotníckych zariadeniach .	verejnej	8	Loc
Odporná extáza strachu a pomstychtivosti , túžba zabíjať , mučiť , drúzgať tváre kováčskym mlátom akoby preskočila sťa elektrický prúd na všetkých a premenila každého aj proti jeho vôli na vrieskajúceho pomätenca s pokrivenou tvárou .	Odporná	0	Nom
Dobrovoľníci z rôznych organizácií pripravili bohatý program : divadelné , umelecké a hudobné dielne aj súťaže .	divadelné	8	Acc
Má netradičnú grafickú podobu a svojimi malými rozmermi sa zmestí do každej tašky a ku každému počítaču .	malými	6	Ins
Tu ide vlastne len o zhutnené zopakovanie už citovaného Kolomanovho zákona , teda opäť o určenie prvostupňového odvolacieho súdu .	prvostupňového	16	Gen
Práve vtedy vošiel ráznym krokom guľatý pánko so špicatou briadkou .	špicatou	8	Ins
Je to už tretí prípad v krátkom čase .	krátkom	6	Loc
Keď Jazmína vošla na chodbu , čo viedla do prijímacej siene , zjavil sa nesmierne rozrušený sultán .	rozrušený	15	Nom
V dvanástom storočí spolu s Vladimírom Zaleským zatienila Rostov a usilovala sa o kolonizáciu severovýchodných území .	severovýchodných	14	Gen
Z tohto hľadiska meriam obdobie svojho pobytu v Čarodejníckej vile podľa intervalov , v akých otec odpovedal na mamine listy .	Čarodejníckej	8	Loc
Za dverami stáli uplakané pestúnky .	uplakané	3	Nom
Keď prišli títo ľudia , bol som na vrchole nervového vyčerpania .	nervového	9	Gen
Toto , spolu s predchádzajúcou svätoštefanskou právnou normou , dobre korešponduje s popisovaným výnimočným postavením uhorského kráľa v krajinskej cirkvi .	uhorského	15	Gen
Keď ich spustil na zem , zazrel na vzdialenom konci miestnosti trojstranné zrkadlo .	vzdialenom	8	Loc
U dovážaných produktov zabezpečí elimináciu tých , ktoré nespĺňajú kritériá kvality a ktoré neprešli colným a daňovým vysporiadaním .	daňovým	16	Ins
Akékoľvek doklady o Fulbertovom ideovom vplyve na Boniperta však chýbajú .	Fulbertovom	3	Loc
Vliekol som sa po Nevskom prospekte a stále som nedokázal sformulovať nijakú myšlienku .	Nevskom	4	Loc
Obrovský panter zdvihol košík a opatrne ho položil na breh .	Obrovský	0	Nom
Johansson je proti vysokým platom	vysokým	3	Dat
Sexuálne puritánstvo Strany im nikto nevnútil .	Sexuálne	0	Acc
“ Prepáčte , “ povedala zvonivým spevavým hlasom .	zvonivým	5	Ins
“ Dobrú noc , želám vám príjemný let . “	Dobrú	1	Acc
Pri Hahótskom kódexe je to trochu inak .	Hahótskom	1	Loc
Šírila sa z veľkého červeného kvetu s tmavozelenými listami .	tmavozelenými	7	Ins
Celou cestou domov som sa dívala z okna do tmavej prázdnoty .	Celou	0	Ins
A uzlovým bodom všetkých právnych formúl , ktoré sa týkajú rozoberaných hnutí , je vzťah tohto spoločenstva k štátnej moci , t . j . stret sveta šamanistického dualizmu s predstaviteľmi kniežacej moci , zjednocujúcimi krajinu .	uzlovým	1	Ins
Povedal som to nezrozumiteľnou , smiešnou ruštinou .	nezrozumiteľnou	3	Ins
Po putovaní rôznymi bratislavskými krčmami sa slovenské večery vrátili do Véčka .	bratislavskými	3	Ins
Toto , spolu s predchádzajúcou svätoštefanskou právnou normou , dobre korešponduje s popisovaným výnimočným postavením uhorského kráľa v krajinskej cirkvi .	právnou	6	Ins
Teraz už neboli v znehybnených pózach .	znehybnených	4	Loc
Môj úsmev do diaľky žiari , tvár zdobia mandľové oči .	mandľové	8	Nom
Vláda sa zaväzuje naďalej garantovať občianske slobody a všestranný rozvoj ľudských práv .	občianske	5	Acc
Vláda podporí rozvoj základného a aplikovaného výskumu na vysokých školách ako nevyhnutnej podmienky na poskytovanie kvalitného vysokoškolského vzdelávania a na zabezpečenie dlhodobo udržateľného rozvoja spoločnosti .	udržateľného	22	Gen
Obrovský vysvietený lunapark s kolotočmi , kľukatými dráhami , hudbou , zábavnými hrami a množstvom vykrikujúcich ľudí .	kľukatými	6	Ins
Za očami matne rozoznala biely ňufáčik a zlato ‐ čierny pásikavý kožuštek .	čierny	9	Acc
V sledovaných cirkevnoprávnych zbierkach sme pendanty k uhorským úpravám nenašli .	uhorským	7	Dat
Cieľom reforiem v sociálnom systéme je zníženie jeho zneužívania , odstraňovanie byrokracie a potláčanie korupcie .	sociálnom	3	Loc
Rozzúrená sa zvrtla a kamennými schodmi zbehla do zámockej pivnice .	zámockej	8	Gen
Maja sa rozhodla , že zasa zaletí do ľudského obydlia .	ľudského	8	Gen
V ďalšom potom budeme identifikovať odraz tejto jeho pozície v sledovaných právnych normách .	právnych	11	Loc
Veľký futbalový zápas	futbalový	1	Nom
Zastupiteľstvo súhlasilo s umiestnením vo vojenskom kostole .	vojenskom	5	Loc
Tentoraz na televízne obrazovky v podobe 13 - dielneho seriálu .	televízne	2	Acc
Týchto ľudí , ktorí pochádzali zo strednej triedy zamestnancov a z vyšších vrstiev robotníckej triedy , sformoval a zoradil jalový svet zmonopolizovaného priemyslu a scentralizovanej vlády .	zmonopolizovaného	21	Gen
Vošla som do tichého bytu .	tichého	3	Gen
Wilsher , blondiak s nasprostastým výrazom na tvári , ktorého takmer nepoznal , ho s úsmevom pozýval na voľné miesto pri svojom stole .	voľné	18	Acc
Nehybnú princeznú nechala ležať na studenej kamennej dlážke .	Nehybnú	0	Acc
V tom istom fascikli som mal odložené aj ďalšie texty , ktoré som neskôr zoskupil do samostatného fascikla .	odložené	6	Acc
Mal som ten hrebeň odložený až donedávna .	odložený	4	Acc
Pustil bicykel a vbehol na rozmoknutú trávu .	rozmoknutú	5	Acc
Vláda bude podporovať programy v horších pôdnych a klimatických podmienkach a orientovať sa na mimoprodukčné funkcie poľnohospodárstva a agroturistiky .	pôdnych	6	Loc
Faika stála pri mne , s červenou tvárou .	červenou	6	Ins
Winston vyskočil na rovné nohy .	rovné	3	Acc
Dlhé pretrvávanie predkresťanských ideí sa vysvetľuje etnicky nerovnomerným obyvateľstvom .	nerovnomerným	7	Ins
A ak sa za týchto okolností zjavil Hádes , bolo to nedobré .	nedobré	11	Nom
Zajac mohol byť vykladaný v systéme predkresťanských názorov jednak ako symbol plodnosti / dodnes spájame na veľkú noc vyobrazenia zajacov s vajíčkami , Nemci počas tohto sviatku hľadajú v záhrade vajíčka ukryté veľkonočným zajacom / .	veľkonočným	32	Ins
Malá húsenička po márnom čakaní zaspávala hladná .	márnom	3	Loc
Koordináciu európskej politiky štátu ako súčasti zahraničnej politiky bude zabezpečovať MZV SR v úzkej spolupráci s ostatnými ústrednými orgánmi štátnej správy .	ostatnými	16	Ins
Jeho zbierka totiž , podľa nás , predstavuje prechodný typ cirkevnoprávnej zbierky , ktorý stojí medzi cirkevnoprávnymi zbierkami vzniknuvšími v období dominancie germánskeho práva a zbierkami reformnými , ktoré sú predstupňom diel klasickej kánonistiky .	cirkevnoprávnymi	16	Ins
Pôjde najmä o precíznejšiu personálnu prácu , efektívnejšie využitie ich vlastných kontrolných a inšpekčných mechanizmov , ale tiež o uplatňovanie nových špecifických protikorupčných postupov .	precíznejšiu	3	Acc
Biele lístočky kvetu sa jemne odhrnuli a zjavila sa malá rúčka .	Biele	0	Nom
Moje meno je skrátenou podobou maminho mena .	skrátenou	3	Ins
Osobitnú pozornosť bude vláda venovať legislatíve a legislatívnemu procesu .	legislatívnemu	7	Dat
Hmotným blahobytom ( chlebom ) , mocou a pýchou .	Hmotným	0	Ins
Napokon ďakujem za vaše modlitby za zbor i nás duchovných pastierov .	duchovných	9	Acc
Siahol mu do vrecka na šatách a keď vytiahol ruku , mal na dlani veľký červený rubín .	červený	15	Acc
Mediácii bráni násilný zásah zvonku — Janova prítomnosť , narúšajúca tak prvotnú rovinu mýtu .	Janova	6	Nom
Budúci pápež však podmienil svoj nástup do úradu – a to bolo v súdobých podmienkach niečím úplne novým – vykonaním regulárnej voľby klérom a ľudom Ríma .	novým	17	Ins
Tá za desaťročia sústredeného výskumu vyprodukovala stovky monografických a časopiseckých spracovaní danej témy .	sústredeného	3	Gen
V blízkej osade Poklony bola Velesova svätyňa , uctievaná pri veľkom dube .	veľkom	10	Loc
V posledných mesiacoch žiletky patrili medzi nedostatkový tovar .	posledných	1	Loc
ZLÁ VÍLA NETRPEZLIVO ČAKALA NA ZÁPAD SLNKA vo vlhkých tmavých rozvalinách kamenného hradu , ktorý stál na vysokom brale .	vysokom	17	Loc
Všetci obyvatelia Makovej lúky sa zišli na čistine , kde Rudko poriadal letecké preteky .	letecké	12	Acc
Vláda v každom prípade prijme kroky na zvýšenie motivácie rodičov a ich detí študovať , respektíve skutočne plniť povinnú školskú dochádzku .	povinnú	18	Acc
Vláda bude podporovať politiku multifunkčného poľnohospodárstva a jeho krajinotvorné , enviromentálne a kultúrne funkcie , podporovať rozvoj vidieckej infraštruktúry a vidieckeho turizmu .	enviromentálne	10	Acc
Sopky vreli , vyčíňali búrky a zemetrasenia , svet bol plný zmätku a veľkého zdesenia .	veľkého	13	Gen
Bola horúca júlová noc a vládla dusivá spara .	júlová	2	Nom
Nález železného kľúča od visiaceho zámku mohol súvisieť s už spomenutou ochrannou funkciou .	visiaceho	4	Gen
Zdalo by sa teda , že Somogyvárske opátstvo bude vďaka zväzku so svojím materským opátstvom súčasťou clunyjskej „ kongregácie “ .	Somogyvárske	6	Nom
Toto stieranie hraníc je veľmi príjemné , pokiaľ ide o poriadneho občana , ktorý cestuje za svojím obchodom alebo za svojou dovolenkou .	poriadneho	10	Acc
V ich rámci budeme na prvom mieste hovoriť o výnimočnom postavení uhorského kráľa voči domácej cirkvi .	domácej	14	Dat
Tieto funkcie sú nápadne podobné funkcii kléru na starej Rusi — pri kláštoroch boli útulky pre chorých a existovali dokonca „ kláštorní lekári “ , ktorí spadali do kompetencie cirkevného práva .	cirkevného	29	Gen
Na druhej strane slovo Kominterna vnuká predstavu prísne štruktúrovanej organizácie a dobre zoštylizovanej ideologickej doktríny .	ideologickej	13	Gen
Bez Ducha Svätého nebudeme schopní ničoho .	schopní	4	Nom
V súlade s európskym trendom budeme podporovať rozširovanie výmery ekologického poľnohospodárstva a výroby biopotravín .	európskym	3	Ins
Pozrela som na jedálny lístok vyvesený nad pultom , potom na zem a do výkladu .	vyvesený	5	Acc
V ten večer sme neboli v skalnatej zátoke .	skalnatej	6	Loc
Odhrnula som mokré plavky , prázdne kokakolové plechovice , ceruzky , listy vytrhnuté z notesa a knižku Kto chytá v žite so somárskymi ušami .	kokakolové	6	Acc
Oči mi na chvíľu zastali na tenkej retiazke , na odhalenej časti pŕs .	tenkej	6	Loc
Vláda uskutoční revíziu úradov , pripraví zmeny v pracovno - právnej legislatíve a uskutoční reorganizáciu štátnej správy .	právnej	10	Loc
Z Odilonovho listu Štefanovi I . sa dozvedáme , že clunyjský opát a prvý uhorský kráľ boli vo vzájomnom styku už pred odoslaním tohto listu vzniknuvšieho medzi rokmi 1031 – 1038 .	vzájomnom	18	Loc
Archeologické vykopávky v Novgorode	Archeologické	0	Nom
So žiarivým trojzubcom v mohutnej ruke sa nad nimi týčila ako predzvesť smrteľných bleskov .	žiarivým	1	Ins
Miluje tlačové konferencie .	tlačové	1	Acc
Potom si kráľovná opäť zastala pred oválne zrkadlo v zlatom ráme .	oválne	6	Acc
Bol prvým z nového tzv . „ druhého “ typu posadnikov v Novgorode .	druhého	7	Gen
Ja som zatiaľ porovnal jej tvár so Soninou .	Soninou	7	Ins
Zdôrazňoval pritom výsadné postavenie apoštolom Petrom založenej rímskej cirkvi a Apoštolského stolca .	výsadné	2	Acc
Pošlem ťa do soľných baní . "	soľných	3	Gen
Iba pred piatimi dňami sa pohrával myšlienkou , že jej rozbije hlavu dlažobným kameňom , lenže čo tam teraz po tom ?	dlažobným	12	Ins
Pečate so vzývajúcou formulou v staroruštine	vzývajúcou	2	Ins
Pustili sa do upratovania školských plástov .	školských	4	Gen
Rumélia je turecký názov pre oblasť juhovýchodného Balkánu ( pozn . prekl . ) .	turecký	2	Nom
Táto téma by si preto iste zaslúžila samostatné obšírnejšie spracovanie .	samostatné	7	Acc
U citlivejších osôb to môže spôsobiť zbytočné bolesti hlavy .	zbytočné	6	Acc
Domáci pán mal zlatý oblek s čiernymi pásikmi .	čiernymi	6	Ins
V období vzniku uhorskej cirkevnej organizácie problém , či si uhorský kráľ uzurpoval práva prináležiace Apoštolskému stolcu , ešte nehral rozhodujúcu úlohu .	prináležiace	14	Acc
V reformnom hnutí v 10 . a 11 . storočí musíme zreteľne odlíšiť dve základné línie – staršiu reformu monastickú a mladšiu reformu rímsku , resp . pápežskú .	monastickú	19	Acc
V posledných mesiacoch žiletky patrili medzi nedostatkový tovar .	nedostatkový	6	Acc
Išli sme až k nášmu vchodu na zadnej strane domu a celou cestou sme mlčali .	celou	11	Ins
Alfonz bez slova zmizol za záhradným plôtikom .	záhradným	5	Ins
Pozrela som na jedálny lístok vyvesený nad pultom , potom na zem a do výkladu .	jedálny	3	Acc
Druhá Doležalova inovácia je v gramatickom popise tohto jazyka .	Doležalova	1	Nom
Vláda bude zvyšovať prostriedky na vzdelávanie , aby sa postupne priblížili priemernej hodnote podielu z HDP v krajinách EÚ .	priemernej	11	Dat
Odtrhol som lesnú jahodu a položil ju ku kamennému prístrešku .	kamennému	8	Dat
Jediným mávnutím zázračnej palice premenil reťaze na zlatú korunku .	zázračnej	2	Gen
Spoza stola ma vytiahol smútočný pochod dychovej kapely .	smútočný	4	Nom
Napriek týmto úžasným poznatkom vedy a techniky neexistuje zatiaľ žiadna definícia , čo je to život .	úžasným	2	Dat
V Oddelení umeleckej literatúry to bol bežný úraz .	bežný	6	Nom
Do slovenských častí Uhorska sa vtedy utiahla jedna časť českých emigrovaných protestantov a tu našli v používaní svoj vlastný spisovný jazyk presne tak , ako vo svojej českej vlasti .	emigrovaných	10	Gen
Monastická reforma mala viacero od seba nezávislých stredísk .	nezávislých	6	Gen
Svoje fotografie odteraz nájdete vždy na adrese www . fotoindex . sk vo svojom súkromnom fotoalbume .	súkromnom	14	Loc
Grifony zapriahnuté v nebeských záprahoch božstiev fungovali ako zjednotitelia neba a zeme .	zapriahnuté	1	Nom
Vybavím to rýchlo a hneď zaspím dobrým spánkom .	dobrým	6	Ins
Naučil sa spať s prudkým svetlom na tvári .	prudkým	4	Ins
Podľa zoznamu posadnikov , uvedených v novgorodskom prvom letopise mladšieho vydania sa nazýval Zavid .	novgorodskom	6	Loc
Pôjde najmä o precíznejšiu personálnu prácu , efektívnejšie využitie ich vlastných kontrolných a inšpekčných mechanizmov , ale tiež o uplatňovanie nových špecifických protikorupčných postupov .	špecifických	21	Gen
Postrehla , že má akési čudné topánky , vraj ešte nikdy predtým také topánky nevidela .	čudné	5	Acc
Pripadala mi veľmi známa a bola príjemná .	známa	3	Nom
Gaston bol presvedčený , že tentoraz nevyviazne so zdravou kožou .	zdravou	8	Ins
" Dom je naozaj obkľúčený , " povedal ten hlas .	obkľúčený	4	Nom
Gaston od úžasu onemel , keď uvidel , ako Bela cvála na koni cez kamenný most .	kamenný	14	Acc
Prepáčila by mi to , aj keby vedela , že som to odkladala kvôli nočnému astronomickému klubu s Chrisom ?	astronomickému	15	Dat
Spratal neuveriteľné množstvo kukuričných placiek a mľaskal pritom a navyše ich zlostil híkavým smiechom .	híkavým	12	Ins
Vlak bol plný proletov so sviatočnou náladou , ktorú v každom vyvolávalo letné počasie .	sviatočnou	5	Ins
Zakrátko zhotovil pekné a pevné nosidlá .	pekné	2	Acc
Vláda bude požadovať zvýšenie finančnej disciplíny a tvrdé rozpočtové obmedzenie .	tvrdé	7	Acc
N . P . Lichačev bol tiež autorom jednej z prvých teoretických prác o uvedených pečatiach .	teoretických	11	Gen
Bol to prekrásny pohľad .	prekrásny	2	Nom
V roku 1977 kvôli zdravotným ťažkostiam odchádza do dôchodku po náročnej a požehnanej práci na vinici Pánovej .	Pánovej	16	Loc
Spev kohúta máva aj vo všednom , obyčajnom živote dvojaký význam .	obyčajnom	7	Loc
Marginým svätcom bol taliansky spevák Gianni Morandi , mojím Angličan Tom Jones .	Marginým	0	Ins
Vzduch preťal prenikavý hlas trúbky .	prenikavý	2	Nom
V „ našich “ zbierkach kánonického práva máme doslova záľahu ustanovení , ktoré hovoria o tom istom .	kánonického	5	Gen
Finančne podporí rozvoj ľudských zdrojov a inštitucionálnej infraštruktúry regiónov , slúžiacej na realizáciu komplexnej regionálnej politiky .	komplexnej	13	Gen
Prvým výskumníkom , zaoberajúcim sa novgorodskými pečaťami bol P . Lichačev , ktorý do roku 1917 objavil šesťsto kusov .	zaoberajúcim	3	Ins
Jeho bezstarostný pohľad ma však varoval .	bezstarostný	1	Nom
Vysvetlila môj výrok ohľadom časopisov v konkrétnom zmysle .	konkrétnom	6	Loc
V nasledujúcej chvíli nastal obrovský rozruch .	obrovský	4	Nom
Vláda upraví rámcové podmienky regionálneho rozvoja decentralizáciou verejných financií a zavedie nový , efektívnejší systém finančného vyrovnávania sociálno - ekonomických rozdielov vyšších územných celkov .	finančného	15	Gen
Svedčia o tom súdobé udalosti späté s I . križiackou výpravou .	križiackou	9	Ins
Vietor hvízdal v konároch a trápil sporadické , ufúľané krókusy .	sporadické	6	Acc
V oblasti manželského práva je teda uhorské ranoarpádovské zákonodarstvo , ak ho porovnávame s dobovým kánonickým právom , nejednoznačné .	nejednoznačné	18	Nom
Vedel , že v neďalekej jaskyni žije vlčia rodinka , ktorej sa nedávno narodili mladé vĺčatá .	neďalekej	4	Loc
Bolo zamračené , malo pršať .	zamračené	1	Nom
Júlia merala všetko vlastnou sexualitou .	vlastnou	3	Ins
Želám vám príjemný zvyšok týždňa .	príjemný	2	Acc
Chrisov autobus zarachotil v zákrute a zabočil na HLavnú ulicu .	HLavnú	8	Acc
Pôjde najmä o precíznejšiu personálnu prácu , efektívnejšie využitie ich vlastných kontrolných a inšpekčných mechanizmov , ale tiež o uplatňovanie nových špecifických protikorupčných postupov .	personálnu	4	Acc
Nateraz sa uzavrel pred vzdialenejšími zvukmi a počúval len kvákanie , ktoré sa valilo z obrazovky .	vzdialenejšími	4	Ins
V tom prípade však ide o veľmi zaujímavý príklad prenosu archaických právnych zvyklostí do uhorského práva a ich pretrvania aj v podmienkach reforiem .	zaujímavý	7	Acc
Neuspokojme sa s tým , že sme poslali svojím blízkym veľkonočný pozdrav , ale ukážme im ako vyzerá život v nádeji vzkriesenia a víťazstva v Kristu .	veľkonočný	10	Acc
Politika zameraná na zníženie deficitnosti verejných financií vytvorí spolu s reformami v najvýznamnejších výdavkových rezortoch priestor na zníženie odvodov a priamych daní .	zameraná	1	Nom
" Vy ste zrejme od svojho mládenectva zažili ohromné zmeny , " opáčil Winston .	ohromné	8	Acc
Vláda bude i po vstupe Slovenskej republiky do NATO podporovať politiku otvorených dverí Aliancie a posilnenia väzieb s partnerskými krajinami .	partnerskými	18	Ins
Novgorodské brezové listiny .	brezové	1	Nom
Sexuálne puritánstvo Strany im nikto nevnútil .	Sexuálne	0	Acc
V oblasti prepravných povolení v cestnej doprave sa realizuje nový transparentný systém založený na princípe nárokovosti pri splnení požadovaných kritérií a podmienok	cestnej	5	Loc
