A horvát alkotmányban csak a tartós akadályoztatás fogalmát rögzítették , amely az államfő helyettesítésének esetére kötelezően előírta új elnökválasztás kiírását is .	akadályoztatás	6	Nom
A magyar keretlegények durvasága , az élelem- és gyógyszerhiány , a hideg , a piszok megtette a magáét .	piszok	14	Nom
— Igen , bár nehéz egészséges arányt találni a két műfaj között .	arányt	6	Acc
Megközelíthetetlenné vált nyolc Vas megyei község , s hótorlasz mögé szorul a Bács-Kiskun megyei Újsolt 190 lakosa is .	hótorlasz	8	Nom
Az IMF által tanácsolt közvetlen jövedelemkiegészítési támogatás bevezetése — amely sok farmert érzékenyen érintene — ugyancsak nehéz döntés elé állítja a török kormányt , mivel a 65 milliós lakosság 45 százaléka gazdálkodó , ami jelentős politikai erőt jelent .	kormányt	22	Acc
Dubceknak az volt az álláspontja , hogy a közös állam szétválasztása egyes cseh és szlovák politikusok egyéni ambícióit szolgálhatja ugyan , de semmiképpen nem a két nép érdekeit .	politikusok	15	Nom
Oroszország nagyhatalom és fontos partner Magyarország számára .	nagyhatalom	1	Nom
II. János Pál pápa már júniusi , majd szeptemberi levelében is bírálta a német püspökségek részvételét a terhes nőknek szervezett állami tanácsadásban , azt vetve a szemükre , hogy az igazolások kiállításával lehetővé teszik meg nem született életek elpusztítását .	tanácsadásban	21	Ine
Mindez annak köszönhető , hogy elképesztő méretekben fejlődött a feldolgozóipar , szinte alig van olyan világcég , amelynek a most sújtott Izmitben vagy környékén name lenne vegyesvállalata .	méretekben	6	Ine
Az állásbörze nemcsak a végzős diákoknak hasznos , az alsóbb évesek is gyűjthetnek tapasztalatokat , felmérhetik a követelményeket , kapcsolatba kerülhetnek a vállalatokkal , szakmai gyakorlatokra jelentkezhetnek .	vállalatokkal	22	Ins
Az illetékesek elejétől fogva óvatosan kezelték a Nyugatra szökött volt KGB-ügynök " leleplezéseit " , ezért az olaszokra vonatkozó listát ugyan közreadták , de az igazságügyi szervek azóta alaposan tanulmányozzák azt .	olaszokra	17	Sub
A megyeszékhelyen egyébként csütörtökre és péntekre tanítási szünetet rendeltek el .	megyeszékhelyen	1	Sup
Kiemelkedik az aukcióban részt vevő darabok közül egy ezüstből készült emeletes szédertál , amelyet cizellált arany elemekkel díszítettek és a súlya megközelíti a négy kilót .	aukcióban	2	Ine
A nyomozást azt követően rendelték el , hogy a közelmúltban egy holttestet leltek a tokiói repülőtér közelében fekvő egyik szállodában .	nyomozást	1	Acc
Hasonlóan járt a Fidesz számára politikai kudarcot és eladósodást hozó 1994-es választások után : túladtak rajta mint gazdasági igazgatón .	igazgatón	18	Sup
Veszprém megyében a 8-as úton órákon állt a forgalom Várpalota és a péti elágazás között két elakadt kamion miatt .	kamion	17	Nom
Megszervezték ugyanis az Első Magyarországi Judaika Árverést , amelynek keretében értékes kulturális-történeti anyag — könyvek , kéziratok , kegytárgyak és festmények — kerül kalapács alá .	kéziratok	16	Nom
A Magyar Tudományos Akadémia ( MTA ) épületében helyet kapott találkozót Glatz Ferenc akadémiai elnök nyitotta meg , aki a magyar nemesség történelmi szerepéről tartott előadást .	helyet	8	Acc
A Corso talpra állítása a társaságot 1994-ben privatizáló — a cég vezetőiből és alkalmazottaiból álló — konzorciumnak sem sikerült ( a vételár mindössze 198 millió forint volt , amelynek csak a 30 százalékát kellett készpénzben kifizetni ) .	készpénzben	34	Ine
A realista a jó szándékot látja benne , no meg azt : ennyire tellett .	szándékot	4	Acc
A nisi polgármesteri hivataltól származó értesüléseink szerint a szerbiai városba szerda este megérkezett a 10 teherautó , amely az Európai Unió és a szerb ellenzék között létrejött megállapodás értelmében fűtőolajat szállít az ellenzéki vezetésű , közép-szerbiai településnek .	megállapodás	27	Nom
Először Don Alfonsót alakítottam benne , majd Guglielmo lettem , több év elteltével pedig ismét megkaptam az öreg filozófus szerepét .	elteltével	12	Ins
Ázsiában ezzel szemben mind több sikerrel veszik fel az AIDS-szel szembeni küzdelmet .	küzdelmet	11	Acc
A Volánbusz Rt. távolsági járatai közül nem indulnak a Bakonyba és Tolna, Baranya, Bács-Kiskun megye egyes településeire buszok .	településeire	16	Sub
A hófúvás a MÁV teljes hálózatán fennakadásokat okozott , mindenütt legalább 30 percet késtek a vonatok .	hálózatán	5	Sup
A testület rendkívüli ülésén kétharmados szavazattöbbséggel elfogadott törvényt azonnal ki is hirdették , így az azonnal érvénybe is lépett .	szavazattöbbséggel	5	Ins
parlament szerepét betöltő svájci nemzeti tanács hétfőn 11 órás vita után ratifikálta az alpesi ország és az Európai Unió ( EU ) között négyéves tárgyalás után nemrégiben létrejött eddigi legfontosabb dokumentumot .	dokumentumot	30	Acc
A világgazdaság gyors , országhatárokon átívelő fejlődését több tényező idézi elő .	világgazdaság	1	Nom
A Maticni utcai " etnikai elválasztófal " megszüntetéséről kedden hozott döntést Ústi nad Labem városi tanácsa .	tanácsa	15	Nom
Pozsony soha nem ismerte el a cseh követelés jogosultságát .	jogosultságát	8	Acc
Putyin ezúttal nem zárta ki teljesen Groznij ostromát , azt hangoztatva , hogy a bázisokat és a fegyverraktárokat meg fogják semmisíteni .	ostromát	7	Acc
A megállapodás várhatóan 2001-ben lép hatályba , miután valamennyi uniós tagország parlamentje is ratifikálta .	parlamentje	11	Nom
A megyében a legnagyobb problémát az átutazó forgalom okozza , s habár nem lehet közlekedni , a kamionok és buszok sofőrjei nem hajlandóak leállítani járműveiket — magyarázta Lánczos János , a Fejér Megyei Közútkezelő Kht. osztályvezetője .	járműveiket	24	Acc
Mario Babiucról van szó , aki " Ikar " fedőnéven szerepelt a szovjet titkosszolgálat jelentéseiben .	fedőnéven	9	Sup
Nem nehéz megjósolni : az elnapolt terv olyan nagyszabású fejlesztéseket javasol , melyeket a közelgő közlekedési krízis ellenére sem tud a főváros — természetesen pénz hiányában — megvalósítani .	krízis	16	Nom
Ennek a jelzőnek nagy sikere lett , mert nálunk imádják a mártírokat , akik magányosan tönkremennek .	mártírokat	11	Acc
A tárlaton mintegy hatvan művet tekinthetnek meg az érdeklődők Marghescuné Hunor Mária gyűjteményéből .	tárlaton	1	Sup
A mintegy 180 magyarországi taggal rendelkező egyesület találkozóján részt vett Habsburg Ottó is , akinek Magyarországon élő fia , György szintén tagja a szervezetnek .	taggal	4	Ins
A vastagon behavazott úton tényleg ez a helyzet .	úton	3	Sup
A jövő év január 5-ig látható kiállításon a kerámiatárgyak mellett Balogh István Péter és Börzsönyi Kollarits Ferenc képei is bemutatkoznak .	kerámiatárgyak	8	Nom
Pedig úgy gondolom , én nem csináltam semmi mást , csak szolgáltam a muzsikát és a közönséget .	közönséget	16	Acc
Állták a szavukat : a szerződés ratifikálása után a szlovák aranykincs várhatóan a jövő év elején , azt követően kerülhet Pozsonyba , hogyha az egyezményt már a két parlament is ratifikálta .	aranykincs	10	Nom
— Azt írta önről valaki , hogy az egyik legkevésbé ismert magyar szobrász , sokak szerint mégis kultikus figura ...	szobrász	12	Nom
A cég 1997-ben 1 milliárd forint körüli árbevétel mellett 500 millió forintos adózás előtti nyereséget ért el , míg tavaly az orosz válság hatására árbevételük 600 millió forintra , eredményük 140 millió forintra csökkent .	nyereséget	14	Acc
A mintegy kétszázezer koszovói szerb közül már csak alig húszezren maradtak a június óta NATO-ellenőrzés alatt lévő dél-szerbiai tartományban .	tartományban	18	Ine
Tegnap este az autóbuszok sok helyütt két és fél órás késéssel érkeztek a célállomásra , a főútvonalakon pedig több kilométer dugók alakultak ki .	főútvonalakon	16	Sup
A Magyar Tudományos Akadémia ( MTA ) épületében helyet kapott találkozót Glatz Ferenc akadémiai elnök nyitotta meg , aki a magyar nemesség történelmi szerepéről tartott előadást .	épületében	7	Ine
Erre azonban a szaktárca vezetője szerint nincs szükség , bár a miniszter felkérte a fuvarozókat , lehetőleg name hagyják el a telephelyeiket .	szaktárca	3	Nom
Mostanában , a cseh-szlovákiai " bársonyos forradalom " tizedik évfordulójára emlékezve , magától értetődően , sok szó esik Alexander Dubcek személyiségéről , a szlovák történelemben betöltött szerepéről .	történelemben	24	Ine
A csehországi Ústi nad Labemben szerda hajnalban teljesen lebontották azt a falat , amelyet a város vezetése építtetett október elején azért , hogy elválassza a helyi romákat a szomszédos családi házak lakóitól .	romákat	26	Acc
Akinek pedig lapát van a kezében , biztosan nem fázik .	kezében	5	Ine
Anynyit nézem a munkámat , hogy a végén már nem látom .	munkámat	3	Acc
Szerdán megalakult a rendkívüli havazás miatt kialakult káosz kezelésével megbízott operatív bizottság .	kezelésével	8	Ins
Olyan vagyok ebben a társadalomban , mint volt egykor a dinoszaurusz : hiába mondták neki , hogy " Repülj ! " , nem tudott repülni és kihalt .	társadalomban	4	Ine
Az Erste Bank Hungary Rt. a jövő héten teszi közzé az újságokban , milyen áron hajlandó megvenni a mintegy 1200 kisbefektető kezében lévő 77 ezer darab , a bank 9,2 milliárd forintos jegyzett tőkéjének négy százalékát kitevő részvényeit .	kezében	21	Ine
Ezen az árverésen azok is megtalálhatják a nekik tetsző tárgyat , akik jó befektetésre vágynak , de a kispénzű érdeklődők is reménykedhetnek , mert akad a listán könyvritkaság mindössze 800 forint kikiáltási áron .	árverésen	2	Sup
A cég helyzetét a növekvő konkurencián kívül rontotta , hogy a kiskereskedelmi üzletek eladását szolgáló előprivatizáció keretében több boltját elvonták , ingatlanvagyonának 86 százalékát így két nagyméretű — 6 ezer négyzetméter körüli — raktár tette ki .	helyzetét	2	Acc
II. János Pál pápa már júniusi , majd szeptemberi levelében is bírálta a német püspökségek részvételét a terhes nőknek szervezett állami tanácsadásban , azt vetve a szemükre , hogy az igazolások kiállításával lehetővé teszik meg nem született életek elpusztítását .	szemükre	26	Sub
A megye több más települését is csupán kerülővel , egyetlen irányból lehetett megközelíteni — tájékoztatta lapunkat Szabó Ferenc ezredes , a megyei védelmi bizottság titkára .	kerülővel	7	Ins
Hiszen a személyi ellentétekben is megnyilvánuló pozícióharc első nagy vesztese a klasszikus szociáldemokrata értékekre előszeretettel hivatkozó Oskar Lafontaine pártelnök lett , aki márciusban távozott a pénzügyminiszteri posztról .	márciusban	22	Ine
A magyar országgyűlési képviselő , ha akarja , szenátornak nevezi magát , ugyanaz a párt egyik nap ellenzék , a másik nap kormányoldalon álló , sőt a parlamenti többség akarata még a matematikánál is erősebb .	kormányoldalon	22	Sup
Törökország például Európa legnagyobb szállítója a textiláruk terén , Isztambul pedig Szöultól nyugatra a legnagyobb , elektronikai eszközöket gyártó központ .	nyugatra	12	Sub
Az eldugott települések lakói már hozzászokhattak , hogy a közepesnél erősebb havazások majd minden esztendőben elzárják őket néhány napra a külvilágtól .	havazások	11	Nom
Az oslói orosz nagykövetség korábban még azt közölte a norvég külügyminiszterrel : Ivanov túlzottan elfoglalt , így a hónap hátralévő részében már nem tud találkozni vele .	külügyminiszterrel	10	Ins
Putyin ezúttal nem zárta ki teljesen Groznij ostromát , azt hangoztatva , hogy a bázisokat és a fegyverraktárokat meg fogják semmisíteni .	bázisokat	14	Acc
A judaika-árverés szervezői azt remélik , hogy ez az újfajta , tematikus aukció új színfoltot hoz az őszi árverési dömpingbe , és új távlatokat nyit a gyűjtők előtt .	judaika-árverés	1	Nom
Én csak ülök itt a műteremben és dolgozom .	műteremben	5	Ine
A megyeszékhelyen egyébként csütörtökre és péntekre tanítási szünetet rendeltek el .	csütörtökre	3	Sub
Weltekére most viszont az a feladat vár , hogy 2002-ben elbúcsúztassa a németek háború utáni identitásának legfontosabb támaszát , hiszen az euró teljes körű bevezetésével a hétköznapi életben is meg kell majd válniuk a márkától .	életben	27	Ine
Más városokban sem sokkal jobb a helyzet : Gnjilanéban néhány nappal ezelőtt egy szerb tulajdonban lévő videotékára dobtak kézigránátokat .	kézigránátokat	18	Acc
Szakadár albán fegyveresek kedden este tüzet nyitottak egy szerb rendőrjárőrre Koszovó délkeleti határa mentén , a biztonsági övezet közelében : két rendőr megsebesült — jelentette szerdán az RTS szerb állami tévé .	rendőrjárőrre	9	Sub
A vészhelyzetből egyedül a taxisok húztak hasznot .	hasznot	6	Acc
Goebbelsi módszereket tulajdonít a díjazott újságíróknak , miközben ő maga az , aki Goebbelset követi , jóllehet , a mester jóval tehetségesebben alkalmazta a nevéről elnevezett módszert .	módszert	26	Acc
Mellette a közelmúltban átalakult gyár művészeti stúdiójában készült , kézzel festett legszebb egyedi darabjai láthatók .	gyár	4	Nom
A lakásokban .	lakásokban	1	Ine
Ő maga szállít élelmet az elzártaknak — traktoron .	traktoron	7	Sup
Mellette a közelmúltban átalakult gyár művészeti stúdiójában készült , kézzel festett legszebb egyedi darabjai láthatók .	stúdiójában	6	Ine
Elhangzik egyszer egy mű egy koncerten , a jelen lévő néhány száz ember meghallgatja , s még akkor , ha sikert arat , sincs biztosítva , hogy legközelebb is lesz mód az előadásra .	koncerten	5	Sup
1992-ben ő volt az Öregasszony Spiró György Csirkefejének Szamos-parti előadásában az Anya szerepét alakította Camus A félreértés című színművében .	színművében	18	Ine
A Corriere della Sera című lap szerint az egyik nevet sikerült azonosítania az üggyel foglalkozó katonai főállamügyésznek .	üggyel	13	Ins
Ezért siettették az ítélet meghozatalával az ügy lezárását , és arra is számíthattak : az önálló Szlovákia megteremtésének láza el is tereli a figyelmet a gyanús körülményekről .	lezárását	7	Acc
" Úgy vélem , hogy az albán reakció ugyan helytelen , ám érthető " — vélekedett Jackson tábornok , s hozzátette : a blokád legfeljebb rögnek tekinthető a rendezés felé vezető úton .	úton	31	Sup
A politikai közbeszédben egyeduralomra jutott jogi nyelvhasználat előfeltevése , hogy csak azt lehet számon kérni , ami le van írva és ahogyan le van írva .	egyeduralomra	3	Sub
A tekercset az ő rokona kívánja most értékesíteni .	tekercset	1	Acc
— A szobor hálós szerkezetű , a háló adja ki a jaguár formáját , ami tehát belül üres .	szobor	2	Nom
A horvát alkotmányban csak a tartós akadályoztatás fogalmát rögzítették , amely az államfő helyettesítésének esetére kötelezően előírta új elnökválasztás kiírását is .	alkotmányban	2	Ine
Az újság szerint az államfőt november 1-jén már későn — legalább két nappal bélátfúródása után — operálták meg , ami súlyos hashártyagyulladást és vérmérgezést okozott szervezetében .	hashártyagyulladást	21	Acc
Mert kétségtelen tény , hogy minél szélesebb körben terítik a terheket , annál könnyebb összeszedni a hiányzó pénzt — de annál nagyobb az érintett választók száma is .	terheket	10	Acc
E tekintetben figyelemre méltó , hogy még legkeményebb bírálói is elismerik : akkor van igazán elemében , ha küzdenie kell .	figyelemre	2	Sub
Az összedőlt házak romjain egy újfajta polgári kezdeményezés csírái kezdtek kialakulni , a hivatalos állami segítség hiányát pótolva .	hiányát	16	Acc
A kormányhatározat által nyújtott lehetőség alapján 11,5 milliárd forint új hitelt vehetnek fel a tartósítóipari termékeket gyártók , a nyolc hónapos futamidejű konstrukcióban a tőketörlesztésre négy hónap moratóriumot kapnak .	hitelt	10	Acc
A kft 1998-ig elsősorban felújított Ikarus buszok oroszországi , illetve FÁK-országi exportjával , valamint pótalkatrész értékesítésével foglalkozott .	értékesítésével	15	Ins
Az intézkedést most is az orosz válság miatt megingott likviditású cégek hitelképtelensége indokolja , ami az alapanyag-termelők pozícióit is veszélyezteti .	pozícióit	17	Acc
Az isztambuli értéktőzsdén ( ISE ) jegyzett 279 vállalat zöme a Márvány-tenger földrengés által sújtott keleti partvidékén és környékén — Törökország ipari szívében — vert tanyát , de többségük a börzéhez eljuttatott jelentésében nem tesz említést jelentősebb károkról .	zöme	9	Nom
A virtuális gazdaság tehát képes az önkorrekcióra , ugyanakkor egyéb jellemzőivel is számolni kell .	jellemzőivel	10	Ins
Olyan az emlékezet , mint a zsidó sírokon a kődarab .	sírokon	7	Sup
A pusztító törökországi földrengés — amely az újabb adatok szerint mintegy 10 milliárd dollárnyi anyagi kárt okozott — nem akadályozta meg az ankarai kormányt abban , hogy töretlenül folytassa a tragédia előtt megkezdett gazdasági reformokat .	kormányt	23	Acc
Az ellenzéki pártok képviselői az alkotmányerejű törvény ellen szavaztak , egyebek között arra hivatkozva , hogy a kormánypárt nem tartja tiszteletben az alkotmányban foglaltakat , és nem hajlandó megállapodni a parlamenti választások időpontjáról sem .	kormánypárt	17	Nom
Ez a műfaj lényege : olyan szuggesztivitással , olyan hőfokon kell előadni az operákat , hogy természetesnek hasson az éneklés .	hőfokon	9	Sup
Az eladásra szánt vállalatok között szerepel továbbá a nemzeti légitársaság , a Türk Hava Yollari — amelynek 30 százalékát kínálják fel — és a Türk Telekom is , amelynek privatizálásából 5,3 milliárd dollárt várnak .	eladásra	1	Sub
A héttagú családot kiköltöztették , s ideiglenesen szövetkezeti vagy egyházi lakásban szállásolják el — tájékoztatta lapunkat Eller János polgármester .	családot	2	Acc
A török alkotmány úgy utal az államra , mint amelynek " területe és nemzete " van , szemben a nyugat-európai felfogással , ahol a nép alkotja az államot .	alkotmány	2	Nom
Emberfeletti feladat volt , hiszen minden hangjegyre meg volt a kötelező mozdulat .	mozdulat	11	Nom
Rájuk férne némi fűtőolaj-szállítmány , hogy a fagyos viszony felengedjen , és ők is — hasonlóan az unióhoz — name csak a frázisok terén legyenek energikusak , hanem a demokráciát illetően is .	frázisok	22	Nom
A hófúvás a MÁV teljes hálózatán fennakadásokat okozott , mindenütt legalább 30 percet késtek a vonatok .	fennakadásokat	6	Acc
Zaporozsje megyeszékhelyen a leszakadt villanyvezetékek miatt rendkívüli állapotot vezettek be .	megyeszékhelyen	1	Sup
A globalizáció a gazdaság kínálati oldalát befolyásolja , és nem hat a jövedelmek nemzeti kereteken belül történő elosztására .	kereteken	14	Sup
Aszlan Maszhadov csecsen elnök közölte : az urusz-martani harcosok megfogadták , hogy egész télen helyükön maradnak és harcolnak .	helyükön	14	Sup
Egyébként is nagyon kedvelem az etnozenét , az afrikai , a távol-keleti zenét ; magam is foglalkoztam ezekkel a muzsikákkal .	muzsikákkal	19	Ins
A szerbek nem csak Orahovacban érzik magukat szorongatva : múlt hét elején a tartományi székhelyen , Pristinában , három szerb nőt bántalmaztak albán támadók , s ismeretlen fegyveresek rálőttek két cigány férfire is .	szerbek	1	Nom
Az egyetemen immár hagyománnyá vált az egy hónapos Felkészítő Napok rendezvénysorozat , amelyen az álláskeresés módszereit ismerhetik meg jobban a hallgatók ; hogyan viselkedjenek , kommunikáljanak , miként mutassák be tudásukat , képességeiket egy interjú során .	hallgatók	20	Nom
Azelőtt az export és a beruházások játszották a főszerepet a gazdasági életben , az elmúlt év elején azonban az export dinamikája lassult , a beruházások egész évben stagnáltak , a belső fogyasztás pedig növekedett . )	életben	11	Ine
S bár nagyon jó viszonyban voltunk , és meghatározó volt életemben ez a vendégszereplés , nemet mondtam .	életemben	10	Ine
S miközben Törökország ásványkincsekben szegény , külkereskedelme gyors ütemben bővül .	ásványkincsekben	3	Ine
II. János Pál pápa már júniusi , majd szeptemberi levelében is bírálta a német püspökségek részvételét a terhes nőknek szervezett állami tanácsadásban , azt vetve a szemükre , hogy az igazolások kiállításával lehetővé teszik meg nem született életek elpusztítását .	kiállításával	31	Ins
A rendőrök keveset tudnak a szektáról , amely rendszeres és drága " önfelfedezési " szemináriumokat rendez .	szemináriumokat	14	Acc
Rezníkről az a hír járta , hogy a rendszerváltás előtt az állambiztonsági szolgálat alkalmazottja volt , tehát érthető volt Dubcek tartózkodása azzal az emberrel szemben , aki korábbi üldözői közé tartozott .	üldözői	28	Nom
Három magas rangú olasz katonatiszt a hidegháború idején fontos államtitkokat adott át a volt szovjet hírszerzésnek — vélik tudni a szerdai olasz újságok .	újságok	22	Nom
A török alkotmány úgy utal az államra , mint amelynek " területe és nemzete " van , szemben a nyugat-európai felfogással , ahol a nép alkotja az államot .	államra	6	Sub
A mondatot pontosan értette a vallató és a vallatott szerepében kényszerűen egyaránt járatos igazgató , és értetlenséget színlelve megtiltotta a költőnek , hogy szavai nyilvánosságot kapjanak .	szerepében	9	Ine
Egyelőre nincs végleges válasz arra , milyen utat kövessenek a szociáldemokraták a jövő évezredben — de arra sem , hogyan veszik majd az ősszel esedékes tartományi és helyhatósági választások akadályait .	évezredben	13	Ine
Egy magángyűjtemény képei címmel nyílik kiállítás ma a budapesti Szépművészeti Múzeumban .	magángyűjtemény	1	Nom
— Mozart operája örökérvényű remekmű , amelynek minden korban van mondanivalója .	remekmű	4	Nom
A Vecernji List című napilap úgy értesült , hogy a Dubrava kórházban lélegeztető készülékkel segítik Tudjman szervezetének működését , de az államfő nincs kómában .	kómában	23	Ine
Van viszont üldözés sítalpakon és sárkányrepülőn , motorcsónakon és olajvezetékben , és még egy atom-tengeralattjáró belseje is fontos szerepet kap , de ott már Bond az idővel is harcban áll , hogy megmenthesse az emberiséget .	sítalpakon	3	Sup
A megyei mentési feladatokkal a megyei védelmi bizottságokat bízták meg , ezek irányítását és az információszolgáltatást pedig az operatív bizottság végzi .	irányítását	12	Acc
1955-ben végzett a marosvásárhelyi főiskolán , több színháznak is tagja volt , de legnagyobb alakításai a Tamási Áron Színházhoz fűzik , ahol ma is dolgozik .	főiskolán	4	Sup
Kouchner erről a Párizsban rendezett balkáni újjáépítési fórumon beszélt .	fórumon	7	Sup
Decemberben , a kolozsváriak tervezett Vígszínház-beli vendégjátékán erről a budapesti közönség is megbizonyosodhat , amikor is majd Shakespeare Troilus és Cressidájának Teiresziászaként láthatjuk őt a magyar fővárosban .	kolozsváriak	3	Nom
Bernard Kouchner , az átmeneti ENSZ-kormányzat francia vezetője ugyan elvetette a Koszovó kantonizálását célzó javaslatot , ám azt is hangsúlyozta , hogy a szerbek biztonságának szavatolása érdekében fontolóra kellene venni egyes szerb közösségek ideiglenes átköltöztetését .	fontolóra	27	Sub
A diplomata ugyanakkor hozzátette : a restitúcióra csak kedvező politikai légkörben kerülhet sor .	légkörben	10	Ine
A kamionok nyári gumival , hólánc nélkül indulnak útnak — mondta Balogh András , a Veszprém Megyei Közútkezelő Kht. igazgatója .	hólánc	5	Nom
A törlesztés határideje 2000. január 31.	törlesztés	1	Nom
A Jutarnji List című ellenzéki napilap szerdai számának címoldalán A legrosszabb várható címmel arról adott hírt , hogy " többé már az intenzív kezelés sem segít " az elnökön .	hírt	15	Acc
Olyan énekes , aki tökéletes átéléssel , szenvedéllyel , humorral alakítja lírai , drámai és buffoszerepeit .	szenvedéllyel	7	Ins
Jó lenne ezt a tendenciát folytatni a 2000. évben is .	tendenciát	4	Acc
Ezért siettették az ítélet meghozatalával az ügy lezárását , és arra is számíthattak : az önálló Szlovákia megteremtésének láza el is tereli a figyelmet a gyanús körülményekről .	meghozatalával	4	Ins
A pályaudvari ceremóniára a hajdani " bajtársat " is meghívták .	bajtársat	6	Acc
A diákok egy helyen , kötetlen formában tájékozódhatnak a lehetőségekről , a vállalatok pedig széles körből , személyes benyomás alapján választhatják ki a legfelkészültebb jelentkezőt .	jelentkezőt	24	Acc
Ezen az árverésen azok is megtalálhatják a nekik tetsző tárgyat , akik jó befektetésre vágynak , de a kispénzű érdeklődők is reménykedhetnek , mert akad a listán könyvritkaság mindössze 800 forint kikiáltási áron .	áron	32	Sup
E tekintetben figyelemre méltó , hogy még legkeményebb bírálói is elismerik : akkor van igazán elemében , ha küzdenie kell .	elemében	15	Ine
A közép-kelet-európai államok rendszerspecifikus vonása , hogy a piacgazdaság közigazgatási , jogi intézményrendszere csupán az elmúlt tíz évben alakult ki , és ez rövid idő ahhoz , hogy az emberek tudata is átformálódjon .	vonása	4	Nom
A kiállítás ( és vásár ) szín- és formagazdagsága a tárgyak kézi megmunkálásának mesterségbeli biztonságáról , a manufakturális módszer gondosságáról vall .	kiállítás	1	Nom
— A Tui név is a keleti filozófiákra utal ?	filozófiákra	7	Sub
Az új , Kravola nevet viselő buszokból idén 20 , jövőre 80 darab készül , s ezeket a hazai piacon az Ikarus midibuszainál mintegy 20 százalékkal olcsóbban , 19,5 millió forintért tervezi értékesíteni a társaság .	nevet	4	Acc
Szóval ilyen és ehhez hasonló bennfentes mesékre tett szert a mi diploma nélküli orvosunk .	mesékre	6	Sub
Hiszen már szeptemberben , sőt a NATO-bombázások idején tudni lehetett : a szétlőtt finomítók egyhamar nem fognak teljes kapacitással működni , a tél viszont legalább olyan pontosan megérkezik , mint az újvidéki olajtartályokra a lézerirányítású bomba .	finomítók	13	Nom
A levél írója a hagyomány embere .	hagyomány	4	Nom
Mint Kontra Ferenc elmondta , a magyar fél már több jegyzékben kérte az orosz külügyminisztériumtól a beazonosított műtárgyak , köztük a Sárospataki könyvtár gyűjteményének visszajuttatását .	jegyzékben	10	Ine
Dubcekről ugyanis közismert volt , hogy következetes híve — Václav Havellal együtt — a csehek és szlovákok közös államának , és a két nemzet közötti vitás kérdéseket tárgyalások útján , de az állami keretek megőrzésével szeretné megoldani .	nemzet	23	Nom
Az Erste Bank Hungary Rt. a jövő héten teszi közzé az újságokban , milyen áron hajlandó megvenni a mintegy 1200 kisbefektető kezében lévő 77 ezer darab , a bank 9,2 milliárd forintos jegyzett tőkéjének négy százalékát kitevő részvényeit .	újságokban	11	Ine
Ráadásul a jelenlegi koalíció kénytelen elszenvedni az építészeti előírások évek óta jellemző megsértése miatti bírálatokat is .	bírálatokat	14	Acc
Az Ersténél abban reménykednek , hogy a saját részvények visszavásárlása szeptember 30-áig befejeződik — ekkor tartják azt a rendkívüli közgyűlést , amelyen a bank jegyzett tőkéjét a hitelintézeti törvényben előírt mértékhez igazítják .	részvények	8	Nom
A tervek szerint 10-15 százalékos , egyfajta nemzeti szolidaritási adóval terhelnék a személyi és a vállalati jövedelmeket , de szó van az ingatlanadó növeléséről , a mobiltelefonok és az autók egyszeri megadóztatásáról is .	adóval	9	Ins
A koszovói háború idején kirobbant konvojügy , az orosz KFOR-gépek átrepülése körüli bonyodalom , legutóbb pedig Orbán Viktor kanadai nyilatkozata váltott ki ingerült reakciókat Moszkvában .	nyilatkozata	19	Nom
Kiemelkedik az aukcióban részt vevő darabok közül egy ezüstből készült emeletes szédertál , amelyet cizellált arany elemekkel díszítettek és a súlya megközelíti a négy kilót .	súlya	20	Nom
Van viszont üldözés sítalpakon és sárkányrepülőn , motorcsónakon és olajvezetékben , és még egy atom-tengeralattjáró belseje is fontos szerepet kap , de ott már Bond az idővel is harcban áll , hogy megmenthesse az emberiséget .	sárkányrepülőn	5	Sup
Az 1944. március 19-e után elindított csoportba került e történet hőse is , a már majdnem orvos fiatalember .	hőse	10	Nom
Az április 4-5-én a Budapesti Műszaki Egyetem központi épületének aulájában tartandó fórumra közel tízezer diákot várnak .	aulájában	9	Ine
Zoran Zsivkovics polgármester hivatalában elmondták : semmiféle ünnepséget nem szerveztek a városban ebből az alkalomból , minthogy " már maga az ünnep , hogy a meleg lesz a lakásokban " .	ünnepséget	7	Acc
Az export csökkenését és a turizmus visszaesését részben kárpótolhatja a külföldön — például Németországban — dolgozó törökök hazautalásainak minden bizonnyal növekvő összege és az újjáépítés által támasztott keresletre épülő fellendülés .	csökkenését	2	Acc
Sztálin elvtárs ugyanis , ismerve gyengéjét , összekötőként elküldte hozzá a szép kis Pelagéját , mondván : legyen , aki Tito üzeneteit eljuttatja Moszkvába .	gyengéjét	5	Acc
" Az atrocitások száma folyamatosan csökken , s mérséklődik a komoly bűncselekmények aránya is " — jelentette ki elégedetten a napokban Mike Jackson tábornok , a Koszovóban szolgálatot teljesítő , 40 ezer főből álló Kfor-erők parancsnoka .	szolgálatot	27	Acc
Az összedőlt házak romjain egy újfajta polgári kezdeményezés csírái kezdtek kialakulni , a hivatalos állami segítség hiányát pótolva .	házak	2	Nom
Oregon állam egyik havas , csúszós autópályáján több mint 80 jármű — köztük diákokat szállító négy busz — szaladt egymásba .	autópályáján	6	Sup
A pályaudvari ceremóniára a hajdani " bajtársat " is meghívták .	ceremóniára	2	Sub
Az alkotmányerejű törvénnyel lehetőség nyílik arra , hogy name váltsák le tisztségéből Franjo Tudjman köztársasági elnököt , akit 24. napja súlyos állapotban kórházban ápolnak .	kórházban	22	Ine
A nisi polgármesteri hivataltól származó értesüléseink szerint a szerbiai városba szerda este megérkezett a 10 teherautó , amely az Európai Unió és a szerb ellenzék között létrejött megállapodás értelmében fűtőolajat szállít az ellenzéki vezetésű , közép-szerbiai településnek .	fűtőolajat	29	Acc
Az újság megszólaltatta Ante Vulin ismert építészt , aki megerősítette : néhány nappal ezelőtt felkérték arra , hogy tervezze meg Franjo Tudjman sírhelyét .	építészt	6	Acc
A jog nem tiltja , hogy egy nagykövet magánlevelet írjon , és azt sem tiltja , hogy a levélben magánvéleményként primitív és dehonesztáló állításokat fogalmazzon meg a magyar belpolitika egyes kérdéseiben .	kérdéseiben	30	Ine
Olyan sokan kerestek bérkocsit , hogy csak a szerencsések juthattak járműhöz .	bérkocsit	3	Acc
Persze mindenki maga dönti el , hogyan él , milyen áron marad életben .	áron	10	Sup
Tegnap este az autóbuszok sok helyütt két és fél órás késéssel érkeztek a célállomásra , a főútvonalakon pedig több kilométer dugók alakultak ki .	késéssel	10	Ins
Weltekére most viszont az a feladat vár , hogy 2002-ben elbúcsúztassa a németek háború utáni identitásának legfontosabb támaszát , hiszen az euró teljes körű bevezetésével a hétköznapi életben is meg kell majd válniuk a márkától .	támaszát	17	Acc
A tévé szerint a támadók egy négytagú járőrre nyitottak tüzet .	tévé	1	Nom
Olyan az emlékezet , mint a zsidó sírokon a kődarab .	emlékezet	2	Nom
Nem értik azt sem a szociáldemokraták , miért zárkóznak el mind a mai napig a vizsgálatban illetékes cseh hatóságok attól , hogy a zsolnai székhelyű Bírósági Műszaki Szakértői Intézet újra lejátssza a balesetet a baleset színhelyén .	balesetet	32	Acc
Mindig is szükségem volt fotókra a műveimről .	fotókra	4	Sub
— Ez a művésznevem , amit kétévesen választottam .	művésznevem	3	Nom
Pedig a marógép csupán másfél tengelyszélességben pusztította el a természetes akadályt .	akadályt	10	Acc
Az isztambuli értéktőzsdén ( ISE ) jegyzett 279 vállalat zöme a Márvány-tenger földrengés által sújtott keleti partvidékén és környékén — Törökország ipari szívében — vert tanyát , de többségük a börzéhez eljuttatott jelentésében nem tesz említést jelentősebb károkról .	tanyát	25	Acc
Ő mondta mindig , hogy aki az utolsó sorban ül , az is fizetett a jegyéért , tehát annak is kell értenie a szöveget .	szöveget	23	Acc
Nem következett be világméretű katasztrófa , mert a globalizált gazdaságban a nagy tőketömegek mozgatásával ezt el lehetett kerülni .	mozgatásával	13	Ins
Ami persze értelmezhető egyszerű szavazatszerző kampányfogásként — de jól mutatja a szociáldemokraták hosszabb távú dilemmáit és megosztottságát is .	dilemmáit	14	Acc
Nem nehéz megjósolni : az elnapolt terv olyan nagyszabású fejlesztéseket javasol , melyeket a közelgő közlekedési krízis ellenére sem tud a főváros — természetesen pénz hiányában — megvalósítani .	fejlesztéseket	9	Acc
Így nevezik az Európai Unió és a szerb ellenzék közötti megállapodást , amelynek köszönhetően a " szabad városok " — copyright by Bodo Hombach , ( EU ) — fűtőolajhoz jutnak .	városok	17	Nom
Ennek ellenére egy " optikai tuningfelszerelések " tömkelegében pompázó Audi A4 Quattro nekivág a domboknak Pilisszántó irányában .	irányában	16	Ine
Leksa perújrafelvételt is kezdeményezett az ügyben , sőt Milos Zeman cseh miniszterelnök is támogatja az új nyomozás lefolytatását — ellentétben elődjével , Václav Klausszal .	elődjével	20	Ins
A horvát elnök egészségi állapota mindeközben tovább romlott , és sajtóértesülések szerint egy neves horvát építészt már felkértek arra , hogy tervezze meg Franjo Tudjman síremlékét .	építészt	15	Acc
Orvosnak készült , de rossz évjáratban jutott az egyetem lépcsőjéig : származása okán — meglengették fölötte a numerus clausus mocskos zászlaját — úgy elzavarták , mint koldust a fukar ember házától .	évjáratban	5	Ine
Magánlevelet ír , miközben a levele a legmélyebben beavatkozik a magyar közállapotokba .	Magánlevelet	0	Acc
Gyógyszer , műszer itt volt elég — az angolok ejtőernyőjével küldték az utánpótlást — , csak éppen orvosból volt hiány .	ejtőernyőjével	9	Ins
A jog nem tiltja , hogy egy nagykövet magánlevelet írjon , és azt sem tiltja , hogy a levélben magánvéleményként primitív és dehonesztáló állításokat fogalmazzon meg a magyar belpolitika egyes kérdéseiben .	magánlevelet	8	Acc
A kétoldalú viszony , a magyar-orosz gazdasági együttműködés egyik problémája az orosz államadósság rendezetlensége .	államadósság	12	Nom
Mindaz a képzeletszülte meseelem , ami a gorillacsaládban nevelkedő embergyerek regénybeli történetének kalandos feszültséget és romantikus lendületet kölcsönzött , ezúttal a rajzfilm műfajában levetette az élő megjelenítés korlátait .	lendületet	16	Acc
Az eldugott települések lakói már hozzászokhattak , hogy a közepesnél erősebb havazások majd minden esztendőben elzárják őket néhány napra a külvilágtól .	napra	18	Sub
A nemzetközi pénzintézet szeptemberben küldi embereit Ankarába , és várhatóan még az év vége előtt megszülethet az egyezség egy 5-10 milliárd dolláros hitelkeretről .	egyezség	17	Nom
A felügyeleti felszólításnak eleget téve a hó végi közgyűlésen először a részvények lebélyegzése révén 2 milliárd forinttal csökkentik a jegyzett tőkét , majd a fő tulajdonos osztrák Erste AG ugyancsak 2 milliárddal tőkésíti fel magyarországi érdekeltségét .	érdekeltségét	35	Acc
A megyei mentési feladatokkal a megyei védelmi bizottságokat bízták meg , ezek irányítását és az információszolgáltatást pedig az operatív bizottság végzi .	feladatokkal	3	Ins
Kovács László személyében magyar külügyminiszter utoljára 1996 márciusában járt Moszkvában .	személyében	2	Ine
Az egyesület alelnöke , természetesen maga is aktív tagja a " kivonuló " brigádnak , nem tud napirendre térni az emberek viselkedésén .	viselkedésén	21	Sup
Az export csökkenését és a turizmus visszaesését részben kárpótolhatja a külföldön — például Németországban — dolgozó törökök hazautalásainak minden bizonnyal növekvő összege és az újjáépítés által támasztott keresletre épülő fellendülés .	külföldön	10	Sup
Tényleg hihetetlen , de Edgar Rice Burroughs híres regényhőse eddig már vagy ötvenszer kelt életre a mozivásznon , de rajzfilmen most először elevenednek meg kalandjai a Walt Disney Stúdió produkciójában .	mozivásznon	16	Sup
A Szlobodan Milosevics jugoszláv elnök vezette belgrádi rezsim pedig azért cenzúrázza a szerbek megpróbáltatásairól és tömeges meneküléséről szóló híreket , hogy továbbra is azt állíthassa : Szerbia megvédte Koszovót , s így megnyerte a NATO elleni háborút .	háborút	36	Acc
A kiállítás egyik szenzációja az az egy méter magas , áttört Zsolnay-díszváza , amely ezen a kiállításon látható először .	kiállításon	16	Sup
" Az atrocitások száma folyamatosan csökken , s mérséklődik a komoly bűncselekmények aránya is " — jelentette ki elégedetten a napokban Mike Jackson tábornok , a Koszovóban szolgálatot teljesítő , 40 ezer főből álló Kfor-erők parancsnoka .	atrocitások	2	Nom
Ezért is fontos , hogy a viszony a korrektségen , a kiszámíthatóságon , egymás érdekeinek kölcsönös tiszteletben tartásán alapuljon .	kiszámíthatóságon	11	Sup
Persze mindenki maga dönti el , hogyan él , milyen áron marad életben .	életben	12	Ine
— Platón szerint a művészet alapvető feladata a rend megmutatása a káoszban .	káoszban	11	Ine
Ha oroszt tanítana , nyilván azt mondaná tanítványainak hogy Tatyjána levelét voltaképpen Anyegin írta , netán Lenszkijnek .	levelét	10	Acc
Kardelj hozta a hírt , hogy valamelyik hegyi kórházukban működik egy magyar orvos , aki bizonyos helyzetekben hipnózisban altatja az operálandó betegeket .	orvos	12	Nom
Egyébként is szeretem az operettet , mulattat , s mindig szívesen szerepeltem ilyen darabokban .	operettet	4	Acc
Brazíliában 300 millió dollárt fordítottak 75 ezer ember kezelésére .	kezelésére	8	Sub
A kolozsváriak 1990-es vendégjátékán tapsolhattunk Senkálszky Endrének is , aki éppen hatvan esztendeje aktív tagja a Magyar Színháznak .	vendégjátékán	3	Sup
A rendszerváltás radikális fordulatot hozott .	fordulatot	3	Acc
A kormányhatározat által nyújtott lehetőség alapján 11,5 milliárd forint új hitelt vehetnek fel a tartósítóipari termékeket gyártók , a nyolc hónapos futamidejű konstrukcióban a tőketörlesztésre négy hónap moratóriumot kapnak .	konstrukcióban	22	Ine
Az illetékesek elejétől fogva óvatosan kezelték a Nyugatra szökött volt KGB-ügynök " leleplezéseit " , ezért az olaszokra vonatkozó listát ugyan közreadták , de az igazságügyi szervek azóta alaposan tanulmányozzák azt .	listát	19	Acc
Egyébként lassan már két évtizede foglalkozom film- és színházi zenével , s nagyon szeretem csinálni .	zenével	9	Ins
Brüszszelben nem is tagadják : a folytatás attól függ , hogy az elkövetkezendő tíz napban rendben megérkeznek -e Nisbe és Pirotba a szállítmányok .	rendben	15	Ine
A felügyeleti felszólításnak eleget téve a hó végi közgyűlésen először a részvények lebélyegzése révén 2 milliárd forinttal csökkentik a jegyzett tőkét , majd a fő tulajdonos osztrák Erste AG ugyancsak 2 milliárddal tőkésíti fel magyarországi érdekeltségét .	közgyűlésen	8	Sup
Az önkéntes tűzoltók még kora este kezdték meg karitatív műszakjukat , s nem volt lehetőségük túlságosan sok kávészünetre .	műszakjukat	9	Acc
Ma a korszerű hangzáshoz hozzátartozik az ütős hangszerek kiemelt szerepeltetése is , s úgy veszem észre , hogy a közönség is szereti az ilyen kompozíciókat .	kompozíciókat	24	Acc
Mivel az élet természeténél fogva leírhatatlan , és milliárdnyi történése a résztvevők között újra meg újra megkötött értelmezési szövetségen múlik , az új beszédből kimaradt az élet , kimaradtak az emberek .	szövetségen	18	Sup
A vezetékre rakódott vizes hó miatt a Dnyeper melléki vasútvonalakon villanymozdony helyett gőzmozdonyok vontatták a személyszállító szerelvényeket .	vasútvonalakon	9	Sup
Az IMF által tanácsolt közvetlen jövedelemkiegészítési támogatás bevezetése — amely sok farmert érzékenyen érintene — ugyancsak nehéz döntés elé állítja a török kormányt , mivel a 65 milliós lakosság 45 százaléka gazdálkodó , ami jelentős politikai erőt jelent .	gazdálkodó	31	Nom
Péter Gábor pár perc múlva jelentette : csak egy orvos , aki a partizánok között gyógyított .	orvos	9	Nom
Ezen az árverésen azok is megtalálhatják a nekik tetsző tárgyat , akik jó befektetésre vágynak , de a kispénzű érdeklődők is reménykedhetnek , mert akad a listán könyvritkaság mindössze 800 forint kikiáltási áron .	könyvritkaság	27	Nom
A 485,7 milliárd márkás német költségvetésből 30 milliárd megspórolására hivatott tervből ( HVG , 1999. július 10. ) immár hivatalos kormány-előterjesztéssé nemesedett intézkedéssorozat már a párton , sőt annak parlamenti frakcióján belül sem talált egyértelmű támogatásra .	párton	25	Sup
S azt sem , hogy emlékeik felélednek -e majd , ha jövőre kocsit kell venni az önkéntes tűzoltóknak vagy hálájuk elolvad tavasszal a ma még legyőzhetetlennek tűnő hóval együtt .	hálájuk	19	Nom
Ennek érezhető következménye például , hogy az elméleti kutatások eredményeit sokkal hamarabb hasznosítják a gyakorlati életben , mint korábban .	életben	15	Ine
Végül ez év elején a társaság vezérigazgatója is felmondott , így a ma már csak néhány alkalmazottat foglalkoztató cég ügyeit várhatóan a végelszámolásra kiszemelt Budapest Holding Első Hazai Vagyonkezelő Rt. zárja le .	alkalmazottat	16	Acc
Kardelj hozta a hírt , hogy valamelyik hegyi kórházukban működik egy magyar orvos , aki bizonyos helyzetekben hipnózisban altatja az operálandó betegeket .	hipnózisban	17	Ine
Ezekben az országokban 1997 és 1999 között megduplázódott az AIDS-esek száma .	országokban	2	Ine
Rezník nem sokkal a szerencsétlenség előtt került Dubcek mellé , aki nem kedvelte őt .	szerencsétlenség	4	Nom
Varsó meredekebb részein és a hidakon csigatempóban haladt a gépkocsiáradat .	csigatempóban	6	Ine
Gyönyörű színpadi beszédét gyakran emlegetik példaként , nem véletlenül tanított diplomája kézhezvétele után négy éven át beszédtechnikát a főiskolán .	főiskolán	18	Sup
A Corriere della Sera című lap szerint az egyik nevet sikerült azonosítania az üggyel foglalkozó katonai főállamügyésznek .	nevet	9	Acc
A török alkotmány úgy utal az államra , mint amelynek " területe és nemzete " van , szemben a nyugat-európai felfogással , ahol a nép alkotja az államot .	nemzete	13	Nom
Kísértetek szabadultak el a szabaddá vált nyilvánosságban , a szavak gyilkos , ordas , gonosz indulatok árján úszva szorongást , félelmet , az egyszer volt újra megtörténhetésének vélelmét keltették fel .	vélelmét	27	Acc
Az aszfalton feltehetőleg irigy pillantásokat vonzó autócsoda hamarosan tehetetlen vasdarabbá válik , alaposan beragad a hócsapdába .	pillantásokat	4	Acc
Súlyosnak minősítette a horvát köztársasági elnök egészségi állapotát a Tudjmant kezelő zágrábi orvoscsoport .	orvoscsoport	12	Nom
Októberben töltötte be a 85. életévét , de a kor színpadi munkáján nem hagyott nyomot .	munkáján	11	Sup
Itt minden megtörténhet egy az egyben , még az is , hogy Tarzan beszélget az állatokkal , hogy úgy mozog , mint ők , akiktől a dzsungelélet minden fortélyát el kellett tanulnia az életben maradáshoz .	dzsungelélet	26	Nom
Mindaz a képzeletszülte meseelem , ami a gorillacsaládban nevelkedő embergyerek regénybeli történetének kalandos feszültséget és romantikus lendületet kölcsönzött , ezúttal a rajzfilm műfajában levetette az élő megjelenítés korlátait .	gorillacsaládban	7	Ine
A kft 1998-ig elsősorban felújított Ikarus buszok oroszországi , illetve FÁK-országi exportjával , valamint pótalkatrész értékesítésével foglalkozott .	exportjával	11	Ins
A tőkeemelésben mindazonáltal a kisbefektetők nem vehetnek részt , mivel egyúttal az Erste átalakul zártkörű társasággá , amelynek viszont tagjai maradnak azok , akik nem élnek a pénzintézet visszavásárlási ajánlatával .	kisbefektetők	4	Nom
A kiállítás ( és vásár ) szín- és formagazdagsága a tárgyak kézi megmunkálásának mesterségbeli biztonságáról , a manufakturális módszer gondosságáról vall .	tárgyak	10	Nom
Az IMF 330 millió , a Világbank 220 millió dolláros kedvezményes kölcsönt helyezett kilátásba , az Európai Unió 40 millió eurós építési segélyt ígért .	segélyt	22	Acc
Egyes vélemények szerint aggasztó , hogy a reálgazdaságtól egyre inkább elválik a tőkepiacok mozgását jelentő virtuális gazdaság .	mozgását	13	Acc
Napjainkban azonban a kortárs zenének nincs infrastruktúrája .	Napjainkban	0	Ine
A 72 tagú konferencia által , három püspök fenntartásai mellett elfogadott közlemény szerint a testület megvizsgálja , van -e lehetőség arra , hogy a katolikus irodák az igazolások kiállítása nélkül is benn maradjanak a terhestanácsadás törvényes rendszerében .	rendszerében	36	Ine
Van viszont üldözés sítalpakon és sárkányrepülőn , motorcsónakon és olajvezetékben , és még egy atom-tengeralattjáró belseje is fontos szerepet kap , de ott már Bond az idővel is harcban áll , hogy megmenthesse az emberiséget .	olajvezetékben	9	Ine
Mario Babiucról van szó , aki " Ikar " fedőnéven szerepelt a szovjet titkosszolgálat jelentéseiben .	jelentéseiben	14	Ine
Brüszszelben nem is tagadják : a folytatás attól függ , hogy az elkövetkezendő tíz napban rendben megérkeznek -e Nisbe és Pirotba a szállítmányok .	napban	14	Ine
A KHVM új testületében helyet kapott a Miniszterelnöki Hivatal , a Belügyminisztérium , az Országos Meteorológiai Szolgálat , a MÁV Rt. , a Volán Egyesülés , a Közlekedési Főfelügyelet is .	testületében	3	Ine
A kamattámogatás is differenciált : az állami garancia nélküli hitelekre 100 , a garantált hitelekre pedig a kezességvállalás mértékének növekedésével csökkenően 75 , illetve 40 százalék .	kezességvállalás	17	Nom
A kegytárgyak , műtárgyak sajátos szépsége és történeti értéke mellett az anyag finomsága és a megformálás egyedisége is megragadhatja az érdeklődőket .	kegytárgyak	1	Nom
Előzetes adatok szerint Kijev megyében 45 , Lemberg megyében 139 , Poltavában 195 , Cserkassziban 62 , Dnyipropetrovszk megyében 396 , Donyeckben 42 , Mikolajivban pedig 46 falu , város borult sötétségbe .	falu	27	Nom
Az Orahovacban rekedt szerbek viszont másként gondolják , s azt állítják , hogy az albánok még arra sem hajlandóak , hogy elégséges vizet és élelmet juttassanak a szerb negyedbe .	vizet	22	Acc
Bécs Budapest - Wien Budapest 2000 címmel kétnyelvű album látott napvilágot a Well-Press Kiadó gondozásában .	gondozásában	14	Ine
Az utóbbi évtized balkáni történelme alapján valószínűnek tűnik , hogy az otthonuk mellett kitartóknak hamarosan fegyveres látogatókra is számítaniuk kell .	évtized	2	Nom
Ami helyettük maradt , az nem több , mint fonémák zagyva halmaza , melynek jelentését a hatalom és egyes-egyedül a hatalom képes csak megszabni , nem számít a konvenció , de még a közvetlen tapasztalat sem .	halmaza	11	Nom
Az IMF által tanácsolt közvetlen jövedelemkiegészítési támogatás bevezetése — amely sok farmert érzékenyen érintene — ugyancsak nehéz döntés elé állítja a török kormányt , mivel a 65 milliós lakosság 45 százaléka gazdálkodó , ami jelentős politikai erőt jelent .	erőt	36	Acc
A politikától távol tartotta magát , jóllehet , azokban a fényes szelekkel átfújt években a magyar baloldalon még nagyon szerették Titót .	szelekkel	11	Ins
A kutatók minden bizonnyal felfigyelnek a nagykövet által önállótlanul alkalmazott kétosztatú gondolkodásra , mely tisztességesekre és tisztességtelenekre osztja a társadalmat , melynek elvben osztatlan képviseletét kellene ellátnia .	gondolkodásra	11	Sub
A 72 tagú konferencia által , három püspök fenntartásai mellett elfogadott közlemény szerint a testület megvizsgálja , van -e lehetőség arra , hogy a katolikus irodák az igazolások kiállítása nélkül is benn maradjanak a terhestanácsadás törvényes rendszerében .	konferencia	3	Nom
Jung mondta , ha az autó befordul a sarkon , nem látjuk , de attól még létezik .	sarkon	8	Sup
A Brüsszelben június 21-én aláírt megállapodás 7 területen irányoz elő az eddiginél szorosabb együttműködést Svájc és az európai integráció között .	megállapodás	5	Nom
Mumadi Szajdajev ugyancsak hamisnak nevezte azokat az orosz jelentéseket , amelyek szerint a csecsen harcosok tömegesen hagyják el Groznijt és a várostól délre lévő hegyekben keresnek menedéket .	hegyekben	24	Ine
A mondatot pontosan értette a vallató és a vallatott szerepében kényszerűen egyaránt járatos igazgató , és értetlenséget színlelve megtiltotta a költőnek , hogy szavai nyilvánosságot kapjanak .	mondatot	1	Acc
A Kfor-illetékesek beszámolói szerint ugyan megkezdődött a szerbek lassú visszatelepülése , ám helyszíni jelentések alapján még mindig többen vannak a távozók .	beszámolói	2	Nom
Mint Kiss Gergely , az egyesület titkára a HVG-nek elmondta , a tagok közé kerülhetnek a főnemesek mellett a köznemesek is .	egyesület	5	Nom
A Szlobodan Milosevics jugoszláv elnök vezette belgrádi rezsim pedig azért cenzúrázza a szerbek megpróbáltatásairól és tömeges meneküléséről szóló híreket , hogy továbbra is azt állíthassa : Szerbia megvédte Koszovót , s így megnyerte a NATO elleni háborút .	híreket	18	Acc
Szakértők szerint a nemzetközi döntőbíráskodást megtiltó 1995-ös törvény más egyéb okokkal együtt 2-6 milliárd dollárnyi külföldi beruházástól fosztotta meg a gazdaságot , főként az infrastruktúra területén .	döntőbíráskodást	4	Acc
A kegytárgyak között is vannak egészen különleges darabok , mint például egy kisméretű tóratekercs , amelynek a története is érdekes .	darabok	7	Nom
Zoran Zsivkovics polgármester hivatalában elmondták : semmiféle ünnepséget nem szerveztek a városban ebből az alkalomból , minthogy " már maga az ünnep , hogy a meleg lesz a lakásokban " .	lakásokban	28	Ine
Tavaly az állami gabonatanács 8 millió tonna szemes terményt vett át , s a mennyiséget az idén 4,5 millióban szeretné korlátozni , mert tavaly például előfordult , hogy olcsón beszerzett iraki búzát adtak tovább a hatóságoknak .	mennyiséget	14	Acc
— Ez alatt a fél évszázad alatt szinte az egész baritonrepertoárt elénekelte , egyedül Wagner darabjaiban nem lépett színpadra .	darabjaiban	15	Ine
Újraöntik és eredeti helyén ismét felállítják Bory Jenő szobrászművész ( 1879-1959 ) Sebzett hős című alkotását .	alkotását	15	Acc
Nem szeretem a zsúfoltságot , egy zsúfolt kiállításról jobb az elején kijönni , mielőtt elfolyik a maradék életerőnk .	maradék	16	Nom
Új népszokás született , aki unatkozik , kimegy a ház elé , és elhányja a havat .	népszokás	1	Nom
Hacsak a jugoszláv utakon , némi hatósági közreműködéssel , lába nem kél a szállítmánynak .	közreműködéssel	7	Ins
Ami helyettük maradt , az nem több , mint fonémák zagyva halmaza , melynek jelentését a hatalom és egyes-egyedül a hatalom képes csak megszabni , nem számít a konvenció , de még a közvetlen tapasztalat sem .	jelentését	14	Acc
Ezen az árverésen azok is megtalálhatják a nekik tetsző tárgyat , akik jó befektetésre vágynak , de a kispénzű érdeklődők is reménykedhetnek , mert akad a listán könyvritkaság mindössze 800 forint kikiáltási áron .	listán	26	Sup
Egy év után Simicska Lajos feladta : az adóhivatal elnöke családi halálesetekre és az ellene irányuló folyamatos támadásokra hivatkozva kedden — miután találkozott Orbán Viktor miniszterelnökkel — lemondott .	halálesetekre	11	Sub
Ha a szemlélő túlteszi magát az egy éve tartó és várhatóan tovább durvuló főváros-kormány vitán , akkor is látszik , hogy a nagyobb beruházások még közös finanszírozásban is túl nagy falatot jelentenének .	vitán	14	Sup
Az ENSZ és a NATO abban bízik , hogy a tények kozmetikázásával sikerül valamilyen formában helyreállítani a tartomány többnemzetiségű státusát .	formában	14	Ine
Nisen kívül Pirot városa részesül még az " Energia a demokratizálódáshoz " elnevezésű akció keretén belül nyújtandó fűtőolaj-szállítmányból .	keretén	14	Sup
A szerencsétlenül járt emberek számának növekedésével ellentétben az anyagi károkkal kapcsolatos első — 20-40 milliárd dolláros — becslések viszont túlzottaknak bizonyultak .	károkkal	9	Ins
— Aki valami miatt személyesen nem lehet jelen ezen az esten , az is meghallgathatja majd ennek a koncertanyagát , hiszen ezekből a szerzeményekből lemezfelvétel is készül .	koncertanyagát	18	Acc
Én pontosan emlékszem egy negyvenöt esztendővel ezelőtti beszélgetésre , amelynek minden szavát megfogadtam .	esztendővel	5	Ins
A 72 tagú konferencia által , három püspök fenntartásai mellett elfogadott közlemény szerint a testület megvizsgálja , van -e lehetőség arra , hogy a katolikus irodák az igazolások kiállítása nélkül is benn maradjanak a terhestanácsadás törvényes rendszerében .	terhestanácsadás	34	Nom
A közbeszéd szavai az évek során egyre csak torzultak , egyre értelmetlenebbé váltak , az értelmes közlés útján álló torlaszokat képeztek .	útján	17	Sup
" Ami történt , oly mély sebeket ejtett — írta a Radikal című lap szemleírója , Erol Katircioglu — , hogy a földrengés után Törökország már soha nem lesz az , ami előtte volt . "	szemleírója	14	Nom
A moszkvai külügyminiszteri megbeszéléseken Martonyi János föl kívánja vetni a Szovjetunióba vitt magyar műkincsek visszaszolgáltatásának kérdését .	kérdését	15	Acc
Két utas életét vesztette , és rengeteg amerikait súlyos sérüléssel kellett kórházba szállítani .	amerikait	7	Acc
A cég helyzetét a növekvő konkurencián kívül rontotta , hogy a kiskereskedelmi üzletek eladását szolgáló előprivatizáció keretében több boltját elvonták , ingatlanvagyonának 86 százalékát így két nagyméretű — 6 ezer négyzetméter körüli — raktár tette ki .	boltját	18	Acc
— Általában a ritmusos kompozíciókat szeretem , a giusto tempójú darabokat , amelyekben kézenfekvő az ütőhangszerek használata .	darabokat	10	Acc
A nyelv , amelyen ír , már a jelené , de ahogyan ír , az még a múlt .	jelené	8	Nom
A vezető leszállította az utasokat , azután a feldühödött tömeg összetörte a busz reflektorait , de jó néhány ablakát is .	utasokat	4	Acc
— A szép beszéd egyébként is kiemelkedő szerephez jut pályáján , hiszen minden évben egyszer díjátadóként lép színpadra az Operaházban , hogy a szép magyar kiejtésért alapított elismerését az erre legméltóbbnak talált kollégájának átnyújtsa .	elismerését	27	Acc
Az EU éppen a fal lebontásának napján tette közzé nyilatkozatát , amely szerint a cseh EU-tagság egyik fő gondja a csehországi roma népességgel való nem megfelelő bánásmód .	népességgel	22	Ins
A gazdasági program végrehajtását az IMF feltételként szabta egy készenlétihitel-megállapodáshoz , amelyre — függetlenül a földrengéstől — égetően szüksége van az országnak .	program	2	Nom
Itt minden megtörténhet egy az egyben , még az is , hogy Tarzan beszélget az állatokkal , hogy úgy mozog , mint ők , akiktől a dzsungelélet minden fortélyát el kellett tanulnia az életben maradáshoz .	állatokkal	15	Ins
A CD a Budapesti Music Center kiadásában lát majd napvilágot .	kiadásában	6	Ine
A lórévi polgármester is hasznos elfoglaltságot talált magának , hozzájuk ugyanis már a kenyereskocsi sem jut be .	elfoglaltságot	5	Acc
Amikor az SPD 1969-ben , a második világháború után először megnyerte a választásokat , az annak volt köszönhető , hogy Willy Brandt meg tudta győzni a választókat , mondhatni szociáldemokratákat csinált belőlük .	szociáldemokratákat	29	Acc
Rájuk férne némi fűtőolaj-szállítmány , hogy a fagyos viszony felengedjen , és ők is — hasonlóan az unióhoz — name csak a frázisok terén legyenek energikusak , hanem a demokráciát illetően is .	fűtőolaj-szállítmány	3	Nom
Tömegbalesetet okozott a rendkívüli havazás az Egyesült Államokban is .	Tömegbalesetet	0	Acc
A rendezvény hivatalos kiadványa a 4500 példányban megjelenő Állásbörze Kalauz .	példányban	6	Ine
Az ENSZ és a NATO abban bízik , hogy a tények kozmetikázásával sikerül valamilyen formában helyreállítani a tartomány többnemzetiségű státusát .	tartomány	17	Nom
A digitalizált látvánnyá felturbózott kalandok sorjázásában tán kevesebb is rá az idő , elég munkájába kerülhet a stábnak már az is , hogy az intellektus fölénye azért name vesszen ki hősünkből az elképesztő csodaketyerék mellett .	intellektus	24	Nom
A magyar fővárosban december 8-án a Néprajzi Múzeumban kerül sor az album 1-től 10-ig sorszámozott példányainak az aukciójára , míg Bécsben várhatóan a jövő év februárjában rendezik meg a licitet .	licitet	29	Acc
Az önkéntes tűzoltók még kora este kezdték meg karitatív műszakjukat , s nem volt lehetőségük túlságosan sok kávészünetre .	kávészünetre	17	Sub
A gazdaság ilyen mértékű fejlődését több folyamat gerjeszti , többek között a magánosítás elterjedése és a tőkekoncentráció .	magánosítás	12	Nom
Állták a szavukat : a szerződés ratifikálása után a szlovák aranykincs várhatóan a jövő év elején , azt követően kerülhet Pozsonyba , hogyha az egyezményt már a két parlament is ratifikálta .	egyezményt	24	Acc
A digitalizált látvánnyá felturbózott kalandok sorjázásában tán kevesebb is rá az idő , elég munkájába kerülhet a stábnak már az is , hogy az intellektus fölénye azért name vesszen ki hősünkből az elképesztő csodaketyerék mellett .	fölénye	25	Nom
Az államnak csupán a gazdaság szervezésében , az információ közvetítésében , az alkalmazkodás segítésében kell részt vennie , nem szabad közvetlenül beavatkoznia a gazdaságba .	szervezésében	5	Ine
A szocdemek szerint éppen ezért akadályozta mind a cseh Klaus-kabinet , mind a szlovák Vladimír Meciar kormánya az első — és szerintük felületes — vizsgálat megismétlését .	megismétlését	25	Acc
Vlagyimir Putyin hangsúlyozta , hogy az új amnesztiát — amely hasonló lenne az 1994-96-os orosz-csecsen háborút követő moszkvai bűnbocsánathoz — mindenképpen megszavazná az orosz alsóház .	háborút	15	Acc
Az elmúlt évben főként informatikusokat , villamosmérnököket , gépészmérnököket kerestek a vállalatok , jövőre várhatóan más műszaki területekről is igényelnek szakembereket .	informatikusokat	4	Acc
Veszprém megyében a 8-as úton órákon állt a forgalom Várpalota és a péti elágazás között két elakadt kamion miatt .	úton	4	Sup
Vagy a nem zsidó temetőkben a november eleji gyertyaláng .	temetőkben	4	Ine
És még egy riasztó adat : 1999-ben 5,6 millió felnőttet és gyermeket fertőzött meg az AIDS kialakulását okozó HIV-vírus .	felnőttet	9	Acc
Ami helyettük maradt , az nem több , mint fonémák zagyva halmaza , melynek jelentését a hatalom és egyes-egyedül a hatalom képes csak megszabni , nem számít a konvenció , de még a közvetlen tapasztalat sem .	tapasztalat	34	Nom
A globalizációt tehát tőkekoncentráció is kíséri .	globalizációt	1	Acc
A legáltalánosabb kritika , hogy a kormánynak nemhogy katasztrófaelhárítási terve nem volt , de a tragédia bekövetkezte után sem állt a helyzet magaslatán .	magaslatán	22	Sup
A polgármesteri hivatalban nem tartottak attól , hogy a szállítmány esetleg nem érkezne meg rendeltetési helyére .	hivatalban	2	Ine
Mint egy edényben , az üresség , azaz a lélek tölti ki a formát .	edényben	2	Ine
Jevgenyij Primakov ezt a vizitet viszonozva , tavaly februárban látogatott el Budapestre .	vizitet	4	Acc
Az állásbörze nemcsak a végzős diákoknak hasznos , az alsóbb évesek is gyűjthetnek tapasztalatokat , felmérhetik a követelményeket , kapcsolatba kerülhetnek a vállalatokkal , szakmai gyakorlatokra jelentkezhetnek .	tapasztalatokat	13	Acc
A nagyobbik koalíciós erő , a Szolidaritás Választási Akció ( AWS ) egyik csoportja , a Katolikus Családok Szervezete tagjának számító Kapera 1991-ben már lemondani kényszerült akkori egészségügyi államtitkár-helyettesi posztjáról , mert nyilvánosan perverzeknek minősítette a homoszexuálisokat .	erő	3	Nom
Varsó meredekebb részein és a hidakon csigatempóban haladt a gépkocsiáradat .	részein	2	Sup
Az IMF 330 millió , a Világbank 220 millió dolláros kedvezményes kölcsönt helyezett kilátásba , az Európai Unió 40 millió eurós építési segélyt ígért .	kölcsönt	11	Acc
Oroszország a múlt heti isztambuli EBESZ-csúcson vonakodva bár , de beleegyezett abba , hogy az EBESZ elnöke ellátogasson a szakadár kaukázusi köztársaságba .	EBESZ-csúcson	5	Sup
A Jutarnji List című ellenzéki napilap szerdai számának címoldalán A legrosszabb várható címmel arról adott hírt , hogy " többé már az intenzív kezelés sem segít " az elnökön .	elnökön	28	Sup
A kiadvány 160 színes fotó segítségével ad képet az alkotó munkásságáról .	képet	7	Acc
Szerényen magánszemélyként tolakszik elő , miközben levélpapírján cirkalmas betűk hirdeti magas köztisztviselői rangját .	levélpapírján	6	Sup
A városi hatóságokra erős nyomást gyakorolt a prágai kormány is a fal lebontása érdekében .	hatóságokra	2	Sub
Decemberben , a kolozsváriak tervezett Vígszínház-beli vendégjátékán erről a budapesti közönség is megbizonyosodhat , amikor is majd Shakespeare Troilus és Cressidájának Teiresziászaként láthatjuk őt a magyar fővárosban .	Decemberben	0	Ine
Meg kell teremteni a versenygazdaság infrastrukturális feltételeit , a közlekedési úthálózatot ( ezen a téren van a legnagyobb elmaradás ) , a korszerű kommunikációs és pénzügyi rendszert .	feltételeit	6	Acc
Kamionok okoznak fennakadást az ország más pontjain is .	pontjain	6	Sup
Zoran Zsivkovics polgármester hivatalában elmondták : semmiféle ünnepséget nem szerveztek a városban ebből az alkalomból , minthogy " már maga az ünnep , hogy a meleg lesz a lakásokban " .	hivatalában	3	Ine
Ezen az árverésen azok is megtalálhatják a nekik tetsző tárgyat , akik jó befektetésre vágynak , de a kispénzű érdeklődők is reménykedhetnek , mert akad a listán könyvritkaság mindössze 800 forint kikiáltási áron .	befektetésre	13	Sub
Igor Ivanov azt is elfogadta , hogy EBESZ küldöttsége december első felében utazzon a körzetbe .	küldöttsége	8	Nom
Úgy vélekedett , hogy a banditák " élő pajzsként " használják fel polgári lakosokat , ezért a civileknek el kell hagyniuk a csecsen fővárost , s az orosz hatóságok " mindennel el fogják látni őket " .	fővárost	23	Acc
A cég ugyan jelezte , hogy alaptőke-emelést tervez , ám " az rt-nél kialakult helyzet kedvezőtlenül befolyásolhatja a tervezett tőkeemelés lefolytatását " — olvasható az ÁPTF-nek a Magyar Tőkepiacban közzétett határozata indoklásában .	lefolytatását	20	Acc
— Az utóbbi években a közönség több filmben is találkozhatott önnel .	filmben	7	Ine
Az isztambuli értéktőzsdén ( ISE ) jegyzett 279 vállalat zöme a Márvány-tenger földrengés által sújtott keleti partvidékén és környékén — Törökország ipari szívében — vert tanyát , de többségük a börzéhez eljuttatott jelentésében nem tesz említést jelentősebb károkról .	jelentésében	32	Ine
Milos Zeman és Mikulás Dzurinda azonban alig egy éve , közvetlenül a szlovákiai kormányváltás után máris egyezséget kötött , amelynek értelmében egy éven belül pontot tesznek az ügy végére .	egyezséget	16	Acc
Az egyetlen dolog az életben , amivel azonos vagyok .	dolog	2	Nom
Két ember életét vesztette a balesetekben , s sokakat kellett kórházba szállítani sérülésekkel is .	sérülésekkel	12	Ins
Az egyetemen immár hagyománnyá vált az egy hónapos Felkészítő Napok rendezvénysorozat , amelyen az álláskeresés módszereit ismerhetik meg jobban a hallgatók ; hogyan viselkedjenek , kommunikáljanak , miként mutassák be tudásukat , képességeiket egy interjú során .	egyetemen	1	Sup
Nem kizárt , hogy a földrengés nemcsak a Márvány-tenger menti térséget rázta meg , de törést okozott a monolitikus bürokrácia és az egyre individualistább , a magángazdaságban edződő , tanult lakosság viszonyában is .	viszonyában	31	Ine
Tényleg hihetetlen , de Edgar Rice Burroughs híres regényhőse eddig már vagy ötvenszer kelt életre a mozivásznon , de rajzfilmen most először elevenednek meg kalandjai a Walt Disney Stúdió produkciójában .	életre	14	Sub
Van , akit már csak a síron túl érhet utol .	síron	6	Sup
Tetejükig hóba süppedt autókat és utasaikat mentették egész éjjel ( és szerdán napközben is ) .	autókat	3	Acc
A levél írója figyelemre méltóan asszimilálódott a fideszes newspeak szabályaihoz .	írója	2	Nom
Egyre nagyobb ugyanis a túlélők hatóságokkal szembeni haragja , szinte példa nélkül álló bírálatözön hull a kormány , a miniszterek és az állami intézmények fejére .	hatóságokkal	5	Ins
A német bankvilág Olümpuszát eddig megjárt hét elnök ugyanis a pénzügyi stabilitás legfőbb őreként , a szigorú kamatpolitika és a pénzmennyiség kézbentartása útján akár a mindenkori kormánnyal való konfliktust is vállalva , a márka értékállóságát helyezte mindenek elé .	konfliktust	28	Acc
A török alkotmány úgy utal az államra , mint amelynek " területe és nemzete " van , szemben a nyugat-európai felfogással , ahol a nép alkotja az államot .	felfogással	20	Ins
Ezt azonban senki nem bizonyította , ahogyan magát a megsemmisítés tényét sem .	tényét	10	Acc
Felhozták tehát a frontról a protezsált ifjút , aki kisvártatva meg is kezdhette szuggesztiós tevékenységét .	ifjút	6	Acc
A legfontosabb feladat a konvertálható tudású munkaerő képzése : ez még mindig nehézkes , és az átlagemberek számára sokba kerül Magyarországon .	feladat	2	Nom
A kizárólag egyedi vagy kis sorozatban készített kerámiatárgyak a majd másfél száz éves műhely hagyományteremtő szellemiségét képviselik , s egyben arra is választ adnak , miért váltak a Zsolnay-tárgyak világszerte ismertté .	szellemiségét	15	Acc
Így aztán nem csoda , ha a megkérdezett német polgároknak csak 28 százaléka — de még az SPD-híveknek is csak 37 százaléka — tartja Schrödert igazi szociáldemokratának .	csoda	3	Nom
A titoisták táborában igen megörültek barátunknak , s jóllehet , tiltakozott , mondván : ő belgyógyász és pszichiáter , elérték , hogy a sebesülteket amputálja , operálja .	táborában	2	Ine
A pesti kiruccanás előtt , még ezen a héten hétfőn Essenben , kedden Kölnben , szerdán Cottbusban , csütörtökön Saarbrückenben kellett kampányolnia pártja jelöltjei érdekében — a szokásos berlini hivatali teendői mellett .	csütörtökön	18	Sup
Éppen ellenkezőleg , jelentésüket megcsúfolta , egyeseket betiltott , másokat az értelmetlenségig kiürített .	jelentésüket	3	Acc
Bernard Kouchner , a koszovói ENSZ-közigazgatás vezetője szerdán közölte : megelégelte az ENSZ biztonságot és megbékélést célzó koszovói erőfeszítéseit érő bírálatokat .	bírálatokat	20	Acc
Bizonyos idő után feltűnt : a marsallnak a megbeszéléseken le-lecsukódik a szeme , este viszont képtelen nyugovóra térni .	nyugovóra	16	Sub
Minden mással problémám van .	problémám	2	Nom
A japán rendőrség több akciót hajtott végre , a Rajfu Szupeszu szekta után kutatva , amely azóta hallatott magáról , hogy két tagjának szállodaszobájában egy mumifikált holttestre bukkantak .	holttestre	26	Sub
A szerbek nem csak Orahovacban érzik magukat szorongatva : múlt hét elején a tartományi székhelyen , Pristinában , három szerb nőt bántalmaztak albán támadók , s ismeretlen fegyveresek rálőttek két cigány férfire is .	nőt	20	Acc
Az állásbörze nemcsak a végzős diákoknak hasznos , az alsóbb évesek is gyűjthetnek tapasztalatokat , felmérhetik a követelményeket , kapcsolatba kerülhetnek a vállalatokkal , szakmai gyakorlatokra jelentkezhetnek .	gyakorlatokra	25	Sub
Nevezetes hősök térnek vissza a mozinézők életébe ezen a héten .	mozinézők	5	Nom
Szerdán megalakult a rendkívüli havazás miatt kialakult káosz kezelésével megbízott operatív bizottság .	havazás	4	Nom
A földrengés okozta kényszerleállás után a múlt csütörtökön újraindult a tőzsdei kereskedés , és az index " csak " 9,93 százalékkal csökkent .	csütörtökön	7	Sup
Egyébként is nagyon kedvelem az etnozenét , az afrikai , a távol-keleti zenét ; magam is foglalkoztam ezekkel a muzsikákkal .	zenét	12	Acc
Tegnap összesen 11 vesebeteget és combnyaktörést szenvedett lakost juttattak kórházba .	lakost	7	Acc
Az Árgus Kiadó a szobor újraöntésével egyidejűleg albumot jelentet meg a szobrász születésének 120. és halálának 40. évfordulója alkalmából .	évfordulója	17	Nom
Mindez annak köszönhető , hogy elképesztő méretekben fejlődött a feldolgozóipar , szinte alig van olyan világcég , amelynek a most sújtott Izmitben vagy környékén name lenne vegyesvállalata .	feldolgozóipar	9	Nom
Számos nagyszerű kötet kiadása , kiállítások és fesztiválok szervezése fűződik a nevükhöz , de most olyan vállalkozásba fogtak , amilyen korábban még nem volt Magyarországon .	kötet	2	Nom
— Az ember csak reménykedhet , s igyekezhet a hangjával hosszabb és rövid távon is gazdálkodni .	hangjával	9	Ins
A támadásokkal párhuzamosan folytatódik a " rábeszélés " is : az albánok számtalanszor érdeklődnek szerb szomszédaiknál , eladó -e az ingatlan .	rábeszélés	6	Nom
Akinek pedig lapát van a kezében , biztosan nem fázik .	lapát	2	Nom
Bernard Kouchner , a koszovói ENSZ-közigazgatás vezetője szerdán közölte : megelégelte az ENSZ biztonságot és megbékélést célzó koszovói erőfeszítéseit érő bírálatokat .	biztonságot	13	Acc
A roppant terhek , az örökös hadi készültség , a csapatok mozgatása , az ütközetek , az utánpótlás megszervezése , a millió véletlen esemény elviselése és integrálása a katonai folyamatokba , megviselték .	készültség	7	Nom
Ő is ilyen napirend szerint élte az életét , nem véletlen , hogy szintén hosszú pályát tudhatott magáénak .	véletlen	10	Nom
A cég helyzetét a növekvő konkurencián kívül rontotta , hogy a kiskereskedelmi üzletek eladását szolgáló előprivatizáció keretében több boltját elvonták , ingatlanvagyonának 86 százalékát így két nagyméretű — 6 ezer négyzetméter körüli — raktár tette ki .	konkurencián	5	Sup
Kaposvár és Tab között , illetve Kecskemétről két irányba nem indítottak járatot .	járatot	11	Acc
Hiszen a személyi ellentétekben is megnyilvánuló pozícióharc első nagy vesztese a klasszikus szociáldemokrata értékekre előszeretettel hivatkozó Oskar Lafontaine pártelnök lett , aki márciusban távozott a pénzügyminiszteri posztról .	pártelnök	18	Nom
A héttagú családot kiköltöztették , s ideiglenesen szövetkezeti vagy egyházi lakásban szállásolják el — tájékoztatta lapunkat Eller János polgármester .	lakásban	10	Ine
Az egész estés rajzfilm készítői egyszerű , kedves történetet mesélnek egy lényről , aki az állatok között tapasztalja meg a szeretet , a családi összetartozás erejét , s aki ember mivoltára ébredve is inkább a dzsungelt választja .	összetartozás	24	Nom
Azt azonban nem lehet tudni , vajon megfogadják -e legközelebb az otthonmaradásra ösztönző jó tanácsot .	tanácsot	14	Acc
A síkos utakon csak üggyel-bajjal jutottak előre a személyautók , a buszközlekedés pedig teljesen csődöt mondott .	utakon	2	Sup
A koszovói háború idején kirobbant konvojügy , az orosz KFOR-gépek átrepülése körüli bonyodalom , legutóbb pedig Orbán Viktor kanadai nyilatkozata váltott ki ingerült reakciókat Moszkvában .	bonyodalom	12	Nom
Amíg hatalmi rivalizálásukat nem szüntetik meg , a demokráciára fordítható energia csak a fele lesz annak , amire amúgy képesek lennének .	demokráciára	8	Sub
Tegnap este az autóbuszok sok helyütt két és fél órás késéssel érkeztek a célállomásra , a főútvonalakon pedig több kilométer dugók alakultak ki .	dugók	20	Nom
Az elmúlt napok időjárása nyomán a Budapesttől alig 30 kilométerre fekvő pilisi települések lakói is megismerték az elszigeteltség érzését .	kilométerre	9	Sub
A jog nem tiltja , hogy egy nagykövet magánlevelet írjon , és azt sem tiltja , hogy a levélben magánvéleményként primitív és dehonesztáló állításokat fogalmazzon meg a magyar belpolitika egyes kérdéseiben .	jog	1	Nom
A tíz kis , zömében szabolcsi konzervgyár hiteleire adott 2,33 milliárd forintnyi állami garancia után ( HVG , 1999.június 19. ) a kormány újabb 5 milliárd forint értékben vállalt készfizető kezességet tartósítóipari cégek hiteleire .	zömében	4	Ine
1955-ben végzett a marosvásárhelyi főiskolán , több színháznak is tagja volt , de legnagyobb alakításai a Tamási Áron Színházhoz fűzik , ahol ma is dolgozik .	alakításai	14	Nom
Kiemelkedik az aukcióban részt vevő darabok közül egy ezüstből készült emeletes szédertál , amelyet cizellált arany elemekkel díszítettek és a súlya megközelíti a négy kilót .	elemekkel	16	Ins
Az aszfalton feltehetőleg irigy pillantásokat vonzó autócsoda hamarosan tehetetlen vasdarabbá válik , alaposan beragad a hócsapdába .	aszfalton	1	Sup
A kiállítás ( és vásár ) szín- és formagazdagsága a tárgyak kézi megmunkálásának mesterségbeli biztonságáról , a manufakturális módszer gondosságáról vall .	vásár	4	Nom
Persze jól jönnek a hómunkások , amikor már megtörtént a baj , és a csupadísz Audit ki kell szabadítani a kátyúból .	hómunkások	4	Nom
Egyre nagyobb ugyanis a túlélők hatóságokkal szembeni haragja , szinte példa nélkül álló bírálatözön hull a kormány , a miniszterek és az állami intézmények fejére .	fejére	24	Sub
Nem értik azt sem a szociáldemokraták , miért zárkóznak el mind a mai napig a vizsgálatban illetékes cseh hatóságok attól , hogy a zsolnai székhelyű Bírósági Műszaki Szakértői Intézet újra lejátssza a balesetet a baleset színhelyén .	vizsgálatban	15	Ine
Legutóbb láthattunk egy sífelszereléseket reklámozó plakátot , melyről nyomban elhangzott , hogy nem az , ami , csak egy fénykép , melyen síoktatók között egy férfiimitátor tévébemondó társaságában ott látható a magyar miniszterelnök is .	plakátot	5	Acc
Gyönyörű színpadi beszédét gyakran emlegetik példaként , nem véletlenül tanított diplomája kézhezvétele után négy éven át beszédtechnikát a főiskolán .	beszédtechnikát	16	Acc
A szerbek nem csak Orahovacban érzik magukat szorongatva : múlt hét elején a tartományi székhelyen , Pristinában , három szerb nőt bántalmaztak albán támadók , s ismeretlen fegyveresek rálőttek két cigány férfire is .	fegyveresek	27	Nom
Éppen ezért óriási a jelentősége a török tb szanálásának , még akkor is , ha szakértők szerint két évig még egyáltalán nem érezteti hatását , és az átmeneti periódus 10 év .	jelentősége	4	Nom
Pedig a kilencvenes évek előtt még igenis lehetett ebben a műfajban is eredményes az ember , hiszen a 180-as csoporttal tizenkét éven át telt házak előtt játszhattunk a Zeneakadémián , jelentős törzsközönségünk volt , készültek lemez- és rádiófelvételeink .	törzsközönségünk	31	Nom
Az áldozat fia , a szekta 31 éves tanítványa azt állította , hogy apja még élt , amikor megtalálták , és a boncolás okozta halálát .	boncolás	22	Nom
— Mozart operája örökérvényű remekmű , amelynek minden korban van mondanivalója .	mondanivalója	10	Nom
Kiemelt feladatként kezelik az Előszállásnál elakadt három sertésszállító jármű kimenekítését is .	kimenekítését	9	Acc
Az egyszerű az , hogy miután éveken keresztül rétegelt lemezből dolgoztam , eluntam a rétegelést , mást akartam — és a lyukasztgatás jutott az eszembe , ami hallatlanul munkaigényesnek bizonyult , de úgy tűnik a kiállításból , van eredménye .	éveken	6	Sup
Bár e kérdések egynémelyikében nincs nézetazonosság a két ország között , az eszmecsere a várakozások szerint jó lehetőséget teremt az álláspontok kifejtésére , s talán közelítésére is .	közelítésére	25	Sub
Az április 4-5-én a Budapesti Műszaki Egyetem központi épületének aulájában tartandó fórumra közel tízezer diákot várnak .	4-5-én	2	Sup
Utolsó tulajdonosa Majse Buchmann szabómester volt , akit családjával együtt 1942-ben a németek elhurcoltak .	családjával	8	Ins
A globalizációról és annak a magyar gazdaságra gyakorolt hatásairól Békesi László volt pénzügyminiszter tartott előadást a Pázmány Péter Katolikus Egyetem Jogtudományi Karán , a Barankovics és Faludi Akadémia , valamint a Pázmány Pódium által közösen szervezett vitasorozat keretében .	keretében	37	Ine
Tito volt a szabadon választott , míg Józsi bácsi a kötelező gyakorlat . )	gyakorlat	11	Nom
Hatezer fiatalembert adott el a magyar állam a németeknek , hogy velük a Todt szervezet — a Siemens és más cégek megbízásából — rezet bányásztasson , illetőleg fönt , a hegyekben vasutat építsen az érckőzet elszállításához .	hegyekben	30	Ine
A megbeszélésen a felek elhatározták , hogy konkrét javaslatokat dolgoznak ki az adósság rendezésére .	rendezésére	13	Sub
Az Állami Pénz- és Tőkepiaci Felügyelet ( ÁPTF ) augusztus 26-án szeptember 10-éig felfüggesztette a London Bróker Rt. tevékenységét , miután e hónapban már kétszer is előfordult , hogy az értékpapír-kereskedő cég nem tudott fizetni a Budapesti Értéktőzsdén .	tevékenységét	18	Acc
Az ENSZ és a NATO abban bízik , hogy a tények kozmetikázásával sikerül valamilyen formában helyreállítani a tartomány többnemzetiségű státusát .	státusát	19	Acc
Bernard Kouchner , az átmeneti ENSZ-kormányzat francia vezetője ugyan elvetette a Koszovó kantonizálását célzó javaslatot , ám azt is hangsúlyozta , hogy a szerbek biztonságának szavatolása érdekében fontolóra kellene venni egyes szerb közösségek ideiglenes átköltöztetését .	kantonizálását	12	Acc
Pedig egy háborúban — bizonygatta a marsall — minden megesik , lám , őt is el akarják tenni láb alól ; a németek nyolcszáz légideszantost küldtek ellene .	légideszantost	24	Acc
A cég ugyan jelezte , hogy alaptőke-emelést tervez , ám " az rt-nél kialakult helyzet kedvezőtlenül befolyásolhatja a tervezett tőkeemelés lefolytatását " — olvasható az ÁPTF-nek a Magyar Tőkepiacban közzétett határozata indoklásában .	határozata	30	Nom
A judaika-árverés szervezői azt remélik , hogy ez az újfajta , tematikus aukció új színfoltot hoz az őszi árverési dömpingbe , és új távlatokat nyit a gyűjtők előtt .	távlatokat	23	Acc
Tisztségviselők például arra szólítják fel a donorokat , hogy a török Vörös Félhold szervezetnek küldjék adományaikat , az iszlámbarát csoportoknak , mint például a Mazlum-Der alapítványnak pedig megtiltották , hogy segélyt gyűjtsenek és osszanak szét .	adományaikat	15	Acc
A belső fogyasztás mérséklődött tavalyhoz képest , bővülése idén nem fogja meghaladni a bruttó nemzeti össztermék ( GDP ) növekedését .	növekedését	19	Acc
A politikai közbeszédben egyeduralomra jutott jogi nyelvhasználat előfeltevése , hogy csak azt lehet számon kérni , ami le van írva és ahogyan le van írva .	előfeltevése	7	Nom
A legutóbbi munkám Kamondi Zoltán Az alkimista és a szűz című filmjének kísérőzenéje volt , s most éppen Gödrös Frigyes Glamour című alkotásához írok zenét ; a filmet a jövő februári filmszemlén mutatják be .	zenét	24	Acc
Bőven akadnak olyan szerbiai települések , ahol nem a szerb kormánypártok egyikének a jelöltje győzött , de első körben Nis és Pirot lakóit töltheti el némi melegség , mikor megérkezik az EU kora karácsonyi ajándéka , amellyel majd befűtenek .	melegség	26	Nom
A tanítás és a műszak végén a megyében dolgozó ingázók és a vidékről bejáró diákok Székesfehérváron rekedtek .	megyében	7	Ine
Az 1997 novemberében még 11 millió forintos törzstőkéjű társaság tőkéjét 1998 januárjában 311 millió forintra emelte a Reichardt család .	novemberében	2	Ine
Tito este tízkor már aludt , mint a macedón kefir , sőt nyugodtan végigaludta az éjszakát , ami hosszú idő óta nem fordult vele elő .	éjszakát	15	Acc
Megszervezték ugyanis az Első Magyarországi Judaika Árverést , amelynek keretében értékes kulturális-történeti anyag — könyvek , kéziratok , kegytárgyak és festmények — kerül kalapács alá .	kegytárgyak	18	Nom
Ukrajnában a zord tél következtében 2800 település maradt áram nélkül szerdára virradóra .	település	6	Nom
Raj Tamás , a Makkabi Kiadó vezetője , a judaisztika kiváló magyarországi szakértője lapunknak beszámolt arról , hogy igazi ritkaságok is találhatók az árverésre szánt anyagban .	anyagban	25	Ine
A másik két név — amelynek gazdáiról ugyancsak bebizonyosodott , hogy kémkedtek a szovjeteknek — szintén szerepel a mintegy kétszázötven fős listán , de kilétüket az ügyészség egyelőre nem fedte fel a sajtónak .	kilétüket	24	Acc
A másik két név — amelynek gazdáiról ugyancsak bebizonyosodott , hogy kémkedtek a szovjeteknek — szintén szerepel a mintegy kétszázötven fős listán , de kilétüket az ügyészség egyelőre nem fedte fel a sajtónak .	listán	21	Sup
Ennek a szakasznak a domborzata amúgy sem kedvez az autósoknak .	domborzata	4	Nom
E tekintetben figyelemre méltó , hogy még legkeményebb bírálói is elismerik : akkor van igazán elemében , ha küzdenie kell .	tekintetben	1	Ine
Kardelj hozta a hírt , hogy valamelyik hegyi kórházukban működik egy magyar orvos , aki bizonyos helyzetekben hipnózisban altatja az operálandó betegeket .	helyzetekben	16	Ine
A magyarországi nézők többek között a történelmi fordulat után Budapestre látogató kolozsvári társulat A buszmegálló című produkciójában láthatták .	produkciójában	16	Ine
Amikor nem olyan régen a balkáni háborúról olvastam , bevallom , csak és kizárólag öreg orvos barátomra gondoltam .	barátomra	16	Sub
A tőkeemelések révén a cég 1997-től 100 százalékban Krankovics István tulajdonába került .	tőkeemelések	1	Nom
Márpedig a növekvő igények miatt csak az energiaszektorban 2002-re mintegy 30 milliárd dollárnyi befektetésre lenne szüksége Törökországnak .	igények	3	Nom
Olyan énekes , aki tökéletes átéléssel , szenvedéllyel , humorral alakítja lírai , drámai és buffoszerepeit .	buffoszerepeit	15	Acc
Mint egy edényben , az üresség , azaz a lélek tölti ki a formát .	lélek	9	Nom
Sőt még ha marad is Saarbrückenben az SPD-többség , akkor sem biztos a győzelem , Reinhard Klimmt szociáldemokrata tartományi miniszterelnök ugyanis kilátásba helyezte : ha újraválasztják , ő sem fogja támogatni az Eichel-csomagot .	Eichel-csomagot	32	Acc
Hatezer fiatalembert adott el a magyar állam a németeknek , hogy velük a Todt szervezet — a Siemens és más cégek megbízásából — rezet bányásztasson , illetőleg fönt , a hegyekben vasutat építsen az érckőzet elszállításához .	vasutat	31	Acc
" Ki ez ? " — kérdezte a magyar kommunisták első embere .	kommunisták	9	Nom
A horvát elnök egészségi állapota mindeközben tovább romlott , és sajtóértesülések szerint egy neves horvát építészt már felkértek arra , hogy tervezze meg Franjo Tudjman síremlékét .	síremlékét	25	Acc
Mindezt a levél írója zárójelbe teszi , s rövidre zárva feljelentését , a magyar társadalmat két osztályra bontja .	osztályra	16	Sub
Svájcban a hó miatt több mint egy órára le kellett zárni a zürichi repülőtér egyik kifutópályáját .	kifutópályáját	15	Acc
Ma a kortárs zenével mindezt valóban nem lehet elérni .	zenével	3	Ins
Ezért is fontos , hogy a viszony a korrektségen , a kiszámíthatóságon , egymás érdekeinek kölcsönös tiszteletben tartásán alapuljon .	tartásán	17	Sup
Kísértetek szabadultak el a szabaddá vált nyilvánosságban , a szavak gyilkos , ordas , gonosz indulatok árján úszva szorongást , félelmet , az egyszer volt újra megtörténhetésének vélelmét keltették fel .	árján	16	Sup
Schröder tavaly a szociáldemokratákat győzte meg , legyenek választók , s ezzel hozta vissza a hatalomba az SPD-t .	szociáldemokratákat	3	Acc
A 72 tagú konferencia által , három püspök fenntartásai mellett elfogadott közlemény szerint a testület megvizsgálja , van -e lehetőség arra , hogy a katolikus irodák az igazolások kiállítása nélkül is benn maradjanak a terhestanácsadás törvényes rendszerében .	kiállítása	28	Nom
Ezért szeretem ezt a kiállítást a Mai Manó Házban : itt csak egy tárgy van .	kiállítást	4	Acc
A Nyugattól minden adandó alkalommal a Jugoszlávia elleni szankciók eltörlését kérő szerb ellenzéki vezetők , ha a gazdasági zárlat feloldását nem is , azt legalább elérték , hogy 350 tonna fűtőolajhoz jutnak a polgárok .	feloldását	19	Acc
Az orosz vezetés természetesen a nemzetközi közösség elleni provokációnak nevezte az albánok tettét , a Kfor-erők nyugati parancsnokai pedig igyekeznek csökkenteni az incidens súlyát .	vezetés	2	Nom
Bizonyos idő után feltűnt : a marsallnak a megbeszéléseken le-lecsukódik a szeme , este viszont képtelen nyugovóra térni .	megbeszéléseken	8	Sup
A hómentesítésre a Magyar Honvédség segítségét kérték , helikoptereikkel vittek kenyeret Bodmérre és Vértesboglárra .	hómentesítésre	1	Sub
Az egész estés rajzfilm készítői egyszerű , kedves történetet mesélnek egy lényről , aki az állatok között tapasztalja meg a szeretet , a családi összetartozás erejét , s aki ember mivoltára ébredve is inkább a dzsungelt választja .	mivoltára	30	Sub
Úgy vélekedett , hogy a banditák " élő pajzsként " használják fel polgári lakosokat , ezért a civileknek el kell hagyniuk a csecsen fővárost , s az orosz hatóságok " mindennel el fogják látni őket " .	banditák	5	Nom
Hiszen a személyi ellentétekben is megnyilvánuló pozícióharc első nagy vesztese a klasszikus szociáldemokrata értékekre előszeretettel hivatkozó Oskar Lafontaine pártelnök lett , aki márciusban távozott a pénzügyminiszteri posztról .	vesztese	9	Nom
A hadiipari kutatások eredményeit a korábbi 3-4 év helyett ma már hat hónap múlva felhasználják a polgári termelésben .	termelésben	17	Ine
A helyi albán vezetők azt is közölték , készek szembeszállni az oroszokkal , ha a moszkvai hadvezetés úgy dönt , fegyverek bevetésével töri át az úttorlaszokat .	bevetésével	21	Ins
Kivételes pompával fogadták .	pompával	1	Ins
" Teljesen hiábavaló a rádióban elhangzott , az újságokban megírt megannyi figyelmeztetés .	újságokban	8	Ine
Itt minden megtörténhet egy az egyben , még az is , hogy Tarzan beszélget az állatokkal , hogy úgy mozog , mint ők , akiktől a dzsungelélet minden fortélyát el kellett tanulnia az életben maradáshoz .	életben	33	Ine
Gyönyörű színpadi beszédét gyakran emlegetik példaként , nem véletlenül tanított diplomája kézhezvétele után négy éven át beszédtechnikát a főiskolán .	beszédét	2	Acc
Olyan énekes , aki tökéletes átéléssel , szenvedéllyel , humorral alakítja lírai , drámai és buffoszerepeit .	humorral	9	Ins
Bár a helyreállítás költségei jórészt az állami büdzsét terhelik majd , török és külföldi elemzők egyetértenek abban , hogy hosszabb távon a földrengés csak korlátozott mértékben hat a gazdaságra .	büdzsét	7	Acc
A tárgyak még ma megtekinthetők a Biblical World Galleryben , a Wesselényi u . 13. szám alatt , az árverés pedig vasárnap délelőtt 10 órakor kezdődik a Hotel Atrium Hyatt Kármán termében .	szám	15	Nom
A cég ugyan jelezte , hogy alaptőke-emelést tervez , ám " az rt-nél kialakult helyzet kedvezőtlenül befolyásolhatja a tervezett tőkeemelés lefolytatását " — olvasható az ÁPTF-nek a Magyar Tőkepiacban közzétett határozata indoklásában .	indoklásában	31	Ine
Pazar látványosság fogadja a várbéli Fortuna 11 Galéria ( Bp. I. , Tárnok utca 10. ) látogatóit a Zsolnay Gyár Stúdiójának most megnyílt kiállításán .	kiállításán	23	Sup
A Trajkovics-tervezet a szerbeket hozná kedvezőbb helyzetbe , hiszen épp ezekben a körzetekben találhatóak a tartomány legjobb bányái és legnagyobb ipari üzemei .	körzetekben	12	Ine
Ráadásul azt gondolom , hogy az én muzsikám a hallgathatóbb , populárisabb kortárs zenék közé tartozik .	muzsikám	7	Nom
Három magas rangú olasz katonatiszt a hidegháború idején fontos államtitkokat adott át a volt szovjet hírszerzésnek — vélik tudni a szerdai olasz újságok .	államtitkokat	9	Acc
A megyeszékhelyen egyébként csütörtökre és péntekre tanítási szünetet rendeltek el .	szünetet	7	Acc
A jog nem tiltja , hogy egy nagykövet magánlevelet írjon , és azt sem tiltja , hogy a levélben magánvéleményként primitív és dehonesztáló állításokat fogalmazzon meg a magyar belpolitika egyes kérdéseiben .	állításokat	23	Acc
Pedig a kilencvenes évek előtt még igenis lehetett ebben a műfajban is eredményes az ember , hiszen a 180-as csoporttal tizenkét éven át telt házak előtt játszhattunk a Zeneakadémián , jelentős törzsközönségünk volt , készültek lemez- és rádiófelvételeink .	csoporttal	19	Ins
Mindezt a levél írója zárójelbe teszi , s rövidre zárva feljelentését , a magyar társadalmat két osztályra bontja .	társadalmat	14	Acc
Nisen kívül Pirot városa részesül még az " Energia a demokratizálódáshoz " elnevezésű akció keretén belül nyújtandó fűtőolaj-szállítmányból .	városa	3	Nom
Mindaz a képzeletszülte meseelem , ami a gorillacsaládban nevelkedő embergyerek regénybeli történetének kalandos feszültséget és romantikus lendületet kölcsönzött , ezúttal a rajzfilm műfajában levetette az élő megjelenítés korlátait .	műfajában	22	Ine
Az egyetlen dolog az életben , amivel azonos vagyok .	életben	4	Ine
Kiemelkedik az aukcióban részt vevő darabok közül egy ezüstből készült emeletes szédertál , amelyet cizellált arany elemekkel díszítettek és a súlya megközelíti a négy kilót .	kilót	24	Acc
— Amikor először énekelt a Carmenben , gondolt arra , hogy ötvenéves évfordulót is ünnepelhet majd ezen a színpadon ?	évfordulót	12	Acc
Miként hat a világgazdasági környezet Magyarországra ?	környezet	4	Nom
A tíz kis , zömében szabolcsi konzervgyár hiteleire adott 2,33 milliárd forintnyi állami garancia után ( HVG , 1999.június 19. ) a kormány újabb 5 milliárd forint értékben vállalt készfizető kezességet tartósítóipari cégek hiteleire .	konzervgyár	6	Nom
Az SPD viszont — legalábbis a közvélemény-kutatások szerint — most ezen az úton jár : tavaly őszi győzelme óta 8 százalékot veszített népszerűségéből , s ha most vasárnap lennének parlamenti választások , csupán a szavazatok 32,5 százalékára számíthatna .	úton	12	Sup
A katasztrófa — vélik szakértők — inkább a politikai életre lehet maradandó hatással .	életre	9	Sub
Hiszen a személyi ellentétekben is megnyilvánuló pozícióharc első nagy vesztese a klasszikus szociáldemokrata értékekre előszeretettel hivatkozó Oskar Lafontaine pártelnök lett , aki márciusban távozott a pénzügyminiszteri posztról .	ellentétekben	3	Ine
A társaság végelszámolással történő megszüntetéséről döntenek a Corso Rt. tulajdonosai a cipőkereskedelmi cég jövő hétre meghirdetett közgyűlésén .	végelszámolással	2	Ins
A török kormány egyik nagy restanciája a gazdaság felére kiterjedő állami tulajdon privatizálása , amit az IMF ugyancsak erőteljesen szorgalmaz .	felére	8	Sub
A kormány máris törvénytervezetet nyújtott be a parlamentnek , hogy a katasztrófa sújtotta tartományok kivételével egyszeri adót vessenek ki , amiből több mint 100 millió dollárnak megfelelő összeg is befolyhat .	adót	16	Acc
A tíz kis , zömében szabolcsi konzervgyár hiteleire adott 2,33 milliárd forintnyi állami garancia után ( HVG , 1999.június 19. ) a kormány újabb 5 milliárd forint értékben vállalt készfizető kezességet tartósítóipari cégek hiteleire .	hiteleire	7	Sub
Az orosz légierő gépei és a tüzérségi egységek ismét hevesen támadták Urusz-Martan környékét , de a várostól nyugatra elhelyezkedő csecsen erők szemmel láthatóan állták a sarat .	sarat	25	Acc
A szerbek nem csak Orahovacban érzik magukat szorongatva : múlt hét elején a tartományi székhelyen , Pristinában , három szerb nőt bántalmaztak albán támadók , s ismeretlen fegyveresek rálőttek két cigány férfire is .	férfire	31	Sub
A belgyógyász-pszichiátert azonban a jugoszláv nagykövetség invitálta , miáltal nem a magyar , hanem a jugoszláv fogadócsoportban állt .	fogadócsoportban	16	Ine
Pontosan azóta , amióta egy vezetői döntés nyomán eltüntették a hófogó rácsokat az út két oldaláról .	hófogó	10	Nom
Kovács Zsolt egyesületi elnökön is látszik már a fáradtság , de jókedvű .	elnökön	3	Sup
A felügyelet már augusztus 18-a óta vizsgálódik a London Brókernél , amelynek megromlott a likviditási helyzete .	helyzete	15	Nom
Korábbi sofőrjével jó személyes viszonya volt , teljesen megbízott benne .	sofőrjével	1	Ins
Két ember életét vesztette a balesetekben , s sokakat kellett kórházba szállítani sérülésekkel is .	balesetekben	5	Ine
Reggel óta ezt csinálják .	Reggel	0	Nom
Pedig a marógép csupán másfél tengelyszélességben pusztította el a természetes akadályt .	tengelyszélességben	5	Ine
Elhangzik egyszer egy mű egy koncerten , a jelen lévő néhány száz ember meghallgatja , s még akkor , ha sikert arat , sincs biztosítva , hogy legközelebb is lesz mód az előadásra .	sikert	20	Acc
A cég ugyan jelezte , hogy alaptőke-emelést tervez , ám " az rt-nél kialakult helyzet kedvezőtlenül befolyásolhatja a tervezett tőkeemelés lefolytatását " — olvasható az ÁPTF-nek a Magyar Tőkepiacban közzétett határozata indoklásában .	alaptőke-emelést	6	Acc
Az ellenzéki pártok képviselői az alkotmányerejű törvény ellen szavaztak , egyebek között arra hivatkozva , hogy a kormánypárt nem tartja tiszteletben az alkotmányban foglaltakat , és nem hajlandó megállapodni a parlamenti választások időpontjáról sem .	tiszteletben	20	Ine
Rezníkről az a hír járta , hogy a rendszerváltás előtt az állambiztonsági szolgálat alkalmazottja volt , tehát érthető volt Dubcek tartózkodása azzal az emberrel szemben , aki korábbi üldözői közé tartozott .	emberrel	23	Ins
Eluralkodott a magyar politikai kultúra egyik átkos öröksége , a jogászi nyelv , melynek szavai csak a semmitmondásra , a csűrés-csavarásra , az időhúzásra , a partner elnémítására , a nyers nyelvi agresszióra alkalmasak .	csűrés-csavarásra	20	Sub
— Ez alatt a fél évszázad alatt szinte az egész baritonrepertoárt elénekelte , egyedül Wagner darabjaiban nem lépett színpadra .	baritonrepertoárt	10	Acc
Elengedhetetlen a nemzetközi bizalmat erősítő makrogazdasági környezet megteremtése .	bizalmat	3	Acc
Gratulálunk a kitüntetetteknek , és további sok sikert kívánunk nekik !	sikert	7	Acc
Az áprilisi választások révén hatalomra jutott bal-jobb koalíció az utóbbi négy év legstabilabb török kormányának tűnik , a földrengés azonban veszélyt jelenthet erre a politikai egységre .	bal-jobb	6	Nom
Az egyetlen jelentős csapást a Tupras állami olajvállalat szenvedte el : a földmozgás által legjobban sújtott Izmitben lévő finomítója napokig lángokban állt , a kárt 200 millió dollárra taksálják , de ebből 150 milliót fedezni tudnak a biztosításból .	lángokban	20	Ine
A mostani segély viszont felfogható próbának , melynek sikerétől függ a további segélyezés .	segélyezés	12	Nom
A gyerek keresztelkedjen ki , s már mint katolikus menjen el a bolognai universitasra .	gyerek	1	Nom
Orvosnak készült , de rossz évjáratban jutott az egyetem lépcsőjéig : származása okán — meglengették fölötte a numerus clausus mocskos zászlaját — úgy elzavarták , mint koldust a fukar ember házától .	zászlaját	20	Acc
Tegnap összesen 11 vesebeteget és combnyaktörést szenvedett lakost juttattak kórházba .	vesebeteget	3	Acc
A horvát alkotmányban csak a tartós akadályoztatás fogalmát rögzítették , amely az államfő helyettesítésének esetére kötelezően előírta új elnökválasztás kiírását is .	elnökválasztás	18	Nom
A bizalmas együttlétek persze módot adtak némely csevegésekre is .	csevegésekre	7	Sub
Szóval ilyen és ehhez hasonló bennfentes mesékre tett szert a mi diploma nélküli orvosunk .	diploma	11	Nom
Mellette a közelmúltban átalakult gyár művészeti stúdiójában készült , kézzel festett legszebb egyedi darabjai láthatók .	darabjai	13	Nom
Októberben töltötte be a 85. életévét , de a kor színpadi munkáján nem hagyott nyomot .	életévét	5	Acc
A versenyképesség fokozása anyagi hátteret igényel .	hátteret	4	Acc
A kamattámogatás is differenciált : az állami garancia nélküli hitelekre 100 , a garantált hitelekre pedig a kezességvállalás mértékének növekedésével csökkenően 75 , illetve 40 százalék .	növekedésével	19	Ins
A díjazottak nekik tetszenek .	díjazottak	1	Nom
A Kravtex Kft.-t 1992-ben az orosz Atex-holding egyik tagja , az Avtoexport és egy magyar magánszemély , Krankovics István , a győri Rába egykori marketingigazgatója 3,5 millió forint törzstőkével alapította .	törzstőkével	28	Ins
— Többször dolgozott együtt az Amadinda együttessel , számos darabjában kapnak fontos szerepet az ütőhangszerek ...	együttessel	6	Ins
A Vatikán ajánlásainak engedve a német katolikus püspökök úgy határoztak , hogy egyházuk módosítani akarja részvételét a terhestanácsadás törvény által szabályozott rendszerében .	részvételét	15	Acc
Leksa perújrafelvételt is kezdeményezett az ügyben , sőt Milos Zeman cseh miniszterelnök is támogatja az új nyomozás lefolytatását — ellentétben elődjével , Václav Klausszal .	nyomozás	16	Nom
Aktuális nemzetközi témák és a kétoldalú viszony kérdései szerepelnek Martonyi János vasárnap kezdődő , egynapos hivatalos moszkvai látogatásán .	látogatásán	17	Sup
Ez utóbbi hazahozatalára reális esélyt látnak a szakértők .	hazahozatalára	2	Sub
— Három fotós háromféleképp fotózta le a szobrot .	fotós	2	Nom
Tetejükig hóba süppedt autókat és utasaikat mentették egész éjjel ( és szerdán napközben is ) .	utasaikat	5	Acc
Legutóbb láthattunk egy sífelszereléseket reklámozó plakátot , melyről nyomban elhangzott , hogy nem az , ami , csak egy fénykép , melyen síoktatók között egy férfiimitátor tévébemondó társaságában ott látható a magyar miniszterelnök is .	sífelszereléseket	3	Acc
Az elzárt falvak hamarosan ellátási problémákkal nézhetnek szembe , így előkészítettek matracot , takarókat a számukra .	matracot	11	Acc
Az összedőlt házak romjain egy újfajta polgári kezdeményezés csírái kezdtek kialakulni , a hivatalos állami segítség hiányát pótolva .	segítség	15	Nom
És még egy riasztó adat : 1999-ben 5,6 millió felnőttet és gyermeket fertőzött meg az AIDS kialakulását okozó HIV-vírus .	gyermeket	11	Acc
Az idén az állam 190 dollárért — a tavalyihoz képest 51 százalékkal többért — vásárolja fel a búza tonnáját , miközben a világpiaci ár 110 dollár körül mozog .	búza	17	Nom
A német kormány múlt héten tartott első berlini ülésén fogadta el végleg a Hans Eichel pénzügyminiszter nevével fémjelzett takarékossági csomagtervet , amelyet körülbelül akkora lelkesedés kísér ott , mint 1995-ben Magyarországon Bokros Lajos megszorításait .	megszorításait	33	Acc
Kovács László személyében magyar külügyminiszter utoljára 1996 márciusában járt Moszkvában .	márciusában	7	Ine
Aztán amikor kiderült , hogy a pszichiáternek van egy kis származási eltérése , ráadásul itáliai egyetemi gyakorlata , ő , aki Fiuméban évekig dolgozott olaszokkal , megenyhült .	olaszokkal	24	Ins
A horvát alkotmányban csak a tartós akadályoztatás fogalmát rögzítették , amely az államfő helyettesítésének esetére kötelezően előírta új elnökválasztás kiírását is .	fogalmát	7	Acc
Szakadár albán fegyveresek kedden este tüzet nyitottak egy szerb rendőrjárőrre Koszovó délkeleti határa mentén , a biztonsági övezet közelében : két rendőr megsebesült — jelentette szerdán az RTS szerb állami tévé .	rendőr	21	Nom
A tíz kis , zömében szabolcsi konzervgyár hiteleire adott 2,33 milliárd forintnyi állami garancia után ( HVG , 1999.június 19. ) a kormány újabb 5 milliárd forint értékben vállalt készfizető kezességet tartósítóipari cégek hiteleire .	hiteleire	33	Sub
Két utas életét vesztette , és rengeteg amerikait súlyos sérüléssel kellett kórházba szállítani .	sérüléssel	9	Ins
Készítek emellett az Amadindának egy Full kontakt című darabot is , amelyben az ütősök egy idő után már nem a hangszereket , hanem egymást ütik .	hangszereket	20	Acc
A lomposan megfogalmazott jogi szövegek korlátlanul megnyitották az utat az önkényes nyelvhasználat előtt , mely mögött nincs s nem is lehet gondolt , ami feltételezné a jogi nyelven túl érvényes szótár létét .	utat	8	Acc
Zaporozsje megyeszékhelyen a leszakadt villanyvezetékek miatt rendkívüli állapotot vezettek be .	állapotot	7	Acc
Az IMF által tanácsolt közvetlen jövedelemkiegészítési támogatás bevezetése — amely sok farmert érzékenyen érintene — ugyancsak nehéz döntés elé állítja a török kormányt , mivel a 65 milliós lakosság 45 százaléka gazdálkodó , ami jelentős politikai erőt jelent .	farmert	11	Acc
Mint Szűcs Andrástól , a KHVM munkatársától megtudtuk , nem terveznek korlátozást .	korlátozást	11	Acc
A megyében a legnagyobb problémát az átutazó forgalom okozza , s habár nem lehet közlekedni , a kamionok és buszok sofőrjei nem hajlandóak leállítani járműveiket — magyarázta Lánczos János , a Fejér Megyei Közútkezelő Kht. osztályvezetője .	megyében	1	Ine
Hacsak a jugoszláv utakon , némi hatósági közreműködéssel , lába nem kél a szállítmánynak .	utakon	3	Sup
Orosz források szerint a csecsen erők létszáma az utóbbi időben 3500-ra emelkedett .	források	1	Nom
Ázsiában ezzel szemben mind több sikerrel veszik fel az AIDS-szel szembeni küzdelmet .	AIDS-szel	9	Ins
A szerbek most a tartomány kantonokra osztásával igyekeznek megállítani a menekülési hullámot , s megmenteni maguknak legalább a tartomány egy részét .	kantonokra	5	Sub
Mivel az élet természeténél fogva leírhatatlan , és milliárdnyi történése a résztvevők között újra meg újra megkötött értelmezési szövetségen múlik , az új beszédből kimaradt az élet , kimaradtak az emberek .	résztvevők	11	Nom
A " legkevésbé ismert " stimmel , a " kultikust " a romantika kedvéért teszik hozzá általam ismeretlen egyének .	romantika	12	Nom
A Vezér például bevallotta , hogy számára a szerelem hozza el a szublimálás élményét , miután az alkoholtól — ami merőben idegen a balkáni lélektől — semminemű feloldódást nem nyer .	élményét	13	Acc
— Úgy vélem , aki színpadra lép , annak kötelessége a nyelv ápolása .	ápolása	12	Nom
Nemcsak a Pilis lábainál küzdenek az elemekkel , Csobánka , Százhalombatta és Ercsi is hó alá került .	elemekkel	6	Ins
A bonyolult válasz : az emberiség történetén végighúzódik egy spirituális mítoszrendszer , ami viszonyítási pontként , világmagyarázatként szolgált az archaikus kor népei számára .	emberiség	5	Nom
Mindaz a képzeletszülte meseelem , ami a gorillacsaládban nevelkedő embergyerek regénybeli történetének kalandos feszültséget és romantikus lendületet kölcsönzött , ezúttal a rajzfilm műfajában levetette az élő megjelenítés korlátait .	feszültséget	13	Acc
A török alkotmány úgy utal az államra , mint amelynek " területe és nemzete " van , szemben a nyugat-európai felfogással , ahol a nép alkotja az államot .	nép	24	Nom
A bonyolult válasz : az emberiség történetén végighúzódik egy spirituális mítoszrendszer , ami viszonyítási pontként , világmagyarázatként szolgált az archaikus kor népei számára .	történetén	6	Sup
Márpedig a növekvő igények miatt csak az energiaszektorban 2002-re mintegy 30 milliárd dollárnyi befektetésre lenne szüksége Törökországnak .	energiaszektorban	7	Ine
A jog nem tiltja , hogy egy nagykövet magánlevelet írjon , és azt sem tiltja , hogy a levélben magánvéleményként primitív és dehonesztáló állításokat fogalmazzon meg a magyar belpolitika egyes kérdéseiben .	levélben	18	Ine
A diákok egy helyen , kötetlen formában tájékozódhatnak a lehetőségekről , a vállalatok pedig széles körből , személyes benyomás alapján választhatják ki a legfelkészültebb jelentkezőt .	formában	6	Ine
Kiemelt feladatként kezelik az Előszállásnál elakadt három sertésszállító jármű kimenekítését is .	jármű	8	Nom
Putyin ezúttal nem zárta ki teljesen Groznij ostromát , azt hangoztatva , hogy a bázisokat és a fegyverraktárokat meg fogják semmisíteni .	fegyverraktárokat	17	Acc
Majdnem minden jelentős rendezővel együtt dolgozhattam már , rengeteg közös produkcióm született Jeles Andrással , Valló Péterrel , Kiss Csabával vagy Makk Károllyal .	rendezővel	3	Ins
Az orosz légierő gépei és a tüzérségi egységek ismét hevesen támadták Urusz-Martan környékét , de a várostól nyugatra elhelyezkedő csecsen erők szemmel láthatóan állták a sarat .	környékét	12	Acc
A felügyeleti felszólításnak eleget téve a hó végi közgyűlésen először a részvények lebélyegzése révén 2 milliárd forinttal csökkentik a jegyzett tőkét , majd a fő tulajdonos osztrák Erste AG ugyancsak 2 milliárddal tőkésíti fel magyarországi érdekeltségét .	lebélyegzése	12	Nom
Az ellenzéki pártok képviselői az alkotmányerejű törvény ellen szavaztak , egyebek között arra hivatkozva , hogy a kormánypárt nem tartja tiszteletben az alkotmányban foglaltakat , és nem hajlandó megállapodni a parlamenti választások időpontjáról sem .	alkotmányban	22	Ine
Kísértetek szabadultak el a szabaddá vált nyilvánosságban , a szavak gyilkos , ordas , gonosz indulatok árján úszva szorongást , félelmet , az egyszer volt újra megtörténhetésének vélelmét keltették fel .	szorongást	18	Acc
A megbeszélésen a felek elhatározták , hogy konkrét javaslatokat dolgoznak ki az adósság rendezésére .	megbeszélésen	1	Sup
Posztját eddigi helyettese , Vida Ildikó vette át , akit egyébként ő hozott magával korábbi munkahelyéről .	helyettese	2	Nom
Az állami televíziófelügyelet például átmenetileg némaságra ítélte az egyik kereskedelmi csatornát , mert az élesen bírálta a kabinetet a válságkezelés hiánya miatt .	válságkezelés	19	Nom
— Amikor először énekelt a Carmenben , gondolt arra , hogy ötvenéves évfordulót is ünnepelhet majd ezen a színpadon ?	színpadon	18	Sup
Eluralkodott a magyar politikai kultúra egyik átkos öröksége , a jogászi nyelv , melynek szavai csak a semmitmondásra , a csűrés-csavarásra , az időhúzásra , a partner elnémítására , a nyers nyelvi agresszióra alkalmasak .	kultúra	4	Nom
Idén három tendenciaváltozás volt a magyar gazdaságban .	gazdaságban	6	Ine
Bár Zoran Djindjics az isztambuli EBESZ-konferenciát követően bejelentette : a szerb ellenzék kész az együttműködésre .	együttműködésre	14	Sub
Így került a KGB kezére az akkori olasz katonai attasé által az otthoniaknak írt titkos jelentés , sőt még a külképviselet páncélszekrényének a titkos kódja is .	kezére	4	Sub
Mindaz a képzeletszülte meseelem , ami a gorillacsaládban nevelkedő embergyerek regénybeli történetének kalandos feszültséget és romantikus lendületet kölcsönzött , ezúttal a rajzfilm műfajában levetette az élő megjelenítés korlátait .	megjelenítés	26	Nom
Hasonló ártámogatási rendszer működik egyébként a cukorrépa és a dohány esetében is .	cukorrépa	6	Nom
— Egészséget , ha már az ember ilyen kort megért , és a nézők észrevették , megszerették .	kort	8	Acc
Állítólag mindhárom személy szerepel a Mitrohin-aktákban található listán .	listán	7	Sup
A szerbek most a tartomány kantonokra osztásával igyekeznek megállítani a menekülési hullámot , s megmenteni maguknak legalább a tartomány egy részét .	tartomány	4	Nom
— Tudatosan törekedett az " ismeretlenségre " ?	ismeretlenségre	5	Sub
Aki nemcsak az operaszínpadon remekel , hanem kiváló dalénekes és oratóriumszólista is s aki gyakorta tűz műsorára új műveket .	műsorára	16	Sub
A Trajkovics-féle javaslatot a hivatalos Belgrád egyelőre nem kommentálta , ám szerbiai értesülések szerint a színfalak mögötti tárgyalások napirendjén mindig ott volt a Koszovó megosztását szorgalmazó javaslat .	napirendjén	18	Sup
A kormány máris igyekszik meggátolni az iszlámista alapítványokat abban , hogy a bajbajutottakon segítsenek .	alapítványokat	7	Acc
Tényleg hihetetlen , de Edgar Rice Burroughs híres regényhőse eddig már vagy ötvenszer kelt életre a mozivásznon , de rajzfilmen most először elevenednek meg kalandjai a Walt Disney Stúdió produkciójában .	rajzfilmen	19	Sup
— Mozart operája örökérvényű remekmű , amelynek minden korban van mondanivalója .	korban	8	Ine
Eluralkodott a magyar politikai kultúra egyik átkos öröksége , a jogászi nyelv , melynek szavai csak a semmitmondásra , a csűrés-csavarásra , az időhúzásra , a partner elnémítására , a nyers nyelvi agresszióra alkalmasak .	elnémítására	27	Sub
Az 1997 novemberében még 11 millió forintos törzstőkéjű társaság tőkéjét 1998 januárjában 311 millió forintra emelte a Reichardt család .	család	18	Nom
Eluralkodott a magyar politikai kultúra egyik átkos öröksége , a jogászi nyelv , melynek szavai csak a semmitmondásra , a csűrés-csavarásra , az időhúzásra , a partner elnémítására , a nyers nyelvi agresszióra alkalmasak .	semmitmondásra	17	Sub
A kereszténydemokrata Tietmeyer soha nem lelkesedett az euróért ( ellentétben a pártelnök Helmut Kohllal ) , de megelégedett annyival , hogy elmondja fenntartásait , s nem tett keresztbe kancellárjának — holott akár tehetett is volna .	pártelnök	11	Nom
A nagyobbik koalíciós erő , a Szolidaritás Választási Akció ( AWS ) egyik csoportja , a Katolikus Családok Szervezete tagjának számító Kapera 1991-ben már lemondani kényszerült akkori egészségügyi államtitkár-helyettesi posztjáról , mert nyilvánosan perverzeknek minősítette a homoszexuálisokat .	homoszexuálisokat	36	Acc
Tényleg hihetetlen , de Edgar Rice Burroughs híres regényhőse eddig már vagy ötvenszer kelt életre a mozivásznon , de rajzfilmen most először elevenednek meg kalandjai a Walt Disney Stúdió produkciójában .	regényhőse	8	Nom
Elhangzik egyszer egy mű egy koncerten , a jelen lévő néhány száz ember meghallgatja , s még akkor , ha sikert arat , sincs biztosítva , hogy legközelebb is lesz mód az előadásra .	előadásra	32	Sub
Az óriási teljesítményű munkagép kezelői elcsigázottan üldögélnek az utasfülkében .	utasfülkében	8	Ine
A nagy elődök ( Sean Connery , Roger Moore ) játékában fellelhető irónia Brosnannek ugyan nem az erőssége , de hál ' isten nem is erőlteti sem ő , sem a történet kiagyalói .	hál	20	Nom
Az elmúlt évben főként informatikusokat , villamosmérnököket , gépészmérnököket kerestek a vállalatok , jövőre várhatóan más műszaki területekről is igényelnek szakembereket .	villamosmérnököket	6	Acc
A püspökök november közepén a Vatikánban tett " ad limina " látogatásuk alatt levelet adtak át az egyházfőnek , amelyben felsorolták megfontolásaikat és érveiket a tanácsadási gyakorlat ( benne az igazolások ) fenntartása mellett .	látogatásuk	11	Nom
Az elmúlt napok időjárása nyomán a Budapesttől alig 30 kilométerre fekvő pilisi települések lakói is megismerték az elszigeteltség érzését .	települések	12	Nom
Az 1997 novemberében még 11 millió forintos törzstőkéjű társaság tőkéjét 1998 januárjában 311 millió forintra emelte a Reichardt család .	tőkéjét	9	Acc
A kamattámogatás is differenciált : az állami garancia nélküli hitelekre 100 , a garantált hitelekre pedig a kezességvállalás mértékének növekedésével csökkenően 75 , illetve 40 százalék .	hitelekre	14	Sub
Az óriási teljesítményű munkagép kezelői elcsigázottan üldögélnek az utasfülkében .	munkagép	3	Nom
Hiszen a keleti szél pár másodpercen belül újra hótakarót borít rá .	másodpercen	5	Sup
Azt azonban nem lehet tudni , vajon megfogadják -e legközelebb az otthonmaradásra ösztönző jó tanácsot .	otthonmaradásra	11	Sub
Azelőtt az export és a beruházások játszották a főszerepet a gazdasági életben , az elmúlt év elején azonban az export dinamikája lassult , a beruházások egész évben stagnáltak , a belső fogyasztás pedig növekedett . )	főszerepet	8	Acc
Az EU éppen a fal lebontásának napján tette közzé nyilatkozatát , amely szerint a cseh EU-tagság egyik fő gondja a csehországi roma népességgel való nem megfelelő bánásmód .	napján	6	Sup
S azt sem , hogy emlékeik felélednek -e majd , ha jövőre kocsit kell venni az önkéntes tűzoltóknak vagy hálájuk elolvad tavasszal a ma még legyőzhetetlennek tűnő hóval együtt .	emlékeik	5	Nom
Vlagyimir Putyin hangsúlyozta , hogy az új amnesztiát — amely hasonló lenne az 1994-96-os orosz-csecsen háborút követő moszkvai bűnbocsánathoz — mindenképpen megszavazná az orosz alsóház .	amnesztiát	7	Acc
A gazdaság ilyen mértékű fejlődését több folyamat gerjeszti , többek között a magánosítás elterjedése és a tőkekoncentráció .	folyamat	6	Nom
A magyar fővárosban december 8-án a Néprajzi Múzeumban kerül sor az album 1-től 10-ig sorszámozott példányainak az aukciójára , míg Bécsben várhatóan a jövő év februárjában rendezik meg a licitet .	aukciójára	17	Sub
Tavaly az állami gabonatanács 8 millió tonna szemes terményt vett át , s a mennyiséget az idén 4,5 millióban szeretné korlátozni , mert tavaly például előfordult , hogy olcsón beszerzett iraki búzát adtak tovább a hatóságoknak .	terményt	8	Acc
A tíz kis , zömében szabolcsi konzervgyár hiteleire adott 2,33 milliárd forintnyi állami garancia után ( HVG , 1999.június 19. ) a kormány újabb 5 milliárd forint értékben vállalt készfizető kezességet tartósítóipari cégek hiteleire .	kezességet	30	Acc
Az államnak csupán a gazdaság szervezésében , az információ közvetítésében , az alkalmazkodás segítésében kell részt vennie , nem szabad közvetlenül beavatkoznia a gazdaságba .	segítésében	13	Ine
Megszervezték ugyanis az Első Magyarországi Judaika Árverést , amelynek keretében értékes kulturális-történeti anyag — könyvek , kéziratok , kegytárgyak és festmények — kerül kalapács alá .	keretében	9	Ine
Az elmúlt napok időjárása nyomán a Budapesttől alig 30 kilométerre fekvő pilisi települések lakói is megismerték az elszigeteltség érzését .	érzését	18	Acc
Mint egy edényben , az üresség , azaz a lélek tölti ki a formát .	formát	13	Acc
A hómentesítésre a Magyar Honvédség segítségét kérték , helikoptereikkel vittek kenyeret Bodmérre és Vértesboglárra .	kenyeret	10	Acc
Valami tudat alatt mindig működött bennem , valami megérzés , hogy mikor mit vállalhatok el , s talán ennek köszönhetem , hogy most is színpadra tudok lépni .	színpadra	24	Sub
Legfőképpen a Demokrata Párt és a Szerb Megújhodási Mozgalom ( SPO ) vezetőire .	vezetőire	12	Sub
A Jutarnji List című ellenzéki napilap szerdai számának címoldalán A legrosszabb várható címmel arról adott hírt , hogy " többé már az intenzív kezelés sem segít " az elnökön .	címoldalán	8	Sup
Az ok : Tito álmatlanságban szenvedett .	álmatlanságban	4	Ine
Kulcskérdés , hogy a két említett tartományban meg tudja -e őrizni többségét , mert ha nem , akkor végleg elveszíti az esélyét annak , hogy a felsőház , a Bundesrat 69 szavazatából 35-öt megszerezzen a takarékossági csomagtervhez .	tartományban	6	Ine
A meggyilkoltak persze már nem szólhatnak , az idő előtt meghaltak se , de akik valamiért tudják , hogy ott mi történt , időről időre kötelességük emlékezni .	időre	24	Sub
A bizalmas együttlétek persze módot adtak némely csevegésekre is .	módot	4	Acc
A szerbek most a tartomány kantonokra osztásával igyekeznek megállítani a menekülési hullámot , s megmenteni maguknak legalább a tartomány egy részét .	osztásával	6	Ins
Az április 4-5-én a Budapesti Műszaki Egyetem központi épületének aulájában tartandó fórumra közel tízezer diákot várnak .	fórumra	11	Sub
Az úttorlaszokat építő és folyamatosan tüntető albánok azzal indokolják viselkedésüket , hogy az oroszok elfogultak az albánokkal szemben , s a koszovói albánok elleni szerb támadásokban több száz orosz zsoldos is részt vett .	zsoldos	29	Nom
" Elképzelhető , hogy a Groznijtól 20 kilométerrel délnyugatra fekvő város — az egyik legnagyobb csecsen település — lesz az első olyan hely , ahol egyesült erővel harcolnak az oroszok ellen " — mondta .	erővel	26	Ins
Goebbelsi módszereket tulajdonít a díjazott újságíróknak , miközben ő maga az , aki Goebbelset követi , jóllehet , a mester jóval tehetségesebben alkalmazta a nevéről elnevezett módszert .	módszereket	1	Acc
Nekem amúgy az életben maradáshoz , a mindennapi megélhetéshez hihetetlen csekély érzékem van , így könnyen beszélek és nehezen élek .	életben	3	Ine
Októberben töltötte be a 85. életévét , de a kor színpadi munkáján nem hagyott nyomot .	nyomot	14	Acc
A megyei mentési feladatokkal a megyei védelmi bizottságokat bízták meg , ezek irányítását és az információszolgáltatást pedig az operatív bizottság végzi .	információszolgáltatást	15	Acc
A püspökök november közepén a Vatikánban tett " ad limina " látogatásuk alatt levelet adtak át az egyházfőnek , amelyben felsorolták megfontolásaikat és érveiket a tanácsadási gyakorlat ( benne az igazolások ) fenntartása mellett .	megfontolásaikat	21	Acc
Akkoriban a cég — átmeneti sikerrel — megszerezte a Magyar Nemzet , az Esti Hírlap és az Expressz kiadói jogát , 1997 végén pedig megindította a Napi Magyarország című napilapot .	sikerrel	5	Ins
A Nyugattól minden adandó alkalommal a Jugoszlávia elleni szankciók eltörlését kérő szerb ellenzéki vezetők , ha a gazdasági zárlat feloldását nem is , azt legalább elérték , hogy 350 tonna fűtőolajhoz jutnak a polgárok .	zárlat	18	Nom
Elemzők szerint a valóságos koszovói helyzet elkendőzésében sajátos módon a nemzetközi közösség és a szerbiai hatalom egyaránt érdekelt .	elkendőzésében	6	Ine
A Vecernji List című napilap úgy értesült , hogy a Dubrava kórházban lélegeztető készülékkel segítik Tudjman szervezetének működését , de az államfő nincs kómában .	készülékkel	13	Ins
Az alkotmány szerint a parlament november 27-i feloszlatását követő 60 napon belül parlamenti választásokat kell tartani , de a pontos dátumról még nem született döntés .	választásokat	13	Acc
Ez utóbbit növelhetik a költségek csökkentésével , a korszerűséggel , valamint a megbízhatósággal ; nem véletlen napjainkban a márkanév jelentőségének növekedése .	megbízhatósággal	12	Ins
Ennek fele a jegyzett tőkét gyarapítja , másik fele a tőketartalékba kerül .	tőkét	4	Acc
A tőkeemelések révén a cég 1997-től 100 százalékban Krankovics István tulajdonába került .	százalékban	7	Ine
Pelagéját mindazonáltal kedvelte , jóllehet , nem is ő , hanem Rankovic mutatott férfiúi érzelmeket iránta , de hát ezt hogyan közölje a haragvó Poszeidonnal ?	érzelmeket	14	Acc
Kardelj hozta a hírt , hogy valamelyik hegyi kórházukban működik egy magyar orvos , aki bizonyos helyzetekben hipnózisban altatja az operálandó betegeket .	kórházukban	8	Ine
Törökországot már-már a fizetésképtelenség fenyegette : a földrengés előtti becslések az idei költségvetési deficitet 20 milliárd dollárra taksálták , miközben ugyancsak dollárban számolva 40 milliárd a belső és 100 milliárd a külső adósság .	dollárban	21	Ine
II. János Pál pápa már júniusi , majd szeptemberi levelében is bírálta a német püspökségek részvételét a terhes nőknek szervezett állami tanácsadásban , azt vetve a szemükre , hogy az igazolások kiállításával lehetővé teszik meg nem született életek elpusztítását .	levelében	9	Ine
Az SPO első embere , Vuk Draskovics semmit sem jelentett be , csak a szankciók feloldását sürgette .	feloldását	15	Acc
A megállapodás várhatóan 2001-ben lép hatályba , miután valamennyi uniós tagország parlamentje is ratifikálta .	tagország	10	Nom
Az orosz külügyminiszter mégis hajlandó hétfőn Moszkvában találkozni az EBESZ soros elnöki tisztét betöltő Knut Vollebaekkel , s tárgyalni arról , hogy EBESZ-küldöttség látogasson Csecsenföldre .	tisztét	12	Acc
A Globus című zágrábi hetilap orvosi körökre hivatkozva azt jelentette , hogy bármelyik pillanatban bekövetkezhet Tudjman halála .	körökre	6	Sub
A jövő év január 5-ig látható kiállításon a kerámiatárgyak mellett Balogh István Péter és Börzsönyi Kollarits Ferenc képei is bemutatkoznak .	kiállításon	6	Sup
Így aztán két év múltán az ifjú már valóban a szegedi alma materben folytathatta tanulmányait , ahol — kiváló eredményei birtokában — élvezte a Nobel-díjas tudós segítőkészségét .	birtokában	20	Ine
Sztálin elvtárs ugyanis , ismerve gyengéjét , összekötőként elküldte hozzá a szép kis Pelagéját , mondván : legyen , aki Tito üzeneteit eljuttatja Moszkvába .	üzeneteit	21	Acc
Olyan vagyok ebben a társadalomban , mint volt egykor a dinoszaurusz : hiába mondták neki , hogy " Repülj ! " , nem tudott repülni és kihalt .	dinoszaurusz	10	Nom
A cég 1997-ben 1 milliárd forint körüli árbevétel mellett 500 millió forintos adózás előtti nyereséget ért el , míg tavaly az orosz válság hatására árbevételük 600 millió forintra , eredményük 140 millió forintra csökkent .	árbevételük	24	Nom
Dubcekről ugyanis közismert volt , hogy következetes híve — Václav Havellal együtt — a csehek és szlovákok közös államának , és a két nemzet közötti vitás kérdéseket tárgyalások útján , de az állami keretek megőrzésével szeretné megoldani .	megőrzésével	34	Ins
Tisztségviselők például arra szólítják fel a donorokat , hogy a török Vörös Félhold szervezetnek küldjék adományaikat , az iszlámbarát csoportoknak , mint például a Mazlum-Der alapítványnak pedig megtiltották , hogy segélyt gyűjtsenek és osszanak szét .	donorokat	6	Acc
Az újság szerint az államfőt november 1-jén már későn — legalább két nappal bélátfúródása után — operálták meg , ami súlyos hashártyagyulladást és vérmérgezést okozott szervezetében .	újság	1	Nom
Ennek érdekében egyensúlyban kell tartani a növekedés , az egyensúly , az infláció , valamint a foglalkoztatás " bűvös négyzetét " .	növekedés	6	Nom
Más városokban sem sokkal jobb a helyzet : Gnjilanéban néhány nappal ezelőtt egy szerb tulajdonban lévő videotékára dobtak kézigránátokat .	videotékára	16	Sub
Felszabadultak a szavak , de mindenki meglepetésre erejük elapadt , igazuk és szépségük eltűnt .	meglepetésre	6	Sub
Így például Bécsben és Budapesten is tíz-tíz számozott kötet kerül kalapács alá , s az árverésen összegyűlt összeget tíz-tíz alapítványnak ajánlják fel .	árverésen	15	Sup
A szerbek nem csak Orahovacban érzik magukat szorongatva : múlt hét elején a tartományi székhelyen , Pristinában , három szerb nőt bántalmaztak albán támadók , s ismeretlen fegyveresek rálőttek két cigány férfire is .	székhelyen	14	Sup
A tekintélyelvű , totalitárius hatalom szótára ugyanis mindig szemben állt a hatalom nélküliek szótárával , melyből szép és igaz mondatok fakadtak .	szótárával	13	Ins
Ami helyettük maradt , az nem több , mint fonémák zagyva halmaza , melynek jelentését a hatalom és egyes-egyedül a hatalom képes csak megszabni , nem számít a konvenció , de még a közvetlen tapasztalat sem .	fonémák	9	Nom
Bülent Ecevit török kormányfő pedig jelezte , szeptember végi washingtoni látogatásán kérni fogja az Egyesült Államok segítségét török építési kötvény tengerentúli kibocsátásához 5 milliárd dollár értékben .	látogatásán	10	Sup
A Trajkovics-tervezet a szerbeket hozná kedvezőbb helyzetbe , hiszen épp ezekben a körzetekben találhatóak a tartomány legjobb bányái és legnagyobb ipari üzemei .	bányái	17	Nom
A fejlesztési terv ezért most elsősorban felkiáltójelként funkcionál , ami felhívja a figyelmet arra : mekkora szakadék tátong a van és a kell között .	szakadék	16	Nom
Az azóta eltelt évtizedek alatt a fiatal baritonistából a magyar zenei élet egyik vezető alakja , élő legenda vált .	évtizedek	3	Nom
A horvát elnök egészségi állapota mindeközben tovább romlott , és sajtóértesülések szerint egy neves horvát építészt már felkértek arra , hogy tervezze meg Franjo Tudjman síremlékét .	állapota	4	Nom
Ki újjászületve , ki saját nyomdokain haladva .	nyomdokain	5	Sup
Szekszárdon a 6-os úton parkolóba terelték az arra tartókat , s számukra itt pihenő-melegedő helyet alakítottak ki — tájékoztatta lapunkat Schieber József , a Polgári Védelem Országos Parancsnokságának szóvivője .	úton	3	Sup
A festmény- , könyv- és műtárgy-aukcióknak különleges kultusza alakult ki az utóbbi időben Magyarországon .	kultusza	7	Nom
A judaika-árverés szervezői azt remélik , hogy ez az újfajta , tematikus aukció új színfoltot hoz az őszi árverési dömpingbe , és új távlatokat nyit a gyűjtők előtt .	szervezői	2	Nom
Egy év után Simicska Lajos feladta : az adóhivatal elnöke családi halálesetekre és az ellene irányuló folyamatos támadásokra hivatkozva kedden — miután találkozott Orbán Viktor miniszterelnökkel — lemondott .	támadásokra	17	Sub
Dubceknak az volt az álláspontja , hogy a közös állam szétválasztása egyes cseh és szlovák politikusok egyéni ambícióit szolgálhatja ugyan , de semmiképpen nem a két nép érdekeit .	szétválasztása	10	Nom
Az alkotmány szerint a parlament november 27-i feloszlatását követő 60 napon belül parlamenti választásokat kell tartani , de a pontos dátumról még nem született döntés .	feloszlatását	7	Acc
A tárgyak még ma megtekinthetők a Biblical World Galleryben , a Wesselényi u . 13. szám alatt , az árverés pedig vasárnap délelőtt 10 órakor kezdődik a Hotel Atrium Hyatt Kármán termében .	termében	31	Ine
Aki nemcsak az operaszínpadon remekel , hanem kiváló dalénekes és oratóriumszólista is s aki gyakorta tűz műsorára új műveket .	operaszínpadon	3	Sup
A kormányhatározat által nyújtott lehetőség alapján 11,5 milliárd forint új hitelt vehetnek fel a tartósítóipari termékeket gyártók , a nyolc hónapos futamidejű konstrukcióban a tőketörlesztésre négy hónap moratóriumot kapnak .	tőketörlesztésre	24	Sub
Eluralkodott a magyar politikai kultúra egyik átkos öröksége , a jogászi nyelv , melynek szavai csak a semmitmondásra , a csűrés-csavarásra , az időhúzásra , a partner elnémítására , a nyers nyelvi agresszióra alkalmasak .	időhúzásra	23	Sub
A felügyeleti felszólításnak eleget téve a hó végi közgyűlésen először a részvények lebélyegzése révén 2 milliárd forinttal csökkentik a jegyzett tőkét , majd a fő tulajdonos osztrák Erste AG ugyancsak 2 milliárddal tőkésíti fel magyarországi érdekeltségét .	eleget	3	Acc
Vegyük példaként a legutóbbi szemantikai puccsot , mely a magánlevél jelentését forgatta fel keresztül-kasul .	jelentését	10	Acc
A kormány máris igyekszik meggátolni az iszlámista alapítványokat abban , hogy a bajbajutottakon segítsenek .	bajbajutottakon	12	Sup
A belpolitikai és jogi csatározásokban formálódott orosz restitúciós törvény értelmében Magyarország igényt tarthat Oroszországba elszármazott műkincseinek nagy részére .	csatározásokban	4	Ine
A támadásokkal párhuzamosan folytatódik a " rábeszélés " is : az albánok számtalanszor érdeklődnek szerb szomszédaiknál , eladó -e az ingatlan .	ingatlan	20	Nom
A fővároshoz közeli kisvárosokban , községekben élőknek azonban alighanem újdonság , hogy ezúttal vagy fél napon át ki sem mozdulhattak otthonukból .	községekben	5	Ine
Fejérben volt a legkritikusabb a helyzet : 8 települést egyáltalán nem lehet megközelíteni , s időlegesen elvesztette kapcsolatát a külvilággal Lepsény és Enying is .	külvilággal	19	Ins
De kaptam felkérést a Budapesti Csellóegyüttestől és egy férfi-énekszextettől is , úgyhogy szerencsére bőven el vagyok látva feladatokkal .	felkérést	2	Acc
Jung mondta , ha az autó befordul a sarkon , nem látjuk , de attól még létezik .	autó	5	Nom
Az árindex várhatóan 8 százalékos lesz .	árindex	1	Nom
A hómentesítésre a Magyar Honvédség segítségét kérték , helikoptereikkel vittek kenyeret Bodmérre és Vértesboglárra .	helikoptereikkel	8	Ins
Bécs Budapest - Wien Budapest 2000 címmel kétnyelvű album látott napvilágot a Well-Press Kiadó gondozásában .	napvilágot	10	Acc
A Vezér például bevallotta , hogy számára a szerelem hozza el a szublimálás élményét , miután az alkoholtól — ami merőben idegen a balkáni lélektől — semminemű feloldódást nem nyer .	szublimálás	12	Nom
Meg kell teremteni a versenygazdaság infrastrukturális feltételeit , a közlekedési úthálózatot ( ezen a téren van a legnagyobb elmaradás ) , a korszerű kommunikációs és pénzügyi rendszert .	rendszert	26	Acc
Önkéntesek hordták a vizet és az élelmet , a törmelék elszállítását — ha kellett , puszta kézzel — maguk szervezték meg .	élelmet	6	Acc
A tőkeemelésben mindazonáltal a kisbefektetők nem vehetnek részt , mivel egyúttal az Erste átalakul zártkörű társasággá , amelynek viszont tagjai maradnak azok , akik nem élnek a pénzintézet visszavásárlási ajánlatával .	tőkeemelésben	1	Ine
Az isztambuli értéktőzsdén ( ISE ) jegyzett 279 vállalat zöme a Márvány-tenger földrengés által sújtott keleti partvidékén és környékén — Törökország ipari szívében — vert tanyát , de többségük a börzéhez eljuttatott jelentésében nem tesz említést jelentősebb károkról .	szívében	22	Ine
S miközben Törökország ásványkincsekben szegény , külkereskedelme gyors ütemben bővül .	ütemben	8	Ine
Martonyi János vasárnap kezdődő moszkvai hivatalos látogatásának célja , hogy partnerével , Igor Ivanovval szót váltson időszerű nemzetközi kérdésekről és a kétoldalú kapcsolatokról — tájékoztatta lapunkat Kontra Ferenc , a Külügyminisztérium főosztályvezető-helyettese .	partnerével	10	Ins
Októberben töltötte be a 85. életévét , de a kor színpadi munkáján nem hagyott nyomot .	Októberben	0	Ine
Az újság szerint az államfőt november 1-jén már későn — legalább két nappal bélátfúródása után — operálták meg , ami súlyos hashártyagyulladást és vérmérgezést okozott szervezetében .	vérmérgezést	23	Acc
Kouchnerhez hasonlóan a tanács többi tagja sem tudja még , miképpen lehetne szavatolni a szerb kisebbség biztonságát , s így a kérdés valószínűleg még többször napirendre kerül a testület ülésein .	ülésein	29	Sup
Orbán Viktor kormányfő állítólag nem kérte a távozást , Járai Zsigmond pénzügyminiszter pedig elégedetten szólt Simicska szakmai munkájáról .	távozást	7	Acc
Az egyetemen immár hagyománnyá vált az egy hónapos Felkészítő Napok rendezvénysorozat , amelyen az álláskeresés módszereit ismerhetik meg jobban a hallgatók ; hogyan viselkedjenek , kommunikáljanak , miként mutassák be tudásukat , képességeiket egy interjú során .	álláskeresés	14	Nom
Itt minden megtörténhet egy az egyben , még az is , hogy Tarzan beszélget az állatokkal , hogy úgy mozog , mint ők , akiktől a dzsungelélet minden fortélyát el kellett tanulnia az életben maradáshoz .	fortélyát	28	Acc
Zsoldos Árpád is jól ismert és kedvelt színész Magyarországon : elég , ha csak a szentgyörgyi színház nagy sikerű Hegedűs a háztetőn című musicaljében nyújtott madárcsontú , mégis hihetetlenül erős Tevje-alakítására gondolunk .	Tevje-alakítására	30	Sub
Az elzárt falvak hamarosan ellátási problémákkal nézhetnek szembe , így előkészítettek matracot , takarókat a számukra .	falvak	2	Nom
Zoran Zsivkovics polgármester hivatalában elmondták : semmiféle ünnepséget nem szerveztek a városban ebből az alkalomból , minthogy " már maga az ünnep , hogy a meleg lesz a lakásokban " .	ünnep	21	Nom
A gyerek keresztelkedjen ki , s már mint katolikus menjen el a bolognai universitasra .	universitasra	13	Sub
Az egyetemen immár hagyománnyá vált az egy hónapos Felkészítő Napok rendezvénysorozat , amelyen az álláskeresés módszereit ismerhetik meg jobban a hallgatók ; hogyan viselkedjenek , kommunikáljanak , miként mutassák be tudásukat , képességeiket egy interjú során .	képességeiket	32	Acc
Gyógyszer , műszer itt volt elég — az angolok ejtőernyőjével küldték az utánpótlást — , csak éppen orvosból volt hiány .	utánpótlást	12	Acc
Meglepett , amikor ezekre a szerepekre felkértek , hiszen voltam alvilági főnök és őrült SS-tiszt , játszhattam a Balekok és banditákban , valamint a Hány az óra , Vekker úr ? című produkciókban .	SS-tiszt	14	Nom
Az emberek valamiféle belső kényszertől hajtva elindulnak — tűzön-vízen át .	tűzön-vízen	8	Ins
De talán a legnagyobb bók az volt az életemben , amit Gábor Miklós mondott nekem : " Ha téged nézlek a színpadon , nem veszem észre , hogy énekelsz . "	életemben	8	Ine
A 6-os úton keletkezett torlódás miatt bizonytalan időre lezárták a dunaföldvári hidat .	hidat	11	Acc
Egy magángyűjtemény képei címmel nyílik kiállítás ma a budapesti Szépművészeti Múzeumban .	képei	2	Nom
Aki nemcsak az operaszínpadon remekel , hanem kiváló dalénekes és oratóriumszólista is s aki gyakorta tűz műsorára új műveket .	oratóriumszólista	10	Nom
" A fiatal zeneakadémistát hibátlan alakításával , szép baritonjával a közönség azonnal szívébe zárta , hangosan ünnepelte . "	baritonjával	8	Ins
S azt sem , hogy emlékeik felélednek -e majd , ha jövőre kocsit kell venni az önkéntes tűzoltóknak vagy hálájuk elolvad tavasszal a ma még legyőzhetetlennek tűnő hóval együtt .	hóval	27	Ins
Hacsak a jugoszláv utakon , némi hatósági közreműködéssel , lába nem kél a szállítmánynak .	lába	9	Nom
Az AIDS különösen gyorsan terjed a Szovjetunió utódállamaiban — állítja a jelentés .	utódállamaiban	7	Ine
A támadásokkal párhuzamosan folytatódik a " rábeszélés " is : az albánok számtalanszor érdeklődnek szerb szomszédaiknál , eladó -e az ingatlan .	támadásokkal	1	Ins
1992-ben ő volt az Öregasszony Spiró György Csirkefejének Szamos-parti előadásában az Anya szerepét alakította Camus A félreértés című színművében .	előadásában	9	Ine
Így szólt egy rádiókritika az 1949. október 18-i Carmen-előadás Moraleséről , Melis György első operaházi fellépéséről .	Carmen-előadás	8	Nom
A magyar országgyűlési képviselő , ha akarja , szenátornak nevezi magát , ugyanaz a párt egyik nap ellenzék , a másik nap kormányoldalon álló , sőt a parlamenti többség akarata még a matematikánál is erősebb .	akarata	29	Nom
A német bankvilág Olümpuszát eddig megjárt hét elnök ugyanis a pénzügyi stabilitás legfőbb őreként , a szigorú kamatpolitika és a pénzmennyiség kézbentartása útján akár a mindenkori kormánnyal való konfliktust is vállalva , a márka értékállóságát helyezte mindenek elé .	kormánnyal	26	Ins
Az utóbbi évtized balkáni történelme alapján valószínűnek tűnik , hogy az otthonuk mellett kitartóknak hamarosan fegyveres látogatókra is számítaniuk kell .	látogatókra	16	Sub
Legutóbb láthattunk egy sífelszereléseket reklámozó plakátot , melyről nyomban elhangzott , hogy nem az , ami , csak egy fénykép , melyen síoktatók között egy férfiimitátor tévébemondó társaságában ott látható a magyar miniszterelnök is .	társaságában	27	Ine
A törökországi földrengés áldozatainak száma hétfőn hivatalos közlések szerint több mint 14 ezer , de még mindig nem tudni pontosan , hogy az összedőlt házak hány embert temettek el élve .	embert	26	Acc
Az ideiglenes helyettesítés dátumáról maga az államfő dönt írásban .	írásban	8	Ine
A kormánynak az IMF elvárásai szerint át kellene alakítania a mezőgazdaságot is .	mezőgazdaságot	10	Acc
Az isztambuli értéktőzsdén ( ISE ) jegyzett 279 vállalat zöme a Márvány-tenger földrengés által sújtott keleti partvidékén és környékén — Törökország ipari szívében — vert tanyát , de többségük a börzéhez eljuttatott jelentésében nem tesz említést jelentősebb károkról .	partvidékén	16	Sup
A megyeszékhelyen egyébként csütörtökre és péntekre tanítási szünetet rendeltek el .	péntekre	5	Sub
A világgazdaság gyors , országhatárokon átívelő fejlődését több tényező idézi elő .	fejlődését	6	Acc
A légzési és a szívritmust szabályozó gyakorlatok , a különféle relaxációs módszerek alkalmazása szinte kicserélték Josip Brozt .	szívritmust	4	Acc
A rosszfiúk jó része szláv akcentussal töri az angolt , de ez , valljuk be , csak arra a nyomorúságra utal , amelyben az utóbbi évek szegény akciófilm-forgatókönyvírói kénytelenek kiizzadni egy valamirevaló főgonoszt a kémhistóriájukhoz .	akcentussal	5	Ins
A földrengés okozta kényszerleállás után a múlt csütörtökön újraindult a tőzsdei kereskedés , és az index " csak " 9,93 százalékkal csökkent .	földrengés	1	Nom
Mindezt a levél írója zárójelbe teszi , s rövidre zárva feljelentését , a magyar társadalmat két osztályra bontja .	feljelentését	10	Acc
Az összedőlt házak romjain egy újfajta polgári kezdeményezés csírái kezdtek kialakulni , a hivatalos állami segítség hiányát pótolva .	romjain	3	Sup
S annak ellenére , hogy iskoláskorú volt , amikor a szlovák nyelv mellett megtanult magyarul is , az egyetlen operaénekes , aki megkapta a Kazinczy-díjat .	operaénekes	19	Nom
Döntő szerepet játszik a politikai stabilitás , valamint a tolerancia , az előítéletek megszüntetése .	tolerancia	9	Nom
A vezető leszállította az utasokat , azután a feldühödött tömeg összetörte a busz reflektorait , de jó néhány ablakát is .	reflektorait	13	Acc
Ezért is fontos , hogy a viszony a korrektségen , a kiszámíthatóságon , egymás érdekeinek kölcsönös tiszteletben tartásán alapuljon .	tiszteletben	16	Ine
Az energiahordozók ára világviszonylatban emelkedni fog .	világviszonylatban	3	Ine
Ezért fordulok a régi kultúrák felé , amelyek csak látszólag halottak .	kultúrák	4	Nom
A nyomozást azt követően rendelték el , hogy a közelmúltban egy holttestet leltek a tokiói repülőtér közelében fekvő egyik szállodában .	szállodában	19	Ine
A lomposan megfogalmazott jogi szövegek korlátlanul megnyitották az utat az önkényes nyelvhasználat előtt , mely mögött nincs s nem is lehet gondolt , ami feltételezné a jogi nyelven túl érvényes szótár létét .	nyelven	27	Sup
Gőz László nemrég indított egy huszonkét lemezből álló sorozatot , amelyben többek között Vidovszky László és Faragó Béla szerzői albuma is helyet kapott , s ennek folytatásaként jelenik meg az én CD-m is , remélhetőleg még ebben az esztendőben .	helyet	21	Acc
Kovács Zsolt egyesületi elnökön is látszik már a fáradtság , de jókedvű .	fáradtság	8	Nom
A színiirodalom legszebb szerepeit alakította .	szerepeit	3	Acc
Törökország például Európa legnagyobb szállítója a textiláruk terén , Isztambul pedig Szöultól nyugatra a legnagyobb , elektronikai eszközöket gyártó központ .	eszközöket	17	Acc
Tegnap este az autóbuszok sok helyütt két és fél órás késéssel érkeztek a célállomásra , a főútvonalakon pedig több kilométer dugók alakultak ki .	célállomásra	13	Sub
A koszovói háború idején kirobbant konvojügy , az orosz KFOR-gépek átrepülése körüli bonyodalom , legutóbb pedig Orbán Viktor kanadai nyilatkozata váltott ki ingerült reakciókat Moszkvában .	reakciókat	23	Acc
Hasonlóan járt a Fidesz számára politikai kudarcot és eladósodást hozó 1994-es választások után : túladtak rajta mint gazdasági igazgatón .	eladósodást	8	Acc
Az úttorlaszokat építő és folyamatosan tüntető albánok azzal indokolják viselkedésüket , hogy az oroszok elfogultak az albánokkal szemben , s a koszovói albánok elleni szerb támadásokban több száz orosz zsoldos is részt vett .	támadásokban	25	Ine
Ha az ideiglenes helyettesítés okai ezek után is fennállnak , a kormány kezdeményezheti az alkotmánybíróságnál , hogy ismét állapítsa meg az elnök ideiglenes akadályoztatását .	okai	4	Nom
A dolgok pillanatnyi állása szerint az utóbbira mutatkozik több esély .	utóbbira	6	Sub
A kabinet a földrengés előtt öt nappal fogadtatott el a parlamenttel egy másik , ugyancsak nagy jelentőségű — az IMF által szintén megkövetelt — törvényt , amely lehetővé teszi a nemzetközi döntőbíráskodást a kormány és a külföldi beruházók között .	parlamenttel	10	Ins
Márpedig az NSZK-ban szinte mindig vannak valahol vagy helyhatósági , vagy tartományi választások — ezen az őszön például a Saar-vidéken és Brandenburgban — , s hosszabb távon egyetlen párt sem veszhet össze a választóival .	őszön	16	Sup
Szakadár albán fegyveresek kedden este tüzet nyitottak egy szerb rendőrjárőrre Koszovó délkeleti határa mentén , a biztonsági övezet közelében : két rendőr megsebesült — jelentette szerdán az RTS szerb állami tévé .	közelében	18	Ine
Az elmúlt évben főként informatikusokat , villamosmérnököket , gépészmérnököket kerestek a vállalatok , jövőre várhatóan más műszaki területekről is igényelnek szakembereket .	szakembereket	20	Acc
A " legkevésbé ismert " jelzőt először Péter Vladimir használta velem kapcsolatban , mikor 97-ben megkaptam a Soros-ösztöndíjat .	Soros-ösztöndíjat	17	Acc
Ez utóbbit növelhetik a költségek csökkentésével , a korszerűséggel , valamint a megbízhatósággal ; nem véletlen napjainkban a márkanév jelentőségének növekedése .	márkanév	18	Nom
A roppant terhek , az örökös hadi készültség , a csapatok mozgatása , az ütközetek , az utánpótlás megszervezése , a millió véletlen esemény elviselése és integrálása a katonai folyamatokba , megviselték .	ütközetek	14	Nom
A világban immár tíz éve tartó folyamatos gazdasági fellendülés minden eddigi konjunktúra-időszaknál hosszabb .	világban	1	Ine
További bizonyíték lehet a perújrafelvételhez a BMW cég szakértői véleménye ( ilyen autóval utazott Dubcek ) , amely kizárja az adott baleseti körülmények között olyan hátgerincsérülés lehetőségét , ami a politikus halálát okozta .	autóval	12	Ins
" Teljesen hiábavaló a rádióban elhangzott , az újságokban megírt megannyi figyelmeztetés .	rádióban	4	Ine
Az isztambuli értéktőzsdén ( ISE ) jegyzett 279 vállalat zöme a Márvány-tenger földrengés által sújtott keleti partvidékén és környékén — Törökország ipari szívében — vert tanyát , de többségük a börzéhez eljuttatott jelentésében nem tesz említést jelentősebb károkról .	értéktőzsdén	2	Sup
Az állami televíziófelügyelet például átmenetileg némaságra ítélte az egyik kereskedelmi csatornát , mert az élesen bírálta a kabinetet a válságkezelés hiánya miatt .	csatornát	10	Acc
A túlélők közül sokan úgy érzik , elárulta őket a törökök által mindig is nagy tisztelettel övezett " atyáskodó állam " , amely " parancsol , követel , de szolgáltat is " .	tisztelettel	15	Ins
A mintegy 860 ezer lakosú városban nem közlekedik 164 trolibusz és 110 villamos , s megbénult a forgalom több vasútvonalon is .	vasútvonalon	19	Sup
A bizalmas együttlétek persze módot adtak némely csevegésekre is .	együttlétek	2	Nom
Rezníkről az a hír járta , hogy a rendszerváltás előtt az állambiztonsági szolgálat alkalmazottja volt , tehát érthető volt Dubcek tartózkodása azzal az emberrel szemben , aki korábbi üldözői közé tartozott .	szolgálat	12	Nom
S bár nagyon jó viszonyban voltunk , és meghatározó volt életemben ez a vendégszereplés , nemet mondtam .	viszonyban	4	Ine
A diplomata ugyanakkor hozzátette : a restitúcióra csak kedvező politikai légkörben kerülhet sor .	restitúcióra	6	Sub
Ezért is fontos fenntartani a magas szintű párbeszédet , és időről-időre szót váltani az országainkat érintő és érdeklő aktuális kérdésekről — fejtette ki Kontra Ferenc .	időről-időre	10	Sub
Készítek emellett az Amadindának egy Full kontakt című darabot is , amelyben az ütősök egy idő után már nem a hangszereket , hanem egymást ütik .	idő	15	Nom
A tárgyalásokon valószínűleg szóba kerülnek az európai biztonság , a délszláv válság , a koszovói rendezés és a NATO-orosz együttműködés témái .	tárgyalásokon	1	Sup
A megbeszélésen a felek elhatározták , hogy konkrét javaslatokat dolgoznak ki az adósság rendezésére .	adósság	12	Nom
Más városokban sem sokkal jobb a helyzet : Gnjilanéban néhány nappal ezelőtt egy szerb tulajdonban lévő videotékára dobtak kézigránátokat .	városokban	1	Ine
A rosszfiúk jó része szláv akcentussal töri az angolt , de ez , valljuk be , csak arra a nyomorúságra utal , amelyben az utóbbi évek szegény akciófilm-forgatókönyvírói kénytelenek kiizzadni egy valamirevaló főgonoszt a kémhistóriájukhoz .	főgonoszt	32	Acc
A kegytárgyak , műtárgyak sajátos szépsége és történeti értéke mellett az anyag finomsága és a megformálás egyedisége is megragadhatja az érdeklődőket .	érdeklődőket	20	Acc
— A szép beszéd egyébként is kiemelkedő szerephez jut pályáján , hiszen minden évben egyszer díjátadóként lép színpadra az Operaházban , hogy a szép magyar kiejtésért alapított elismerését az erre legméltóbbnak talált kollégájának átnyújtsa .	pályáján	9	Sup
Ez talán túlzott derűlátás , de lehet , hogy a közeljövőben minden konjunktúra-dekonjunktúra elméletet felül kell vizsgálni .	közeljövőben	10	Ine
De talán a legnagyobb bók az volt az életemben , amit Gábor Miklós mondott nekem : " Ha téged nézlek a színpadon , nem veszem észre , hogy énekelsz . "	észre	25	Sub
Egyébként is szeretem az operettet , mulattat , s mindig szívesen szerepeltem ilyen darabokban .	darabokban	13	Ine
Az 1997 novemberében még 11 millió forintos törzstőkéjű társaság tőkéjét 1998 januárjában 311 millió forintra emelte a Reichardt család .	januárjában	11	Ine
A politikától távol tartotta magát , jóllehet , azokban a fényes szelekkel átfújt években a magyar baloldalon még nagyon szerették Titót .	baloldalon	16	Sup
Aktuális nemzetközi témák és a kétoldalú viszony kérdései szerepelnek Martonyi János vasárnap kezdődő , egynapos hivatalos moszkvai látogatásán .	kérdései	7	Nom
A tapasztalatok szerint egy állásra hét jelentkező is juthat .	állásra	4	Sub
A nisi polgármesteri hivataltól származó értesüléseink szerint a szerbiai városba szerda este megérkezett a 10 teherautó , amely az Európai Unió és a szerb ellenzék között létrejött megállapodás értelmében fűtőolajat szállít az ellenzéki vezetésű , közép-szerbiai településnek .	értesüléseink	5	Nom
Raj Tamás , a Makkabi Kiadó vezetője , a judaisztika kiváló magyarországi szakértője lapunknak beszámolt arról , hogy igazi ritkaságok is találhatók az árverésre szánt anyagban .	ritkaságok	19	Nom
Legutóbb láthattunk egy sífelszereléseket reklámozó plakátot , melyről nyomban elhangzott , hogy nem az , ami , csak egy fénykép , melyen síoktatók között egy férfiimitátor tévébemondó társaságában ott látható a magyar miniszterelnök is .	tévébemondó	26	Nom
A betegség jóval kevésbé érinti a fejlett országokat .	betegség	1	Nom
" 6 ezer rendőrre lenne szükségünk .	rendőrre	3	Sub
Az eredeti gipszminta alapján negatívokat készítenek a 3,4 méter magas szoborról , majd a viaszkópiák alapján Gödöllőn egy magánöntődében újraöntik a szobrot .	magánöntődében	18	Ine
A földrengés ellenére az ankarai kormány a múlt héten megerősítette elkötelezettségét a deficitet enyhítő és az inflációt mérséklő stabilizációs program , illetve a privatizációval egybekötött szerkezetátalakítás mellett .	program	19	Nom
Az állami televíziófelügyelet például átmenetileg némaságra ítélte az egyik kereskedelmi csatornát , mert az élesen bírálta a kabinetet a válságkezelés hiánya miatt .	némaságra	5	Sub
Márpedig az NSZK-ban szinte mindig vannak valahol vagy helyhatósági , vagy tartományi választások — ezen az őszön például a Saar-vidéken és Brandenburgban — , s hosszabb távon egyetlen párt sem veszhet össze a választóival .	választóival	33	Ins
A legfontosabb feladatnak a hatóságok azt tartják , hogy elhelyezzék a katasztrófa következtében otthontalanná vált mintegy 600 ezer túlélőt — korábban 200 ezer hajléktalanról érkeztek hírek .	túlélőt	18	Acc
A japán rendőrség több akciót hajtott végre , a Rajfu Szupeszu szekta után kutatva , amely azóta hallatott magáról , hogy két tagjának szállodaszobájában egy mumifikált holttestre bukkantak .	szállodaszobájában	23	Ine
Az IMF által tanácsolt közvetlen jövedelemkiegészítési támogatás bevezetése — amely sok farmert érzékenyen érintene — ugyancsak nehéz döntés elé állítja a török kormányt , mivel a 65 milliós lakosság 45 százaléka gazdálkodó , ami jelentős politikai erőt jelent .	támogatás	6	Nom
Rohamosan veszít népszerűségéből a nagyobbik német kormánypárt , az SPD , s vele együtt Gerhard Schröder kancellár , elsősorban a 30 milliárd márkás takarékossági csomagterv s a párton belül ennek kapcsán felszínre került ellentétek miatt .	párton	27	Sup
A moszkvai külügyminiszteri megbeszéléseken Martonyi János föl kívánja vetni a Szovjetunióba vitt magyar műkincsek visszaszolgáltatásának kérdését .	megbeszéléseken	3	Sup
De kaptam felkérést a Budapesti Csellóegyüttestől és egy férfi-énekszextettől is , úgyhogy szerencsére bőven el vagyok látva feladatokkal .	feladatokkal	17	Ins
Az elégedetlenséget hosszabb távon az ellenzék , elsősorban is az iszlámisták aknázhatják ki , akiknek jelentős politikai muníciót szolgáltathat a " könyörtelen , profitéhes építészeti maffia " elleni harag .	elégedetlenséget	1	Acc
Méteres hótorlaszokon vágták át magukat a Pest Megyei Közterület-fenntartó Vállalat hómarógépei tegnap hajnalban ( meg délelőtt és délután ) a Pilisvörösvárt Pilisszántóval összekötő mellékútvonalon .	mellékútvonalon	23	Sup
Akkoriban a cég — átmeneti sikerrel — megszerezte a Magyar Nemzet , az Esti Hírlap és az Expressz kiadói jogát , 1997 végén pedig megindította a Napi Magyarország című napilapot .	napilapot	29	Acc
Ez utóbbit növelhetik a költségek csökkentésével , a korszerűséggel , valamint a megbízhatósággal ; nem véletlen napjainkban a márkanév jelentőségének növekedése .	csökkentésével	5	Ins
A Magyar Tudományos Akadémia ( MTA ) épületében helyet kapott találkozót Glatz Ferenc akadémiai elnök nyitotta meg , aki a magyar nemesség történelmi szerepéről tartott előadást .	találkozót	10	Acc
A Trajkovics-féle javaslatot a hivatalos Belgrád egyelőre nem kommentálta , ám szerbiai értesülések szerint a színfalak mögötti tárgyalások napirendjén mindig ott volt a Koszovó megosztását szorgalmazó javaslat .	megosztását	24	Acc
A májusról novemberre halasztott Martonyi-vizittől szakértők azt várják , hogy kedvező politikai légkört teremt a kétoldalú kapcsolatokban fennálló vitás kérdések megoldásához .	novemberre	2	Sub
Az elmúlt napok időjárása nyomán a Budapesttől alig 30 kilométerre fekvő pilisi települések lakói is megismerték az elszigeteltség érzését .	elszigeteltség	17	Nom
Weltekére most viszont az a feladat vár , hogy 2002-ben elbúcsúztassa a németek háború utáni identitásának legfontosabb támaszát , hiszen az euró teljes körű bevezetésével a hétköznapi életben is meg kell majd válniuk a márkától .	bevezetésével	24	Ins
A kiállítás egyik szenzációja az az egy méter magas , áttört Zsolnay-díszváza , amely ezen a kiállításon látható először .	Zsolnay-díszváza	11	Nom
Decemberben , a kolozsváriak tervezett Vígszínház-beli vendégjátékán erről a budapesti közönség is megbizonyosodhat , amikor is majd Shakespeare Troilus és Cressidájának Teiresziászaként láthatjuk őt a magyar fővárosban .	vendégjátékán	6	Sup
Szakértők szerint a nemzetközi döntőbíráskodást megtiltó 1995-ös törvény más egyéb okokkal együtt 2-6 milliárd dollárnyi külföldi beruházástól fosztotta meg a gazdaságot , főként az infrastruktúra területén .	okokkal	10	Ins
Tudják , hogy az imént letakarított útszakaszra percek múlva vissza kell térniük .	percek	7	Nom
Ennek ellenére egy " optikai tuningfelszerelések " tömkelegében pompázó Audi A4 Quattro nekivág a domboknak Pilisszántó irányában .	tömkelegében	7	Ine
Tavaly az állami gabonatanács 8 millió tonna szemes terményt vett át , s a mennyiséget az idén 4,5 millióban szeretné korlátozni , mert tavaly például előfordult , hogy olcsón beszerzett iraki búzát adtak tovább a hatóságoknak .	búzát	31	Acc
Az eredeti gipszminta alapján negatívokat készítenek a 3,4 méter magas szoborról , majd a viaszkópiák alapján Gödöllőn egy magánöntődében újraöntik a szobrot .	gipszminta	2	Nom
Nem következett be világméretű katasztrófa , mert a globalizált gazdaságban a nagy tőketömegek mozgatásával ezt el lehetett kerülni .	gazdaságban	9	Ine
Az orosz kormányfő büntetlenséget ígért azoknak a csecsen fegyvereseknek , akiknek nem tapad vér a kezéhez , s leteszik a fegyvert a szövetségi erők előtt .	büntetlenséget	3	Acc
A vörösváriak és a pilisszántóiak többsége azonban nem siet sehova .	pilisszántóiak	4	Nom
Igaz , emberi " segítséget " is kapott a települések elszigeteléséhez .	települések	9	Nom
A szerbek közül jelenleg csak az ellenzékiek támogatják azt a néhány évvel ezelőtt előterjesztett tervet , mely szerint Koszovót meg kellene osztani a szerbek és a lakosság többségét kitevő albánok között .	többségét	27	Acc
Mindaz a képzeletszülte meseelem , ami a gorillacsaládban nevelkedő embergyerek regénybeli történetének kalandos feszültséget és romantikus lendületet kölcsönzött , ezúttal a rajzfilm műfajában levetette az élő megjelenítés korlátait .	meseelem	3	Nom
Raj Tamás , a Makkabi Kiadó vezetője , a judaisztika kiváló magyarországi szakértője lapunknak beszámolt arról , hogy igazi ritkaságok is találhatók az árverésre szánt anyagban .	judaisztika	9	Nom
A tervezet értelmében Koszovó északi , Szerbiával határos részei kerülnének szerb irányítás alá , s a szerb kantonoknak Kosovska Mitrovica és Gnjilane lenne a központja .	részei	8	Nom
— Az utóbbi években a közönség több filmben is találkozhatott önnel .	közönség	5	Nom
Van viszont üldözés sítalpakon és sárkányrepülőn , motorcsónakon és olajvezetékben , és még egy atom-tengeralattjáró belseje is fontos szerepet kap , de ott már Bond az idővel is harcban áll , hogy megmenthesse az emberiséget .	motorcsónakon	7	Sup
Így aztán két év múltán az ifjú már valóban a szegedi alma materben folytathatta tanulmányait , ahol — kiváló eredményei birtokában — élvezte a Nobel-díjas tudós segítőkészségét .	materben	12	Ine
A szépet , a jót kell megmutatni .	szépet	1	Acc
A kamattámogatás is differenciált : az állami garancia nélküli hitelekre 100 , a garantált hitelekre pedig a kezességvállalás mértékének növekedésével csökkenően 75 , illetve 40 százalék .	hitelekre	9	Sub
Ki kérdezné , hogy a fénykép miért éppen síelőket mutat , amikor Magyarország a pusztáról híres , meg arról , hogy egy olyan sípálya sincs területén , melyen életveszély nélkül le lehetne siklani .	síelőket	8	Acc
Bernard Kouchner , a koszovói ENSZ-közigazgatás vezetője szerdán közölte : megelégelte az ENSZ biztonságot és megbékélést célzó koszovói erőfeszítéseit érő bírálatokat .	erőfeszítéseit	18	Acc
A CTK hírügynökség szerint a betonfal lebontása 56 ezer cseh koronába került .	hírügynökség	2	Nom
Az 1944. március 19-e után elindított csoportba került e történet hőse is , a már majdnem orvos fiatalember .	19-e	3	Nom
Bernard Kouchner , a koszovói ENSZ-közigazgatás vezetője szerdán közölte : megelégelte az ENSZ biztonságot és megbékélést célzó koszovói erőfeszítéseit érő bírálatokat .	megbékélést	15	Acc
A másik kocsinak már a nyomai sem látszanak .	nyomai	5	Nom
Elhitették vele , hogy szeretője , Marina Fjodorovna Mangurina teherbe esett tőle , és abortuszon kellett átesnie .	abortuszon	14	Sup
Mostanában , a cseh-szlovákiai " bársonyos forradalom " tizedik évfordulójára emlékezve , magától értetődően , sok szó esik Alexander Dubcek személyiségéről , a szlovák történelemben betöltött szerepéről .	évfordulójára	9	Sub
— Általában a ritmusos kompozíciókat szeretem , a giusto tempójú darabokat , amelyekben kézenfekvő az ütőhangszerek használata .	használata	16	Nom
Az ENSZ és a NATO abban bízik , hogy a tények kozmetikázásával sikerül valamilyen formában helyreállítani a tartomány többnemzetiségű státusát .	kozmetikázásával	11	Ins
Orwell 1984-ről szóló regényének megrázó negatív nyelvi utópiája azért lehetett mozgósító erejű a szabadsághiányos múltban , mert semmi nem lehetett hatékonyabb érv a szólásszabadság mellett , mint a szólásszabadság hiánya .	múltban	14	Ine
Az áldozat fia , a szekta 31 éves tanítványa azt állította , hogy apja még élt , amikor megtalálták , és a boncolás okozta halálát .	fia	2	Nom
Kísértetek szabadultak el a szabaddá vált nyilvánosságban , a szavak gyilkos , ordas , gonosz indulatok árján úszva szorongást , félelmet , az egyszer volt újra megtörténhetésének vélelmét keltették fel .	nyilvánosságban	6	Ine
( Radnóti a második transzportban volt . )	transzportban	4	Ine
Az illetékesek elejétől fogva óvatosan kezelték a Nyugatra szökött volt KGB-ügynök " leleplezéseit " , ezért az olaszokra vonatkozó listát ugyan közreadták , de az igazságügyi szervek azóta alaposan tanulmányozzák azt .	szervek	26	Nom
— Ez alatt a fél évszázad alatt szinte az egész baritonrepertoárt elénekelte , egyedül Wagner darabjaiban nem lépett színpadra .	színpadra	18	Sub
Ma a világ három legfontosabb — a japán , a délkelet-ázsiai , az USA — gazdaságában újabb növekedési hullám kezdődött .	gazdaságában	15	Ine
Az államnak csupán a gazdaság szervezésében , az információ közvetítésében , az alkalmazkodás segítésében kell részt vennie , nem szabad közvetlenül beavatkoznia a gazdaságba .	közvetítésében	9	Ine
Az újság szerint az államfőt november 1-jén már későn — legalább két nappal bélátfúródása után — operálták meg , ami súlyos hashártyagyulladást és vérmérgezést okozott szervezetében .	szervezetében	25	Ine
A kiadvány 160 színes fotó segítségével ad képet az alkotó munkásságáról .	alkotó	9	Nom
A magyar keretlegények durvasága , az élelem- és gyógyszerhiány , a hideg , a piszok megtette a magáét .	hideg	11	Nom
Akkoriban a cég — átmeneti sikerrel — megszerezte a Magyar Nemzet , az Esti Hírlap és az Expressz kiadói jogát , 1997 végén pedig megindította a Napi Magyarország című napilapot .	jogát	19	Acc
A XVIII. században Lengyelországban készült , a Lemberg melletti Libahara faluból származik .	században	2	Ine
A két évtizede tartó változások következtében a török gazdaság szinte lokomotívként száguldott , teljesítményét pontosan mérni sem lehetett a feketegazdaság hatalmas volumene miatt .	feketegazdaság	19	Nom
A japán rendőrség több akciót hajtott végre , a Rajfu Szupeszu szekta után kutatva , amely azóta hallatott magáról , hogy két tagjának szállodaszobájában egy mumifikált holttestre bukkantak .	akciót	4	Acc
A szobor alkotójával beszélgettünk .	alkotójával	2	Ins
Johann Strauss műve pedig azért jutott eszembe , mert csodálatos muzsika , ami a dalszínházban mindig is a legnagyobb énekesek előadásában hangzott fel .	műve	2	Nom
A virtuális gazdaság tehát képes az önkorrekcióra , ugyanakkor egyéb jellemzőivel is számolni kell .	önkorrekcióra	6	Sub
A 6-os úton keletkezett torlódás miatt bizonytalan időre lezárták a dunaföldvári hidat .	úton	2	Sup
A magyar-orosz kapcsolatokat azonban nem ez jellemezte az eltelt időszakban .	kapcsolatokat	2	Acc
Az oroszok azonban feltűnően békésen viselkednek , s egyelőre semmi jele annak , hogy a katonák erőszakos akcióra készülnének .	akcióra	17	Sub
A német bankvilág Olümpuszát eddig megjárt hét elnök ugyanis a pénzügyi stabilitás legfőbb őreként , a szigorú kamatpolitika és a pénzmennyiség kézbentartása útján akár a mindenkori kormánnyal való konfliktust is vállalva , a márka értékállóságát helyezte mindenek elé .	pénzmennyiség	20	Nom
Az alelnök meséli el azt is , hogy az egyik elakadt autót rövid két óra alatt sikerült , az ítéletidő ellenére , valakinek kifosztania .	autót	11	Acc
Nem közlekedett a Volán az M1-es autópályán sem , mivel azt a rendőrség lezárta .	autópályán	6	Sup
A politikai közbeszédben egyeduralomra jutott jogi nyelvhasználat előfeltevése , hogy csak azt lehet számon kérni , ami le van írva és ahogyan le van írva .	közbeszédben	2	Ine
Bár e kérdések egynémelyikében nincs nézetazonosság a két ország között , az eszmecsere a várakozások szerint jó lehetőséget teremt az álláspontok kifejtésére , s talán közelítésére is .	kifejtésére	21	Sub
Nyitott gazdaságunkra jellemző a természeti tényezők szűkössége , a külkereskedelem szükségessége , az integráció igénye .	gazdaságunkra	1	Sub
Az úttorlaszokat építő és folyamatosan tüntető albánok azzal indokolják viselkedésüket , hogy az oroszok elfogultak az albánokkal szemben , s a koszovói albánok elleni szerb támadásokban több száz orosz zsoldos is részt vett .	albánok	6	Nom
Németországban Baden-Württemberg tartományban és Bajorországban a főutakon és az autópályán egyaránt 25-30 kilométer hosszan torlódtak fel az személygépkocsik és az autóbuszok .	autópályán	9	Sup
A Vatikán ajánlásainak engedve a német katolikus püspökök úgy határoztak , hogy egyházuk módosítani akarja részvételét a terhestanácsadás törvény által szabályozott rendszerében .	rendszerében	21	Ine
Nem szeretem a zsúfoltságot , egy zsúfolt kiállításról jobb az elején kijönni , mielőtt elfolyik a maradék életerőnk .	zsúfoltságot	3	Acc
A rosszfiúk jó része szláv akcentussal töri az angolt , de ez , valljuk be , csak arra a nyomorúságra utal , amelyben az utóbbi évek szegény akciófilm-forgatókönyvírói kénytelenek kiizzadni egy valamirevaló főgonoszt a kémhistóriájukhoz .	akciófilm-forgatókönyvírói	27	Nom
Az áldozat fia , a szekta 31 éves tanítványa azt állította , hogy apja még élt , amikor megtalálták , és a boncolás okozta halálát .	halálát	24	Acc
Jaroslav Volf azt állítja , hogy az egész históriában roppant homályos Dubcek gépkocsivezetőjének , Ján Rezníknek a szerepe .	históriában	8	Ine
A 485,7 milliárd márkás német költségvetésből 30 milliárd megspórolására hivatott tervből ( HVG , 1999. július 10. ) immár hivatalos kormány-előterjesztéssé nemesedett intézkedéssorozat már a párton , sőt annak parlamenti frakcióján belül sem talált egyértelmű támogatásra .	frakcióján	30	Sup
A magyar fővárosban december 8-án a Néprajzi Múzeumban kerül sor az album 1-től 10-ig sorszámozott példányainak az aukciójára , míg Bécsben várhatóan a jövő év februárjában rendezik meg a licitet .	februárjában	25	Ine
Az áprilisi választások révén hatalomra jutott bal-jobb koalíció az utóbbi négy év legstabilabb török kormányának tűnik , a földrengés azonban veszélyt jelenthet erre a politikai egységre .	hatalomra	4	Sub
Budapest bízik abban , hogy az utóbbi hónapokban keletkezett vitákat , félreértéseket az orosz fél számára is megnyugtatóan sikerült tisztázni és lezárni .	félreértéseket	11	Acc
A " legkevésbé ismert " jelzőt először Péter Vladimir használta velem kapcsolatban , mikor 97-ben megkaptam a Soros-ösztöndíjat .	jelzőt	5	Acc
A Trajkovics-tervezet a szerbeket hozná kedvezőbb helyzetbe , hiszen épp ezekben a körzetekben találhatóak a tartomány legjobb bányái és legnagyobb ipari üzemei .	szerbeket	3	Acc
Raj Tamás , a Makkabi Kiadó vezetője , a judaisztika kiváló magyarországi szakértője lapunknak beszámolt arról , hogy igazi ritkaságok is találhatók az árverésre szánt anyagban .	árverésre	23	Sub
Az egész estés rajzfilm készítői egyszerű , kedves történetet mesélnek egy lényről , aki az állatok között tapasztalja meg a szeretet , a családi összetartozás erejét , s aki ember mivoltára ébredve is inkább a dzsungelt választja .	erejét	25	Acc
Ez utóbbit növelhetik a költségek csökkentésével , a korszerűséggel , valamint a megbízhatósággal ; nem véletlen napjainkban a márkanév jelentőségének növekedése .	utóbbit	1	Acc
A hibátlanul sikerült szinkron mellett a magyar változat meglepetése , hogy Phil Collins remek ritmusú betétdalait Ákos énekli , saját műfordításában , hibátlan stílusérzékkel .	műfordításában	20	Ine
Ma a korszerű hangzáshoz hozzátartozik az ütős hangszerek kiemelt szerepeltetése is , s úgy veszem észre , hogy a közönség is szereti az ilyen kompozíciókat .	észre	15	Sub
Súlyosnak minősítette a horvát köztársasági elnök egészségi állapotát a Tudjmant kezelő zágrábi orvoscsoport .	állapotát	7	Acc
Hasonló ártámogatási rendszer működik egyébként a cukorrépa és a dohány esetében is .	dohány	9	Nom
Én pontosan emlékszem egy negyvenöt esztendővel ezelőtti beszélgetésre , amelynek minden szavát megfogadtam .	beszélgetésre	7	Sub
Pedig a kilencvenes évek előtt még igenis lehetett ebben a műfajban is eredményes az ember , hiszen a 180-as csoporttal tizenkét éven át telt házak előtt játszhattunk a Zeneakadémián , jelentős törzsközönségünk volt , készültek lemez- és rádiófelvételeink .	műfajban	10	Ine
Ebből a szempontból is különleges jelentősége van annak , hogy az albánok már több mint egy hete nem engedik be a városba azokat az orosz Kfor-katonákat , akiknek az Orahovacban június óta szolgáló hollandokat kellett volna felváltaniuk .	jelentősége	5	Nom
Persze vezetőjét hiába kérlelik a közúti hómunkások .	vezetőjét	1	Acc
Ez talán túlzott derűlátás , de lehet , hogy a közeljövőben minden konjunktúra-dekonjunktúra elméletet felül kell vizsgálni .	konjunktúra-dekonjunktúra	12	Nom
A Magyar Tudományos Akadémia ( MTA ) épületében helyet kapott találkozót Glatz Ferenc akadémiai elnök nyitotta meg , aki a magyar nemesség történelmi szerepéről tartott előadást .	előadást	25	Acc
Ez alkalmazkodási hajlandósággal jár .	hajlandósággal	2	Ins
Hiába nyilvánvaló , hogy a nagy fővárosi közlekedési fejlesztésekben az államnak is részt kell vennie , még ha a politikai akarat meg is van , akkor sem lehet ezt a hatalmas beruházási igényt kielégíteni .	fejlesztésekben	8	Ine
Ha a szemlélő túlteszi magát az egy éve tartó és várhatóan tovább durvuló főváros-kormány vitán , akkor is látszik , hogy a nagyobb beruházások még közös finanszírozásban is túl nagy falatot jelentenének .	finanszírozásban	26	Ine
Az éjszaka eredménye 12 személyautó , 2 autóbusz és a ráadás : a Pilisszántóba igyekvő kenyereskocsi kiszabadítása a hó fogságából .	autóbusz	7	Nom
Az EU éppen a fal lebontásának napján tette közzé nyilatkozatát , amely szerint a cseh EU-tagság egyik fő gondja a csehországi roma népességgel való nem megfelelő bánásmód .	nyilatkozatát	9	Acc
Hazudik , aki azt állítja , hogy nem akar sikeres lenni vagy hogy számára nem fontos , hogy minél több visszajelzést kapjon .	visszajelzést	20	Acc
— A szép beszéd egyébként is kiemelkedő szerephez jut pályáján , hiszen minden évben egyszer díjátadóként lép színpadra az Operaházban , hogy a szép magyar kiejtésért alapított elismerését az erre legméltóbbnak talált kollégájának átnyújtsa .	színpadra	17	Sub
Így aztán két év múltán az ifjú már valóban a szegedi alma materben folytathatta tanulmányait , ahol — kiváló eredményei birtokában — élvezte a Nobel-díjas tudós segítőkészségét .	alma	11	Nom
Szekszárdon a 6-os úton parkolóba terelték az arra tartókat , s számukra itt pihenő-melegedő helyet alakítottak ki — tájékoztatta lapunkat Schieber József , a Polgári Védelem Országos Parancsnokságának szóvivője .	tartókat	8	Acc
— Többször dolgozott együtt az Amadinda együttessel , számos darabjában kapnak fontos szerepet az ütőhangszerek ...	darabjában	9	Ine
A pesszimisták szerint ez az — árnyékgazdaságnak is nevezett — " léggömb " ki fog pukkadni .	pesszimisták	1	Nom
— Az ember csak reménykedhet , s igyekezhet a hangjával hosszabb és rövid távon is gazdálkodni .	távon	13	Sup
Kísértetek szabadultak el a szabaddá vált nyilvánosságban , a szavak gyilkos , ordas , gonosz indulatok árján úszva szorongást , félelmet , az egyszer volt újra megtörténhetésének vélelmét keltették fel .	indulatok	15	Nom
Meglepett , amikor ezekre a szerepekre felkértek , hiszen voltam alvilági főnök és őrült SS-tiszt , játszhattam a Balekok és banditákban , valamint a Hány az óra , Vekker úr ? című produkciókban .	szerepekre	5	Sub
Tegnap újabb házak dőltek össze a hó súlya alatt .	súlya	7	Nom
Szakértők szerint a nemzetközi döntőbíráskodást megtiltó 1995-ös törvény más egyéb okokkal együtt 2-6 milliárd dollárnyi külföldi beruházástól fosztotta meg a gazdaságot , főként az infrastruktúra területén .	Szakértők	0	Nom
Ez a műfaj lényege : olyan szuggesztivitással , olyan hőfokon kell előadni az operákat , hogy természetesnek hasson az éneklés .	szuggesztivitással	6	Ins
Három magas rangú olasz katonatiszt a hidegháború idején fontos államtitkokat adott át a volt szovjet hírszerzésnek — vélik tudni a szerdai olasz újságok .	katonatiszt	4	Nom
A hibátlanul sikerült szinkron mellett a magyar változat meglepetése , hogy Phil Collins remek ritmusú betétdalait Ákos énekli , saját műfordításában , hibátlan stílusérzékkel .	stílusérzékkel	23	Ins
A világgazdaság gyors , országhatárokon átívelő fejlődését több tényező idézi elő .	országhatárokon	4	Sup
De azért kérdésünkre megindul a panaszáradat .	kérdésünkre	2	Sub
Ilyen például a teljes német Talmud-fordítás , amely a náci Németországban jelent meg , és a kikiáltási ára 200 ezer forint .	Talmud-fordítás	5	Nom
A társaság végelszámolással történő megszüntetéséről döntenek a Corso Rt. tulajdonosai a cipőkereskedelmi cég jövő hétre meghirdetett közgyűlésén .	hétre	14	Sub
A tévé szerint a támadók egy négytagú járőrre nyitottak tüzet .	járőrre	7	Sub
Hiszen a keleti szél pár másodpercen belül újra hótakarót borít rá .	szél	3	Nom
Simicska akkor formálisan nem vett részt a Mahir Rt. 1994. eleji privatizációjában , ám hamarosan átvette a cég irányítását , amelynek 1998-ig áttételesen résztulajdonosa is volt .	privatizációjában	11	Ine
A májusról novemberre halasztott Martonyi-vizittől szakértők azt várják , hogy kedvező politikai légkört teremt a kétoldalú kapcsolatokban fennálló vitás kérdések megoldásához .	kapcsolatokban	16	Ine
Zsoldos Árpád is jól ismert és kedvelt színész Magyarországon : elég , ha csak a szentgyörgyi színház nagy sikerű Hegedűs a háztetőn című musicaljében nyújtott madárcsontú , mégis hihetetlenül erős Tevje-alakítására gondolunk .	musicaljében	23	Ine
" Minden napra esik egy szemantikai puccs .	napra	2	Sub
Fejérben volt a legkritikusabb a helyzet : 8 települést egyáltalán nem lehet megközelíteni , s időlegesen elvesztette kapcsolatát a külvilággal Lepsény és Enying is .	települést	8	Acc
A kutatók minden bizonnyal felfigyelnek a nagykövet által önállótlanul alkalmazott kétosztatú gondolkodásra , mely tisztességesekre és tisztességtelenekre osztja a társadalmat , melynek elvben osztatlan képviseletét kellene ellátnia .	elvben	22	Ine
Egy héten belül immár másodszor bénította meg a lengyel fővárost a hatalmas hózuhatag .	hózuhatag	12	Nom
A roppant terhek , az örökös hadi készültség , a csapatok mozgatása , az ütközetek , az utánpótlás megszervezése , a millió véletlen esemény elviselése és integrálása a katonai folyamatokba , megviselték .	megszervezése	18	Nom
A betegség kitörése , azaz a 80-as évek eleje óta a kórokozó 50 millió embert fertőzött meg .	kitörése	2	Nom
Az egyszerű az , hogy miután éveken keresztül rétegelt lemezből dolgoztam , eluntam a rétegelést , mást akartam — és a lyukasztgatás jutott az eszembe , ami hallatlanul munkaigényesnek bizonyult , de úgy tűnik a kiállításból , van eredménye .	rétegelést	14	Acc
Én pontosan emlékszem egy negyvenöt esztendővel ezelőtti beszélgetésre , amelynek minden szavát megfogadtam .	szavát	11	Acc
A csehországi Ústi nad Labemben szerda hajnalban teljesen lebontották azt a falat , amelyet a város vezetése építtetett október elején azért , hogy elválassza a helyi romákat a szomszédos családi házak lakóitól .	falat	11	Acc
A cég helyzetét a növekvő konkurencián kívül rontotta , hogy a kiskereskedelmi üzletek eladását szolgáló előprivatizáció keretében több boltját elvonták , ingatlanvagyonának 86 százalékát így két nagyméretű — 6 ezer négyzetméter körüli — raktár tette ki .	keretében	16	Ine
Az Ersténél abban reménykednek , hogy a saját részvények visszavásárlása szeptember 30-áig befejeződik — ekkor tartják azt a rendkívüli közgyűlést , amelyen a bank jegyzett tőkéjét a hitelintézeti törvényben előírt mértékhez igazítják .	tőkéjét	25	Acc
Az eredeti gipszminta alapján negatívokat készítenek a 3,4 méter magas szoborról , majd a viaszkópiák alapján Gödöllőn egy magánöntődében újraöntik a szobrot .	méter	8	Nom
— Úgy vélem , aki színpadra lép , annak kötelessége a nyelv ápolása .	színpadra	5	Sub
Ennek érezhető következménye például , hogy az elméleti kutatások eredményeit sokkal hamarabb hasznosítják a gyakorlati életben , mint korábban .	következménye	2	Nom
Gyönyörű színpadi beszédét gyakran emlegetik példaként , nem véletlenül tanított diplomája kézhezvétele után négy éven át beszédtechnikát a főiskolán .	kézhezvétele	11	Nom
A kormány máris törvénytervezetet nyújtott be a parlamentnek , hogy a katasztrófa sújtotta tartományok kivételével egyszeri adót vessenek ki , amiből több mint 100 millió dollárnak megfelelő összeg is befolyhat .	törvénytervezetet	3	Acc
Azt is rebesgették az új gépkocsivezetőről , hogy a rendszerváltás után részt vett volna egyes állambiztonsági ügynöknévsorok megsemmisítésében .	megsemmisítésében	17	Ine
A csehországi Ústi nad Labemben szerda hajnalban teljesen lebontották azt a falat , amelyet a város vezetése építtetett október elején azért , hogy elválassza a helyi romákat a szomszédos családi házak lakóitól .	hajnalban	6	Ine
A Tupras jövő márciusra tervezett eladásából egymilliárd dollárnyi bevételt remélt a kabinet , s bár az izmiti finomítóban négy hónap múlva teljes kapacitással folyhat a termelés , a tűzkárok helyreállítása még akár egy évet is igénybe vehet .	helyreállítása	29	Nom
Tegnap újabb házak dőltek össze a hó súlya alatt .	hó	6	Nom
Az egymást követő török kormányok politikai megfontolásokból nem mertek hozzányúlni e nagyvonalú ellátáshoz , amely a költségvetési deficit több mint negyedét okozza .	kormányok	4	Nom
Amikor az SPD 1969-ben , a második világháború után először megnyerte a választásokat , az annak volt köszönhető , hogy Willy Brandt meg tudta győzni a választókat , mondhatni szociáldemokratákat csinált belőlük .	választókat	26	Acc
Bár a helyreállítás költségei jórészt az állami büdzsét terhelik majd , török és külföldi elemzők egyetértenek abban , hogy hosszabb távon a földrengés csak korlátozott mértékben hat a gazdaságra .	távon	20	Sup
Dubceknak az volt az álláspontja , hogy a közös állam szétválasztása egyes cseh és szlovák politikusok egyéni ambícióit szolgálhatja ugyan , de semmiképpen nem a két nép érdekeit .	nép	26	Nom
További bizonyíték lehet a perújrafelvételhez a BMW cég szakértői véleménye ( ilyen autóval utazott Dubcek ) , amely kizárja az adott baleseti körülmények között olyan hátgerincsérülés lehetőségét , ami a politikus halálát okozta .	bizonyíték	1	Nom
Nem kizárt , hogy a földrengés nemcsak a Márvány-tenger menti térséget rázta meg , de törést okozott a monolitikus bürokrácia és az egyre individualistább , a magángazdaságban edződő , tanult lakosság viszonyában is .	magángazdaságban	26	Ine
Megszervezték ugyanis az Első Magyarországi Judaika Árverést , amelynek keretében értékes kulturális-történeti anyag — könyvek , kéziratok , kegytárgyak és festmények — kerül kalapács alá .	kalapács	23	Nom
A globalizáció a gazdaság kínálati oldalát befolyásolja , és nem hat a jövedelmek nemzeti kereteken belül történő elosztására .	elosztására	17	Sub
Idén eddig 2,6 millió áldozatot szedett a gyógyíthatatlan immunbetegség , az AIDS — adta hírül a France 2 televízió az Egészségügyi Világszervezet jelentésére hivatkozva .	jelentésére	22	Sub
A kegytárgyak , műtárgyak sajátos szépsége és történeti értéke mellett az anyag finomsága és a megformálás egyedisége is megragadhatja az érdeklődőket .	anyag	11	Nom
Az Erste Bank Hungary Rt. a jövő héten teszi közzé az újságokban , milyen áron hajlandó megvenni a mintegy 1200 kisbefektető kezében lévő 77 ezer darab , a bank 9,2 milliárd forintos jegyzett tőkéjének négy százalékát kitevő részvényeit .	áron	14	Sup
Kevésbé aggasztó a helyzet Dél-Amerikában is , ahol különösen nagy összegekkel támogatják a megelőzést .	megelőzést	13	Acc
Ezért is fontos fenntartani a magas szintű párbeszédet , és időről-időre szót váltani az országainkat érintő és érdeklő aktuális kérdésekről — fejtette ki Kontra Ferenc .	országainkat	14	Acc
Tömegbalesetet okozott a rendkívüli havazás az Egyesült Államokban is .	havazás	4	Nom
Méteres hótorlaszokon vágták át magukat a Pest Megyei Közterület-fenntartó Vállalat hómarógépei tegnap hajnalban ( meg délelőtt és délután ) a Pilisvörösvárt Pilisszántóval összekötő mellékútvonalon .	hajnalban	12	Ine
" Soha nem tapasztaltam ekkora dühöt az állam és a politikusok ellen " — írta a Milliyet című napilap egyik újságírója .	újságírója	20	Nom
Közel négyszáz fő jelenlétében tartotta összejövetelét múlt hét végén a Magyar Történelmi Családok Egyesülete .	jelenlétében	3	Ine
Az eladásra szánt vállalatok között szerepel továbbá a nemzeti légitársaság , a Türk Hava Yollari — amelynek 30 százalékát kínálják fel — és a Türk Telekom is , amelynek privatizálásából 5,3 milliárd dollárt várnak .	légitársaság	9	Nom
A kutatók minden bizonnyal felfigyelnek a nagykövet által önállótlanul alkalmazott kétosztatú gondolkodásra , mely tisztességesekre és tisztességtelenekre osztja a társadalmat , melynek elvben osztatlan képviseletét kellene ellátnia .	kutatók	1	Nom
— Ma a kortárs zenére nagyon szűk réteg kíváncsi .	zenére	4	Sub
Johann Strauss műve pedig azért jutott eszembe , mert csodálatos muzsika , ami a dalszínházban mindig is a legnagyobb énekesek előadásában hangzott fel .	dalszínházban	14	Ine
És ezt bizonyítja az út szélén órák óta veszteglő távolsági busz is .	szélén	5	Sup
Örülök , ha azokkal a munkáimmal , amiket huszonöt év alatt csináltam , meg tudok tölteni egy-két szobát .	munkáimmal	5	Ins
A Magyar Tudományos Akadémia ( MTA ) épületében helyet kapott találkozót Glatz Ferenc akadémiai elnök nyitotta meg , aki a magyar nemesség történelmi szerepéről tartott előadást .	nemesség	21	Nom
Oroszország a múlt heti isztambuli EBESZ-csúcson vonakodva bár , de beleegyezett abba , hogy az EBESZ elnöke ellátogasson a szakadár kaukázusi köztársaságba .	szakadár	19	Nom
Eluralkodott a magyar politikai kultúra egyik átkos öröksége , a jogászi nyelv , melynek szavai csak a semmitmondásra , a csűrés-csavarásra , az időhúzásra , a partner elnémítására , a nyers nyelvi agresszióra alkalmasak .	agresszióra	32	Sub
Hatezer fiatalembert adott el a magyar állam a németeknek , hogy velük a Todt szervezet — a Siemens és más cégek megbízásából — rezet bányásztasson , illetőleg fönt , a hegyekben vasutat építsen az érckőzet elszállításához .	fiatalembert	1	Acc
A helyi albán vezetők azt is közölték , készek szembeszállni az oroszokkal , ha a moszkvai hadvezetés úgy dönt , fegyverek bevetésével töri át az úttorlaszokat .	oroszokkal	11	Ins
Van viszont üldözés sítalpakon és sárkányrepülőn , motorcsónakon és olajvezetékben , és még egy atom-tengeralattjáró belseje is fontos szerepet kap , de ott már Bond az idővel is harcban áll , hogy megmenthesse az emberiséget .	idővel	26	Ins
Az Árgus Kiadó a szobor újraöntésével egyidejűleg albumot jelentet meg a szobrász születésének 120. és halálának 40. évfordulója alkalmából .	újraöntésével	5	Ins
A szervezők jövőre a multinacionális vállalatok mellett kis cégeket , tervezőirodákat is meghívnak , és olyan cégeket is bemutatnak , amelyeknek jelenleg nincsenek konkrét állásajánlataik .	tervezőirodákat	10	Acc
A magyar országgyűlési képviselő , ha akarja , szenátornak nevezi magát , ugyanaz a párt egyik nap ellenzék , a másik nap kormányoldalon álló , sőt a parlamenti többség akarata még a matematikánál is erősebb .	kormányoldalon	22	Sup
Orosz források szerint a csecsen erők létszáma az utóbbi időben 3500-ra emelkedett .	létszáma	6	Nom
Hatezer fiatalembert adott el a magyar állam a németeknek , hogy velük a Todt szervezet — a Siemens és más cégek megbízásából — rezet bányásztasson , illetőleg fönt , a hegyekben vasutat építsen az érckőzet elszállításához .	rezet	23	Acc
A kamionok nyári gumival , hólánc nélkül indulnak útnak — mondta Balogh András , a Veszprém Megyei Közútkezelő Kht. igazgatója .	gumival	3	Ins
Mégis mit képzeltek , szándékosan szabotálta a sofőr az utazást ? " — mérgelődik Pfeiffer Ferenc .	sofőr	7	Nom
A kerítések mögött német juhászkutyák és kuvaszok hengergetik magukat a hóban .	hóban	10	Ine
Mivel nem várható , hogy hazahívják , lemondani meg semmiképpen sem fog , a tekintélyelvű személyiség amerikai kutatói számára csak ajánlani lehet a vele való megismerkedést , melynek alapján nagyszerű esettanulmányok várhatók .	megismerkedést	25	Acc
A 338 millió forint jegyzett tőkéjű Corso a nyolcvanas évek végéig a belföldi lábbeli-kiskereskedelmi piac 40 százalékát tudhatta magáénak , amit látványos mélyrepülés követett : az árbevétel 1989 és 1993 között 3 milliárd forintról 400 millió forintra apadt .	árbevétel	26	Nom
Az úton ragadtak persze hálásak a tűzoltók , útmunkások segítségéért .	úton	1	Sup
A feledést hozó idő az egyik oldalról , a politikai érdek a másikról talán megszépítheti ezt a borzasztó rabszolgamunkát , de az a két-három korosztály , amelyet a magyar hatóságok odavezényeltek , azért megtapasztalták Dante Infernóját .	rabszolgamunkát	18	Acc
Döntő szerepet játszik a politikai stabilitás , valamint a tolerancia , az előítéletek megszüntetése .	stabilitás	5	Nom
Az elégedetlenséget hosszabb távon az ellenzék , elsősorban is az iszlámisták aknázhatják ki , akiknek jelentős politikai muníciót szolgáltathat a " könyörtelen , profitéhes építészeti maffia " elleni harag .	távon	3	Sup
" A fiatal zeneakadémistát hibátlan alakításával , szép baritonjával a közönség azonnal szívébe zárta , hangosan ünnepelte . "	alakításával	5	Ins
— Nagyon fontos az üresség , az űr utal a láthatatlan valóságra .	valóságra	11	Sub
Ez a szerep nem egy embert , hanem egy tucatot kívánt .	embert	5	Acc
Az attasét ekkor megkereste egy szovjet titkosszolgálati tiszt , aki a nő férjének adta ki magát , és megfenyegette Babiucot : botrányt csinál .	attasét	1	Acc
A hadiipari kutatások eredményeit a korábbi 3-4 év helyett ma már hat hónap múlva felhasználják a polgári termelésben .	eredményeit	3	Acc
Az elégedetlenséget hosszabb távon az ellenzék , elsősorban is az iszlámisták aknázhatják ki , akiknek jelentős politikai muníciót szolgáltathat a " könyörtelen , profitéhes építészeti maffia " elleni harag .	iszlámisták	10	Nom
Végül ez év elején a társaság vezérigazgatója is felmondott , így a ma már csak néhány alkalmazottat foglalkoztató cég ügyeit várhatóan a végelszámolásra kiszemelt Budapest Holding Első Hazai Vagyonkezelő Rt. zárja le .	végelszámolásra	22	Sub
A felügyelet már augusztus 18-a óta vizsgálódik a London Brókernél , amelynek megromlott a likviditási helyzete .	18-a	4	Nom
Az építmény heves nemzetközi tiltakozást váltott ki az emberi jogvédő csoportok és az Európai Unió részéről is .	tiltakozást	4	Acc
Ázsiában ezzel szemben mind több sikerrel veszik fel az AIDS-szel szembeni küzdelmet .	sikerrel	5	Ins
A szervezők jövőre a multinacionális vállalatok mellett kis cégeket , tervezőirodákat is meghívnak , és olyan cégeket is bemutatnak , amelyeknek jelenleg nincsenek konkrét állásajánlataik .	állásajánlataik	24	Nom
A horvát alkotmányban csak a tartós akadályoztatás fogalmát rögzítették , amely az államfő helyettesítésének esetére kötelezően előírta új elnökválasztás kiírását is .	esetére	14	Sub
— Az úton járni kell és nem megérkezni — de ez a veszély nem is fenyeget .	úton	2	Sup
Erre azonban a szaktárca vezetője szerint nincs szükség , bár a miniszter felkérte a fuvarozókat , lehetőleg name hagyják el a telephelyeiket .	fuvarozókat	14	Acc
Egyes vélemények szerint aggasztó , hogy a reálgazdaságtól egyre inkább elválik a tőkepiacok mozgását jelentő virtuális gazdaság .	tőkepiacok	12	Nom
Az Orahovacban rekedt szerbek viszont másként gondolják , s azt állítják , hogy az albánok még arra sem hajlandóak , hogy elégséges vizet és élelmet juttassanak a szerb negyedbe .	albánok	14	Nom
Ez a szerep nem egy embert , hanem egy tucatot kívánt .	tucatot	9	Acc
Az Árgus Kiadó a szobor újraöntésével egyidejűleg albumot jelentet meg a szobrász születésének 120. és halálának 40. évfordulója alkalmából .	szobrász	11	Nom
Ha oroszt tanítana , nyilván azt mondaná tanítványainak hogy Tatyjána levelét voltaképpen Anyegin írta , netán Lenszkijnek .	oroszt	1	Acc
A mintegy 860 ezer lakosú városban nem közlekedik 164 trolibusz és 110 villamos , s megbénult a forgalom több vasútvonalon is .	villamos	12	Nom
Napok óta hóvihar tombol egész Európában .	hóvihar	2	Nom
A rosszfiúk jó része szláv akcentussal töri az angolt , de ez , valljuk be , csak arra a nyomorúságra utal , amelyben az utóbbi évek szegény akciófilm-forgatókönyvírói kénytelenek kiizzadni egy valamirevaló főgonoszt a kémhistóriájukhoz .	nyomorúságra	19	Sub
A digitalizált látvánnyá felturbózott kalandok sorjázásában tán kevesebb is rá az idő , elég munkájába kerülhet a stábnak már az is , hogy az intellektus fölénye azért name vesszen ki hősünkből az elképesztő csodaketyerék mellett .	sorjázásában	5	Ine
A muzsikus-zeneszerző több mint negyedszázaddal ezelőtt végzett a Liszt Ferenc Zeneművészeti Főiskolán , s 1979-ben alapítója volt a 180-as csoportnak .	negyedszázaddal	4	Ins
Boldoggá tett és tesz , hogy zeneszerzőzseniket szólaltathatok meg , s ezáltal még közelebb kerülök művészetükhöz .	zeneszerzőzseniket	6	Acc
Hiszen már szeptemberben , sőt a NATO-bombázások idején tudni lehetett : a szétlőtt finomítók egyhamar nem fognak teljes kapacitással működni , a tél viszont legalább olyan pontosan megérkezik , mint az újvidéki olajtartályokra a lézerirányítású bomba .	olajtartályokra	32	Sub
A kerítések mögött német juhászkutyák és kuvaszok hengergetik magukat a hóban .	kerítések	1	Nom
A terepjáró-gépkocsik hólánccal is csak vergődnek .	hólánccal	2	Ins
A testület arról is határozott , hogy 3,6 millió koronáért ( mintegy 100 ezer dollárért ) megvásárolja annak a három családnak a házát , amelyik a legtöbbet panaszkodott a cigány szomszédok túl zajos életmódjára .	életmódjára	33	Sub
" Elképzelhető , hogy a Groznijtól 20 kilométerrel délnyugatra fekvő város — az egyik legnagyobb csecsen település — lesz az első olyan hely , ahol egyesült erővel harcolnak az oroszok ellen " — mondta .	kilométerrel	7	Ins
Pontosan azóta , amióta egy vezetői döntés nyomán eltüntették a hófogó rácsokat az út két oldaláról .	rácsokat	11	Acc
A 6-os úton keletkezett torlódás miatt bizonytalan időre lezárták a dunaföldvári hidat .	időre	7	Sub
Nem értik azt sem a szociáldemokraták , miért zárkóznak el mind a mai napig a vizsgálatban illetékes cseh hatóságok attól , hogy a zsolnai székhelyű Bírósági Műszaki Szakértői Intézet újra lejátssza a balesetet a baleset színhelyén .	színhelyén	35	Sup
— Ma este az Operaházban jubileumi előadással köszöntik pályakezdésének fél évszázados évfordulóját .	előadással	6	Ins
Az RTS rendőrségi közleményre hivatkozó beszámolója szerint a támadás a kizárólag albánok lakta Lucane és Konculj között történt .	közleményre	3	Sub
A mostani reformok a nyolcvanas évek elején megkezdett gazdasági liberalizáció folytatását jelentik .	folytatását	10	Acc
II. János Pál pápa már júniusi , majd szeptemberi levelében is bírálta a német püspökségek részvételét a terhes nőknek szervezett állami tanácsadásban , azt vetve a szemükre , hogy az igazolások kiállításával lehetővé teszik meg nem született életek elpusztítását .	elpusztítását	38	Acc
Tito azt szerette , ha a politikai és a katonai vezetők együtt élnek a brigádokkal , majd amikor kellőképpen feltöltődtek , mindent elmesélnek egymásnak .	brigádokkal	14	Ins
A legáltalánosabb kritika , hogy a kormánynak nemhogy katasztrófaelhárítási terve nem volt , de a tragédia bekövetkezte után sem állt a helyzet magaslatán .	kritika	2	Nom
Törökországot már-már a fizetésképtelenség fenyegette : a földrengés előtti becslések az idei költségvetési deficitet 20 milliárd dollárra taksálták , miközben ugyancsak dollárban számolva 40 milliárd a belső és 100 milliárd a külső adósság .	deficitet	13	Acc
A vezető leszállította az utasokat , azután a feldühödött tömeg összetörte a busz reflektorait , de jó néhány ablakát is .	busz	12	Nom
Az egész estés rajzfilm készítői egyszerű , kedves történetet mesélnek egy lényről , aki az állatok között tapasztalja meg a szeretet , a családi összetartozás erejét , s aki ember mivoltára ébredve is inkább a dzsungelt választja .	rajzfilm	3	Nom
Márpedig a növekvő igények miatt csak az energiaszektorban 2002-re mintegy 30 milliárd dollárnyi befektetésre lenne szüksége Törökországnak .	befektetésre	13	Sub
Érdemes mégis ebben a műfajban dolgozni ?	műfajban	4	Ine
A filmvásznakról is jól ismert Orosz Lujza szinte egész pályája Kolozsvárhoz kapcsolódik .	pályája	9	Nom
Napjainkban azonban a kortárs zenének nincs infrastruktúrája .	kortárs	3	Nom
Ennek az elsősorban Eörsi Mátyás SZDSZ-képviselőnek és meg nem nevezett társainak szóló üzenetnek nyilván szerepe van a látszólag önkéntes távozásban .	távozásban	19	Ine
A Globus című zágrábi hetilap orvosi körökre hivatkozva azt jelentette , hogy bármelyik pillanatban bekövetkezhet Tudjman halála .	pillanatban	13	Ine
Nagyon szeretem a darabot , s most is rendszeresen színpadra lépek benne .	színpadra	9	Sub
Vegyük példaként a legutóbbi szemantikai puccsot , mely a magánlevél jelentését forgatta fel keresztül-kasul .	puccsot	5	Acc
Pozsony soha nem ismerte el a cseh követelés jogosultságát .	követelés	7	Nom
Van Goghra gondolok elérzékenyülten , bár kicsit nyugtalanít , hogy az ő műveivel igazán mások kerestek .	műveivel	12	Ins
Johann Strauss műve pedig azért jutott eszembe , mert csodálatos muzsika , ami a dalszínházban mindig is a legnagyobb énekesek előadásában hangzott fel .	előadásában	20	Ine
Ennek érezhető következménye például , hogy az elméleti kutatások eredményeit sokkal hamarabb hasznosítják a gyakorlati életben , mint korábban .	eredményeit	9	Acc
Az új törvényben az alkotmányban foglaltaknak megfelelően kimondták , hogy a köztársasági elnököt csak a parlament elnöke helyettesítheti ideiglenesen .	alkotmányban	4	Ine
A szerencsétlenül járt emberek számának növekedésével ellentétben az anyagi károkkal kapcsolatos első — 20-40 milliárd dolláros — becslések viszont túlzottaknak bizonyultak .	növekedésével	5	Ins
Mert kétségtelen tény , hogy minél szélesebb körben terítik a terheket , annál könnyebb összeszedni a hiányzó pénzt — de annál nagyobb az érintett választók száma is .	tény	2	Nom
A 485,7 milliárd márkás német költségvetésből 30 milliárd megspórolására hivatott tervből ( HVG , 1999. július 10. ) immár hivatalos kormány-előterjesztéssé nemesedett intézkedéssorozat már a párton , sőt annak parlamenti frakcióján belül sem talált egyértelmű támogatásra .	megspórolására	8	Sub
Mert hősünket egyszer csak kiemelték .	hősünket	1	Acc
Azt is rebesgették az új gépkocsivezetőről , hogy a rendszerváltás után részt vett volna egyes állambiztonsági ügynöknévsorok megsemmisítésében .	rendszerváltás	9	Nom
A tervek szerint 10-15 százalékos , egyfajta nemzeti szolidaritási adóval terhelnék a személyi és a vállalati jövedelmeket , de szó van az ingatlanadó növeléséről , a mobiltelefonok és az autók egyszeri megadóztatásáról is .	jövedelmeket	16	Acc
Veszprém megyében a 8-as úton órákon állt a forgalom Várpalota és a péti elágazás között két elakadt kamion miatt .	órákon	5	Sup
Oregon állam egyik havas , csúszós autópályáján több mint 80 jármű — köztük diákokat szállító négy busz — szaladt egymásba .	diákokat	13	Acc
Az isztambuli értéktőzsdén ( ISE ) jegyzett 279 vállalat zöme a Márvány-tenger földrengés által sújtott keleti partvidékén és környékén — Törökország ipari szívében — vert tanyát , de többségük a börzéhez eljuttatott jelentésében nem tesz említést jelentősebb károkról .	említést	35	Acc
Ez utóbbit növelhetik a költségek csökkentésével , a korszerűséggel , valamint a megbízhatósággal ; nem véletlen napjainkban a márkanév jelentőségének növekedése .	korszerűséggel	8	Ins
A nyomozást azt követően rendelték el , hogy a közelmúltban egy holttestet leltek a tokiói repülőtér közelében fekvő egyik szállodában .	közelében	16	Ine
— Aki valami miatt személyesen nem lehet jelen ezen az esten , az is meghallgathatja majd ennek a koncertanyagát , hiszen ezekből a szerzeményekből lemezfelvétel is készül .	esten	10	Sup
Ennek a " hatása " is meg van írva a darabban , hiszen egyre inkább hamissá válnak az egyes táncok .	darabban	10	Ine
Aki egyszer azt mondta : őrület , hogy két szomszéd nép között a háború legyen az egyetlen megfelelő érintkezési forma .	forma	19	Nom
Pedig egy háborúban — bizonygatta a marsall — minden megesik , lám , őt is el akarják tenni láb alól ; a németek nyolcszáz légideszantost küldtek ellene .	háborúban	2	Ine
Minden napra esik egy szemantikai puccs .	napra	1	Sub
Tényleg hihetetlen , de Edgar Rice Burroughs híres regényhőse eddig már vagy ötvenszer kelt életre a mozivásznon , de rajzfilmen most először elevenednek meg kalandjai a Walt Disney Stúdió produkciójában .	produkciójában	29	Ine
A Nyugattól minden adandó alkalommal a Jugoszlávia elleni szankciók eltörlését kérő szerb ellenzéki vezetők , ha a gazdasági zárlat feloldását nem is , azt legalább elérték , hogy 350 tonna fűtőolajhoz jutnak a polgárok .	eltörlését	9	Acc
Az együttes 1990-es feloszlása óta főleg zeneszerzői tevékenységet folytat : komponált balettzenét , két kamaraoperát , nagyzenekari és kamaraművet , valamint több tucatnyi filmnek , színházi előadásnak is ő a zeneszerzője .	balettzenét	11	Acc
Új népszokás született , aki unatkozik , kimegy a ház elé , és elhányja a havat .	havat	15	Acc
Ennek érdekében egyensúlyban kell tartani a növekedés , az egyensúly , az infláció , valamint a foglalkoztatás " bűvös négyzetét " .	egyensúlyban	2	Ine
Az intézkedést most is az orosz válság miatt megingott likviditású cégek hitelképtelensége indokolja , ami az alapanyag-termelők pozícióit is veszélyezteti .	alapanyag-termelők	16	Nom
A levél írója figyelemre méltóan asszimilálódott a fideszes newspeak szabályaihoz .	figyelemre	3	Sub
A törökországi földrengés áldozatainak száma hétfőn hivatalos közlések szerint több mint 14 ezer , de még mindig nem tudni pontosan , hogy az összedőlt házak hány embert temettek el élve .	földrengés	2	Nom
Németországban Baden-Württemberg tartományban és Bajorországban a főutakon és az autópályán egyaránt 25-30 kilométer hosszan torlódtak fel az személygépkocsik és az autóbuszok .	főutakon	6	Sup
A közbeszéd szavai az évek során egyre csak torzultak , egyre értelmetlenebbé váltak , az értelmes közlés útján álló torlaszokat képeztek .	torlaszokat	19	Acc
A püspökök november közepén a Vatikánban tett " ad limina " látogatásuk alatt levelet adtak át az egyházfőnek , amelyben felsorolták megfontolásaikat és érveiket a tanácsadási gyakorlat ( benne az igazolások ) fenntartása mellett .	közepén	3	Sup
Goebbelsi módszereket tulajdonít a díjazott újságíróknak , miközben ő maga az , aki Goebbelset követi , jóllehet , a mester jóval tehetségesebben alkalmazta a nevéről elnevezett módszert .	mester	19	Nom
Ettől függetlenül az AIDS " epicentruma " továbbra is Afrika , s elsősorban annak Szaharától délre eső része , ahol a vírussal fertőzöttek 55 százaléka nő .	vírussal	21	Ins
Dubceknak az volt az álláspontja , hogy a közös állam szétválasztása egyes cseh és szlovák politikusok egyéni ambícióit szolgálhatja ugyan , de semmiképpen nem a két nép érdekeit .	érdekeit	27	Acc
Ezért siettették az ítélet meghozatalával az ügy lezárását , és arra is számíthattak : az önálló Szlovákia megteremtésének láza el is tereli a figyelmet a gyanús körülményekről .	figyelmet	23	Acc
Az alkotmányerejű törvénnyel lehetőség nyílik arra , hogy name váltsák le tisztségéből Franjo Tudjman köztársasági elnököt , akit 24. napja súlyos állapotban kórházban ápolnak .	törvénnyel	2	Ins
Ezért is fontos , hogy a viszony a korrektségen , a kiszámíthatóságon , egymás érdekeinek kölcsönös tiszteletben tartásán alapuljon .	korrektségen	8	Sup
Megszervezték ugyanis az Első Magyarországi Judaika Árverést , amelynek keretében értékes kulturális-történeti anyag — könyvek , kéziratok , kegytárgyak és festmények — kerül kalapács alá .	anyag	12	Nom
Az elzárt falvak hamarosan ellátási problémákkal nézhetnek szembe , így előkészítettek matracot , takarókat a számukra .	problémákkal	5	Ins
Kelebiától Budapestig százméterenként magyar és jugoszláv zászló lobogott a sínek mentén , és katonák tisztelegtek a különvonatnak .	zászló	6	Nom
Egy év után Simicska Lajos feladta : az adóhivatal elnöke családi halálesetekre és az ellene irányuló folyamatos támadásokra hivatkozva kedden — miután találkozott Orbán Viktor miniszterelnökkel — lemondott .	miniszterelnökkel	25	Ins
És elvitték a főhadiszállásra .	főhadiszállásra	3	Sub
Állítólag mindhárom személy szerepel a Mitrohin-aktákban található listán .	Mitrohin-aktákban	5	Ine
A tízezer példányban megjelenő album megszületéséhez mindkét fővárosban több rendezvény is kapcsolódik .	példányban	2	Ine
( Az is lehet , hogy jobban , mint a Kreml urát , amin fél évszázad múltán igazán nincs mit csodálkoznunk .	urát	11	Acc
Kelebiától Budapestig százméterenként magyar és jugoszláv zászló lobogott a sínek mentén , és katonák tisztelegtek a különvonatnak .	sínek	9	Nom
Meglepett , amikor ezekre a szerepekre felkértek , hiszen voltam alvilági főnök és őrült SS-tiszt , játszhattam a Balekok és banditákban , valamint a Hány az óra , Vekker úr ? című produkciókban .	produkciókban	32	Ine
A szobrot 1925-ben I. világháborús emlékműként a Budapesti Műszaki Egyetem udvarán állították fel , s az 1950-es években döntötték le .	udvarán	10	Sup
Emberfeletti feladat volt , hiszen minden hangjegyre meg volt a kötelező mozdulat .	hangjegyre	6	Sub
A 485,7 milliárd márkás német költségvetésből 30 milliárd megspórolására hivatott tervből ( HVG , 1999. július 10. ) immár hivatalos kormány-előterjesztéssé nemesedett intézkedéssorozat már a párton , sőt annak parlamenti frakcióján belül sem talált egyértelmű támogatásra .	támogatásra	35	Sub
Régen azt mondták , van a látható és van a láthatatlan világ , és a látható a láthatatlannak a megmutatkozása .	megmutatkozása	19	Nom
Nagyon szeretem a darabot , s most is rendszeresen színpadra lépek benne .	darabot	3	Acc
De talán a legnagyobb bók az volt az életemben , amit Gábor Miklós mondott nekem : " Ha téged nézlek a színpadon , nem veszem észre , hogy énekelsz . "	színpadon	21	Sup
Az úttorlaszokat építő és folyamatosan tüntető albánok azzal indokolják viselkedésüket , hogy az oroszok elfogultak az albánokkal szemben , s a koszovói albánok elleni szerb támadásokban több száz orosz zsoldos is részt vett .	albánokkal	16	Ins
Járni próbálok az úton , majd kiderül , merre visz .	úton	3	Sup
Nem illek bele abba a közegbe , ahol nem az a fontos , hogy mit csinál valaki és annak milyen a minősége , hanem az , hogy mennyire tudja megtölteni a kiállítótermeket .	kiállítótermeket	31	Acc
A Tupras jövő márciusra tervezett eladásából egymilliárd dollárnyi bevételt remélt a kabinet , s bár az izmiti finomítóban négy hónap múlva teljes kapacitással folyhat a termelés , a tűzkárok helyreállítása még akár egy évet is igénybe vehet .	finomítóban	17	Ine
A hóakadályok , hófúvások országszerte számos települést zártak el a külvilágtól .	települést	6	Acc
A legutóbbi munkám Kamondi Zoltán Az alkimista és a szűz című filmjének kísérőzenéje volt , s most éppen Gödrös Frigyes Glamour című alkotásához írok zenét ; a filmet a jövő februári filmszemlén mutatják be .	filmszemlén	31	Sup
Márpedig az NSZK-ban szinte mindig vannak valahol vagy helyhatósági , vagy tartományi választások — ezen az őszön például a Saar-vidéken és Brandenburgban — , s hosszabb távon egyetlen párt sem veszhet össze a választóival .	távon	26	Sup
Aki nemcsak az operaszínpadon remekel , hanem kiváló dalénekes és oratóriumszólista is s aki gyakorta tűz műsorára új műveket .	műveket	18	Acc
A földrengés ellenére az ankarai kormány a múlt héten megerősítette elkötelezettségét a deficitet enyhítő és az inflációt mérséklő stabilizációs program , illetve a privatizációval egybekötött szerkezetátalakítás mellett .	privatizációval	23	Ins
Egy miniatűr rabbi-szobrocska pedig az 1880-as évek körül készülhetett porcelánból , tulajdonképpen sótartó , de a megformálása humorral telített , a zsidó polgárság sajátos öniróniáját fejezi ki .	öniróniáját	24	Acc
Ennek a " hatása " is meg van írva a darabban , hiszen egyre inkább hamissá válnak az egyes táncok .	hatása	3	Nom
Varsó meredekebb részein és a hidakon csigatempóban haladt a gépkocsiáradat .	hidakon	5	Sup
A földrengés utáni órákban , napokban az elvárás talán alaptalanul is nagy volt az állammal szemben , viszont éppen ezért a csalódás is hatalmas .	órákban	3	Ine
Az export csökkenését és a turizmus visszaesését részben kárpótolhatja a külföldön — például Németországban — dolgozó törökök hazautalásainak minden bizonnyal növekvő összege és az újjáépítés által támasztott keresletre épülő fellendülés .	keresletre	27	Sub
Bernard Kouchner , az átmeneti ENSZ-kormányzat francia vezetője ugyan elvetette a Koszovó kantonizálását célzó javaslatot , ám azt is hangsúlyozta , hogy a szerbek biztonságának szavatolása érdekében fontolóra kellene venni egyes szerb közösségek ideiglenes átköltöztetését .	szerbek	23	Nom
A fővároshoz közeli kisvárosokban , községekben élőknek azonban alighanem újdonság , hogy ezúttal vagy fél napon át ki sem mozdulhattak otthonukból .	kisvárosokban	3	Ine
Olyan énekes , aki tökéletes átéléssel , szenvedéllyel , humorral alakítja lírai , drámai és buffoszerepeit .	átéléssel	5	Ins
Amíg hatalmi rivalizálásukat nem szüntetik meg , a demokráciára fordítható energia csak a fele lesz annak , amire amúgy képesek lennének .	rivalizálásukat	2	Acc
A vezetékre rakódott vizes hó miatt a Dnyeper melléki vasútvonalakon villanymozdony helyett gőzmozdonyok vontatták a személyszállító szerelvényeket .	vezetékre	1	Sub
A pusztító törökországi földrengés — amely az újabb adatok szerint mintegy 10 milliárd dollárnyi anyagi kárt okozott — nem akadályozta meg az ankarai kormányt abban , hogy töretlenül folytassa a tragédia előtt megkezdett gazdasági reformokat .	földrengés	3	Nom
Így csak kezelte a képviselő urakat , ha túlságosan belebonyolódtak a politikába .	urakat	5	Acc
Mielőtt az irdatlan hágókat , szakadékokat szép libasorban elhagyták volna , megjelentek a partizánok .	libasorban	7	Ine
Tudják , hogy az imént letakarított útszakaszra percek múlva vissza kell térniük .	útszakaszra	6	Sub
A hivatalos verzió szerint a nyilatkozat csak következménye volt az APEH-elnök támadások miatti idegállapotának .	APEH-elnök	10	Nom
Kouchnerhez hasonlóan a tanács többi tagja sem tudja még , miképpen lehetne szavatolni a szerb kisebbség biztonságát , s így a kérdés valószínűleg még többször napirendre kerül a testület ülésein .	biztonságát	16	Acc
A Tupras jövő márciusra tervezett eladásából egymilliárd dollárnyi bevételt remélt a kabinet , s bár az izmiti finomítóban négy hónap múlva teljes kapacitással folyhat a termelés , a tűzkárok helyreállítása még akár egy évet is igénybe vehet .	márciusra	3	Sub
Ha a szemlélő túlteszi magát az egy éve tartó és várhatóan tovább durvuló főváros-kormány vitán , akkor is látszik , hogy a nagyobb beruházások még közös finanszírozásban is túl nagy falatot jelentenének .	falatot	30	Acc
— A szobor hálós szerkezetű , a háló adja ki a jaguár formáját , ami tehát belül üres .	formáját	12	Acc
Egy miniatűr rabbi-szobrocska pedig az 1880-as évek körül készülhetett porcelánból , tulajdonképpen sótartó , de a megformálása humorral telített , a zsidó polgárság sajátos öniróniáját fejezi ki .	humorral	17	Ins
Az első évben , 1991-ben mindössze 31 , tavaly már több mint száz vállalat jelent meg a rendezvényen .	rendezvényen	17	Sup
Van viszont üldözés sítalpakon és sárkányrepülőn , motorcsónakon és olajvezetékben , és még egy atom-tengeralattjáró belseje is fontos szerepet kap , de ott már Bond az idővel is harcban áll , hogy megmenthesse az emberiséget .	harcban	28	Ine
A volt cseh és a volt szlovák miniszterelnök éveken át nem tudott megállapodni a vagyonrendezés nyitott kérdésében .	éveken	8	Sup
Kísértetek szabadultak el a szabaddá vált nyilvánosságban , a szavak gyilkos , ordas , gonosz indulatok árján úszva szorongást , félelmet , az egyszer volt újra megtörténhetésének vélelmét keltették fel .	félelmet	20	Acc
Méteres hótorlaszokon vágták át magukat a Pest Megyei Közterület-fenntartó Vállalat hómarógépei tegnap hajnalban ( meg délelőtt és délután ) a Pilisvörösvárt Pilisszántóval összekötő mellékútvonalon .	hótorlaszokon	1	Sup
Éppen ezért óriási a jelentősége a török tb szanálásának , még akkor is , ha szakértők szerint két évig még egyáltalán nem érezteti hatását , és az átmeneti periódus 10 év .	periódus	28	Nom
Ami persze értelmezhető egyszerű szavazatszerző kampányfogásként — de jól mutatja a szociáldemokraták hosszabb távú dilemmáit és megosztottságát is .	megosztottságát	16	Acc
Rohamosan veszít népszerűségéből a nagyobbik német kormánypárt , az SPD , s vele együtt Gerhard Schröder kancellár , elsősorban a 30 milliárd márkás takarékossági csomagterv s a párton belül ennek kapcsán felszínre került ellentétek miatt .	felszínre	31	Sub
