Teraz Jasienica będzie musiała usunąć część wodociągu , który bezprawnie postawiła na prywatnej ziemi Pałuchy .	Pałuchy	14	Gen
Podtopiony dom , to była łódź z ludźmi zakotwiczona na środku Sanu .	Sanu	11	Gen
Może warto odkryć Amerykę .	Amerykę	3	Acc
Jagienka jest młoda i nowoczesna , idzie do Iwony , by zrobić sobie pasemka .	Iwony	8	Gen
W lesie czekał na niego już Król z Rejem .	Rejem	8	Ins
Ale jak zinterpretować pojawienie się kolędników w finałowej scenie , kiedy rozjadą się już Konrad i ksiądz Piotr ?	Konrad	14	Nom
Biedny Wojtek wysługuje się .	Wojtek	1	Nom
Kiwek zawsze tak zaczynał rozmowę .	Kiwek	0	Nom
Książę Andrzej Poniatowski , porucznik armii francuskiej , odwiedził Polskę w roku 1919 jako członek francuskiej misji wojskowej .	Poniatowski	2	Nom
Hiszpański wicekról Argentyny kazał wysłać znalezisko do Madrytu .	Argentyny	2	Gen
- Internet wzbudza wielkie nadzieje wśród inwestorów .	Internet	1	Nom
Na początku lat 80 . fryzjerka z najdłuższym stażem była na zjeździe branży w Warszawie .	Warszawie	14	Loc
Czy on nie był Mazurem ?	Mazurem	4	Ins
Wychowankowie Domu Dziecka na Oruni otrzymali od policjantów prezenty mikołajkowe .	Oruni	4	Loc
Sznur tirów przecina niemal cały Wrocław , ma dziesięć kilometrów długości , stoi w nim kilkaset ciężarowek .	Wrocław	5	Acc
Nakazuje je Konstytucja RP oraz przewidywany harmonogram reform ustrojowych .	RP	3	Gen
Mordowanie Pigmejów nadal trwa .	Pigmejów	1	Gen
Palce Szczyrbka ściskały coraz mocniej .	Szczyrbka	1	Gen
Papier płonie także w Pillow Book .	Pillow	4	Loc
Wyobrażał sobie minę Każe-duba czytającego jego raport .	Każe-duba	3	Gen
Uważamy , że goniec przyniósł by je szybciej pieszo z Gdańska .	Gdańska	10	Gen
Na ekranie TV , na zatrzymanej stop-klatce Jurka Kilera idą napisy końcowe programu .	TV	2	Gen
Nie widzieli się miesiąc i musiał ponownie oswoić Gosię .	Gosię	8	Acc
Padają Zakłady Cegielskiego w Poznaniu , a dialog przenosi się na ulice .	Cegielskiego	2	Gen
W okresie międzywojennym pałac w Kadynach nie był zamieszkały .	Kadynach	5	Loc
Na Podkarpaciu oficjalnie kampania żniwna zacznie się w przyszłym tygodniu .	Podkarpaciu	1	Loc
- Wyobraża Pan sobie koalicję części UW , UP i SLD przy okazji wyborów parlamentarnych za cztery lata ?	UP	8	Gen
Zatrzymał doktorwagena przed samym wejściem , przywiązał lejce do barierki przy krawężniku , pogłaskał konia po chrapach i wszedł do królestwa Polizeiwachtmeistra Starkego .	Starkego	22	Gen
W ubiegłym roku w czerwcu okna w komunalnym mieszkaniu Salwockich wybijano trzy razy .	Salwockich	9	Gen
Wuja nie uczestniczył w rozmowie przyglądając się im obu bez sympatii .	Wuja	0	Nom
Nie uważam , żeby na przykład Marksa szczególnie kompromitował romans ze służącą .	Marksa	6	Acc
Jesteś Brytyjką ?	Brytyjką	1	Ins
Darmosz wymknął się za nimi .	Darmosz	0	Nom
- Muzyka nagrywana jest w Stanach . . .	Stanach	5	Loc
Nie widział przy nim Szczęsnego .	Szczęsnego	4	Gen
W Miedźnej wiedzą , że nie zdarzy się cud . . .	Miedźnej	1	Loc
Kiwek zawsze tak zaczynał rozmowę .	Kiwek	0	Nom
Uczył się w Liceum Technik Plastycznych w Zakopanem prowadzonym przez Antoniego Kenara .	Antoniego	10	Acc
Szczegółowo analizowane są zapisy z kamer monitorujących , które znajdują się na terenie Kwidzyna .	Kwidzyna	13	Gen
W gruncie rzeczy nie obchodziła go odpowiedź Heleny .	Heleny	7	Gen
Lepiej nadłożyć kilometrów , omijając Wrocław , a mimo to szybciej dojechać do celu .	Wrocław	5	Acc
Zmniejszył szanse elekcyjne Marka Borowskiego .	Marka	3	Gen
W ten sposób poznała m Wojtka Ligotę .	Wojtka	5	Acc
Przedostatni figuruje Artur Balazs , poseł i minister rolnictwa , a zamyka ją Stefan Oleszczuk z UPR-u , starosta kamieński .	Balazs	3	Nom
Kowalik i Stryjek zerwali się , drzwi do łazienki na szczęście były otwarte .	Stryjek	2	Nom
Przez dwa ostatnie tygodnie policjanci zaczęli podejrzliwie obserwować Staszka i Dawida .	Staszka	8	Acc
- Maniek Zieniuk jest dalej komendantem w Nowym Mieście ?	Zieniuk	2	Nom
Chodzi prawdopodobnie o Burkina Faso .	Burkina	3	Acc
Słońce Grecji zgasło i nad tragedią Sofoklesa zapadły egipskie ciemności .	Sofoklesa	6	Gen
Syna Włodzimierza Olewnika porwano jesienią 2001 r .	Olewnika	2	Gen
Najlepiej to widać w zlewni Przemszy na Górnym Śląsku .	Śląsku	8	Loc
Obiecankami zakończyło się sylwestrowe połączenie z Wrocławiem .	Wrocławiem	6	Ins
- A więc Leszek Balcerowicz odniósł już zwycięstwo ?	Leszek	3	Nom
Do pierwsze kolizji doszło przy ulicy Kolejowej w Szydłowcu .	Szydłowcu	8	Loc
Wybrał dobre nagrania Bernsteina i włączał obydwa głośniki adapteru .	Bernsteina	3	Gen
Z czasem przeprowadzą się na Plewiska .	Plewiska	5	Acc
Tekst wyszedł spod srebrzystych parkerów Colina Rowe'a i Roberta Slutzky'ego .	Rowe'a	6	Gen
ZSRR wypowiada wojnę Japonii .	ZSRR	0	Nom
Z Lipusza trasa powiedzie ich dalej do Sulęczyna , Sierakowic , Mirachowa i Otomina .	Otomina	13	Gen
Nazajutrz Tomek osiodłał pony i razem z Dingiem wyruszył do parowu .	Dingiem	7	Ins
Po zetknięciu z ziemią maszyna wybuchła , a siła eksplozji wyrzuciła dwóch słowackich mechaników i Marka Panasia .	Marka	15	Acc
Służba Ruchu MO interweniowała w 9 kolizjach .	MO	2	Gen
Oczy Nony zalśniły .	Nony	1	Gen
Kiedy w Banja Luce skończył się ostatni , decydujący o medalu mecz , Halina leżała na parkiecie , a na niej kłębiła się góra ciał .	Banja	2	Loc
Jewhen drzemał na krześle przy drzwiach .	Jewhen	0	Nom
Na czwarte miejsce finiszowała Diana Star .	Diana	4	Nom
Wspomina przecież , że był na Sybirze razem z Antonim Schmidtem .	Sybirze	6	Loc
Dochodzenie w sprawie wypadku wszczęła Prokuratura Rejonowa w Szczytnie .	Szczytnie	8	Loc
Na MI-2 robił em .	MI-2	1	Acc
Na terenie przyległym do Kolonii Wierzbicy znajdują się dwie garbarnie .	Kolonii	4	Gen
Siadał em w kącie na kanapce obok Lili i słuchał em , jak Borys śpiewa .	Borys	13	Nom
Chodzi o 35-letnią Małgorzatę T . , mieszkankę jednej z pobliskich gmin .	Małgorzatę	3	Acc
Trupy wrzucono do Gopła .	Gopła	3	Gen
A Bóg jest Prawdomówny .	Bóg	1	Nom
Ale dla mnie nie ma różnicy między Włochem , Polakiem czy Węgrem .	Włochem	7	Ins
Zeznania urzędniczki były elementem republikańskiej kampanii , która miała zmusić prezydenta Billa Clintona do odwołania wizyty w Chinach .	Billa	11	Acc
Stanisława Mackiewicza , Cata , trudno scharakteryzować .	Cata	3	Acc
Swoje problemy ma też Hanna Gronkiewicz - Waltz .	Gronkiewicz	5	Nom
Zobaczył Dunaja .	Dunaja	1	Acc
Grabowski i Samczyc kończyli już obiad .	Grabowski	0	Nom
Nie będzie postulowanego przez PiS samorozwiązania Sejmu , bo nie godzi się na nie Platforma Obywatelska .	PiS	4	Acc
Z Lipusza trasa powiedzie ich dalej do Sulęczyna , Sierakowic , Mirachowa i Otomina .	Lipusza	1	Gen
To bilans kilku ostatnich miesięcy działalności Szpitala Wojewódzkiego w Olsztynie .	Olsztynie	9	Loc
Rabi Eleazar ben Cwi nie szemrze .	Cwi	3	Nom
Stachurski i Janusz Olędzki zastąpili latem Janusza Lacha i Artura Mazurka .	Lacha	7	Acc
Także miasto Bielsko-Biała włączyło się w finansowanie dokumentacji .	Bielsko-Biała	2	Nom
We wtorek w Annopolu , gdzie Wisła przekroczyła stan alarmowy o 34 cm , ogłoszono alarm przeciwpowodziowy .	Annopolu	3	Loc
Razem z mętami w Bornem Sulinowie pojawiły się klechy .	Sulinowie	5	Loc
Gagosian nadal milczał , siedząc za biurkiem na swój sztywny sposób .	Gagosian	0	Nom
Reputację intelektualisty potwierdził , cytując obficie Witolda Gombrowicza i Stanisława Jerzego Leca .	Gombrowicza	7	Acc
I zrozumieli ludzie , że tu Bóg był , i zburzyli ten sądowy dom , aby w nim nikt już więcej po Panu Jezusie nie sądził , a przed jabłonnymi drzewami postawili krzyż i on do dziś tam stoi .	Panu	22	Loc
Oczywiście nie zabrakło w tym momencie również opiekunki stypendystów pani Karoliny Szybki .	Szybki	11	Gen
Zwiedzili także Warszawę .	Warszawę	2	Acc
Do najciekawszych należą parki w Wierzonce i Owińskach .	Owińskach	7	Loc
Druga patrząc wymownie na panią Zielińską zaśmiała się wesoło .	Zielińską	5	Acc
Jan stanie przed Bogiem i będzie musiał świadomie odpowiedzieć za całe życie , cokolwiek w tym poprzednim się wydarzyło .	Bogiem	3	Ins
Bawi się Pan w kolejnego kundelka UPR-u ?	UPR-u	6	Gen
Ale dla mnie nie ma różnicy między Włochem , Polakiem czy Węgrem .	Polakiem	9	Ins
Napisałaby więc z pewnością o Bali , co się stało w Kucie , tuż przy głównym deptaku .	Bali	5	Loc
W listopadzie 1946 r . powróciła do Olkusza , by nadal uczyć rysunków .	Olkusza	7	Gen
Większość skradziono w Berlinie , Hamburgu , Kilonii i Bremie .	Hamburgu	5	Loc
Na szczęście zjawia się radca Ambasady Polskiej w Moskwie .	Moskwie	8	Loc
Weronika wytężyła wzrok i ze zdumieniem poznała Krzysztofa .	Krzysztofa	7	Acc
Mruk jęknął .	Mruk	0	Nom
Cagliostro krzyknął z bólu .	Cagliostro	0	Nom
Szafir umilkł .	Szafir	0	Nom
Dzięki podświetleniu widać też nasz kościołek z Traktu Brzeskiego .	Traktu	7	Gen
Zresztą padało na północy i wschodzie , zaś susza dotknęła przede wszystkim Polskę południową .	Polskę	12	Acc
Udało się niestety uratować tylko Marię Fryc , zaś dwudziestotrzyletni jej mąż utonął .	Fryc	6	Acc
Z Bronkiem niedawno rozmawiał przez telefon .	Bronkiem	1	Ins
Udaliśmy się do Kroczewa .	Kroczewa	3	Gen
- Powinno być łatwiej , bo Husajna nie otaczają fanatycy .	Husajna	6	Gen
Pomodlę się za Polskę .	Polskę	3	Acc
Przedostatni figuruje Artur Balazs , poseł i minister rolnictwa , a zamyka ją Stefan Oleszczuk z UPR-u , starosta kamieński .	Stefan	13	Nom
Po Jugosławii podróżowali śmy z namiotem , szukając pól campingowych .	Jugosławii	1	Loc
Nawet Nagroda Nobla mu nie dorównuje !	Nobla	2	Gen
Powiedział em , że uczą , uśmiechnął em się do Rogera i wychylił em kieliszek .	Rogera	10	Gen
82 proc . respondentów CBOS uważa , że różnica zarobków w Polsce jest zbyt duża .	CBOS	4	Gen
W Chadaju odezwała się podlaska dusza .	Chadaju	1	Loc
Rebelianci z tak zwanej Wyzwoleńczej Armii Kosowa zajęli Belacewacz tydzień temu .	Kosowa	6	Gen
Uruchamiany system ma stać się zaczątkiem większego , obejmującego całą Wielkopolskę .	Wielkopolskę	10	Acc
Kim są osoby z syndromem DDA ?	DDA	5	Gen
A przecież prezydent Kaczyński odsłaniał kiedyś pomnik Ognia i wtedy prawie nikt nie był oburzony .	Ognia	7	Gen
W Kraspolu pracuje się po osiem godzin , na trzy zmiany .	Kraspolu	1	Loc
- Maciek akcentuje to słowo .	Maciek	1	Nom
Dzieci były zachwycone prezentami od Michała .	Michała	5	Gen
Agent Pawłow nieustannie wodził wzrokiem za kapitanem , pilnie nadstawiał ucha .	Pawłow	1	Nom
Sekretarz generalny KPZR Leonid Breżniew odwiedził Bułgarię , Jugosławię i Węgry .	Jugosławię	8	Acc
Poproszę pana senatora Józefa Kuczyńskiego .	Kuczyńskiego	4	Acc
Chodzi prawdopodobnie o Burkina Faso .	Faso	4	Acc
Nawiązano współpracę z kołami gospodyń wiejskich w Domatkowie , Kolbuszowej Górnej , Nowej Wsi , Weryni i Widełce .	Domatkowie	7	Loc
W bramie spotkał podporucznika Samczyca .	Samczyca	4	Acc
Głos zabrał towarzysz Korntopf od nauki .	Korntopf	3	Nom
Przystupa odstawiła szklankę po whisky i skuliła się w fotelu , pan Cox wyglądał , jakby się właśnie obudził .	Przystupa	0	Nom
Prawem opozycji nazwał szef Agencji Bezpieczeństwa Wewnętrznego Andrzej Barcikowski zapowiedź ewentualnego wniosku o odwołanie go z pełnionej funkcji .	Barcikowski	8	Nom
ŻYCIE przedstawiło w sądzie świadków , którzy widzieli Kwaśniewskiego w Cetniewie .	Kwaśniewskiego	8	Acc
Na piersiach dyndały im krzyże z Jezusem Chrystusem .	Chrystusem	7	Ins
Doświadczenie zawodowe zdobyła pracując w teatrze i telewizji w Polsce i na Ukrainie .	Ukrainie	12	Loc
Ostatnią decyzją Adamsa , podjętą przed opuszczeniem Białego Domu , było podpisanie nominacji dla Johna Marshalla na prezesa Sądu Najwyższego .	Marshalla	15	Gen
Rosjanie zajęli Baranowicze i biją się na przedmieściach Wilna .	Baranowicze	2	Acc
Książkę wydrukowano w Polsce na zlecenie paryskiej Edition Cercle d'Arts .	Edition	7	Gen
Izrael zagroził wczoraj , że wkroczy zbrojnie na tereny Autonomii , jeśli Arafat nie zapanuje nad terrorem .	Arafat	12	Nom
Niestety , Sąd Rejonowy w Kutnie nie jest w stanie takowego uzasadnienia wydać .	Kutnie	5	Loc
Stamtąd widać cały Sybir .	Sybir	3	Acc
Koncern nadal ma umowy licencyjne z producentami w Japonii , Włoszech , Afryce Południowej i na Filipinach .	Włoszech	10	Loc
Sprawę znam z relacji mojej Irenki .	Irenki	5	Gen
Jej wnuczka , dziesięcioletnia Marta , chodziła do klasy z zamordowanym Łukaszem .	Łukaszem	11	Ins
- Zostaw Izaaka .	Izaaka	2	Acc
Dziękujemy w imieniu Agnieszki Kulig .	Agnieszki	3	Gen
Sanki pomknęły po ubitym śniegu na Pohulankę .	Pohulankę	6	Acc
W Birkenau osadzono ich oddzielnie w podziemiach Bloku Śmierci .	Birkenau	1	Loc
Podporucznik Kowalik , nie mogąc znieść kuchenno - masarnianego obrządku i słodkawego zapachu krwi , ubrał się i wyszedł z domu .	Kowalik	1	Nom
Od 1998 roku funkcjonuje w FSB wydział bezpieczeństwa komputerowego i informacyjnego .	FSB	5	Loc
Polskich komunistów nie łączyły nigdy żadne specjalne więzy z przywódcami ludowych Chin .	Chin	11	Gen
Uczniowie klas młodszych sprzątali las w oddziale 184 pod kierunkiem stażysty , Przemysława Mazgaj .	Przemysława	12	Gen
Rano Odra nasyca niebieskawą mgłą ulice obu miast .	Odra	1	Nom
W środę ambasador USA w Pekinie przekazał ministrowi spraw zagranicznych Chin list z przeprosinami .	Chin	10	Gen
Ten biało - czarny kocur zdobył szturmem serca pracowników Downing Street , a z czasem jego sława rozprzestrzeniła się na cały kraj .	Street	10	Gen
Rzecznik Białego Domu odmówił jednak ich podania , informując tylko , że dowody zostaną przekazane inspektorom ONZ w Iraku .	ONZ	16	Gen
Kaczmarek teraz równie stanowczo zaprzecza , by Ungier go ostrzegał .	Ungier	7	Nom
Na Zalewie Szczecińskim z trudem przedzieramy się przez gęstą krę lodową .	Zalewie	1	Loc
Siedziba gminy to Olecko .	Olecko	3	Nom
Ostatni zawodnicy maratonu przybiegli na metę nawet kilka godzin po Afrykańczyku .	Afrykańczyku	10	Loc
W ZUS nie ukrywają , że lekarzom trudno udowodnić , iż nadużywają swych kompetencji .	ZUS	1	Loc
Była przy żonie Andrzeja , dopóki nie urodziło się dziecko .	Andrzeja	3	Gen
Biznesmena Roku wybierano na Pomorzu już po raz szósty .	Pomorzu	4	Loc
Równolegle z kilkoma innymi inwestycjami w Tucholi rozpoczęły się prace związane z budową nawierzchni asfaltowej na podbudowie z gruzobetonu na ulicy Mickiewicza .	Tucholi	6	Loc
Klub Przyjaciół Życia Ludzkiego działa w Nakle od 1996 roku .	Nakle	6	Loc
Twarz Gabrieli była szara .	Gabrieli	1	Gen
– w Mel Rozie była ś ?	Mel	2	Loc
Dowódca sił amerykańskich w Afganistanie generał Tommy Franks zapowiedział kolejne operacje lądowe .	Tommy	6	Nom
Zwodujcie Wałęsę .	Wałęsę	1	Acc
Wyprzedza Małysza o 1,6 punktu .	Małysza	1	Acc
Sąd Rejonowy w Olsztynie wczoraj postanowił przekazać ją Sądowi Okręgowemu .	Olsztynie	3	Loc
Parokrotnie Wajdowie osobiście kwestowali na ulicach Japonii .	Japonii	6	Gen
Taką obietnicę otrzymała grupa bydgoszczan , która uczestniczyła wczoraj w spotkaniu z Aleksandrem Kwaśniewskim .	Kwaśniewskim	13	Ins
Soso namyślał się .	Soso	0	Nom
A dał Kaliszowi Niderlandy .	Niderlandy	3	Acc
Podczas przesłuchania w komisji minister Zbigniew Siemiątkowski zdystansował się wobec pomysłu Cimoszewicza .	Cimoszewicza	11	Gen
Gdyby kierownictwo ZUS zdecydowało się na Mercedesa lub BMW , to koszt jednego samochodu przekroczyłby 200 tys . nowych złotych .	BMW	8	Acc
Nowoczesną motorówkę do patrolowania Wisły ukradziono policjantom z Torunia .	Wisły	4	Gen
Klepał Jazończyka po ramieniu , ciągle ze śmiechem , mimo że twarz tamtego wyrażała surową powagę .	Jazończyka	1	Acc
Suzanne pokręciła przecząco głową .	Suzanne	0	Nom
Adasia ogarnął niepokój .	Adasia	0	Acc
W święta głodowało już sześciu pracowników MZK , przedwczoraj dwóch z nich odmówiło przyjmowania płynów .	MZK	6	Gen
Spośród trzystu ochotników Polluks wybrał stu najlepiej znających się na morzu .	Polluks	3	Nom
- Józwa ma konika . . .	Józwa	1	Nom
i ta mała Asia się pochorowała .	Asia	3	Nom
W kościele mariackim w Radomiu o północy mszę święto odprawił biskup senior Edward Materski .	Materski	13	Nom
Dyrektor archiwum na Łubiance przekazał te materiały synowi Stanisława Głąbińskiego .	Głąbińskiego	9	Gen
W tym momencie adresat może pobrać MMS-a do swojego telefonu .	MMS-a	6	Acc
Pan Bóg wyjął Ewę z boku Adama i to jest zboczenie .	Ewę	3	Acc
Potem , gdy próbowali je sprzedać w Szanghaju , zostali zauważeni przez policję .	Szanghaju	7	Loc
Podobnie obchody wyglądać będą w Koszalinie .	Koszalinie	5	Loc
I przeczytaj coś o Simone de Beauvoir .	Simone	4	Loc
W Piszu bracia Laudańscy już czekają .	Piszu	1	Loc
Wykorzystując przerwę w popołudniowych grach , Agassi i Graf zrobili sobie małą sesję treningową .	Agassi	6	Nom
Dante raczył zajmować się przede wszystkim potępionymi .	Dante	0	Nom
Amerykanie patrząc zza Oceanu na Europę myślą niemal wyłącznie kategoriami strategicznymi i gospodarczymi .	Europę	5	Acc
Orfeusz zmierza pewnie ku światłu , pomyślnie wyprowadzając Eurydykę z krainy zmarłych .	Eurydykę	8	Acc
Przygryzając wargi z bezsilnej złości , Chmura wołał Adasia .	Adasia	8	Acc
- Jaki los czeka Czeczenię ?	Czeczenię	4	Acc
Służby ratownicze w Stalowej Woli toczyły dziś walkę z oleistą plamą na Sanie .	Sanie	12	Loc
Czy pan zna inżyniera Jarzęckiego ?	Jarzęckiego	4	Acc
Ten wiersz Dominika przykleiła sobie nad biurkiem , a Jadzia dziwiła się .	Jadzia	9	Nom
Jeszcze w poniedziałek prosił o pomoc wojskową sąsiednie republiki kaukaskie i Rosję .	Rosję	11	Acc
Basia nie dostała dziś nic na targu .	Basia	0	Nom
W Białce , u górali możecie się dowiedzieć na mój temat wiele .	Białce	1	Loc
Tata ukrywał się na Żoliborzu u Zosi , mojej przyszłej wspaniałej macochy , jako Pan Nikt .	Zosi	6	Gen
Jerzy Gruza wydaje się nieubłagany w swoim perfekcjonizmie .	Gruza	1	Nom
Do nich należeli niewątpliwie Mannerheim , Paasikivi i Tanner .	Tanner	8	Nom
Wraz z kadrą wyjadą Daria Kasperska , Paulina Rytwińska i Agnieszka Karcz .	Daria	4	Nom
Pod Wisłą buduje się wielki tunel ciepłowniczy .	Wisłą	1	Ins
Premier Józef Cyrankiewicz przyjął wicepremiera Rumunii George Radalescu .	Rumunii	5	Gen
Bardzo dobrze zaprezentował się Tomasz Robaczewski .	Robaczewski	5	Nom
Uniemożliwiła mu to bardzo ofensywna postawa Raftera .	Raftera	6	Gen
Nade mną stała Jędrusia .	Jędrusia	3	Nom
Wziął em Roszka pod pachę i poszli śmy do nas do domu .	Roszka	2	Acc
Był również profesorem uniwersytetów w Jenie i Berlinie .	Jenie	5	Loc
Kłopoty z tożsamością Macieja i Mateusza każą mi tutaj przywołać jeszcze jedną parę imion , a mianowicie Szczepana i Stefana .	Mateusza	5	Gen
- Czy chce otrzymać azyl w Danii ?	Danii	6	Loc
Marchewą wstrząsnęła taka sugestia .	Marchewą	0	Ins
A musi z ZSSR i z Polską .	ZSSR	3	Ins
Od dwóch lat w Woli Skolankowskiej goszczą niepełnosprawni artyści z Centrum Rehabilitacji w Grudziądzu .	Woli	4	Loc
W Radlinie trafiła do szpitala .	Radlinie	1	Loc
W czasie obławy policjantom z Pieniężna udało się zatrzymać dwóch kłusowników .	Pieniężna	5	Gen
W czasie pobytu krótko rozmawiał em z Lechem Bądkowskim .	Lechem	7	Ins
Powiedziała , że komórki zamówił u niej Bogusław Linda .	Bogusław	7	Nom
Trwa izraelska akcja zbrojna w Strefie Gazy .	Gazy	6	Gen
Prezydenci Polski , Ukrainy i Rumunii spotkali się na roboczych rozmowach w Bukareszcie .	Rumunii	5	Gen
Stali na chodniku przed odrapanym budynkiem w Erewanie , w którym mieścił się Komitet Karabachu .	Erewanie	7	Loc
Ostatnią decyzją Adamsa , podjętą przed opuszczeniem Białego Domu , było podpisanie nominacji dla Johna Marshalla na prezesa Sądu Najwyższego .	Adamsa	2	Gen
W niedzielę 7 czerwca o godz . 17 Odra podejmuje Inę , a Mieszko o tej samej godzinie u siebie gra z Dąbrovią .	Dąbrovią	22	Ins
Mani wciąż nie było i Beata pomyślała , że wyjechała już na wakacje .	Mani	0	Gen
Wzięli w niej udział przedstawiciele policji z Niemiec , Czech , Słowacji , Węgier , Ukrainy i Polski .	Czech	9	Gen
Nad bezpieczeństwem w Zachodniopomorskiem czuwało 2500 policjantów , w tym 500 z drogówki .	Zachodniopomorskiem	3	Loc
Sołtys Ligoty Stanisław Kuźnik składa serdeczne podziękowanie wszystkim sponsorom , którzy przyczynili się do zorganizowania festynu i dzięki którym dzieci z Ligoty będą mogły pojechać na wycieczkę .	Ligoty	1	Gen
Pana Sławomira zakwaterowano w pawilonie I .	Sławomira	1	Acc
– Co Pani jeszcze wie o rodzinie Wielgusa ?	Wielgusa	7	Gen
W progu stał Irek .	Irek	3	Nom
Prezes Bogdan Kościuczyk odesłał nas do dyrektor Anieli Kotowicz .	Kotowicz	8	Gen
W Wielkopolsce na nową maturę zdecydowało się 522 abiturientów .	Wielkopolsce	1	Loc
PiS idzie do wyborów pod własnym szyldem .	PiS	0	Nom
Pannę Wiosnę rozpiera młodzieńcza energia .	Wiosnę	1	Acc
Niech wejdzie lis Chmura w świetny stan , górników polskich stan .	Chmura	3	Nom
Próbował bronić swej dyktatury , Osi , paktu z Hitlerem .	Hitlerem	9	Ins
Pani Maria Figiel jest teściową Barbary .	Figiel	2	Nom
Stojący w drzwiach hotelu Wyroba natychmiast ruszył w jego kierunku .	Wyroba	4	Nom
Haberda patrzy na Gabrielę bez sympatii .	Gabrielę	3	Acc
Mogła by być nawet leżąca , bo Krysia lubi leżeć .	Krysia	7	Nom
- Do Krakowa jechać nie mogę , bo tajemnica wydała by się przedwcześnie .	Krakowa	2	Gen
Dogadał się z NATO i Bushem .	Bushem	5	Ins
- Co to jest brew Breżniewa ?	Breżniewa	5	Gen
W Polsce uruchomiła już dwie fabryki , w Grójcu oraz koło Wałbrzycha .	Grójcu	8	Loc
Nasze piłkarki w grupie zmierzą się z Niemcami , Szwecją i Szwajcarią .	Szwajcarią	11	Ins
Burmistrz , Zbigniew Grzesiak , wyjaśnił , że są trudności w porozumieniu się z Urzędem Rejonowym .	Zbigniew	2	Nom
Z Jackiem Kuroniem współpracowali śmy i nadal współpracujemy .	Jackiem	1	Ins
Niektóre sale pałacyku w Karolinie przeznaczono na małe muzeum .	Karolinie	4	Loc
Podobnie wypowiadali się przedstawiciele państw Zachodu i Trzeciego Świata .	Zachodu	5	Gen
W tym momencie adresat może pobrać MMS-a do swojego telefonu .	MMS-a	6	Acc
Dlatego też dojrzewanie w Chrystusie nie jest łatwe .	Chrystusie	4	Loc
W Charkowie 300 osób odkryło ostatnio karaimskie korzenie .	Charkowie	1	Loc
Wtedy Dudlik usłyszał samochody .	Dudlik	1	Nom
Na zakończonym wczoraj w Paryżu kongresie FPK przyjęto 1080 głosami przeciw 43 centrowy program szefa partii Roberta Hue .	FPK	6	Gen
Czy La Famille Richet istotnie została zaprezentowana w Edynburgu ?	Edynburgu	8	Loc
W kraju nad Wisłą dominującym gatunkiem jest Polakatolik .	Wisłą	3	Ins
- Może i ty by ś się uczył u Sołowjowa - Tamarina ?	Tamarina	11	Gen
Chodzi prawdopodobnie o Burkina Faso .	Faso	4	Acc
Które łóżko było Panka ?	Panka	3	Gen
W jednej chwili runęło życie Michała .	Michała	5	Gen
Można się oczywiście zastanawiać , co młodego Johnsona tak pchało do faszyzmu czy nazizmu .	Johnsona	7	Acc
Kontrolę w PAR zlecił jesienią ub.r . minister łączności Maciej Srebro .	Srebro	10	Nom
Radykalnie negując ład istniejący na ziemiach ukraińskich w Polsce i ZSRR , nacjonalizm odrzucał każdą próbę prowadzenia polityki w ramach realnego układu sił .	ZSRR	10	Loc
Najciekawiej zapowiada się w Moskwie , gdzie miejscowy Spartak podejmuje Ajax Amsterdam .	Spartak	8	Nom
Przez następne 200 lat Krzyżacy kolonizowali Prusy i budowali swoje państwo .	Prusy	6	Acc
W Tczewie w Radzie Miejskiej zasiada 23 radnych .	Tczewie	1	Loc
- Zawsze wierzyłem w Europę .	Europę	4	Acc
Rzecznik przyznała , ze ministerstwa generalnie krytykują założenia przygotowane przez ministra finansów Jarosława Bauca .	Bauca	13	Acc
Agencja poinformowała , że Masud zmarł w Afganistanie .	Afganistanie	7	Loc
Wspomina przecież , że był na Sybirze razem z Antonim Schmidtem .	Schmidtem	10	Ins
Elektrownie gazowe mają dać tyle prądu , ile daje elektrownia wodna w Asuanie .	Asuanie	12	Loc
W ubiegłym roku w czerwcu okna w komunalnym mieszkaniu Salwockich wybijano trzy razy .	Salwockich	9	Gen
Tak jak upiekło im się po Zatoce i Afganistanie .	Afganistanie	8	Loc
Nikt dziś na świecie nie wie , że Olgierd zna Małgorzatę .	Małgorzatę	10	Acc
Z Darkiem wymienił em kilka słów , niebawem przyjechał do Słupska .	Darkiem	1	Ins
Zmarł w Livorno w roku 1846 .	Livorno	2	Loc
Molenda posłusznie wysiadł .	Molenda	0	Nom
Ja na miejscu Pana Giertycha wprowadziłbym zakaz rodzenia głupim matkom .	Giertycha	4	Gen
Aparaturę filmową obsługuje instruktor terenowy PDK Czesław Fudala .	Fudala	7	Nom
Kłopoty z tożsamością Macieja i Mateusza każą mi tutaj przywołać jeszcze jedną parę imion , a mianowicie Szczepana i Stefana .	Stefana	19	Acc
Goran Persson , premier Szwecji , napisał niedawno książkę .	Goran	0	Nom
Ale po co ogłaszać przetarg , skoro muszą wygrać partnerzy biznesowi Stanisława K . ?	Stanisława	11	Gen
Na Siemiradzkiego wybrzydzali krytycy , ale publiczność uwielbiała jego obrazy .	Siemiradzkiego	1	Acc
Adams odpowiedzialnością za tę porażkę obarczał Hamiltona i jego ludzi , którzy doprowadzili do rozłamu wśród federalistów .	Hamiltona	6	Acc
Podobnie było w Czaplinku i Złocieńcu .	Czaplinku	3	Loc
Potem zaraz z świętym Piotrem zniknął .	Piotrem	4	Ins
Żonę ma w Stanach Zjednoczonych , dorosłym dzieciom powodzi się dobrze .	Stanach	3	Loc
Zdaniem Kwaśniewskiego jest to wystarczająca kara i Siwiec nie musi ustępować ze stanowiska .	Siwiec	7	Nom
Na torze pod Kielcami odbyty się pierwsze wyścigi samochodowe .	Kielcami	3	Ins
- Wierzę , że kandydaci do członkostwa w NATO powinni spełniać generalne kryteria demokratycznych rządów i gospodarki wolnorynkowej , włączając w to poszanowanie dla praw człowieka oraz cywilną kontrolę nad wojskiem .	NATO	8	Loc
Informacje na temat historii zen i różnych szkół znajdzie Czytelnik w chronologicznym zestawieniu najważniejszych wydarzeń z historii zen w Chinach i Japonii .	Japonii	21	Loc
Lenda złożyła powoli papier .	Lenda	0	Nom
Razem z mętami w Bornem Sulinowie pojawiły się klechy .	Bornem	4	Loc
Patesi zbladł .	Patesi	0	Nom
Ale dla mnie nie ma różnicy między Włochem , Polakiem czy Węgrem .	Węgrem	11	Ins
ładnie nawiązał eś do Łazarza i przepaści potępiając mnie i skazując na nie .	Łazarza	4	Gen
Dlaczego nie mogę włożyć swetra Anki ?	Anki	5	Gen
W połowie lat sześćdziesiątych łowiłem z przyjaciółmi na Biebrzy .	Biebrzy	8	Loc
Dwaj nieznani mężczyźni okradają restauratorów we Włochach , Opaczy , Pruszkowie .	Pruszkowie	10	Loc
„ Pogadam ze Stanleyem .	Stanleyem	3	Ins
Wzrasta temperatura rozmów o prawyborach w AWS .	AWS	6	Loc
Po bombardowaniach wojsko przeczesuje dom po domu , starając się odnaleźć porwanego w niedzielę swego kolegę , Gilada Shalita .	Shalita	18	Acc
Dlaczego marszałek Małachowski milczy wobec antyreligijnych wypowiedzi niektórych posłów ?	Małachowski	2	Nom
Wezwali Marcina .	Marcina	1	Acc
Wkrótce zawiniemy do Trondheim .	Trondheim	3	Gen
Myślano o dorocznym spotkaniu ekonomistów i biznesmenów Wschodu i Zachodu w Davos .	Davos	11	Loc
Po zetknięciu z ziemią maszyna wybuchła , a siła eksplozji wyrzuciła dwóch słowackich mechaników i Marka Panasia .	Panasia	16	Acc
Teraz opanowali Somalię .	Somalię	2	Acc
Teraz zwłoki Odiego leżą w chłodni .	Odiego	2	Gen
- Ruski przerzucił się na Turcję .	Turcję	5	Acc
Bawiąc się w salonie z Jurkiem Łobzowskim , zaczepił em kiedyś rękawicą bokserską o lep na muchy .	Łobzowskim	6	Ins
Podporucznik Stryjek zamknął okno .	Stryjek	1	Nom
Wie , że w starciu z Donaldem Tuskiem nie ma większych szans .	Tuskiem	7	Ins
Auto z czterema młodymi mężczyznami wpadło do Wisły .	Wisły	7	Gen
Za parę dni dotrze do Londynu .	Londynu	5	Gen
Tymczasem wiceprezes Sądu Rejonowego w Kędzierzynie , Anna Lipnicka , broni decyzji koleżanki .	Lipnicka	8	Nom
Janina Michaluk leży w szpitalu w Gryficach .	Janina	0	Nom
Widzą nagle Cygana z Jadźką .	Jadźką	4	Ins
Spotkali się wzrokiem z Polkiem .	Polkiem	4	Ins
A ja z Armenami świetnie się po rosyjsku dogaduję .	Armenami	3	Ins
Warnecke , wolę tego nie opisywać .	Warnecke	0	Nom
Z tych samych środków , które zasiliły konto Hufca ZHP , dofinansowanie zdobyło także Stowarzyszenie Na Rzecz Szkolnictwa Specjalnego .	ZHP	9	Gen
Zawody będą rozgrywane na Dunajcu na odcinku od Krościenka do mostu w Gołkowicach .	Gołkowicach	12	Loc
PZN to jest zrzeszenie wszystkich podmiotów , które działają na terenie kraju .	PZN	0	Nom
Parlament Europejski w Strasburgu przegłosował niedawno całkowity zakaz reklamowania wyrobów tytoniowych .	Strasburgu	3	Loc
Małachowski zarzuca Kościołowi milczenie wobec wystąpień nacjonalistycznych i antysemickich .	Małachowski	0	Nom
Dobrze spisała się młodzież w Sterdyni , Ceranowie , Skrzeszynie , Czerwonce i Wężach .	Ceranowie	7	Loc
Do tego momentu Polak miał wyraźną przewagę .	Polak	3	Nom
Powiedziała Elizabeth , iż jest Polką , a to miasto kiedyś należało do Polski .	Polką	5	Ins
Wprowadzenie rozwiązań proponowanych przez SLD prowadziłoby do wynaradawiania .	SLD	4	Acc
Pięcioletnia dziewczynka , porwana wczoraj przez 65-letniego mężczyznę w Chorzowie na Śląsku , odzyskała wieczorem przytomność .	Śląsku	11	Loc
W Turynie miał wolną rękę i mógł poruszać się po całym boisku .	Turynie	1	Loc
Siadam w kącie i usypiam , budząc się na Gare du Nord .	Gare	9	Loc
Czasem przyjeżdżają do Nataszy z Polski rodzice .	Nataszy	3	Gen
Adam po pobycie w Nowym Jorku nie mógł już w Krośnie złapać oddechu , postanowił zbudować dom pod Krakowem .	Jorku	5	Loc
Szkoda , że nie można dysponować Heinzem Mirynkiem .	Mirynkiem	7	Ins
Rozmawiał eś z Anną ?	Anną	3	Ins
Ta masa wodna , nieraz podnosząca poziom Wiku o jeden metr ponad równię Puckiej Zatoki , spotyka się przy dziobie gołębia z silnym prądem zachodnim .	Wiku	7	Gen
Główne dowództwo niemieckie musi objąć kierownictwo operacji wojennych we Włoszech .	Włoszech	9	Loc
W Burkina Faso dominują muzułmanie .	Faso	2	Loc
Selekcjoner Jerzy Engel rozdał pamiątkowe monety , wybite z okazji zbliżających się mistrzostw świata .	Engel	2	Nom
Kto jest przewodnikiem Dantego podczas wędrówki po piekle ?	Dantego	3	Gen
- Niech Kwaśniewski się nie wtrąca .	Kwaśniewski	2	Nom
- Mógł by m wejść do Internetu ?	Internetu	6	Gen
Dobrze spisała się młodzież w Sterdyni , Ceranowie , Skrzeszynie , Czerwonce i Wężach .	Czerwonce	11	Loc
- Słuchaj , ty pewnie wyższą akademię talmudyczną w Mirze ukończył eś ?	Mirze	9	Loc
Gagosian nadal milczał , siedząc za biurkiem na swój sztywny sposób .	Gagosian	0	Nom
Sex Pistols gramy od paru ładnych lat na specjalne okazje .	Pistols	1	Acc
Emil Drejtser urodził się w Odessie , wyemigrował do USA w 1974 roku .	Odessie	5	Loc
Kontrolę w PAR zlecił jesienią ub.r . minister łączności Maciej Srebro .	PAR	2	Loc
Nastroszony w telewizorze Biernacki jest równie zabawny jak nastroszony Buzek .	Biernacki	3	Nom
Pożeracz Chmur aż się otrząsnął .	Chmur	1	Gen
Miał po swojemu ten Koch rację .	Koch	4	Nom
Wykonanie całej inwestycji zlecono Przedsiębiorstwu Budowy Dróg i Mostów ze Świecia .	Świecia	10	Gen
– Ja tylko chcę się zobaczyć z więźniarką Gertrudą von Mogmitz .	Gertrudą	8	Ins
Westchnienia Ruskina i Prousta trafiają na podatny grunt .	Prousta	3	Gen
W niedzielny wieczór premier Izraela Ariel Saron ogłosił wojnę z palestyńskim terroryzmem .	Saron	6	Nom
Usłyszał także głos Łukasza .	Łukasza	3	Gen
W Konstancinie-Jeziornie i Spale przygotowują się piłkarskie reprezentacje do nadzwyczaj ważnych spotkań .	Spale	3	Loc
- Jaka jest Moskwa Putina ?	Putina	4	Gen
Protokół i listę mówców prowadzić będą pani posłanka Zdzisława Kobylińska oraz pan poseł Andrzej Zapałowski .	Kobylińska	9	Nom
Dziękujemy w imieniu Agnieszki Kulig .	Kulig	4	Gen
Podkreśla się , ze był on najlepszym rozgrywającym ligi i ojcem dominacji Chicago Fire w rozgrywkach grupowych .	Fire	13	Gen
Proszę uprzejmie , pan poseł Zbyszek Zaborowski z SLD .	Zaborowski	6	Nom
Przypomnijmy , że na budowę centrum hurtowego nie zgadzają się mieszkańcy Osowej .	Osowej	11	Gen
Angelina Jolie jest bezgranicznie zakochana w swoim adoptowanym synku , który niedawno urodził się w Kambodży .	Kambodży	15	Loc
Na torze pod Kielcami odbyty się pierwsze wyścigi samochodowe .	Kielcami	3	Ins
Wróćmy na Kościelec , na jego piękną zachodnią ścianę .	Kościelec	2	Acc
Wczoraj koło cmentarza w Sianowie znaleziono kilkuletniego chłopca .	Sianowie	4	Loc
I dlatego muszę wspomnieć o Krzysiu z Częstochowy .	Krzysiu	5	Loc
– ale Hubertus po Niemiecku będzie prowadził ?	Hubertus	2	Nom
Amerykanie wzięli La Haie du Puy .	La	2	Acc
- Raport o stanie państwa nie został ogłoszony przed Wigilią na osobisty wniosek premiera .	Wigilią	9	Ins
Z pozostałymi członkami dawnego kierownictwa związanymi z Gomułką plenum obeszło się bezceremonialnie , usuwając ich w większości ze składu KC .	Gomułką	7	Ins
Gdyby Celina Szulc pozostała na stanowisku , związkowcy zamierzali ogłosić wczoraj strajk okupacyjny w łomżyńskich wodociągach .	Celina	1	Nom
Niemcy ciągle kontratakują w Normandii .	Normandii	4	Loc
– Nieraz już leczyła m tak Jarowita .	Jarowita	6	Acc
Hutnictwo polskie współpracuje z hutnictwem ZSRR , NRD , Czechosłowacji i Bułgarii .	NRD	7	Gen
Batura poczerwieniał z upokorzenia i gniewu .	Batura	0	Nom
Zanim wiązanki kwiatów przykryły mogiłę , słowa modlitwy prowadzonej przez ks . Pawła Dorucha splatały się z wyrazami bólu i wspomnieniami przyjaciół .	Dorucha	13	Acc
- Rysiek , dam ci ciężarówkę , ale mi nią przywieziesz Nałkowską z Adamowizny i Gojawiczyńską ze Stawiska !	Gojawiczyńską	15	Acc
Według dyżurnego Komendy Miejskiej Policji w Chorzowie po przebudzeniu dziecka stwierdzono , że zostało ono upite .	Chorzowie	6	Loc
Właśnie to zagęszczenie chyba spowodowało , że w krótkim czasie koszatniczki w Wiedniu wyginęły .	Wiedniu	12	Loc
Misję tę powierzyła doktorowi Lane matka Oswalda , Marguerite .	Oswalda	6	Gen
Zajmowała się tym głównie Maryla Wacławkówna , wygnana ongiś z przedszkola za klerykalizm .	Wacławkówna	5	Nom
W Venezii Keneth ciągle leczył kontuzje , nie doszedł do formy .	Keneth	2	Nom
Kochamy Polskę , lecz fakty składające się na polską rzeczywistość działają nam na nerwy .	Polskę	1	Acc
Przewodniczący Vegów uśmiechnął się jakby z zakłopotaniem .	Vegów	1	Gen
Poparła przyjaciółkę Marychna .	Marychna	2	Nom
Na parkingu do samochodu Kosińskiego dosiadł się Osiński .	Kosińskiego	4	Gen
W Czarnem umieszczono go w celi o zaostrzonym rygorze .	Czarnem	1	Loc
Sprawę znam z relacji mojej Irenki .	Irenki	5	Gen
W Urzędzie Wojewódzkim w Skierniewicach pracuje około 230 osób .	Skierniewicach	4	Loc
Klasztor fundacji Gaszynów posiada sklepione cele i korytarze komunikacyjne .	Gaszynów	2	Gen
Tak jak upiekło im się po Zatoce i Afganistanie .	Zatoce	6	Loc
Agnus kipiał , bulgotał z wściekłości , ale wciąż jeszcze siedział cicho .	Agnus	0	Nom
Rodzina Chmurów zręcznie z niej wybrnęła .	Chmurów	1	Gen
Reynevan odetchnął głęboko .	Reynevan	0	Nom
Mock odsalutował .	Mock	0	Nom
Z jednym z nich , Witkiem , rozmawialiśmy przez CB-radio .	CB-radio	9	Acc
Oceniając strajk , Gawin oświadczył , że ruch towarowy praktycznie się nie odbywał , a na Śląsku stanęło wiele pociągów pasażerskich .	Śląsku	16	Loc
Spiskowano wokół Saddama w sposób nieprawdopodobnie aktywny .	Saddama	2	Gen
Będą pracować w Wilczycach i w rejonie Ćmielowa .	Ćmielowa	7	Gen
- Możliwość odejścia Leszka Balcerowicza bardzo zaniepokoiła inwestorów .	Leszka	3	Gen
Królowała wśród nich pani Gieniuchna .	Gieniuchna	4	Nom
Czy pan poseł Chmielewski chce zadać pytanie ?	Chmielewski	3	Nom
Beacie towarzyszył mój starszy kuzyn , inżynier Wacław Straszyński .	Straszyński	8	Nom
Tym razem był to Haugsdorf .	Haugsdorf	4	Nom
Pan Sapieha tego nie zauważył , czując się w kręgu jasności .	Sapieha	1	Nom
Z pożaru uratowała się czternastoletnia Stefania Nowaczuk .	Stefania	5	Nom
Doznały jedynie stłuczeń kończyn i po opatrzeniu ran w szpitalu w Broumovie zostały zwolnione .	Broumovie	11	Loc
Zapomniał eś dodać okultyzm Ojca Pio i Katarzyny Neuman .	Neuman	8	Gen
Jaro pofatygował się zadośćuczynić życzeniu klienta , a tymczasem dziewczyny na scenie dały spokój rurce .	Jaro	0	Nom
Radni Malborka podjęli uchwałę w sprawie nowych stawek za wodę i odprowadzane ścieki .	Malborka	1	Gen
Gospodarstwo Stanisławy Sowy , Irki Paulako i Moniki Niebrzydowskiej rozszerza się powoli poza obręb zabudowań gospodarskich .	Moniki	7	Gen
W niedzielę rano odprawiono z okazji rocznicy śmierci kompozytora msze święte w kościołach sióstr Wizytek i św . Krzyża , gdzie spoczywa serce Chopina .	Chopina	23	Gen
Tylko w czterech państwach w Europie pojawiły się sieci DCS .	Europie	5	Loc
Spojrzał na Staśka .	Staśka	2	Acc
Ula czuła radość .	Ula	0	Nom
Ciężkie działa przeciw abolicji wytoczył Leszek Miller .	Leszek	5	Nom
Kłaniając się przepraszająco , opuścili śmy z panem Adamkiem zakład pogrzebowy .	Adamkiem	8	Ins
Starostwo katowickie zwraca się do Giesche SA , by bezdomnych pozostawić w spokoju .	Giesche	5	Gen
Początkowo chcieli wywieźć je nad Wisłę .	Wisłę	5	Acc
Jak to skończysz , spróbuj Stendhala i Buddenbrooków Tomasza Manna . . .	Manna	9	Gen
Żywiła m tym Dominikę .	Dominikę	3	Acc
Ale dzisiaj umysł mędrca od razu uleciał w stronę Ciemnej Gwiazdy .	Gwiazdy	10	Gen
Podniosła słuchawkę telefonu i wystukała numer Filipa .	Filipa	6	Gen
Świat Michnika bez świata Rydzyka umiera .	Michnika	1	Gen
Rekordowy mróz minus osiemnaście stopni Celsjusza zanotowano w podgórskiej miejscowości Przibyslavi .	Celsjusza	5	Gen
Angelina oczywiście wyraziła chęć ponownego zagrania Lary Croft .	Lary	6	Gen
Zaciągam się papierosem i próbuję przypomnieć sobie dawnego Dziedziuszkę .	Dziedziuszkę	8	Acc
Historycy nadal spierają się o pochodzenie Mwisków .	Mwisków	6	Gen
Wisła w Toruniu przekroczyła stan alarmowy o 80 cm , a wody wciąż przybywa .	Toruniu	2	Loc
Temu sukcesowi w znacznej mierze przysłużył się również Szymon , który wywalczył 10 z 18 zdobytych przez Polaków punktów .	Szymon	8	Nom
Nawiązano współpracę z kołami gospodyń wiejskich w Domatkowie , Kolbuszowej Górnej , Nowej Wsi , Weryni i Widełce .	Widełce	17	Loc
- Stefan z uznaniem przygląda się jej nowemu mundurkowi .	Stefan	1	Nom
Teofil trzymał je w ręce , aby włożyć dopiero w ostatniej chwili .	Teofil	0	Nom
Wojska etiopskie kontynuują ofensywę w Erytrei .	Erytrei	5	Loc
i Maciek tak zawsze robił .	Maciek	1	Nom
W zamian kuria proboszczem tego kościoła uczyniła jego starszego brata , ks . Zdzisława Struzika .	Zdzisława	13	Acc
Na parkingu do samochodu Kosińskiego dosiadł się Osiński .	Osiński	7	Nom
Potem pismo prowadzić będzie Dionizy Bek .	Dionizy	4	Nom
Natomiast do Tesco już wkrótce będą należały sklepy Leader Price'a .	Tesco	2	Gen
Królową Mody wybrano na rok 1935 znaną pieśniarkę Werę Bobrowską .	Bobrowską	9	Acc
Nawet Nagroda Nobla mu nie dorównuje !	Nobla	2	Gen
W tym roku w kościele św . Brygidy na Wielkanoc można było obejrzeć kościotrupa trzymającego flagę UE .	Wielkanoc	9	Acc
Teraz wynajmuje mieszkanie w Rzeszowie .	Rzeszowie	4	Loc
Jego nominacja na ministra spraw zagranicznych była największą niespodzianką rządu Angeli Merkel .	Angeli	10	Gen
Luiza słyszała nad sobą kroki Weelsa .	Weelsa	5	Gen
Jest wychowankiem Sportulu Studenţesc , w którym łącznie występował przez dziewięć lat .	Studenţesc	3	Gen
Henryk informował , że Jenny przespała granicę i nikt jej nawet nie budził .	Jenny	4	Nom
Zapytaj Andrzeja .	Andrzeja	1	Acc
Tak jakby ludzie z kręgów kulturalnych bali się Szuwara , jakby mając nieczyste sumienie , chcieli jednak go wysłuchać , dopuścić do głosu .	Szuwara	8	Gen
Zaprosił do Varietes Budapest .	Varietes	2	Gen
- Do sypialni Polaków coraz częściej wchodzą istoty posiadające zdolność przenikania przez ściany .	Polaków	3	Gen
- Znowu sięgnę do wspomnień z okresu , kiedy mieszkał em w Krakowie .	Krakowie	12	Loc
Jego anegdoty traktowały o najrozmaitszych księżach dziwakach , których w okolicy nie brakło , a których przygody tchnęły często humorem z epoki Seweryna Soplicy czy nawet Paska .	Seweryna	22	Gen
O kradzieży powiadomiono Straż Graniczną i Interpol .	Interpol	6	Acc
Przede wszystkim zdecydował wynik w Stanach .	Stanach	5	Loc
- Poza tym Jan Paweł II nie został jeszcze ogłoszony świętym .	Paweł	4	Nom
Humphrey zmarł w wieku 18 lat , dziewięć lat po odejściu na emeryturę .	Humphrey	0	Nom
Co ś zrobił z babcią i Czerwonym Kapturkiem ?	Kapturkiem	7	Ins
Oddanie do użytku domków w Połańcu w październiku 1997 r . było wyjątkowo uroczyste .	Połańcu	5	Loc
– sika w Stanach ?	Stanach	3	Loc
Ze strychu zieje ogniem Roman i Szczepan .	Szczepan	6	Nom
Stacja BP dysponuje ośmioma dystrybutorami z całym zakresem paliw .	BP	1	Gen
Widownia westchnęła ze współczuciem , a Iwana to uskrzydliło .	Iwana	6	Acc
I oto w ONZ przemawia nowy prezydent Kwaśniewski .	ONZ	3	Loc
Wśród podhalańskich Cyganów z bezwzględności słynie jego współpracownik , współoskarżony w Oświęcimiu , Stanisław Kamiński z Czarnej Góry .	Góry	17	Gen
Natomiast do Tesco już wkrótce będą należały sklepy Leader Price'a .	Price'a	9	Gen
– Druga część będzie w Afganistanie ?	Afganistanie	5	Loc
Za najważniejszych nazistowskich zbrodniarzy powszechnie uznawano Hitlera , Himmlera i Goebbelsa .	Himmlera	8	Acc
Wacek tam mieszka .	Wacek	0	Nom
Pięcioletnia dziewczynka , porwana wczoraj przez 65-letniego mężczyznę w Chorzowie na Śląsku , odzyskała wieczorem przytomność .	Chorzowie	9	Loc
— Wielu Europejczyków wyznaje ideologię komunistyczną .	Europejczyków	2	Gen
Oto nagle w gazecie spotkałem naszą Kassandrę .	Kassandrę	6	Acc
Na pastwisku w Uniszkach Gumowskich rolnik załadował na dwukółkę krowę .	Uniszkach	3	Loc
Na domową edukację Budajczakowie zdecydowali się w 1995 roku .	Budajczakowie	3	Nom
Iwan delikatnie postawił Sibircewa na oblodzonej ziemi .	Sibircewa	3	Acc
W Drygałach koło Białej Piskiej zatrzymany do kontroli 47-letni kierowca zionął na policjantów czosnkiem .	Drygałach	1	Loc
Gramy Beethovena , dziś nawet idą tradycyjnie koncerty fortepianowe .	Beethovena	1	Acc
Baryshnikov automatycznie skorzystał z Rangera .	Rangera	4	Gen
Dzięki jego zaangażowaniu w naszym mieście nadal funkcjonuje sekcja piłki nożnej na odpowiednim poziomie sportowym , promująca Jarosław na terenie Polski południowo - wschodniej .	Jarosław	17	Acc
11-latek przyniósł do szkoły w Studziankach granat .	Studziankach	5	Loc
Młodzi mieszkańcy Skarżyna nie widzą sprawy tak czarno .	Skarżyna	2	Gen
Jędrusia przysiadła na brzegu .	Jędrusia	0	Nom
Dlatego Marek z kartonem stał teraz na poboczu , czekając na Grzesia i jego półciężarówkę .	Grzesia	11	Acc
W 1989 roku Humphrey zaczął pracować w rezydencji premierów Wielkiej Brytanii w charakterze niezłomnego pogromcy myszy i szczurów .	Humphrey	3	Nom
Koranu pan nie zna ?	Koranu	0	Gen
- Jestem sługą Jezusa .	Jezusa	3	Gen
Oficer SS wyznaczył żołnierzy do plutonu egzekucyjnego .	SS	1	Gen
Usłużnym kierowcą okazał się 34-letni Rob Gatena .	Rob	5	Nom
Ten Murzyn to sekretarz generalny ONZ , Kofi Annan .	Annan	8	Nom
Wie , że w starciu z Donaldem Tuskiem nie ma większych szans .	Donaldem	6	Ins
pamiętasz tą Karolinkę ?	Karolinkę	2	Acc
Prezydenci Polski , Ukrainy i Rumunii spotkali się na roboczych rozmowach w Bukareszcie .	Bukareszcie	12	Loc
Co to był COP ?	COP	3	Nom
— Wielu Europejczyków wyznaje ideologię komunistyczną .	Europejczyków	2	Gen
- Na razie przedstawiciele SLD spotkali się z Jerzym Buzkiem .	Jerzym	8	Ins
Zza kulis wychodzi aktorka grająca Magdalenkę .	Magdalenkę	5	Acc
Według niej , Havel czuł się źle już w niedzielę .	Havel	3	Nom
- A czy słyszał pan o Witoldzie Michałowskim ?	Michałowskim	7	Loc
Akcję sprawozdawczo - wyborczą w pracowniczych ogrodach działkowych zakończy ogólnopolska konferencja delegatów wybranych na zjazdach wojewódzkich POD , która będzie obradowała w maju w Warszawie .	POD	16	Gen
Co słychać w Ameryce ?	Ameryce	3	Loc
Karina pracowała na oddziale dziecięcym .	Karina	0	Nom
– Ja tylko chcę się zobaczyć z więźniarką Gertrudą von Mogmitz .	Mogmitz	10	Ins
Na Węgrzech występuje pianistka Halina Czerny - Stefańska i jej córka klawesynistka Elżbieta Stefańska - Łukowicz .	Węgrzech	1	Loc
Radni powiatowi z Nowogródka zdecydowali wczoraj , że w rodzinnym mieście Adama Mickiewicza nie będzie polskiej szkoły .	Nowogródka	3	Gen
Piłkarze FC Porto zapewnili sobie wczoraj ponownie tytuł mistrzów Portugalii .	Porto	2	Gen
To jeden z najdroższych sylwestrów na Mazowszu .	Mazowszu	6	Loc
W lufciku pojawiła się wreszcie twarz Tarasiuka .	Tarasiuka	6	Gen
Tradycja związana ze św . Wojciechem głosi , że w X w . założył on w Trzemesznie klasztor benedyktynów .	Wojciechem	5	Ins
Specjaliści Paribas mówią przede wszystkim o doskonałej kondycji gospodarki amerykańskiej , która winduje kurs dolara .	Paribas	1	Gen
Jeździ Pan na Żywiecczyźnie ?	Żywiecczyźnie	3	Loc
Mieszka w Mysłowicach .	Mysłowicach	2	Loc
Zdaniem ekspertów pytanych przez PG , nowe prawo farmaceutyczne nie spowoduje odpływu reklamodawców .	PG	4	Acc
Wszystkie te rzeczy zjadał Józio z Hańdzią , gdyż matka żywiła się raczej kiszoną kapustą .	Hańdzią	6	Ins
Wyciągnął z kieszeni dwa batoniki Bounty .	Bounty	5	Acc
Wyciągnął Władysława przed bar i zaczął kłótnię .	Władysława	1	Acc
Gdy rozległ się krzyk , Guilielmo zakryl twarz rękami .	Guilielmo	5	Nom
Gdyby Nina Terentiew ciągle rządziła Dwójką , krzywdy pani zrobić by nie dała ?	Nina	1	Nom
IRA nie pozwoli ?	IRA	0	Nom
Z jednym z nich , Witkiem , rozmawialiśmy przez CB-radio .	Witkiem	5	Ins
Wczoraj koło cmentarza w Sianowie znaleziono kilkuletniego chłopca .	Sianowie	4	Loc
Dominować będą piosenki do tekstów Edwarda Stachury .	Stachury	6	Gen
Podczas świąt we wszystkich kościołach diecezji radomskiej odczytano list biskupa Zygmunta Zimowskiego .	Zimowskiego	11	Gen
W kraju działa kilka grup partyzanckich utworzonych przez patriotów Dominikany .	Dominikany	9	Gen
Zbliżają się ferie , już niedługo pociągi z Warszawy do Zakopanego zapełnią się młodzieżą .	Zakopanego	10	Gen
Podobnie było w Czaplinku i Złocieńcu .	Złocieńcu	5	Loc
Zadeklarowali , że w stacji znajdą zatrudnienie mieszkańcy Szypliszek .	Szypliszek	8	Gen
Wzięli w niej udział przedstawiciele policji z Niemiec , Czech , Słowacji , Węgier , Ukrainy i Polski .	Ukrainy	15	Gen
Maciek opowiadał .	Maciek	0	Nom
Weźmy Siedlce .	Siedlce	1	Acc
Rządek Indian Chamula patrzył w milczeniu z wysokiego muru .	Indian	1	Gen
Białoruś wie , czym była Bereza .	Bereza	5	Nom
- Wasza gazeta od dawna robi świetne przewodniki dla poszukujących pracy w Irlandii .	Irlandii	12	Loc
W LIZBONIE zakończyła się 66 sesja Rady Europy na szczeblu ministrów spraw zagranicznych 21 państw kapitalistycznych naszego kontynentu .	LIZBONIE	1	Loc
Większość skradziono w Berlinie , Hamburgu , Kilonii i Bremie .	Bremie	9	Loc
Narconon to najskuteczniejszy program , jaki wymyślono .	Narconon	0	Nom
Dobrze spisała się młodzież w Sterdyni , Ceranowie , Skrzeszynie , Czerwonce i Wężach .	Sterdyni	5	Loc
W numerze wydanym przez Movex rzuca się w oczy kilkustronicowy wstępniak .	Movex	4	Acc
Każdy w Breslau wie , że hrabina siedzi w tym obozie . . .	Breslau	2	Loc
Kino w Tuczępach posiada osiemdziesiąt miejsc .	Tuczępach	2	Loc
Szpital w Ostródzie został sprywatyzowany 7 lat temu .	Ostródzie	2	Loc
Wzrasta temperatura rozmów o prawyborach w AWS .	AWS	6	Loc
Korespondenci budapesztańskich gazet donoszą , że wielu miejscowych Węgrów wyjechało do krewnych na wieś albo uciekło na Węgry .	Węgry	17	Acc
Na Węgrzech występuje pianistka Halina Czerny - Stefańska i jej córka klawesynistka Elżbieta Stefańska - Łukowicz .	Halina	4	Nom
Co kwartał wysokość tych kwot może się zmienić w związku ze zmianą ceny metra kwadratowego ogłaszaną przez GUS .	GUS	17	Acc
Następcy Piotra wybrali na siedzibę Rzym , a nie Jerozolimę .	Rzym	5	Acc
Zwłaszcza przed znajomością z Affleckiem , kiedy była dziewczyną Brada Pitta .	Affleckiem	4	Ins
Zostałem Żydem zaraz po oderwaniu się od polskiej ziemi , tej , której nigdy nie sprzedamy cudzoziemcom .	Żydem	1	Ins
Najgłośniejsza draka wybuchła o Tywonka .	Tywonka	4	Acc
Chodzi o to , by dobrze rozumieć Chopina .	Chopina	7	Acc
Nie dogadał by się z ministrem Szmajdzińskim .	Szmajdzińskim	6	Ins
W twarzy Che tkwiła trudno uchwytna skaza .	Che	2	Gen
Hanka , będę wam przysyłać .	Hanka	0	Nom
Saturn wyda miliony złotych na reklamę .	Saturn	0	Nom
Jak ta Mirta miała wszystko uporządkowane i przemyślane !	Mirta	2	Nom
Po pani Florczakowej i Kropce został tylko jeden ślad .	Kropce	4	Loc
Obudzimy Anamarię o dwunastej .	Anamarię	1	Acc
W Netii taniej będzie jeszcze jutro przez cały dzień .	Netii	1	Loc
Pora rozstać się z Hehem i chłopakami .	Hehem	4	Ins
Odsłonili jednak tyły i kolejną bramkę zdobyli lechici .	lechici	7	Nom
Ojciec Tadeusz Rydzyk po emisji poświęconego mu filmu mówił na antenie swego radia , że to zemsta TVP za jego plany stworzenia telewizji .	Rydzyk	2	Nom
Wiece i akademie odbyły się również w Sofii , Damaszku , Kabulu , Surabai i innych miastach .	Sofii	7	Loc
Wśród osób , które nielegalnie przekroczyły wschodnią granicę , było sześciu obywateli Bangladeszu , dwóch Afgańczyków i czterech Kurdów irackich , w tym kobieta z dzieckiem .	Bangladeszu	12	Gen
Doktryna Trumana ma oblicze wyraźnie polityczne .	Trumana	1	Gen
– Myśli pan , że Michnik albo Geremek mają mniej ?	Michnik	5	Nom
- Japońska firma Seiko wprowadziła na rynek pierwszy kwarcowy zegarek na rękę .	Seiko	3	Nom
Prokuratorowi oraz sędziom mówił , iż pojechał na Wschód , aby holować do Polski uszkodzony za Bugiem samochód .	Bugiem	16	Ins
Jeszcze większe wrażenie na współczesnych sprawiał Tomasz z Akwinu , dyktując dwa albo trzy traktaty filozoficzne .	Akwinu	8	Gen
Jest to może jedyna okoliczność , w której Francuza opuszcza na chwilę materializm .	Francuza	8	Acc
W Świebodzinie na śmietniku znaleziono torbę z fałszywymi banknotami wartości miliarda złotych .	Świebodzinie	1	Loc
Kompromitowali nie tylko siebie , ale i Polskę .	Polskę	7	Acc
Widział em rano , jak rozmawiała ś z tym sympatycznym młodzieńcem , Abibem Denisem .	Denisem	13	Ins
Przed Sądem Okręgowym w Koszalinie zeznała tak wczoraj pielęgniarka z karetki .	Koszalinie	4	Loc
Kiedyś uduszono jej jedynego syna Amadeusza .	Amadeusza	5	Acc
Czy naprawdę byłbym jej coś zrobił za Zucha ?	Zucha	7	Acc
Mój Piotrek uchodzi za speca w dziedzinie drewnianego budownictwa na Podhalu .	Podhalu	10	Loc
Stworzyła polski oddział EquiLibre , organizowała konwoje z pomocą dla byłej Jugosławii , Kazachstanu , Czeczenii .	Czeczenii	15	Gen
Trafił do Pogotowia Opiekuńczego w Polanowie .	Polanowie	5	Loc
Niedługo zobaczymy Tomasza Adamka reklamującego piwo albo męską bieliznę ?	Tomasza	2	Acc
Dyrektor zapoznał Grodzickiego z katechetą , potem pożegnał się i wyszedł .	Grodzickiego	2	Acc
I wziął niebieską kredkę od Karolci , aby zabrać się do roboty .	Karolci	5	Gen
W Nowym Tomyślu wiatr zerwał dach urzędu skarbowego i pasażu handlowego .	Tomyślu	2	Loc
Na ekranie TV , na zatrzymanej stop–klatce Jurka Kilera idą napisy końcowe programu .	Kilera	8	Gen
W Małej Komorzy z tego powodu zapaliły się sadze .	Komorzy	2	Loc
W Zwieczycy koło Rzeszowa autobus PKS wpadł do głębokiego rowu .	PKS	5	Gen
Ulewne deszcze nawiedziły także Słupsk .	Słupsk	4	Acc
Partia Konserwatywna zawiesiła Spencera w obowiązkach posła .	Spencera	3	Acc
Wszyscy we wsi znają Andrzeja Wrońskiego .	Andrzeja	4	Acc
Spotkanie poprowadził dyrektor TVB Kazimierz Puciłowski .	TVB	3	Gen
Idiotka Zuzia zapomniała zrobić w banku blokadę i całą forsę zajęli na długi .	Zuzia	1	Nom
W środę ze Szpitala Ginekologiczno - Położniczego w Opolu wypisywano 11 noworodków .	Opolu	8	Loc
Adam po pobycie w Nowym Jorku nie mógł już w Krośnie złapać oddechu , postanowił zbudować dom pod Krakowem .	Krośnie	10	Loc
Większość skradziono w Berlinie , Hamburgu , Kilonii i Bremie .	Hamburgu	5	Loc
Tadeusz Okoniewski pisał też do samych palotynek .	Tadeusz	0	Nom
Arkadiusza J . pogrążyły też zeznania taksówkarza , który zabrał oskarżonych sprzed Stodoły .	Arkadiusza	0	Acc
Krystyna Kofta ogłosiła , że przyjmuje na siebie misję walki o równouprawnienie Bożen z Krystynami i za dwa lata zaprosiła panie do Trójmiasta , by równość tę udowodnić .	Bożen	12	Gen
Jarosław Kaczyński ruszył w Polskę .	Jarosław	0	Nom
Zza kulis wychodzi aktorka grająca Magdalenkę .	Magdalenkę	5	Acc
Dobrze spisała się młodzież w Sterdyni , Ceranowie , Skrzeszynie , Czerwonce i Wężach .	Skrzeszynie	9	Loc
Liczba cudzoziemców na Mazowszu rośnie z roku na rok .	Mazowszu	3	Loc
- Zawsze wierzył em w Europę .	Europę	5	Acc
Chciał by m podzielić się kilkoma przemyśleniami z Mikołajem Szymańskim .	Mikołajem	8	Ins
W 1831 pod Komorzem A . Mickiewicz próbował przekroczyć granicę zaborów biegnącą na Prośnie , aby wziąć udział w powstaniu listopadowym .	Prośnie	13	Loc
Prezes Bogdan Kościuczyk odesłał nas do dyrektor Anieli Kotowicz .	Anieli	7	Gen
Już drugi dzień próbują pocieszyć Ewę .	Ewę	5	Acc
W niezwykłym spektaklu Partice'a Chfreau zabrakło głównej bohaterki .	Partice'a	3	Gen
Nasz przyjaciel Taban zamilkł .	Taban	2	Nom
- Nyvarp zmienia kolor na zielony !	Nyvarp	1	Nom
Podczas przesłuchania w komisji minister Zbigniew Siemiątkowski zdystansował się wobec pomysłu Cimoszewicza .	Siemiątkowski	6	Nom
Minister obrony Tengiz Kitowani , były premier Tengiz Sigua i szef milicji Mchedrioni Dżaba Joseljani obalili przed rokiem prezydenta Zwiada Gamsahurdię .	Gamsahurdię	20	Acc
Okazją był szczyt NATO w Madrycie .	Madrycie	5	Loc
Rysio spojrzał na ń uważnie .	Rysio	0	Nom
KTO PIERWSZY ZAPALIŁ OGIEŃ NA ROZEWIU ?	ROZEWIU	5	Loc
Sama nie wiem .	Sama	0	Acc
I tym razem Gagarin zniósł ją ze stoickim spokojem .	Gagarin	3	Nom
Jakimiszyn pochodzi z Baku , tu do dziś mieszka jego matka .	Baku	3	Gen
Za najważniejszych nazistowskich zbrodniarzy powszechnie uznawano Hitlera , Himmlera i Goebbelsa .	Goebbelsa	10	Acc
Napisał ją Chilijczyk Ariel Dorfman .	Dorfman	4	Nom
tutaj mówimy o Sekule ale też są problemy no .	Sekule	3	Loc
Podobnie jak we współczesnej Japonii , również w Tybecie żywe są dawne herbaciane tradycje , chociaż przyczyny ich kultywowania są zgoła odmienne .	Tybecie	8	Loc
- Dużo o tym pisał Antoni Słonimski , mój stryj .	Antoni	5	Nom
Śmierć na miejscu poniosła 36-letnia kobieta , która z mężem przechodziła przez Małą Fatrę w rejonie Niskich Tatr .	Fatrę	13	Acc
Co ś zrobił z babcią i Czerwonym Kapturkiem ?	Czerwonym	6	Ins
Stanisława Mackiewicza , Cata , trudno scharakteryzować .	Mackiewicza	1	Acc
Już wówczas zaczęto go przygotowywać do przyszłej akcji na Wschodzie .	Wschodzie	9	Loc
To najgorszy wstrząs sejsmiczny zarejestrowany w Kolumbii .	Kolumbii	6	Loc
Z tego też powodu cieszył em się , że prawica odbija teraz TVP .	TVP	12	Acc
- Mój ojciec pracuje w BRH , biurze radcy handlowego .	BRH	5	Loc
Klasztor na Jasnej Górze przeżywa prawdziwe oblężenie .	Górze	3	Loc
Wyraźnie za Basajewem nie przepadał .	Basajewem	2	Ins
Usamodzielniły się Wyry , Bojszowy , Lędziny i Bieruń .	Wyry	2	Nom
Na Suwalszczyźnie złamało się 6 słupów , nie pracuje 50 stacji transformatorowych .	Suwalszczyźnie	1	Loc
Kasprowicz opuścił Wrocław i wyjechał do rodzinnego Szymborza .	Szymborza	7	Gen
Patrzył na Petera ze smutkiem i zdumieniem zmieszanym z podziwem .	Petera	2	Acc
Sam zniknął w środku .	Sam	0	Nom
Ziuta uściskała go i ucałowała w oba policzki .	Ziuta	0	Nom
Czy bez Marka Pola w rządzie miał by pan pełnomocnika do spraw kobiet albo pomysły autostradowo - winietowe ?	Marka	2	Gen
Gdzie jest Zuza ?	Zuza	2	Nom
Przez uczony wywód autorki przewijają się dzieła współczesnych filozofów , od Ricoeura po Levinasa .	Ricoeura	11	Gen
Gwyneth przyznaje , że przez tych ostatnich kilka lat dojrzewała na zdwojonych obrotach .	Gwyneth	0	Nom
W drzwiach pojawił się sympatyczny mężczyzna , górnik z Borynii .	Borynii	9	Gen
Najpierw samodzielność uzyskał Zakład Naprawy Autobusów w Biskupicach , wcześniej stanowiący integralną część MPK .	MPK	13	Gen
Jak stawiać granice dzieciom z FAS ?	FAS	5	Ins
Wojska etiopskie kontynuują ofensywę w Erytrei .	Erytrei	5	Loc
Jak to skończysz , spróbuj Stendhala i Buddenbrooków Tomasza Manna . . .	Stendhala	5	Gen
Odeszli , choć mogli zapytać o to i owo w samym Betlejem .	Betlejem	11	Loc
Tych zaś było dziś aż siedmiu na podwórku Adamusa .	Adamusa	8	Gen
Dwaj nieznani mężczyźni okradają restauratorów we Włochach , Opaczy , Pruszkowie .	Opaczy	8	Loc
Jej program układał radca handlowy ambasady RP w Rzymie .	RP	6	Gen
Większość skradziono w Berlinie , Hamburgu , Kilonii i Bremie .	Bremie	9	Loc
Do tego doszła rada od organizatora Wiesława Szczygielskiego .	Wiesława	6	Gen
Halina Auderska we wszystkich książkach każe swoim bohaterom szukać tożsamości .	Halina	0	Nom
Był z żoną , Wandą .	Wandą	4	Ins
Odwróciwszy się omal nie uderzył w brzuch starego Pancera .	Pancera	8	Gen
Dziś , po odkryciach Zygmunta Freuda , to zapomniane w średniowieczu dziedzictwo wchodzi do naszej codzienności i znajduje w niej swoje miejsce .	Freuda	5	Gen
Ze swadą wyśmiał i wypunktował tę pookrągłostołową zgraję rządzącą Polską z nadania Kiszczaka .	Polską	9	Ins
Rozmawiał em również z Adamem .	Adamem	4	Ins
Miejsca rozgrywania spotkań zostały ustalone w drodze losowania w siedzibie Polskiego Związku Tenisa Stołowego w Warszawie .	Warszawie	15	Loc
Kto zabił Kaina ?	Kaina	2	Acc
Wyskoczyli z niej mężczyźni i rzucili się na Ilię .	Ilię	8	Acc
ja jechał em pociągiem do Gdańska .	Gdańska	5	Gen
Taką obietnicę otrzymała grupa bydgoszczan , która uczestniczyła wczoraj w spotkaniu z Aleksandrem Kwaśniewskim .	Aleksandrem	12	Ins
On mnie poznał z Jankiem Pospieszalskim .	Jankiem	4	Ins
Przedostatni figuruje Artur Balazs , poseł i minister rolnictwa , a zamyka ją Stefan Oleszczuk z UPR-u , starosta kamieński .	Oleszczuk	14	Nom
Przejęli go demagodzy jak Gamsachurdia .	Gamsachurdia	4	Nom
A jak to wygląda w Stalowej Woli ?	Woli	6	Loc
Premier Józef Cyrankiewicz przyjął wicepremiera Rumunii George Radalescu .	Radalescu	7	Acc
Na Lower East Side straż pożarna stawia wówczas ogromne , żelazne pojemniki …	East	2	Loc
Afgańczycy nie uznawali ani wiecznych wrogów , ani wiecznych przyjaciół .	Afgańczycy	0	Nom
- W Janowie to była dziecinada .	Janowie	2	Loc
bo jedziesz przez most w Dęblinie . .	Dęblinie	5	Loc
– Jasiu jest bardzo modny . .	Jasiu	1	Nom
Giertych robi to samo Kwachowi .	Giertych	0	Nom
Bandyci pobili Rosjanina i wyrzucili z samochodu na Pradze .	Rosjanina	2	Acc
Przewiduje on wynajęcie firm zewnętrznych , które zajmą się utrzymaniem sieci abonenckiej TP SA .	SA	13	Gen
Świadkowie twierdzą , że spod siedziby SdRP odjechało w ostatnich kilkunastu miesiącach kilka takich grup .	SdRP	6	Gen
Badania wielkości sił naciągu strun na torze przeprowadzono przez bezpośredni pomiar sił w poszczególnych strunach za pomocą przyrządu VOGT .	VOGT	18	Gen
Akurat wtedy , gdy kadrowicze rozpakowywali w Warszawie swój sprzęt po powrocie ze zgrupowania w Barsinghausen , w kościele w Kazimierzu zebrał się tłum wiernych , który modlił się o powodzenie naszej drużyny w zbliżających się mistrzostwach świata .	Barsinghausen	15	Loc
Ta masa wodna , nieraz podnosząca poziom Wiku o jeden metr ponad równię Puckiej Zatoki , spotyka się przy dziobie gołębia z silnym prądem zachodnim .	Zatoki	14	Gen
Uroczysta msza święta w intencji reprezentacji Polski w piłce nożnej została odprawiona w piątek w Kazimierzu Dolnym .	Kazimierzu	15	Loc
Niestety , ja też jestem na wychowawczym i ZUS niczego nie wpłacił .	ZUS	8	Nom
Rysio spojrzał na ń uważnie .	Rysio	0	Nom
Ta przekazała sprawę do PW w Lesznie .	PW	4	Gen
Pozwoliło to załatwić ostatecznie sprawę Czechowicza .	Czechowicza	5	Gen
Niedługo zobaczymy Tomasza Adamka reklamującego piwo albo męską bieliznę ?	Adamka	3	Acc
Z nadbrzeża woła mnie Lazo Jowanowski .	Jowanowski	5	Nom
W trakcie rozmowy wpada Jan Sienkiewicz .	Sienkiewicz	5	Nom
Ultimatum postawione przez Izrael minęło wczoraj .	Izrael	3	Acc
Jak stawiać granice dzieciom z FAS ?	FAS	5	Ins
Wisła w Toruniu przekroczyła stan alarmowy o 80 cm , a wody wciąż przybywa .	Wisła	0	Nom
Chce uruchomić przewozy w Raciborzu-Markowicach i Nieborowicach .	Raciborzu-Markowicach	4	Loc
Z danych wynika , że plan Marshalla wpływa coraz bardziej na pogorszenie się stanu ekonomicznego kraju .	Marshalla	6	Gen
Podopieczni trenera Mirko Jozica obecnie przebywają na zgrupowaniu w Austrii .	Mirko	2	Gen
W styczniu radni Darłowa oficjalnie nadali swemu miastu miano królewskiego .	Darłowa	3	Gen
On nie był Polakiem ?	Polakiem	3	Ins
Proponuję Włosiaka .	Włosiaka	1	Acc
Szefowie Masterlink zauważyli , że chociaż nie mają pracownika obok siebie , jego efektywność wzrosła .	Masterlink	1	Gen
Na tegorocznym inauguracyjnym balu tradycyjnego karnawału w Rio pracowały równolegle dwie komisje sędziowskie .	Rio	7	Loc
Jadzia wolała by , żeby za bardzo nie oddalały się od siebie i żeby Dominika tak nie latała .	Dominika	14	Nom
Holendrzy nie mają odwagi iść za nimi .	Holendrzy	0	Nom
CZY BRZECHWA ZNAŁ TOKARSKIEGO ?	BRZECHWA	1	Nom
Most w Kuligach na rzece Jegrzni znajduje się w fatalnym stanie i grozi zawaleniem .	Jegrzni	5	Loc
Za 30.000 złotych wyremontowana została ulica prowadząca do ośrodka zdrowia w Lubiewie .	Lubiewie	11	Loc
- W Moryniu czeka na nas wspaniałe jezioro .	Moryniu	2	Loc
Na skrzyżowaniu Lidka zatrzymała się nagle .	Lidka	2	Nom
Znał Andrzeja Zawadę i innych polskich himalaistów .	Zawadę	2	Acc
Ali Agca przebywa w więzieniu już 18 lat .	Ali	0	Nom
Jak długo Szczuka zabawi w Ostrowcu ?	Ostrowcu	5	Loc
Gdy odbywa służbę wojskową w Maroku , wielkie wrażenie robi na nim głęboka religijność wyznawców Islamu .	Maroku	5	Loc
Produkcję nadzorował w Krośnie Jerzy .	Krośnie	3	Loc
Zrobiłem krok do przodu i pociągnąłem Dorę za sobą .	Dorę	6	Acc
Marianka nawet bardzo lubię .	Marianka	0	Acc
To będzie dobry moment , żeby przedstawić Krzysztofa ojcu .	Krzysztofa	7	Acc
W czwartek Prokuratura Okręgowa w Warszawie skierowała do sądu wniosek o aresztowanie .	Warszawie	5	Loc
- Rozmawiałem ze starym Mortonem kilka razy i wydał mi się całkiem sympatyczny .	Mortonem	4	Ins
W rozległej przestrzeni czyśćca spotyka po raz pierwszy Beatrycze .	Beatrycze	8	Acc
Jest też Roll Ball .	Roll	2	Nom
Komisja rewizyjna rady powiatowej zawnioskowała o udzielenie absolutorium i przesłała stosowny wniosek do Regionalnej Izby Obrachunkowej w Bydgoszczy .	Bydgoszczy	17	Loc
Bo Scotland Yard postanowił przykręcić wysięgnik z kamerą zaledwie 30 cm od jedynego okna w jej mieszkaniu .	Scotland	1	Nom
Czy musiały śmy tu przyjechać z tą wstrętną Grochulską ?	Grochulską	8	Ins
Dlatego Marek z kartonem stał teraz na poboczu , czekając na Grzesia i jego półciężarówkę .	Grzesia	11	Acc
Mister O'Goreck schował się do jakiejś sieni .	O'Goreck	1	Nom
Niemal wszystkie nici myśli kwestionującej prowadzą do Kartezjusza .	Kartezjusza	7	Gen
11-latek przyniósł do szkoły w Studziankach granat .	Studziankach	5	Loc
Wcześniej szefował ZOZ-owi w Piasecznie .	Piasecznie	4	Loc
Na Irku cały ten wywód nie zrobił żadnego wrażenia .	Irku	1	Loc
Nasze piłkarki w grupie zmierzą się z Niemcami , Szwecją i Szwajcarią .	Szwajcarią	11	Ins
– Pixy się roześmiał .	Pixy	1	Nom
Drogę rozliczenia ze zbrodniami PRL pokonujemy od tyłu .	PRL	4	Gen
Kazancewa po raz ostatni widziano , gdy podróżował śmigłowcem w rejonie walk .	Kazancewa	0	Acc
Najwięcej do powiedzenia na ten temat ma chyba Marcin . . .	Marcin	8	Nom
Wąsacz został . . .	Wąsacz	0	Nom
Pogłaskał ją po dłoni i znowu mimowolnie zastanowił się nad kopertą od Bazarewicza .	Bazarewicza	12	Gen
Wcześniej szefował ZOZ-owi w Piasecznie .	Piasecznie	4	Loc
- Może nową posadą będzie fotel prezesa PZN ?	PZN	7	Gen
Eli chwycił wiadra i ruszył za nią kamienistą dróżką .	Eli	0	Nom
Kto by uwierzył , że kiedykolwiek będziemy się chlubić kopalniami , nie mówiąc o obiektach PKP ?	PKP	15	Gen
Z wnioskiem takim wystąpił naczelnik OSP Arkadiusz Pindral .	Pindral	7	Nom
Wyborca , który nie będzie głosował na AWS , w zamian będzie na nią płacił .	AWS	7	Acc
W forcie więziono również Rosjan , Francuzów i Jugosłowian i niemieckich antyfaszystów .	Jugosłowian	8	Acc
Kontemplując Jezusa pragnę budować na takiej skale .	Jezusa	1	Acc
- Zabrali nam Młodego .	Młodego	3	Acc
Stał na środku przedpokoju , hipnotyzując wzrokiem Lidkę , która wpatrywała się w niego z niedowierzaniem i zachwytem .	Lidkę	7	Acc
Za nimi Toyotą syn Doroty wiezie Marcina .	Marcina	6	Acc
Później Dąbrowska podobno się na mnie obraziła , bo porównał em ją gdzieś z Orzeszkową .	Orzeszkową	14	Ins
Samochód był w pełni ubezpieczony w Hestii .	Hestii	6	Loc
50.000 złotych kosztowała modernizacja ul . Hallera w Lubiewie .	Lubiewie	8	Loc
Zajmowały się tym już Zofia Korczak - Blatonowa i Aniela Cieszkowska .	Korczak	5	Nom
- Wygląda na to , że piłka nożna seniorów w Występie przestanie istnieć .	Występie	10	Loc
Pięcioletnia dziewczynka , porwana wczoraj przez 65-letniego mężczyznę w Chorzowie na Śląsku , odzyskała wieczorem przytomność .	Śląsku	11	Loc
Gdyby m umiała płakać , Mat , gdyby m umiała płakać .	Mat	5	Nom
Śmierć na miejscu poniosła 36-letnia kobieta , która z mężem przechodziła przez Małą Fatrę w rejonie Niskich Tatr .	Tatr	17	Gen
Za pomaganie funkcjonariuszom MO Konstanty odpowie teraz przed sądem .	MO	3	Gen
W ZUS nie ukrywają , że lekarzom trudno udowodnić , iż nadużywają swych kompetencji .	ZUS	1	Loc
Na ostatniej sesji Rady Gminy w Dobrej Szczecińskiej nadano nazw nowym ulicom .	Dobrej	6	Loc
Wieczorem po przyjeździe do Nowego Jorku zdążyłem jeszcze przeczytać różne materiały i przygotować swoje wystąpienie , a potem odwiedziłem sekretarza generalnego ONZ U Thanta .	Thanta	23	Acc
Zbrodnia była dokonana pod Urlami .	Urlami	4	Ins
Potwierdził to prezydent Jiang podczas niedawnego spotkania z prezydentem Clintonem .	Clintonem	9	Ins
Czy Dominik , broniąc się , mógł przewidzieć aż tak dramatyczne skutki ? !	Dominik	1	Nom
Po trzecie , Iwan nie czytał oczywiście ani Freuda , ani ponurej antyutopii Williama Goldinga .	Williama	13	Gen
Na dowód dobrej woli natychmiast odwołało z rady nadzorczej dwóch największych banachożerców , w tym Poczobutta .	Poczobutta	15	Acc
Gra rolę Pawła .	Pawła	2	Gen
Przyjechali też strażacy z OSP z Poronina , Suchego i Kościeliska .	Suchego	8	Gen
Jedną pustą wmurowano między epitafiami porucznika Ludwika Ratajczaka i majora Leona Recheńskiego .	Leona	10	Gen
To był wielki dzień w życiu Genowefy Wiśniowskiej .	Genowefy	6	Gen
Na ekranie TV , na zatrzymanej stop-klatce Jurka Kilera idą napisy końcowe programu .	Jurka	7	Gen
- Chciał em porozmawiać z panem Luboratem .	Luboratem	6	Ins
Ale Dzidzia mordowała mnie wczoraj o Olka . . .	Olka	6	Acc
Angelina Jolie jest bezgranicznie zakochana w swoim adoptowanym synku , który niedawno urodził się w Kambodży .	Angelina	0	Nom
Jeszcze wczoraj Francja miała zarządzić blokadę kont Osamy bin Ladena oraz 26 innych osób i organizacji znajdujących się na amerykańskiej liście terrorystów .	Osamy	7	Gen
Bez sprzeciwu zabiera Izaaka na szczyt góry , przywiązuje do ołtarza , podnosi nóż , jest gotów do ciosu .	Izaaka	3	Acc
Odbył jedynie krótką telefoniczną pogawędkę z prezydentem ZSRR Gromowem .	Gromowem	8	Ins
Adam przyjechał natychmiast .	Adam	0	Nom
Są jeszcze dwie propozycje , na które Huntington dotąd nie odpowiedział .	Huntington	7	Nom
I oto w ONZ przemawia nowy prezydent Kwaśniewski .	ONZ	3	Loc
Zmarł w klinice onkologicznej w Warszawie .	Warszawie	5	Loc
Kaspar Furt wcale o tym nie wiedział .	Furt	1	Nom
Co pan sądzi o pomyśle Pawła Piskorskiego ?	Piskorskiego	6	Gen
Celnikom wyjaśniła , że muszlę kupiła w Acapulco za 20 dolarów .	Acapulco	7	Loc
Wicemistrzynie Polski z Mielca nie dały pograć w Krakowie Wiśle i opuściły ostatnie miejsce w tabeli właśnie na rzecz podopiecznych Lesława Kędryny .	Kędryny	21	Gen
Podopieczni trenera Mirko Jozica obecnie przebywają na zgrupowaniu w Austrii .	Mirko	2	Gen
Niech pan Piskorski sam idzie demonstrować do parku na Agrykoli .	Agrykoli	9	Loc
Suger Land jest najdynamiczniej rozwijającym się teksańskim miastem .	Suger	0	Nom
Ale Rzeczpospolita jej nie potrzebuje . . .	Rzeczpospolita	1	Nom
Prace metaloplastyczne w kościele wykonywał Władysław Gąsienica Makowski .	Makowski	7	Nom
W ten sposób Rumuni wystąpili w roli głównego mediatora pomiędzy Moskwą a Pekinem .	Pekinem	12	Ins
Oryginalne lampy zdobyto z zasobów niemieckich przeznaczonych dla Wehrmachtu .	Wehrmachtu	8	Gen
Niemiecka liga hokeja należy do jednej z najlepszych lig w Europie .	Europie	10	Loc
Maciej Gielecki , wojewoda warszawski , obiecał im , że Łubna II nie zostanie wybudowana .	Gielecki	1	Nom
W jego głosie Kloss usłyszał wahanie .	Kloss	3	Nom
Specjalnie podesłał eś mi Celińskiego .	Celińskiego	4	Acc
Uczył się w Liceum Technik Plastycznych w Zakopanem prowadzonym przez Antoniego Kenara .	Kenara	11	Acc
Przez dwa ostatnie tygodnie policjanci zaczęli podejrzliwie obserwować Staszka i Dawida .	Staszka	8	Acc
Odprawiła nawet TVN , która chciała podpisać umowę na wyłączność w informowaniu o seksaferze .	TVN	2	Acc
Rola UNPROFOR jest jednak niejasna .	UNPROFOR	1	Gen
Wisła w Toruniu przekroczyła stan alarmowy o 80 cm , a wody wciąż przybywa .	Toruniu	2	Loc
Teraz Jasienica będzie musiała usunąć część wodociągu , który bezprawnie postawiła na prywatnej ziemi Pałuchy .	Jasienica	1	Nom
W środę do Jana Kwiatkowskiego , wujka Adama , zadzwonili policjanci z sekcji kryminalnej w Legionowie .	Kwiatkowskiego	4	Gen
Teraz zwłoki Odiego leżą w chłodni .	Odiego	2	Gen
Wprost z getta wywieźli mnie do Berlina .	Berlina	6	Gen
Zwycięzcą biegu maratońskiego został 87-letni dziś Koreańczyk Ki - jung Son .	jung	9	Nom
- Witaj , synu Arana .	Arana	4	Gen
– w Aleksandrowie straż miejska jest ?	Aleksandrowie	2	Loc
Miesiąc temu posadę stracił komendant powiatowy z Braniewa , który w komendzie był w stanie nietrzeźwości .	Braniewa	7	Gen
Katecheta zwięźle opowiedział o swych niedomaganiach i wtrącił słówko o kosztownej kuracji w Karlsbadzie .	Karlsbadzie	13	Loc
W zeszłym roku w Cieszynie zawiązał się CKH i występował w naszej II lidze .	CKH	7	Nom
– Przyjedź szybko do Nowolipska .	Nowolipska	4	Gen
Wyprawa Magellana opłynęła wokół kulę ziemską .	Magellana	1	Gen
Ta sprawa wstrząsnęła całą Polską .	Polską	4	Ins
Wpadł na warszawskim Bemowie .	Bemowie	3	Loc
Gdyby kierownictwo ZUS zdecydowało się na Mercedesa lub BMW , to koszt jednego samochodu przekroczyłby 200 tys . nowych złotych .	Mercedesa	6	Acc
Zginęło wielu ochotników z Wielkopolski , między nimi 68 uczniów gimnazjum w Trzemesznie .	Trzemesznie	12	Loc
Jej nikt nie podskoczy , nawet w Babilonie .	Babilonie	7	Loc
Po zmianie stron między słupkami zabrzańskiej bramki stanął Tomasz Wronka .	Tomasz	8	Nom
Patrol saperski całą dobę dyżuruje w Kazuniu .	Kazuniu	6	Loc
Stilo to model środka gamy Fiata .	Fiata	5	Gen
Baltazar obojętnie naciągnął mu spodnie .	Baltazar	0	Nom
Odtąd w naszych zabawach już zawsze ja była m Siwym .	Siwym	9	Ins
Myślę , że pamiętał czasy Cezara .	Cezara	5	Gen
Naszego Piotrusia w zasadzie od początku fascynowały cienie .	Piotrusia	1	Acc
Czy chcę ich oboje z Cezarem obrazić , zapytała .	Cezarem	5	Ins
Przyjechał tu na Milkowszczyznę już jako doktor .	Milkowszczyznę	3	Acc
Przewodniczący Rady Państwa NRD Walter Ulbricht odwiedził Jugosławię .	Walter	4	Nom
Sekretarz generalny KPZR Leonid Breżniew odwiedził Bułgarię , Jugosławię i Węgry .	Bułgarię	6	Acc
Na ekranie TV , na zatrzymanej stop-klatce Jurka Kilera idą napisy końcowe programu .	Kilera	8	Gen
Podopieczni trenera Mirko Jozica obecnie przebywają na zgrupowaniu w Austrii .	Austrii	9	Loc
Chodź , poszukamy czegoś na Trzynachę .	Trzynachę	5	Acc
Jestem za ujawnieniem dokumentów IPN-u , niech każdy je oceni .	IPN-u	4	Gen
Bez przesady , nie jestem już tym , co wycierał się na Mazurach w pomarańczowy ręcznik .	Mazurach	12	Loc
Stałą obserwacją objęta jest ulica Bohaterów Warszawy od poczty głównej do placu Wolności .	Bohaterów	5	Gen
Czy w Kielcach uczył się w szkole rabinackiej i czy naprawdę był rabinem , jak zapewniał Fangora i inne osoby w Ameryce ?	Fangora	16	Acc
- Czy to prawda , że ty , Manahemie , posiadasz miecz Hyrkana ?	Hyrkana	12	Gen
– Martę znowu ogarnęła wściekłość .	Martę	1	Acc
Jeszcze mniej pewny jest los podstawówki w Klonowie .	Klonowie	7	Loc
Sekretarz generalny KPZR Leonid Breżniew odwiedził Bułgarię , Jugosławię i Węgry .	KPZR	2	Gen
Emil Drejtser urodził się w Odessie , wyemigrował do USA w 1974 roku .	Odessie	5	Loc
Nazwijmy ją Lady Iks .	Iks	3	Nom
- Ma dość ciemną skórę , ale chyba nie jest Murzynem ?	Murzynem	10	Ins
Mimo to może nie zobaczyć już syna , bo dziadkowie uprowadzili go na Ukrainę .	Ukrainę	13	Acc
Zwycięzcą biegu maratońskiego został 87-letni dziś Koreańczyk Ki - jung Son .	Koreańczyk	6	Nom
On mnie poznał z Jankiem Pospieszalskim .	Pospieszalskim	5	Ins
Niewytłumaczalna zbrodnia wstrząsnęła Polską .	Polską	3	Ins
Do jej udzielenia namawiał wiceprezydent Ciechanowa Jacek Kaczorowski .	Ciechanowa	5	Gen
Michał zaczął zmagać się z niewyraźnym pismem Marka .	Marka	7	Gen
- Stoimy nad Odrą , na odwiecznie polskiej , piastowskiej ziemi .	Odrą	3	Ins
Pierwsze brawa zebrał Bugaj polemizujący z Rakowskim .	Bugaj	3	Nom
Następnym mówcą będzie senator Marian Żenkiewicz .	Żenkiewicz	5	Nom
Jak dotychczas w Oxfordzie nie doszło do żadnych incydentów .	Oxfordzie	3	Loc
Choroba Ani zaczęła się niewinnie .	Ani	1	Gen
Zmieniłem Marka Walburga , bo rozbolał go żołądek i po prostu musiał szybko udać się do ubikacji .	Walburga	2	Acc
Brytyjczycy są więc dominującym udziałowcem w największym polskim towarzystwie emerytalnym .	Brytyjczycy	0	Nom
Oprócz słuchania Steczkowskiej delegaci zajmowali się dyskusją o strajku generalnym .	Steczkowskiej	2	Gen
O wrocławskim spotkaniu prezydentów Kwaśniewskiego i Chiraca oraz kanclerza Schrödera informowały wszystkie media .	Chiraca	6	Gen
Prokuratura Okręgowa w Krakowie , która prowadzi śledztwo w sprawie wycieku testów w 2000 r . , potwierdziła , że sprzedawano testy w cenach od kilkuset złotych do 15 tysięcy .	Krakowie	3	Loc
Hunt rozwinął z prawego przedramienia ledpad .	Hunt	0	Nom
W ręce izraelskich żołnierzy dostali się palestyńscy politycy związani z Hamasem .	Hamasem	10	Ins
Do pierwsze kolizji doszło przy ulicy Kolejowej w Szydłowcu .	Szydłowcu	8	Loc
Podobnie jak we współczesnej Japonii , również w Tybecie żywe są dawne herbaciane tradycje , chociaż przyczyny ich kultywowania są zgoła odmienne .	Japonii	4	Loc
Wczoraj piłkarze z Taszkientu dwukrotnie ćwiczyli na stadionie .	Taszkientu	3	Gen
Może byśmy tak załatwili Mafię wspólnie ?	Mafię	4	Acc
Na terenie przyległym do Kolonii Wierzbicy znajdują się dwie garbarnie .	Wierzbicy	5	Gen
Marta dyskretnie przyglądała się trójce młodych ludzi , którzy teraz opiekują się Polą .	Polą	12	Ins
Dziesięciu jeźdźców pokonuje trasę z Torunia do Pucka .	Torunia	5	Gen
Przerwali terapię we Mstowie i w krótkim czasie zmarli z powodu narkotycznego przedawkowania .	Mstowie	3	Loc
Sędzią Krzysztofem O . interesuje się także Instytut Pamięci Narodowej .	Krzysztofem	1	Ins
Le Pen straszy zjednoczoną Europą .	Europą	4	Ins
– Mieliśmy listę Wildsteina , teraz wypłynęła tak zwana lista 500 , o której istnieniu poinformował prezes IPN Janusz Kurtyka .	Janusz	18	Nom
Wstępna analiza Inspektoratu wskazuje , że sąd w Jeleniej Górze nie jest przystosowany do procesów , w których oskarżonymi są członkowie zorganizowanych grup przestępczych .	Górze	9	Loc
Indie stanowczo zaprzeczają .	Indie	0	Nom
Rekord należy do Wojciecha Zabłockiego , który uczestniczył we wszystkich turniejach .	Wojciecha	3	Gen
Już we wtorek prezydent Kwaśniewski wybiera się z roboczą wizytą do Paryża , by przekonywać do naszych racji prezydenta Jacquesa Chiraka .	Chiraka	20	Acc
Tatry są bezlitosne .	Tatry	0	Nom
Na scenie bez przerwy prezentowały się zespoły młodzieżowe z Reska , Szczecina , Polic i Wolina .	Reska	9	Gen
Dobrze spisała się młodzież w Sterdyni , Ceranowie , Skrzeszynie , Czerwonce i Wężach .	Wężach	13	Loc
On pisał odę do Matki - Syberii .	Syberii	6	Gen
Niestety w Biblii nie ma nic o żadnych książeczkach .	Biblii	2	Loc
Maria Fryc została przewieziona do szpitala .	Fryc	1	Nom
Aby pozbyć się niespokojnego ducha z Apulii , Onufry wysłał Roberta do Kalabrii .	Apulii	6	Gen
Specjalnie podesłałeś mi Celińskiego .	Celińskiego	3	Acc
Kilkaset wagonów z ładunkami przychodzi codziennie na stację kolejową w Lublinie .	Lublinie	10	Loc
A do Azji Polski przenieść się nie da .	Azji	2	Gen
Zanim wiązanki kwiatów przykryły mogiłę , słowa modlitwy prowadzonej przez ks . Pawła Dorucha splatały się z wyrazami bólu i wspomnieniami przyjaciół .	Pawła	12	Acc
Rykiert wahał się przez moment , potem odwrócił się i zaczął uciekać .	Rykiert	0	Nom
Decyzja zapadła , mimo że szefowie tajnych służb ostrzegli , iż Palestyńczycy wyjdą na ulice .	Palestyńczycy	11	Nom
Trzymiesięczne owczarki niemieckie pochodzą z wyspecjalizowanej hodowli ze Słowacji .	Słowacji	8	Gen
Może dlatego Frasyniuk zmienia swój image ?	Frasyniuk	2	Nom
Wczoraj o godz . 2 rano policjanci ruszyli pod posiadłość przestępcy w Białce na Pomorzu .	Białce	12	Loc
W roku 1912 Olga w związku z kolejną przygotowującą się pod jej nieobecność wystawą zasięgnęła rady Sainsèrea przy wyborze obrazów .	Olga	3	Nom
Dowódca sił amerykańskich w Afganistanie generał Tommy Franks zapowiedział kolejne operacje lądowe .	Afganistanie	4	Loc
Wysiadła na zakręcie przed Hagen .	Hagen	4	Ins
Ogonowski i Latusek tłumaczyli , że właśnie znaleźli zastrzelone zwierzę .	Latusek	2	Nom
Po wypiciu wódki i wina również inni schodzili na dół , bo widział em na schodach i pana Jaworka , i pana Napiórkowskiego .	Jaworka	18	Acc
Zadzwonimy do Patrycji . . .	Patrycji	2	Gen
W sobotnią noc na parkingu dyskoteki w Nowych Bielicach uszkodzono dwa samochody .	Bielicach	8	Loc
Niemcy wyrzucają z mieszkania Konstantego Prusa .	Konstantego	4	Acc
Ze Stanisławem Łangowskim , prezesem Zarządu Powiatowego Platformy Obywatelskiej , rozmawialiśmy w ubiegły czwartek .	Łangowskim	2	Ins
40-osobowa grupa chuliganów wywołała rozróbę przed sobotnim III-ligowym meczem piłki nożnej Lublinianki z Cracovią .	Lublinianki	11	Gen
Może warto odkryć Amerykę .	Amerykę	3	Acc
Wędrował po Tatrach od 1914 r. , wspinał się od 1924 .	Tatrach	2	Loc
no znam trochę Ukrainę .	Ukrainę	3	Acc
Sophią Loren raczej nigdy nie będzie .	Loren	1	Ins
Surowy , suchy klimat , huraganowe wiatry oraz nieurodzajność gleb spowodowały , że odkryta w 1520 roku przez Magellana Patagonia długo nie była kolonizowana przez Europejczyków .	Europejczyków	25	Acc
Widać , że gabinet Millera stopniowo traci kontakt z rzeczywistością .	Millera	4	Gen
Wystawa w Tel Awiwie przyciągnęła ponad 5 tysięcy zwiedzających , pokazano ją we wszystkich izraelskich telewizjach , pisały o niej wszystkie gazety .	Tel	2	Loc
Topielec zobaczył jakiś ruch w tej martwocie .	Topielec	0	Nom
- Czy chce otrzymać azyl w Danii ?	Danii	6	Loc
Wardziński brał Santa Anę !	Anę	3	Acc
Moczarskiego znał em sprzed wojny , byli śmy razem w Wyższej Szkole Dziennikarskiej , dość zaprzyjaźnieni .	Moczarskiego	0	Acc
- Prokuratura stołeczna równolegle z UOP wszczęła śledztwo w sprawie przecieków .	UOP	5	Ins
Teodor podniósł się z fotela .	Teodor	0	Nom
Na Ukrainie i Białorusi została już częściowo odtworzona struktura administracji kościelnej .	Ukrainie	1	Loc
Bo ja dawno tak nie czekała m na coś w tv .	tv	10	Loc
W czasach Demokryta panował jeszcze inny pogląd na nicość materialną , który nazwę potocznym .	Demokryta	2	Gen
Nasz artykuł o zakupie przez wojsko kurtek dla pilotów od firmy kierowanej przez Bogusława Bagsika spowodował kontrolę Najwyższej Izby Kontroli .	Bogusława	13	Acc
Studiują tutaj Łukasz Kruczek , Grzegorz Śliwka , Krystian Długopolski , teraz obok mnie studentem został Tomek Pochwała .	Długopolski	9	Nom
Romek stanął przed nim w postawie na baczność .	Romek	0	Nom
Jednocześnie policja poinformowała , że w różnych częściach stolicy Iraku odnaleziono 10 ciał mężczyzn .	Iraku	9	Gen
Może by śmy tak załatwili Mafię wspólnie ?	Mafię	5	Acc
Jak poinformował Cesar Fraga z Uniwersytetu w Buenos Aires , przeprowadzone tam badania wykazały , że czekolada wzmacnia antyutleniacze znajdujące się we krwi , zwiększając odporność na zaburzenia serca i naczyń wieńcowych .	Buenos	7	Loc
Wcześniej za największe osiągniecie uważał dwukrotne zwycięstwo w Memoriale Zakrzewskiego w Kędzierzynie-Koźlu .	Zakrzewskiego	9	Gen
Hill startował z pole position , ale już na pierwszych metrach wyprzedził go kolega z zespołu David Coulthard .	David	16	Nom
50.000 złotych kosztowała modernizacja ul . Hallera w Lubiewie .	Hallera	6	Gen
- Na razie przedstawiciele SLD spotkali się z Jerzym Buzkiem .	Buzkiem	9	Ins
Trzemeśnianka zaczyna swą drogę u podnóża Kamiennika .	Kamiennika	6	Gen
W 2004 Jabil wszedł w posiadanie fabryki telewizorów w Kwidzynie .	Kwidzynie	9	Loc
Widownia westchnęła ze współczuciem , a Iwana to uskrzydliło .	Iwana	6	Acc
- Nie jedź do Jerozolimy !	Jerozolimy	4	Gen
Oskarżano nas , że w Bielicznej sprzedali śmy prywatnemu nabywcy kilkaset hektarów wraz z cmentarzem i cerkwią .	Bielicznej	5	Loc
W Zborowie powstał obiekt o powierzchni użytkowej 3364 metrów kwadratowych , w którym zamieszka 50 osób .	Zborowie	1	Loc
Kozubek wysyła Anglikom koronkową bieliznę .	Kozubek	0	Nom
Dostrzegł podporucznika Kowalika , skinął mu porozumiewawczo głową .	Kowalika	2	Acc
Franciszek Aromiński zawiadomił o wszystkim prokuraturę .	Aromiński	1	Nom
Adam wygrał ostatni etap , w lutym .	Adam	0	Nom
Siedzibą tej parafii jest usytuowany przy skrzyżowaniu ulicy Zamoyskiego i Sabały nowoczesny kościół Świętego Krzyża .	Sabały	10	Gen
Jeszcze w ub.r . wstrzymywanie pieniędzy na nowe emisje akcji przypominało czekanie na Godota .	Godota	13	Acc
Ta zbrodnia wstrząsnęła Polską .	Polską	3	Ins
Radni powiatowi z Nowogródka zdecydowali wczoraj , że w rodzinnym mieście Adama Mickiewicza nie będzie polskiej szkoły .	Mickiewicza	12	Gen
Nad Halberdą nie rozpiął parasola .	Halberdą	1	Ins
Największy na świecie producent sieci komórkowych zamierza skupić się na podstawowej działalności , a aparaty będzie kupował od producenta zewnętrznego z siedzibą w Singapurze i tylko sygnował je własnym znakiem towarowym .	Singapurze	23	Loc
Zatrzymali śmy się także na jeden dzień w Bourges , a stamtąd pojechali śmy już do Niemiec .	Bourges	8	Loc
Rekord należy do Wojciecha Zabłockiego , który uczestniczył we wszystkich turniejach .	Zabłockiego	4	Gen
Kira też zobaczyła to , co chciała .	Kira	0	Nom
W świecie nauki początek jesieni to emocje towarzyszące Nagrodom Nobla .	Nobla	9	Gen
Zajmowały się tym już Zofia Korczak - Blatonowa i Aniela Cieszkowska .	Aniela	9	Nom
W ten sposób Rumuni wystąpili w roli głównego mediatora pomiędzy Moskwą a Pekinem .	Rumuni	3	Nom
Mateo mieszka na Elbie , gdzie latem wynajmuje turystom motorówki .	Elbie	3	Loc
Władze samorządowe wystąpiły już z pozwem do sądu w Warszawie .	Warszawie	9	Loc
Zaangażowała się w Teatrze Dramatycznym kierowanym wówczas przez Gustawa Holoubka .	Gustawa	8	Acc
W tym roku w Kolnie w wyborach prezydenckich wygrał Lech Kaczyński .	Kolnie	4	Loc
Wikary Pudło odprawia je żując gumę .	Pudło	1	Nom
VIII Zjazd Inżynierów Mechaników Polskich obradował w Katowicach pod hasłem zbiorowego wysiłku myśli i pracy nad aktualnymi zagadnieniami technicznymi , mającego na celu rozwój techniki polskiej .	Katowicach	7	Loc
Pałęczkę przejęła Ciri .	Ciri	2	Nom
W słowackich Tatrach piorun uderzył w parę polskich turystów .	Tatrach	2	Loc
Innym razem pojechała z Kaharem do portu Xiamen na południu Chin , gdzie kupili trzy japońskie magnetowidy .	Chin	10	Gen
Agnieszka Strumiłowska opowiedziała mi historię z jej czasów studenckich .	Strumiłowska	1	Nom
– Pixy się roześmiał .	Pixy	1	Nom
CZY WARTO PISAC O INGEMARZE STENMARKU ?	STENMARKU	5	Loc
W rozległej przestrzeni czyśćca spotyka po raz pierwszy Beatrycze .	Beatrycze	8	Acc
Płonącą Warszawę widać było z dużej odległości .	Warszawę	1	Acc
Zaproszenie Gadowskiego i jego muzyków było jej inicjatywą .	Gadowskiego	1	Gen
Krysia pociągnęła nosem i zaśmiała się .	Krysia	0	Nom
Leci z Milwaukee do Pekinu na chiński Nowy Rok .	Rok	8	Acc
Po rzucie rożnym obrońcy Vardaru zbyt wolno wychodzili spod swojej bramki , podanie z linii pola karnego dotarło do Kucharskiego , a ten strzelił , stojąc tyłem do bramki .	Kucharskiego	19	Gen
Yennefer opuściła głowę , spojrzała między swoje uda , nad którymi przemykały złote rybki .	Yennefer	0	Nom
Za Wankiewiczem ja sam głosował em .	Wankiewiczem	1	Ins
De Gaulle w tych dniach pozyskał Francję .	Francję	6	Acc
Niektóre sale pałacyku w Karolinie przeznaczono na małe muzeum .	Karolinie	4	Loc
Ideą konkursu jest propagowanie kultury polskiej na Wschodzie .	Wschodzie	7	Loc
Dankowski objął Bełchatów na początku sezonu , a pierwszej porażki doznał dopiero w siódmej kolejce .	Bełchatów	2	Acc
Sprawy zasadnicze to niemiecka marka i Europa .	Europa	6	Nom
Jedziemy do Havru , ten stary kozioł płaci .	Havru	2	Gen
- Czy może pan Lehmann ma dzisiaj urodziny ?	Lehmann	4	Nom
Sam nie mógł pojechać do Poznania .	Poznania	5	Gen
W środę do Jana Kwiatkowskiego , wujka Adama , zadzwonili policjanci z sekcji kryminalnej w Legionowie .	Legionowie	15	Loc
Natomiast Rada Państwa NRD podjęła decyzja podpisania układu .	NRD	3	Gen
Wsparł go Wierchowicz .	Wierchowicz	2	Nom
Działo się to podczas dochodzenia do nabrzeża w Ystad .	Ystad	8	Loc
Steve zaklina się , że po każdym dyżurze szykuje ekstra posiłek czworonożnemu ratownikowi .	Steve	0	Nom
Jedną pustą wmurowano między epitafiami porucznika Ludwika Ratajczaka i majora Leona Recheńskiego .	Ratajczaka	7	Gen
Większość skradziono w Berlinie , Hamburgu , Kilonii i Bremie .	Kilonii	7	Loc
Przypomnijmy , że 16 lipca 1994 r . dziadkowie półtorarocznej wówczas Moniki zostawili ją przed legnicką apteką pod opieką ojca , Roberta Bielawskiego .	Bielawskiego	22	Gen
Akcję sprawozdawczo - wyborczą w pracowniczych ogrodach działkowych zakończy ogólnopolska konferencja delegatów wybranych na zjazdach wojewódzkich POD , która będzie obradowała w maju w Warszawie .	Warszawie	24	Loc
Gen . Wróblewski jest kwatermistrzem Warszawskiego Okręgu Wojskowego .	Wróblewski	2	Nom
Karl jest bardzo gościnny .	Karl	0	Nom
Co dziś robią ludzie z GTW ?	GTW	5	Gen
Później współpracowali z Szewardnadze , strzegąc jednak zazdrośnie swojej sfery wpływów .	Szewardnadze	3	Ins
Zdążyli dojechać do Knurowa .	Knurowa	3	Gen
Zdyszany , wyprężył się przed Dziadoniem .	Dziadoniem	5	Ins
Ale pięć lat temu tryumfował Aleksander Kwaśniewski .	Kwaśniewski	6	Nom
Zajmowały się tym już Zofia Korczak - Blatonowa i Aniela Cieszkowska .	Blatonowa	7	Nom
Widawska pochodzi z Kalisza .	Kalisza	3	Gen
Najlepiej to widać w zlewni Przemszy na Górnym Śląsku .	Przemszy	5	Gen
40-osobowa grupa chuliganów wywołała rozróbę przed sobotnim III-ligowym meczem piłki nożnej Lublinianki z Cracovią .	Cracovią	13	Ins
Obecny był kierownik Wydziału Prasy , Radia i Telewizji KC PZPR Kazimierz Rokoszewski .	Rokoszewski	12	Nom
Wioślarzom AZS przybył nowy konkurent .	AZS	1	Gen
Uczestnicy zjazdu wypili wodę święconą z kościoła Najświętszego Zbawiciela .	Zbawiciela	8	Gen
W egzekucjach przeprowadzonych w Miednoje , Charkowie i Katyniu zabito 15 tys . polskich oficerów .	Charkowie	6	Loc
Już w 15 . minucie Stal objęła prowadzenie po strzale Grecha .	Grecha	10	Gen
Prezydenci Polski , Ukrainy i Rumunii spotkali się na roboczych rozmowach w Bukareszcie .	Bukareszcie	12	Loc
Arcybiskup Ochrydy przypisuje Borysowi także i inne cechy , które wzbogacają jego wizerunek .	Ochrydy	1	Gen
Z całego nakładu książki Witkacego wycięto stronę przedtytułową .	Witkacego	4	Gen
Ţe przyszła . . .	Ţe	0	Nom
Z dziedzińca koszar pułkownik Ahlberg obserwował przez lornetkę aeroplan .	Ahlberg	4	Nom
W 1938 roku po raz pierwszy przyjechał do Narviku major Vidkun Quisling .	Narviku	8	Gen
Wyciągał jedynie wnioski z obszaru i potencjału państwa rosyjskiego twierdząc , że dwa mocarstwa , Rosja i Ameryka , określać będą przyszłość świata .	Rosja	15	Nom
Odpowiedziałeś posługując się sztandarowym obok Białorusi argumentem .	Białorusi	5	Gen
Początkowo chcieli wywieźć je nad Wisłę .	Wisłę	5	Acc
Oprócz Warszawy , gość odwiedzi także Kraków oraz Gdańsk .	Kraków	6	Acc
- Paul aż podskoczył na krześle .	Paul	1	Nom
Został em Żydem .	Żydem	2	Ins
Za słabo garbowano Musze skórę w Gross Rosen .	Rosen	7	Loc
Na pastwisku w Uniszkach Gumowskich rolnik załadował na dwukółkę krowę .	Uniszkach	3	Loc
Do wypadku doszło na drodze z Gilwy do Prabut .	Gilwy	6	Gen
Tutaj zamieszkał Józio .	Józio	2	Nom
Policjanci i prokuratorzy potwierdzają , że ostatnio liczba wyłudzeń VAT-u i subwencji lawinowo wzrosła .	VAT-u	9	Gen
Jej program układał radca handlowy ambasady RP w Rzymie .	Rzymie	8	Loc
Tamtędy płynie Stobrawa .	Stobrawa	2	Nom
Jakubowski ciężko westchnął .	Jakubowski	0	Nom
Rzecznik Białego Domu odmówił jednak ich podania , informując tylko , że dowody zostaną przekazane inspektorom ONZ w Iraku .	Iraku	18	Loc
Dobiszewski nie pamięta .	Dobiszewski	0	Nom
Martha Kosicky ma blond włosy i dziadka z Polski .	Kosicky	1	Nom
Brak drapaczom na Ś-W zaplecza w postaci sklepów spożywczych .	Ś-W	3	Loc
- A więc Leszek Balcerowicz odniósł już zwycięstwo ?	Balcerowicz	4	Nom
Angelika przystąpi do komunii w kościele w Dytmarowie .	Angelika	0	Nom
Informacje na temat historii zen i różnych szkół znajdzie Czytelnik w chronologicznym zestawieniu najważniejszych wydarzeń z historii zen w Chinach i Japonii .	Chinach	19	Loc
W Olsztynie pod drzwiami szpitalnymi zmarły ostatnio dwie osoby .	Olsztynie	1	Loc
NBP OBNIŻYŁ o 4 punkty procentowe stopę swoich kredytów .	NBP	0	Nom
Rano Saszka zapukał do drzwi .	Saszka	1	Nom
Na scenie bez przerwy prezentowały się zespoły młodzieżowe z Reska , Szczecina , Polic i Wolina .	Polic	13	Gen
Andrzej Chronowski , dotychczasowy minister skarbu , złożył wczoraj dymisję na ręce premiera .	Chronowski	1	Nom
Ma on być gościem prezydenta Saragata .	Saragata	5	Gen
- I zupełnym przypadkiem trafił eś na Jacka Kuronia .	Jacka	7	Acc
- Mila jest do mnie podobna .	Mila	1	Nom
Ale dla Serbów Kosowo ma olbrzymią wartość emocjonalną , to kolebka ich państwowości .	Kosowo	3	Nom
Partnerami Ukraińców byli Szwajcarzy , czyli Duferco .	Duferco	6	Nom
Moda na École de Paris niewątpliwie zasłużenie dowartościowała to środowisko artystyczne , ale w przypadku niektórych nazwisk także przewartościowała .	Paris	4	Acc
Dlatego część historyków fińskich kwestionuje badania Silvennoinena , zarzucając mu pogoń za sensacją .	Silvennoinena	6	Gen
Polska i Izrael podpisały wczoraj umowę o zniesieniu obowiązku wizowego .	Izrael	2	Nom
Ci ostatni liczyli na głosy Lecanueta w drugiej turze .	Lecanueta	5	Gen
Tragiczny wypadek zdarzył się na trasie kolejowej z Piły do Chojnic .	Chojnic	10	Gen
– Mieliśmy listę Wildsteina , teraz wypłynęła tak zwana lista 500 , o której istnieniu poinformował prezes IPN Janusz Kurtyka .	Kurtyka	19	Nom
Bawiąc się w salonie z Jurkiem Łobzowskim , zaczepił em kiedyś rękawicą bokserską o lep na muchy .	Jurkiem	5	Ins
Druga kwestia zajmowała Sinego jeszcze bardziej .	Sinego	3	Acc
Reputację intelektualisty potwierdził , cytując obficie Witolda Gombrowicza i Stanisława Jerzego Leca .	Leca	11	Acc
Wystawa w Tel Awiwie przyciągnęła ponad 5 tysięcy zwiedzających , pokazano ją we wszystkich izraelskich telewizjach , pisały o niej wszystkie gazety .	Awiwie	3	Loc
Widziałem , jak wielka epidemia uderzyła w Hongkong .	Hongkong	7	Acc
Zaczęła opowiadać o Marii .	Marii	3	Loc
Finansowo wspiera Trutnia Gminny Ośrodek Kultury w Rabie Wyżnej , a także skawiańscy biznesmeni z Polski i Chicago .	Rabie	7	Loc
Dlatego władze w Pekinie już dawno były gotowe wypuścić Weia na Zachód .	Weia	9	Acc
Harcerze zbierają niepotrzebne rowery , aby po naprawie przekazać je Domowi Dziecka w Kórniku-Bninie .	Kórniku-Bninie	13	Loc
W pobliżu granicy Kosowa z Albanią zginęło w walkach z serbskimi żołnierzami co najmniej ośmiu albańskich separatystów .	Albanią	5	Ins
Kompromitowali nie tylko siebie , ale i Polskę .	Polskę	7	Acc
Potem toksyczne resztki trafiały pod Brześć .	Brześć	5	Acc
CZY WARTO PISAC O INGEMARZE STENMARKU ?	INGEMARZE	4	Loc
Szumigaj wyjechał .	Szumigaj	0	Nom
Z początkiem wojny przenosi się do dworku w Krzykawce .	Krzykawce	8	Loc
Amerykanie wzięli La Haie du Puy .	Haie	3	Acc
IV Zjazd Absolwentów Liceum Ogólnokształcącego odbył się w sobotę w Tucholi .	Tucholi	10	Loc
Oglądała niedawno coś takiego na TVP Kultura .	TVP	5	Loc
Skomplikowany zabieg przeprowadzono w jednej z klinik w Szanghaju .	Szanghaju	8	Loc
Jej nikt nie podskoczy , nawet w Babilonie .	Babilonie	7	Loc
Ślizgawki w Dąbrowie Górniczej odbywają się już od 4 lat .	Dąbrowie	2	Loc
Jeszcze większe oszczędności będą w Krakowie .	Krakowie	5	Loc
W piątek życzenia od przedstawicieli władz miejskich , kolejowych i zaproszonych gości odebrał dyrektor ZSET Kazimierz Maćkowiak .	ZSET	14	Gen
- Więcej powiedzą wam Kuba i Rudek .	Rudek	6	Nom
W ataku grali Michalis Konstantinou i Nikos Liberopoulos .	Konstantinou	4	Nom
Jednocześnie z Dingiem wychylił głowę , spoglądając ciekawie za załom parowu .	Dingiem	2	Ins
– Zidentyfikował z uśmiechem suknię , kupioną w salonie Coco Chanel .	Coco	9	Gen
Na klatce schodowej domu u zbiegu Alei Jerozolimskich i Nowego Światu skoczył z wysokości trzeciego piętra .	Światu	10	Gen
- Ruski przerzucił się na Turcję .	Turcję	5	Acc
Na placu Wolności wisiało jeszcze wtedy kilka plakatów , zachęcających do głosowania na Tadeusza Zwiefkę .	Zwiefkę	14	Acc
Stąd też wziął się pomysł zorganizowania strzelnicy sportowej w Łukowie .	Łukowie	9	Loc
Spekulowano nawet , że odejdzie z partii wraz z Jurkiem .	Jurkiem	9	Ins
Wiem tylko , że jego żona jeszcze w Nowym Jorku zdecydowała się wrócić z synem do kraju .	Nowym	8	Loc
Po odparciu ataku i ujęciu 10 terrorystów zawrócono konwój do bazy w Al Kut .	Kut	13	Loc
Na zakończonym wczoraj w Paryżu kongresie FPK przyjęto 1080 głosami przeciw 43 centrowy program szefa partii Roberta Hue .	Hue	17	Gen
Rzecznik australijskiego koncernu Chris Codrington wyraził przekonanie , że przyczyną zatrucia wód Cisy nie był cyjanek .	Chris	3	Nom
Tylko w minioną sobotę w atakach terrorystycznych w Bagdadzie zginęło ponad 40 osób .	Bagdadzie	8	Loc
W latach sześćdziesiątych , już jako sztygar oddziałowy , pamiętam odbiory przygotowywanych do rozruchu ścian dokonywane przez dyrektora Śniegonia .	Śniegonia	18	Acc
- W Krzyczkach leży jeszcze kilkadziesiąt zakopanych psów .	Krzyczkach	2	Loc
- Zadurzył eś się w Fantastyczce .	Fantastyczce	5	Loc
Można wysłać SMS-a , e-maila lub połączyć się z Internetem .	Internetem	9	Ins
Tak orzekł wczoraj niemiecki Trybunał Federalny w Karlsruhe .	Karlsruhe	7	Loc
W ten sposób poznała m Wojtka Ligotę .	Ligotę	6	Acc
Później innego uczestnika spotkania znaleziono martwego w jego domu letniskowym pod Belgradem .	Belgradem	11	Ins
- Z Lechowskim i Szamockim jest kiepsko .	Szamockim	4	Ins
Uśmiecha się do Hugona .	Hugona	3	Gen
W Pikardii ewakuowano 700 osób , woda zalała ponad 1800 domów .	Pikardii	1	Loc
Było jeszcze wtedy w granicach typowych dla Tadzia .	Tadzia	7	Gen
To był dla Orlenu za dobry interes .	Orlenu	3	Gen
– no zapraszała mnie tam Kalińska .	Kalińska	5	Nom
Składa się na ń obecnie pięć pierwszych ksiąg Biblii .	Biblii	8	Gen
I tym razem Gagarin zniósł ją ze stoickim spokojem .	Gagarin	3	Nom
Gospodarstwo Stanisławy Sowy , Irki Paulako i Moniki Niebrzydowskiej rozszerza się powoli poza obręb zabudowań gospodarskich .	Stanisławy	1	Gen
Fajny jest Pętal .	Pętal	2	Nom
W USA jest szpital , który chce Łukasza ratować .	Łukasza	7	Acc
Grób Petuli zdobi wrzos .	Petuli	1	Gen
Mieszkamy w Kuźni Raciborskiej .	Kuźni	2	Loc
Potwierdził to prezydent Jiang podczas niedawnego spotkania z prezydentem Clintonem .	Jiang	3	Nom
Nasz artykuł o zakupie przez wojsko kurtek dla pilotów od firmy kierowanej przez Bogusława Bagsika spowodował kontrolę Najwyższej Izby Kontroli .	Bagsika	14	Acc
Jak poinformował Cesar Fraga z Uniwersytetu w Buenos Aires , przeprowadzone tam badania wykazały , że czekolada wzmacnia antyutleniacze znajdujące się we krwi , zwiększając odporność na zaburzenia serca i naczyń wieńcowych .	Aires	8	Loc
Rosemarie wznosi kieliszek .	Rosemarie	0	Nom
Najciekawiej zapowiada się w Moskwie , gdzie miejscowy Spartak podejmuje Ajax Amsterdam .	Amsterdam	11	Acc
Ta przekazała sprawę do PW w Lesznie .	Lesznie	6	Loc
Szef Polsatu zapowiedział , że złoży dziś do NSA wniosek o zmianę postanowienia .	Polsatu	1	Gen
Pawłowi M . zarzuca się również , że działał z zamiarem spowodowania ciężkiego kalectwa rzucając nożem w głowę włoskiego piłkarza Dino Baggio .	Baggio	21	Gen
Potem polski papież zostałby w Watykanie kanonizowany .	Watykanie	5	Loc
W poniedziałek rano do Betlejem i Kalkilli na Zachodnim Brzegu Jordanu wjechały izraelskie czołgi .	Jordanu	10	Gen
Regina z ciekawością słuchała czytającego z kartki Bornsteina .	Bornsteina	7	Gen
Wzięła urlop i pojechała do Zbyszka .	Zbyszka	5	Gen
Młodzi zamieszkali na ul . Chrobrcgo .	Chrobrcgo	5	Gen
Agnus wyjaśnił , że czeka na jej ojca .	Agnus	0	Nom
I przez ten rok chodzić do AA przynajmniej trzy razy w tygodniu .	AA	6	Gen
Spała , Wałcz czy Cetniewo są od dawna ośrodkami na najwyższym europejskim poziomie .	Spała	0	Nom
Karlik oddychał ciężko .	Karlik	0	Nom
Przejazd we wrocławskich Świniarach nie jest strzeżony .	Świniarach	3	Loc
Ciotka nie przysyłała dolarów , ciotka brodatego syna Cybucha rozwijała świadomość .	Cybucha	8	Gen
Po chwili na tyłach trafiki Krziwaniego pozostali jedynie Sorg i Smolorz .	Krziwaniego	5	Gen
W 1917 r. przeprowadza się wraz z matką do Bolesławia .	Bolesławia	9	Gen
Talent dramatopisarski Kisielewskiego wypowiedział się w zasadzie w tych dwóch sztukach młodzieńczych .	Kisielewskiego	2	Gen
– Ela chciała Sabę . .	Sabę	3	Acc
W okolicach Ełku i Giżycka nie pracują 3 linie .	Giżycka	4	Gen
- Dużo o tym pisał Antoni Słonimski , mój stryj .	Słonimski	6	Nom
Soso namyślał się .	Soso	0	Nom
- Wstydź się , Zuzanno , tak kłamać , zapłacił ci za Jadzię .	Jadzię	12	Acc
I zrozumieli ludzie , że tu Bóg był , i zburzyli ten sądowy dom , aby w nim nikt już więcej po Panu Jezusie nie sądził , a przed jabłonnymi drzewami postawili krzyż i on do dziś tam stoi .	Jezusie	23	Loc
Reputację intelektualisty potwierdził , cytując obficie Witolda Gombrowicza i Stanisława Jerzego Leca .	Stanisława	9	Acc
W Wielkopolsce brakuje 300 gliniarzy .	Wielkopolsce	1	Loc
Na jego otwarcie zjechali się przedstawiciele PSP w Warszawie , władze gminne , powiatowe oraz państwowe .	PSP	6	Gen
Główne dowództwo niemieckie musi objąć kierownictwo operacji wojennych we Włoszech .	Włoszech	9	Loc
Michał od początku ubóstwiał ojca .	Michał	0	Nom
- Poseł Janusz Wójcik sam zrzeknie się immunitetu .	Wójcik	3	Nom
Politycy opozycji poinformowali również , że zamierzają złożyć do Trybunału Konstytucyjnego wniosek w sprawie niekonstytucyjności ustawy o ABW i AW .	ABW	17	Loc
Kościański zespół przegrał je wszystkie za wyjątkiem derbowego występu w Rawiczu .	Rawiczu	10	Loc
Chodziło oczywiście o kontakty ściśle naukowe , ale umożliwiły one później wysłanie jezuity , astronoma , do Chin .	Chin	17	Gen
Walkom rewolucyjnym towarzyszyły klęski rosyjskie na Dalekim Wschodzie w wojnie z Japonią .	Japonią	11	Ins
Z Jackiem Kuroniem współpracowali śmy i nadal współpracujemy .	Kuroniem	2	Ins
Na jego otwarcie zjechali się przedstawiciele PSP w Warszawie , władze gminne , powiatowe oraz państwowe .	Warszawie	8	Loc
Sophią Loren raczej nigdy nie będzie .	Sophią	0	Ins
W Stanach istnieje taka zasada , że pracownik naukowy uniwersytetu może raz na trzy lata startować w konkursie na innej uczelni .	Stanach	1	Loc
Po zakończeniu kariery Perry rok w rok komentował Wimbledon .	Wimbledon	8	Acc
Borys Conrad , syn znakomitego pisarza Józefa Conrada - Korzeniowskiego przybył do Warszawy .	Korzeniowskiego	9	Gen
– Talar akurat skłócił tam tych ludzi .	Talar	1	Nom
Kaźmierz oddał stryjowi latarnię ; na ziemi położył podłużny wąski przedmiot .	Kaźmierz	0	Nom
Pontyfikat Piusa XII trwał 7152 dni .	Piusa	1	Gen
Była teściową Juergena Fuchsa .	Juergena	2	Gen
- W 1299-tym nadał Nakłu prawa miejskie mały drobny Król Łokietek , a Dzielny Krzywousty w 12-tym wieku narobił w Nakle kapusty !	Łokietek	10	Nom
Karolina spuściła głowę .	Karolina	0	Nom
Wyzwanie rzuci mu senator Jacek Bachalski .	Jacek	4	Nom
Specjaliści z Centralnej Agencji Wywiadowczej mają już świadka , który widział zamachowców na kilka minut przed eksplozją w Nairobi .	Nairobi	18	Loc
Ostatecznie ten przemysł został stworzony przez Europejczyków .	Europejczyków	6	Acc
Zebrali śmy się u Nocnego Śpiewaka .	Śpiewaka	5	Gen
– Mieliśmy listę Wildsteina , teraz wypłynęła tak zwana lista 500 , o której istnieniu poinformował prezes IPN Janusz Kurtyka .	Wildsteina	3	Gen
Regulaminowe decyzje , po wnikliwej analizie protokołu z tego pojedynku , podejmie Wydział Dyscypliny BOZPN .	BOZPN	14	Gen
Dlatego władze w Pekinie już dawno były gotowe wypuścić Weia na Zachód .	Pekinie	3	Loc
Zaraz potem , bez żadnych ceregieli , skoczyła Filomena .	Filomena	8	Nom
Brazylijczyk , dwukrotny zwycięzca wielkoszlemowego Roland Garros , podkreślał przed spotkaniem , że najważniejszym elementem piątkowej potyczki będzie skuteczna gra przy własnym serwisie .	Brazylijczyk	0	Nom
Dzień później trener Bogdan Pamuła zabrał swoich podopiecznych , tym razem pod sztandarem juniorskim , na mecz do Przemyśla .	Pamuła	4	Nom
Mao stał się na wiele lat przywódcą największego narodu na kuli ziemskiej .	Mao	0	Nom
Odnalazł Jaskra , kibicującego łupiącym w gwinta krasnoludom .	Jaskra	1	Acc
Nie wspomniał , że idzie o zatrudnienie w lokalu nocnym Turka .	Turka	10	Gen
Siadam w kącie i usypiam , budząc się na Gare du Nord .	Gare	9	Loc
Bartodziej kładzie się na leżance .	Bartodziej	0	Nom
Symbolizują zmienną fortunę i uzasadniają nawoływania do stoickiego znoszenia dopustów losu albo chrześcijańskiej ufności w Bogu .	Bogu	15	Loc
- A jeszcze niedawno mówiłeś o pani Gronkiewicz tak ciepło .	Gronkiewicz	7	Loc
Ułożył je ks. Wawrzyniec Beniok w 1707 roku .	Beniok	4	Nom
Malwina spojrzała na niego z odrazą , Kulesza się zaczerwienił , ale Ewa , o dziwo , parsknęła śmiechem .	Kulesza	7	Nom
Ukląkłem przy Mateuszu i szybko wcisnąłem mu woreczek do ręki .	Mateuszu	2	Loc
Amerykańską ambasadę reprezentował konsul Knitte .	Knitte	4	Nom
Później był jeszcze Pewex .	Pewex	3	Nom
Czy naprawdę był by m jej coś zrobił za Zucha ?	Zucha	9	Acc
Proszę zobaczyć , ilu posłów AWS nie głosowało .	AWS	5	Gen
Wilczyński nadal był zdziwiony , ale pokiwał głową .	Wilczyński	0	Nom
Za słabo garbowano Musze skórę w Gross Rosen .	Gross	6	Loc
Nie zostałam więc działaczką PiS , ulubienicą Kaczyńskich i ich matki , doradczynią w PKO BP ani prezeską TVP .	PKO	14	Loc
Przygryzając wargi z bezsilnej złości , Chmura wołał Adasia .	Adasia	8	Acc
Pomiaukując alarmująco , zaprowadził Adama do dużego pokoju .	Adama	4	Acc
Ulewne deszcze nawiedziły także Słupsk .	Słupsk	4	Acc
Niewytłumaczalna zbrodnia wstrząsnęła Polską .	Polską	3	Ins
Niespodziewana , nagła choroba zaściankowego Casanowy zmieniła sytuację .	Casanowy	5	Gen
Beata nigdy nie zobaczyła swojego wydrukowanego Aniołka .	Beata	0	Nom
Wisła w Toruniu przekroczyła stan alarmowy o 80 cm , a wody wciąż przybywa .	Wisła	0	Nom
Można też załatwić L-4 za alkohol .	L-4	3	Acc
Wspomina przecież , że był na Sybirze razem z Antonim Schmidtem .	Antonim	9	Ins
Jakiś gorący dreszcz przeniknął Felusia .	Felusia	4	Acc
- Mimo stacjonujących w Groznym wojsk i patroli Rosjanie nie będą się tam czuli bezpiecznie .	Groznym	4	Loc
Prokuratura Okręgowa w Katowicach wystąpiła do sądu o aresztowanie Krzysztofa Rutkowskiego .	Katowicach	3	Loc
Ale Saszkę to wzruszyło .	Saszkę	1	Acc
Gdyby mógł wtedy dopaść Szamila , niechybnie by go zabił .	Szamila	4	Acc
Co panią łączy z panem prezydentem Kaczyńskim ?	Kaczyńskim	6	Ins
Dyrektor zapoznał Grodzickiego z katechetą , potem pożegnał się i wyszedł .	Grodzickiego	2	Acc
Gdyby Bergvall zdecydował się przewieźć wydobyty alkohol do Finlandii , zapłaciłby ogromny podatek .	Bergvall	1	Nom
Wjeżdżamy między niechlujne zabudowania Płaszowa .	Płaszowa	4	Gen
Tylko w minioną sobotę w atakach terrorystycznych w Bagdadzie zginęło ponad 40 osób .	Bagdadzie	8	Loc
Ponad 1600 osób wzięło wczoraj udział w 24 . maratonie ulicznym we Wrocławiu .	Wrocławiu	12	Loc
Partia Konserwatywna zawiesiła Spencera w obowiązkach posła .	Spencera	3	Acc
- Synek ma zespół Downa .	Downa	4	Gen
Wzięli w niej udział przedstawiciele policji z Niemiec , Czech , Słowacji , Węgier , Ukrainy i Polski .	Słowacji	11	Gen
- W Janowie to była dziecinada .	Janowie	2	Loc
Z Arkadią czas obszedł się mimo wszystko lepiej .	Arkadią	1	Ins
W końcu lipca przyjechał po mnie Ojciec i pojechali śmy do Kielc .	Kielc	11	Gen
Mam nadzieję , że za Dziurowiczem pójdą następni .	Dziurowiczem	5	Ins
- Wiosną zdał maturę , będzie studiował nauki polityczne w Hamburgu .	Hamburgu	10	Loc
- Małą miss została Klaudia Zdunek !	Zdunek	5	Nom
Siedział odchylony za swoim biurkiem z taką miną , jakby dowodził całą policją , Interpolem i FBI na dodatek i delektował się kawą .	FBI	16	Ins
Hakerzy zaatakowali stronę internetową Watykanu .	Watykanu	4	Gen
Pan Bóg wyjął Ewę z boku Adama i to jest zboczenie .	Bóg	1	Nom
Wacek uciekł z domu .	Wacek	0	Nom
- To nasi obrońcy przed IRA !	IRA	5	Ins
Księdza zatrzymano w ubiegłym tygodniu na polsko - ukraińskim przejściu granicznym w Dorohusku przy wjeździe do Polski .	Dorohusku	12	Loc
Wczoraj o godz . 2 rano policjanci ruszyli pod posiadłość przestępcy w Białce na Pomorzu .	Pomorzu	14	Loc
Można wysłać SMS-a , e-maila lub połączyć się z Internetem .	SMS-a	2	Acc
– Przyjedź szybko do Nowolipska .	Nowolipska	4	Gen
Partnerami Ukraińców byli Szwajcarzy , czyli Duferco .	Szwajcarzy	3	Nom
Tenisiści stołowi Energetyka Opoki Trzebinia znają już terminy spotkań barażowych o I ligę , w których ich rywalem będzie zwycięzca II ligi łódzko - świętokrzyskiej Start Brzezina .	Brzezina	26	Nom
Czekał tam na mnie Holeksa .	Holeksa	4	Nom
Zyta milknie , Blanka opowiada o kłopotach małżeńskich .	Blanka	3	Nom
IV Zjazd Absolwentów Liceum Ogólnokształcącego odbył się w sobotę w Tucholi .	Tucholi	10	Loc
Ciągle też nie wiadomo , jaki będzie pełny skład rady PRKCh .	PRKCh	10	Gen
Jeden z tej piątki przedstawił się jako Krzysztof Mamiński .	Mamiński	8	Nom
Zresztą sam lider konfederatów Adam Słomka podnosi takie argumenty i zapowiada , ze będzie domagał się dyskusji o realizacji programu AWS i konieczności rekonstrukcji rządu .	AWS	20	Gen
W Tczewie w Radzie Miejskiej zasiada 23 radnych .	Tczewie	1	Loc
Na parkingu do samochodu Kosińskiego dosiadł się Osiński .	Osiński	7	Nom
A więc można zacząć źle myśleć o Barbarze .	Barbarze	7	Loc
Receptą Hewitta na zmianę tego stanu rzeczy jest odformalizowanie fizyki .	Hewitta	1	Gen
Bóg nigdy nie karał sam występujących przeciwko niemu .	Bóg	0	Nom
Droga do Falsztyna prowadzi przez łagodne wzgórza Pienin Spiskich .	Falsztyna	2	Gen
Po odparciu ataku i ujęciu 10 terrorystów zawrócono konwój do bazy w Al Kut .	Al	12	Loc
Wyjeżdża do Kocic , gdzie będzie odnawiał polichromię .	Kocic	2	Gen
ŻYCIE przedstawiło w sądzie świadków , którzy widzieli Kwaśniewskiego w Cetniewie .	Cetniewie	10	Loc
W 1935 roku brytyjski informatyk Alan Mathison Turing wymyślił abstrakcyjną maszynę .	Turing	7	Nom
Po decyzji parlamentu zawiesiły działalność polityczną Batasuny .	Batasuny	6	Gen
Obecnie mieścić się one będą w Zweibruecken i w Wormacji .	Wormacji	9	Loc
Wróbel był zaskoczony wiedzą posła Grzesika .	Grzesika	5	Gen
Został kamerdynerem w Warszawie .	Warszawie	3	Loc
Czy my wszyscy zasługujemy na życie w państwie rządzonym przez państwa Kaczyńskich ?	Kaczyńskich	11	Acc
Według Zofii Staśkiewicz z Dworu Artusa , artyści bardzo chętnie godzą się na koncerty w Toruniu .	Toruniu	15	Loc
Naudin roześmiał się .	Naudin	0	Nom
Strajk ten objął całą Francję .	Francję	4	Acc
Po piętnastu zawiadamiamy Kowala , że coś ci się stało .	Kowala	3	Acc
Zaangażowała się w Teatrze Dramatycznym kierowanym wówczas przez Gustawa Holoubka .	Holoubka	9	Acc
– w Mel Rozie była ś ?	Rozie	3	Loc
Na Podkarpaciu oficjalnie kampania żniwna zacznie się w przyszłym tygodniu .	Podkarpaciu	1	Loc
Robert czekał już na mnie przy tym samym stoliku , przy którym spotkaliśmy się wczoraj rano .	Robert	0	Nom
Drugi dwumecz z łódzkimi drużynami rozegrają dziś w Skierniewicach nasi drugoligowcy .	Skierniewicach	8	Loc
Dostojny gość zwiedzi ponadto stolicę , Kraków oraz Gdańsk .	Gdańsk	8	Acc
Oprócz Warszawy , gość odwiedzi także Kraków oraz Gdańsk .	Gdańsk	8	Acc
Radosny uśmiech nie gościł jednak na twarzy pana Adama .	Adama	8	Gen
Stachurski i Janusz Olędzki zastąpili latem Janusza Lacha i Artura Mazurka .	Artura	9	Acc
W ostatecznym rozrachunku triumfuje tradycyjnie Dior .	Dior	5	Nom
Mundek zasiadł jak zwykle przy pianinie , Czesiek kiwał się przy kontrabasie .	Czesiek	7	Nom
Jasieńczyk o nią zapytał .	Jasieńczyk	0	Nom
O trzecie miejsce Melnox zagra zatem z Wisłą .	Wisłą	7	Ins
- Poseł Janusz Wójcik sam zrzeknie się immunitetu .	Janusz	2	Nom
W Pruszkowie gang zorganizowali wychowankowie słynnego w czasach PRL bandyty Barabasza .	Pruszkowie	1	Loc
Krystyna Kofta ogłosiła , że przyjmuje na siebie misję walki o równouprawnienie Bożen z Krystynami i za dwa lata zaprosiła panie do Trójmiasta , by równość tę udowodnić .	Krystynami	14	Ins
W związku z Katyniem śmiać się głośno nie wypada .	Katyniem	3	Ins
Osuch przeszył go nieprzyjemnym , badawczym spojrzeniem .	Osuch	0	Nom
- Zdarzało się , że uderzyłem butnego Niemca z Wehrwolfu , ale tego nie obejmuje akt oskarżenia .	Wehrwolfu	9	Gen
Czy jeszcze kiedyś spotkam Anię ?	Anię	4	Acc
Na cmentarzu w Koniku Nowym leży ponad 100 psów , pięć kotów i jeden chomik .	Koniku	3	Loc
Niedługo po tym apelu Kamiński , Wołek i Jurek spotkali się na podwieczorku u krzywdzonego Pinocheta .	Pinocheta	15	Gen
Wybrała TVN .	TVN	1	Acc
Gest Handzi poruszył go głęboko .	Handzi	1	Gen
Zostałem Żydem .	Żydem	1	Ins
Ale Dzidzia mordowała mnie wczoraj o Olka . . .	Olka	6	Acc
sika w Stanach .	Stanach	2	Loc
Przez chwilę jeszcze posłuchajmy , co mówią o Kwaśniewskim jego zwolennicy .	Kwaśniewskim	8	Loc
Wracał em do Bud już po północy .	Bud	3	Gen
Wacek nie jest stary , dopiero skończył czterdziestkę . . .	Wacek	0	Nom
Klasztor na Jasnej Górze przeżywa prawdziwe oblężenie .	Górze	3	Loc
Po tej wypowiedzi papieża zapytaliśmy księdza Tadeusza Isakowicza - Zaleskiego , gorącego zwolennika lustracji , jak odebrał te słowa .	Isakowicza	7	Acc
W Konstancinie-Jeziornie i Spale przygotowują się piłkarskie reprezentacje do nadzwyczaj ważnych spotkań .	Spale	3	Loc
Dawniej nie wyglądał na Żyda .	Żyda	4	Acc
Jarosław Kaczyński ruszył w Polskę .	Polskę	4	Acc
Usamodzielniły się Wyry , Bojszowy , Lędziny i Bieruń .	Bieruń	8	Nom
Amerykanie patrząc zza Oceanu na Europę myślą niemal wyłącznie kategoriami strategicznymi i gospodarczymi .	Europę	5	Acc
Dlatego w dziedzinie literatury demokratyzm Internetu jest pozorny .	Internetu	5	Gen
Były one niezwykle rzadkie , nadające świątyni szczególne miejsce wśród wszystkich miejsc kultu na Pomorzu Gdańskim .	Pomorzu	14	Loc
W Czarnem umieszczono go w celi o zaostrzonym rygorze .	Czarnem	1	Loc
John Glenn pochodzi z Ohio .	Ohio	4	Gen
Dyrektor archiwum na Łubiance przekazał te materiały synowi Stanisława Głąbińskiego .	Stanisława	8	Gen
Tomasz Gudzowaty poluje kamerą na lwy , gepardy , lamparty .	Gudzowaty	1	Nom
Adam po pobycie w Nowym Jorku nie mógł już w Krośnie złapać oddechu , postanowił zbudować dom pod Krakowem .	Krakowem	18	Ins
Padają nazwiska Zbigniewa Romaszewskiego i Jana Olszewskiego .	Olszewskiego	6	Gen
W styczniu pojechał do Melbourne .	Melbourne	4	Gen
Książę Andrzej Poniatowski , porucznik armii francuskiej , odwiedził Polskę w roku 1919 jako członek francuskiej misji wojskowej .	Polskę	9	Acc
Rumieniec buchnął na policzki Janka .	Janka	4	Gen
Nieoficjalnie wiadomo , że Krzysztof Jagiełło , znany w środowisku SLD jako doskonały organizator , był w tej sprawie w sobotę w Warszawie .	SLD	10	Gen
W zeszłym roku w Cieszynie zawiązał się CKH i występował w naszej II lidze .	Cieszynie	4	Loc
Przyjechał em , żeby ratować Gruzję .	Gruzję	5	Acc
Jesienią zeszłego roku odwołać dyrektora Ziarkowskiego usiłowała Rada Kasy .	Ziarkowskiego	5	Acc
W siedzibie kłodzkiego starostwa powiatowego dowiaduję się , że Średzińskiego nie lubią tu , bo to postkomuch , a powiatem rządzi egzotyczna koalicja złożona z platformersów i byłych pisowców .	Średzińskiego	9	Gen
Konflikt dojrzewa też w spokojnym dotąd Kazachstanie .	Kazachstanie	6	Loc
Brigitte Bardot zaczęła bronić zwierząt histerycznie , szlachetne intencje popsuły się i pogniły jak robaczywe jabłka .	Brigitte	0	Nom
Koncern nadal ma umowy licencyjne z producentami w Japonii , Włoszech , Afryce Południowej i na Filipinach .	Filipinach	16	Loc
Seniorska reprezentacja Polski zbliża się do zgrupowania we Wronkach .	Wronkach	8	Loc
Ułatwi ona włączenie się do ruchu jadącym z Koziegłów do Poznania .	Poznania	10	Gen
Czwarty kwartał 1932 roku przywlókł chmurę na czoło Wotana - Hitlera .	Wotana	8	Gen
– W HSW SA trwa obecnie wielkie liczenie .	HSW	2	Loc
Pamiętam w Iveronie w sześciu gablotach stłoczone największe relikwie .	Iveronie	2	Loc
Rosyjsko - niemiecka inwestycja ominie Polskę i inne państwa Europy Środkowej .	Polskę	5	Acc
Zawody będą rozgrywane na Dunajcu na odcinku od Krościenka do mostu w Gołkowicach .	Dunajcu	4	Loc
Czy ekonomiści liczą , że Balcerowicz będzie korzystał z ich rad ?	Balcerowicz	5	Nom
W Gnieźnie w sylwestrowy wieczór zginęli podczas pożaru trzej chłopcy , a jadący do akcji samochód strażacki wpadł na dwie kobiety .	Gnieźnie	1	Loc
Nieoficjalnie wiadomo , że Krzysztof Jagiełło , znany w środowisku SLD jako doskonały organizator , był w tej sprawie w sobotę w Warszawie .	Jagiełło	5	Nom
Komisja sędziego Kramarza przystąpiła do pracy .	Kramarza	2	Gen
Ostatni król Polinezji , Pomare V , zmarł z powodu alkoholizmu .	Polinezji	2	Gen
Już we wtorek prezydent Kwaśniewski wybiera się z roboczą wizytą do Paryża , by przekonywać do naszych racji prezydenta Jacquesa Chiraka .	Jacquesa	19	Acc
Po odparciu ataku i ujęciu 10 terrorystów zawrócono konwój do bazy w Al Kut .	Al	12	Loc
Mimo że na koncie ma już osiem wyroków , nadal okrada turystów odwiedzających Kraków .	Kraków	13	Acc
Dyna nie wydawał się obrażony .	Dyna	0	Nom
- Jak pan sądzi , zobaczycie się z Bagsikiem w tym tysiącleciu ?	Bagsikiem	8	Ins
Podczas obchodu można było się przekonać , że nastąpiły gruntowne zmiany w pomieszczeniach CSiK .	CSiK	13	Gen
Młodzi zamieszkali na ul. Chrobrcgo .	Chrobrcgo	4	Gen
Pierwsza z wymienionych sygnalizacji pojawi się u zbiegu ulic Gdyńskiej i Piaskowej w Koziegłowach .	Koziegłowach	13	Loc
W Venezii Keneth ciągle leczył kontuzje , nie doszedł do formy .	Venezii	1	Loc
Od tego czasu Tusk z nią nie rozmawiał .	Tusk	3	Nom
Agnieszka też ma matkę narkomankę .	Agnieszka	0	Nom
Do przechodzącego ulicą 28-letniego mieszkańca Ostrowca Świętokrzyskiego oddał dwa strzały .	Ostrowca	5	Gen
Ale dla Serbów Kosowo ma olbrzymią wartość emocjonalną , to kolebka ich państwowości .	Serbów	2	Gen
Ukląkł em przy Mateuszu i szybko wcisnął em mu woreczek do ręki .	Mateuszu	3	Loc
Panna Janka nie mogła już Gilarzowi w niczym przeszkodzić .	Janka	1	Nom
Na Ukrainie i Białorusi została już częściowo odtworzona struktura administracji kościelnej .	Białorusi	3	Loc
Wybór padł na Stany Zjednoczone , ponieważ stamtąd przyszła pierwsza oferta pracy .	Stany	3	Acc
Jakimiszyn pochodzi z Baku , tu do dziś mieszka jego matka .	Baku	3	Gen
Tom Spencer posiadał przy sobie pisma pornograficzne i kasety video dla homoseksualistów oraz marihuanę .	Spencer	1	Nom
Lolek za głowę się złapał , kiedy to usłyszał .	Lolek	0	Nom
Jerzyk szepnął mi .	Jerzyk	0	Nom
Wiezie on pismo cesarza Hajle Sellasje do pułkownika Bumediena .	Sellasje	5	Gen
Wyraźnie za Basajewem nie przepadał .	Basajewem	2	Ins
– edwansa ma zrobionego ?	edwansa	1	Acc
– Będzie pan rozmawiał z doktorem Kazniczem .	Kazniczem	6	Ins
Niechętnie przecież opuszczali Legnicę i inne bazy wojskowe .	Legnicę	3	Acc
Powiedziała , że komórki zamówił u niej Bogusław Linda .	Linda	8	Nom
- Józwa ma konika . . .	Józwa	1	Nom
W Wielkopolsce brakuje 300 gliniarzy .	Wielkopolsce	1	Loc
Może w dużych ośrodkach miejskich ludzie zagłosują na Juszczenkę , ale we wsiach poparcie dla Janukowicza będzie ogromne .	Juszczenkę	8	Acc
Kłopoty z tożsamością Macieja i Mateusza każą mi tutaj przywołać jeszcze jedną parę imion , a mianowicie Szczepana i Stefana .	Szczepana	17	Acc
Każdy w Polsce słyszał o Samarkandzie , świętym mieście w Uzbekistanie .	Samarkandzie	5	Loc
Około 15 km za Nag–czu , boczną , terenową drogą dojechali śmy do pasterskich namiotów .	Nag–czu	4	Ins
Wicemistrzynie Polski z Mielca nie dały pograć w Krakowie Wiśle i opuściły ostatnie miejsce w tabeli właśnie na rzecz podopiecznych Lesława Kędryny .	Lesława	20	Gen
Dzięki cyfrowej telewizji satelitarnej istnieje też możliwość połączenia z Internetem czy udziału w kursach przygotowujących do matury albo egzaminu na studia .	Internetem	9	Ins
- Zdarzało się , że uderzyłem butnego Niemca z Wehrwolfu , ale tego nie obejmuje akt oskarżenia .	Niemca	7	Acc
Steve zaklina się , że po każdym dyżurze szykuje ekstra posiłek czworonożnemu ratownikowi .	Steve	0	Nom
Ranni żołnierze zostali przewiezieni do szpitala w Białogardzie .	Białogardzie	7	Loc
Celnikom wyjaśniła , że muszlę kupiła w Acapulco za 20 dolarów .	Acapulco	7	Loc
Kolejna sygnalizacja pojawi się u zbiegu ulic Okrężnej i Gdyńskiej i ułatwi wyjazd z osiedla 40-lecia w Czerwonaku .	Czerwonaku	17	Loc
Zamoyski gorzko się na to uśmiecha .	Zamoyski	0	Nom
Cichoń znów poczuł się bezpieczniej , komisarz przestał pytać o niego .	Cichoń	0	Nom
Po przewrocie władzę w Algierii objęła Rada Rewolucyjna .	Algierii	4	Loc
Jeden Chińczyk został zabity .	Chińczyk	1	Nom
W ten sposób Rumuni wystąpili w roli głównego mediatora pomiędzy Moskwą a Pekinem .	Moskwą	10	Ins
Przez uczony wywód autorki przewijają się dzieła współczesnych filozofów , od Ricoeura po Levinasa .	Levinasa	13	Acc
Rozczytywał em się w Słowackim i w myślach nazywał em ją Ellenai .	Słowackim	4	Loc
Wcześniej o ośmiu takich maturzystach informowała OKE w Łomży .	Łomży	8	Loc
- A jeszcze niedawno mówił eś o pani Gronkiewicz tak ciepło .	Gronkiewicz	8	Loc
Prokuratura Apelacyjna współpracuje w tej sprawie z oddziałami CBŚ we wspomnianych miastach i Urzędami Kontroli Skarbowej .	CBŚ	8	Gen
Wieczorek uderzył i znów głowę przekrzywił .	Wieczorek	0	Nom
Uwolniono też polskiego ambasadora w Jemenie .	Jemenie	5	Loc
Według oficjalnej wersji radzieckiej Wallenberg zmarł w więzieniu na Łubiance .	Wallenberg	4	Nom
Już we wtorek prezydent Kwaśniewski wybiera się z roboczą wizytą do Paryża , by przekonywać do naszych racji prezydenta Jacquesa Chiraka .	Kwaśniewski	4	Nom
Tygellin poczuł , że gra się rozszerza .	Tygellin	0	Nom
Burmistrz Wiesław Śniecikowski gwarantuje , że w tym roku fajerwerki będą bardzo efektowne .	Śniecikowski	2	Nom
Ashram w Magliano Sabina to ośrodek dla małych dzieci Sahaja Yoginów .	Magliano	2	Loc
Traktuje Beatę jak córkę , służy radą i wsparciem psychicznym .	Beatę	1	Acc
Po opadach deszczu nadleśniczowie z Tucholi , Woziwody , Zamrzenicy i Trzebcin podjęli decyzję o wycofaniu zakazu .	Trzebcin	11	Gen
O trzecie miejsce Melnox zagra zatem z Wisłą .	Melnox	3	Nom
To państwo Kaczyńscy wiedzą i rządu do dymisji nie podadzą .	Kaczyńscy	2	Nom
Potwierdził to prezydent Jiang podczas niedawnego spotkania z prezydentem Clintonem .	Jiang	3	Nom
Studiują tutaj Łukasz Kruczek , Grzegorz Śliwka , Krystian Długopolski , teraz obok mnie studentem został Tomek Pochwała .	Krystian	8	Nom
Szewardnadze zgubił kraj .	Szewardnadze	0	Nom
A musi z ZSSR i z Polską .	Polską	6	Ins
Kapitan Bayernu trafił do siatki Koeln jeszcze raz w 68 . minucie .	Koeln	5	Gen
Zaciągnął w kąt grubego , jowialnego Skwarskiego .	Skwarskiego	6	Acc
Widzą nagle Cygana z Jadźką .	Cygana	2	Acc
- Ekspertyza balistyczna wykluczyła udział żołnierzy niemieckich w zastrzeleniu 49-letniego mężczyzny w Koniecpolu .	Koniecpolu	12	Loc
Podobną akcję przeprowadzono w czasie wojny w Zatoce Perskiej w 1990 r.	Zatoce	7	Loc
Rekordowy mróz minus osiemnaście stopni Celsjusza zanotowano w podgórskiej miejscowości Przibyslavi .	Przibyslavi	10	Loc
Wszyscy we wsi znają Andrzeja Wrońskiego .	Wrońskiego	5	Acc
Kobieta w czasie okupacji przechowuje u siebie Cygana .	Cygana	7	Acc
Występuje w Europie .	Europie	2	Loc
W Kcyni odbyło się spotkanie z kandydatami na kierowników na samodzielny publiczny zakład opieki zdrowotnej w Kcyni i Kowalewku .	Kowalewku	18	Loc
Szkoda , że nie można dysponować Heinzem Mirynkiem .	Heinzem	6	Ins
Ponad 20 ulic będzie wyłączonych z ruchu w związku ze Świętem Zmarłych .	Świętem	10	Ins
Widocznie ktoś otworzył drzwi od ulicy i zastrzelił Melmana .	Melmana	8	Acc
Wieś leży na Szlaku Zamonitu z Błędowa do Poraja .	Zamonitu	4	Gen
Kazimierz Barcikowski aż poderwał się z miejsca .	Kazimierz	0	Nom
Rozmaite padliny wieszano na Sienkiewiczu , ale ja w jego obronie zawsze staję .	Sienkiewiczu	4	Loc
Podobał mi się wygląd Geralta w komiksie .	Geralta	4	Gen
Nad Odrą stoi obrońca .	Odrą	1	Ins
Posłużono się amerykańską zastawką doktora Starra .	Starra	5	Gen
Przypomina tego twojego pedała ze Służewa .	Służewa	5	Gen
W Centrum Naukowym Wielkich Jezior w amerykańskim Cleveland otwarto wystawę niecodziennych pomocy naukowych dla dzieci .	Jezior	4	Gen
Monarchia Habsburgów została rozczłonkowana .	Habsburgów	1	Gen
Dogadał się z NATO i Bushem .	Bushem	5	Ins
Ekspozycja zawiera kilkaset zdjęć przedstawiających życie codzienne ludzi w NRD .	NRD	9	Loc
Kierownictwo tego ministerstwa objął John Kakonge .	Kakonge	5	Nom
I wcześniej Smolański gwałtownie manifestował swoje poglądy .	Smolański	2	Nom
- Dowiedziała m się , że pan spotyka się od pewnego czasu z Renią .	Renią	13	Ins
Sprzęt o wartości 10 tysięcy złotych to prezent od dyrekcji Wojewódzkiego Ośrodka Ruchu Drogowego w Tarnobrzegu .	Tarnobrzegu	15	Loc
Poseł Cymański docenił . . .	Cymański	1	Nom
– W HSW SA trwa obecnie wielkie liczenie .	SA	3	Loc
I dlatego muszę wspomnieć o Krzysiu z Częstochowy .	Częstochowy	7	Gen
Chciałbym podzielić się kilkoma przemyśleniami z Mikołajem Szymańskim .	Mikołajem	6	Ins
W sobotę gmach sądu w Bielsku-Białej przypominał twierdzę .	Bielsku-Białej	5	Loc
Partnerami Ukraińców byli Szwajcarzy , czyli Duferco .	Ukraińców	1	Gen
Propozycję tę przedstawił minister Brandt .	Brandt	4	Nom
W dorożce siedział rozparty chirurg Tamten .	Tamten	5	Nom
Za nimi Toyotą syn Doroty wiezie Marcina .	Doroty	4	Gen
NIP nadaje urząd skarbowy .	NIP	0	Acc
Ostatecznym celem był garnizon w Greifswaldzie na Pomorzu .	Pomorzu	7	Loc
Moi ludzie odnaleźli tego Pawła .	Pawła	4	Acc
Czytałem , że to dobry kryminał , poza tym lubię Ginę Gershon .	Ginę	10	Acc
W ogólnym rozgardiaszu jedynie Kosiński i Gorczyca zachowywali się spokojnie .	Kosiński	4	Nom
W środę ambasador USA w Pekinie przekazał ministrowi spraw zagranicznych Chin list z przeprosinami .	Pekinie	5	Loc
– To David . . .	David	2	Nom
Chodzi prawdopodobnie o Burkina Faso .	Burkina	3	Acc
Nieznani sprawcy w nocy z wtorku na środę zbezcześcili cmentarz w Akwizgranie .	Akwizgranie	11	Loc
Wyróżniały się głosy dyrektora Suchanka , byłego wojewody oraz lekarza dyżurnego .	Suchanka	4	Gen
Chciała by m dopuścić do głosu pana senatora Romaszewskiego .	Romaszewskiego	8	Acc
Mechanicy zajęli się już samochodem Gorczycy .	Gorczycy	5	Gen
Do smutasów należy również minister rolnictwa Krzysztof Jurgiel .	Jurgiel	7	Nom
Przed tygodniem pisali śmy o rozboju w Rabce .	Rabce	7	Loc
- Rozmawiał pan z Filipiakiem ?	Filipiakiem	4	Ins
- Moich zawodników zdopingowała wczorajsza porażka Górnika z Jeziorakiem .	Górnika	6	Gen
Na podwórzu czekał Ebersbach .	Ebersbach	3	Nom
CZY BRZECHWA ZNAŁ TOKARSKIEGO ?	TOKARSKIEGO	3	Acc
Przypomniał swą pierwszą sprzed kilku lat wizytę w Ludwinowie w 1860 roku , zabawił kilka dni , zburzył spokój samotniczki .	Ludwinowie	8	Loc
Zajmowały się tym już Zofia Korczak - Blatonowa i Aniela Cieszkowska .	Blatonowa	7	Nom
- Czy chcesz , niewiasto , wziąć udział w uroczystościach ku czci bogini Zirbanit ?	Zirbanit	13	Gen
Miał dwóch Norwegów przy boku .	Norwegów	2	Gen
Gdańscy radni podjęli uchwałę o przekazaniu miliona złotych na odbudowę kościoła św . Katarzyny .	Katarzyny	13	Gen
O piątej przyszli Hauboldowie , zrobili śmy im herbatę i było dość przyjemnie .	Hauboldowie	3	Nom
Prezes uważa , że ludzie z Polamu nie rozumieją nowych warunków gry .	Polamu	6	Gen
Elektryczność najwięcej kosztuje w Warszawie i na Śląsku .	Warszawie	4	Loc
- I zupełnym przypadkiem trafił eś na Jacka Kuronia .	Kuronia	8	Acc
- Moszczyński kiwał głową .	Moszczyński	1	Nom
Nie dociera do niego , co Chadaj mówi .	Chadaj	6	Nom
Demonstranci mieli flagi Liberalno - Demokratycznej Partii Rosji , organizacji politycznej znanego nacjonalisty Żyrinowskiego .	Żyrinowskiego	13	Gen
Według KAI zaskarżenie ustawy do sądu zapowiedziała już organizacja American Civil Liberties Union .	Union	12	Nom
Zbigniew Brzeziński , doradca prezydenta Jimmy'ego Cartera do spraw bezpieczeństwa , zaapelował o umiar do robotników , władzy i Kościoła w Polsce .	Cartera	6	Gen
Wczesnym popołudniem polska delegacja udała się do Warny .	Warny	7	Gen
Mówił , że w TVP nie szanuje się ludzi .	TVP	4	Loc
Polski samolot M-28 rozbił się i eksplodował kilka sekund po starcie z lotniska w Puerto Cabello , 200 km na zachód od Caracas .	Cabello	15	Loc
W bramie spotkał podporucznika Samczyca .	Samczyca	4	Acc
Saszka podszedł do Handzi , usiadł obok na kłodzie .	Handzi	3	Gen
W Wielką Sobotę święci się też wodę i ogień .	Sobotę	2	Acc
Według oficjalnej wersji radzieckiej Wallenberg zmarł w więzieniu na Łubiance .	Łubiance	9	Loc
W hali przy ulicy Księcia Bolesława na warszawskim Bemowie gościł Tomasz Frankowski .	Bemowie	8	Loc
Dobrze spisała się młodzież w Sterdyni , Ceranowie , Skrzeszynie , Czerwonce i Wężach .	Wężach	13	Loc
Ta przekazała sprawę do PW w Lesznie .	Lesznie	6	Loc
Właścicielom wystarcza kino domowe , a bogate panie nie potrafią docenić kunsztu Anny Jaxy - Chamiec .	Jaxy	13	Gen
Wcześniej za największe osiągniecie uważał dwukrotne zwycięstwo w Memoriale Zakrzewskiego w Kędzierzynie-Koźlu .	Kędzierzynie-Koźlu	11	Loc
Po pani Florczakowej i Kropce został tylko jeden ślad .	Florczakowej	2	Loc
Jako pierwszy zabierze się do ciebie honorowo obłędny rycerz Eyck z Denesle !	Denesle	11	Gen
Poszły nad Ślęzę .	Ślęzę	2	Acc
Dostojny gość zwiedzi ponadto stolicę , Kraków oraz Gdańsk .	Kraków	6	Acc
Niedziela Palmowa na Kociewiu różniła się zresztą od obchodów w innych częściach Polski .	Kociewiu	3	Loc
Napisał ją Chilijczyk Ariel Dorfman .	Ariel	3	Nom
- Jakie znaczenie dla śledztwa ma odkrycie dokonane w archiwach w Łomży , o którym niedawno poinformowała prof . Daria Nałęcz ?	Łomży	11	Loc
Pawłowi M . zarzuca się również , że działał z zamiarem spowodowania ciężkiego kalectwa rzucając nożem w głowę włoskiego piłkarza Dino Baggio .	Dino	20	Gen
Innym razem pojechała z Kaharem do portu Xiamen na południu Chin , gdzie kupili trzy japońskie magnetowidy .	Kaharem	4	Ins
Wanda Gąsior w to jednak powątpiewa .	Gąsior	1	Nom
Zeznania urzędniczki były elementem republikańskiej kampanii , która miała zmusić prezydenta Billa Clintona do odwołania wizyty w Chinach .	Clintona	12	Acc
Najciekawiej zapowiada się w Moskwie , gdzie miejscowy Spartak podejmuje Ajax Amsterdam .	Ajax	10	Acc
A dlaczego małżeństwo z Szymonem miało by kolidować z tymi planami ?	Szymonem	4	Ins
Patrzył pytająco na Bąka .	Bąka	3	Acc
Pablo podszedł do Wójcika .	Wójcika	3	Gen
Wczoraj świdnicka WSK zorganizowała konferencję prasową .	WSK	2	Nom
- Moim zdaniem , pan Fank ma dużo niewyżytej energii .	Fank	5	Nom
W 1905 roku Karl Braun zbudował detektor kryształkowy .	Braun	4	Nom
Spotkał Brońcię z białą kózką .	Brońcię	1	Acc
Świat Rydzyka tego wszystkiego nie wydumał .	Rydzyka	1	Gen
Irenka była Belgijką .	Belgijką	2	Ins
Jak zwykle pośliznął się na posadzce w przedpokoju , chłodnym i białym niczym Antarktyda we mgle .	Antarktyda	13	Nom
Sekretarz generalny KPZR Leonid Breżniew odwiedził Bułgarię , Jugosławię i Węgry .	Węgry	10	Acc
Następnie rozłożyła wysoki statyw , zawiesiła na nim pudełko , przeprowadziła od niego przezroczysty przewód do igły , którą wcześniej automatyczny iniektor umieścił w żyle na przedramieniu Irka .	Irka	27	Gen
Poseł w liście do ministra pyta o możliwość postawienia Polańskiego przed polskim sądem .	Polańskiego	9	Gen
chwalmy pana przez Maryję .	Maryję	3	Acc
Do dziennikarki Beaty Igielskiej zatelefonowała któregoś dnia krewna , bardzo zresztą daleka .	Beaty	2	Gen
Napisałaby więc z pewnością o Bali , co się stało w Kucie , tuż przy głównym deptaku .	Kucie	11	Loc
Potwierdził to prezydent Jiang podczas niedawnego spotkania z prezydentem Clintonem .	Clintonem	9	Ins
Pierwsze brawa zebrał Bugaj polemizujący z Rakowskim .	Rakowskim	6	Ins
Nowicki trochę zły podniósł lunetę .	Nowicki	0	Nom
Niestety zabrakło światowej sławy muzyka , przyjaciela Karola Szymanowskiego , Romana Totenberga , któremu choroba nie pozwoliła na przyjazd do Zakopanego .	Totenberga	11	Gen
Najwyższą sumę otrzymał wójt Michał Skałecki i jest to 7100 złotych .	Skałecki	5	Nom
Na Siemiradzkiego wybrzydzali krytycy , ale publiczność uwielbiała jego obrazy .	Siemiradzkiego	1	Acc
Siadam w kącie i usypiam , budząc się na Gare du Nord .	Nord	11	Loc
Odziedziczyła ona po bracie majątek w Galicji , uprzemysłowiony i dający duże profity .	Galicji	6	Loc
W Europie firma posiada ponad 70 sklepów , głównie w Niemczech , Holandii , Luksemburgu .	Luksemburgu	14	Loc
Najpierw pan Klecki poszedł sprawdzić , czy wódka jest zimna .	Klecki	2	Nom
" Słuchaj , to prawda z tym Spławikiem ? "	Spławikiem	7	Ins
Ustalili śmy ze Stachem , że jeszcze trochę pociągnę pismo dla honoru domu i odejdę .	Stachem	3	Ins
Królową Mody wybrano na rok 1935 znaną pieśniarkę Werę Bobrowską .	Werę	8	Acc
Michał sięgnął do klamki , ale Wasielewski chwycił go za rękaw i przytrzymał .	Wasielewski	6	Nom
Do gabinetu weszła panna Wunsch i położyła na biurku Trentscha niebieski skoroszyt .	Wunsch	4	Nom
Na lewo od nich widać cylindryczny budynek mieszczący teleskop Subaru .	Subaru	9	Acc
- Pan ma spotkanie z Zombiem ?	Zombiem	5	Ins
Z wnioskiem takim wystąpił naczelnik OSP Arkadiusz Pindral .	Arkadiusz	6	Nom
Weronka i Janek Bajurski siedzą .	Weronka	0	Nom
Zgodził się , dał kilka dobrych rad i wyznaczył Polluksa na dowódcę .	Polluksa	9	Acc
Kiedy wyciągnęli Wandzię na brzeg , z ust wypłynęła jej piana . . .	Wandzię	2	Acc
Zwolennicy Mossadegha , ministrowie , podejrzani oficerowie , działacze Tudeh są przesłuchiwani i torturowani .	Mossadegha	1	Gen
Nawiązano współpracę z kołami gospodyń wiejskich w Domatkowie , Kolbuszowej Górnej , Nowej Wsi , Weryni i Widełce .	Weryni	15	Loc
Papier płonie także w Pillow Book .	Book	5	Loc
Po tej wypowiedzi papieża zapytaliśmy księdza Tadeusza Isakowicza - Zaleskiego , gorącego zwolennika lustracji , jak odebrał te słowa .	Zaleskiego	9	Acc
Ludmiła Putin , żona prezydenta Federacji Rosyjskiej Władimira Putina , rozpoczęła wczoraj wizytę w Polsce od zwiedzenia zamku na Wawelu .	Władimira	7	Gen
Turyści z NRD odwiedzać będą Szczecin i powiat szczeciński .	NRD	2	Gen
Jego wzrost i groźna twarz uczyniły na Turku wrażenie .	Turku	7	Loc
Tak jest w perfumerii na MDM .	MDM	5	Loc
Wszyscy znamy historię Abrahama i Izaaka .	Izaaka	5	Gen
Natalia spoważniała .	Natalia	0	Nom
Zdaniem Kwaśniewskiego jest to wystarczająca kara i Siwiec nie musi ustępować ze stanowiska .	Kwaśniewskiego	1	Gen
Po bombardowaniach wojsko przeczesuje dom po domu , starając się odnaleźć porwanego w niedzielę swego kolegę , Gilada Shalita .	Gilada	17	Acc
Mariusz Walter zadebiutował jako reżyser już w latach 60 . , szybko związał się z telewizją publiczną , w której pracował aż do lat 80 .	Walter	1	Nom
Ze Stanisławem Łangowskim , prezesem Zarządu Powiatowego Platformy Obywatelskiej , rozmawialiśmy w ubiegły czwartek .	Stanisławem	1	Ins
Leki na obniżenie temperatury nie działały , a sytuacja , według słów Havlovej , w nocy z poniedziałku na wtorek stała się krytyczna .	Havlovej	12	Gen
Billa martwi co innego .	Billa	0	Acc
W samolocie myślała m o tych dniach spędzonych z Kowerskim .	Kowerskim	9	Ins
Prezes Pieprzowski nie jest taki pewny .	Pieprzowski	1	Nom
Gdzie jest Paula ?	Paula	2	Nom
Zobaczył Dunaja .	Dunaja	1	Acc
Leci z Milwaukee do Pekinu na chiński Nowy Rok .	Milwaukee	2	Gen
W Senacie zgłosił swoje przystąpienie do komunistów senator Boguszewski , wybrany z listy BBWR , już przedtem miał kontakty .	BBWR	13	Gen
Niech żyje nasza Ojczyzna , Wielka Ruś !	Ruś	6	Nom
Po przewiezieniu do Jeleniej Góry prokurator postawił mu zarzuty żądania i przyjęcia korzyści majątkowych .	Góry	4	Gen
Chciał by m podzielić się kilkoma przemyśleniami z Mikołajem Szymańskim .	Szymańskim	9	Ins
Auto z czterema młodymi mężczyznami wpadło do Wisły .	Wisły	7	Gen
Najtrudniejsze zadanie stało przed Mercedesem .	Mercedesem	4	Ins
Przez dwa ostatnie tygodnie policjanci zaczęli podejrzliwie obserwować Staszka i Dawida .	Dawida	10	Acc
Minister obrony Tengiz Kitowani , były premier Tengiz Sigua i szef milicji Mchedrioni Dżaba Joseljani obalili przed rokiem prezydenta Zwiada Gamsahurdię .	Zwiada	19	Acc
Tassilo de Tresckow zajechał go i ciął mieczem .	Tresckow	2	Nom
W czasie pobytu krótko rozmawiał em z Lechem Bądkowskim .	Bądkowskim	8	Ins
Przekonywał o tym wojewoda pomorski Roman Zaborowski w Kwidzynie .	Kwidzynie	8	Loc
Obecny był kierownik Wydziału Prasy , Radia i Telewizji KC PZPR Kazimierz Rokoszewski .	KC	9	Gen
Nie ma też dowodów , by Pietruszka był agentem KGB , choć SB ściśle współpracowała z Rosjanami .	Rosjanami	16	Ins
- Mój ojciec pracuje w BRH , biurze radcy handlowego .	BRH	5	Loc
Ali Agca przebywa w więzieniu już 18 lat .	Agca	1	Nom
Mały Marcel lubi oglądać kościoły .	Marcel	1	Nom
Zdaniem Wasiłowskiego , Charczew nie pojawiał się więcej w Inwestgasie .	Inwestgasie	9	Loc
Dwa lata temu kilkudziesięciu okolicznych rolników demonstrowało swoje niezadowolenie przed mławską Temidą .	Temidą	11	Ins
Szpital w Ostródzie został sprywatyzowany 7 lat temu .	Ostródzie	2	Loc
Co będzie z Emilką ?	Emilką	3	Ins
- Według konstytucji wasz Wałęsa nie ma takich uprawnień jak prezydent Białorusi .	Białorusi	11	Gen
W czasie weekendu dorodny lampart spacerował ulicami stolicy Indii , Delhi .	Indii	8	Gen
Ewa i Ania chodziły z Agnieszką do jednej klasy trzeci rok .	Agnieszką	5	Ins
Ale demokrata Al Gore obiecał emerytom dopłaty państwa do leków . . .	Al	2	Nom
Czy pan zna inżyniera Jarzęckiego ?	Jarzęckiego	4	Acc
Poznali śmy już nazirejczyków , ponieważ należał do nich Samson .	Samson	9	Nom
Pod stołem bawił się granatem mały chłopiec , nazywany Osęką .	Osęką	9	Ins
Następcy Piotra wybrali na siedzibę Rzym , a nie Jerozolimę .	Jerozolimę	9	Acc
Na reklamowanie Heyah nie ma szans .	Heyah	2	Gen
Wczoraj w podobnych okolicznościach wpadł technik Wydziału Kryminalnego w Nowym Mieście Lubawskim .	Mieście	10	Loc
Swoje problemy ma też Hanna Gronkiewicz - Waltz .	Waltz	7	Nom
- Olek nie słyszał , zemdlał .	Olek	1	Nom
Ostatecznym celem był garnizon w Greifswaldzie na Pomorzu .	Greifswaldzie	5	Loc
Hutnictwo polskie współpracuje z hutnictwem ZSRR , NRD , Czechosłowacji i Bułgarii .	ZSRR	5	Gen
Palestyńczycy będą mogli nawet sprowadzić czołg .	Palestyńczycy	0	Nom
100-tysięcznym Grudziądzem rządzi lewica .	Grudziądzem	1	Ins
W końcu znalazł się w Lesznie .	Lesznie	5	Loc
- Możliwość odejścia Leszka Balcerowicza bardzo zaniepokoiła inwestorów .	Leszka	3	Gen
Zwierzenia Ani poruszyły mnie do głębi .	Ani	1	Gen
Doktor Słodkowski zapewnia , że przynajmniej raz na kwartał będzie odwiedzał Zakopane .	Zakopane	11	Acc
TP SA chce złagodzić planowane redukcje .	TP	0	Nom
Na razie żeglarze z całego świata odpoczywają i bawią się w Talinie .	Talinie	11	Loc
Dziadkowie kochali bardzo wnuki i synową , ale ich majątek , Wysokie , gonił resztkami .	Wysokie	11	Nom
Rodziny , które zdecydują się kupić na kredyt własne M , mogą liczyć na pomoc finansową .	M	9	Acc
Potem , gdy próbowali je sprzedać w Szanghaju , zostali zauważeni przez policję .	Szanghaju	7	Loc
Podczas obchodu można było się przekonać , że nastąpiły gruntowne zmiany w pomieszczeniach CSiK .	CSiK	13	Gen
Wypytywała rodaków o Warszawę , interesowała się przeżyciami Tomka w czasie wyprawy i nawet namawiała go usilnie , aby pozostał w Australii .	Warszawę	3	Acc
Lecz spojrzawszy na Polka umilkła .	Polka	3	Acc
Czyż ton wypowiedzi Zdziechowskiego i Courtenaya nie jest podobny ?	Courtenaya	5	Gen
– i chciała zmienić sobie Wilczyńskiego . .	Wilczyńskiego	5	Acc
Po wypiciu wódki i wina również inni schodzili na dół , bo widział em na schodach i pana Jaworka , i pana Napiórkowskiego .	Napiórkowskiego	22	Acc
Rzeczy te są w PUBP .	PUBP	4	Loc
Teraz to wszystko staje się naprawdę , doczekał się Stefan Chmura Piaskowej Góry .	Chmura	10	Nom
Na spotkanie z Jeffreyem przyszła spóźniona , umówili się w kawiarni nieopodal opery .	Jeffreyem	3	Ins
Uczył się w Liceum Technik Plastycznych w Zakopanem prowadzonym przez Antoniego Kenara .	Zakopanem	7	Loc
– z Waldkiem chodził do klasy .	Waldkiem	2	Ins
W Etiopii 21 osób zginęło w katastrofie autobusu .	Etiopii	1	Loc
Chciał em gonić Łesia .	Łesia	3	Acc
W Kcyni odbyło się spotkanie z kandydatami na kierowników na samodzielny publiczny zakład opieki zdrowotnej w Kcyni i Kowalewku .	Kcyni	1	Loc
Najbardziej popularne są mercedesy , audi , golfy i BMW .	BMW	9	Nom
Natomiast Gorczyca pominął w ogóle sprawę milczeniem .	Gorczyca	1	Nom
Gdyby kierownictwo ZUS zdecydowało się na Mercedesa lub BMW , to koszt jednego samochodu przekroczyłby 200 tys . nowych złotych .	ZUS	2	Gen
– Mock zapalił i rozsiadł się w fotelu .	Mock	1	Nom
Sierpcem nie interesuje się zupełnie przemysł terenowy .	Sierpcem	0	Ins
W Europie początkowo kawę sprzedawali medycy , zalecając ją na smutki i przygnębienie .	Europie	1	Loc
Wardziński brał Santa Anę !	Santa	2	Acc
Georges Mathieux w kostiumie szermierza dźga płótno pędzlem umieszczonym na szpadzie .	Georges	0	Nom
– Będzie pan rozmawiał z doktorem Kazniczem .	Kazniczem	6	Ins
Tym samym rząd Indiry Gandhi utrzymał się przy władzy .	Gandhi	4	Gen
Jarzębowski wzruszył ramionami .	Jarzębowski	0	Nom
- Mam zamiar zagrać wraz z Sinfonią Varsovią .	Varsovią	7	Ins
Oprócz słuchania Steczkowskiej delegaci zajmowali się dyskusją o strajku generalnym .	Steczkowskiej	2	Gen
Poranna Łunia świeciła nad miastem Krakowem , gdy wsiadałam do pociągu .	Krakowem	5	Ins
Bronił eksmitowanych na bruk , naprawiając błędy przyjętej przez koalicję SLD­PSL ustawy , grzmiał na globalistów i świeżych krajowych , drapieżnych kapitalistów .	SLD­PSL	10	Gen
– Dzwonił jakiś Kluba , pytał się , czy wiesz , że Zając nie żyje .	Zając	12	Nom
Tylko w czterech państwach w Europie pojawiły się sieci DCS .	Europie	5	Loc
Wicemistrzynie Polski z Mielca nie dały pograć w Krakowie Wiśle i opuściły ostatnie miejsce w tabeli właśnie na rzecz podopiecznych Lesława Kędryny .	Krakowie	8	Loc
Le Pen straszy zjednoczoną Europą .	Pen	1	Nom
Policjant spojrzał na Nowaka .	Nowaka	3	Acc
Obecnie we Francji wykłada na uniwersytecie w Awinionie .	Awinionie	7	Loc
Linia Jana kończy się na świętym Stanisławie Kostce .	Kostce	7	Loc
Niedawno zapytał darłowskie dzieci , kim był król Eryk .	Eryk	8	Nom
Zdradzisz nam sekrety urody Cosmodziewczyny ?	Cosmodziewczyny	4	Gen
Koncern nadal ma umowy licencyjne z producentami w Japonii , Włoszech , Afryce Południowej i na Filipinach .	Japonii	8	Loc
Podczas mojej pierwszej bytności w Londynie miałam , dzięki uprzejmości pani z biblioteki polskiej , dostęp do teczki Krystyny .	Krystyny	18	Gen
Zupełnie nie udał się start naszej pięciobojowej młodzieży w mistrzostwach świata w czwórboju nowoczesnym kobiet i mężczyzn w szwedzkiej Uppsali .	Uppsali	19	Loc
Dwa lata temu powstało koło w Ostrowcu Świętokrzyskim .	Ostrowcu	6	Loc
Jak planował , pojechał do Jurka wczesnym popołudniem .	Jurka	5	Gen
Nie ma pan w Jankowicach żadnych krewnych .	Jankowicach	4	Loc
Tragiczny wypadek zdarzył się na trasie kolejowej z Piły do Chojnic .	Chojnic	10	Gen
Potwierdzili ścisłość obserwacji Broki .	Broki	3	Gen
Raue z entuzjazmem przyjął tę propozycję .	Raue	0	Nom
Klaskał mu prezydent Kwaśniewski oraz zgodnie prawa i lewa strona .	Kwaśniewski	3	Nom
Ale cały czas marzył , żeby zobaczyć Samarkandę .	Samarkandę	7	Acc
Staruszkowie skwapliwie wyściskali Pindla , a on stał oszołomiony .	Pindla	3	Acc
- Próbowali śmy jej tutaj pomóc , ale w końcu zabrano ją do najlepszego szpitala w Kijowie .	Kijowie	16	Loc
Z Michalskim było gorzej , ale to osobny temat .	Michalskim	1	Ins
W piątek otrzymała w nagrodę kuchenkę mikrofalową , ufundowaną przez Makro .	Makro	10	Acc
Amerykanie zajęli Carantan .	Amerykanie	0	Nom
Zwycięzcą biegu maratońskiego został 87-letni dziś Koreańczyk Ki - jung Son .	Son	10	Nom
Kopacz rozłożył bezradnie ręce .	Kopacz	0	Nom
Jewhen drzemał na krześle przy drzwiach .	Jewhen	0	Nom
Kiedy w Banja Luce skończył się ostatni , decydujący o medalu mecz , Halina leżała na parkiecie , a na niej kłębiła się góra ciał .	Luce	3	Loc
Nawiązano współpracę z kołami gospodyń wiejskich w Domatkowie , Kolbuszowej Górnej , Nowej Wsi , Weryni i Widełce .	Kolbuszowej	9	Loc
Niemcy wyrzucają z mieszkania Konstantego Prusa .	Prusa	5	Acc
Podmuch obrócił go i Nicholas zahaczył barkiem o coś miękkiego .	Nicholas	4	Nom
Gra Hindusa - anglofila .	Hindusa	1	Acc
Wypytywała rodaków o Warszawę , interesowała się przeżyciami Tomka w czasie wyprawy i nawet namawiała go usilnie , aby pozostał w Australii .	Australii	21	Loc
Za Pożarowem rozpoczynają się lasy i jeziora .	Pożarowem	1	Ins
Jest samodzielny , codziennie dojeżdża na zajęcia 12 km z Koszalina .	Koszalina	10	Gen
Teraz na zamówienie mafii gangi złożone z zamieszkałych w Niemczech Polaków kradną samochody wybranej marki .	Polaków	10	Gen
Edison z trudem uspokoił przyjaciela i pomocnika .	Edison	0	Nom
Dlatego w Masterlink pojawiają się kolejne etaty na odległość .	Masterlink	2	Loc
Surowy , suchy klimat , huraganowe wiatry oraz nieurodzajność gleb spowodowały , że odkryta w 1520 roku przez Magellana Patagonia długo nie była kolonizowana przez Europejczyków .	Magellana	18	Acc
- Z tą Martą też nic dobrego nie wyjdzie .	Martą	3	Ins
W czwartkowe popołudnie gasili płonący śmietnik przy ul. Brodzińskiego w Proszowicach .	Brodzińskiego	8	Gen
Seniorska reprezentacja Polski zbliża się do zgrupowania we Wronkach .	Wronkach	8	Loc
Rozmaite padliny wieszano na Sienkiewiczu , ale ja w jego obronie zawsze staję .	Sienkiewiczu	4	Loc
Goldman zrobił pauzę .	Goldman	0	Nom
- Zobaczymy , czy RS AWS będzie już mógł samodzielnie działać .	AWS	5	Nom
Stanisława Mackiewicza , Cata , trudno scharakteryzować .	Stanisława	0	Acc
Napadła ś na Kucyka , a to jest ich człowiek w terenie i nie dadzą go ruszyć .	Kucyka	3	Acc
Wkrótce zawiniemy do Trondheim .	Trondheim	3	Gen
Odbywają się one w 100 fabrykach i PGR-ach .	PGR-ach	7	Loc
Odpowiada Bohumil Panik .	Panik	2	Nom
Potem polski papież został by w Watykanie kanonizowany .	Watykanie	6	Loc
Rafał Blechacz zapowiedział , że w niedzielę palmową ma zamiar zagrać kolejny ważny koncert .	Blechacz	1	Nom
IZABELLE ADJANl , gwiazda filmu francuskiego , wygrała precedensowy proces .	IZABELLE	0	Nom
Pierwsza stanęła Parnecka .	Parnecka	2	Nom
Niektórzy didżeje wpisują sobie występ w Pieksie do CV .	CV	8	Gen
To w Czesławie nadal Róży się podoba .	Czesławie	2	Loc
Chodzi o to , by dobrze rozumieć Chopina .	Chopina	7	Acc
był eś w Meksyku ?	Meksyku	3	Loc
Na Trakcie Królewskim ma stanąć Ronald Reagan .	Ronald	5	Nom
Kuba tego nie pamięta , ale wie od mamy .	Kuba	0	Nom
Ich celem był sklep spożywczy w Niedalinie .	Niedalinie	6	Loc
Rodzina i przyjaciele powitali w sobotę uwolnione przez rosyjskie służby specjalne Polki .	Polki	11	Acc
Jednak już wkrótce Nizioł i Wapiński ze zdumieniem odkryli , że Łapiński nie dotrzymuje wcześniej danego słowa .	Nizioł	3	Nom
Nieprzytomnego Pawła znajduje właściciel pizzerii .	Pawła	1	Acc
W Warszawie jest ulica Nowy Świat .	Świat	5	Nom
Ognista łapa przejechała po głowie Liścia , ledwie zdołał jej umknąć .	Liścia	5	Gen
Rysiek dziękował Bogu , że nie wręczył prezesowi dolara w parku , bo by wtedy nie miał czego szukać .	Rysiek	0	Nom
Widział em rano , jak rozmawiała ś z tym sympatycznym młodzieńcem , Abibem Denisem .	Abibem	12	Ins
Przygoda u czoła Lodowca Hansa uświadomiła mi , że lepiej bezpośrednio nie dotykać lodowego klifu .	Hansa	4	Gen
Olszak posadził pajacyka na tapczanie .	Olszak	0	Nom
" Zuzanna lubi je tylko jesienią " .	Zuzanna	1	Nom
Nietschke myślał chwilę o samotnym , smutnym ptaku .	Nietschke	0	Nom
Chce w Bohatyrowiczach zrobić biznes .	Bohatyrowiczach	2	Loc
Po odparciu ataku i ujęciu 10 terrorystów zawrócono konwój do bazy w Al Kut .	Kut	13	Loc
Zostawiam wam Owsika , trzeba z nim natychmiast wyjść .	Owsika	2	Acc
W jakim języku rozmawia się z Japonią ?	Japonią	6	Ins
Z radością witali również państwa Paleniów sąsiedzi , którzy na tę okazję upiekli specjalny tort .	Paleniów	5	Acc
To się nazywało teatr , ale to było mieszkanie cioci Lecha Emfazego .	Emfazego	11	Gen
Krauze podszedł bliżej .	Krauze	0	Nom
Mówić on będzie dzisiaj o sytuacji religijnej i nowych ruchach w Europie .	Europie	11	Loc
Pomimo smutnej wymowy , sztuka obfituje w sceny humorystyczne , można również posłuchać piosenek Wasowskiego i Przybory .	Przybory	16	Gen
Tym kobylim synom chodzi o to , by Francja dostała guzik .	Francja	8	Nom
Podobne warunki terenowe charakteryzują cmentarzysko w Předmostí .	Předmostí	6	Loc
Obok miasta umieszczono cmentarz żydowski z wyeksponowanym nagrobkiem do złudzenia przypominającym ohel Sonnenberga .	Sonnenberga	12	Gen
Na drugich drzwiach widnieje Samson , herb Wattów .	Wattów	7	Gen
Sprzęt należał do Stacji Doświadczalnej w Łopusznej .	Łopusznej	6	Loc
Pani Kennedy siedziała przy zwłokach .	Kennedy	1	Nom
Adam Bylina chciwie popatrzył na plan .	Bylina	1	Nom
Do komendy policji w Olsztynie zgłosiła się matka aktorki .	Olsztynie	4	Loc
- Jaki los czeka Czeczenię ?	Czeczenię	4	Acc
Drugiej , rozładowanej do połowy w Pruszkowie , rabusie nie tknęli .	Pruszkowie	6	Loc
Następcy Piotra wybrali na siedzibę Rzym , a nie Jerozolimę .	Jerozolimę	9	Acc
Stworzyła polski oddział EquiLibre , organizowała konwoje z pomocą dla byłej Jugosławii , Kazachstanu , Czeczenii .	EquiLibre	3	Gen
Paul Dellapina skazany na dwadzieścia lat ucieka po raz ósmy z więzienia .	Paul	0	Nom
Rada Nadzorcza PZU zebrała się wczoraj rano .	PZU	2	Gen
Angelika przystąpi do komunii w kościele w Dytmarowie .	Dytmarowie	7	Loc
Czy zdążymy przed deszczem pochować pana Sierożę ?	Sierożę	6	Acc
– W HSW SA trwa obecnie wielkie liczenie .	HSW	2	Loc
Sex Pistols gramy od paru ładnych lat na specjalne okazje .	Sex	0	Acc
W Ameryce pozostały do dziś .	Ameryce	1	Loc
Kiermasze te zapowiadały Wielki Tydzień , który charakteryzował się postem i wyrzeczeniami .	Tydzień	4	Acc
- Jadę w stronę Palazzo di Giustizia .	Giustizia	6	Acc
Otyński jeszcze raz przebiegł wzrokiem pokój .	Otyński	0	Nom
Chciałbym podzielić się kilkoma przemyśleniami z Mikołajem Szymańskim .	Szymańskim	7	Ins
Przewodniczący Rady Państwa NRD Walter Ulbricht odwiedził Jugosławię .	Jugosławię	7	Acc
- Pan ma spotkanie z Zombiem ?	Zombiem	5	Ins
Ale , Yennefer , wydaj te polecenia szybko .	Yennefer	2	Nom
Marcin spojrzał zuchwale .	Marcin	0	Nom
Ale Marcin zdawał się tego wszystkiego nie widzieć .	Marcin	1	Nom
Premier Józef Cyrankiewicz przyjął wicepremiera Rumunii George Radalescu .	George	6	Acc
Rodzice Agnieszki nie motywowali jej do nauki .	Agnieszki	1	Gen
Jędrek urwał . . .	Jędrek	0	Nom
MPK prowadzi jeszcze rozmowy z wojskiem i PKP .	PKP	7	Ins
Weź Lolkę i idźcie na górę .	Lolkę	1	Acc
Dziś mieszka w Arkansas .	Arkansas	3	Loc
Zakon wysłał do nich delegację pod wodzą siostry Gizeli .	Gizeli	8	Gen
- Nazywam się Wiśnieski .	Wiśnieski	3	Nom
Gdyby Celina Szulc pozostała na stanowisku , związkowcy zamierzali ogłosić wczoraj strajk okupacyjny w łomżyńskich wodociągach .	Szulc	2	Nom
DigiPath przykładowo pozwala na zarządzanie drukowaniem dokumentów w sieci korporacyjnej .	DigiPath	0	Nom
- Mam zamiar zagrać wraz z Sinfonią Varsovią .	Sinfonią	6	Ins
Ja nawet premiera Oleksego lubię " .	Oleksego	3	Acc
W Kcyni odbyło się spotkanie z kandydatami na kierowników na samodzielny publiczny zakład opieki zdrowotnej w Kcyni i Kowalewku .	Kcyni	16	Loc
Uczestniczyli śmy z Jewhenem w tych seansach .	Jewhenem	3	Ins
Wiele szczęścia miała grupa uczniów z Warszawy , która wybrała się w niedzielę na pieszą wycieczkę po Karkonoszach .	Karkonoszach	17	Loc
I ma w dodatku zorganizowane oparcie w ZNP .	ZNP	7	Loc
Stachurski i Janusz Olędzki zastąpili latem Janusza Lacha i Artura Mazurka .	Mazurka	10	Acc
- Jadę w stronę Palazzo di Giustizia .	Palazzo	4	Acc
Przy prezydiach GRN w Iłowie i Kamionie działają już komitety przeciwpowodziowe .	GRN	2	Gen
jesteśmy w Koszalinie .	Koszalinie	2	Loc
Dobry Allach uratował honor naszego państwa !	Allach	1	Nom
O wrocławskim spotkaniu prezydentów Kwaśniewskiego i Chiraca oraz kanclerza Schrödera informowały wszystkie media .	Kwaśniewskiego	4	Gen
Uratujcie wierzącego chrześcijanina Walerego Marczenkę !	Walerego	3	Acc
Przedstawiciele Stalexportu zapewniają , że banki chcą dalej finansować holding .	Stalexportu	1	Gen
Jedynie Sermak starał się strzelać z dystansu .	Sermak	1	Nom
Amerykanie wzięli La Haie du Puy .	Puy	5	Acc
BMW wspomaga Rolls-Royce'a .	Rolls-Royce'a	2	Acc
- Venderk to prawnik .	Venderk	1	Nom
Jean Paul nie odzywał się .	Jean	0	Nom
Sprawą zajęła się już prokuratura w Gryficach .	Gryficach	6	Loc
Przedstawienie gnieźnieńskie wyreżyserował Zdzisław Wardejn w scenografii Jana Ciecierskiego .	Ciecierskiego	8	Gen
Ale jak zinterpretować pojawienie się kolędników w finałowej scenie , kiedy rozjadą się już Konrad i ksiądz Piotr ?	Piotr	17	Nom
Czytałem , że to dobry kryminał , poza tym lubię Ginę Gershon .	Gershon	11	Acc
Piszę o tym za zgodą kapitana Domejki .	Domejki	6	Gen
Kazio M . jest ciekawym przypadkiem .	Kazio	0	Nom
Kasprowicz opuścił Wrocław i wyjechał do rodzinnego Szymborza .	Wrocław	2	Acc
Rebelianci z tak zwanej Wyzwoleńczej Armii Kosowa zajęli Belacewacz tydzień temu .	Belacewacz	8	Acc
Mógł by zmienić zdanie , gdyby AWS i UW razem zaproponowały mu , by reprezentował je w wyborach .	AWS	6	Nom
Od dwóch lat w Woli Skolankowskiej goszczą niepełnosprawni artyści z Centrum Rehabilitacji w Grudziądzu .	Grudziądzu	13	Loc
Po utrwaleniu ich w formalinie przekazał je do muzeum w Paryżu .	Paryżu	10	Loc
Poznali się na weselu brata Edyty .	Edyty	5	Gen
Długi ograniczył się do spojrzenia .	Długi	0	Nom
W niedzielę 7 czerwca o godz . 17 Odra podejmuje Inę , a Mieszko o tej samej godzinie u siebie gra z Dąbrovią .	Inę	10	Acc
– W HSW SA trwa obecnie wielkie liczenie .	SA	3	Loc
Przyczyną tej zadziwiającej dla Europejczyków decyzji jest postać Prosiaczka , przyjaciela Kubusia .	Kubusia	11	Gen
Mussolini przemawiał pierwszy .	Mussolini	0	Nom
Listy Katarzyny do św . Rajmunda robią na mnie duże wrażenie .	Rajmunda	5	Gen
Polskę reprezentowały dwie kompozycje .	Polskę	0	Acc
Na drugim miejscu uplasował się Bolesław Prus .	Prus	6	Nom
Baryshnikov automatycznie skorzystał z Rangera .	Rangera	4	Gen
Przyjechał tu na Milkowszczyznę już jako doktor .	Milkowszczyznę	3	Acc
Towarzysz jego wzywał Jezusa i jego Matkę , a tacy ludzie jak Esteban wołają te słowa tylko twarzą w twarz ze śmiercią .	Jezusa	3	Acc
Trzy lata temu rozstał się z górniczą spółką mieszkaniową w Nikiszowcu .	Nikiszowcu	10	Loc
- Valoarna zmienia czerwony na biały !	Valoarna	1	Nom
Z czasem przeprowadzą się na Plewiska .	Plewiska	5	Acc
Dla pozostałych autobusów jadących w kierunku Śródki , dopuszczony zostanie przejazd ul . Estkowskiego .	Śródki	6	Gen
Stali na chodniku przed odrapanym budynkiem w Erewanie , w którym mieścił się Komitet Karabachu .	Karabachu	14	Gen
Są to Singapur i Jordania .	Singapur	2	Nom
Prokuratorowi oraz sędziom mówił , iż pojechał na Wschód , aby holować do Polski uszkodzony za Bugiem samochód .	Wschód	8	Acc
Nie czekając na decyzję Akcji , Unia Wolności zaczęła lansować na prezesa Karola Modzelewskiego , historyka i polityka związanego z Unią Pracy .	Modzelewskiego	13	Acc
Pamiętał teraz także , że Rychezę polecili mu poniekąd margrabiowie .	Rychezę	5	Acc
Tych zaś było dziś aż siedmiu na podwórku Adamusa .	Tych	0	Gen
Jesteś wyższy od wicepremiera Romana Giertycha ?	Romana	4	Gen
Przyczyną tej zadziwiającej dla Europejczyków decyzji jest postać Prosiaczka , przyjaciela Kubusia .	Europejczyków	4	Gen
Baszmaczkina sam niegdyś postawił em w dzienniku obok kopisty Bartleby z noweli Melville'a .	Baszmaczkina	0	Acc
Po incydentach w meczu derbowym ukarali ście Cracovię zamknięciem stadionu na dwa mecze .	Cracovię	7	Acc
Bogdan Borusewicz jest marszałkiem Senatu RP .	RP	5	Gen
Przemawiał pan poseł Czesław Pogoda .	Pogoda	4	Nom
Następcy Piotra wybrali na siedzibę Rzym , a nie Jerozolimę .	Rzym	5	Acc
Dobrze spisała się młodzież w Sterdyni , Ceranowie , Skrzeszynie , Czerwonce i Wężach .	Czerwonce	11	Loc
Będę więc dalej pracować , pojutrze lecę do Meksyku , ale w sobotę wracam .	Meksyku	8	Gen
Cały Boguszów trzęsie się z oburzenia .	Boguszów	1	Nom
- Jak pan sądzi , zobaczycie się z Bagsikiem w tym tysiącleciu ?	Bagsikiem	8	Ins
W końcu znalazł się w Lesznie .	Lesznie	5	Loc
Już Siwy wiedział , co robi !	Siwy	1	Nom
Siedział odchylony za swoim biurkiem z taką miną , jakby dowodził całą policją , Interpolem i FBI na dodatek i delektował się kawą .	Interpolem	14	Ins
– bo ty był eś na feragosto ?	feragosto	6	Loc
Chińczycy jednak wkrótce poparli interwencję na Węgrzech , bo tam już lała się krew .	Chińczycy	0	Nom
- Rysiek , dam ci ciężarówkę , ale mi nią przywieziesz Nałkowską z Adamowizny i Gojawiczyńską ze Stawiska !	Nałkowską	11	Acc
Jesienią Hamid też poszedł na wojnę , by pomścić brata .	Hamid	1	Nom
Rząd w Ułan Bator w lutym zaapelował o pomoc międzynarodową .	Bator	3	Loc
Druga kwestia zajmowała Sinego jeszcze bardziej .	Sinego	3	Acc
Nasze piłkarki w grupie zmierzą się z Niemcami , Szwecją i Szwajcarią .	Szwecją	9	Ins
Na Śląsku mamy ciemnoskórego kolegę .	Śląsku	1	Loc
Niechlubny ranking województwa wielkopolskiego otwiera Wojewódzki Szpital Zespolony w Lesznie .	Lesznie	9	Loc
Etiopczycy kontynuują atak , choć pod koniec ubiegłego tygodnia władze Erytrei poinformowały o wycofaniu swych oddziałów ze wszystkich spornych terenów nadgranicznych .	Erytrei	10	Gen
Toboła odprowadził Dębskiego na łodziowy .	Dębskiego	2	Acc
We wtorek prezydent Robert Choma skierował sprawę do rzecznika dyscyplinarnego UM Danuty Wiech .	UM	10	Gen
Studiują tutaj Łukasz Kruczek , Grzegorz Śliwka , Krystian Długopolski , teraz obok mnie studentem został Tomek Pochwała .	Śliwka	6	Nom
Pani Maria Figiel jest teściową Barbary .	Maria	1	Nom
Najpierw samodzielność uzyskał Zakład Naprawy Autobusów w Biskupicach , wcześniej stanowiący integralną część MPK .	Biskupicach	7	Loc
Na obiedzie byli Józewscy .	Józewscy	3	Nom
Trzy lata temu rozstał się z górniczą spółką mieszkaniową w Nikiszowcu .	Nikiszowcu	10	Loc
Amerykanie zajęli Carantan .	Carantan	2	Acc
Dratewkę pani Joasia wyrwała z bestialskich łap pewnego szewca , którego niech piekło pochłonie .	Dratewkę	0	Acc
Był Szulkin .	Szulkin	1	Nom
Większość skradziono w Berlinie , Hamburgu , Kilonii i Bremie .	Kilonii	7	Loc
W zamian kuria proboszczem tego kościoła uczyniła jego starszego brata , ks . Zdzisława Struzika .	Struzika	14	Acc
Pierwsza dama Rosji przyleciała do Polski na zaproszenie Jolanty Kwaśniewskiej .	Kwaśniewskiej	9	Gen
Nawiązano współpracę z kołami gospodyń wiejskich w Domatkowie , Kolbuszowej Górnej , Nowej Wsi , Weryni i Widełce .	Wsi	13	Loc
- Pawle , nie jedź do Jerozolimy !	Jerozolimy	6	Gen
Do tego doszła rada od organizatora Wiesława Szczygielskiego .	Szczygielskiego	7	Gen
- W Gazie wybuchnie wojna domowa .	Gazie	2	Loc
Stawiam przed nim Sikorskiego , mimo wszystko .	Sikorskiego	3	Acc
W 1831 pod Komorzem A . Mickiewicz próbował przekroczyć granicę zaborów biegnącą na Prośnie , aby wziąć udział w powstaniu listopadowym .	Komorzem	3	Ins
Oni z kolei odkryli Związek Radziecki .	Związek	4	Acc
I przeczytaj coś o Simone de Beauvoir .	Beauvoir	6	Loc
De Gaulle jest stary .	Gaulle	1	Nom
Marszałek Senatu Alicja Grześkowiak zwróciła się o wyjaśnienie tej sprawy do Trybunału Konstytucyjnego .	Grześkowiak	3	Nom
Rządy Leszka Millera dużo dały wielu ludziom .	Millera	2	Gen
TP SA chce złagodzić planowane redukcje .	SA	1	Nom
Tymczasem do sieni wsadził głowę Kropa i dzwonił natarczywie .	Kropa	5	Nom
Zacznę od dziś nazywać Lewickiego Anakondą .	Lewickiego	4	Acc
Wcześniej Gracen stanowczo zaprzeczała , że utrzymywała intymne kontakty z prezydentem .	Gracen	1	Nom
Z oficjalnym żądaniem wobec MKOl , złożonym na piśmie , wystąpił Narodowy Komitet Olimpijski KRLD , domagając się od naczelnej władzy sportowej rewizji listy triumfatorów olimpijskich .	MKOl	4	Gen
Wielka kanalizacja gminy Tychowa to najnowsza inwestycja tutejszych władz .	Tychowa	3	Gen
Ale gospodarza zakatował 26-letni Dariusz D . z Kwidzyna .	Kwidzyna	8	Gen
Każda z tych miejscowości będzie uczestniczyć w programie wraz ze swoim partnerem z Ukrainy .	Ukrainy	13	Gen
Donald Tusk będzie miał kontrkandydata w wyścigu o fotel przewodniczącego Platformy .	Tusk	1	Nom
- Czy chce otrzymać azyl w Danii ?	Danii	6	Loc
Mówią , że chcą wynająć salę na bankiet dla gości z Zachodu .	Zachodu	11	Gen
W Ciechanowie bywam regularnie od 26 lat .	Ciechanowie	1	Loc
Na zakończenie uroczystości głos zabrał sam ks . kardynał Sodano , który na początku niemal czystą polszczyzną przywitał przybyłych gości oraz wyraził swoje zadowolenie z pobytu we Wrocławiu .	Sodano	9	Nom
Wraz z kadrą wyjadą Daria Kasperska , Paulina Rytwińska i Agnieszka Karcz .	Rytwińska	8	Nom
Tusk też tak początkowo myślał lokalizując Muzeum Wojny na Westerplatte .	Westerplatte	9	Loc
Za Wojciechowską przemawia jeszcze jeden argument .	Wojciechowską	1	Ins
O szczegóły poprosimy porucznika Achselringa .	Achselringa	4	Acc
Haberda patrzy na Gabrielę bez sympatii .	Gabrielę	3	Acc
- Mama , widział em Kuferbluma !	Kuferbluma	5	Acc
Lepper spotkał się wczoraj z rolnikami w Malechowie w województwie zachodniopomorskim .	Malechowie	7	Loc
Na Lower East Side straż pożarna stawia wówczas ogromne , żelazne pojemniki …	Side	3	Loc
Na terenie przyległym do Kolonii Wierzbicy znajdują się dwie garbarnie .	Kolonii	4	Gen
Najlepszy polski tyczkarz Janusz Gronowski przebywa obecnie w Finlandii .	Finlandii	8	Loc
Tylko wówczas widzimy , że Orfeusz zawiódł .	Orfeusz	5	Nom
Drzymałowie mieszkali w bocznej , zacisznej uliczce , w nowo zbudowanym domu .	Drzymałowie	0	Nom
Haberda patrzy na Gabrielę bez sympatii .	Haberda	0	Nom
Zosia Szymanowska była starszą siostrą Antka , mego dawnego kolegi od Batorego .	Batorego	11	Gen
Co oni wiedzą o Leninie ? ”	Leninie	4	Loc
- Moich zawodników zdopingowała wczorajsza porażka Górnika z Jeziorakiem .	Jeziorakiem	8	Ins
W Konstancinie-Jeziornie i Spale przygotowują się piłkarskie reprezentacje do nadzwyczaj ważnych spotkań .	Konstancinie-Jeziornie	1	Loc
Pani z jamnikiem spytała Kuronia , czy to jego samochód .	Kuronia	4	Acc
- Znam Marzenę .	Marzenę	2	Acc
- Trawianka azjatycka w Wiśle miała nie wytrzymać sezonu .	Wiśle	4	Loc
Od 1996 w Ekstraklasie gra drużyna miejscowej Odry .	Odry	7	Gen
Zaciągam się papierosem i próbuję przypomnieć sobie dawnego Dziedziuszkę .	Dziedziuszkę	8	Acc
NIP nadaje urząd skarbowy .	NIP	0	Acc
Zaprosił do Varietes Budapest .	Budapest	3	Gen
Dyrektor archiwum na Łubiance przekazał te materiały synowi Stanisława Głąbińskiego .	Łubiance	3	Loc
- Z Lechowskim i Szamockim jest kiepsko .	Lechowskim	2	Ins
Igor Kantorowski zajmował się również krytyką literacką .	Igor	0	Nom
Kiedy mówi się o cudach w Lourdes , kiedy ktoś dostąpił cudownego uzdrowienia , Kościół prosi lekarzy , aby wypowiedzieli się na ten temat .	Lourdes	6	Loc
I kamera pokazuje go w panterce , na froncie w Bośni .	Bośni	10	Loc
Kochał Dorę , ale nie potrafił odejść od Zofii , swej żony .	Dorę	1	Acc
Jego zadaniem jest ponowne wylansowanie pojazdów tej marki w największym segmencie w Europie .	Europie	12	Loc
Na twarzy Marii zgasł uśmiech .	Marii	2	Gen
Będą pracować w Wilczycach i w rejonie Ćmielowa .	Wilczycach	3	Loc
Iluż poważnych obecnie pisarzy czytało swe pierwsze próby literackie w sali przy Krupniczej , siedząc wokół dębowych stołów zsuniętych pośrodku .	Krupniczej	12	Loc
Łagodnie usiłował panią Barbarę postawić na nogi .	Barbarę	3	Acc
Liwus , Magdasf1 ma rację , lepiej dla pewności zrobić sobie test .	Liwus	0	Nom
Wiece i akademie odbyły się również w Sofii , Damaszku , Kabulu , Surabai i innych miastach .	Damaszku	9	Loc
Zamki przemycała kobieta handlująca na bazarze Różyckiego w Warszawie .	Warszawie	8	Loc
W Burkina Faso dominują muzułmanie .	Burkina	1	Loc
- To anteny Polcomtelu .	Polcomtelu	3	Gen
Konferencji przewodniczył Antoni Żeglej .	Antoni	2	Nom
W Denver można znaleźć ogród zoologiczny , który jest najchętniej w tym mieście odwiedzaną atrakcją .	Denver	1	Loc
Pora rozstać się z Hehem i chłopakami .	Hehem	4	Ins
Chińczycy jednak wkrótce poparli interwencję na Węgrzech , bo tam już lała się krew .	Węgrzech	6	Loc
Najgłośniejsza draka wybuchła o Tywonka .	Tywonka	4	Acc
Może być attache kulturalny na Hawajach .	Hawajach	5	Loc
W Typinie , małej wiosce pod Tomaszowem Lubelskim , wrze .	Tomaszowem	6	Ins
Starostwo katowickie zwraca się do Giesche SA , by bezdomnych pozostawić w spokoju .	SA	6	Gen
- Jaka jest Moskwa Putina ?	Moskwa	3	Nom
Przy prezydiach GRN w Iłowie i Kamionie działają już komitety przeciwpowodziowe .	Kamionie	6	Loc
tutaj obcięła m Ewelinę .	Ewelinę	3	Acc
( Michał krzywi się , wyraźnie zirytowany . )	Michał	1	Nom
jest na niej 250 szopek nigdy dotąd poza Betlejem niepokazywanych .	Betlejem	8	Ins
Dokonać charakterystyki Tatr na podstawie mapy wielkoskalowej .	Tatr	2	Gen
Będzie matka Agnieszka kontenta . . .	Agnieszka	2	Nom
- Teraz ubieraj się już , Simonne .	Simonne	6	Nom
Studiują tutaj Łukasz Kruczek , Grzegorz Śliwka , Krystian Długopolski , teraz obok mnie studentem został Tomek Pochwała .	Łukasz	2	Nom
W Betlejem zupełnie utracili ducha dociekliwości , z punktu widzenia intelektualisty zachowali się nadzwyczaj pokornie .	Betlejem	1	Loc
Teraz do kontrakcji przystąpili wszyscy ludzie przegranego Rybnika .	Rybnika	7	Gen
Bogu zawierzam i w Bogu pokładam nadzieję .	Bogu	4	Loc
Przed 6 lat w Ludowo - Demokratycznej Republice Jemenu wprowadzono nowe prawo rodzinne .	Republice	7	Loc
Napisał ją Chilijczyk Ariel Dorfman .	Chilijczyk	2	Nom
W Laskach w liturgii uczestniczyło się przez cały dzień i modliło się wszędzie .	Laskach	1	Loc
Uratujcie wierzącego chrześcijanina Walerego Marczenkę !	Marczenkę	4	Acc
Opublikowano też felieton pułkownika Bosaka .	Bosaka	4	Gen
- Na pewno taką możliwość ma Ungier .	Ungier	6	Nom
Starcie między Generałem a MRP przybrało nawet formy drastyczne .	MRP	4	Ins
Musimy częściej przyjeżdżać na Służewiec .	Służewiec	4	Acc
Wśród osób , które nielegalnie przekroczyły wschodnią granicę , było sześciu obywateli Bangladeszu , dwóch Afgańczyków i czterech Kurdów irackich , w tym kobieta z dzieckiem .	Kurdów	18	Gen
Z ciał potopionych stryjów wylęgły się tysiące myszy i wyruszyły wszystkie do Kruszwicy , prosto na dwór zbrodniarza .	Kruszwicy	12	Gen
Zapomniał eś dodać okultyzm Ojca Pio i Katarzyny Neuman .	Pio	5	Gen
Spustoszył potem Kujawy i zabrał wielkie łupy , które jednak mistrz prowincji mu wydarł .	Kujawy	2	Acc
Kulesza oczywiście nie wstał na jego powitanie .	Kulesza	0	Nom
Popatrz na tych młodych KZT .	KZT	4	Acc
- Przypomniał em sobie obie Prylińskie i kaszankę .	Prylińskie	5	Acc
Edek odmówił , nie chciał zostawić Mali .	Edek	0	Nom
Bardzo zachęcam do wizyty w ICM i stałego korzystania z jej usług .	ICM	5	Loc
Timoszenko goni Niemców za Rostowem .	Rostowem	4	Ins
Proszę o zabranie głosu pana senatora Ryszarda Żołyniaka .	Żołyniaka	7	Acc
Zmieniłem Marka Walburga , bo rozbolał go żołądek i po prostu musiał szybko udać się do ubikacji .	Marka	1	Acc
W Zwieczycy koło Rzeszowa autobus PKS wpadł do głębokiego rowu .	Zwieczycy	1	Loc
Krystyna Kofta ogłosiła , że przyjmuje na siebie misję walki o równouprawnienie Bożen z Krystynami i za dwa lata zaprosiła panie do Trójmiasta , by równość tę udowodnić .	Kofta	1	Nom
- Kriszan , odwieziesz pana na Stare Delhi .	Delhi	7	Acc
Mock przytulił się do hrabiny i objął jej kruche ramiona .	Mock	0	Nom
Przypomnijmy , że 16 lipca 1994 r . dziadkowie półtorarocznej wówczas Moniki zostawili ją przed legnicką apteką pod opieką ojca , Roberta Bielawskiego .	Moniki	11	Gen
Rzecznik przyznała , ze ministerstwa generalnie krytykują założenia przygotowane przez ministra finansów Jarosława Bauca .	Jarosława	12	Acc
Gdy Dominika przyjechała po matkę , Babel dożywał swych dni .	Babel	6	Nom
Bardzo panią proszę o interwencję w FPNP .	FPNP	6	Loc
Duszy nie ma , ale Kotliński nienawidzi Kościoła z całej duszy .	Kotliński	5	Nom
Zdaniem obrońców polecenie osadzenia Chodorkowskiego w pojedynczej celi przyszło z samego Kremla , który chce złamać byłego szefa koncernu naftowego .	Kremla	11	Gen
Zastawał em Janka w ciemnym pokoju .	Janka	2	Acc
Nie odzywając się przez cały czas do siebie , dojechali śmy do Wisły .	Wisły	12	Gen
Przez dwa ostatnie tygodnie policjanci zaczęli podejrzliwie obserwować Staszka i Dawida .	Dawida	10	Acc
Nasze piłkarki w grupie zmierzą się z Niemcami , Szwecją i Szwajcarią .	Szwecją	9	Ins
Bartoch zapalał się coraz bardziej i zdawało się , że o Franoszkach zapomniał .	Franoszkach	11	Loc
Czy prowadzi nas jeszcze Orfeusz , czy Hermes , a może od dawna już idziemy sami ?	Orfeusz	4	Nom
Marchewą wstrząsnęła taka sugestia .	Marchewą	0	Ins
Brazylijczyk , dwukrotny zwycięzca wielkoszlemowego Roland Garros , podkreślał przed spotkaniem , że najważniejszym elementem piątkowej potyczki będzie skuteczna gra przy własnym serwisie .	Roland	5	Gen
Tak spotkali śmy Jezusa .	Jezusa	3	Acc
Tradycja związana ze św . Wojciechem głosi , że w X w . założył on w Trzemesznie klasztor benedyktynów .	Trzemesznie	16	Loc
Spoglądam na Ignaca .	Ignaca	2	Acc
Nie wiem , czy Putin to Piotr II , który chciałby przywiązać Rosję do Zachodu , by uczynić ją silną .	Rosję	12	Acc
Ziemię z Przemyśla wiezie się dla rodaków w Nowym Jorku .	Jorku	9	Loc
Reputację intelektualisty potwierdził , cytując obficie Witolda Gombrowicza i Stanisława Jerzego Leca .	Witolda	6	Acc
- Może spotkasz swojego starego znajomego , Szmidta .	Szmidta	7	Acc
Machał na Hunta ponaglająco , jakby w istocie w Nicholasa mocy było jeszcze bardziej przyspieszyć pracę nóg .	Hunta	2	Acc
Odzyskanie rodowej siedziby jest jednym z głównych celów Fundacji założonej w latach 90 . przez ks . Adama Czartoryskiego .	Czartoryskiego	18	Gen
Na licytację wystawione zostaną prace uczniów i szkolnego plastyka Romana Waszko .	Waszko	10	Gen
Ostatni stanął w kolejce Osiński .	Osiński	4	Nom
CZY WARTO PISAC O INGEMARZE STENMARKU ?	STENMARKU	5	Loc
Już widze Opłatek w kulinarnej oprawie Hejrublańskiego !	Hejrublańskiego	6	Gen
Przed tygodniem wicestarosta Hrycyna podczas wyjazdu do Gdańska uzyskał przychylność tamtejszych środowisk żydowskich .	Gdańska	7	Gen
Pseudokibicom ze Stalowej Woli upiekło się , choć nieźle w sobotę nabroili .	Woli	3	Gen
Mieszkała m w Dobrziszu .	Dobrziszu	3	Loc
- Storację zabiorę stąd .	Storację	1	Acc
Wieś leży na Szlaku Zamonitu z Błędowa do Poraja .	Błędowa	6	Gen
Daję dzieciom wiele swobody w naszym domku pod Warszawą .	Warszawą	8	Ins
- Ale ich liczba w Europie będzie szybko rosnąć .	Europie	5	Loc
Zwodujcie Wałęsę .	Wałęsę	1	Acc
- Kiedy spotkał Pan Białoszewskiego ?	Białoszewskiego	4	Acc
Oni z kolei odkryli Związek Radziecki .	Związek	4	Acc
Według KPN budżet państwa traci na [import]cie paliw , a zasady koncesjonowania są niejasne .	KPN	1	Gen
W tej sytuacji wiele przedziałów w pociągach nad morze , w góry i na Mazury zajmują koloniści .	Mazury	14	Acc
Obecnie mieścić się one będą w Zweibruecken i w Wormacji .	Zweibruecken	6	Loc
Stachurski i Janusz Olędzki zastąpili latem Janusza Lacha i Artura Mazurka .	Olędzki	3	Nom
Popatrzyli śmy z Ludwikiem na siebie , zaskoczeni , bez słowa .	Ludwikiem	3	Ins
On też miał we Lwowie kancelarię prawniczą .	Lwowie	4	Loc
Oficjalnie cały Sejm RP śpi .	RP	3	Gen
Przeprowadziła się tutaj z Krakowa .	Krakowa	4	Gen
Na piersiach dyndały im krzyże z Jezusem Chrystusem .	Jezusem	6	Ins
Leki na obniżenie temperatury nie działały , a sytuacja , według słów Havlovej , w nocy z poniedziałku na wtorek stała się krytyczna .	Havlovej	12	Gen
Wuj matki , Bronisław Werner , spędził pięć lat w aresztanckich rotach w Orenburgu .	Orenburgu	13	Loc
Czekali śmy wszyscy na odpowiedź Bradleya .	Bradleya	5	Gen
Maria Kadłubek odebrała wydany zaocznie wyrok sądu grodzkiego .	Kadłubek	1	Nom
Walkom rewolucyjnym towarzyszyły klęski rosyjskie na Dalekim Wschodzie w wojnie z Japonią .	Wschodzie	7	Loc
Ród Piastów pochodził z plemienia Polan .	Piastów	1	Gen
Rodzina i przyjaciele powitali w sobotę uwolnione przez rosyjskie służby specjalne Polki .	Polki	11	Acc
Stałą obserwacją objęta jest ulica Bohaterów Warszawy od poczty głównej do placu Wolności .	Wolności	12	Gen
W dwie godziny później Ania i Norbert siedzieli w fotelach w pokoju gościnnym przy łóżku Karoliny .	Ania	4	Nom
Pięcioletnia dziewczynka , porwana wczoraj przez 65-letniego mężczyznę w Chorzowie na Śląsku , odzyskała wieczorem przytomność .	Chorzowie	9	Loc
O tych wszystkich wydarzeniach Agnus dowiedział się z opóźnieniem , gdyż rodzice w pierwszym okresie nie chcieli przekazywać mu złych wiadomości .	Agnus	4	Nom
Ale nie rozumiem , jak można w imię ekumenizmu wysuwać roszczenia do tworzenia w Europie stref monopolistycznych wpływów religijnych .	Europie	14	Loc
Na przykład z Australią łączył em się na dwudziestoletnim radiu mojego ojca .	Australią	3	Ins
Na licytację wystawione zostaną prace uczniów i szkolnego plastyka Romana Waszko .	Romana	9	Gen
Moda na École de Paris niewątpliwie zasłużenie dowartościowała to środowisko artystyczne , ale w przypadku niektórych nazwisk także przewartościowała .	École	2	Acc
Czy doszła do Pana moja Scena Zazdrości ?	Pana	3	Gen
Karina pracowała na oddziale dziecięcym .	Karina	0	Nom
Kochamy Polskę , lecz fakty składające się na polską rzeczywistość działają nam na nerwy .	Polskę	1	Acc
O tym , że on sam chciał oszukać przeciwnika , Iwanuszka nie pomyślał .	Iwanuszka	10	Nom
W Betlejem zupełnie utracili ducha dociekliwości , z punktu widzenia intelektualisty zachowali się nadzwyczaj pokornie .	Betlejem	1	Loc
- Jestem w Rzymie tylko czasowo .	Rzymie	3	Loc
Jedynie opisywane przez panią żółwie na Seszelach się p . . .	Seszelach	6	Loc
W przypadku BIG-u ostatni miesiąc roku obrachunkowego przyniósł wynik poniżej tegorocznej średniej .	BIG-u	2	Gen
Ja ich spotkał em na Mazurach .	Mazurach	5	Loc
„ Kiedy dojdzie do procesu Reinefahrta ” ?	Reinefahrta	5	Gen
Czostek ma autorytet .	Czostek	0	Nom
Złoty medal w kategorii do 68 kilogramów zdobyła Kamila Zgolak .	Kamila	8	Nom
Działo się to podczas dochodzenia do nabrzeża w Ystad .	Ystad	8	Loc
