Telpā nebija scenogrāfijas uzbūves vai rekvizītu , izņemot zālē iebūvētās kolonas , ap kurām riņķoja V. Varslavānes efektīgajos XVIII gs. modi imitējošajos tērpos ģērbtās , balti pūderētās aktrises .	iebūvētās	9	Acc
Ar iekasēto naudu savukārt bija iespējams algot pa impēriju izkaisītos romiešu armijas leģionārus .	izkaisītos	9	Acc
Arī viņa retorika ir jūtami pamainījusies .	pamainījusies	5	Nom
Vecrīgā naktī nekādi nevar saklausīt atsevišķu automašīnu sacelto troksni Purvciemā .	sacelto	7	Gen
Uzpūšot vējam , no ziedošas plūmes bedrē birst ziedlapiņas .	ziedošas	4	Gen
Tikusi atkal Slēpnī , viņa atvēra aploksni un izņēma no tās vairākas ar mašīnu aprakstītas lapas .	aprakstītas	14	Acc
Tāpat tiek nolauzti balsti un bojātas sadalnes ceļu satiksmes negadījumos .	bojātas	5	Nom
Izmantojot formu tehnoloģiju ir iespējams pilnīgi atjaunot un izlīdzināt gandrīz pilnīgi nograuztos nagus .	nograuztos	11	Acc
Ceturtais kritērijs paredz augšupejošas pieejas īstenošanu , lemjot iejaukties vai neiejaukties kādas rīcībpolitikas īstenošanā , lai risinātu vardarbības skarto sabiedrības indivīdu pamatvajadzības .	skarto	18	Gen
Bet Haims dzīvoja Rēzeknē , apbedīts ebreju kapos .	apbedīts	5	Nom
Tikai tās seksualitāte ir dīvaina , tiešos vārdos nekur nenosaukta , toties ar katru lappusi starp rindām aizvien vairāk sajūtama .	sajūtama	19	Nom
Vara var būt koncentrēta noteiktas sabiedrības daļas , elites rokās , vai arī izkliedēta dažādās sabiedrības daļās .	noteiktas	4	Gen
Glābēji norāda , ka kuģis varēja būt apgāzies , kad , tuvojoties krastam , pārāk daudz cilvēku bija sakāpuši uz augšējā klāja , lai būtu mobilo sakaru pārklājuma zonā un varētu veikt zvanus .	apgāzies	7	Nom
Zināmākie šā virziena pārstāvji ir Pjērs Burdjē un Bezils Bernstains , kuru darbi apraksta kā izglītības process atbalsta noteiktas sabiedrības elites kultūru un tās pieņemto kodu pārzināšanu .	pieņemto	24	Acc
Pēc Gaismas pils apmeklējuma Itālijas vēstnieks Latvijā pauda gandarījumu par redzēto un raksturoja topošo bibliotēku kā civilizācijas pieminekli , salīdzinot to ar Ēģiptes piramīdām .	redzēto	10	Acc
Okaups norādīja , ka Igaunijai tuvākajās nedēļās ir jādod atbilde , vai valsts piekrīt EK uzstādītajam sodam .	uzstādītajam	15	Dat
Jāatļauj gājējiem pārvietoties pa ceļiem un takām , kas izveidoti aizsargājamās teritorijas apskatei .	aizsargājamās	10	Gen
Tā kā nāve tādā gadījumā neiestājas uzreiz , tā nav acumirklīga , pašnāvniecei ir dota iespēja apdomāties , lai lūgtu pēc palīdzības , tāpēc viņas biežāk var tikt izglābtas .	dota	14	Nom
" Līdz brīdim , kamēr attīrīšanas iekārtas iztekā nebūs konstatētas vides prasībām pieļaujamās attīrītā ūdens kvalitātes normas , attīrītais ūdens netiks novadīts vidē , " sacīja uzņēmuma pārstāvis .	attīrītā	13	Gen
Tādā gadījumā ir notikusi nelaime .	notikusi	3	Nom
JRT dibināšanas datums tomēr saistāms ar 1992. / 1993. gada sezonu , kad ar Kultūras ministrijas rīkojumu tiek izveidots jauns valsts dotēts repertuāra teātris .	dotēts	21	Nom
Tāpat finanšu ministrs ar pašvaldības amatpersonām pārrunās novada demogrāfijas problēmu , lai rastu risinājumu rindu uz bērnudārziem pašvaldībā , kā arī tiks iepazīstināts ar aktuālo situāciju izglītības iestāžu darbību .	iepazīstināts	22	Nom
Obligāti novērtē arī sezonas aktuālo modes izlasi , kas liks tavai sirdij sisties straujāk un lūkoties pēc košiem un pamanāmiem pavasara toņiem !	pamanāmiem	19	Dat
Dziedātājs Kriss Brauns noliedz informāciju , ka koncerta laikā būtu iesitis fanam un beigu beigās uzkāpis uz viņa galvas .	uzkāpis	15	Nom
Kopti un veseli nagi ir svarīgs faktors , lai rokas būtu vizuāli pievilcīgas , tāpēc ir svarīgi , kā mēs tās kopjam .	Kopti	0	Nom
Grilētās maizītes vari pārkaisīt arī ar piparmētru lapiņām , bet ogas vari aizvietot ar banāniem vai žāvētiem augļiem .	žāvētiem	16	Dat
Ņemot vērā veikto analīzi , varam secināt , ka pedagoģisko darbinieku skaitu ietekmējošos faktorus var nosacīti iedalīt trīs grupās – demogrāfiskie faktori , sociālie faktori un ekonomiskie faktori ( sk. 5. att. ) .	ietekmējošos	12	Acc
No tā , kas iekrāts , knapi pietiks materiāliem un samaksai meistariem par darbu .	iekrāts	4	Nom
Stilizētā , palēninātā kustībā , skatītājiem muguru pagriezis , spēles laukumā iztaustās Ģirta Krūmiņa Vailds , uzceļ uz paaugstinājuma krēslu , apsēžas tajā stilizētā pozā , tad citā apsēžas un citā – it kā meklējot efektīgāko .	Stilizētā	0	Gen
Taču šajā variācijā , kurā piesummēti somugri igauņi , jau jārunā nevis par etnisku kopību , bet gan jaunāko laiku ģeopolitisku veidojumu , kuru vieno atrašanās Baltijas jūras austrumu krastā .	piesummēti	5	Nom
Florence aplūkoja savas domas , aplūkoja vārdus — kā tie jocīgi pulsē un kursē pelēkajā telpā aiz aizvilktiem aizkariem .	aizvilktiem	17	Dat
Tikmēr uz sakarsētas pannas izcep divas olas .	sakarsētas	2	Gen
Latvijas migrācijas politikai pašlaik ir jārisina virkne problēmjautājumu , kas saistās ar emigrācijas pieaugošo apjomu , kvalificētā darbaspēka deficītu , sabiedrības novecošanos , strukturālo bezdarbu un vispārējo valsts mērķi pēc iespējas ātrāk pārvarēt atpalicību no ES vidējā dzīves līmeņa .	pieaugošo	13	Acc
Helēna skatījās , un Baņuta ieraudzīja , ka Helēna redz divas nenoslaucītas drupačas un taukainas lupatas zīmējumu uz galda .	nenoslaucītas	11	Acc
Būvniecības nozarē ( 6,1 % ) apjoms kāpis par 14,6 % .	kāpis	7	Nom
Saistībā ar Valsts kontroles ( VK ) revīzijā par Jelgavas pašvaldības aģentūru darbību konstatētajiem nepamatotajiem tēriņiem Jelgavas pilsētas pašvaldība ņēmusi vērā ieteikumus un apņemas rūpīgāk kontrolēt savas aģentūras .	konstatētajiem	13	Dat
Nezināmais vēstuļu sūtītājs bija izglābis viņu no ikdienišķās dzīvošanas vienaldzības .	izglābis	4	Nom
Savukārt liela daļa pircēju , kurus nekustamo īpašumu iegāde vilina , bet vēl nav spiesta lieta , pašlaik nogaida .	spiesta	14	Nom
48 gadus vecā fotogrāfe apceļo pasauli , meklējot pamestas vietas , un piedzīvojumu meklējumos vienmēr līdzi ņem savu uzticamo mīluli .	uzticamo	18	Acc
Pārītis esot centies dažādi slēpt savas attiecības no Panarina komandas biedriem .	centies	2	Nom
Es domāju , ka daudz pareizāk būtu likvidēt šīs sekas , un te es pilnīgi piekrītu Muciņa kunga sacītajam par profilaksi .	sacītajam	18	Dat
Vienīgais veids , kā to paveiksim , ir saredzot mūsu radošās spējas visā to bagātībā , un saredzot mūsu bērnus kā to cerību , ko viņi nes .	radošās	10	Acc
Ornitologu vadībā jaunieši mācīsies pazīt tuvākajā apkārtnē dzīvojošos putnus , dosies dienas un nakts ekspedīcijās , kuru laikā ķers un gredzenos putnus .	dzīvojošos	7	Acc
« Latvijā beidzamo reizi biju 2014. gada oktobrī .	beidzamo	2	Acc
Nesam taču ne tikai laikrakstus , bet arī ierakstītas vēstules , rēķinus .	ierakstītas	8	Acc
Vēsajā gaisā stikls liekas aizsarmojis , sīkām ledus dzīsliņām caurvīts .	aizsarmojis	4	Nom
Par kukuļņemšanu KNAB izmeklētājs rosina uzsākt kriminālvajāšanu pret četrām bijušajām " Latvenergo " amatpersonām , pret divām uzsākt no tām - arī par noziedzīgi iegūtu līdzekļu legalizēšanu .	bijušajām	9	Dat
" Mēs esam no Eiropas pārņēmuši visus noteikumus , lai nepieļautu diskrimināciju , un neredzu šā jautājuma aktualitāti , " Neatkarīgajai saka ministre , uzsverot , ka ministram ir izvēles tiesības , iet gājienos vai neiet .	pārņēmuši	5	Nom
Jelgavas slimnīcas virsārste Solveiga Ābola informē , cietušā meitenīte krītot bija sasitusi sānus , taču lūzumu nebija .	cietušā	7	Gen
Tu esi ne tikai redzējusi kādu radījumu no pasaules izplatījuma .	redzējusi	4	Nom
Ģenerālprokuratūra cēlusi apsūdzības piecām iesaistītajām personām tā dēvētajā uzņēmuma " Latvenergo " amatpersonu kukuļošanas lietā , aģentūru LETA informēja prokuratūras preses sekretāre Aiga Šēnberga .	iesaistītajām	4	Dat
Pateicoties veiktajiem uzlabojumiem , uzņēmums varēs ātrāk , precīzāk un kvalitatīvāk padot izejvielas maizes ražošanas līnijām , kā arī optimizēt darba resursus , tādējādi palielinot uzņēmuma ražošanas jaudas .	veiktajiem	1	Dat
Tās piemēro pirmajā daļā minētos noteikumus jebkurai darba devēja maksātnespējai , kas iestājusies pēc šādu noteikumu spēkā stāšanās dienas .	iestājusies	12	Nom
Pārsvarā būvmateriāli objektā nav bijuši nodrošināti ar ekspluatācijas īpašību deklarācijām , būvizstrādājumiem nav noteiktas un novērtētas ekspluatācijas īpašības , ir konstatēti gadījumi , kad būvizstrādājumi ir iebūvēti neatbilstoši paredzētajam mērķim .	paredzētajam	28	Dat
Pēdējās nedēļas notikumi , lai arī viņa jau zināja un gatavojās , ka agri vai vēlu tas notiks , ir atstājuši emocionālu triecienu un izsmēluši viņu .	atstājuši	20	Nom
Latvijas pašvaldību policisti tiek pakļauti nežēlīgai diskriminācijai , “ Kursas Laikam ” pauž kāds vīrietis , kurš vēlas palikt anonīms .	pakļauti	4	Nom
Makss asi piebremzēja , lai nesabrauktu pāri ceļam ejošu suni .	ejošu	8	Acc
Tie darbojās tā , lai laistu caur sevi maksimālo dienas gaismas daudzumu ( Tv = 38 % ) pie paaugstināta mākoņainuma un minimālu dienas gaismas daudzumu laistu saulainā laikā ( Tv = 11 % ) .	paaugstināta	19	Gen
Jaukākais tad esot , ka nekur nav jāskrien un laiks nav saplānots pa stundai un minūtei , kā ikdienā .	saplānots	11	Nom
Ja , piemēram , darbā uzsāktais projekts izgāžas , to vēlāk varēs pārstrādāt , kļūdas labot , bet ar bērnu tas nav iespējams .	uzsāktais	5	Nom
Acīmredzot palu laikā organiskais materiāls tiek iznests piekrastes teritorijās un par spīti apstākļiem , kas varētu veicināt dūņu uzkrāšanos , šis process nav novērojams .	iznests	6	Nom
Šobrīd 27 gadus vecais hokejists ir savainots un nav spēlējis kopš septembra otras puses .	savainots	6	Nom
Šajā gadījumā par applūstošajām teritorijām nav skaidrs , kura ir tā vērtība , kas ir jāizsargā .	applūstošajām	3	Dat
Projekts tiek vērtēts kā veiksmīgs , jo tas bija veicinājis Baltijas valstu savstarpējo militāro integrāciju un nodrošinājis nepieciešamo apmācību un personāla kvalifikāciju , lai piedalītos starptautiskajās operācijās .	veicinājis	9	Nom
Sofija siltajā ziemeļu upē redzēja rietošās saules ceļu , laivas un iedegušus vīrus košos kreklos , apaļām cepurēm galvās .	rietošās	5	Nom
Kad ieradās ugunsdzēsēji , dievnams jau dega ar atklātu liesmu , drīz vien iebruka jumts .	atklātu	8	Acc
Pinnes vārds iepriekš figurējis arī Latvijas kadetu un junioru izlases kandidātu sarakstā , tiesa , Eiropas čempionātos vēl nav iznācis piedalīties .	iznācis	19	Nom
Viņiem galvenais drukātā vārda lasīšanas veids būs kaut kas līdzīgs planšetdatoram .	drukātā	2	Gen
Sodu reģistrā minētā informācija būs pieejama ar vienu , tā teikt , klikšķi : datorizētās apstrādes sistēmas attiecīgais darbinieks vienkārši nospiedīs podziņu un attiecīgi automātiski saņems arī izdruku par personām , kuras sauktas pie administratīvās atbildības .	datorizētās	14	Gen
Lielbritānijas premjeru Gordonu Braunu , kurš pirms nepilna mēneša piedzīvoja pazemojošu sakāvi municipālajās vēlēšanās , gaida atkal jauns pārbaudījums .	pazemojošu	10	Acc
Nākamais karalis visu nakti lūdzās Reimsas katedrālē , prasot Dievam spēku un gudrību , lai veiksmīgi pārvaldītu valsti .	Nākamais	0	Nom
Viens no redzamākajiem ES veicinātiem fenomeniem ir brīva darbaspēka kustība , kas Latvijas gadījumā nozīmēja strauju ietekmi uz demogrāfisko situāciju , proti , starptautiskās migrācijas neprognozēti augstu pieaugumu .	redzamākajiem	2	Dat
Tāpēc var runāt vienīgi par kādu perifēru nozīmju grupu , kas aptver tiešu skatījumu un zināmo , iepriekš pieredzēto .	pieredzēto	18	Acc
Tas ir saistīts gan ar nepieciešamību garantēt sekmīgu izglītības sistēmas , tajā skaitā vispārējās izglītības sistēmas , darbību , gan arī ar nepieciešamību racionāli izmantot pedagoģisko darbinieku izglītošanai pieejamos resursus .	pieejamos	28	Acc
Nūdistu biedrībai par labu nenāca arī tas , ka tās vadītājs Jēkabs Nalda bija preses kriminālhronikās slejās bieži pieminētais Latvijas armijas atvaļinātais virsnieks Jēkabs Grīnbergs , kuru policija daudzkārt bija pieķērusi izplatām un pašu lietojam kokaīnu .	atvaļinātais	21	Nom
Apnikušās drēbes nemazgātas var mest ārā pa logu virsū cilvēkam , kurš šeit pastaigājas kā pa sev svešas realitātes muzeju .	Apnikušās	0	Acc
Tāpat cilvēki ir norūpējušies par ietekmi uz vidi , vienlaikus atzīstot , ka jaunās tehnoloģijas novērš būtiskus riskus .	norūpējušies	3	Nom
2. Līgumā noteikto saistību izpildi koordinē Satversmes aizsardzības birojs .	noteikto	2	Gen
Pievieno saberztu biezpienu , tad sodu ar miltiem , visu labi samaisa .	saberztu	1	Acc
Pagaidām šādu eksāmenu drīkst kārtot tikai reizi gadā , taču LZNP iesniegusi valdībai Notariāta likuma grozījumus , kas paredz neierobežot eksāmena kārtošanas laiku .	iesniegusi	11	Nom
Karjeras laikā esmu uzvarējis 21 ATP līmeņa turnīrā , tajā skaitā četros " Masters " turnīros un sezonas noslēguma turnīrā Londonā .	uzvarējis	3	Nom
Pareizi organizētas loģistikas uzdevums ir saglabāt produkta ārējo izskatu un sulīgumu , samazinot siltuma zudumus .	organizētas	1	Gen
Kad Mia atgriežas no peldes , viņa redz , ka tēvs mātes istabā sanesis visādus ziedošus zarus .	ziedošus	15	Acc
Ja saņemtais ziņojums attiecas uz jau strādājošu procesa verificēšanas instanci , tas tiek " nosūtīts " attiecīgajai instancei apstrādei .	strādājošu	6	Acc
Rastorgujevs savukārt ar 82 punktiem noslīdējis uz 31. pozīciju .	noslīdējis	5	Nom
Vecmāma ar vecpapu aizbrauca , vienmēr pametot palicējus sāpošām kājām .	sāpošām	8	Dat
Vēršanās pie Lielbritānijas un Francijas pierāda Latvijas vēlēšanos saņemt šo valstu garantijas vai pat atbalstu projektējamajam līgumam .	projektējamajam	15	Dat
Tāpēc var runāt vienīgi par kādu perifēru nozīmju grupu , kas aptver tiešu skatījumu un zināmo , iepriekš pieredzēto .	zināmo	15	Acc
Ņemot vērā veikto analīzi , varam secināt , ka pedagoģisko darbinieku skaitu ietekmējošos faktorus var nosacīti iedalīt trīs grupās – demogrāfiskie faktori , sociālie faktori un ekonomiskie faktori ( sk. 5. att. ) .	veikto	2	Acc
Kurzemē deviņus gadus vecai meitenei kritiens no šūpolēm beidzies ar lauztu roku .	lauztu	10	Acc
Turklāt kāds no bijušajiem stipendiātiem ierosināja rīkot absolventu klubiņu .	bijušajiem	3	Dat
Pēc otrā bērna dzimšanas Kimai Kardašjanai nebija tikai jādomā , kā atgūt savu ierasto formu , bet arī jāsaskaras ar vecākā bērna greizsirdību .	ierasto	13	Acc
Kas ir tas , kas liek zaļajai augu vielai kilogramiem vien celties un velties no nedzīvās zemes augšup , tiklīdz laiks kļūst siltāks un ir izzudušas pēdējās sniega pēdas ?	izzudušas	25	Nom
Jelgavas pilsētas pašvaldības izpilddirektore Irēna Škutāne aģentūrai LETA apgalvoja , ka pašvaldība ir ņēmusi vērā VK revīzijas ieteikumus attiecībā par pašvaldības izveidotajām aģentūrām , kā arī veikusi aģentūru darbības lietderības , efektivitātes un ekonomisko izvērtējumu .	izveidotajām	21	Dat
Un tur varētu ielikt arī paralēli vēl vienu sadaļu , kurā būtu norādīti administratīvie pārkāpumi , kurus cilvēks ir izdarījis .	norādīti	12	Nom
Visstraujākais samazinājums bija vērojams būvniecības nozarē , apstrādes rūpniecībā , tirdzniecībā un sabiedrisko pakalpojumu nozarēs .	vērojams	3	Nom
1. Jebkura konvencijas dalībvalsts var ierosināt grozījumus un iesniegt tos Apvienoto Nāciju Organizācijas ģenerālsekretāram .	Apvienoto	10	Acc
Lai arī iedzīvotāji uzskata , ka būtu vairāk jāattīsta atjaunojamās enerģijas izmantošana , tai pašā laikā arī valda uzskats , ka jauna cietā kurināmā stacija palīdzētu dažādot izmantojamās enerģijas veidus un radīt jaunas darba vietas pilsētā .	kurināmā	23	Gen
Ja attiecīgajam līgumslēdzējam nav atbilstošas speciālās atļaujas vai industriālās drošības sertifikāta , Nacionālā drošības iestāde , kas piešķirs klasificēto līgumu , var lūgt , lai šim līgumslēdzējam tiek veikta atbilstoša drošības pārbaude .	klasificēto	18	Acc
Arī mūsu apkopotā informācija pierāda , ka darbinieki pret savu darba devēju un algas maksātāju ir kļuvuši lojālāki un beidzies laiks , kad strādājošo mainība bija mērāma desmitos procentu .	strādājošo	23	Gen
Vadītājs atstāja avarējušo braucamo un nozuda mežā .	avarējušo	2	Acc
VUGD Bauskas brigādē pašlaik ir 73 strādājošie , vakanču nav .	strādājošie	6	Nom
Rita pat neatceras , kad beidzamo reiz būtu dejojusi restorānā .	beidzamo	5	Acc
Kopumā 18. gs. vidū galvenais darbnīcu uzplaukums saistāms ar stikla taras izgatavošanu un masu produkcijas ražošanu .	saistāms	7	Nom
Pēdējās desmitgadēs daudzās attīstītajās valstīs novērojams vispārējs uzticēšanās sarukums , kurš tiek saistīts ar modernajai sabiedrībai raksturīgajām norisēm .	novērojams	5	Nom
2009. gadā nodarbināto skaits samazinājās visās tautsaimniecības nozarēs un gandrīz visās profesiju grupās .	nodarbināto	2	Gen
Tomēr lietas attīstījās - viens labs padarīts darbs nesa sev līdzi nākamo , honorāri gāja uz augšu ...	nākamo	11	Acc
Lielāka ietekme tam ir lēnās upēs ar dziļām gravām , padziļinātām upēm , kurās plūdu darbības ietekme samazinās .	padziļinātām	10	Dat
Personas sauktas pie kriminālatbildības par vairāku noziedzīgu nodarījumu izdarīšanu saistībā ar " Latvenergo " rīkoto Rīgas otrās termoelektrocentrāles otrās kārtas rekonstrukcijas iepirkuma konkursu .	rīkoto	14	Acc
Durbē svētkos izgaismotu objektu gan nebūs , pauž V. Kārkliņš .	izgaismotu	2	Gen
Tie būs ticības svētki , kuros galvenā loma piederēs mirušajiem , bet kas tomēr tiks svinēti līksmā greznībā .	mirušajiem	9	Dat
Sanāksmē paredzēts apmainīties viedokļiem par ciešāku Ekonomikas un monetāro savienību un uzklausīt informāciju par šā gada februāra vidū notikušo G20 sanāksmi .	notikušo	18	Acc
Konkursa komisija , vērtējot pretendentus , ņēmusi vērā pieredzi valsts vai pašvaldības darbā , izglītību , darba stāžu vadošos amatos un citus kritērijus .	ņēmusi	6	Nom
Latvijas , Igaunijas , Lietuvas un Polijas prezidenti Kijevā notikušajā reģionālajā apspriedē par Eiropas enerģētisko drošību pauduši atbalstu Gruzijas teritoriālajai integritātei un neatkarībai starptautiski atzīto robežu ietvaros .	atzīto	24	Gen
Ūdens pamazām mainījis krāsu un gaisā uzvirmojis līdz tam vēl nepazīts aromāts .	nepazīts	10	Nom
Tādējādi var teikt , ka tā ir veicinājusi krīzi .	veicinājusi	7	Nom
Jaunās maizes šķirnes - " Allažu Ķimeņu maize " , " Rucavas Sēklu maize " un " Staburaga Kliju maize " - radītas , iedvesmojoties no Latvijas dabas un godājot senču maizes cepšanas tradīcijas dažādos Latvijas novados .	radītas	22	Nom
Kalvenes pamatskolā apliecina , ka savāktā makulatūra nesen aizvesta , nu skolēni sākuši gaidīt apsolīto zīmēšanas papīru .	apsolīto	14	Acc
Es biju saraduši ar eņģeļiem .	saraduši	2	Nom
Es gaidu , kamēr viņš , rupji lamādamies , atrod simtlatnieku , pieceļas kājās , asinis saskrējušas sejā no piepūles un dusmām , un tad es pasmaidu , un pagriežos , un eju .	saskrējušas	16	Nom
Saistībā ar Valsts kontroles ( VK ) revīzijā par Jelgavas pašvaldības aģentūru darbību konstatētajiem nepamatotajiem tēriņiem Jelgavas pilsētas pašvaldība ņēmusi vērā ieteikumus un apņemas rūpīgāk kontrolēt savas aģentūras .	nepamatotajiem	14	Dat
Mēs iebraucam meža ceļā un skūpstāmies , viņa skūpsti sasien mani mezglā , un neatsietai man jābrauc mājās , jo mašīnā mīlēties viņš negrib .	neatsietai	14	Dat
Homeopāta rūpes par jums patiesi neaprobežojas ar slimības izraisītajiem simptomiem vien , un par to liecina jau pirmā vizīte pie speciālista .	izraisītajiem	8	Dat
Procesi ir tādu notikumu un mehānismu pastāvīga atkārtošanās , kas noved pie līdzīgām pētāmo elementu transformācijām .	pētāmo	13	Gen
Kad Mia atgriežas no peldes , viņa redz , ka tēvs mātes istabā sanesis visādus ziedošus zarus .	sanesis	13	Nom
Ja jūs noņemat naga nelīdzeno virskārtu , tad dariet to ar mīksto saaudzējošo nagu vīlīti , lai netraumētu naga emalju .	saaudzējošo	12	Acc
Ceļa Dobele – Bauska 69. kilometrā Rundāles novadā , netālu no Saulaines , tuvu braucoša automobiļa « Renault Megane » priekšā izskrēja stirna .	braucoša	14	Gen
Bērnībā es bieži redzēju eņģeļus , istabas stūrī pie griestiem , tik lielus kā strazdus , fosforescējošus , naktīs pamostoties .	fosforescējošus	16	Acc
Ar atjaunoto Rātsnamu Bauska ir atgriezusies Eiropā , » sacīja I. Lancmanis .	atjaunoto	1	Acc
Veterinārajās aptiekās pieejami vairāku veidu ērču izvelkamie .	pieejami	2	Nom
Pinnes vārds iepriekš figurējis arī Latvijas kadetu un junioru izlases kandidātu sarakstā , tiesa , Eiropas čempionātos vēl nav iznācis piedalīties .	figurējis	3	Nom
Vienīgi varētu būt gadījumi , kad tiks rūpīgāk izvērtēti palīgā saucēju zvani .	izvērtēti	8	Nom
Savukārt ārējā pamatojumā tiesai jāizskaidro juridiskā siloģisma premisu izvēle – jāatveido risinājuma rašanas gaitā notikušais dialogs , kurā mijiedarbojušies par lietas faktiskajiem apstākļiem un piemērojamo tiesību normu paustie viedokļi un argumenti .	notikušais	14	Nom
Ieēdu karsti kūpinātu skumbriju ar ceptiem šampinjoniem .	ceptiem	5	Dat
Labākā laikā sirmgalvis piemājas dārziņā nesaudzīgi apkaroja gliemežus , Kolorādo vaboles un citus mošķus vai laiskojās uz nama priekšā dziļi smilšainajā augsnē iegrimuša betona soliņa .	iegrimuša	22	Gen
Ir lībieši , kas spējīgi sazināties iekaltām frāzēm , bet to vairs nesaucam par dzimto valodu .	dzimto	14	Acc
No rīta noņemiet kompresi , noskalojiet kājas siltā ūdenī un paberzējiet pārakmeņojušos ādu ar cietu birstīti .	pārakmeņojušos	11	Acc
Būtiski , lai šie resursi tiktu pareizi izmantoti : pareizi ir uzticēties uzticamajam un neuzticēties neuzticamajam ; savukārt nepareizi ir uzticēties neuzticamajam un neuzticēties uzticamajam .	neuzticamajam	15	Dat
R. Auševs esot nodevis teroristu prasības Ziemeļosetijas Iekšlietu ministrijas štābam , bet pēc tam par tām informēts Krievijas prezidents Vladimirs Putins .	nodevis	3	Nom
Ieva lūkojās , kā tas lēnām rāpjas lejā no augstumiem — lien gar pelēki ribaino ārējo sienu kā trombs pa uzblīdušu asinsvadu , kā dzeltena acs , kas , iztraucēta apcerē , viņiem nesteidzīgi pievēršas .	iztraucēta	29	Nom
Diez vai pašam nav aizmeties dilonis .	aizmeties	4	Nom
Ir lībieši , kas spējīgi sazināties iekaltām frāzēm , bet to vairs nesaucam par dzimto valodu .	iekaltām	6	Dat
Mani personīgi pārsteidza , ka Vācijā viens no maniem , var teikt , bērnības draugiem 2015. gadā par patērēto siltumu savā mājsaimniecībā , kuru viņš apkurina ar gāzi , samaksāja mazāk nekā bija jāmaksā atbilstošai mājsaimniecībai Latvijā .	atbilstošai	34	Dat
Erdogans aicināja visas politiskas partijas sākt strādāt pie jaunas civilas konstitūcijas , kas aizvietotu 1980. gadā pieņemto pamatlikumu .	pieņemto	16	Acc
Ieēdu karsti kūpinātu skumbriju ar ceptiem šampinjoniem .	kūpinātu	2	Acc
Globalizācijas ietvaros starptautiskā tirdzniecība ir veicinājusi izaugsmi un attīstību , taču tā nav stimulējusi nodarbinātības kvalitātes pieaugumu .	stimulējusi	13	Nom
Uzmanīgi tuvojamies dambim , apejot bebru izraktās alas grāvja malā .	izraktās	6	Acc
Dziedātājs Kriss Brauns noliedz informāciju , ka koncerta laikā būtu iesitis fanam un beigu beigās uzkāpis uz viņa galvas .	iesitis	10	Nom
Ne visai sen Kultūras ministrijā nodibināta vēl viena uzraugoša institūcija — Mediju politikas nodaļa .	nodibināta	5	Nom
Pillar pārdoto objektu skaits 2012. gadā , salīdzinot ar 2011. gadu , ir divkāršojies , sasniedzot 254 nekustamos īpašumus .	pārdoto	1	Gen
Turklāt modernajai sabiedrībai raksturīgās īslaicīgās attiecības samazina nepieciešamību pēc attiecību turpināšanas , vienlaikus samazinot arī pamudinājumu būt uzticamam .	uzticamam	17	Dat
Izceļams rīkojuma 10. punkts , kas norāda , ka jaunieši jāapgādā kā savi ģimenes locekļi un jānodrošina ar pilnu pansiju – gultas vietu , drēbēm un pārtiku .	Izceļams	0	Nom
Par finanšu iestāžu atalgojuma politiku Latvija kopumā atbalsta Eiropas Parlamenta piedāvāto priekšlikumu , jo īpaši jautājumā par to , ka atalgojuma mainīgā daļa nedrīkst pārsniegt fiksēto daļu .	piedāvāto	10	Acc
2006. gadā viņi uzvarēja tiesas prāvā par šī likuma grozīšanu , taču parlaments to pārstrādāja tā , ka monopols vienalga palika aklo un licencēto masieru rokās .	licencēto	23	Gen
Sīkais meitēns parādīja apskaužamu sīkstumu .	apskaužamu	3	Acc
Vērtīgākās ziņas aplūkojamās tēmas sakarā rodamas muižu un baznīcu materiālu mapēs .	rodamas	5	Nom
Šajā izdalītajā lietā apsūdzības uzrādītas Meļko , Liuzinikam un Stalažam .	uzrādītas	4	Nom
Tikmēr 33 % norādījuši , ka vidēji reizi gadā apskata , kas uzkrājies viņu zāļu skapīšos , un 16 % aptaujāto anketās bija atzīmējuši , ka to dara vismaz reizi pusgadā .	aptaujāto	20	Gen
Bet stāsta finālā Žeņečka , kuru Igors nolamājis par “ zilo ” , izmisīgi sitas pret zilas gaismas apspīdētajām kopmītnes istabas sienām , rausta un nespēj atvērt durvis , kuras patiesībā nemaz nav aizslēgtas .	apspīdētajām	18	Dat
Automehāniķi strādāja poligonā , kur jaunieši jau paspējuši iemēģināt jauno kartingu .	paspējuši	7	Nom
Būs sarūpēta arī zāļu tēja , ar ko varēs stiprināties organizatoru iecerētajām rotaļām .	iecerētajām	11	Dat
Taču , kā parādīju iepriekš , lai ietvari būtu efektīvi , tam ir jābūt atbilstošai sociālai bāzei un tiem ir jāsaskan ar potenciālo kustības dalībnieku pieredzi .	atbilstošai	14	Dat
Bez minētā būtisku ietekmi uz nepieciešamo pedagoģisko darbinieku skaitu vispārējās izglītības sistēmā atstāj arī pašas sistēmas izveides un darbības principi , kā arī infrastruktūras līmenis ( satiksmes iespējas u.c. ) .	minētā	1	Gen
Aizgājuši uz restorānu , dejojuši .	dejojuši	4	Nom
Savas organizatoriskās spējas jaunieši parādīja , veidojot Adventes laikam veltītus pasākumus , » stāsta A. Borinta .	veltītus	9	Acc
Vēl komandas sastāvā divu nedēļu treniņnometnē Itālijā piedalījušies Uldis Balbeks , Māris Gūtmanis , Kaspars Ernstons , Viesturs Morozs , Kristaps Rakštelis un Toms Mankus .	piedalījušies	7	Nom
Biedrība cer , ka jaunās patroneses piemērs veicinās arī uzņēmējus atbalstīt bāreņu un bez vecāku gādības palikušo bērnu aprūpi aizbildņu ģimenēs vai audžuģimenēs .	palikušo	16	Gen
Sofija saprata , ka viņa bija tikai izvērsusi šo problēmu .	izvērsusi	7	Nom
Vasks piebilda , ka patlaban prokuratūrā tiek izvērtēti notikušā apstākļi , lai varētu lemt par tālāko rīcību .	notikušā	8	Gen
Mazāk tiek analizēta problēmas skaitliskā un finansiālā puse .	analizēta	2	Nom
Rietumvalstu prese ziņo , ka Dubaijas lidostā atstātas neskaitāmas automašīnas , jo viesstrādnieki aizbēguši uz dzimteni , pametot aiz sevis visu .	atstātas	7	Nom
Bet neviens no kažoka dziļumā mītošajiem pat nepakustas un nepievērš uzmanību filosofa saucienam .	mītošajiem	5	Dat
Kā negatīvu iezīmi etniskajos stereotipos jāmin arī tajos ietvertās prognozes attiecībā uz vērtējamās etniskās grupas locekļu rīcību , kā arī to , ka stereotipa aizsargmehānismi ignorē un apslāpē acīmredzamo , kas noliedz tajā pārvērstos faktus .	ietvertās	8	Acc
Izrādē ar humoru un smeldzīgām skumjām tiek atklāta Benzīnvīra pasaule , pilna pārsteidzošu tēlu un notikumu .	pārsteidzošu	12	Acc
Veikalos pārdod vien importētos ābolus , galvenokārt no Polijas .	importētos	3	Acc
Ierakstīto biogrāfisko interviju atšķirīgā kvalitāte apliecināja pieņēmumu , ka intervēšana ir māksla , kas pilnveidojas tikai prakses gaitā un prasa rūpīgu darbu ( Gāle-Kārpentere , 2001 , Miller , 2000 ) .	Ierakstīto	0	Gen
J. Kalvāns pastāstīja , ka Latvijā tiek ieviesta dalīta atkritumu savākšana , līdz ar to uzņēmumā tiks saražoti zili , zaļi un dzelteni konteineri .	dalīta	8	Nom
Ebreju misticisms - viena no vissenākajām un visintriģējošākajām garīgajām sistēmām , apgalvo , ka sapņi mums sniedz neskaitāmas atslēgas uz sevis izziņu un paver ceļu pie visaugstākās gudrības un saiknes ar kosmosu .	visintriģējošākajām	7	Dat
Viss aizliegtais kļūst sevišķi interesants .	aizliegtais	1	Nom
Viens no redzamākajiem ES veicinātiem fenomeniem ir brīva darbaspēka kustība , kas Latvijas gadījumā nozīmēja strauju ietekmi uz demogrāfisko situāciju , proti , starptautiskās migrācijas neprognozēti augstu pieaugumu .	veicinātiem	4	Dat
5. Ārstniecības persona triju dienu laikā pēc ieslodzītā uzņemšanas ieslodzījuma vietā veic ieslodzītā veselības pārbaudi .	ieslodzītā	12	Gen
Vecāmāte stāstīja , ka kara laikā dzīvžogs neesot ļāvis lapsām lavīties dārzā medīt vistas , kas brīvi ganījušās pa dārzu .	ļāvis	8	Nom
Lasīju par citu sasniegto , nomestajiem kilogramiem , bet pati turpināju ēst visu , kas pagadās .	nomestajiem	5	Dat
Trešā mīkla bija — kas ir Hilda Mellere Knāga , un kāpēc Sofija saņēma pilnīgi svešai meitenei domātu dzimšanas dienas apsveikumu .	domātu	17	Acc
Tātad šeit saskaras teksta autora tiešais , nepastarpinātais skatījums un pieredze , iepriekš zināmais , kas balstīts uz konkrētiem apsvērumiem .	balstīts	16	Nom
Seko stāsts par Sāru , pievienoto vērtību mājas pirkumam : " Saimnieki steidzami brauca projām , pārdeva māju par ciešamu cenu un lūdza mūs parūpēties arī par suni .	ciešamu	19	Acc
Lielākā daļa no sabrukušās masas sakoncentrējās mākoņa centrā , tādā veidā izveidojoties Saulei , bet pārējais palika protoplanetārajā diskā , kur izveidojās planētas , pavadoņi , asteroīdi un citi mazie Saules sistēmas objekti .	sabrukušās	3	Gen
Esmu mēģinājusi zīmēt , taču tas nav vajadzīgs filmai .	mēģinājusi	1	Nom
Ar darbaspēka migrāciju saistīto problemātisko profesiju sarakstos neiekļūst tikai neliels skaits profesiju , uzskatot , ka nekvalificētais darbaspēks jāmeklē vietējās darbaspēka rezervēs .	saistīto	3	Gen
Kādā brīdī Rītiņš sapratis , ka pārāk bieži mēdz iedzert un iestājies anonīmajos alkoholiķos .	sapratis	3	Nom
Šajā brīdī Helēnai gribējās celties un ātri skriet vai skaļi raudāt , raudāt tā , kā izraud ilgi aizturētas emocijas .	aizturētas	18	Acc
Un šajā sakarā man jāteic , ka 2014. gadā ministrijās un centrālajās valsts iestādēs nav izlietoti 3 procenti no ieplānotā finansējuma jeb 121 miljons eiro .	ieplānotā	19	Gen
Pateicoties tam , ka jūras ūdens ir vasarā uzkrājis lielu siltumu daudzumu , ziemas un rudens te ir siltākas nekā dziļāk sauszemē .	uzkrājis	8	Nom
Arī Margarita nu ir pāri , viņa ir to izdarījusi , un tūlīt aiz viņas muguras mašīnas nosvītro izdarīto .	izdarīto	18	Acc
30. Ēdienkartē izmantojamie produkti nedrīkst saturēt ģenētiski modificētos organismus , nedrīkst sastāvēt no tiem un nedrīkst būt ražoti no tiem .	ražoti	17	Nom
Taurupietis Dzintars Cīrulis , kurš šogad atzīmēja 76 gadu jubileju , joprojām nespēj samierināties ar to , ka vienā dienā tika izpostīti viņa senču kapi , tāpēc ar laikraksta starpniecību vēlējās atklāt savu sāpi .	izpostīti	21	Nom
Pēdējā desmitgadē , kopējam valsts budžeta finansēto studentu skaitam praktiski nemainoties , budžeta finansēto studentu skaits izglītības jomā ir samazinājies no 5990 studentiem 2000. / 01. studiju gadā uz 3064 studentiem 2007. / 08. studiju gadā .	finansēto	6	Gen
Skolotājai prieks ir arī par iegūtajiem mūzikas centriem , kas palīdzēs attīstīt aerobikas konkursu tradīciju , kas skolā ir populāra .	iegūtajiem	5	Dat
Tās piemēro pirmajā daļā minētos noteikumus jebkurai darba devēja maksātnespējai , kas iestājusies pēc šādu noteikumu spēkā stāšanās dienas .	minētos	4	Acc
Viņi , kastaņetes klaudzinādami , izstaigāja istabas , apskatīja guļošos un ilgi nevarēja izdomāt , kuru no šīm dvēselēm nomaitāt .	guļošos	9	Acc
Lai palutinātu ķermeņa ādu un tā nezaudētu elastību , vislabāk ieteicams izmantot sezama eļļu , kas ajūrvēdā ir pazīstama kā universāls līdzeklis gan ārīgai , gan iekšķīgai lietošanai .	ieteicams	10	Nom
Kad ideja tapusi , zīmēšanas process norit ātri .	tapusi	2	Nom
Pie Irinas aktieris ieradies ar pāris čemodāniem , ņemot līdzi pašu nepieciešamāko , bet pārējās mantas aizsūtījis pie vecākiem .	aizsūtījis	16	Nom
„ Sabiedrība , kas nav attīrījusies , nav spējīga būvēt no totalitārisma mantojuma patiesi brīvu , plaukstošu valsti , jo to nomāc pagātnes rēgi un neizgaismotās padomju sistēmas ēnas , ” tā ir izteikusies dzejniece Liāna Langa .	neizgaismotās	25	Nom
Tāpat tiek nolauzti balsti un bojātas sadalnes ceļu satiksmes negadījumos .	nolauzti	2	Nom
Edgars Andersons sev raksturīgajā piesardzīgajā stilā kritizējis Baltijas valstu izvēlēto novilcināšanas taktiku .	kritizējis	6	Nom
Jūs nebijāt iedomājušies , ka Šekspīram ir tēvs , vai ne ?	iedomājušies	2	Nom
Cietusī nogādāta slimnīcā .	Cietusī	0	Nom
Esošajā atsavināšanas likumā ir noteikts : ja būves īpašnieks nomaksas pirkuma līguma darbības laikā atsavina ēku , ar tās jauno īpašnieku tiek slēgts minētā nomaksas pirkuma līguma pārjaunojuma līgums .	slēgts	22	Nom
Bijušās Jelgavas Būvmateriālu un konstrukciju rūpnīcas teritorijā Neretas ielā 1 tika pārņemta ražotne , kurā top transporta betons ( to atšķirībā no dzelzsbetona piegādā tieši klientam ) .	Bijušās	0	Gen
Jau pēc mirkļa rūķis bija iemērkts sveķos , kas uzreiz pārvērtās dzintarā , un knariņš sastinga ar sviesta smaidu karstā putrā .	iemērkts	5	Nom
Runāja , paģiraino elpu ievilkdams .	ievilkdams	4	Nom
Inficēto sifilisa slimnieku skaita straujš pieaugums var liecināt par kārtējo sifilisa epidēmiskā pacēluma sākumu , turklāt pieredze rāda , ka sifilisa epidēmijas parasti uzliesmo , būtiski pasliktinoties ekonomiskajai situācijai un dzīves līmenim .	Inficēto	0	Gen
Kopš tiem laikiem tēja cilvēcei kalpo ne tikai kā lielisks atspirdzinošs dzēriens , bet arī kā nozīmīgs ārstniecības līdzeklis .	atspirdzinošs	10	Nom
Vēja veidotām kāpām ir ļoti atšķirīga forma .	veidotām	1	Dat
Es arī labi apzinos to , ka arvien vairāk sastapsimies ar tā saucamajām bibliotēkām bez grāmatām , kad bibliotēka ir , bet grāmatu tur nav , lai gan tā joprojām ir bibliotēka .	saucamajām	12	Dat
Pastiprināta svīšana un ādas raga kārtas sabiezējums uz delnām un pēdām liecina par sviedru dziedzeru pārmaiņām , var būt sūdzības par niezi un dedzinošu sajūtu .	dedzinošu	23	Acc
Normatīvais regulējums paredzot pašvaldības tiesības izvērtēt sniegtos priekšlikumus , vienlaikus darot sabiedrībai zināmu pieņemtā lēmuma pamatojumu .	pieņemtā	13	Gen
Gadu gaitā nolietotajai Rīgas notekūdeņu kanalizācijas sistēmai nebija pa spēkam savākt lietusūdeni , kas pagājušās nedēļās nogalē pārpludināja pilsētas ielas pēc stipras lietusgāzes .	pagājušās	14	Gen
Kad autobuss izlaida nedaudzos līdz galapunktam atbraukušos pasažierus , nosprauslājās un apklusa arī motors .	atbraukušos	6	Acc
Apnikušās drēbes nemazgātas var mest ārā pa logu virsū cilvēkam , kurš šeit pastaigājas kā pa sev svešas realitātes muzeju .	nemazgātas	2	Acc
Pagaidām bieži vien studenti ir apguvuši sadrumstalotas un pārāk vispārīgas zināšanas .	sadrumstalotas	6	Acc
Pēc jaunās ēkas apmeklējuma Džovanni Polici ieradās LNB Reto grāmatu un rokrakstu nodaļā Jēkaba ielā , lai iepazītos ar bibliotēkas reto izdevumu kolekciju , kuru veido arī virkne itāļu un Itālijā izdotu grāmatu .	izdotu	31	Gen
Lai izveidotu pabeigto tēlu , var noderēt nagi ar svētku dizainu , jo mūsdienīgās nail-art iespējas , kā zīmējumos tā arī materiālu izvēle ir praktiski neierobežotas .	pabeigto	2	Acc
Klusēdams vēroja uzgleznotās laivas .	uzgleznotās	2	Acc
Laura pie loga sēž šūpuļkrēslā un lūkojas laukā pa logu vienā punktā , kājas augšup sacēlusi un aptvērusi ceļus ar rokām .	sacēlusi	15	Nom
Mēs , kam ir jau dažs labs gads uz pleciem , jūtamies it kā mazliet samulsināti no bērna sajūsmas .	samulsināti	15	Nom
Esmu aiznests pavisam citā pasaulē .	aiznests	1	Nom
Tajā esošo personu vārdi netiek atklāti līdz pat fināla norises dienai .	atklāti	5	Nom
Savukārt Košrags sveicina ar mežā izmestiem ciema iedzīvotāju veciem ledusskapjiem un citiem sadzīves atkritumiem .	izmestiem	5	Dat
Iereibis gājējs vai velosipēdists , kurš diennakts tumšajā laikā pārvietojas pa ceļa braucamo daļu nopietni apdraud savu veselību vai pat dzīvību .	braucamo	12	Acc
Nu jau kādu laiku Mamikins ir “ saaudzis ” ar Briseles varas koridoriem , taču pēdējos mēnešos Saskaņu pārstāvošais Eiropas Parlamenta deputāts iecienījis koridorus tieši Krievijas vēstniecībā Briselē , kā arī Maskavā .	iecienījis	22	Nom
Testēšanas koordinators izmanto prasību - pārbaužu kontroliera sniegto informāciju tālākam darbam : pēc kārtas atrod visu pārbaudes moduļu izpildāmos failus , tos ielādē atmiņā un izpilda pārbaudes .	izpildāmos	18	Acc
Labajā pusē uz tahtas ar kājām pret logu guļ oma , kreisajā , uz izvelkamā dīvāna , ar galvu pret logu — opaps .	izvelkamā	14	Gen
Mēs abi esam precēti , mēs abi negribam pamest savas ģimenes .	precēti	3	Nom
Šis spriedums diemžēl kļuva par judikatūru , proti , šis spriedums , kurā tika noteikta minētā juridiskā atziņa jeb prejudīcija , tiesām jāņem vērā , spriežot lietas un piemērojot attiecīgās tiesību normas .	minētā	15	Gen
Pagājušo piektdien Salaspilī notika Valsts policijas atklātais čempionāts svaru bumbu celšanā .	Pagājušo	0	Acc
Tur bija aizņemts , bet citur teica , lai piezvanot vēl kur , bet to numuru es nezinu ...	aizņemts	2	Nom
Tomēr gan izglītības sistēmā pieejamo resursu ierobežotība , gan pēdējos gados notikušās pārmaiņas rada nepieciešamību izvērtēt pedagoģisko darbinieku skaita un izglītības tematiskajā jomā studējošo skaita atbilstību valsts izglītības sistēmas vajadzībām tagad un turpmākajos gados .	studējošo	23	Gen
Bijušā vīra argumenti bija gana pārliecinoši , lai liktu tiesnesim anulēt sava kolēģa pieņemto lēmumu un norunāt vel vienu tiesas sēdi .	Bijušā	0	Gen
6. Pārvaldes uzdevums tiek deleģēts uz laiku no saistošo noteikumu spēkā stāšanās brīža līdz 2016. gada 31. decembrim .	saistošo	8	Gen
Pārmeklējot apkārtni , kāpās atrada niķelētu suņa siksnu .	niķelētu	5	Acc
Tostarp uz Rīgu tiks atvesti arī itāļu literatūras un Itālijā izdoti darbi , kas motivēja Džovanni Polici iepazīties ar izstādes koncepciju un plānoto izstādes izvietojumu jaunajā bibliotēkas ēkā .	plānoto	22	Acc
Būtiski , lai šie resursi tiktu pareizi izmantoti : pareizi ir uzticēties uzticamajam un neuzticēties neuzticamajam ; savukārt nepareizi ir uzticēties neuzticamajam un neuzticēties uzticamajam .	neuzticamajam	21	Dat
Un arī tagad tu esi dzēris .	dzēris	5	Nom
Tomēr Helēna ievēroja , ka cēlā vīra acis , raugoties uz viņu , pildās ar neapvaldāmām , nenoslēpjamām skumjām , kas draudēja pārvērsties par daudzām stikla bumbiņām , kas tad neapturami ripotu un plīstu , ripotu un plīstu .	neapvaldāmām	15	Dat
Tiem , kuri ir iemīlējušies , ir ārkārtīgi grūti būt šķirtiem , tie ir smagi pārdzīvojumi , dažkārt pat jāiestāsta sev , ka tu ienīsti cilvēku , kuru patiesībā mīli .	iemīlējušies	4	Nom
Un nolikto atslēgu mehānisms ir tas regulators , kurš nostāda tirgū nekustamo īpašumu reālo , nevis uzpūsto cenu , jo motivē hipotekāros kreditorus necelt izsniedzamos kredītus virs cenas , par kuru viņiem varbūt nāksies īpašumu pārdot .	uzpūsto	16	Acc
No mājas iznāk Jasmīne un kar uz auklām baltu , pilošu , tikko izmazgātu palagu .	izmazgātu	13	Acc
Finanšu ministrija ( FM ) , komentējot jaunākos iekšzemes kopprodukta ( IKP ) apjoma datus , uzsver , ka IKP pieaugums ir izcils sasniegums un arī aizvadītais gads Latvijas ekonomikā bijis izcils .	aizvadītais	26	Nom
Eitanāzijas pārvaldi vada Janga Forevera sieviņa Jina , smalka , trausla būtne ar nenoliedzamām vadītājas dotībām .	nenoliedzamām	13	Dat
Pēc tam gari apskatīja čučošos bērnus , tomēr bērni viņiem nederēja , jo tie ir pārāk vāji un pārāk maz sver , lai kļūtu pat par mazu lietuvēnu .	čučošos	4	Acc
Ella savāca pierādījumus , ka dēls nelikumīgi iegādājies būvmateriālus , un lika tos galdā rajona partijas komitejā .	iegādājies	7	Nom
Es biju to jutis jau dienā .	jutis	3	Nom
Florence mācījās augstskolā , tomēr dzīve spieda viņu kaktā un lika strādāt līdz pusnaktij , jo lielākā daļa grūti sapelnīto līdzekļu izgāja par to , lai slepus , bet neatlaidīgi veidotu savu , neviena neapdraudētu terra incognita .	sapelnīto	19	Gen
Vidējās kvalifikācijas profesiju grupā visstraujāk samazinājās nodarbināto skaits būvniecībā , vidējā medicīnas personāla un māsu profesiju grupā , kā arī transporta līdzekļu vadītāju profesiju grupā .	nodarbināto	6	Gen
Taču it kā starp citu ieminējās , ka tagad šī uzraugošā institūcija saņems un regulāri lasīs arī “ Rēzeknes Vēstis ” .	uzraugošā	10	Gen
Baltijas Antantes nodibināšanas izraisītais optimisms bija pierimis .	izraisītais	3	Nom
Starp apsūdzētajiem gan nav Miķelsona toreizējā vietnieka Aigara Meļko , aģentūrai LETA apgalvoja Meļko advokāts Agris Bitāns .	apsūdzētajiem	1	Dat
Abas ir gluži netipiskas lomas un pretstati Ģirta tēlotajam romantiķim un mieramikam Leonam no seriāla “ Neprāta cena ” , taču jāatzīst , ka dziļāko dziņu apmierinājums būs gan garantēts , jo trakajiem jau pieder pasaule !	tēlotajam	8	Dat
Ar laiku šeit varētu ieviest licencēto makšķerēšanu , arī likumīgi zvejot .	licencēto	5	Acc
Lūgt naktsmājas šķirtajai sievai ?	šķirtajai	2	Dat
Manuprāt , mēs nonākam pie sekojošā : Als Gors vakar runāja par ekoloģiju un revolūciju , ko aizsāka Reičela Kārsone .	sekojošā	5	Gen
Babītes novada Babītes pagastā degušas neapsaimniekotas ēkas desmit kvadrātmetru platībā , šķūnis 60 kvadrātmetru platībā , kā arī kūla un niedres 10 hektāru platībā .	degušas	4	Nom
48 gadus vecā fotogrāfe apceļo pasauli , meklējot pamestas vietas , un piedzīvojumu meklējumos vienmēr līdzi ņem savu uzticamo mīluli .	pamestas	8	Acc
1973. gadā dzimis vīrietis , būdams 1,11 promiļu reibumā , Limbažos , Cēsu ielā vadīja automašīnu Volvo 850 bez jebkāda veida transportlīdzekļu vadīšanas tiesībām .	būdams	5	Nom
Pēc tam šie rezultāti tiks nosūtīti uz EBU un apstiprināti .	nosūtīti	5	Nom
Šis aspekts ir būtisks , jo līdzīgi kā iepriekš , daļa skatītāju konceptuālo nespēju nebūt redzamam uztver kā uzbrukumu .	redzamam	15	Dat
Esošajā atsavināšanas likumā ir noteikts : ja būves īpašnieks nomaksas pirkuma līguma darbības laikā atsavina ēku , ar tās jauno īpašnieku tiek slēgts minētā nomaksas pirkuma līguma pārjaunojuma līgums .	minētā	23	Gen
Bet daudz ir tādu , kas ir dzirdējuši citus runātājus , kam tās ir dzīvās atmiņas .	dzirdējuši	7	Nom
Nevienam nav ne jausmas , par spīti visai tai kompetencei , kas parādīta pēdējo četru dienu laikā , kā izskatīsies pasaule pēc pieciem gadiem .	parādīta	12	Nom
Ir nepieciešami dažādu līmeņu profesionāļi , tāpēc tūrisma eksperti pieļauj , ka ne visiem obligāti būtu jābūt ar augstāko izglītību — atsevišķām vakancēm pilnīgi pietiktu ar kvalitatīvu , uz praksi orientētu profesionālo izglītību .	orientētu	30	Acc
Arī Margarita nu ir pāri , viņa ir to izdarījusi , un tūlīt aiz viņas muguras mašīnas nosvītro izdarīto .	izdarījusi	9	Nom
7 ) Pēdējos gados Rīgā ir īstenoti tikai daži empīriski pētījumi , kas apskata Rīgas teritorijas funkcionālās struktūras attīstību , turklāt teritorijas transformācijas procesi pārejas periodā esošajos pētījumos nav apskatīti .	apskatīti	29	Nom
Valmieras pilsētas pašvaldībā , darbojoties juridiskās nodaļas vadītāja amatā , jau 2007. gadā izveidoju un pastāvīgi pilnveidoju pašvaldībai piederošo kapitālsabiedrību pārvaldības organizatorisko sistēmu , nodrošinot arī tās juridisko virsvadību .	piederošo	18	Gen
Tai vismaz jau kopš romiešu tiesībām ir atzīts arī juridisks aspekts .	atzīts	7	Nom
Ja lēmumu nav iespējams nekavējoties ( pēc materiālu izskatīšanas par psihiatriskās palīdzības sniegšanu bez pacienta piekrišanas ) noformēt rakstveidā , tā norakstu šīs daļas pirmajā teikumā minētajām personām nosūta pa pastu ne vēlāk kā nākamajā darbdienā pēc lēmuma paziņošanas .	minētajām	26	Dat
85. Ņemot vērā riska novērtējuma rezultātus , veicamā darba ilgumu un ergonomiskos ierobežojumus , darba vietu augstumā nodrošina ar sēdekli , kurš aprīkots ar atbilstošām palīgierīcēm .	atbilstošām	24	Dat
Lugu „ Frankenšteins ” , ko britu dramaturgs Niks Dīrs sacerējis pēc Mērijas Šellijas romāna motīviem un kas pirmizrādīta Londonas Nacionālajā teātrī 2011. gadā , uz Dailes teātra lielās skatuves iestudējusi Laura Groza-Ķibere .	pirmizrādīta	18	Nom
To ir atzinusi un inkorporējusi arī kristīgā mācība .	atzinusi	2	Nom
Nē , nekādus vadošus norādījumus “ Rēzeknes Vēstīm ” viņš nedeva .	vadošus	3	Acc
Reizēm tā bija apgrūtinoša , neskatoties uz to , ka Parlamentārās izmeklēšanas komisiju likumā valsts institūcijām un amatpersonām noteikts pienākums sniegt komisijas pieprasīto informāciju .	pieprasīto	22	Acc
Kas viņiem jauns , kas nomiris .	nomiris	5	Nom
Pētām tirgu , runājam ar Igaunijas un Lietuvas firmām , kas realizē zooveikaliem paredzēto produkciju .	paredzēto	13	Acc
Papildus par šogad izdotajām grāmatām , kas ir izdotas Valsts pētījumu programmas " Nacionālā identitāte ” un Latvijas Zinātnes padomes pētniecisko projektu laikā , dalīsies to autori un veidotāji video prezentācijās un klātienē .	izdotajām	3	Dat
Ebreju misticisms - viena no vissenākajām un visintriģējošākajām garīgajām sistēmām , apgalvo , ka sapņi mums sniedz neskaitāmas atslēgas uz sevis izziņu un paver ceļu pie visaugstākās gudrības un saiknes ar kosmosu .	neskaitāmas	17	Acc
ECC vakar paziņoja par savu gatavību pārtraukt aļģu izplatību veicinošo notekūdeņu izmešanu Baltijas jūrā ar noteikumu , ja ostas pieņems tos bez maksas .	veicinošo	9	Gen
Kamilla pēc pilsonības saņemšanas ierakstīja portālā « Twitter » , ka jūtas pagodināta , ka nu viņai ir Amerikas pase , jo mīl Ameriku un ir pieķērusies valstij .	pagodināta	12	Nom
Arī sacietējusī āda , kura pārsvarā parādās uz pirkstiem un pēdu sāniem , kas rada gana daudz nepatikšanu , daudzas sievietes uzskata par tulznām .	sacietējusī	1	Acc
Kopā ar komandu divas reizes uzvarēts VEF Latvijas Jaunatnes basketbola līgas čempionātā un vairākkārt izcīnītas otrās un trešās vietas .	uzvarēts	5	Nom
Ukrainas armijas vienības ielenktas to bāzēs , tomēr atsakās padoties un neatbild uz provokācijām .	ielenktas	3	Nom
Protestētāji dalīja lapiņas , kurās informēja par ĢMO radītajiem draudiem .	radītajiem	8	Dat
Netīrumus un sakrājušās mirušās ādas šūnas regulāri notīriet no nagu apakšas ar neasu kociņu , to ir jādara ļoti uzmanīgi , lai netraumētu naga iekšpusi .	mirušās	3	Acc
Nosūtītāja Puse nekavējoties rakstiski informē saņēmēju Pusi par jebkādām izmaiņām klasificētās informācijas klasifikācijas pakāpē , ar kuru ir notikusi apmaiņa .	klasificētās	10	Gen
Pašreizējā noteikumu redakcija neesot viennozīmīgi saprotama , to ir iespējams pārprast un procentuāli neprecīzi aprēķināt atbalsttiesīgo dzīvnieku skaitu , secinājusi Zemkopības ministrija .	secinājusi	19	Nom
30. Ēdienkartē izmantojamie produkti nedrīkst saturēt ģenētiski modificētos organismus , nedrīkst sastāvēt no tiem un nedrīkst būt ražoti no tiem .	izmantojamie	2	Nom
Kima atzinusies , ka glabā visas savas skaistās vakarkleitas , ar kurām viņa gadu laikā ieradusies uz « Meet Gala » pieņemšanu meitas vajadzībām .	ieradusies	15	Nom
Pavisam pielāgojusies .	pielāgojusies	1	Nom
Nevienu no tām viņš nebija pircis .	pircis	5	Nom
Noteiktu lomu skolotāju skaita izmaiņās spēlē arī ekonomiskā situācija .	Noteiktu	0	Acc
Viens ticīgais tev dāvā sargājošu lūgšanu , cits tava dzimuma dēļ nesēžas blakus kā spitālīgajam .	sargājošu	4	Acc
Nauda nav atradusies , tāpēc brauciens nav noticis .	atradusies	2	Nom
Skolā bija grūtāk koncentrēties un sekot skolotāja teiktajam .	teiktajam	7	Dat
Taču nākamajā dienā viņa Māra atsilušo labrītu atņēma caur zobiem , acīs neskatīdamās .	neskatīdamās	12	Nom
Jāatzīst , ka daudzās no tām bija pausts patiess prieks par notiekošo .	pausts	7	Nom
Telpā nebija scenogrāfijas uzbūves vai rekvizītu , izņemot zālē iebūvētās kolonas , ap kurām riņķoja V. Varslavānes efektīgajos XVIII gs. modi imitējošajos tērpos ģērbtās , balti pūderētās aktrises .	pūderētās	26	Acc
Jau ziņots , ka patlaban Latvijā roņi ir īpaši aizsargājami , bet izņēmuma gadījumos DAP var izsniegt atļauju aizsargājamu sugu medīšanai .	aizsargājamu	18	Gen
Kopumā 87 % no izglītības nozarē studējošajiem bija izvēlējušies izglītībai atbilstošas darba vietas .	studējošajiem	6	Dat
Jelgavas pilsētas pašvaldības izpilddirektore Irēna Škutāne aģentūrai LETA apgalvoja , ka pašvaldība ir ņēmusi vērā VK revīzijas ieteikumus attiecībā par pašvaldības izveidotajām aģentūrām , kā arī veikusi aģentūru darbības lietderības , efektivitātes un ekonomisko izvērtējumu .	veikusi	26	Nom
Pēc Klāras nāves Gļebs Ivaničs palika vientuļš kā pavasarī apzāģēts koks .	apzāģēts	9	Nom
Ir jau dzirdētas baumas , ka pie robežas stāv onkulis no Skandināvijas ar lielu naudas čemodānu un tūlīt visu sāks uzpirkt .	dzirdētas	2	Nom
Necentieties arī uzreiz enerģiski ķerties klāt problēmai un risināt to , kamēr neesat uzklausījis visu , ko bērns ir vēlējies pateikt , un kamēr neesat uzzinājis , kādu palīdzību šis bērns sagaida un ir gatavs pieņemt tieši no jums .	uzklausījis	13	Nom
Saņēmēja Puse nedrīkst deklasificēt saņemto klasificēto informāciju vai mainīt tās klasifikācijas pakāpi bez iepriekšējas rakstiskas nosūtītājas Puses atļaujas .	klasificēto	5	Gen
Pēkšņi viņai ienāca prātā , ka tētis sākumā esot vēlējies , lai viņu sauktu par Sinēvi .	vēlējies	9	Nom
Savukārt pašvaldības aģentūrā " Kultūra " ir konstatēts , ka 8000 latu ir izlietoti atlīdzībai saskaņā ar uzņēmuma līgumu par sabiedrisko attiecību speciālista pienākumu veikšanu , nenodrošinot darbu izpildes apjoma un kvalitātes kontroli .	izlietoti	13	Nom
Tas informē , kā konstatēti un novērtēti lietas faktiskie apstākļi , kā sameklēta un interpretēta piemērojamā tiesību norma un kā iegūts juridiskā siloģisma gala secinājums .	interpretēta	14	Nom
Jautāju , kas Ritai atliek pašai sev pēc atbildīgā un nogurdinošā darba .	nogurdinošā	10	Gen
Armijas pārstāvis piebilda , ka trieciens bijis vērsts pret ieroču darbnīcu , kas atradusies Rafahas pilsētā netālu no Gazas joslas robežas ar Ēģipti .	atradusies	13	Nom
Viņš bija pārliecināts , ka mājās tās nav .	pārliecināts	2	Nom
Taču jāatzīst , ka , apejot Tieslietu ministrijas darba grupas , Saeimā nonāk arī daudzi pietiekami nesagatavoti likumprojekti .	nesagatavoti	16	Nom
Pedagoģisko darbinieku skaitu ietekmējošo faktoru sadalījums grupās ir visai nosacīts .	ietekmējošo	3	Gen
6. Iestāde ievieš un regulāri pārskata ar iestādi saistīto personu riska darījumu veikšanas politiku un procedūras .	saistīto	8	Gen
Nē , viņai šis tas padodas , bet , ja viņa gatavo , viņa vienlaikus runā pa tālruni , viņa runā ar bērniem , viņa krāso griestus , un taisa atvērto sirds operāciju .	atvērto	30	Acc
Helēnai palika vieglāk , it kā viņa būtu dabūjusi rūgtu tinktūru satrauktai sirdij .	satrauktai	11	Dat
Tāpēc Tu arī nesaņemsi atpakaļ nekādu naudu , ja šis kurss nesasniegs cerēto .	cerēto	12	Acc
Un tad tas pūlis skrien , kam priekšgalā ir ir jaunas meitenes mirdzošām stikla acīm un cigaretēm sarkanos stikla nagos .	mirdzošām	12	Dat
Mans mīļotais nezina , ka es esmu mirusi .	mirusi	7	Nom
Kad mēs vēl nebijām precējušies , viņš vienmēr gribēja turēt manu roku tā , lai visi to redz , apskaut manus plecus un runāt bez apstājas .	precējušies	4	Nom
Nesen veiktajā pētījumā par reģistrētās un nereģistrētās kopdzīves faktoru salīdzinošo analīzi [ LU Publiskās antropoloģijas centrs , 2015 ] respondenti lielākoties uzskatījuši , ka kopdzīve un attiecības jebkurā brīdī var pāraugt laulībā .	salīdzinošo	9	Acc
Sofija ieslēdzās mājā , nolika somu un mātei adresēto pastu .	adresēto	8	Acc
Vasarāju raža šogad solās būt vidēja un pat zema , liecina Latvijas Lauku konsultāciju un izglītības centra ( LLKC ) augkopju veiktā oficiālā vasarāju ražas prognozēšana .	veiktā	21	Nom
Tā tiek organizēta ar Eiropas Sociālā fonda ( ESF ) atbalstu .	organizēta	2	Nom
( 2 ) Saņēmēja Puse izvieto ekvivalentus nacionālos klasifikācijas apzīmējumus uz saņemtās klasificētās informācijas .	saņemtās	11	Gen
1. Ja uzņēmums , kas darbojas vismaz divu dalībvalstu teritorijā , ir maksātnespējīgs 2. panta 1. punkta nozīmē , tad par darbinieku neapmaksāto prasījumu apmierināšanu ir atbildīga tās dalībvalsts iestāde , kuras teritorijā viņi strādā vai parasti strādā .	neapmaksāto	22	Gen
Mēs šeit esam dzimuši , mani vecāki šeit ir dzimuši ...	dzimuši	3	Nom
Es labi sadzirdēju šļūcošos soļus .	šļūcošos	3	Acc
2. Šī direktīva neierobežo valstu tiesību aktos definētos terminus " darbinieks " , " darba devējs " , " darba samaksa " , " iegūtās tiesības " un " iegūstamās tiesības " .	definētos	7	Acc
No 1. janvāra likvidēts Rundāles postenis , kurā bija 16 strādājošie .	likvidēts	3	Nom
Esmu redzējusi arī pieaugušus cilvēkus , spēlējot datorspēles , un man tas šķiet bērnišķīgi , ” uzskata Eva un priecājas , ka viņas vecākā māsa Monta neaizraujas ar datorspēlēm .	redzējusi	1	Nom
Antigone , kritušo brāļu māsa , uzskata par savu pienākumu apglabāt Polineiku , kaut arī zina , ka par to draud nāves sods .	kritušo	2	Gen
Pieredzējām gan to , ka no mūsu pieliekamā zaga produktus , gan dzērāju ļembastus , bet reiz man pat nāca virsū ar nazi .	pieliekamā	7	Gen
Hierarhija , ja tā ir redzama , ietver sevī skaidri identificējamu hierarhijas uzturētāju , veidotāju .	identificējamu	10	Acc
Iznācis no vannas istabas apakškreklā , viņš uzšķīra nākamo cēlienu un tuvojās Pobedskai .	Iznācis	0	Nom
Vladimirs Nikolejevičs pie šī projekta strādājis trīs gadus , izveidojot prototipu , kas sastāv no noņemama « kapsulas konteinera » , kā to dēvē pats inženieris .	noņemama	15	Gen
Bijušā vīra argumenti bija gana pārliecinoši , lai liktu tiesnesim anulēt sava kolēģa pieņemto lēmumu un norunāt vel vienu tiesas sēdi .	pieņemto	13	Acc
Nauda reformai ir iedalīta , tātad atpakaļceļa nav .	iedalīta	3	Nom
51. Personai , kuras sertifikāta darbība ir apturēta vai kuras sertifikāts ir anulēts , vai kura ir saņēmusi atteikumu par atkārtota sertifikāta piešķiršanu , ir tiesības sertificēšanas institūcijā reģistrēties par asistentu un strādāt prakses vadītāja vadībā .	atkārtota	20	Gen
Krītoties skolotāju prestižam , nākas maksāt lielāku atalgojumu izglītības sistēmā strādājošajam , lai viņš nemeklētu darbu citā jomā .	strādājošajam	10	Dat
Lai gan varbūt labāk nevajag – jaunizceptajam Barijam var nebūt ne jausmas par šādu leģendu un viņš var aizlēkšot tālēs zilajās ar visiem divām nedēļām paredzētajiem brendija krājumiem .	paredzētajiem	25	Dat
Beļģijā tiek nošķirta darbaspēka pieprasījuma un darbaspēka nepietiekamības identificēšana , līdztekus paredzot iespējas identificēt arī abus faktorus .	nošķirta	2	Nom
Komisija padara šos paziņojumus publiski pieejamus . "	pieejamus	5	Acc
Savukārt ārējā pamatojumā tiesai jāizskaidro juridiskā siloģisma premisu izvēle – jāatveido risinājuma rašanas gaitā notikušais dialogs , kurā mijiedarbojušies par lietas faktiskajiem apstākļiem un piemērojamo tiesību normu paustie viedokļi un argumenti .	piemērojamo	24	Acc
Daudzi cilvēki uztver pasauli par tikpat neizprotamu kā burvju mākslinieka triku ar trusīti , ko pēkšņi izvelk ārā no cilindra , kas vēl pirms acumirkļa bija pilnīgi tukšs .	neizprotamu	6	Acc
Tagad Egons spēlē Liepājā , bet Evita saimnieko viņu kopīgi izveidotajā ziedu salonā , kas tika radīts laikā , kad Egonam Dailes teātrī lomu kļuva arvien mazāk , bet Liepājā viņš vēl nebija atgriezies .	atgriezies	33	Nom
Prokuratūra apsūdzēto vārdus neatklāj , bet advokāts Egons Rusanovs aģentūrai LETA apstiprināja , ka apsūdzība celta viņa klientam bijušajam " Latvenergo " prezidentam Kārlim Miķelsonam .	apsūdzēto	1	Gen
„ Lai cik arī ļoti man tas patīk , tomēr beidzamo divu gadu laikā nevienu grāmatu neesmu izlasījusi no sākuma līdz beigām .	beidzamo	10	Acc
Konkrētajos gadījumos no verba pamatnozīmes izriet visas pārējās nozīmes – redzēšanas process tiek attiecināts ne vairs tikai uz ar aci saskatāmo materiālo dabu , bet arī uz garīgām lietām .	attiecināts	13	Nom
Un nu mēs redzam iespēju kaut ko no tā izmantot , turklāt redzam pamatotas iespējas , kas varētu ļaut risināt minētos jautājumus , mums darbojoties valdībā .	pamatotas	13	Acc
20. aprīlī un 21. aprīlī tiks izrādīta sirreālā biogrāfija " Benzīnvīrs " , ko iestudējis izrādes dramaturgs Andris Kalnozols kopā ar režisori Martinsoni .	iestudējis	14	Nom
Kā liecina pagājušajā gadā Latvijā veiktais pētījums , tad vismaz pēc augstskolas beigšanas vai jau studiju laikā pedagoģisko specialitāšu studentu izvēlētais darbs atbilda iegūtai izglītībai .	izvēlētais	20	Nom
Aktrise Mila Kunisa paziņojusi , ka ļoti daudz līdzekļu viņa un aktieris Eštons Kačers ietaupījuši uz kāzu rēķina .	ietaupījuši	14	Nom
Bet lieta ir tāda , ka Tev nevajadzētu būt vienai no tiem , kas pieņem pasauli par kaut ko dotu , mīļā Sofij !	dotu	19	Acc
Pērn viņa bija pieteikusies Nodarbinātības valsts aģentūras piedāvātajiem vasaras darbiem , taču iekārtoties kādā konkrētā vietā neizdevās .	piedāvātajiem	7	Dat
Seko stāsts par Sāru , pievienoto vērtību mājas pirkumam : " Saimnieki steidzami brauca projām , pārdeva māju par ciešamu cenu un lūdza mūs parūpēties arī par suni .	pievienoto	5	Acc
Viņa ir sadzirdējusi , ko Tomass saka , un strauji pagriežas .	sadzirdējusi	2	Nom
Lai labāk ilustrētu iegūto skaitļu nozīmi , tie ir jāpaskaidro reālos un ar pētāmo jautājumu saistītos lielumos .	iegūto	3	Gen
Iedzīvotāji atzina , ka liela problēma ir daudzo privatizēto dzīvokļu īrnieki , kuri bieži mainās un kuriem nama stāvoklis un citas problēmas ir vienaldzīgas .	privatizēto	8	Gen
Esmu filozofs un tie ir mazliet aizmākoņu domājoši ļaudis , tāpēc esmu centies meklēt cēloņus , kāpēc Andris rīkojies tā , nevis citādi .	rīkojies	18	Nom
Straujā kušana veicina piesārņojuma izkliedēšanos ūdenī , un Sventājas pilsētiņā smaka tikpat kā nav jūtama .	jūtama	14	Nom
Izplūduši no ledāja , ūdeņi varenu upju veidā tecēja pa ledus atstāto teritoriju .	atstāto	11	Acc
( 2 ) Saņēmēja Puse izvieto ekvivalentus nacionālos klasifikācijas apzīmējumus uz saņemtās klasificētās informācijas .	klasificētās	12	Gen
pirksti sarkani nosaluši , un man pat nav nepieciešams teikt tos vārdus , ko esmu iecerējusi , - man pietiek tāpat .	nosaluši	2	Nom
Un kā jau filmā , kas uzņemta pie raganām , nekad nevar zināt , kur ir robeža starp ikdienu un kādu citu realitāti .	uzņemta	6	Nom
Ja iesaukums militārajā dienestā tiek attiecināts uz personām , kas sasniegušas 15 gadu vecumu , bet ir jaunākas par 18 gadiem , dalībvalstis cenšas dot priekšroku vecākām personām .	attiecināts	5	Nom
Ievērojot ierobežotās informācijas statusu , es jums publiski nevaru nosaukt , kāds bija ministru balsojums vienu punktu iepriekš , kur izšķīrās jautājums par to , ka netiks turpinātas sarunas ar visiem .	ierobežotās	1	Gen
Kad kūka ir gatava un atdzisusi , virsū vari uzbērt pūdercukuru .	atdzisusi	5	Nom
Maskava noliedz , ka tās bumbvedējs " Su-24 " būtu ielidojis Turcijā .	ielidojis	10	Nom
Kā negatīvu iezīmi etniskajos stereotipos jāmin arī tajos ietvertās prognozes attiecībā uz vērtējamās etniskās grupas locekļu rīcību , kā arī to , ka stereotipa aizsargmehānismi ignorē un apslāpē acīmredzamo , kas noliedz tajā pārvērstos faktus .	pārvērstos	33	Acc
Pilsētas varas iestādes atzīst , ka novecojušajai sistēmai ir daudz trūkumu , un nākamgad sola ūdens savākšanas sistēmu uzlabot .	novecojušajai	6	Dat
Tagad gribu redzēt , kā var saglabāt neskartu mežu un reizē veidot tūristiem domātu meža taku , – teica A. Gorbunovs .	domātu	13	Acc
Atgāztu galvu raudzīties augšup .	Atgāztu	0	Acc
AR GARDU ĶĪSELI UN REŽISORES UNAS CELMAS VĀRĪTU PUTUKRĒJUMA RĪSU PUTRU tauta laista jauna filma « Raganu mēnesis » - interesanta un atraktīva , taču tajā pašā laikā arī pamācoša kinolente .	pamācoša	29	Nom
Pagājušās nedēļas piektdienā no amata tika atlaists līdzšinējais komandas galvenais treneris Hoakins Kaparross , kurš ar to strādāja kopš sezonas sākuma , bet viņa vadībā " Granada " noslīdēja uz kopvērtējuma pēdējo vietu .	Pagājušās	0	Gen
Manas intereses bija daudzveidīgas , un zināmā gadījuma dēļ izšķīros iet uz bibliotekāriem .	zināmā	6	Gen
Par laimi , man ir izdevies draugiem iestāstīt , ka tas ir mans imidžs būt sirmai un savītušai vecmāmiņai , divu bērnu mātei , kas nudien nedzenas pēc otrās laulības un otrās bērnu paaudzes .	savītušai	17	Dat
Zviedrijas hokejistu izlases ārsts Bjērns Valdbeks vakar sacījis , ka pēc Mārtiņa Karsuma veiktā spēka paņēmiena savainojumu guvušais Tobiass Enstrēms , iespējams , vēl izies uz ledus šajā pašā pasaules čempionātā .	sacījis	7	Nom
Un mīlēšot vienmēr , līdz kapa malai , arī tad , kad es būšot viņu jau pametusi .	pametusi	16	Nom
Šis punkts ir nelabvēlīgs apdzīvoto vietu attīstībai .	apdzīvoto	4	Acc
Automašīnu un tuvāk stāvošos viesus aktrise « iesvētīja » , aplejot ar šampanieti .	stāvošos	3	Acc
No etniskā viedokļa baltu vienība būtu aplūkojama kā baltu tautu vēstures daļa .	aplūkojama	6	Nom
Pārsvarā būvmateriāli objektā nav bijuši nodrošināti ar ekspluatācijas īpašību deklarācijām , būvizstrādājumiem nav noteiktas un novērtētas ekspluatācijas īpašības , ir konstatēti gadījumi , kad būvizstrādājumi ir iebūvēti neatbilstoši paredzētajam mērķim .	novērtētas	15	Gen
Tas attiecīgi paredz daudz aptverošāku politiku izstrādi un saskaņotāku rīcību .	aptverošāku	4	Acc
Kā aģentūru LETA informēja LU Literatūras , folkloras un mākslas institūtā , šogad dažādu projektu laikā tika sagatavots liels skaits pētījumu un monogrāfiju , latviešu literatūras un folkloras tekstu apkopojumu , kā arī dažādu tulkojumu .	sagatavots	17	Nom
Vīrietis , kurš ir precējies , mēdz būt ieinteresēts citās sievietēs un tā var būt ne tikai kaisles pārņemta interese , bet arī dziļām emocijām piepildīta interese .	pārņemta	18	Nom
Padomju periodā iestāde bija kā režīma neskarta sala , kur neskaitāmas kultūras personības tikās ar skatītājiem .	neskaitāmas	10	Nom
Ievērojot spriedumā lietā Nr. 2010-56-03 atzīto , Birojs rekomendējis īpašu uzmanību pievērst dabas liegumam " Ziemupe " piegulošajām Akmeņraga meža daļām , kuras teritorijas plānojumā apzīmētas ar indeksu M-3 .	piegulošajām	17	Dat
Gastons pastiepa roku , gribēdams pavērt lodziņu , tomēr roka slīdēja pār sienas tapeti un nevarēja satvert kloķi vai rūts rāmja spraugu .	gribēdams	4	Nom
Viņa ņēmās pētīt nesaprotamo skatu karti vēlreiz .	nesaprotamo	3	Acc
Lai neizjauktu ieplānotos darbus , pārbūvējamā dzīvokļa saimnieks var mēģināt vienoties par abpusēji izdevīgiem nosacījumiem ar kaimiņiem .	ieplānotos	2	Acc
Viņa dod laulātajiem draugiem daudz pēcnācēju un , bērnam dzimstot , dod mātei svētību .	laulātajiem	2	Dat
Ievērojot spriedumā lietā Nr. 2010-56-03 atzīto , Birojs rekomendējis īpašu uzmanību pievērst dabas liegumam " Ziemupe " piegulošajām Akmeņraga meža daļām , kuras teritorijas plānojumā apzīmētas ar indeksu M-3 .	rekomendējis	8	Nom
No viņu stāstītā atliek vien secināt , ka nosaukumi nav ne īsti līvu valodā , ne īsti pareizi latviskoti — kaut kas pa vidu .	stāstītā	2	Gen
Biedrība cer , ka šis fakts veicinās sabiedrības informētību par audžuģimenēm un aizbildņiem , kas savukārt varētu veicināt bāreņu vai bez vecāku gādības palikušo bērnu audzināšanu ģimenēs .	palikušo	23	Gen
Elektriskām iekārtām ir jābūt piestiprinātām tā , lai bērns savā darbošanās tieksmē tās nevarētu aizsniegt .	piestiprinātām	4	Dat
Es bildu , ka pats patieso skādes apjomu apzinājos tikai tad , kad labākie bloki bija iztērēti un bija palikusi kaudze ar apdauzītajiem .	apdauzītajiem	22	Dat
Pēc sezonāli izlīdzinātiem datiem , 2012. gada ceturtajā ceturksnī IKP apjoms salīdzinājumā ar 2012. gada trešo ceturksni pieaudzis par 1,4 % .	izlīdzinātiem	2	Dat
Brīžam garām gausajos ūdeņos slīdēja kādas baržas ar dažādiem Čārlziem Dikensiem , Džonijiem Depiem , krievu kupčiem , ātri sastiķētām elitēm , Kolumbijas mafijas , TV seriālu varoņiem un Tomiem Soijeriem uz klāja .	sastiķētām	19	Dat
Klātesošajiem pilnvarotajiem novērotājiem arī ir tiesības aizzīmogot šos saiņus ar saviem zīmogiem vai parakstīties uz tiem .	pilnvarotajiem	1	Dat
Ja pret valsts valodu mēs paši būtu izturējušies ar pienācīgu cieņu , krievi sen to būtu apguvuši un Godmanim nevajadzētu teikt šādus latviešu pašcieņu pazemojošus vārdus .	pazemojošus	24	Acc
Viņš atgādināja , ka jau agrāk mājā bijis siltumskaitītājs , bet noņemts dēļ sūdzībām par augsto apkures maksu .	noņemts	11	Nom
Vērtējot 2012. gadu , Pillar izpilddirektore Ieva Valtere uzsvēra : " 2012. gada rezultāti liecina , ka nekustamā īpašuma tirgū ir novērojama atkopšanās .	novērojama	21	Nom
Brīvdienās Latvijā ieplūdīs aukstākas gaisa masas , tomēr gaisa temperatūra būtiski nepazemināsies , jo laiks būs apmācies .	apmācies	16	Nom
Svētdienās pagasta vai apriņķa ietvaros nodarbinātajiem jauniešiem tika rīkotas kopējas izglītojošas sanāksmes .	nodarbinātajiem	5	Dat
Protams , arī tradicionālais manikīrs ļauj nagiem izskatīties koptiem !	koptiem	8	Dat
Pirmo reizi mūžā viņai likās , ka nav pareizi dzīvot pasaulē un pat nejautāt , no kurienes tā cēlusies .	cēlusies	18	Nom
Vilks neesot nolaidis rokas , jo viņu kaitinājusi sabiedrības nievājošā attieksme pret notikumiem juridiskajā un sociāli politiskajā sfērā .	nolaidis	2	Nom
Florence mācījās augstskolā , tomēr dzīve spieda viņu kaktā un lika strādāt līdz pusnaktij , jo lielākā daļa grūti sapelnīto līdzekļu izgāja par to , lai slepus , bet neatlaidīgi veidotu savu , neviena neapdraudētu terra incognita .	neapdraudētu	34	Acc
Viņa drebošām rokām velk no matiem pa vienai sprādzei un liek uz spoguļgalda .	drebošām	1	Dat
Šovasar uzlietā trīsarpus centimetrus biezā melnā seguma virskārta kalpos piecus līdz septiņus gadus .	uzlietā	1	Gen
Ieslēdzu televizoru , rāda mazu , slapju , tikko dzimušu tīģeri ar trīcošu galvu .	trīcošu	12	Acc
Deputāts pauda bažas , ka citādi situācija ieslodzījuma vietās varētu līdzināties pagājušā gadsimta deviņdesmito gadu vidū pieredzētajam , kad cietumu ārējā apsardze tika nodrošināta , bet situācija to iekšienē netika kontrolēta .	kontrolēta	30	Nom
Taču nedēļas vidū pēkšņi dēls man piezvanīja un paziņoja , ka braukšot uz Rīgu , jo esot nokritis un pamatīgi sadauzījis labo roku .	sadauzījis	20	Nom
Pēc saglabātās DNS kopijas tika radīts embrijs , un augot viņš uzņēma Luīzes atmiņu impulsus ( kas , par laimi , tika saglabāti pāris mēnešus pirms negadījuma ) .	saglabātās	1	Gen
Nemiernieki pametuši Aklamijas , Deir Džamalas un Mareanaras ciematus , paklausot iedzīvotāju lūgumam , kas bažījušies , ka uzlidojumos var ciest viņu mājas .	pametuši	1	Nom
( 2 ) Mobilizācijas izsludināšanas gadījumā , pildot mobilizācijas pieprasījumus , valsts un pašvaldību institūcijām un privāto tiesību juridiskajām personām ir pienākums nodot Nacionālo bruņoto spēku vienību un civilās aizsardzības formējumu turējumā mobilizācijas pieprasījumā noteikto īpašumu .	noteikto	34	Acc
Aplūkojot pasaules izglītībā notiekošos procesus ilgtermiņā , redzams , ka attiecībai starp skolēnu skaitu un skolotāju skaitu ir tendence samazināties .	notiekošos	3	Acc
Jau šomēnes kinoteātrī « Splendid Palace » skatāma filma « Raganu mēnesis » , kurā iemūžināts aktieru Harija Spanovska un Andra Bērziņa dēkpilns ceļojums pie Latvijas dziedniekiem un citiem alternatīvās medicīnas praktizētājiem , meklējot izeju no dzīves krīzēm .	skatāma	7	Nom
Elmārs pastāstīja , ka patiešām zēnam neesot paveicies , roka esot diezgan nopietni traumēta ( lauzta gan neesot , tik daudz viņi saprotot ) , sadauzīts arī plecs un mugura .	paveicies	7	Nom
Tas vairāk saistīts ar jaunības lietām , kad viss tika uztverts emocionālāk .	uztverts	10	Nom
Aleksandrs devies pārgājienā pa pludmali un uzgājis baisu atradumu .	uzgājis	6	Nom
Teikšu godīgi : man ir apnicis skatīties , kā slimi bērni tiek vesti uz bērnudārzu , man ir apnicis skatīties , kā slimi cilvēki iet uz darbu ar 39 un 40 grādu temperatūru .	vesti	12	Nom
Un noņemot no pēdām atmirušo ādu , jūs attīriet organismu un ļaujat tam brīvi elpot .	atmirušo	4	Acc
Sofija bija mēģinājusi sākt mācīties , bet tā vietā viņa gluži vienkārši sēdēja un prātoja par lasīto .	lasīto	16	Acc
Ilgstoša atrašanās ūdenī nav patīkama ādai , tā kļūst ievainojamāka un daudz jutīgāka .	patīkama	4	Nom
Aizvadītais 2012. gads nekustamā īpašuma attīstīšanas un tirdzniecības grupai Pillar bija straujas attīstības gads .	Aizvadītais	0	Nom
Vai esi dzirdējusi , ka N. kundzei atkal būs bērns ?	dzirdējusi	2	Nom
Pastiprināta svīšana un ādas raga kārtas sabiezējums uz delnām un pēdām liecina par sviedru dziedzeru pārmaiņām , var būt sūdzības par niezi un dedzinošu sajūtu .	Pastiprināta	0	Nom
Savukārt jaunās enerģiju taupošās un precīzās tehnoloģijas ļauj mūsu uzņēmumam nodrošināt arvien pieaugošo pieprasījumu pēc kvalitatīvas un veselīgas maizes . "	pieaugošo	12	Acc
Bet , kad visas šādas vajadzības ir apmierinātas — vai tomēr ir kaut kas , kas nepieciešams visiem ?	apmierinātas	7	Nom
Autors uzskata , ka veicamie uzdevumi ir jāsadala divos līmeņos :	veicamie	4	Nom
Pēdējā desmitgadē , kopējam valsts budžeta finansēto studentu skaitam praktiski nemainoties , budžeta finansēto studentu skaits izglītības jomā ir samazinājies no 5990 studentiem 2000. / 01. studiju gadā uz 3064 studentiem 2007. / 08. studiju gadā .	finansēto	13	Gen
Mazāk domāju par atlikušo laiku , vairāk sekoju līdzi spēlei un domāju , ko vēl varam izdarīt .	atlikušo	3	Gen
Padzirdējusi šo vēsti , nekavējoties šķiršanās prasību iesniedza Mika likumīgā sieva Džerija Hola ( pēc profesijas arī modele , starp citu ) un paģērēja kompensācijā viņai izmaksāt 50 miljonus dolāru .	Padzirdējusi	0	Nom
Dalībvalstis , kuru pārskata laikposms nav mazāks par 18 mēnešiem , var ierobežot to laikposmu , par kuru garantiju iestādes sedz neapmaksātos prasījumus , līdz astoņām nedēļām .	neapmaksātos	21	Acc
Tāpēc M. Segliņš rosina noteikt eksāmenu saturu kā klasificējamu informāciju , par kuras izpaušanu draudētu kriminālsods .	klasificējamu	8	Acc
Tātad paldies valdībai par ziņojumā demonstrēto gara nabadzību , ačgārnajām prioritātēm , cinismu un vienaldzību pret Latvijas nodokļu maksātājiem .	demonstrēto	5	Acc
Patlaban Vilks darbojas kā īpašnieks un pārvaldnieks mantotiem nekustamajiem īpašumiem .	mantotiem	7	Dat
Re , līdzīgs kā tu , saku blakus guļošajam kaķim , un tad man sāk likties , ka viss iet uz labo pusi .	guļošajam	8	Dat
7 ) Pēdējos gados Rīgā ir īstenoti tikai daži empīriski pētījumi , kas apskata Rīgas teritorijas funkcionālās struktūras attīstību , turklāt teritorijas transformācijas procesi pārejas periodā esošajos pētījumos nav apskatīti .	īstenoti	6	Nom
Pēc tā slēgšanas uzņēmējs nopirka mašīnas un lika tās pārvest uz paša izveidoto muzeju Maiami .	izveidoto	12	Acc
Tomēr perspektīvas makro skatījums ir izvirzījis virkni nepilnību , kuras liedz iedziļināties izglītības atsevišķos gadījumos un attiecīgi , nespēj novērot izglītības blakusefektus , kuri detalizēti tiek aplūkoti vēlāk attīstītajās teorijās .	izvirzījis	5	Nom
Esmu redzējusi arī pieaugušus cilvēkus , spēlējot datorspēles , un man tas šķiet bērnišķīgi , ” uzskata Eva un priecājas , ka viņas vecākā māsa Monta neaizraujas ar datorspēlēm .	pieaugušus	3	Acc
" Līdzīgi kā Latvijā , tā citviet ir noregulēta attiecīgo valstu civillikumos .	noregulēta	8	Nom
Katrs reģions , ņemot vērā problemātiskās profesijas ( piemēram , sekretāra , tirdzniecības pārstāvju u.c. profesijas ) , sagatavo ikgadēji aktualizējamu sarakstu darbaspēka migrācijas mērķiem neatkarīgi no šo profesiju sektora ( piemēram , veselības aprūpe ) .	aktualizējamu	20	Acc
Tomēr tas nevar būt īsāks par tādu laikposmu , kas aptver atlīdzību par pēdējiem trim darba attiecību mēnešiem pirms un / vai pēc 3. pantā minētās dienas .	minētās	25	Gen
Ja četros mēnešos pēc šāda paziņojuma vismaz viena trešdaļa dalībvalstu atbalsta konferences sasaukšanu , ģenerālsekretārs sasauc konferenci Apvienoto Nāciju Organizācijas paspārnē .	Apvienoto	17	Acc
Pagastā esmu izvirzīta apbalvošanai .	izvirzīta	2	Nom
Taču atsakoties no jebkādas ticības rakstītiem līgumiem , diplomātija zaudētu savu jēgu .	rakstītiem	5	Dat
Mums atkal jāpieņem jauni cilvēki darbā , ir vajadzīgi jauni informācijas resursi , un tas tiešām ir izdarīts .	izdarīts	17	Nom
Šis kāpums saskanējis ar analītiķu iepriekš izteiktajām prognozēm .	izteiktajām	6	Dat
Var lietot arī speciālos attīrošos skrubjus kājām , lai noņemtu atmirušās ādas daļiņas .	attīrošos	4	Acc
Ar iekasēto naudu savukārt bija iespējams algot pa impēriju izkaisītos romiešu armijas leģionārus .	iekasēto	1	Acc
Lai izvēlētos terapijas kursu , nesteidzīgā sarunā ārsts noskaidros gan slimības simptomus , gan arī jūsu ieradumus , dzīvesveidu , iecienīto uzturu , ķermeņa īpatnības un rakstura pazīmes .	iecienīto	20	Acc
Svētdienās pagasta vai apriņķa ietvaros nodarbinātajiem jauniešiem tika rīkotas kopējas izglītojošas sanāksmes .	rīkotas	8	Nom
( 4 ) Akreditētais muzejs zaudē akreditēta muzeja tiesības , ja tas neatbilst šā panta otrajā daļā minētajiem nosacījumiem .	akreditēta	6	Gen
Likuma mērķis ir nodrošināt valsts drošības iestāžu amatpersonām Valsts drošības iestāžu likumā noteiktās tiesības uz izdienas pensiju un reglamentēt kārtību , kādā tā tiek piešķirta , aprēķināta un izmaksāta .	aprēķināta	26	Nom
Nemiernieki pametuši Aklamijas , Deir Džamalas un Mareanaras ciematus , paklausot iedzīvotāju lūgumam , kas bažījušies , ka uzlidojumos var ciest viņu mājas .	bažījušies	15	Nom
Veikt šādu pētījuma prasa arī notikušās izmaiņas valsts budžeta finansēto studiju vietu skaitā .	notikušās	5	Nom
Masveida emigrācijas rezultātā Latvija ir zaudējusi 150_000 – 200_000 iedzīvotāju aktīvā darbaspēka un reproduktīvajā vecumā .	zaudējusi	5	Nom
Māmiņa ir apguvusi to , ka cilvēki nelido .	apguvusi	2	Nom
Es vēlos , lai Tu dzīvotu ar atvērtu skatu .	atvērtu	7	Acc
Cietušo , par laimi , nav .	Cietušo	0	Gen
Kāda cita sieviete pabaroja izsalkušos , lai gan ēdamais izrādījās negaršīgs , ar kādu asu , nepatīkamu piegaršu , jo produkti bija veci .	izsalkušos	4	Acc
Bet , pateicoties Laviņa kungam , tika izveidots izņēmums no šīs prasības , jo kādi tomēr ir vienlīdzīgāki .	izveidots	7	Nom
Nevajag pirkt pirotehniku no privātpersonām , kas tirgo nezināmas izcelsmes nesertificētus izstrādājumus .	nesertificētus	10	Acc
Iepriekšējā parlamentā par šo reorganizāciju pamatā nedrīkstēja lemt tikai viena un galvenā iemesla dēļ – 50 tautas kalpiem vēlētāji atkārtoti nebija izteikuši uzticību .	izteikuši	21	Nom
Latvijas Zinātņu akadēmijā ( LZA ) šodien plkst. 16 notiks Latvijas Universitātes ( LU ) Literatūras , folkloras un mākslas institūta grāmatu atvēršanas svētki " 8 ½ grāmatas ” , kurā tiks prezentēti šajā gadā īstenotie sasniegumi .	prezentēti	32	Nom
— Ja gribi strādāt ar citām metodēm , lai skolēniem ir interesanti , nevis sniegt tikai mācību grāmatā atrodamās zināšanas , tad ir daudz jāgatavojas .	atrodamās	18	Acc
Ja Tu esi sevi izjutusi šāda veidā , Tu esi atklājusi kaut ko tādu , kas ir tikpat noslēpumains kā marsieši , kurus pieminējām sākumā .	atklājusi	10	Nom
2. Šī direktīva neierobežo valstu tiesību aktos definētos terminus " darbinieks " , " darba devējs " , " darba samaksa " , " iegūtās tiesības " un " iegūstamās tiesības " .	iegūstamās	29	Nom
Deputāte savā " Twitter " kontā norāda , ka aizliegums attiektos arī uz " Papardes zieda " izplatītajiem materiāliem .	izplatītajiem	17	Dat
Tiem , kuri ir iemīlējušies , ir ārkārtīgi grūti būt šķirtiem , tie ir smagi pārdzīvojumi , dažkārt pat jāiestāsta sev , ka tu ienīsti cilvēku , kuru patiesībā mīli .	šķirtiem	10	Dat
Valsts policijas pārstāvji iesaka pirotehnikas preces iegādāties tikai firmās , kurām ir izsniegta atbilstoša licence .	izsniegta	12	Nom
Nekas vairs nebija savā vietā , tā , kā mēs to bijām novietojuši .	novietojuši	12	Nom
Vadošā valsts bija Dānija sadarbībā ar citām Skandināvijas valstīm – Norvēģiju un Zviedriju .	Vadošā	0	Nom
Par revīzijā konstatēto VK ir informējusi tiesībaizsardzības iestādes .	konstatēto	2	Acc
VD minēto atsevišķu sieviešu dzemdēto bērnu skaitu nedrīkst pārvērtēt .	dzemdēto	4	Gen
Nepārdomāti priekšlikumi par grozījumiem Krimināllikumā Saeimā tiek iesniegti arī pēdējā laikā , piemēram , par jau minētā Krimināllikuma 262. pantā paredzētā nodarījuma izdarīšanu noteikt sankciju - brīvības atņemšanu uz vienu gadu .	paredzētā	20	Gen
Viņš dzīves aizvainota cilvēka niknumā runā par kapitālistiskās iekārtas sociālo netaisnību .	aizvainota	2	Gen
Viņš vakar ieradies no ceļojuma pa Eiropu , ļoti sailgojies pēc mājām un manis .	sailgojies	9	Nom
Ir mainījusies ne vien valsts forma , bet devalvējusies arī ideja par ļaužu kopību vienotu principu vārdā un vienotas pasaules iespējamību .	devalvējusies	8	Nom
Šogad tas ir otrais gadījums , kad Lietuvas robežsargi neļauj iebraukt valstī automašīnai ar aizliegtu simboliku .	aizliegtu	14	Acc
Šādi aktrise ne tikai deva kucēnam mājas , bet lika sabiedrībai aizdomāties par klaiņojošo dzīvnieku problēmu .	klaiņojošo	13	Gen
Pēc mēnesi ilgas atpūtas , kas izpaudās kā vispostošākā dzeršana no saullēkta līdz rietam , viss sāksies no gala .	vispostošākā	8	Nom
Eglītis bija pārsteigts , ka premjers nereti tiek dezinformēts ar aplamiem skaitļiem .	dezinformēts	8	Nom
Lai arī šis materiāls galvenokārt satur neizvērstas informatīvas ziņas , tas sniedz ieskatu darbnīcu pasutījumdarbu klāstā , uzrādot konkrētu izpildītāju uzvārdus , ari vēstī par stiklinieku sociālajām problēmām , un atsevišķos gadījumos min logu skaitu un raksturu noteiktās ēkās .	neizvērstas	6	Acc
Piemēram , viens no Odesas portāliem informē , ka skolniece izdarījusi pašnāvību tāpēc , ka nav spējusi sadzīvot ar to , ka aktīvi piedalījusies akcijā , kuras rezultātā bojā gājuši cilvēki	piedalījusies	23	Nom
Šodien viņa bija tikai apjukusi .	apjukusi	4	Nom
Viņš mani vairs nemīl tik maigi kā agrāk , un pēdējā reizē - es tobrīd nezinu , ka tā ir pēdējā , - grūžas manī ar tādu kā aizturētu niknumu .	aizturētu	28	Acc
Kārba ar nezināmā filosofa vēstulēm atradās drošībā Slēpnī .	nezināmā	2	Gen
Nauda tika kalta dievietes Junonas jeb Monētas ( tulkojumā – padomdevējas ) tempļa kaltuvē – tāpēc arī daudzas pasaules valodas naudas apzīmēšanai ieviesušas vārdu monēta : vācu Moneten , angļu money , franču monnaie un arī latviešu monēta .	kalta	2	Nom
Gan sievietes , gan vīrieši baidās par to runāt , klusē , neko nedara , kamēr nereti problēma tiešām samilzt līdz grūti risināmiem apmēriem .	risināmiem	22	Dat
Daži neiztur smagumu un nokrīt , bet citi stingri pieķeras pie truša spalvām un sauc visiem lejā palikušajiem cilvēkiem , kas sēž tur mīkstajā akotā un pielādē vēderus ar labiem ēdieniem un dzērieniem :	palikušajiem	17	Dat
Balta taisne debesīs bīdīja uz priekšu neredzamu lidmašīnu .	neredzamu	6	Acc
Aploksnē atradās trīs lielas mašīnrakstā aprakstītas loksnes , sastiprinātas kopā ar saspraudi .	sastiprinātas	8	Nom
No saulē sasilušu grīdas dēļu siltuma .	sasilušu	2	Gen
Kā ziņots , VK ir pabeigusi revīziju par Jelgavas pašvaldības aģentūru darbību un konstatējusi nepamatotus tēriņus vairāk nekā 50_000 latu apmērā , aģentūru LETA iepriekš informēja Valsts kontroles pārstāve Egita Diure .	nepamatotus	14	Acc
Bet saprotiet : ja ir plūdi vai ugunsgrēks , tad pa to laiku viss jau sen ir beidzies , kamēr šis process ir nonācis līdz augsti godājamai Saeimai , kurā mēs nu tātad atbalstām šo vēlmi ...	godājamai	26	Dat
Kā uzsvēris Montrims , konkursa uzvarētājs izraudzīts , ņemot vērā piedāvāto cenu un īsāko termiņu , un " Fima " , zinot par projekta sarežģītību , pati piedāvājusi pabeigt darbus 22. martā .	piedāvāto	10	Acc
Es nevarēju domāt citādi , kad apkārt ir tik daudz mirušu , sakropļotu , pārogļotu ķermeņu , kad krīt bumbas , īpaši neizvēloties mērķi , un gaiss ir biezs no putekļiem , sodrējiem , asins dvakas un kliedzieniem .	sakropļotu	12	Gen
51. Personai , kuras sertifikāta darbība ir apturēta vai kuras sertifikāts ir anulēts , vai kura ir saņēmusi atteikumu par atkārtota sertifikāta piešķiršanu , ir tiesības sertificēšanas institūcijā reģistrēties par asistentu un strādāt prakses vadītāja vadībā .	apturēta	7	Nom
No skaistas , tramvaja pieturā ieraudzītas sievietes sejas .	ieraudzītas	5	Gen
Kā liecina pagājušajā gadā Latvijā veiktais pētījums , tad vismaz pēc augstskolas beigšanas vai jau studiju laikā pedagoģisko specialitāšu studentu izvēlētais darbs atbilda iegūtai izglītībai .	iegūtai	23	Dat
Tā rezultātā ierobežota finansējuma apstākļos ir iespējams atalgot mazāku skaitu pedagoģiskos darbiniekus , un skolēnu skolotāju skaita attiecības samazināšanās tiek nobremzēta .	ierobežota	2	Gen
Taču ari pats " neinterpretētais " jeb " tīrais " materiāls ir tikai teorētisks konstrukts , jo pat ikdienas sarunās par arhitektūru kā kāda " naivā " arhitektūras modeļa sastāvdaļa tas ir jau interpretēts .	interpretēts	33	Nom
Neizmantotos dārzeņus vai gaļas produktus var izmantot atkārtoti , gatavojot zupu , salātus vai sautējumu .	Neizmantotos	0	Acc
Kā atzīmēts CSP ziņojumā par aprīļa inflāciju , " lielākā ietekme uz patēriņa cenu pārmaiņām aprīlī bija cenu kāpumam elektroenerģijai par 39,2 % " .	atzīmēts	1	Nom
" Ceļi ir slapji , bet , kad uznāks sals , tie sasals un radīs tiešām labus ledus apstākļus , " organizatori izteikušies portālam " Autosport " .	izteikušies	22	Nom
Kādā atpūtas brīdī , kad imperators sēdējis zem tējas koka un dzēris vārītu ūdeni , sacēlies vējš un imperatora krūzē iepūtis pāris tējas koka lapas .	vārītu	12	Acc
Vienmēr nāksies veidot izglītības sistēmu tā , lai izglītības sistēmā nepieciešamo kvalificēto skolotāju skaits nepārsniegtu to skolotāju skaitu , ko valsts ir spējīga algot tā , lai viņi skolu nepamestu .	kvalificēto	11	Gen
Un otrā ir akadēmiskās spējas , kas patiešām ir sākušas dominēt mūsu izpratnē par intelektu , jo universitātes izglītības sistēmu radīja pēc savas līdzības .	sākušas	9	Nom
Tobrīd mēs vēl balstījāmies uz ne pilnībā slēgtajiem uzņēmumiem .	slēgtajiem	7	Dat
Grupas adresācija sakārto darbojošos praktiskos procesus un sadalās 15 pamatgrupās , kuras savukārt iekļauj 2048 apakšgrupas .	darbojošos	3	Acc
Šai kontekstā ievērojama loma piešķirta Tieslietu ministrijā izveidotajām darba grupām , kuru līdzdalība likumprojektu izstrādes procesā neapšaubāmi uzlabo to kvalitāti .	izveidotajām	7	Dat
2. Draudze līdz 2008. gada 1. jūnijam paziņo Tieslietu ministrijai šā likuma 14. panta pirmajā daļā minētos datus .	minētos	16	Acc
Kopumā 87 % no izglītības nozarē studējošajiem bija izvēlējušies izglītībai atbilstošas darba vietas .	atbilstošas	10	Acc
Tomēr šā pētījuma rezultātus nevar attiecināt uz sabiedrības attieksmi kopumā , ņemot vērā samērā niecīgo izlasi – 41 dalībnieku , kas bija pārtraucis vismaz vienu laulību vai nereģistrētu kopdzīvi , kurā ir dzimis vismaz viens bērns .	pārtraucis	22	Nom
( 7 ) Darba devējam aizliegts bez attiecīgās arodbiedrības piekrišanas uzteikt darba līgumu arodbiedrības pilnvarotajai amatpersonai , kura pilda pārstāvja pienākumus , izņemot likumā noteiktos gadījumus .	pilnvarotajai	14	Dat
Es nevarēju domāt citādi , kad apkārt ir tik daudz mirušu , sakropļotu , pārogļotu ķermeņu , kad krīt bumbas , īpaši neizvēloties mērķi , un gaiss ir biezs no putekļiem , sodrējiem , asins dvakas un kliedzieniem .	pārogļotu	14	Gen
Lielākie , spožākie lībiešu valodas runātāji , ko vēl pēdējos gados izmantoja zinātnieki , ir miruši .	miruši	15	Nom
Vai visam notiekošajam pamatā ir kāda griba vai nolūks ?	notiekošajam	2	Dat
30. Ēdienkartē izmantojamie produkti nedrīkst saturēt ģenētiski modificētos organismus , nedrīkst sastāvēt no tiem un nedrīkst būt ražoti no tiem .	modificētos	7	Acc
Tur ārpusē , smalko spalviņu galā , viņa bija ieraudzījusi pasauli tā , it kā skatītu to pirmoreiz .	ieraudzījusi	9	Nom
[ 56 ] PSRS pārstāvis Rīgā S. Brodovskis nonāca līdz vāji slēptiem draudiem , norādot , ka Baltijas valstīm nāksies nožēlot savu atteikšanos , jo konflikta gadījumā mazu valstu piekrišana karaspēka cauri laišanai netiks lūgta .	slēptiem	11	Dat
Lasīju par citu sasniegto , nomestajiem kilogramiem , bet pati turpināju ēst visu , kas pagadās .	sasniegto	3	Acc
Minētā informācija padara tiesas nolēmumu saprotamu , kā arī ļauj pārbaudīt tā pareizību .	saprotamu	5	Acc
Šiem mērķiem un arī nagu ieaudzēšanas problēmu risināšanai tiek pielietots akrils arī kāju nagiem .	pielietots	9	Nom
Viena meitene ievesta , cietusi autokatastrofā .	cietusi	4	Nom
Mani personīgi pārsteidza , ka Vācijā viens no maniem , var teikt , bērnības draugiem 2015. gadā par patērēto siltumu savā mājsaimniecībā , kuru viņš apkurina ar gāzi , samaksāja mazāk nekā bija jāmaksā atbilstošai mājsaimniecībai Latvijā .	patērēto	18	Acc
Uz patiesiem notikumiem balstītais iestudējums vēsta par kādu vīrieti , kurš klaiņo pa dažādiem Latvijas benzīntankiem , elpo benzīnu un ļoti daudz smejas .	balstītais	3	Nom
Nieres un aknas apdraud materiāli , kas izmantoti iestiepto griestu konstrukcijās .	iestiepto	8	Gen
Kad pienāks laiks iegādāties jaunu preci , pircējs noteikti būs saņēmis daudzus kārdinošus piedāvājumus no citiem veikaliem .	kārdinošus	12	Acc
Nesanāca , jo " augusta beigās piezvanīja māsīca un teica , ka noplīsusi kompanjone ceļojumam uz Aļasku , vai es negribot piebiedroties ?	noplīsusi	12	Nom
Tomēr neviena no pieminētajām grāmatām nebija īpaši populāra un Darvins attīstīja savas idejas neatkarīgi no tām .	pieminētajām	3	Dat
Viņš labprāt pastāstīs par jūs ieinteresējošo preci , organizēs degustāciju , sniegs rekomendācijas , ieteiks labu recepti .	ieinteresējošo	5	Acc
Būtiski , lai šie resursi tiktu pareizi izmantoti : pareizi ir uzticēties uzticamajam un neuzticēties neuzticamajam ; savukārt nepareizi ir uzticēties neuzticamajam un neuzticēties uzticamajam .	uzticamajam	24	Dat
No mājas iznāk Jasmīne un kar uz auklām baltu , pilošu , tikko izmazgātu palagu .	pilošu	10	Acc
Tie , kas interesējas par šādiem jautājumiem , nodarbojas ar ko tādu , par ko cilvēki ir strīdējušies tik ilgi , cik ilgi mēs vispār dzīvojam uz šīs planētas .	strīdējušies	17	Nom
Ja tā ir neredzama , tad pedagogs darbojas tieši ar sniedzamo zināšanu kontekstu un tikai netieši iedarbojas uz skolēnu , kas padara pašu pedagogu pedagoģiskajās praksēs neredzamu .	neredzamu	26	Acc
Pēc sezonāli izlīdzinātiem datiem , 2012. gada ceturtajā ceturksnī IKP apjoms salīdzinājumā ar 2012. gada trešo ceturksni pieaudzis par 1,4 % .	pieaudzis	17	Nom
Tātad arī pasaules telpai vajadzēja būt reiz tapušai no kaut kā cita .	tapušai	7	Dat
Piemēram , notikums " jauns fails " atgriež izveidotā faila nosaukumu , kas tiek saglabāts procesa verificēšanas apraksta mainīgajā .	izveidotā	8	Gen
SPRK tarifu projektu izvērtē aptuveni trīs mēnešus , un dažkārt tas tiek koriģēts , arī izvērtējot tikai informāciju par aprēķiniem , taču no iedzīvotājiem būtiski iebildumi sanāksmē nav izskanējuši , pēc kolēģu informācijas skaidroja Krūmiņa .	izskanējuši	28	Nom
Limbažu un Alojas novadā lielais vējš bija nolauzis kokus , kas sakrita pār ceļa braucamo daļu .	braucamo	14	Acc
Zēns klakšķināja ar mēli un orientējās pēc priekšmetu raidītās atbalss .	raidītās	8	Gen
Naudu , gan ne tik lielu , pieprasīja arī Lučiana , kura tikmēr ar DNS testu palīdzību bija pierādījusi , ka Miks patiesi ir papucis .	pierādījusi	18	Nom
Zagļi mājokļa teritorijā bija iekļuvuši , izgriežot caurumu stiepļu žogā un aiznesot kopā saķēdētus velosipēdus .	iekļuvuši	4	Nom
Bet reiz es ieraudzīju it kā pazīstamas sejas , pazīstamus veidolus .	pazīstamas	6	Acc
Piemājas saimniecībās audzētās ogas tiek vestas no tuvākas un tālākas apkārtnes , arī no kaimiņvalsts .	vestas	5	Nom
Vai izravētas zemes atdevīgā smarža .	izravētas	1	Gen
Ierobežotas pieejamības dati par pacientu iedalāmi pamatdatos un papilddatos .	Ierobežotas	0	Gen
Proti , iekšējā pamatojumā tiesai jāataino juridiskais siloģisms – jāatklāj lietas risinājuma loģiskā saikne ar lietas faktiskajiem apstākļiem un piemērojamo tiesību normu .	piemērojamo	19	Acc
Var izmantot arī maltas auzu pārslas .	maltas	3	Acc
Bankas “ Citadele ” darījumā iesaistītās valsts amatpersonas nav vadījušās pēc profesionāli sagatavota komunikācijas plāna , bet informāciju medijiem un sabiedrībai sniedza haotiski , nepārdomāti , radot labvēlīgu vidi baumām un pretrunīgai informācijas interpretācijai .	sagatavota	12	Gen
– Tēti , Rainim ūdenī muša ir , – – Jurģis norūpējies teica , un es cēlos , izlēju veco pieputējušo ūdeni , kurā tiešām peldēja nosprāgusi muša , un ielēju jaunu .	pieputējušo	20	Acc
Aivars Plinte izdibinājis , ka agrāk Alokste nav plūdusi tur , kur tas notiek tagad .	izdibinājis	2	Nom
Hanovs pauda , ka sabiedrība vēl aizvien ir vēsturiski dziļi traumēta , turklāt sabiedrība , dzīvojot konstantā traumatiskā stāvoklī , ļaujas politiskajai manipulācijai .	traumēta	10	Nom
Kad atbrauca policija , tā atklāja , ka durvis uz guļamistabu ir aizslēgtas .	aizslēgtas	12	Nom
Par kukuļdošanu ierosināts saukt pie atbildības četrus ārvalstu komercuzņēmumu pilnvarotos pārstāvjus , savukārt par noziedzīgi iegūtu līdzekļu legalizēšanu - astoņas personas saukt , vienu saukt _ saukt arī par starpniecību kukuļošanā , kas izdarīta atkārtoti .	pilnvarotos	9	Acc
Šī tehnoloģija dod iespēju optimāli strādāt ar deformētiem nagiem .	deformētiem	7	Dat
Laiku pa laikam cilvēces vēsturē pienāk brīži , kad nākas uzrakstīt to , kas agrāk bijis pats par sevi saprotams arī nerakstīts .	nerakstīts	21	Nom
2. Dalībvalstis izņēmuma kārtā drīkst neattiecināt šīs direktīvas piemērošanas jomu uz dažu kategoriju darbiniekiem , pamatojoties uz pastāvošām cita veida garantijām , ja konstatē , ka tās sniedz attiecīgajai personai līdzvērtīgas pakāpes nodrošinājumu , kāds izriet no šīs direktīvas .	pastāvošām	17	Dat
Viņš esot gribējis arī , lai teksts iederas skanējumā .	gribējis	2	Nom
Dailes teātra sezonas noslēgumā paziņoti skatītāju visvairāk mīlētie aktieri .	paziņoti	4	Nom
Ir burvīgs Džonasa Solka citāts , kurš teica : „ Ja visi kukaiņi pazustu no zemes virsas , 50 gadu laikā dzīvība uz Zemes beigtos .	beigtos	24	Acc
Izlietotos vīriešus cacas izmet un dodas meklēt nākamo upuri .	Izlietotos	0	Acc
Sēdēdams kāpās , es domāju , ka tie , kas bēg , tie nezina , ko tie dara , braukdami prom no savas zemes .	Sēdēdams	0	Nom
Nesen veiktajā pētījumā par reģistrētās un nereģistrētās kopdzīves faktoru salīdzinošo analīzi [ LU Publiskās antropoloģijas centrs , 2015 ] respondenti lielākoties uzskatījuši , ka kopdzīve un attiecības jebkurā brīdī var pāraugt laulībā .	reģistrētās	4	Gen
19. Iesniegumu Nodaļas speciālista klātbūtnē aizpilda un paraksta visas pilngadīgās personas , kuras vēlas saņemt Palīdzību , uzrādot personu apliecinošu dokumentu .	apliecinošu	19	Acc
Visbeidzot , K. Malena un D. Brinkerhofs ir veikuši vislielāko ieguldījumu politiskās gribas mērīšanā , galvenokārt identificējot to ietekmējošos faktorus .	ietekmējošos	18	Acc
Sofijai atausa atmiņā , ka vecmāmiņa tajā dienā , kad uzzināja par savu slimību , bija teikusi kaut ko līdzīgu .	teikusi	16	Nom
Ņemot vērā , ka kukuļošanā iesaistītās personas KNAB aizturēja , tad paspēts nodot kukuli 77_499 latu apmērā .	iesaistītās	5	Acc
Piemēram , plānojot nepieciešamo skolotāju skaitu Floridā laika periodam līdz 2016. gadam , izglītības departaments ņem vērā 2006. gada decembrī notikušās konferences par skolēnu skaita noteikšanu lēmumos paredzēto vidējā klases lieluma samazināšanos .	notikušās	20	Acc
Tāpēc viņa labāk piekrīt administratīvai atbildībai par pases nolaidīgu glabāšanu , samaksājot komisijas noteikto soda naudu ( šajā gadījumā trīs lati _ ) , nekā lūdz policijas palīdzību .	noteikto	13	Acc
Lugu „ Frankenšteins ” , ko britu dramaturgs Niks Dīrs sacerējis pēc Mērijas Šellijas romāna motīviem un kas pirmizrādīta Londonas Nacionālajā teātrī 2011. gadā , uz Dailes teātra lielās skatuves iestudējusi Laura Groza-Ķibere .	sacerējis	10	Nom
Valdošā Afrikāņu Nacionālā Kongresa vēlēšanu manifestā Zuma solīja darīt vairāk , lai palīdzētu viņiem .	Valdošā	0	Gen
Tomēr , kā smejas studijas vadītāja , gandarījums par paveiktu darbu , kā arī jaukās sarunas un studijā valdošā gaisotne procesa laikā nav mērāmas naudas izteiksmē .	paveiktu	9	Acc
Šoferis to neredzēja , jo viņam skatu aizsedza pie vārtiem augošais kuplais pīlādzis , bet es nepaspēju vārtus noķert – un tā mašīna salauza vārtus .	augošais	10	Nom
Izbalējušas , vietām atlīmējušās , gultu galvgaļos taukaini brūnas tapetes ir .	atlīmējušās	3	Nom
IR PIEŅĒMUŠI ŠO DIREKTĪVU .	PIEŅĒMUŠI	1	Nom
Tātad — ja zīdainis spētu runāt , tam droši vien būtu kas sakāms par to , cik apbrīnojama ir pasaule , kurā viņš ir ieradies .	sakāms	12	Nom
Ministrs norādīja , ka Latvijas prezidentūra sagatavos Padomes secinājumus par sieviešu un vīriešu saņemto pensiju apmēru atšķirībām .	saņemto	13	Gen
Korektuma novērtēšanai var tikt lietota gan sistēmā iebūvēta instrumentācija , gan ārēja sistēmas darbības notikumu novērošana .	lietota	4	Nom
Grāmatas prezentācijā piedalījās vien autors – pats grāmatas varonis nebija ieradies , jo , izrādās , abi sakašķējušies jau radošā darba sākumposmā .	radošā	19	Gen
Tādējādi tika jau priekšlaicīgi ieviesti pārvaldības principi , par kuriem tikai salīdzinoši nesen par realizējamām atzina gan Valsts Kontrole , gan arī Ekonomikas ministrija .	realizējamām	14	Dat
Un ar šīm reportāžām pierāda , ka noliktajām atslēgām nav pieprasījuma , tā ir valsts glaimu politika , kura izmanto apstākli , ka jaunieši vēl nezina , ka naudu uz parāda ņemt ir viegli , bet ir grūti atmaksāt .	noliktajām	7	Dat
Prezidenta preses dienests informējis , ka D. Medvedevs nosūtījis Valsts domei vēstuli , kurā izvirza V. Putina kandidatūru premjera amatam .	nosūtījis	8	Nom
Labām kaimiņattiecībām pietiks ar padomiem balkona puķu audzēšanā vai atsvaidzinošu limonādi , ko pasniedz pār sētu .	atsvaidzinošu	9	Acc
Ja viņš šo nolādēto dienasgrāmatu izlasītu , tik un tā taču saprastu , ka runa ir par viņu !	nolādēto	3	Acc
Kāpēc — dots pret dotu ?	dotu	4	Acc
OECD apkopotā informācija apstiprina plaši izplatītus uzskatus , ka attīstības ekonomikas ir zaudējušas daļu no virzītājspēka , kas palīdzēja pasaulei pārciest attīstīto valstu nesen piedzīvoto izaugsmes tempa palēninājumu .	attīstīto	21	Gen
Pēc Rokko pārstāvju teiktā , viņš ļoti vēlas , lai viņu liek mierā un lai tiesas lēmums netiek iztirzāts publiski .	teiktā	3	Gen
Tā kā nāve tādā gadījumā neiestājas uzreiz , tā nav acumirklīga , pašnāvniecei ir dota iespēja apdomāties , lai lūgtu pēc palīdzības , tāpēc viņas biežāk var tikt izglābtas .	izglābtas	28	Nom
Laiks parādījis , ka šāds uzskats ir bijis maldinošs , jo piektā kolonna ideoloģiski joprojām pastāv un ir viens no lielākajiem draudiem mūsu valstij .	maldinošs	8	Nom
Meita to bija noķērusi .	noķērusi	3	Nom
Pedagoģisko darbinieku kopums jebkuras valsts izglītības sistēmā veidojas gadu desmitu gaitā , mijiedarbojoties dažādiem to ietekmējošajiem faktoriem .	ietekmējošajiem	15	Dat
Līdz ko apdzīvojamā teritorija vairs nebūs apbūvējama , tajā iestāsies stagnācija .	apbūvējama	6	Nom
Viena no tām ir Bauskas pils , kurai tagad pievienojies arī Rātsnams .	pievienojies	9	Nom
Arī bērnu centrs var būt izglītības iestāde , kura ir akreditēta un īsteno savu izstrādāto izglītības programmu , kuras rezultātu pārbauda valsts institūcijas .	izstrādāto	14	Acc
Kādu no vietējiem krogiem iespējams asociēt ar Svētā Bernarda klosteri , bet kādu no klaiņojošajiem suņiem , uzkarinot tam kaklā brendija mučeli , pasludināt par sanbernāru Bariju , kurš izglābis tūkstošiem dzīvību .	klaiņojošajiem	14	Dat
Bet ar teātra piedāvāto algu , kaut arī tā būs lielāka , nevar uzturēt ģimeni , kurā aug trīs bērni .	piedāvāto	3	Acc
Beļģijā trūkstošā darbaspēka sarakstus izmanto tikai tāpēc , lai elastīgi piešķirtu darba atļaujas jauno ES dalībvalstu pilsoņiem ( kopš 2009. gada maija - tikai Rumānijas un Bulgārijas pilsoņiem ) .	trūkstošā	1	Gen
Piedāvātā redakcija ir tik diskutabla , ka tā prasa nopietnu revīziju un analīzi .	Piedāvātā	0	Nom
Aizturēto izdevās nogāzt zemē un uzmanīgi atņemt viņam granātu .	Aizturēto	0	Acc
Ja līgumā nav noteikts līgumsods , tad pircējs maksā līgumsodu iemaksātā avansa apmērā .	iemaksātā	10	Gen
Un šī kundze un tie visi , ar kuriem es biju ticies , tie visi man bija sveši cilvēki .	ticies	11	Nom
Rezultāti ierosina uz domu , ka iekšējās delēcijas saturošu HBc gēna variantu zemās ekspresijas cēlonis ir izmainītie translācijas vai pēctranslācijas procesi .	saturošu	8	Gen
Otrajā pusē , kur vajadzēja sūtījumu vērt vaļā , bija uzrakstīts : Filosofijas kurss .	uzrakstīts	10	Nom
Pats par sevi saprotams , ka varēja iedomāties — pasaules telpa ir pastāvējusi vienmēr un mūžīgi , un tādā gadījumā nebija nepieciešams meklēt atbildi uz jautājumu , no kurienes tā cēlusies .	cēlusies	30	Nom
Informācijas tieša uztvere šajā gadījumā iegūst it kā papildu uzslāņojumu , jo uztvertās informācijas analīzē iesaistās domāšana , pieredze , analīze .	uztvertās	12	Gen
Bijis AP Tautas izglītības , zinātnes un kultūras komisijas loceklis , balsojis par Latvijas Padomju Sociālistiskās Republikas Augstākās padomes Deklarāciju par Latvijas Republikas neatkarības atjaunošanu .	balsojis	11	Nom
Pati Signe apmierināti uzskaita padarīto : ir tapusi civilizēta virtuve , sanitārais mezgls , kārtīgi izremontētas telpas , nu ēkai nomainīts jumts .	civilizēta	8	Nom
Visu kolektīvu uzstāšanos neredzējām , bet no redzētā mums ļoti patika Slovākijas čigāni .	redzētā	7	Gen
Arī puišeļi atieztiem zobiem un mazā Anna , kas kaut kur pazaudējusi cepurīti .	atieztiem	2	Dat
Vēlams , taču nav obligāti , iepriekšējās dienas vakarā izdzert kādu caurejas līdzekli , vislabāk zāļu tējas veidā .	Vēlams	0	Nom
( 4 ) Augstākās tiesas Senāts , atceļot spriedumu lietā , nodod to jaunai izskatīšanai tiesā atbilstoši Administratīvā procesa likumā noteiktajai piekritībai .	noteiktajai	20	Dat
Ir radīti speciāli medikamenti , kas pazemina holesterīna līmeni , bet pirms to lietošanas obligāti jākonsultējas ar ārstu , jo holesterīns nav vienīgais faktors , kas veicina aterosklerozi asinsvados .	radīti	1	Nom
Es pati biju par to , lai tiktu palielināts latviešu valodas stundu skaits .	palielināts	8	Nom
Izstādē redzamas Ilmāra Znotiņa , Aivara Liepiņa , Romāna Kokšarova un Zigismunda Zālmaņa fotogrāfijas , kurās tverti Latvijas olimpiešu spilgtākie mirkļi un emocijas Soču spēlēs šogad februārī .	tverti	16	Nom
Varbūt vairāk vajadzēja spēlēt ar cīņas spēlētājiem , taču beigās jau bija piekusuši .	piekusuši	12	Nom
Viņš vēlreiz uzsvēra , ka Latvijas nodomu noslēgt līgumu ar PSRS izraisījusi vēlēšanās “ līdzrunāt ” PSRS un Francijas attiecībās , un uzsvēra , ka atrisinājums ar Vācijas līdzdalību [ 100. lp. ] būtu “ daudz patīkamāks ” .	izraisījusi	11	Nom
Intervijā Mila atzinusies , ka visvairāk ietaupīts tieši uz saderināšanās gredzeniem , kurus tie nopirkuši par 190 dolāriem .	atzinusies	2	Nom
Bet ir arī viena kategorija cilvēku , kas apliecina šausmas , kas ar viņiem notikušas , ko narkotikas viņu dzīvei nodarījušas .	nodarījušas	20	Nom
Tie būs ticības svētki , kuros galvenā loma piederēs mirušajiem , bet kas tomēr tiks svinēti līksmā greznībā .	svinēti	15	Nom
Spēcīgs arguments pret šo plānu bija nemitīgi prātā paturamā iespēja , ka varenie kaimiņi varētu savā atbildībā nodoto zonu vienkārši sadalīt .	nodoto	17	Acc
10. Valda uzskats , ka kapātus vai smalki sagrieztus ēdienus neēdam ar naža palīdzību , jo nav taču ko vairs griezt !	kapātus	5	Acc
No turienes vējš _ , te tikai aizvējš _ , no turienes gaismas _ , šeit pusēnas _ , no turienes upe tiek dzīta atpakaļ uz savu iesākumu , līdz malām piepildīdama krastus .	piepildīdama	31	Nom
Esmu no rīta sastrīdējusies ar Ibisu , paģiraina devusies uz lekcijām un pēkšņi uz līdzenas vietas baltas aprīļa dienas vidū iekritusi tādā kā straumē , un tagad mani nes .	devusies	8	Nom
Tas ātri izslīdēja pa pavērto durvju starpu un , sākdams bļaut , joņoja pa koridoru , atsizdamies pret citu mantu skapjiem .	pavērto	4	Gen
Nevajag pirkt pirotehniku no privātpersonām , kas tirgo nezināmas izcelsmes nesertificētus izstrādājumus .	nezināmas	8	Nom
To izraisīja Eiropas Centrālās bankas ( ECB ) vadītāja Mario Dragi remarkas pagājušās nedēļas preses konferencē .	pagājušās	12	Gen
Likuma mērķis ir nodrošināt valsts drošības iestāžu amatpersonām Valsts drošības iestāžu likumā noteiktās tiesības uz izdienas pensiju un reglamentēt kārtību , kādā tā tiek piešķirta , aprēķināta un izmaksāta .	izmaksāta	28	Nom
1944. gada augustā Vasariņš tika iesaukts leģionā .	iesaukts	5	Nom
1972. gadā Ziedonim piešķirts nopelniem bagātā kultūras darbinieka nosaukums , 1977. gadā piešķirts Tautas dzejnieka goda nosaukums , 1983. gadā viņš apbalvots ar " Tautu draudzības " ordeni .	piešķirts	3	Nom
Jaunie tarifi nozīmē arī to , ka Lidosta Rīga nolēmusi atteikties no esošās lidostas apjoma atlaižu tarifu sistēmas , kas nodrošināja 80 % atlaides aviokompānijām airBaltic un Ryanair .	nolēmusi	9	Nom
Tāpat birojs aizturēja Daugavpils uzņēmēju Mihailu Paladiju un uzlika arestu viņam piederošajiem 100 % SIA " Būvenergoserviss " kapitāldaļu .	piederošajiem	11	Dat
Ņemiet vērā , viņi bija nosvinējuši ceturto gadadienu , jo mēnesis 16 gadu vecumā ir ilgs laiks .	nosvinējuši	5	Nom
Tu jūties ļoti ērti tā baltā truša kažokā , kurš tieši šajā acumirklī tiek izvilkts ārā no Visuma brīnumainā melnā cilindra .	izvilkts	14	Nom
Un tad mēs atgūlāmies , un es ieraudzīju , ka visa istaba ir pārkārtota .	pārkārtota	13	Nom
Viņš uzskata , ka integrētas federatīvas " Eiropas Savienotās Valstis " varētu kļūt par ietekmīgu spēku globalizētajā pasaulē , kā arī tas veicinātu Eiropas ekonomisko attīstību un ļautu labāk cīnīties pret organizēto noziedzību .	Savienotās	8	Gen
Zagļi mājokļa teritorijā bija iekļuvuši , izgriežot caurumu stiepļu žogā un aiznesot kopā saķēdētus velosipēdus .	saķēdētus	13	Acc
Viņš ieskatījās spogulī un , klibodams gar sienām , virzījās ārā .	klibodams	5	Nom
LAB patroneses pienākumos ietilpst LAB rīkoto pasākumu apmeklēšana un tikšanās ar aizbildņu ģimenēm .	rīkoto	5	Gen
Jaunais Rīgas teātris ārzemēs nereti ticis uztverts kā viena režisora autorteātris , kļūdaini uzsverot , ka to 1997. gadā dibinājis Alvis Hermanis .	dibinājis	19	Nom
Tas ātri izslīdēja pa pavērto durvju starpu un , sākdams bļaut , joņoja pa koridoru , atsizdamies pret citu mantu skapjiem .	atsizdamies	16	Nom
Testēšanas koordinators izmanto prasību - pārbaužu kontroliera sniegto informāciju tālākam darbam : pēc kārtas atrod visu pārbaudes moduļu izpildāmos failus , tos ielādē atmiņā un izpilda pārbaudes .	sniegto	7	Acc
Ekspresējamo HBc gēna variantu gadījumā recSFV genoms atbildīs subgenomiskā RNS HBc proteīnu mRNS .	Ekspresējamo	0	Gen
Pilsētās cēla kinoteātrus , bet laukos demonstrēja mēmās filmas uz ekrāniem , ko veidoja gar šķūņa sienu nostiepts balts palags .	nostiepts	17	Nom
Latvijā ražotos Lieldienu olu krāsojamos maisiņus pērk un lieto visa civilizētā pasaule !	krāsojamos	4	Acc
Nevarēdamas vairs izturēt komunālās šausmas , mēs ar mammu apņēmāmies darīt visu , lai tiktu laukā no tās pekles .	Nevarēdamas	0	Nom
ASV delegācijas vadītājs Stjuarts Eizenšatats atzinīgi novērtēja gan deklarāciju kopumā , gan tajā ietverto atsauci uz sociālo palīdzību .	ietverto	13	Acc
Lai neizjauktu ieplānotos darbus , pārbūvējamā dzīvokļa saimnieks var mēģināt vienoties par abpusēji izdevīgiem nosacījumiem ar kaimiņiem .	pārbūvējamā	5	Gen
Lai aktivitātes un tās identificējošos notikumus varētu sasaistīt ar konkrētu procesa instanci , valodā ir ieviesti mainīgie .	identificējošos	4	Acc
Kā norāda N. Muižnieks , „ vairāki politiķi un pat dažas valsts iestādes uzsvēruši , ka , viņuprāt , cittautiešu - ārpilsoņu atrašanās Latvijā nav leģitīma .	uzsvēruši	13	Nom
Kāds pasažieris pastāstīja , ka viens vagons noslīdējis no dzelzceļa uzbēruma un slīdējis lejup pa aizas malu , taču pēc desmit vai divdesmit metriem ieķēries kokos .	noslīdējis	7	Nom
Savukārt jaunās enerģiju taupošās un precīzās tehnoloģijas ļauj mūsu uzņēmumam nodrošināt arvien pieaugošo pieprasījumu pēc kvalitatīvas un veselīgas maizes . "	taupošās	3	Nom
Darba līgums arodbiedrības pilnvarotajai amatpersonai uzteicams atbilstoši Darba likuma noteikumiem .	pilnvarotajai	3	Dat
Izskatās , ka publika ir sašķēlusies divās nometnēs .	sašķēlusies	5	Nom
Ieva to klausījās , stāvēdama Ošu dārzā un lūkodamās pāri laukam uz mežu .	stāvēdama	4	Nom
Viss ieturēts rozā toņos , TV nepārtraukti tiek demonstrētas Bārbiju filmas .	ieturēts	1	Nom
Ja cilvēce nekad nebūtu atkritusi no Dieva , arī Bībele nebūtu uzrakstīta .	uzrakstīta	11	Nom
Līdzko pirmie koncertētāji bija prom , zālē ieskrēja Grinčs ar savu suni un meiteni , kuri paziņoja , ka Ziemassvētku nebūs , jo viņi tos ir nozaguši .	nozaguši	26	Nom
Skandalozajā ierakstā Cesto piedāvāja savu attiecību konflikta skaidrojumu , pavēstot , ka ar dziedātāju nav kopā kopš laika , kad viņš sācis piedalīties Nacionālā teātra uzvedumā « Uguns un nakts » , jo sieviete nav atbalstījusi viņa radošās ambīcijas .	sācis	21	Nom
Grilētās maizītes vari pārkaisīt arī ar piparmētru lapiņām , bet ogas vari aizvietot ar banāniem vai žāvētiem augļiem .	Grilētās	0	Acc
Kad lidmašīna nosēdās , asarās izplūdušajai Hiltonei paziņoja , ka tas bija joks .	izplūdušajai	5	Dat
Viss likās labākajā kārtībā — putekļi noslaucīti , uz krēslu atzveltnēm nomestās parpalas aizvāktas , biju pacenties pat ieviest šķietamu kārtību savā grāmatu plauktā .	nomestās	11	Acc
" Man bija bail , un es jutos bezspēcīga , " sacīja Virdžinja , atzīstot , ka viņa arī sajutusies nokaunējusies par to , ka bijusi īsos svārkos un augstpapēžu kurpēs .	nokaunējusies	20	Nom
Viņā krastā rūc mašīna , tajā iestiprināta vinča , kas velk gaisā izpletnī iekārušos Stefanu .	iekārušos	13	Acc
Savukārt , vērtējot šodien publiskotos datus par 2012. gada ceturto ceturksni , FM secina , ka salīdzinājumā ar iepriekšējiem ceturkšņiem IKP izaugsmē būtiskas izmaiņas nav vērojamas .	publiskotos	4	Acc
Dažas no identificētajām pundurplanētām ir asteroīds Cerera un transneptūna objekti Plūtons un Erīda .	identificētajām	2	Dat
Negadījumā cietušo nav , bojāts transporta līdzeklis .	cietušo	1	Gen
Viņa nevarēja pateikt pat , vai maz viņai bija atlicis laika ievilkt elpu lasīšanas laikā .	atlicis	9	Nom
Ūdens vārāmā kanna ir , kas nestrādā , trīs sienas kontakti ir , kas vados karājas ārpus sienas , ceturtais aiznaglots ar finiera kvadrātiņu .	aiznaglots	20	Nom
Pagaidām gan likumu nepilnību dēļ reāli sodīt var tikai tos , kuri tirgo viltotus eksāmenu uzdevumus .	viltotus	13	Acc
Saakašvili 2003. gadā vadīja tā dēvēto rožu revolūciju , kurā tika gāzts parlamenta vēlēšanu rezultātu viltošanā apsūdzētais prezidents Eduards Ševardnadze un pie varas nāca reformistiska , prorietumnieciska valdība .	dēvēto	5	Acc
Kopā ar brāli upes krastos esam piedzīvojuši ne vienu vien neparastu notikumu .	piedzīvojuši	6	Nom
Liepājas apkārtnē ceļojošās kāpas apbēra iekoptus tīrumus un 15 zemnieku mājas .	iekoptus	5	Acc
AR GARDU ĶĪSELI UN REŽISORES UNAS CELMAS VĀRĪTU PUTUKRĒJUMA RĪSU PUTRU tauta laista jauna filma « Raganu mēnesis » - interesanta un atraktīva , taču tajā pašā laikā arī pamācoša kinolente .	VĀRĪTU	7	Acc
Meitenes vecvecāki līdz Otrajam pasaules karam dzīvojuši Latvijā , un arī viņa sevi uzskata par latvieti .	dzīvojuši	6	Nom
1983. gadā uztaisījām pirmo zīmēto filmu .	zīmēto	4	Acc
Tirdzniecība ir organizēta pēc tirgus principa .	organizēta	2	Nom
Hēra aizstāv laulību un sargā laulības saišu nepārkāpjamo svētumu .	nepārkāpjamo	7	Acc
Latvijas futbola izlases aizsargs Kaspars Gorkšs pēc neliela atvaļinājuma šodien atsāks treniņus pirms maija beigās paredzētās Baltijas kausa izcīņas .	paredzētās	15	Gen
Upīte aizsērē , sākas tā sauktā eitrofikācija , nu arī zivīm tur vairs nav ko darīt .	sauktā	5	Nom
Tik daudz spēka jāsakopo , lai paklausītu šai siltajai pavēlošajai balsij .	pavēlošajai	9	Dat
Cikloniem , virzoties no Atlantijas okeāna , tie atnes apmākušos laiku , bieži ar nokrišņiem .	apmākušos	9	Acc
Arī pats Čaudhri ieradās Karači , lai uzstātos demonstrantu priekšā , taču līdz manifestācijas vietai netika , jo valdošo spēku atbalstītāji sāka bloķēt ceļus , lai neielaistu pilsētā opozicionārus .	valdošo	18	Gen
Taču nākamajā dienā viņa Māra atsilušo labrītu atņēma caur zobiem , acīs neskatīdamās .	atsilušo	5	Acc
Sarīvējiet uz smalkās rīves ziepes un izšķīdiniet traukā , ieteicams pievienot mazliet dzeramās sodas un ožamo spirtu , tie lieliski mīkstina nagus un ādu uz kāju pirkstiem .	ožamo	15	Acc
Baidīdamies kļūdīties , viņi nodarbojas ar sīkumiem , nevis sāk būtiskus projektus .	Baidīdamies	0	Nom
Dodoties uz norādīto vietu , notverts Rēzeknes iedzīvotājs , kurš jau bija paspējis nomedīt zivis - sešus plaužus un divas līdakas .	norādīto	2	Acc
Nu jau pieaudzis viņš labprāt pastaigājas pa nepazīstamām vietām dabā un pa Losandželosu regulāri brauc ar riteni .	pieaudzis	2	Nom
8. Ievērojot minēto un pamatojoties uz Administratīvā procesa likuma 85. panta pirmo daļu , Ministru kabinets nolemj atcelt rīkojumu daļā par atteikumu nodot privatizācijai atdalīto zemes vienību .	atdalīto	24	Acc
Objektīvais līmenis paredz analizēt konkrēto politisko vidi , kura ietver institucionālos un likumiskos veidojumus , iesaistītos politikas veidotājus , pieejamos resursus un citus faktorus .	iesaistītos	15	Acc
Pirmdien visu ziemeļaustrumu štatu gubernatori tiksies ar Brazīlijas prezidentu Luisu Inasiu Lulu da Silvu , lai prasītu papildu finansējumu , kas nepieciešams galvenokārt palīdzības nodrošināšanai cietušajiem un applūdušo pilsētu infrastuktūru atjaunošanai .	applūdušo	27	Gen
Minētā zeme kopā ar būvi atstājama kopīpašumā , bet pārējo zemi var sadalīt atsevišķos īpašumos , ievērojot šā panta pirmajā daļā noteikto .	noteikto	21	Acc
( 4 ) Ja izdienas pensijas izmaksu pārtrauc , pirms parāds dzēsts , atlikušo parāda daļu piedzen likumos noteiktajā kārtībā .	dzēsts	11	Nom
Konkrētajos gadījumos no verba pamatnozīmes izriet visas pārējās nozīmes – redzēšanas process tiek attiecināts ne vairs tikai uz ar aci saskatāmo materiālo dabu , bet arī uz garīgām lietām .	saskatāmo	20	Acc
Kā tikko sapļautas zāles nastu .	sapļautas	2	Gen
Pievieno arī smalki sakapātu ķiploku , citronu miziņas un spinātus .	sakapātu	3	Acc
Savukārt vēl divas amatpersonas apsūdzētas gan par nepatiesu ziņu norādīšanu valsts amatpersonas deklarācijā , gan par neatļautu piedalīšanos mantiskos darījumos .	neatļautu	16	Acc
1. Noteikumi nosaka Ministru kabinetam padoto institūciju vienotas vizuālās identitātes prasības .	padoto	5	Acc
Tā pavēstījusi arī par plašāku sadarbību ar starptautiski neatzīto Abhāziju un Dienvidosetiju .	pavēstījusi	1	Nom
Top animācijas filma pašu veidotajai sērijai Pasaules tautu pasakas .	veidotajai	4	Dat
Lieliski varēja dzirdēt cauri Irbes jūras šaurumam braucošo kuģu dzinējus , kuri nekādi nevarēja atrasties tuvāk par 20 kilometriem .	braucošo	7	Gen
Finanšu ministrs Andris Vilks ( V ) norāda , ka Latvijas ekonomikas noturība pret ārējās vides pasliktināšanos ir skaidrojama gan ar krīzes laikā īstenotajām reformām un budžeta samazinājumu , gan ar iekšējā pieprasījuma pakāpenisku atlabšanu .	īstenotajām	23	Dat
Budēļi iet no sētas uz sētu , svētību nesdami , un tāpēc visur gaidīti .	gaidīti	13	Nom
Tātad runa varētu būt par savulaik reģionu apdzīvojušo baltu cilšu saliedētību .	apdzīvojušo	7	Gen
Lai cik paradoksāli būtu , studentiem katra šī lekcija nāk kā pārsteigums — viņi neko tādu iepriekš nav zinājuši , " apliecina K. Apse .	zinājuši	18	Nom
Labāk izvēlēties bioloģiski audzētus produktus .	audzētus	3	Acc
Netīrumus un sakrājušās mirušās ādas šūnas regulāri notīriet no nagu apakšas ar neasu kociņu , to ir jādara ļoti uzmanīgi , lai netraumētu naga iekšpusi .	sakrājušās	2	Acc
Ideja ir apmēram šāda : tiek radīts vienkāršots cilvēka klons , kuram uz laiku tiek dota oriģināla apziņa , un šis duplikāts tad arī piedalās konferencēs vai vienkāršās sarunās pierasto hologrammu vietā .	radīts	6	Nom
K. Klemm piedāvā , izmantojot informāciju par paredzamo skolēnu skaitu , klases piepildījumu un stundu skaitu nedēļā katrai klasei , teorētiski skaitļot skolēnu skolotāju skaita attiecību un no tās noteikt nepieciešamo pedagoģisko darbinieku skaitu ( Klemm , 1992 ) .	paredzamo	7	Gen
Līdz ar to padomes locekļu skaits tiks samazināts no 11 līdz septiņiem .	samazināts	7	Nom
Savukārt drīz būsim ieguvuši jaunus logus .	ieguvuši	3	Nom
Analītiķi atzīmē , ka nevienam nav skaidrs , kādā virzienā dosies valsts ekonomika , kas pārdzīvo grūtus laikus pēc ilgstošas augsmes posma .	ilgstošas	19	Gen
Par gluži simbolisku cenu būs iespēja iegādāties SIA " Servilat " dāvātās desiņas .	dāvātās	11	Acc
Funkcionālisma perspektīva ir izstrādājusi arī izglītību raksturojošu jēdzienu kopumu , ko ir iespējams lietot , lai precīzāk identificētu analizējamos izglītības procesus .	analizējamos	18	Acc
Ieslēdzu televizoru , rāda mazu , slapju , tikko dzimušu tīģeri ar trīcošu galvu .	dzimušu	9	Acc
Paredzams , ka ECOFIN sanāksmē Īrijas prezidentūra prezentēs panākto progresu šo priekšlikumu saskaņošanā ar Eiropas Parlamentu .	panākto	8	Acc
Bet stāsta finālā Žeņečka , kuru Igors nolamājis par “ zilo ” , izmisīgi sitas pret zilas gaismas apspīdētajām kopmītnes istabas sienām , rausta un nespēj atvērt durvis , kuras patiesībā nemaz nav aizslēgtas .	nolamājis	7	Nom
Viena meitene ievesta , cietusi autokatastrofā .	ievesta	2	Nom
Pēdējā skaitļa izmaiņas gan lielā mērā ir skaidrojamas ar ievērojamu skolotāju kvalifikācijas paaugstināšanos pēdējo gadu laikā .	ievērojamu	9	Acc
Nomināciju komiteja veica " Lattelecom " padomes kandidātu kompetenču izvērtēšanu un vienojās , ka esošo padomes locekļu Gata Kokina un Jāņa Grēviņa kompetence tehnoloģiju un uzņēmumu pārvaldības jomā būtu jāpapildina , piesaistot speciālistus ar padziļinātām zināšanām finanšu pārraudzībā .	padziļinātām	34	Dat
— Labi , ka vakar nolija , nebūs putekļu , — sacīja Vilnis , nogriezdamies no šosejas uz grantētā lielceļa , kas cauri diviem sīkiem ciematiņiem veda uz Mežmaļiem .	grantētā	18	Gen
Pirmdien visu ziemeļaustrumu štatu gubernatori tiksies ar Brazīlijas prezidentu Luisu Inasiu Lulu da Silvu , lai prasītu papildu finansējumu , kas nepieciešams galvenokārt palīdzības nodrošināšanai cietušajiem un applūdušo pilsētu infrastuktūru atjaunošanai .	cietušajiem	25	Dat
Vienlaicīgi būtiski ir uzsvērt , ka globalizācijas veicinātā brīvā tirdzniecība nav veicinājusi labāku darba apstākļu izveidošanos attīstības valstīs .	veicinājusi	11	Nom
Uzņēmēju apgalvojumi par izvēlēto stratēģiju ir nekompetenti un pretrunīgi .	izvēlēto	3	Acc
No pieliekamā iznāk Artis .	pieliekamā	1	Gen
Zviedrijas hokejistu izlases ārsts Bjērns Valdbeks vakar sacījis , ka pēc Mārtiņa Karsuma veiktā spēka paņēmiena savainojumu guvušais Tobiass Enstrēms , iespējams , vēl izies uz ledus šajā pašā pasaules čempionātā .	veiktā	13	Gen
Tepat netālu bijušās baznīcas pagrabā ir veco ļaužu saieta nams jeb senioru centrs , kā to parasts te saukt .	bijušās	2	Gen
5. Ārstniecības persona triju dienu laikā pēc ieslodzītā uzņemšanas ieslodzījuma vietā veic ieslodzītā veselības pārbaudi .	ieslodzītā	7	Gen
Turpinot darbu pie dokumentu izstrādes , diskusijas dalībnieki vienojās , ka LPS nosūtīs VARAM apkopotos novadu pašvaldību priekšlikumus , ko ministrija savukārt solījās izskatīt .	apkopotos	14	Acc
No aizvadītās sezonas izrādēm skatītāji anketās visbiežāk minējuši mūziklu Marlēna , ar kuras pirmizrādi izdevniecība Žurnāls Santa svinēja savu 20 gadu jubileju .	aizvadītās	1	Gen
Promocijas darbā šo datu trūkums kompensēts ar izmantoto krātuvju materiāliem .	izmantoto	7	Acc
Vērtīgākās ziņas aplūkojamās tēmas sakarā rodamas muižu un baznīcu materiālu mapēs .	aplūkojamās	2	Gen
Mūzika nāca no zvejas kuģīša , kas kopš Jāņiem bija noenkurojies selgā .	noenkurojies	10	Nom
Policija darbinieki pastiprinātu uzmanību pievērsīs arī iereibušiem gājējiem , velosipēdistiem un mopēdistiem , kuri ir vieni no neaizsargātākajiem satiksmes dalībniekiem .	pastiprinātu	2	Acc
Administratīvās tiesas vispārējos tiesību principus piemēro , interpretējot tiesību normas , aizpildot likuma robu , piemērojot principu kā tiesību normu , kā arī skaidrojot , kāpēc princips nav piemērojams .	piemērojams	28	Nom
Tā pavēstījusi arī par plašāku sadarbību ar starptautiski neatzīto Abhāziju un Dienvidosetiju .	neatzīto	8	Acc
Sofija siltajā ziemeļu upē redzēja rietošās saules ceļu , laivas un iedegušus vīrus košos kreklos , apaļām cepurēm galvās .	iedegušus	11	Acc
Bet izejot no telpas , viņš ieslēdza uz galda stāvošo radio .	stāvošo	9	Acc
Tā rezultātā mēs izglītojam cilvēkus prom no viņu radošajām spējām .	radošajām	8	Dat
Turpretim pie subjektīviem faktoriem pieskaitāma priekšlikumu ( ierosinājumu ) nesagatavotība , fakts , ka tie nav sociāli , ekonomiski , kriminoloģiski pamatoti , ir fragmentāri , bez sistēmas , dažkārt tos nosaka konjunktūras apsvērumi .	pieskaitāma	4	Nom
Tiek uzsvērts , ka vislielākie stereotipu draudi rodami nevis tajos ietvertajos maldos , bet gan rīcībā , kas tiem seko .	uzsvērts	1	Nom
Pēc tam noskrāpē sacietējušo vasku no bojātās virsmas .	sacietējušo	3	Acc
Nav arī nekādu pazīmju , ka tā tikusi nolaupīta .	nolaupīta	8	Nom
Raksturojot čigānus , respondenti , neatkarīgi no pārstāvētā reģiona vai vecuma grupas , lielā vienprātībā atzīmēja , ka viņi zogot , krāpjot , mānot , hipnotizējot , nestrādājot , klejojot , ubagojot , nemācoties .	pārstāvētā	7	Gen
Pirmo reizi redzēju , ka ir pabeigta Latvijas Nacionālās bibliotēkas celtniecība , » sarunā ar » Vakara Ziņām « stāsta Pulkinena .	pabeigta	6	Nom
Runājot par solokoncertu , portālam Mango Šomase atklāj , ka augsti novērtē savus dziedošos viesus - Ati Auzānu un viņa Daugavpils kori , Andri Ērgli un Jāni Vinteru , kuri ļoti labi nodziedāja .	dziedošos	13	Acc
Jauna krimināllikuma izstrādāšanas vai esošā grozīšanu iniciatori var būt ļoti dažādi , piemēram : valdības deklarācijas , koncepcijas , tiesībsargājošo un citu institūciju prakses apkopojumi , politisko partiju un atsevišķu politiķu ierosinājumi , zinātniskajās publikācijās izteiktie priekšlikumi utt .	izteiktie	35	Nom
Es esmu sūtījusi vienu īsziņu pēc otras .	sūtījusi	2	Nom
Ieteicams visus bērnam sasniedzamos priekšmetus novietot un sakārtot tā , lai bērns varētu ar tiem rotaļāties , nebojājot vērtīgās lietas .	sasniedzamos	3	Acc
Starp aizdomās turētajiem ir arī konsultants Andrejs Livanovičs , kuram piederošā firma SIA " Energy Consulting " darbojās kā Šveices uzņēmuma " AF Colenco " aģents .	turētajiem	2	Dat
Seula ierosināja 30. oktobrī noorganizēt augsta līmeņa politiskās sarunas , bet Ziemeļkoreja uz šo priekšlikumu vēl nav atbildējusi .	atbildējusi	17	Nom
Zobs ir līdzens , tāpēc , la kape spētu labi aizķerties un novadīt atbilstošus spēkus , nepieciešamas šīs atslēdziņas .	atbilstošus	13	Acc
Pašlaik tiek novērtētas ietekmes uz apkārtējo vidi sekas .	novērtētas	2	Nom
Lustrētu personu vārdi netiek publiskoti .	Lustrētu	0	Gen
Tāpat aizsardzībai no katastrofu postošajiem faktoriem iedzīvotāji var izmantot arī individuālos aizsardzības līdzekļus , veikt telpu hermetizāciju un citus nepieciešamos pasākumus .	postošajiem	4	Dat
Bet administratore atrauj vaigu no telefona klausules , uzmet man iztraucētu skatienu , it kā brīnīdamās , ka vēl esmu te , un uzrunā mani , tieši mani .	iztraucētu	10	Acc
Gadījumā , ja palīdzību pieprasījusī Puse ir atsaukusi savu pieprasījumu , tā apņemas atlīdzināt izdevumus , kas jau izlietoti vai radušies otrai Pusei .	atsaukusi	7	Nom
Turpmāk paredzēts ražot septiķus jeb kontrolakas kanalizācijas sistēmām .	paredzēts	1	Nom
Nosodījumu pelna ne tikai diskriminācija , kas atsevišķos gadījumos ir saslēgta vienotā ķēdē ar stereotipiem , bet arī tāda rīcība , kad vērtējamās grupas pārstāvji apzināti sāk līdzināties par sevi radītajiem priekšstatiem .	radītajiem	30	Dat
To nozīmīgums pamanīts un izmantots , atlasot atbilstošās tautas dziesmas , arī okupācijas varu ideoloģijas arsenālā , kas visspilgtāk atspoguļojas skolas mācību grāmatās .	atbilstošās	7	Acc
Jutas štatā tādu , kas pārtrauc strādāt skolā pirmajos piecos gados pēc darba gaitu uzsākšanas , īpatsvars ir pārsniedzis 55 % ( Utah System of Higher Education , 2007 ) .	pārsniedzis	18	Nom
Dievinu sajūtu , kad vīrieši , kurus apdzenu , piebrauc man klāt , paskatās uz mani un , ieraugot pie stūres meiteni , parāda neticošu sejas izteiksmi , » smejas Viola .	neticošu	24	Acc
Aizturētais narkomāns nozagtos velosipēdus galvenokārt tirgoja zemniekiem Purvciema tirgū , piedāvājot tos par 30 - 40 latiem .	nozagtos	2	Acc
Piemēram , plānojot nepieciešamo skolotāju skaitu Floridā laika periodam līdz 2016. gadam , izglītības departaments ņem vērā 2006. gada decembrī notikušās konferences par skolēnu skaita noteikšanu lēmumos paredzēto vidējā klases lieluma samazināšanos .	paredzēto	27	Acc
Uiguru skaistules ticēja , ka , ietinoties svaigi nodīrāta lāča ādā , var saglabāt meitenīgu sejas krāsu līdz pat vecumam .	nodīrāta	8	Gen
Par sistēmiski nozīmīgo finanšu iestāžu papildu kapitāla rezervju prasībām Latvija atbalsta Eiropas Parlamenta priekšlikumu , ka sistēmiskā riska rezerves un sistēmiski nozīmīgo iestāžu rezervju kopējā prasība tiek aprēķināta summāri ar 8 % maksimālo ierobežojumu .	aprēķināta	27	Nom
Turp viņa devās vienīgi tad , ja bija ārkārtīgi sadusmojusies , ārkārtīgi nogurusi vai ārkārtīgi laimīga .	sadusmojusies	9	Nom
Ja visu saliek pa plauktiņiem , neapgalvošu , ka uzvarējām likumsakarīgi , tomēr nevar teikt , ka mūsu uzvara bija nepelnīta .	nepelnīta	20	Nom
Vēlēšanu komisijai nogādājamos vēlēšanu materiālus ( 66. punkts ) ievieto vēlēšanu kastē .	nogādājamos	2	Acc
Sarīvējiet uz smalkās rīves ziepes un izšķīdiniet traukā , ieteicams pievienot mazliet dzeramās sodas un ožamo spirtu , tie lieliski mīkstina nagus un ādu uz kāju pirkstiem .	dzeramās	12	Gen
( 4 ) Akreditētais muzejs zaudē akreditēta muzeja tiesības , ja tas neatbilst šā panta otrajā daļā minētajiem nosacījumiem .	minētajiem	17	Dat
Pieaugušie pieņem pasauli kā kaut ko dotu .	dotu	6	Acc
Un tur varētu ielikt arī paralēli vēl vienu sadaļu , kurā būtu norādīti administratīvie pārkāpumi , kurus cilvēks ir izdarījis .	izdarījis	19	Nom
Sākot ar 2008. gada beigām , strauji samazinājās nodarbināto skaits .	nodarbināto	8	Gen
Likumprojekta mērķis pēc būtības ir apbalvot nacistiskās Vācijas pusē karojušos , piešķirot viņiem krūšu nozīmi .	karojušos	9	Acc
OECD apkopotā informācija apstiprina plaši izplatītus uzskatus , ka attīstības ekonomikas ir zaudējušas daļu no virzītājspēka , kas palīdzēja pasaulei pārciest attīstīto valstu nesen piedzīvoto izaugsmes tempa palēninājumu .	izplatītus	5	Acc
Galvenajai līdzi paņemtajai lietai gan jābūtot možam noskaņojumam .	paņemtajai	2	Dat
Ikvienam ESIF atbalstītajam projektam būs nepieciešams EIB apstiprinājums .	atbalstītajam	2	Dat
Vīrs atsūtījis pretī mašīnu ar šoferi .	atsūtījis	1	Nom
Skolēnu skaita izmaiņas uzreiz nenoved pie atbilstošām skolotāju skaita izmaiņām .	atbilstošām	6	Dat
Puisis palēcās , laipiņa sašūpojās , kājas atgrūdās , un viņš izstieptām rokām traucās pretim melnajam atvaram .	izstieptām	11	Dat
Ar kvebekieti iedzerot vīnu un apspriežot notikušo , secinām , ka viss šajā pasaulē atkarīgs no ļaudīm .	notikušo	6	Acc
Pazīstot savus produktus , zinot katras preces lietošanas ilgumu , iespējams noteikt brīdi , kad pienācis laiks reiz pārdoto preci aizstāt ar jaunu .	pārdoto	18	Acc
Dziesma intuitīvi saplūst arī ar gaidāmo saulgriežu svinēšanas tematiku .	gaidāmo	5	Gen
Atnāca jaunsargi un pa kādam varas vīram , kam sagribējies „ pazīmēties ” tautas tuvumā .	sagribējies	9	Nom
Savu mērķu sasniegšanai viņi mēģina , gan apiet robežkontroles punktus , tādejādi nelikumīgi šķērsojot " zaļo " robežu , gan izmantot viltotus ceļošanas dokumentus , tajā skaitā arī viltotas citu Šengenas zonas valstu uzturēšanās atļaujas un vīzas .	viltotus	21	Acc
Vilks uzskata , ka šajā laika posmā gūtās zināšanas ļaujot secināt , ka " vairumā gadījumu domstarpību starp izīrētāju un īrnieku var rast abiem pieņemamu risinājumu , ja jautājumam pieiet ar izpratni un ņem vērā abpusējas intereses " .	pieņemamu	24	Acc
Ja attiecīgajam līgumslēdzējam nav atbilstošas speciālās atļaujas vai industriālās drošības sertifikāta , Nacionālā drošības iestāde , kas piešķirs klasificēto līgumu , var lūgt , lai šim līgumslēdzējam tiek veikta atbilstoša drošības pārbaude .	atbilstoša	29	Nom
Petardes bijušas pavērstas pret cilvēkiem un sieviete guvusi slēgtu kājas bojājumu , iespējams , kaula lūzumu .	slēgtu	8	Acc
Viņai ir negatīvais rēzuss , tā ka jūs nākat kā saukts .	saukts	10	Nom
" Vēlos piesaukt Lībijas jautājumu un mūsu acu priekšā un mūsu robežu tuvumā dzimstošos tiešos draudus mūsu drošībai – jauno barotni džihādistu teroristiem , " uzrunājot Eiropas sociāldemokrātu sanāksmi , norādīja Valss .	dzimstošos	13	Acc
Viena lietotāju kategorija pilnībā ir mierā ar narkotiku lietošanu un ar to saistītām grūtībām .	saistītām	12	Dat
Saskaņā ar autora ideju katram vides rādītājam atbilstošo pārbaudes moduli piemeklē prasību - pārbaužu kontrolieris .	atbilstošo	7	Acc
Padomju Savienībā ienākošās vienības tūlīt pārņēma savā kontrolē visus atrastos lauksaimniecības produktus .	atrastos	9	Acc
Brūvēsim gaišā un tumšā alus šķirnes , piesaistot vienu no zināmākajiem alus darītājiem .	zināmākajiem	10	Dat
Hērdas iesniegtajos dokumentos apgalvots , ka maijā Deps viņai « vardarbīgi uzbruka » pāra kopīgajā dzīvoklī .	apgalvots	3	Nom
Nenoskaidrota persona Limbažos no veikala Supernetto nozagusi 0,7 l tilpuma degvīna pudeli Vodočka 5,99 eiro vērtībā .	nozagusi	6	Nom
Kaut kāda rosība Jūrmalā vērojama vien nosacīti lētajā un ļoti dārgajā tirgus daļā .	vērojama	4	Nom
Kā negatīvu iezīmi etniskajos stereotipos jāmin arī tajos ietvertās prognozes attiecībā uz vērtējamās etniskās grupas locekļu rīcību , kā arī to , ka stereotipa aizsargmehānismi ignorē un apslāpē acīmredzamo , kas noliedz tajā pārvērstos faktus .	vērtējamās	12	Gen
Un nu mēs redzam iespēju kaut ko no tā izmantot , turklāt redzam pamatotas iespējas , kas varētu ļaut risināt minētos jautājumus , mums darbojoties valdībā .	minētos	20	Acc
Krimināllikumu pilnveidošanas process kļūs pārdomātāks , pamatotāks un efektīvāks , ja tiks balstīts uz krimināltiesību politikas progresīvām atziņām .	balstīts	12	Nom
Dominējošais šajos piemēros – iztēles tēlu vizualizēšana un nākotnes redzējums perspektīvā .	Dominējošais	0	Nom
Tomēr Helēna ievēroja , ka cēlā vīra acis , raugoties uz viņu , pildās ar neapvaldāmām , nenoslēpjamām skumjām , kas draudēja pārvērsties par daudzām stikla bumbiņām , kas tad neapturami ripotu un plīstu , ripotu un plīstu .	nenoslēpjamām	17	Dat
Veikt šādu pētījuma prasa arī notikušās izmaiņas valsts budžeta finansēto studiju vietu skaitā .	finansēto	9	Gen
Respondentu sniegtajos nacistiskās Vācijas armijas karavīru vērtējumos būtiska bijusi pašu saskarsmes pieredze .	bijusi	8	Nom
Vai tad tas nav pārgājis ?	pārgājis	4	Nom
Un nu jau viņa čivina par savu jauno acu krāsu , savas skolas ballīti , savu draudzeņu draugu bijušajām draudzenēm ...	bijušajām	18	Dat
Abas personas apsūdzētas par " Latvenergo " rīkoto konkursu " Pļaviņu hidroelektrostacijas hidroagregāta Nr. 4 , 5 , 7 rekonstrukcija " .	rīkoto	7	Acc
Var uzteikt arī Raimonda Vējoņa darbu šobrīd Aizsardzības ministrijā – jo īpaši tagad , kad Latvija ir Eiropas Savienības prezidējošā valsts un ģeopolitiskā situācija pasaulē nav viennozīmīga .	prezidējošā	19	Gen
Eitanāziju ir iespējams izdarīt gan vientulībā , gan sērojošo tuvinieku lokā , ir iespējams izvēlēties starp visdažādākajiem nāves un apbedīšanas veidiem , protams , ir arī speciālistu konsultācijas .	sērojošo	8	Gen
Patiesībā te bija bijis dzīvžogs , kas veidoja robežu starp dārzu un lielo mežu , bet , tā kā to neviens nebija kopis pēdējo divdesmit gadu laikā , tas bija aizaudzis un kļuvis par necaurejamu biežņu .	aizaudzis	30	Nom
Un tā bija gadījies , ka neviens neko tajā nebija ielicis .	gadījies	3	Nom
Ūdens pamazām mainījis krāsu un gaisā uzvirmojis līdz tam vēl nepazīts aromāts .	mainījis	2	Nom
Piemēram , klases telpas izvietojums , skaidri iezīmē pedagoģiju un hierarhiskas attiecības starp iesaistītajiem aģentiem .	iesaistītajiem	13	Dat
Zimbabvē un citur , kur Centrālā banka joprojām ir Finanšu ministrijas vai Prezidenta kancelejas pakļautības iestāde , ierēdņiem apsolītā nauda tiek vienkārši nodrukāta .	apsolītā	18	Nom
Un es apsolos sev , lūk , tagad es došos uz pāriemiesošanas telpu , un tad , kad būšu tikusi galā , tad pirmām kārtām lūgšu Patrīcijai , lai iesaka man ko labu no mūsdienu mūzikas klāsta .	tikusi	19	Nom
Ēdiena maiņa izmainīja viņa fizisko spēku un veicināja smadzeņu pastiprinātu darbību un attīstību .	pastiprinātu	9	Acc
Tas attiecīgi paredz daudz aptverošāku politiku izstrādi un saskaņotāku rīcību .	saskaņotāku	8	Acc
Pēdējo reizi šajā štatā nāvessods tika izpildīts 1997. gadā .	izpildīts	6	Nom
Būtiski , lai šie resursi tiktu pareizi izmantoti : pareizi ir uzticēties uzticamajam un neuzticēties neuzticamajam ; savukārt nepareizi ir uzticēties neuzticamajam un neuzticēties uzticamajam .	uzticamajam	12	Dat
Vērsieties pēc palīdzības pie ārsta vai pieredzējuša pedikīra meistara .	pieredzējuša	6	Gen
Viņas sāni cilājas kā pēc gara skrējiena , Jasmīne atrod mātes doto kleitu , paceļ to un apskata .	doto	11	Acc
Pieauguši vīrieši un sievietes , kas nevaldāmi lokās , bez ritma izjūtas .	Pieauguši	0	Nom
Tā savā ziņojumā ECOFIN sanāksmei lūdz padomi vienoties par vēl atvērtajiem jautājumiem un pārapstiprināt padomes mandātu turpmākajām sarunām ar Eiropas Parlamentu .	atvērtajiem	10	Dat
10. Valda uzskats , ka kapātus vai smalki sagrieztus ēdienus neēdam ar naža palīdzību , jo nav taču ko vairs griezt !	sagrieztus	8	Acc
Saule izstaro arī tā saukto Saules vēju , kurš izplatās pat līdz izkliedētā diska vidum , veidojot heliosfēru .	saukto	4	Acc
Upe plūst , tecila griežas , mēness trin sānus , izlec pa dzirkstij , izkrīt pa zvaigznei , tilts sakumpis , uzmetis lūpu , gumst zem signāliem , elpām un riteņu dunēšanas .	sakumpis	19	Nom
Vienlaikus A. Sietiņš apliecina , ka glābēji neatteiks palīdzību nelaimē nonākušajiem cilvēkiem , arī dzīvniekiem .	nonākušajiem	10	Dat
Vai jums nekad nav gadījies , ka pirmoreiz kaut ko ieraugāt un uzreiz saprotat , ka visu mūžu esat to meklējis ?	meklējis	20	Nom
Tā dzīvē iekārtots .	iekārtots	2	Nom
Ievērojot spriedumā lietā Nr. 2010-56-03 atzīto , Birojs rekomendējis īpašu uzmanību pievērst dabas liegumam " Ziemupe " piegulošajām Akmeņraga meža daļām , kuras teritorijas plānojumā apzīmētas ar indeksu M-3 .	atzīto	5	Acc
Ja Tu tikai pakrati galvu un nejūties sevī ne kā bērns , ne arī kā filosofs , tad Tu esi jau paspējusi aprast ar pasauli tā , ka tajā nekas vairs tevi nepārsteidz .	paspējusi	21	Nom
Sofija saprata , ka viņa jau ir sākusi rāpties lejup pa kažoka spalviņu tam trusim , kas izvilkts no Visuma melnā cilindra .	izvilkts	17	Nom
Saulkrastietes māsas Arnita un Evita Čistjakovas asinis nodod regulāri un ir priecīgas palīdzēt nelaimē nokļuvušajiem .	nokļuvušajiem	14	Dat
Pie sociālo faktoru grupas pieskaitāmi kā ar sabiedrības viedokli par izglītības sistēmas attīstību saistīti faktori , tā arī tādi , kas ir noformulēti Latvijas Republikas Saeimas un Ministru kabineta tiesību aktos .	pieskaitāmi	4	Nom
Pagaidām neviena apsūdzētā vārdu prokuratūra publiski neatklāj .	apsūdzētā	2	Gen
Edgars Andersons sev raksturīgajā piesardzīgajā stilā kritizējis Baltijas valstu izvēlēto novilcināšanas taktiku .	izvēlēto	9	Acc
Māja , kuru viņiem parādīja vietējie , bija dabūjama bez aizkavēšanās .	dabūjama	8	Nom
Kad viņa pārbēga uz Lielbritāniju , jauniete bija pārsteigta , ka citur pasaulē pret apgraizīšanu ir klaji noraidoša attieksme .	noraidoša	17	Nom
Pagājušās nedēļas nogalē Valgā 32 kaimiņpilsētu šahisti cīnījās Paula Keresa dzimšanas dienai veltītajā šaha turnīrā .	Pagājušās	0	Gen
Maija stāsta , ka visvairāk uztraukusies par dzīvnieka ēdināšanu ziemā .	uztraukusies	5	Nom
Viņa laikam bija kaut ko pazaudējusi - varbūt debess puses ?	pazaudējusi	5	Nom
Paša gatavotas dāvanas pasniegšana ir daudz sirsnīgāka par steigā iegādātu lietu .	iegādātu	9	Acc
Izvērtējot nozaru organizāciju ieteiktos kandidātus , kā labākos finanšu jomas speciālistus darbam " Lattelecom " padomē nomināciju komiteja atzina Jāni Brazovski un Džastinu Bankroftu .	ieteiktos	3	Acc
Apkopojot iepriekš rakstīto , var norādīt , ka funkcionālisms ir iezīmējis nozīmīgu pētījumu lauku , liekot pamatus izglītības socioloģiskai analīzei .	rakstīto	2	Acc
Polineiks ved pret dzimto pilsētu svešzemnieku karapulkus .	dzimto	3	Acc
Kopumā viņas darbības ir atbalstāmas .	atbalstāmas	4	Nom
Bērni un to vecāki noklusē notikušo , jo saprot , ka nespēs cīnīties pret kādu no Holivudas spīdekļiem .	notikušo	5	Acc
Vispārējais dzīves-pēc-septiņdesmit princips ir tāds : tā kā šajā vecumā cilvēka ķermenis prasa pārāk daudz aprūpes un ir objektīvi nolietojies , tas stipri palielina sociālās izmaksas , un tādēļ izdevīgāk ir nomainīt ķermeni uz jaunāku .	nolietojies	19	Nom
47. Aizliegts pārvietot kāpnes , ja uz tām atrodas nodarbinātais .	nodarbinātais	9	Nom
Ja neizmaksāto pabalsta summu pieprasa vairākas personas , to izmaksā vienādās daļās visām pieprasījumu iesniegušajām personām , kurām uz to ir tiesības .	neizmaksāto	1	Acc
Ziņojumā ir norādīts , ka sadarbība ar bankas “ Citadele ” akciju pārdošanas procesā iesaistītajām personām ne vienmēr bija veiksmīga .	iesaistītajām	14	Dat
Apgūstamās zināšanas veidojas no akadēmiskajām zināšanām , balstoties uz kurām tiek izstrādāta izglītības dienas kārtība , un vērtīborientētām zināšanām , kuras pamatā veidojas caur dažādu pedagoģisku instrumentu izmantojumu ( piem. , MK 2008 , 2006a ) .	Apgūstamās	0	Gen
To dara pat Norvēģijā - ievērojamu daļu grāmatu valsts iegādājas no izdevējiem bibliotēku vajadzībām .	ievērojamu	5	Acc
Kāds pasažieris pastāstīja , ka viens vagons noslīdējis no dzelzceļa uzbēruma un slīdējis lejup pa aizas malu , taču pēc desmit vai divdesmit metriem ieķēries kokos .	slīdējis	12	Nom
Pirmajiem diviem parasti tiek pievērsta liela uzmanība , trešais bieži tiek saprasts nepareizi vai pārprasts .	pārprasts	14	Nom
[ 58 ] Vēstures literatūrā Baltijas valstu rīcība nav atbalstīta .	atbalstīta	9	Nom
Dažas minūtes pirms paredzamā operācijas sākuma vīrietis pēkšņi izskrēja no ēkas ar granātu rokā .	paredzamā	3	Gen
Centrālajā parkā ar savu nesen dzimušo dēlu Dāvidu pastaigājās Tatjana .	dzimušo	5	Gen
Vienlaikus dažādu pasākumu finansēšanai 2014. gada laikā tika papildus pieprasīti un no citiem resoriem pārdalīti 67,5 miljoni eiro .	pieprasīti	9	Nom
Minētā informācija padara tiesas nolēmumu saprotamu , kā arī ļauj pārbaudīt tā pareizību .	Minētā	0	Nom
Paneļi bija pieslēgti pie foto devējiem un regulējama luminiscējoša apgaismojuma .	luminiscējoša	8	Gen
Lietotāja iespējas tiek lieliski uzlabotas , pievienojot šīm lietojumprogrammām īpašās ierīces .	uzlabotas	4	Nom
OECD apkopotā informācija apstiprina plaši izplatītus uzskatus , ka attīstības ekonomikas ir zaudējušas daļu no virzītājspēka , kas palīdzēja pasaulei pārciest attīstīto valstu nesen piedzīvoto izaugsmes tempa palēninājumu .	piedzīvoto	24	Acc
Lai attīrītu ādu no atmirušajām šūnām un sagatavotu to parafīna procedūrai , pirms tam rūpīgi jāveic manikīrs un roku pīlings .	atmirušajām	4	Dat
Tie bija tie 20 gadi , kad būtībā lielākā daļa nacionālo bibliotēku tika uzceltas no jauna vai ar milzīgām piebūvēm visās valstīs .	uzceltas	13	Nom
Tikmēr 33 % norādījuši , ka vidēji reizi gadā apskata , kas uzkrājies viņu zāļu skapīšos , un 16 % aptaujāto anketās bija atzīmējuši , ka to dara vismaz reizi pusgadā .	uzkrājies	12	Nom
Rēzeknes policijas pārvaldi pārstāvēja trīs dalībnieki , un visi ieguva godalgotas vietas .	godalgotas	10	Acc
Daloties iespaidos par redzēto Saeimas namā , skolēni stāstīja , ka skolā par Raini un Aspaziju latviešu valodas stundās daudz runājuši , taču abu dzejnieku saistība ar politiku viņiem esot interesants atklājums .	redzēto	3	Acc
Šīs atšķirības , kā rezignēti atzinuši vēsturnieki , lielā mērā izslēdza iespēju pārveidot Baltijas Antanti par patiesi konsolidētu bloku .	konsolidētu	17	Acc
Kamēr lasiet grāmatu , aiciniet mazuli pārvietoties pa istabu atbilstoši grāmatā attēlotajam dzīvniekam .	attēlotajam	11	Dat
Pašvaldības darbinieki sadarbībā ar finanšu stabilizācijas uzraugu un Finanšu ministrijas darbiniekiem ir paveikuši lielu darbu , lai turpmāk šādu situāciju nepieļautu un nodrošinātu iedzīvotājiem stabilu un drošu vidi , " komentējot paveikto novadā , norāda finanšu ministrs Andris Vilks .	paveikuši	12	Nom
Policija darbinieki pastiprinātu uzmanību pievērsīs arī iereibušiem gājējiem , velosipēdistiem un mopēdistiem , kuri ir vieni no neaizsargātākajiem satiksmes dalībniekiem .	iereibušiem	6	Dat
Jā , un šogad pirmo reizi jaunieši nes iegūtos diplomus .	iegūtos	8	Acc
Padarījusi darāmo , Irmgarde kāpj lejā uz virtuvi .	darāmo	1	Acc
Kurš var pateikt , vai tu to neesi izdomājusi vai dzirdējusi sapnī ?	izdomājusi	8	Nom
Sofija bija pilnīgi pārgurusi .	pārgurusi	3	Nom
Viņš bija no klejojoša cirka trupas vai - drīzāk gan - kumēdiņu rādītājs .	klejojoša	3	Gen
Visas kalna nogāzes bija nosētas cilvēkiem .	nosētas	4	Nom
Tā kā 1941. gada septembra sākumā vēl nebija izstrādāti konkrēti plāni , kādai būtu jābūt vāciešu sadarbībai ar vietējiem iedzīvotājiem , tad vācu Civilpārvalde atstāja darboties izveidotās Zemes pašpārvaldes struktūras .	izveidotās	26	Acc
48. Nodarbinātajiem nodrošina iespēju jebkurā brīdī pieturēties un atbalstīties , īpaši , ja augšup pa kāpnēm ar rokām tiek pārvietoti smagumi .	Nodarbinātajiem	1	Dat
Pasākuma organizatori aicina apmeklētājus līdzi paņemt krāsainus dzīparus šūpoļu izrotāšanai , kā arī kādu skaistu , pašu krāsotu olu Lieldienu atrakcijām .	krāsotu	17	Acc
Tomēr tieši par Ministru kabineta 2014. gada 29. jūlija sēdes gaitu un audioieraksta tehniskajām kļūmēm skaidras pārliecības nav arī pēc prokuratūras veiktās pārbaudes .	veiktās	21	Gen
Vajadzēja atrast piemērotāko vietu .	piemērotāko	2	Acc
Starp HBc-wt un mutantajiem gēniem netika atklātas atšķirības to detektējamās RNS līmenī .	detektējamās	9	Gen
Funkcionālisma perspektīva ir izstrādājusi arī izglītību raksturojošu jēdzienu kopumu , ko ir iespējams lietot , lai precīzāk identificētu analizējamos izglītības procesus .	raksturojošu	6	Acc
Par divām citām pirms tam nolaupītajām lidmašīnām viņu centrā ziņas vēl nebija pienākušas .	nolaupītajām	5	Dat
Otrs nakšņošanas variants ir " Ekstrēmā nakts " , kuras ietvaros cietumā iespējams pārlaist nakti grupās , iejusties aizturētā tēlā un izbaudīt dažādas ar cietuma dzīvi saistītas aktivitātes .	saistītas	26	Nom
Īrijā pastāv cits Trūkstošo profesiju saraksta veids , publicējot to profesiju sarakstu , kurās var pretendēt uz zaļajām kartēm ar vidēju atalgojuma līmeni , bet pārējās profesijas nevar pretendēt uz vidējo atalgojuma līmeni .	Trūkstošo	3	Gen
Pabriks atgādināja , ka šī tēma jau agrāk cilāta un daudzi uz to skeptiski raudzījušies , bet šobrīd situācija strauji mainās .	raudzījušies	14	Nom
Daudzus gadus strādājot tūrisma jomā , izvērtējot pašu mājās un ārzemēs gūto pieredzi , Ludzas tūrisma informācijas centra vadītāja secina , ka Ludzas lielā vērtība ir vecpilsēta .	gūto	11	Acc
Ne tik sen Sofijai bija nomirusi vecmāmiņa .	nomirusi	5	Nom
Ziedonis saņēmis starptautiskas atzinības Hansa Kristiana Andresena vārdā nosaukto pasaku meistara diplomu , internacionālo Januša Korčaka medaļu un Goda diplomu par aktīvu darbību bērnu kultūras attīstībā .	nosaukto	8	Acc
Es nevarēju domāt citādi , kad apkārt ir tik daudz mirušu , sakropļotu , pārogļotu ķermeņu , kad krīt bumbas , īpaši neizvēloties mērķi , un gaiss ir biezs no putekļiem , sodrējiem , asins dvakas un kliedzieniem .	mirušu	10	Gen
Apdomājam , vai vēlamies dot bērniem nebioloģiski audzētus pilngraudu produktus , jo tieši grauda apvalkā uzkrājas tās vielas , ar kurām labība tiek apstrādāta augšanas laikā .	audzētus	7	Acc
Nordic Walking jeb nūjošana ir sportiska pastaiga ar speciāli veidotām atbalsta nūjām .	veidotām	9	Dat
Tā kā " Germanwings " lidmašīna , šķiet , ietriekusies zemē nebojāta , nedaudz paslīdot uz priekšu , maz ticams , ka tā cietusi bumbas sprādzienā .	nebojāta	11	Nom
Labāk _ te , pie cilvēkiem , kaut arī ziemā vienai starp apsnigušām eglēm .	apsnigušām	12	Dat
Saule izstaro arī tā saukto Saules vēju , kurš izplatās pat līdz izkliedētā diska vidum , veidojot heliosfēru .	izkliedētā	12	Gen
Vispārējās izglītības sistēmas pedagoģisko darbinieku skaitu ietekmējošo faktoru kopums	ietekmējošo	6	Gen
Lai tiktu pie fotouzņēmuma retro stilā , būs jādodas uz foto salonu " Pie Bartiljona " , kas iekārtots Lielās ģildes otrajā stāvā .	iekārtots	18	Nom
Etniskās mobilizācijas pieeja šķir etniskās mobilizācijas cēloņus un katalizējošos faktorus ( root causes and triggers ) .	katalizējošos	8	Acc
Ieva lūkojās , kā tas lēnām rāpjas lejā no augstumiem — lien gar pelēki ribaino ārējo sienu kā trombs pa uzblīdušu asinsvadu , kā dzeltena acs , kas , iztraucēta apcerē , viņiem nesteidzīgi pievēršas .	uzblīdušu	20	Acc
Es nezinu , kāpēc _ , bet , miegā laizdamies , nospriedu , ka viņa vairs nezvanīs .	laizdamies	9	Nom
spožajā gaismā aizsoļo mirušu bērnu armija ,	mirušu	3	Gen
Lielbritānijas dzelzceļa operators paziņoja , ka sniegs un ledus visvairāk var ietekmēt līnijas Kentā un Saseksā , jo tur vilcieniem elektrība tiek piegādāta pa sliedēm , nevis vadiem .	piegādāta	22	Nom
" Tā ir mana artava , tas ir tas , ko es varu dot , nesen rēķināju , ka esmu ziedojis 47 litrus asiņu , " saka R. Daudze , kurš joprojām ziedo asinis piecas reizes gadā .	ziedojis	20	Nom
Satiksmes ministrijā , darbojoties ministra padomnieka amatā , esmu nodrošinājis juridiski korektu padomu sniegšanu ministram , kas ir vainagojies ar apstākli , ka ministrs atzinīgi ir novērtējis manu darbību un lūdzis turpināt darbu komandā arī pēc demisijas raksta iesniegšanas .	nodrošinājis	9	Nom
Elmārs pastāstīja , ka patiešām zēnam neesot paveicies , roka esot diezgan nopietni traumēta ( lauzta gan neesot , tik daudz viņi saprotot ) , sadauzīts arī plecs un mugura .	lauzta	15	Nom
Tur viņš redzējis , ka vīnadārzi tiek apūdeņoti ar liela , upē novietota riteņa palīdzību .	novietota	12	Gen
Pērn piedzīvojām gadījumu , kad nepiegādātā piena dēļ gandrīz nevarējām izpildīt savas līguma saistības ar citas valsts partneri .	nepiegādātā	5	Gen
Marķīze de Sada tika izrādīta JRT Kamerzālē .	izrādīta	4	Nom
Šī ir diena , kad dzīvie vienosies ar mirušajiem , kad atvērsies Ēģiptes nozīmīgākais templis un pa vārtiem laukā plūdīs krāšņs gājiens .	mirušajiem	8	Dat
Lai arī iedzīvotāji uzskata , ka būtu vairāk jāattīsta atjaunojamās enerģijas izmantošana , tai pašā laikā arī valda uzskats , ka jauna cietā kurināmā stacija palīdzētu dažādot izmantojamās enerģijas veidus un radīt jaunas darba vietas pilsētā .	atjaunojamās	9	Gen
Bet Kairiša izrādē viņa sasniedz jaunu , gluži neticamu spēles pakāpi .	neticamu	8	Acc
Piemēram : jāatsakās no daudzu nodarījumu atzīšanas par noziedzīgiem ; nepieciešams kardināli mainīt iesīkstējušu stereotipu par sodu , jo bargi sodi kriminalizē sabiedrību .	iesīkstējušu	13	Acc
Pēc darba skolā viss atlikušais laiks tiek veltīts pašas bērniem .	atlikušais	4	Nom
Pats par sevi saprotams – kad apsveram iespēju iegādāties kādu produktu vai pakalpojumu , mēs skatāmies , vai to iegādājas citi un kas tiek izvēlēta kā alternatīva .	izvēlēta	24	Nom
Tas ir secināts 2009. gada Pasaules Tirdzniecības organizācijas un Starptautiskās Nodarbinātības organizācijas kopīgajā ziņojumā .	secināts	2	Nom
Ja kāds no taviem kaimiņiem ir divkosis , tu nekad nezini , kad tevis izpaustā informācija nāks atpakaļ kā bumerangs .	izpaustā	14	Nom
Par to , ka ar paša izvirzītajiem projektiem viņš tiks galā , Aivars Plinte un viņa kundze nešaubījās ne mirkli .	izvirzītajiem	6	Dat
Laiku pa laikam cilvēces vēsturē pienāk brīži , kad nākas uzrakstīt to , kas agrāk bijis pats par sevi saprotams arī nerakstīts .	saprotams	19	Nom
Sakarsē pusi no kausētā sviesta .	kausētā	3	Gen
Par labāko aktrisi 2011. / 2012. gada sezonā skatītāji atzinuši Rēziju Kalniņu , bet labākā aktiera gods ticis Artūram Skrastiņam .	atzinuši	9	Nom
Gaidāma arī ceļojošā izstāde .	Gaidāma	0	Nom
Saņēmēja Puse nedrīkst deklasificēt saņemto klasificēto informāciju vai mainīt tās klasifikācijas pakāpi bez iepriekšējas rakstiskas nosūtītājas Puses atļaujas .	saņemto	4	Acc
Ja Milna varoņos tiek atrastas populārākās cilvēku tipu un raksturu iezīmes , tad tādas ir sastopamas arī aktieros , un rodas jautājums , kādas lomas padodas aktierim , kas dzīvē nes sevī Pūka arhetipu ?	sastopamas	15	Nom
Viss noticis kā anekdotē par vīrieti , kurš iekāpj automašīnā , dzird tirkšķoņu un lūdz Dievu , lai tas būtu mugurkauls , tikai ne viņa jaunais « iPhone » .	noticis	1	Nom
Droši vien , ja nebūtu parādījies tu , tā kļūtu par barību ķirmjiem vai lēnām sapūtu .	parādījies	5	Nom
Augstajai amatpersonai atlika vien pastarpināti uzsvērt savas bažas par pieaugošās eiro vērtības ietekmi uz ekonomiku , lai kopējās valūtas cena strauji samazinātos .	pieaugošās	9	Gen
Ja nu tomēr bērna maltītes izejvielas tiek pirktas lielveikalā , ēdienam būtu jābūt gatavotam mājās .	pirktas	7	Nom
Tomēr iepriekš nosaukto nozīmju gadījumā vairs nevar runāt par tiešu informāciju , bet drīzāk par informāciju _ , kas tiek izprasta , izmantojot gan cilvēka zināšanas , gan pieredzi , arī subjektīvo skatījumu .	nosaukto	2	Gen
Piemēram , aizejošā Eiropas Komisija nolēma 380 miljonus no lauksaimniecības budžeta papildu ieņēmumiem pārdalīt citām vajadzībām .	aizejošā	2	Gen
Velns , kurš gan varētu zvanīt tādā stundā , es lādējos , basām kājām joņoju cauri neapgaismotajam dzīvoklim un centos tumsā saskatīt tālruņa klausules mirguļojošo zaļo spuldzīti .	neapgaismotajam	16	Dat
Vai drīzāk , mēs tiekam no tā izglītoti laukā .	izglītoti	7	Nom
Ja neizmaksāto pabalsta summu pieprasa vairākas personas , to izmaksā vienādās daļās visām pieprasījumu iesniegušajām personām , kurām uz to ir tiesības .	iesniegušajām	14	Dat
Vēlāk Vilks iepazīsies ar Ādažu novada pašvaldībā un privātuzņēmumos īstenotajiem ES fondu projektiem , īpašu vērību pievēršot pašvaldības ūdens projekta realizācijai , kuram ir piešķirts stabilizācijas aizdevums no Valsts kases .	īstenotajiem	9	Dat
Nesen veiktajā pētījumā par reģistrētās un nereģistrētās kopdzīves faktoru salīdzinošo analīzi [ LU Publiskās antropoloģijas centrs , 2015 ] respondenti lielākoties uzskatījuši , ka kopdzīve un attiecības jebkurā brīdī var pāraugt laulībā .	nereģistrētās	6	Gen
Šī izrāde ir pirmais mēģinājums Latvijas teātrī paskatīties uz populāro Milna darbu par lācīti Pūku kā uz katra to lasījušā cilvēka pieredzes nospiedumu .	lasījušā	19	Gen
Bieži kāju nagi sāk dalīties , šo defektu var izlabot uz nakti sasmērējot plānā kārtiņā nagus ar jodu un regulāri uzklājot uz nagiem caurspīdīgo stiprinošo nagu laku , kura aizsargās naga emalju .	stiprinošo	24	Acc
Pirms trim gadiem , tieši Saeimas ārpolitikas debatēs 2011. gada janvārī , Nacionālās apvienības vārdā deputāts Jānis Dombrava klāstīja par Krievijas realizētās “ maigās varas ” iespējamām bīstamajām sekām , atsaucoties arī uz ārvalstu analītiķu vērtējumiem .	realizētās	21	Gen
Liepājā grūti gāja , jo tur nebija atbilstošas kompānijas , atbilstošu cilvēku , ar kuriem kopā rakt .	atbilstošas	7	Gen
Pāris paziņoja , ka pēc ilgām pārdomām , ieklausoties savās sirdīs un analizējot domas , viņi izlēmuši izbeigt savas attiecības .	izlēmuši	16	Nom
Personas , kas reģistrētas Iedzīvotāju reģistrā un Uzņēmumu reģistrā , e-adreses kontu lietos , izmantojot portāla www.latvija.lv grafisko saskarni vai ar e-adreses risinājumu integrētu dokumentu vadības sistēmu .	integrētu	23	Acc
Kad viņa tā stāvēja ārā uz grantēta celiņa ar noslēpumaino vēstuli rokā , viņu pēkšņi pārņēma brīnumaina nojausma .	grantēta	6	Gen
Lai arī iedzīvotāji uzskata , ka būtu vairāk jāattīsta atjaunojamās enerģijas izmantošana , tai pašā laikā arī valda uzskats , ka jauna cietā kurināmā stacija palīdzētu dažādot izmantojamās enerģijas veidus un radīt jaunas darba vietas pilsētā .	izmantojamās	27	Gen
Daudzi iedzīvotāji bez brīva darbaspēka kustības iespējām būtu bezdarbnieki vai zemu atalgoti darbinieki Latvijā , savukārt tagad viņi pelna naudu un apgūst noderīgas iemaņas .	atalgoti	11	Nom
Parēķinot mums nebija četru spēlētāju , kuri būtu varējuši iet laukumā , " izteicās Straume .	varējuši	8	Nom
Pēc Gaismas pils apmeklējuma Itālijas vēstnieks Latvijā pauda gandarījumu par redzēto un raksturoja topošo bibliotēku kā civilizācijas pieminekli , salīdzinot to ar Ēģiptes piramīdām .	topošo	13	Acc
Pāri palikušo ēdienu var izmantot arī nākamās dienas brokastīm vai pusdienām .	palikušo	1	Acc
Tas , ka G. Zariņa ir izcila traģēdijas aktrise , protams , bija zināms jau kopš Vladislava Nastavševa Maskavas Gogoļa centrā iestudētās Mēdejas .	iestudētās	21	Gen
Saprotu , ka šis jautājums jau ir " apzelēts " , tomēr arvien mums jautā - kādēļ laikmetā , kad grāmatas lasīsim digitalizēti , mums bija jābūvē tik liela un dārga bibliotēka ?	apzelēts	8	Nom
Sajutos pārliecināta par savu angļu valodu un uzreiz gribējās ar kādu sarunāties .	pārliecināta	1	Nom
Caur kluso , pielijušo dārzu tās aicina pirtī .	pielijušo	3	Acc
Tieši tikpat nejauku krāsu ar laiku iegūst arī dzeramā ūdens filtrkrūze .	dzeramā	8	Gen
« Bauskas bijušā rajona teritorijā mazinājusies kukaiņu aktivitāte , savukārt citos reģionos vēl tiek konstatēti kukaiņu kodumi cilvēkiem , » apliecina L. Geriņa .	bijušā	2	Gen
Tikai šoreiz to lāgiem aizsedz samilzušu mākoņu ēnas .	samilzušu	5	Gen
Gadu gaitā nolietotajai Rīgas notekūdeņu kanalizācijas sistēmai nebija pa spēkam savākt lietusūdeni , kas pagājušās nedēļās nogalē pārpludināja pilsētas ielas pēc stipras lietusgāzes .	nolietotajai	2	Dat
Tālāk viņa nedomāja , bet vārds Ķurbe viņai turpmāk vienmēr saistījās ar nolādētu pamestību , kas velk un vilina kā dīķī trūdoši indīgi ziedi .	nolādētu	12	Acc
Abās pusēs vēl bija samanāmi izraktās zemes valnīši .	izraktās	5	Acc
Bet katra sieviete vēlētos ne tikai sakoptus , skaistus nagus , bet ari satriecoši garus nagus .	sakoptus	6	Acc
Kāda ciema iedzīvotāja , redzot mūsu interesi par uzraktiem , tūdaļ ir klāt ar savu milzīgo lācim līdzīgo suni un jautā , vai mēs esam tie , kuriem var pasūdzēties par dažiem noplēstiem uzrakstiem .	noplēstiem	32	Dat
Sapnī es turēju bērnu , piespiestu sev pie krūtīm .	piespiestu	5	Acc
Grāmatas prezentācijā piedalījās vien autors – pats grāmatas varonis nebija ieradies , jo , izrādās , abi sakašķējušies jau radošā darba sākumposmā .	sakašķējušies	17	Nom
– Tēti , Rainim ūdenī muša ir , – – Jurģis norūpējies teica , un es cēlos , izlēju veco pieputējušo ūdeni , kurā tiešām peldēja nosprāgusi muša , un ielēju jaunu .	nosprāgusi	26	Nom
Paneļi bija pieslēgti pie foto devējiem un regulējama luminiscējoša apgaismojuma .	regulējama	7	Gen
Apdāvināts kā jubilārs .	Apdāvināts	0	Nom
Uz picas kārto dārzeņus , šķiņķi , sieru un uz pusēm pārgrieztas olīvas .	pārgrieztas	11	Acc
Tiek pieņemts , ka abiem iesaistītajiem stājoties , parasti , vismaz daļēji reglamentētā mijiedarbē veidosies akceptētais rezultāts – skolēns iegūs tās zināšanas , kuras izglītības procesā tam būtu jāapgūst .	iesaistītajiem	5	Dat
Jauna krimināllikuma izstrādāšanas vai esošā grozīšanu iniciatori var būt ļoti dažādi , piemēram : valdības deklarācijas , koncepcijas , tiesībsargājošo un citu institūciju prakses apkopojumi , politisko partiju un atsevišķu politiķu ierosinājumi , zinātniskajās publikācijās izteiktie priekšlikumi utt .	esošā	4	Gen
Normatīvais regulējums paredzot pašvaldības tiesības izvērtēt sniegtos priekšlikumus , vienlaikus darot sabiedrībai zināmu pieņemtā lēmuma pamatojumu .	sniegtos	6	Acc
Pēc pieprasījuma Nacionālās drošības iestāde sniedz informāciju , vai attiecīgajam līgumslēdzējam ir izsniegta atbilstoša speciālā atļauja vai industriālās drošības sertifikāts , kas atbilst klasificētajai informācijai , kuru plānots saņemt , glabāt un apstrādāt .	klasificētajai	23	Dat
Paša gatavotas dāvanas pasniegšana ir daudz sirsnīgāka par steigā iegādātu lietu .	gatavotas	1	Nom
Prokuratūra tuvākajā laikā izlems , vai apsūdzības uzrādīt pārējām lietā iesaistītajām personām .	iesaistītajām	10	Dat
Vakar , 12. augustā , kopā ar Viļakas novada būvvaldes vadītāju Gati Rundzānu tika pārbaudīts arī citu bibliotēkas telpu griestu stāvoklis un bibliotēkas lasītavā , kas ir otrajā stāvā virs internetlasītavas , dažās vietās griesti tika nostiprināti .	nostiprināti	36	Nom
Dalībvalstis informē Komisiju un pārējās dalībvalstis par tiem valstī noteiktajiem maksātnespējas procedūru veidiem , uz kuriem attiecas šīs direktīvas piemērošanas joma , un par visām ar to saistītajām izmaiņām .	saistītajām	27	Dat
Atliek tikai krāsu komponentu pēdējo bitu vietā ievietot slēpjamo informāciju .	slēpjamo	8	Acc
Tikai tās seksualitāte ir dīvaina , tiešos vārdos nekur nenosaukta , toties ar katru lappusi starp rindām aizvien vairāk sajūtama .	nenosaukta	9	Nom
Lai būtu kā būdams – es smaidīju .	būdams	3	Nom
Ja masēju nepareizi , vai varu savainot cietušo ?	cietušo	7	Acc
Skeptiķi ( to vidū diemžēl ir arī Džonatans ) mēdz aizrādīt , ka daudz vienkāršāk ir savu sakāmo pateikt vārdos ...	sakāmo	17	Acc
Transficēto BHK šūnu kopējās RNS preparātos Northern blotā redzama abu tipu SFV RNS klātbūtne ( 4. attēls ) .	Transficēto	0	Gen
Četrdesmit četrus iestudējumus A. Hermanis veidojis Latvijā – vienu _ Latvijas Nacionālajā operā , pārējos _ Jaunajā Rīgas teātrī .	veidojis	5	Nom
Līdz ar to , izmantojot redzes asuma mērījumus krāsainiem stimuliem , nevar iegūt viennozīmīgu atbildi par gaismas izkliedes spektrālo atkarību miglā un citos paaugstinātas gaismas izkliedes apstākļos .	paaugstinātas	23	Gen
Dažādu faktoru ietekmi uz skolotāju skaitu apliecina arī visai ievērojamās atšķirības skolēnu skaitā vienam pedagoģiskajam darbiniekam , kas ir vērojamas Latvijā dažādos reģionos ( sk. 1. att. ) .	ievērojamās	9	Nom
... manas dzīves redzamajai daļai ar manu patieso iekšējo dzīvi jau sen nav nekāda sakara , to es vienmēr esmu gribējusi un mācējusi paturēt sev .	redzamajai	3	Dat
Uzbeki uzcēla divos gados , kas ir kaut kas neaptverams .	neaptverams	9	Nom
Tomēr spirgtais , dzestrais gaiss , gaišo skatlogu spožums un balto sniegpārslu deja blīvā straumē slīdošo automobiļu uguņu un ielas spuldžu gaismas kūļos man tādos vakaros vienmēr rada smeldzīgu laimes un prieka priekšnojautu .	slīdošo	15	Gen
Pie nagu modelēšanas ar formas palīdzību netiek izmantota līme un tāpēc mākslīgie nagi nav tik jūtīgi pret ūdeni .	izmantota	7	Nom
Jelgavas , Saikavas , Biržu , Vircavas , Ventspils , Kandavas stiklinieku ikdienas darījumi un darbnīcu inventāra izvērsti apraksti atrodami LWA 554. fonda 3. apraksta lietās .	izvērsti	17	Nom
3. Pašreizējais no valsts budžeta finansētais studiju vietu skaits ilgtermiņa nenodrošina pedagoģisko darbinieku sastāva atjaunināšanu vispārējās izglītības sistēmai .	finansētais	5	Nom
Un to nav bijis mazums , jo ik gadu še tiek kaut kas remontēts un pārveidots .	pārveidots	15	Nom
Pirms seansa lielu atzinību guva režisores Unas Celmas pašrocīgi gatavotā rīsu kremputra ar ķīseli .	gatavotā	9	Nom
Svētdienās pagasta vai apriņķa ietvaros nodarbinātajiem jauniešiem tika rīkotas kopējas izglītojošas sanāksmes .	izglītojošas	10	Nom
Daudzās valstīs , tāpat kā Latvijā , ģimene un laulība kā atbalstāmas vērtības ir izceltas arī konstitūcijā – gan tās ievaddaļā , gan arī konkrētos konstitūcijas noteikumos .	izceltas	14	Nom
85. Ņemot vērā riska novērtējuma rezultātus , veicamā darba ilgumu un ergonomiskos ierobežojumus , darba vietu augstumā nodrošina ar sēdekli , kurš aprīkots ar atbilstošām palīgierīcēm .	veicamā	7	Gen
Zinātne jau daudzas senas mīklas ir atrisinājusi .	atrisinājusi	6	Nom
Ja nu tomēr bērna maltītes izejvielas tiek pirktas lielveikalā , ēdienam būtu jābūt gatavotam mājās .	gatavotam	13	Dat
Es mostos Brīvības ielas šaurajā istabiņā uz izvelkamā krēsla .	izvelkamā	7	Gen
Līdz pat pēdējai ainai iestudējumā nekas neliecina , ka skatītājs nesagaidīs žanrā paredzētās „ laimīgās beigas ” .	paredzētās	12	Acc
Latvijas līdzdalība ES ir mainījusi un ietekmējusi valsts ekonomisko , sociālo un iekšpolitisko attīstību .	mainījusi	4	Nom
Šādā veidā Latvijā joprojām noteicošās represīvās un dārgās kriminālpolitikas nostādnes pakāpeniski un mērķtiecīgi jāaizstāj ar elastīgāku , liberālāku un sabiedrības drošībai atbilstošāku politiku .	atbilstošāku	21	Acc
Ja es ar aizturētu elpu sekoju visiem sporta raidījumiem TV , man ir jāsamierinās ar to , ka citiem sports šķiet garlaicīgs .	aizturētu	3	Acc
• Dzimis 1957. gadā Rīgā	Dzimis	1	Nom
Veidojas kopīgi uzskati par krimināltiesiskās politikas , prioritāro kriminālās likumdošanas virzienu attīstību , taču konkrētos jautājumos tie var būtiski atšķirties , kas rezultātā ietekmē pieņemtos likumus .	pieņemtos	24	Acc
Uz aizsalušās upes ir neticams skats .	aizsalušās	1	Gen
Un atkal jāpadomā – vai mēs tik ļoti neesam iegrimuši skumjās , ka pat aizmirstam par tām darīt zināmu mūsu skumju objektam ?	iegrimuši	9	Nom
Kādā atpūtas brīdī , kad imperators sēdējis zem tējas koka un dzēris vārītu ūdeni , sacēlies vējš un imperatora krūzē iepūtis pāris tējas koka lapas .	iepūtis	20	Nom
Uz pusēm pārgrieztus citronus paspaida un izmet .	pārgrieztus	2	Acc
Komentējot jaunākos EK pieņemtos priekšlikumus , kas paredz , ka Latvijai varētu būt jāuzņem 737 bēgļi , Pētersone-Godmane sacīja , ka , atšķirībā no iepriekšējā piedāvājuma , " šis jau ir pietiekami skaidrs un modificēts " .	pieņemtos	3	Acc
Pārlej ābolus ar sagatavoto mīklu .	sagatavoto	3	Acc
2. Dalībvalstis dara Komisijai zināmus tiesību aktus , ko tās pieņēmušas jomā , uz kuru attiecas šī direktīva .	pieņēmušas	10	Nom
Izglītības un zinātnes ministrijā atzīst , ka līdz šim pietrūcis konkrēta tiesiskā regulējuma , kas noteiktu , kā dalāma skolotāju algām domātā nauda .	pietrūcis	9	Nom
11. Apvienoto Nāciju Organizācijas ģenerālsekretārs nodrošina personālu un aprīkojumu , kas nepieciešams , lai Komiteja varētu efektīvi veikt uzdevumus , kas tai uzticēti saskaņā ar šo konvenciju .	Apvienoto	1	Acc
Lai kā mums gribētos ar viņiem slēgt mūsu sagatavotus līgumus , viņi strādā ar saviem līgumiem , un tajos piegāžu neizpildes gadījumā ir jāsedz , piemēram , pat negūtā peļņa .	sagatavotus	8	Acc
Vienā no tiem , saliecies kā embrijs mātes miesās , tiek radīts Daiņa Grūbes atveidotais mākslīgais cilvēks , kurš paliek bez vārda un kuru dēvēs par Radību .	atveidotais	14	Nom
Sofijai vienmēr bija šķitis , ka šis dārzs ir kā vesela pasaule .	šķitis	3	Nom
Ja mēs esam ar sevi apmierināti cilvēki , tad otra aizrādījums mūs nesāpinās , bet gan , ja tas ir pamatots , ļaus padomāt , ko mainīt .	pamatots	20	Nom
Nepārdomāti priekšlikumi par grozījumiem Krimināllikumā Saeimā tiek iesniegti arī pēdējā laikā , piemēram , par jau minētā Krimināllikuma 262. pantā paredzētā nodarījuma izdarīšanu noteikt sankciju - brīvības atņemšanu uz vienu gadu .	minētā	16	Gen
Noslēdzot ES līdzfinansētu projektu , " Latvijas Maiznieka " ražotne ir paplašināta ar jaunām un mūsdienīgām noliktavām vairāk nekā 1000 m2 platībā , kā arī ar automātiskām izejvielu dozēšanas , svēršanas un transportēšanas iekārtām .	līdzfinansētu	2	Acc
Iemesls – sakāpt mazajā kabrioletā visi nespējam , bet mazajā Denijā , kurā ir vismaz trīs autonomas , nav nevienas iznomājamas mašīnas .	iznomājamas	20	Gen
Tā bija vienīgā parlamentārā institūcija , kas cēla trauksmi jau ilgi pirms šo sabiedrībai acīm redzamo seku parādīšanās ; tur tika uzklausīts Valsts ieņēmumu dienesta Muitas kriminālpārvaldes direktors Vaškeviča kungs un iztaujāts par situāciju nelegālā alkohola aprites jomā .	redzamo	15	Gen
Četras 9. Saeimas frakcijas ir vienojušās par kopīgu labēju valdību manā vadībā , un es aicinu visus deputātus , kas tiešām rūpējas par Valdības deklarācijā pausto mērķu sasniegšanu , atbalstīt to .	pausto	25	Gen
Ja es esmu aizrāvies ar zirgiem vai dārgakmeņiem , es nevaru cerēt , ka visus pārējos aizraus tieši tas pats .	aizrāvies	3	Nom
Tādēļ šādu risinājumu nevaru atbalstīt un balsoju par piedāvāto likumprojektu atturoties .	piedāvāto	8	Acc
Bailes no tā , ka sabiedrības locekļi varētu sekot vilinošajam piemēram , liek viltot statistiku , noklusēt patieso pašnāvību skaitu , iemeslus un apstākļus , tas mazina suicīda tēmas aktualizēšanās iespēju mākslā un literatūrā .	vilinošajam	9	Dat
Bet piekrītat , ka viss sievietes skaistums ar koptām rokām , skaistu frizūru un make-up nobālēs , ja viņa uzliks krāšņas baskājiņas un āda uz papēžiem būs nolupusi un kāju nagi būs nevīžīgi nogriezti .	koptām	8	Dat
Šādu uzaicinājumu pārrunāju arī ar satiksmes ministru Aivi Roni un , ņemot vērā , ka plānoto projektu realizācija ir nozīmīga Satiksmes ministrijai , saņēmu atbalstu darbībai LDz viceprezidenta amatā , lai pārstāvētu uzņēmumā arī Satiksmes ministrijas intereses .	plānoto	15	Gen
Ja pret valsts valodu mēs paši būtu izturējušies ar pienācīgu cieņu , krievi sen to būtu apguvuši un Godmanim nevajadzētu teikt šādus latviešu pašcieņu pazemojošus vārdus .	izturējušies	7	Nom
Deputāts pauda bažas , ka citādi situācija ieslodzījuma vietās varētu līdzināties pagājušā gadsimta deviņdesmito gadu vidū pieredzētajam , kad cietumu ārējā apsardze tika nodrošināta , bet situācija to iekšienē netika kontrolēta .	pieredzētajam	16	Dat
Tieši to mēs izjutām , ilgi pirms bijām iemācījušies to izprast .	iemācījušies	8	Nom
Jebkurš grozījums , ko pieņēmis šajā konferencē klātesošo un balsošanā piedalījušos dalībvalstu vairākums , tiek iesniegts Ģenerālajai asamblejai apstiprināšanai .	piedalījušos	10	Acc
Velns , kurš gan varētu zvanīt tādā stundā , es lādējos , basām kājām joņoju cauri neapgaismotajam dzīvoklim un centos tumsā saskatīt tālruņa klausules mirguļojošo zaļo spuldzīti .	mirguļojošo	24	Acc
Ja attiecīgajam līgumslēdzējam nav atbilstošas speciālās atļaujas vai industriālās drošības sertifikāta , Nacionālā drošības iestāde , kas piešķirs klasificēto līgumu , var lūgt , lai šim līgumslēdzējam tiek veikta atbilstoša drošības pārbaude .	atbilstošas	4	Gen
Lai labāk ilustrētu iegūto skaitļu nozīmi , tie ir jāpaskaidro reālos un ar pētāmo jautājumu saistītos lielumos .	pētāmo	13	Acc
Mēdejā G. Zariņa nospēlēja Likteni – to , ka iepriekš nolemtajam nav iespējams pretoties .	nolemtajam	10	Dat
Tā kā " Germanwings " lidmašīna , šķiet , ietriekusies zemē nebojāta , nedaudz paslīdot uz priekšu , maz ticams , ka tā cietusi bumbas sprādzienā .	ietriekusies	9	Nom
Nes diplomātus , smalkādas portfeļus , sportiskas pleca somas , veikalu polietilēna maisiņus , puķes ; otrās maiņas skolnieciņi stiepj smagas mugursomas , mammas velk līdzi mazus , niķīgus , dienas nogurdinātus bērneļus .	nogurdinātus	31	Acc
Man patiešām nebija bail par to , ka man nebūs darba , ka man nebūs naudas , ka man būs jābrauc atpakaļ nolaistām acīm ...	nolaistām	22	Dat
„ Sabiedrība , kas nav attīrījusies , nav spējīga būvēt no totalitārisma mantojuma patiesi brīvu , plaukstošu valsti , jo to nomāc pagātnes rēgi un neizgaismotās padomju sistēmas ēnas , ” tā ir izteikusies dzejniece Liāna Langa .	plaukstošu	16	Acc
Bet manā uztverē apkalpojošā sfērā strādājošajiem ir jāpalīdz cilvēkiem !	strādājošajiem	5	Dat
Sakaltētas rupjas rudzu maizes salaiek traukā , pieliek sauju piparmētru , pārlej ar verdošu ūdeni , pasedz un 24 stundas ļauj ievilkties .	Sakaltētas	0	Acc
Protams , var izveidot programmas , ar kuru palīdzību šo slēpto informāciju , ja tāda ir , var ieraudzīt un tādējādi konstatēt slepenās informācijas pārsūtīšanas faktu .	slēpto	10	Acc
Kad dalībvalstis pieņem minētos noteikumus , tajos ietver atsauci uz šo direktīvu , vai arī šādu atsauci pievieno to oficiālai publikācijai .	minētos	3	Acc
Ieaugušos nagus nevajag censties izgriezt pašām , tā var ienest infekciju , jo manikīra komplekta piederumi noteikti nav sterili .	Ieaugušos	0	Acc
Plašāk pievēršoties pirmajam darbības virzienam , jāuzsver , ka krimināltiesību politika tiek nostiprināta un izpaužas likumdevēja regulētās krimināllikuma normās , tādējādi politiskā griba gūst savu objektīvo izpausmi un tiek noteiktas stingras likumības un tiesiskās kārtības robežas .	noteiktas	29	Nom
Korupcijas novēršanas un apkarošanas biroja ( KNAB ) vēsturē apjomīgāko krimināllietu prokuratūra saņēma pērn septembrī un šajā pašā mēnesī apsūdzības uzrādīja divām no 17 lietā iesaistītajām personām .	iesaistītajām	25	Dat
Kas notiks , ja uz vienas un tās pašas skatuves „ apvienot ” satriecošo skaistuli un izsmalcināto estētu Viktoru Loginovu un pašu „ smieklīgāko ” aktrisi Oļesju Žeļezņaka ?	satriecošo	13	Acc
Premjerministra Hosē Luisa Rodrigesa Sapatero valdība gan mierina , ka valstī elektrības un degvielas krīze nedraud un ka tiks sagatavots piekšlikumu komplekts autopārvadātāju nomierināšanai , raksta BBC .	sagatavots	19	Nom
Biedrība darbojas kopš 1994. gada , un biedrības galvenais uzdevums ir gan morāla , gan psiholoģiska , gan materiāla atbalsta sniegšana ģimenēm , kas uzņēmušās bez vecāku gādības palikušo bērnu audzināšanu .	palikušo	28	Gen
Neviens neizteica vēlēšanos ielūkoties sagrabējušā mersedesa bagāžniekā .	sagrabējušā	4	Gen
Saistībā ar " Latvenergo " rīkoto Rīgas otrās termoelektrocentrāles otrās kārtas rekonstrukcijas iepirkuma konkursu amatpersonas par konkrēta uzņēmuma uzvaru pieņēma kukuļa piedāvājumu - 5_432_989 latus .	rīkoto	5	Acc
Sauriešos pagājušās nedēļas nogalē divi vīrieši dzērumā nosituši savu biedru , aģentūra LETA noskaidroja Valsts policijā .	pagājušās	1	Gen
Žēl , Sofija tik ļoti bija cerējusi uz jaunu vēstuli no nezināmā rakstītāja .	nezināmā	11	Gen
Te gan jāmin , ka esmu relatīvi daudz pārvietojies ar auto pa rietumvalstu ceļiem - nu nesoda tur par šādiem nebūtiskiem pārkāpumiem , izņemot īpašas situācijas !	pārvietojies	8	Nom
Bet reiz es ieraudzīju it kā pazīstamas sejas , pazīstamus veidolus .	pazīstamus	9	Acc
Lielākā daļa pieaugušo uztver pasauli kā kaut ko diezgan parastu .	pieaugušo	2	Gen
Paneļi bija pieslēgti pie foto devējiem un regulējama luminiscējoša apgaismojuma .	pieslēgti	2	Nom
Vakar Rīgā tika atklāta ražotne , kurā parastam stiklam palielina redzamās gaismas caurlaidību , vienlaikus padarot to par ultravioletā un infrasarkanā starojuma filtru .	redzamās	10	Gen
Latviešu dainas abos neatkarības posmos aktualizētas arī Latvijas valsts vīru uzrunās gan citētas kā ilustrācija , akcentējot kādu domu , gan piesauktas kā latviskās dvēseles izzināšanas avotiem .	citētas	12	Nom
Pēc tam noskrāpē sacietējušo vasku no bojātās virsmas .	bojātās	6	Gen
Limbažu novada pašvaldības ēkas 1. stāvā šobrīd skatāma izstāde par Soču Olimpiskajām spēlēm Vareni spēki no Latvijas .	skatāma	7	Nom
Un apmetās lauka vidū , pelēkā namiņā no locītā šīfera plāksnēm .	locītā	8	Gen
Viņa kļuva aizņemtāka un veltīja darbam daudz vairāk laika nekā pirms tam , strādājot par projektu vadītāju Rīgā .	aizņemtāka	2	Nom
Ietvju malās kaudzēs samestais sniegs izčākstējis un pelēks , taču sīks putenītis apņēmīgi griež baltas pārslas ielas spuldžu gaismā un mēģina visu pārklāt ar baltu plānu plīvuru .	samestais	3	Nom
Rudens mēnešos novērojama ciklonu darbības aktivizēšanās .	novērojama	2	Nom
Sena ķīniešu leģenda vēsta , ka pirms pieciem tūkstošiem gadu leģendārais Ķīnas imperators Šennongs nobaudījis pasaulē pirmo tējas malku .	nobaudījis	14	Nom
Lai kā mums gribētos ar viņiem slēgt mūsu sagatavotus līgumus , viņi strādā ar saviem līgumiem , un tajos piegāžu neizpildes gadījumā ir jāsedz , piemēram , pat negūtā peļņa .	negūtā	28	Nom
Tailers pagājušogad izlaida dziesmas no gaidāmā kantrimūzikas albuma .	gaidāmā	5	Gen
Var lietot arī speciālos attīrošos skrubjus kājām , lai noņemtu atmirušās ādas daļiņas .	atmirušās	10	Acc
Jo uzskatīja , ka citrona sula izšķīdina nejauši norītu asaku .	norītu	8	Acc
Latvijā ražotos Lieldienu olu krāsojamos maisiņus pērk un lieto visa civilizētā pasaule !	ražotos	1	Acc
2. Dalībvalstis dara Komisijai zināmus tiesību aktus , ko tās pieņēmušas jomā , uz kuru attiecas šī direktīva .	zināmus	4	Acc
Kas bija kustīgs , ir sastindzis .	sastindzis	5	Nom
Tātad viņi ir piedalījušies Eiropas demilitarizācijā .	piedalījušies	3	Nom
Ģenerālsekretārs pēc tam nosūta ierosināto labojumu dalībvalstīm ar lūgumu norādīt , vai tās pieprasa sasaukt dalībvalstu konferenci , lai izskatītu šos priekšlikumus un sarīkotu par tiem balsošanu .	ierosināto	4	Gen
Viņš uzskata , ka integrētas federatīvas " Eiropas Savienotās Valstis " varētu kļūt par ietekmīgu spēku globalizētajā pasaulē , kā arī tas veicinātu Eiropas ekonomisko attīstību un ļautu labāk cīnīties pret organizēto noziedzību .	organizēto	31	Acc
Gāja darbos , kopa slimniekus un mājās šuva virsnieku sievām spīguļojošas vakarkleitas un mēteļus ar resnām polārlapsu apkaklēm , bet dzirksteles viņai nešķīlās .	spīguļojošas	10	Acc
Pati Signe apmierināti uzskaita padarīto : ir tapusi civilizēta virtuve , sanitārais mezgls , kārtīgi izremontētas telpas , nu ēkai nomainīts jumts .	padarīto	4	Acc
Arī bērnu centrs var būt izglītības iestāde , kura ir akreditēta un īsteno savu izstrādāto izglītības programmu , kuras rezultātu pārbauda valsts institūcijas .	akreditēta	10	Nom
Ja minētā nomaksas pirkuma līguma pārjaunojums netiek noslēgts , līguma izbeigšanas gadījumā iestājas sekas , kādas līgumā noteiktas gadījumam , kad pārdevējs izmanto tiesības vienpusēji atkāpties no līguma .	minētā	1	Gen
Lai labāk ilustrētu iegūto skaitļu nozīmi , tie ir jāpaskaidro reālos un ar pētāmo jautājumu saistītos lielumos .	saistītos	15	Acc
Tomēr viņš atzina , ka štābā tās neesot apspriestas , jo nevienam nebija tādu pilnvaru .	apspriestas	8	Nom
Tāpat esot jūtams , ka cilvēki ļoti gaida « Daugaviņu » , un katrs vietējo laikrakstu grib saņemt pēc iespējas ātrāk .	jūtams	2	Nom
Nu var gaidīt pievakari , kad pie izjauktā dambja izdosies ieraudzīt arī pašu cēlāju .	izjauktā	7	Gen
Ja nepieciešams , vēlreiz izsmidzini saspiesto gaisu .	saspiesto	5	Acc
Bet šķiet , ka ar abiem jēdzieniem kritiķi un pētnieki saprot nevis izrādes estētiku , bet gan šādu nosacītu nežēlību pret skatītāju , kurš ir spiests publiski klausīties atklātus tekstus par tabu tematiem .	atklātus	28	Acc
Viņa atbildēja , ka jau sen esot sadirsusies ar savām smadzenēm .	sadirsusies	7	Nom
Kārtējo reizi valdība lēmumu pieņēmusi aiz slēgtām durvīm .	slēgtām	6	Dat
Pārsvarā būvmateriāli objektā nav bijuši nodrošināti ar ekspluatācijas īpašību deklarācijām , būvizstrādājumiem nav noteiktas un novērtētas ekspluatācijas īpašības , ir konstatēti gadījumi , kad būvizstrādājumi ir iebūvēti neatbilstoši paredzētajam mērķim .	nodrošināti	5	Nom
Bazils tiek raksturots salauzītām kustībām – aktierim piekabināts mākslīgs kupris un kustības izrādes laikā raisa asociācijas ar Verlēna Albatrosu – simbolistu zīmi māksliniekam , putnu , kas ir absolūti brīvs debesīs , bet uz zemes - kroplīgs .	salauzītām	3	Dat
Es bildu , ka pats patieso skādes apjomu apzinājos tikai tad , kad labākie bloki bija iztērēti un bija palikusi kaudze ar apdauzītajiem .	iztērēti	16	Nom
Ar Ventspils mēru Aivaru Lembergu runājam burtiski dažas minūtes pēc viņa vadītās pilsētas domes budžeta komisijas sēdes , kurā tiek nolemts — Ventspilī šogad notiks Eirovīzijas nacionālā konkursa fināls !	vadītās	11	Gen
Jangs Forevers vada Atjaunošanas un Augšāmcelšanas Institūtu , kurā šobrīd atdzīvināšanai tiek sagatavots mans jaunais ķermenis .	sagatavots	12	Nom
Zemkopības ministrijas ierēdnis vai darbinieks iegūtās sistēmas lietošanas tiesības izmanto , arī gatavojot atbalsta programmas un individuālā atbalsta projekta pieteikumu citu komercdarbības nozaru atbalstīšanai .	iegūtās	5	Acc
Ja tā ir neredzama , tad pedagogs darbojas tieši ar sniedzamo zināšanu kontekstu un tikai netieši iedarbojas uz skolēnu , kas padara pašu pedagogu pedagoģiskajās praksēs neredzamu .	sniedzamo	10	Gen
Šajā kontekstā ir konstatējams , kā birokrātiska institūcija nodrošina gan savu resursu pietiekamību , gan darbības efektivitāti ar konkrētas rīcībpolitikas noteikšanu par prioritāru politikas plānošanas dokumentos , pēc kuriem vadās lēmumu pieņēmēji .	konstatējams	3	Nom
No otras puses , kurš noteiks to brīdi , kur ir taisnīgs atalgojums par talantīgi uzrakstītu , labu darbu un kur varbūt ir runa par amatniecību un ka tas ir tikai sociālais atbalsts .	uzrakstītu	15	Acc
Brīžiem šķita , ka viņš kaut ko pamanījis uz mēness dzeltenīgā apļa , jo ik pa brīdim iegaudojās , pavērsis draudīgo purnu un sarkanās , asinīm pielijušās acis pret spīdekli , kas , rītam tuvojoties , sāka jau bālēt .	pielijušās	26	Acc
„ No kurienes cēlusies pasaule ? ”	cēlusies	3	Nom
