Tarihi , içinden dersler çıkarılacak cep kılavuzu olmaktan kültür boyutuna taşımak gerekiyor .	taşımak	10	Pres
Çünkü savcılığın raporu çıkmıştı .	çıkmıştı	3	Pqp
Bu Bakanlar Kurulu'nda tartışılacak " dedi .	tartışılacak	3	Fut
Hülya'nın dairesinde ışık yanmıyordu .	yanmıyordu	3	Past
Belki de bir daha bulamayacağım orayı .	bulamayacağım	4	Fut
Ama orada bulundum .	bulundum	2	Past
Yanılıyor muyum yoksa .	Yanılıyor	0	Pres
Bila , " Sizinle ilgili izlenimlerimi yazacağım , isterseniz , bu söylediklerinizi de yazayım , ancak teypteki ifadenizi de yazmak zorundayım " karşılığını verdi .	yazacağım	6	Fut
Sevilme peşinde koşan ve sevmeyi bilemeyen iki genç , yasal ve yasal olmayan uyuşturucuların etkisiyle sevme oyunu oynayacaklar ve minik bağımlı çocuklar dünyaya getirecekler .	sevmeyi	4	Pres
Tek başımıza iktidara doğru yürüyoruz " dedi .	yürüyoruz	4	Pres
Bunlara yeşiller diyecektim .	diyecektim	2	Past
( Hızlı ve kolay kazanılmış parayı tüketmek için aşırı bir enerji harcıyor ; para sayesinde istedikleri her şeyi yapabileceklerini sanıyorlar .	sanıyorlar	19	Pres
Aslında o anda bana kendi fikrini söylemişti ama bu genel bir düşünce tarzıydı .	söylemişti	6	Pqp
Artırım otuz gün önceden bildirilecek .	bildirilecek	4	Fut
İnceldiği yerden kopsun .	İnceldiği	0	Past
Alev'in babasının amacı , annesinin parasını istediği gibi kullanmak ve sevgilisiyle gününü gün etmek .	kullanmak	8	Pres
Yüksek Seçim Kurulu'nun ( Taylor ) bu seçimi iptal etmesinin ardından dosya Adalet Bakanlığı kanalıyla Yargıtay'a yeniden iletildi .	iletildi	17	Past
Beni niye sevdiğini hiçbir zaman anlayamamıştım , ama beni niye terk ettiğini biliyordum , bütün kadınlar beni hep aynı şekilde ve aynı nedenden terk ederlerdi zaten .	ederlerdi	24	Past
Ancak o zaman tüm belgelere ulaşabilecek ve bir yön bulabileceklerdi .	ulaşabilecek	5	Fut
Kaç kez denemişti ; iki türküden sonra balıkçılar , utangaç hallerinden sıyrılıp , tarihin değil , doğanın kendilerine verdiği niteliği yeğleyerek , masalarda oturan yabancı kadınlara göz süzmeye başlıyorlardı .	sıyrılıp	11	Pres
Sevdikçe , sevdiklerinden daha çok korkan insanların , başkalarına inanılmaz , tuhaf ve yabancı gözüken davranışlarını Sevda'ya anlatmam mümkün değildi .	gözüken	14	Pres
Ummadığı inandırıcı soğukkanlılığım , açığa vurmasına yaradı , umut beklentisini ...	vurmasına	5	Pres
Annem son günlerde iyileşmeye başladı .	iyileşmeye	3	Pres
" Bankalar öyle bir izlenim yarattı ki sanki verilen hizmetler hava , su gibi ücretsiz olabilir " diyen Demiray , bundan sonra verilen hizmetlerden ücret alınacağını bildirdi .	alınacağını	25	Fut
Buyur , Ayşe abla , geç sofraya .	Buyur	0	Pres
Bir yandan da Kahve'nin günde kaç öğün yemek yiyeceğini , hangi vitaminleri alacağını , muhallebisinin şekersiz olması gerektiğini yoksa gözlerinin bozulacağını , aşılarının tarihini anlatıp duruyordu .	bozulacağını	20	Fut
Yanında oturan annesinin , ağzına zorla tıkıştırdığı lokmayı bir hamlede yuttu ; parmakları darbukanın derisini okşadı ; başını çevirip , arkası dönük oturduğu sahneye baktı .	okşadı	15	Past
Ona anlatmayıp da kime anlatacaktım ? Kimim kimsem yoktu , her şeyim oydu .	anlatacaktım	4	Fut
Ekonomik ve Sosyal Konsey'e işlerlik kazandırılsın .	kazandırılsın	5	Pres
Bir yandan da Kahve'nin günde kaç öğün yemek yiyeceğini , hangi vitaminleri alacağını , muhallebisinin şekersiz olması gerektiğini yoksa gözlerinin bozulacağını , aşılarının tarihini anlatıp duruyordu .	alacağını	12	Fut
Oturun yerinize .	Oturun	0	Pres
Hiç böyle düşünmemiştim , doğrusu bugüne kadar hiç böyle düşünmemiştim .	düşünmemiştim	2	Pqp
Paris'te kaldırım yapan kadınlar , maske takan orospuların dolaştığı Roma'nın koskocaman binalarının yukarı katlarındaki genelevler ...	takan	6	Pres
Her gün kırmızı Mersedesi bekleyeceğim , dedi Memo heyecanla .	bekleyeceğim	4	Fut
Askerler , Anayasa çiğnendi diye rejime müdahale etmişler , sonra da Anayasayı toptan kaldırarak yeniden başka bir metin yazdırmışlardı .	etmişler	7	Past
Boşalmasını sabırsızlıkla beklerim .	Boşalmasını	0	Pres
Hangi aday kazanırsa kazansın birlikte mücadeleyi sürdüreceklerini ifade eden Çelebi , ANAP'ı ayağa kaldırmak için hep birlikte çaba harcayacaklarını söyledi .	harcayacaklarını	18	Fut
FDR'nin altıyüzotuzdört sefer sayılı Konya uçağının tekerleklerinin , yaklaşma hattının soluna kaydığı , ancak kaptanın uçağı düzeltme manevrası yaparken sol ana iniş takımının tepeye çarptığı ve pist başına yakın bir noktada parçalandığı ileri sürüldü .	sürüldü	33	Past
Hiç konuşmasanız da aklınızdan geçirdiğiniz her şey duyulacak .	geçirdiğiniz	4	Past
Aldatma üstüne kurulmuş bir mekanizma .	kurulmuş	2	Past
O alanda doğruyu bulmuş olan bilim dalı daha fazla ilerleyemez ; son bilgiye ulaşmıştır , kapalıdır ; yeni bilgilere , olaylara , süreçlere yer yoktur .	ilerleyemez	9	Pres
Kanatmış mıyım ne ? Dolma gibi dudakları .	Kanatmış	0	Past
Düşen " Konya " uçağında kabin görevlisi olan Deniz Karasu'nun hostes ablası Gaye Karasu , kardeşinin öldüğüne inanamadı .	Düşen	0	Pres
Hazine'nin yaptığı çalışmaya göre Irak'a askeri operasyon durumunda Türkiye en az otuz milyar dolarlık kayıp yaşayacak .	yaşayacak	15	Fut
Diyarbakır'da bir inşaat firmasında proje müdürü olarak çalışan inşaat mühendisi Servet Karadağ , evlendikten sonra da eşini yanından hiç ayırmadı .	ayırmadı	19	Past
Şimdi adımlarını daha da hızlandırmıştı .	hızlandırmıştı	4	Pqp
entelektüel yetilerde uzunca bir süre bozulma görülmeyeceğinden bağımlı kişilerde temelde yatan kişilik bozukluğuyla da beslenmiş , parlak bir zeka ve yalancı bir filozofluk çok belirgin bir ortak özelliktir .	görülmeyeceğinden	6	Fut
Terk ettiği bir aşığıyla konuşmuştum bir akşamüstü .	konuşmuştum	4	Pqp
Yapbozun parçaları yerlerine oturuyordu .	oturuyordu	3	Past
ikibin yılı , Bilim ve Ütopya ailesine , toplumumuza ve tüm insanlığa mutluluklar ve başarılar getirsin .	getirsin	15	Pres
Kazadaki adamın sinirleri kaç kişiye bağlansa bunların hepsi , aynı Politzer gibi , kazayı başından sonuna kadar yaşayacaktır .	yaşayacaktır	17	Fut
Dayım , Eee , kes şu şarkıyı , demişti de , o da dayıma , Bu şarkı değil bi defa - , marş bu marş , akıllım , diye karşılık vermişti .	vermişti	30	Pqp
Katana başı önünde yerine yürürken Ramiz'e kaçamak bir bakış attı .	yürürken	4	Pres
Sopa yiyeceğiz , dedi Miskoye .	yiyeceğiz	1	Fut
İnşaat ortamına ve getireceği değişikliklere alışması için hazırlanan tanıtım filmi ile alıştırılacak ve bilgilendirilecek olan köylüler , çalışma ekiplerine hizmet satabilecekler .	getireceği	3	Fut
Ancak , bu amaçla yapılacak düzenlemelerde aksi ispat edilmedikçe mükellef beyanının doğru olarak kabul edileceği şeklinde ve benzeri hükümlere yer verilmemeli .	düzenlemelerde	5	Pres
Ayakta duramayacak kadar yorgun olduğumu sanıyordum , o ilk adıma kadar ...	duramayacak	1	Fut
Burjuvazinin siyasal devrimlerle iktidarı ele geçirip , hakim sınıf konumunu sağlamlaştırmasıyla birlikte , bilimi , idealizme karşı mücadelede materyalizmin temel mevzisi olmaktan çıkartacak , bilim ile dini barıştıracak yeni bir ideolojik ortam yaratma arayışları baş göstermiştir .	çıkartacak	22	Fut
Her seferinde suratını şaşırmış gibi buruşturup İyi , derdi .	buruşturup	5	Pres
Eğer sözünü ettiğiniz şey çift üretimi ( pair production ) adı verilen süreçse , bunu hiç yoktan yaratılma olarak sunmak bir aldatmacadır .	yaratılma	17	Pres
Baktı olmayacak , beni yanağımdan öptü , saçlarımı okşadı .	okşadı	8	Past
Biraz hayal kırıklığına uğramıştım aslında .	uğramıştım	3	Pqp
Oradan oraya seğirtmelerim bitecek , bitip de baş başa kalacak , baş başa kalınca da uzun uzun hayatlarımızın özetlerini çıkarıp bu hayatların görünen ucuna doğru birbirimize el verecek durumda değilim .	görünen	22	Pres
Ekonomi yetkililerinin YPK toplantısında gündeme getirmeyi planladığı toplusözleşme görüşmeleri konusunda da işçi konfederasyonlarına düşük oranlı bir zammın önerilmesi tartışılıyor .	planladığı	6	Past
Kalktım , sarıldım boynuna , zoraki öptürdü pembeliğini koruyan yanaklarını .	sarıldım	2	Past
Türkiye'de birçok alanda olduğu gibi bankacılıkta da zaman zaman haksız rekabet yaşandığına dikkat çeken Demiray , verilen hizmetlerden ücret alınmamasının bunlardan biri olduğunu söyledi .	yaşandığına	11	Past
Ne derece başarılı oldular ?	oldular	3	Past
Neyse ki üçüncü kez sorduğunda iyi bir cevap hazırlamıştım : Esinciğim evde tek kız olmasının daha iyi olduğuna karar verdik .	hazırlamıştım	8	Pqp
Oğlunuza sarıldığınızda , aklınızdan , Ya bu ona son sarılışımsa gibi aptalca bir düşünce geçiyor .	sarıldığınızda	1	Past
Geçenlerde anneannemin komşuları babamın hemen evlenebileceğini , belki de başka bir kadın yüzünden evi terk ettiğini konuşuyorlardı .	evlenebileceğini	5	Fut
Ama asıl avuçları iyi tanıyordu o cetveli .	tanıyordu	4	Past
yirmibeş cesedin kimliğinin ise DNA incelemesiyle belirleneceği bildirildi .	belirleneceği	6	Fut
Kapıya yürüdüm , açtım .	yürüdüm	1	Past
Mektubu yazdım , dedi .	yazdım	1	Past
Üç kamp kurulacak .	kurulacak	2	Fut
Pencerelerde ışık olsa gidip kapıyı çalacak mıydım , emin değildim .	çalacak	5	Fut
Tamam kapatıyorum .	kapatıyorum	1	Pres
" Bu sözleri ağlayarak dinleyen Özmen , programında çalışması için Ciguli'ye teklifte bulununca o da seve seve kabul etti .	seve	16	Pres
Öyle bir felsefe ki bu , kendi içinde bir çelişkiyi taşıyor ; varoluşla yaşamanın birbirine hiç uygun düşmeyeceğini , bu ikisi arasındaki çelişkiyi anlatıyor .	taşıyor	10	Pres
Aşağıda ayrıntılarıyla değineceğiz .	değineceğiz	2	Fut
Bütün sınıf önümüzdeki hafta harçlıklarımızı harcamayıp biriktireceğiz .	harcamayıp	5	Pres
Hadi yürü geç oldu parka gidelim .	yürü	1	Pres
İş Güvencesi Yasasındaki uygulama tarihini ileri atmak gibi bir planları olmadığını da vurgulayan Şahin , atıl istihdamda izlenecek yolda kesin karar vermediklerini de belirtti .	izlenecek	17	Fut
Karasu dışarı çıktığında şok içerisinde ve yarı baygın haldeydi .	çıktığında	2	Past
Mali Barış'tan yararlanacakların hürriyeti bağlayıcı cezalarla ilgili düzenlemeler karşısında sorumlulukları devam etmeli .	yararlanacakların	2	Fut
Aşınmış mermer merdiveni tırmandım .	Aşınmış	0	Past
Yeni gelen , masanın bir kenarındaki boş sandalyeye atmıştı kendini .	atmıştı	8	Pqp
Kendisine saygı göstermekte kusur etmiyorlardı .	etmiyorlardı	4	Past
Hablemitoğlu'nun ve yurtdışında şirket almanın da bu stratejinin bir parçası olduğunu vurgulayan Batılı , alacakları şirkette marka , üretim kapasitesi ve pazar payı kriterlerine bakacaklarını belirtti .	bakacaklarını	24	Fut
Bütün sınıf önümüzdeki hafta harçlıklarımızı harcamayıp biriktireceğiz .	biriktireceğiz	6	Fut
Damla damlatacağım .	damlatacağım	1	Fut
Yürüdüğümüz yol bitmiş , bir başka sokağa açılmıştı .	açılmıştı	7	Pqp
Cumhuriyet'in temel nitelikleri , Anayasa'nın değişmez ilkeleri ve değiştirilmesi teklif edilemez maddeleri yeni anayasada yer alacaktır " dedi .	alacaktır	15	Fut
Ceketinin kollarını hafifçe çekip ünlü cetvelini aldı .	çekip	3	Pres
Tezgahtan ve günün hayhuyundan ne kadar uzak olduğu sanılırsa sanılsın bu oda bir süre sonra tezgahı aratır oldu .	sanılırsa	8	Pres
Pencerelerde ışık olsa gidip kapıyı çalacak mıydım , emin değildim .	değildim	9	Past
İnşaat ortamına ve getireceği değişikliklere alışması için hazırlanan tanıtım filmi ile alıştırılacak ve bilgilendirilecek olan köylüler , çalışma ekiplerine hizmet satabilecekler .	alıştırılacak	11	Fut
Eğer sözünü ettiğiniz şey virtual parçacıklarsa ( aşağıdaki satırlarda Verschuur'dan yapılan alıntıya bakınız ) durum hala inandırıcı olmaktan uzak demektir .	bakınız	12	Pres
Lange Leidsewards Straat'da Kierkegaard okuyan kıza , kendisiyle yeniden görüşmekten sevinç duyacağımı söylemiş , ertesi gün öğleye doğru , onun oturduğu sokağın başındaki o güzel , iki katlı kahveye çağırmıştım onu .	duyacağımı	11	Fut
Düşünmeye çalışıyordum .	Düşünmeye	0	Pres
Cadı üvey anne üzerine yazılmış masallar .	yazılmış	4	Past
Bir romanda anlatılmaya değmeyecek kadar bildik , binlerce yıldan beri yaşanan duygulardı bunlar , ama deneyimlerim bana bir şey öğretmişti : En korkunç gerçekler , söylenmeye değmeyecek kadar basit olan bildik gerçeklerdi .	anlatılmaya	2	Pres
Görürüz bakalım , yarın o arabayı kim silecek , diye tehditler savurarak uzaklaştı diğer siliciler .	silecek	7	Fut
Oradan oraya seğirtmelerim bitecek , bitip de baş başa kalacak , baş başa kalınca da uzun uzun hayatlarımızın özetlerini çıkarıp bu hayatların görünen ucuna doğru birbirimize el verecek durumda değilim .	bitip	5	Pres
Onun arkasından öbür silici çocuklar da arabanın önüne atladılar ve birbirleriyle itişip kakışmaya başladılar .	kakışmaya	12	Pres
Gazetecilere uçak havada yanarak geldi yere çakıldı diyen tanıklar , anket heyetinin hazırladığı raporlara göre , farklı konuşmuşlardı .	konuşmuşlardı	17	Pqp
Kerem yerinden kalkmıştı .	kalkmıştı	2	Pqp
Oradan oraya seğirtmelerim bitecek , bitip de baş başa kalacak , baş başa kalınca da uzun uzun hayatlarımızın özetlerini çıkarıp bu hayatların görünen ucuna doğru birbirimize el verecek durumda değilim .	seğirtmelerim	2	Pres
Babam derdi ki .	derdi	1	Past
Sebze yeşil demek dedik .	dedik	3	Past
Planla Kıbrıs'ın Rumların denetimi altına verildiğini , nüfus aktarımının da Rumlar lehine gelişeceğini ifade eden Linn , " Bu da Kıbrıslı Türklerin kendi ülkelerinde bağımsızlıklarının sonu olacaktır " dedi .	gelişeceğini	12	Fut
Saçlarını boyattı , modelini değiştirdi .	boyattı	1	Past
Bu amaçla Almanya'da faaliyet gösteren iki şirketi izlediklerini açıklayan Hablemitoğlu'nun Genel Müdürü Melih Batılı , 2005'e kadar bu planlarını gerçekleştirmek istediklerini söyledi .	izlediklerini	7	Past
Şimdi düşünüyorum da , galiba o parkın dışında yapamayacağım ben , dedi Kerem .	yapamayacağım	8	Fut
Lan tamam , sizi de kurtaracağım , var mı öyle kalleşlik .	kurtaracağım	5	Fut
Artık Beyoğlu'na , geceleri içki içmek için çıkışları azaltmıştım .	içmek	5	Pres
Dünyada düşünülecek onca güzel şey varken , senin kuruntular yaratman ve onların içinde bunalman akıl alacak gibi değil .	düşünülecek	1	Fut
Keşfetmeyi severler .	Keşfetmeyi	0	Pres
Ayrıca dokuz deri yüklendi odunların üstüne .	yüklendi	3	Past
İki genç çoban biraz daha erken kahvaltılarını bitirip geyikleri geceledikleri bölgeden toplamış , sürerek getiriyorlardı .	sürerek	13	Pres
Sevilme peşinde koşan ve sevmeyi bilemeyen iki genç , yasal ve yasal olmayan uyuşturucuların etkisiyle sevme oyunu oynayacaklar ve minik bağımlı çocuklar dünyaya getirecekler .	getirecekler	23	Fut
- Evet , meslektaş sayılırız .	sayılırız	4	Pres
Etrafı zaman zaman on metreye kadar yükselen ve bir sura dönüşen kayalarla çevrelenen bu ırmak , geyik sürülerinin dışarıdan gelebilecek saldırılara karşı kendilerini korudukları doğal bir sığınaktı .	gelebilecek	19	Fut
Gecikme faizini frenleyecek tasarı ocak ayında Meclis'te .	frenleyecek	2	Fut
Demin övüp duruyordun patlıcanı !	övüp	1	Pres
Akgündüz'ün fezlekesi , davanın ağır ceza mahkemelerinin kapsamına girmesi nedeniyle , bünyesinde ağır ceza mahkemesi bulunan Bakırköy Adliyesi'ne gönderilecek .	gönderilecek	18	Fut
Bu araştırma konusunda onun da yardımını isteyeceğim .	isteyeceğim	6	Fut
Israr etseydin bize , daha güzel bir isim önerseydin ! ..	etseydin	1	Past
Değil mi ağabeyisi ? dedi bana dönerek .	Değil	0	Pres
Ancak burada söz konusu olan , bilinçli bir soyutlamadan çok , sürekli yinelenen bir deneme - yanılma sürecidir .	yanılma	16	Pres
Unakıtan hükümeti , işçilerin yasal zorunluluktan kaynaklanan ve toplusözleşmeye konulması şartıyla ödenen iki ikramiyeden ikisini ödememe konusunu değerlendirecek .	değerlendirecek	17	Fut
Bu süreçle siyasal düzlemde ilişkilendirilen olgu da artık devrimler değil , devrimsizlik ve küreselleşme sürecidir .	ilişkilendirilen	4	Pres
Kampın kasabaya yakın olmasının avantajından masadaki çilek reçelini tadarak yararlanıyoruz .	tadarak	8	Pres
Henüz iki saattir yoldaydık ve ben altı kez düşmüştüm .	düşmüştüm	8	Pqp
Ben merkezimden çıkıp başkalarına yönelmem dünyamı genişletmeye başladı .	genişletmeye	6	Pres
Onu dinlemeyip çıktım , kapıyı kapamadan , arkamdan geleceğini biliyordum .	çıktım	2	Past
İnsanları ikiye ayırıyor annem ( sayacağı iki kalem de olsa mutlaka parmaklarını avucuna kapatarak sayacak ; birincisi yaşayanlar ( bunlar başkalarını da yaşatıyor ) , ikincisi yaşayanları seyredenler ( bunlar da başkalarının sırtına yük oluyorlar ) .	sayacak	14	Fut
Özellikle de günümüz teknolojisinin ilerleme hızını düşününce birçok insan faktörünün geri plana itildiğini gözlemleyebiliriz .	itildiğini	12	Past
Cami avlusundan koşarak çıktılar .	koşarak	2	Pres
Tehlikeli Oyunlar'ın sonu malumdur , diye mırıldandım .	mırıldandım	6	Past
Ailenin yakınlarından alınan bilgiye göre Altuğ Ulusu , aslında Diyarbakır'a gidecek olan uçağın ikinci pilotu değildi .	gidecek	10	Fut
Askerler , Anayasa çiğnendi diye rejime müdahale etmişler , sonra da Anayasayı toptan kaldırarak yeniden başka bir metin yazdırmışlardı .	çiğnendi	3	Past
Dolayısıyla , bilimsel teorilerin bazı kavramları oluşturup kullanabilmeleri , toplumun ideolojik düzeyinin o kavramların ortaya çıkmasına elveren bir olgunluğa ulaşmış olmasını gerektirir .	oluşturup	6	Pres
Hem yarın sokağa çıkma yasağı olacaktır .	olacaktır	5	Fut
Biliyor musun ben bu bourbon viskiyi daha çok seviyorum .	Biliyor	0	Pres
NA toplantılarında ilk kez başkalarına yöneldim .	yöneldim	5	Past
Bir romanda anlatılmaya değmeyecek kadar bildik , binlerce yıldan beri yaşanan duygulardı bunlar , ama deneyimlerim bana bir şey öğretmişti : En korkunç gerçekler , söylenmeye değmeyecek kadar basit olan bildik gerçeklerdi .	değmeyecek	3	Fut
Halam nasıl böyle büyüklerine laf çakıştıran bir çocuk yetiştirir diye şaşakalmıştık .	şaşakalmıştık	10	Pqp
İkimizden başka kimse bilmeyecek tamam mı ? dedi .	bilmeyecek	3	Fut
Gözkulak olunması görevini üstlenmiş gibi .	üstlenmiş	3	Past
Şimdi içeriye girip onu Mahmut'a vereceğim , dedim .	vereceğim	5	Fut
Sorumluluk taşıyan insanlarımız var ; verdikleri sözün arkasında durdular ve eserler yarattılar .	durdular	8	Past
İhtiyaç olabileceği düşüncesiyle evin etrafında gün boyu bekleyecek on kadar geyik seçildikten sonra diğerleri serbest bırakıldı .	olabileceği	1	Fut
Hastaneye yatırmışlar kaç defa , biraz düzelir gibi oluyor , ay geçmeden başlıyor daha beter içmeye .	düzelir	6	Pres
Kelime Rumca gibi görünse de değil .	görünse	3	Pres
Tam umudunu kesip geri döneceği sırada şehrin en ucundan çıkan dumanı görmüş .	döneceği	4	Fut
Bu konuda Cumhurbaşkanı Ahmet Necdet Sezer'in de " Türban tartışması bitmiştir " diyerek son noktayı koyduğu belirtildi .	koyduğu	15	Past
Dosyanın içerisine girdikçe bu kanaatim daha da güçlendi .	güçlendi	7	Past
Bizi kıyaslayan , karşılaştıranlar bilsinler ki ... Biz , yarışta değiliz .	kıyaslayan	1	Pres
Birden Erkekler Parkı önümüzde belirdi .	belirdi	4	Past
Kemal devam etti : Ben bunun , hem tek tek hepimiz için çok rahatlatıcı olacağından eminim hem de birbirimize yaklaşımımızı , ilişkilerimizi olumlu etkileyecektir , eminim .	etkileyecektir	23	Fut
Ev , ya da ev yapmak adına , ülkemizdeki gecekondu uygulamalarından öğrenecek epey şeyimiz olduğunu düşünüyorum .	öğrenecek	11	Fut
Dün gece diskoda unutmuşsun .	unutmuşsun	3	Past
Naci Bey elini masaya öyle bir vurdu ki , ön sırada oturan kızlar hii diye bağırıp yerlerinden sıçradılar .	sıçradılar	17	Past
Kentten iki mikrofonla , gerekli öteki aygıtları getirtmişti .	getirtmişti	7	Pqp
Bir köpeğin bütün kokuları birbirinden ayırdedip insanların duygularını kokularından anlamaları gibi kadınların sesini tanırdım , her tonunu bilirdim , yalnızca kulaklarımla değil bütün vücudumla duyardım onların sesini .	anlamaları	9	Pres
Konuşmayı sevmezdi , konuşunca da iyi konuşurdu .	konuşunca	3	Pres
Binlerce , onlarca , yüzlerce soru sorabilirdim daha .	sorabilirdim	6	Past
Süryani Kadim Meryem Ana Kilisesi Vakfı Başkanı Yakup Tahincioğlu ve İstanbul Protestan Kilisesi Vakfı Başkanı Kirkor Ağabaloğlu , yönetmelikle kendi cemaatlerine yine mal edinme hakkı verilmediğini ifade etti .	edinme	23	Pres
Yanında oturan annesinin , ağzına zorla tıkıştırdığı lokmayı bir hamlede yuttu ; parmakları darbukanın derisini okşadı ; başını çevirip , arkası dönük oturduğu sahneye baktı .	yuttu	10	Past
Pay çıkaracaksın kendine .	çıkaracaksın	1	Fut
Bir ara köpeği kimin dolaştıracağına karar veremedikleri için kavgaya bile tutuştular .	tutuştular	10	Past
Bunu kendisine yapılmış saygısızlık sayıyordu , gurbet ellerde bulduğum işe gitmemi yediremiyordu kendine .	gitmemi	10	Pres
rapor kaza günü düzenlenmişti .	düzenlenmişti	3	Pqp
Esin de Özer de Uykudan Önce programı gibi dinlediler anlattıklarımı , bir yandan esniyorlardı bir yandan da gözleri sevinçle parlıyordu .	anlattıklarımı	9	Past
Bin yıl kadar sonra da Moğol kavimlerinin saldırısı ile bugün yaşadıkları bölgeleri yurt edindiler .	yaşadıkları	10	Past
Saffet , bağlamanın tellerine , akordu anlamak , sesi ayarlamak için şöyle bir dokundu .	dokundu	13	Past
Bakalım daha nelere sokacak Grek burnunu ...	Bakalım	0	Pres
Servet ( ellialtı ) ve Sevinç Karadağ ( elliüç ) çiftinin ardında bitmeyen aşklarının mutlu hikayesi , gözü yaşlı çocukları ve yakınları kaldı .	bitmeyen	12	Pres
Çocuğun tabaktakileri bir solukta silip süpüreceğini biliyordu artık .	süpüreceğini	5	Fut
binyediyüzotuzdört yılında Cloyne bişopu olan bu filozof - din adamının özdeğin varlığına karşı geliştirdiği savlar , The Dialogues of Hylas and Philonous adlı kitapta yayınlanmıştır .	geliştirdiği	13	Past
Beni görür görmez kendini yere atıp göbeğini bir açışı var ki sevdirmek için özellikle şişiriyor sanırsın .	sanırsın	15	Pres
Bırak zırlasın .	Bırak	0	Pres
Sözgelimi , Gümrük Birliği gibi bir yolculuğa çıkarken , çevresindeki duvarları yıkmaya çalışınca , eski eşyayla yenilerin bakışması gibi , hüzünlü ve çarpıcı yalnızlıklar yaşayan bir ülkeyi ...	bakışması	17	Pres
Fizik yasası olarak nitelendirebileceğimiz ilk bulguları elde eden Arşimed'in , kumun üstüne çizdiği şekillerle bu geometri problemini çözmeye çalışırken , Siraküza'yı işgal eden Roma ordusunun bir askeri tarafından öldürülmesi , adeta Roma'nın teori düşmanlığının bir simgesi olarak tarihe geçmiştir .	nitelendirebileceğimiz	3	Fut
Yeşilden maviye dönüşen iri gözlerini bize çevirmişti .	çevirmişti	6	Pqp
Tabanları şişmiş , ayakları parçalanmış ama iş aslan ağzındaymış .	şişmiş	1	Past
Ne kadar zengin olursan ol , diyor , seyirci olduktan sonra ( al işte Nurettin Bey ; sattı yedi , sattı yedi şimdi beş parasız , onun bunun eline bakıyor ) sıfırı tüketirsin .	olursan	3	Pres
Bir romanda anlatılmaya değmeyecek kadar bildik , binlerce yıldan beri yaşanan duygulardı bunlar , ama deneyimlerim bana bir şey öğretmişti : En korkunç gerçekler , söylenmeye değmeyecek kadar basit olan bildik gerçeklerdi .	değmeyecek	26	Fut
Göz kırptı .	kırptı	1	Past
Üniversiteyi bitirdikten sonra ilk girdiği şirketin müdürü delikanlıya yakın ilgi gösteriyor , baba ilgisi açlığı çeken delikanlı , çocuksu bir ben merkezcilikle müdürün ilgisini bir baba ilgisi olarak algılıyordu : Değerini bilen bir baba .	bitirdikten	1	Past
Şefkatle okşadım çizmeleri oturduğum kızakta .	oturduğum	3	Past
Ayağa kalkıp yine gerindi .	gerindi	3	Past
Evlerine sığınmıştım .	sığınmıştım	1	Pqp
Leidse Alanından Vondelpark yönüne doğru , bir nehri andıran kanalın kıyısına iniliyordu , oradaydı bu geniş , rahat , sulara bakan kahve .	andıran	8	Pres
Gelin , birlikte girelim , dedim .	girelim	3	Pres
Müdür delikanlının uyuşturucu aldığını biliyor ama eroini aklına bile getirmiyordu .	aldığını	3	Past
Kıskanmanın çaresizliğinden ve içimde yarattığı aşağılanma duygusundan kurtulmak ve bana kaçınılmaz gözüken o terk edilme gününun acısını daha baştan hafifletmek için , hayatıma kattığım kadınların sayısı artıyordu .	aşağılanma	5	Pres
Tartışmayı bir televizyon muhabirinin uçaktan " canlı yayına " geçmeye çalışması başlattı .	geçmeye	9	Pres
Bunu nasıl daha mümkün hale getiririz diye düşünürken Amerikalı şirket aleyhine bir dava açarak belgeleri , savcılığın soruşturma belgelerini Kara Kuvvetleri'nin müşterek kanaat raporuna konu olan belgeleri oraya getirtmek mümkün olur gibi bir fikir geldi aklımıza .	açarak	13	Pres
Bu hafta borsa sekizbinbesyuz dokuzbinuzyuz - aralığı bandında hareket edebilir .	edebilir	9	Pres
Ayakta duramayacak kadar yorgun olduğumu sanıyordum , o ilk adıma kadar ...	sanıyordum	5	Past
Duyguları öldürme eşiği hücrelerinde kayıtlı olduğu için yerine başka bir şey koysa da o şeyi de had safhada kullanıyor .	koysa	11	Pres
O ara kapı yeniden tıkladı .	tıkladı	4	Past
Yok , yok , bilmez değilim : birçok eski dinin ürettiği efsaneler , iğretilemeler , kısa öykücükler de söylemek ister bunu ; ama bambaşka bir anlamda .	bilmez	4	Pres
Yani şimdi o gerçekleşiyor .	gerçekleşiyor	3	Pres
Adam , argoyla karışık da olsa - ki bu , sınıfını gizlemediğini gösterdiğinden bir erdem sayılabilirdi - Necmi Bey'i aratmayan güzel cümleler kurabiliyordu .	gizlemediğini	11	Past
Melek her zamanki yerinde , ümitle gelene geçene flasterlerini ve kalemlerini uzatıyordu , ama nafile ; kimsenin ona aldırdığı yoktu .	uzatıyordu	11	Past
İnşaat ortamına ve getireceği değişikliklere alışması için hazırlanan tanıtım filmi ile alıştırılacak ve bilgilendirilecek olan köylüler , çalışma ekiplerine hizmet satabilecekler .	satabilecekler	20	Fut
Olası Irak operasyonunda Türkiye'den taleplere ilişkin son kararın alınacağı MGK öncesinde Ankara'ya gelen ABD'nin iki bakan yardımcısı yirmi milyar dolarlık paket açacak .	açacak	21	Fut
Prensin adamları doğru gidip zalim üvey babayı tutuklamış .	tutuklamış	7	Past
oniki Aralık'a kadar çıkarılması beklenen AB uyum yasalarını içeren paketin çalışmaları dün gece tamamlandı .	beklenen	4	Pres
Ama inanın , yanıtlar hep aynı olacaktır .	olacaktır	6	Fut
Dolapta yeterince makarna ve margarin bulunup bulunmadığına baktık .	bulunmadığına	6	Past
Üstelik mitolojilere inanmayan birisiyse , boşluk üzerinden akacaktır onun .	akacaktır	7	Fut
Gün boyu ormanda odun kesip kamyona yüklemekten yorgun düşmüş dört kişi depoya kamyonu yaklaştırmanın yollarını aradı .	kesip	4	Pres
Bir romanda anlatılmaya değmeyecek kadar bildik , binlerce yıldan beri yaşanan duygulardı bunlar , ama deneyimlerim bana bir şey öğretmişti : En korkunç gerçekler , söylenmeye değmeyecek kadar basit olan bildik gerçeklerdi .	söylenmeye	25	Pres
Irak'ta savaş tehdidi yanısıra , Amerika'nın baskısına rağmen AB için Türkiye'ye müzakere tarihi verilmeyeceği yönündeki sinyaller piyasada moral bozdu .	verilmeyeceği	13	Fut
Babanız yaşlanmıştı .	yaşlanmıştı	1	Pqp
Ayla : Böyle olur mu bilmiyorum .	bilmiyorum	5	Pres
O zaman , lise son sınıfta Fen - Edebiyat diye ayrılırdı .	ayrılırdı	10	Past
Nasıl buldun onu .	buldun	1	Past
Öğretmenim , diyeceğim , köpeklerden korktuğum için Miskoye ile Katana da benimle geldiler .	diyeceğim	2	Fut
Hadi lan , zil çalmıştır bile .	çalmıştır	4	Past
Melek her zamanki yerinde , ümitle gelene geçene flasterlerini ve kalemlerini uzatıyordu , ama nafile ; kimsenin ona aldırdığı yoktu .	aldırdığı	18	Past
Durun ! Gitmeyin ! diye bağırdı Hacı Murat .	bağırdı	5	Past
Yaşamı , bilimin ve dinin geçerli olduğu alanlar olarak ayrı kompartımanlara bölen bu formül , bilimin kapsadığı alanların genişlemesiyle yeniden zora girmiştir .	genişlemesiyle	18	Pres
Yine de raporlara ulaşmanın bu kadar kolay olmayacağını biliyorlardı .	olmayacağını	7	Fut
Anneme yeni sınıf arkadaşlarımı çağırmak istediğimi söyledim .	çağırmak	4	Pres
Tecrübeli editör kesiminin görüşü , " mesele , yayın ilkeleri arasına bunu katmak değil , pratikte ne yapılacağının iyi bilinmesi ve eğitimin önemidir " şeklinde .	katmak	12	Pres
Tüketici kredisinin yabancı para birimi cinsinden kullanılması durumunda , geri ödemeye ilişkin taksitlerin ve toplam kredi tutarının hesaplanmasında , hangi tarihteki kurun dikkate alınacağına ilişkin bilginin sözleşmede yer alması koşulu getiriliyor .	alınacağına	23	Fut
Çünkü uyarıldık ...	uyarıldık	1	Past
Bir birbuçuk - saat içinde çok hızlı bir şekilde incelemek zorunda kaldık .	incelemek	9	Pres
Soğuk iklimi severler .	severler	2	Pres
AB'nin de yakından ilgilendiği bu soruna yeni yönetmelikle çözüm getirilmeliydi .	ilgilendiği	3	Past
Taşhan'ın kapısını itip bu yarı karanlık dünyanın içine girdim .	itip	2	Pres
Bir kuramı oluştururken kullanılan ilk ilkelerin , hipotezlerin gözlemlerden türetilmiş olması istenen bir durumdur .	türetilmiş	9	Past
Kopenhag Zirvesi'ne kadar yetiştirilmeye çalışılan ikinci uyum paketinde son dakika değişikliği yapıldı .	çalışılan	4	Pres
Niye mutsuz olduklarını ise söylemezlerdi , mutsuzluklarının nedenini siz keşfetmek zorundaydınız , bunu keşfedemezseniz biraz daha düşmanlaşırlardı ; bu düşmanlık gerçek değildi , yalnızca mutsuzluklarının üstüne örtmeye çalıştıkları yakıcı bir örtüydü .	olduklarını	2	Past
Seben Gölü'ne ulaşmıştık artık .	ulaşmıştık	2	Pqp
- Ben de yazdıklarımı sana gösteririm .	yazdıklarımı	3	Past
Türkler Avrupa'yı Feth etmemişken beyaz peynir bulunmazdı .	bulunmazdı	6	Past
Diyor ki Uçak buzlanmadan düşmüştür .	Diyor	0	Pres
Hitler'in Almanya için kimi iyi şeyler yaptığına , Karl Marks'ın dört ayak üstünde çocukları sırtında gezdiren , büyümeyen bir çocuk olarak kaldığına hayretle muttali oluyorsunuz .	oluyorsunuz	24	Pres
Aptallığıma şaşırdığını belli eden bir şekilde yüzünü buruşturdu .	buruşturdu	7	Past
Onun güzelliğine duyduğum hayranlıkla başlayan ilişki daha sonra kesin bir cinsel bağımlılığa dönüşmüş ve hep öyle sürmüştü , hatta bir ara artık onun güzelliğini bile fark edemez hale gelmiştim .	sürmüştü	16	Pqp
Mazeret bildirip uçuşa gitmeyen ikinci pilotun yerine göreve çağrıldı , böylece o gece eşiyle yemeğe gitmek yerine ölüme kanat açtı .	gitmeyen	3	Pres
Biz çıkaramadık .	çıkaramadık	1	Past
Tanrı öldü ve biz sokağa bırakıldık .	bırakıldık	5	Past
Bunu nasıl daha mümkün hale getiririz diye düşünürken Amerikalı şirket aleyhine bir dava açarak belgeleri , savcılığın soruşturma belgelerini Kara Kuvvetleri'nin müşterek kanaat raporuna konu olan belgeleri oraya getirtmek mümkün olur gibi bir fikir geldi aklımıza .	getiririz	5	Pres
ATO Başkanı Sinan Aygün , Maliye Bakanı Kemal Yazıcıoğlu ziyaretinden sonra da Bakan'ın " Vergi Barışı Projesi " konusunda , ocak ayının ilk haftasında mükelleflere müjde verebileceklerini söylediğini bildirdi .	verebileceklerini	26	Fut
Hiç değilse kaliteli bir film bularak Hülya ve Selma'yı ayartabilirdim , o da olmadı .	ayartabilirdim	9	Past
Serhat , Öyle bir şey öneriyorsun ki Kemal , dedi , bu öyle bir çırpıda karar verilebilecek bir şey değil .	verilebilecek	16	Fut
Özer de desteklemişti .	desteklemişti	2	Pqp
Her gün yüz bin mi verecekler sana .	verecekler	5	Fut
Boşalmasını sabırsızlıkla beklerim .	beklerim	2	Pres
Halbuki arada gidip günah çıkardın mı , kendini bir miktar yırtmış hissediyorsun , temizlenmiş hissediyorsun , aynı haltı yiyeceğini bilsen bile bir güvencen var .	yiyeceğini	18	Fut
Bir an kafamda bir şimşek çaktı Bu evde iki tane prense ihtiyacımız var , prensesi ve evimizi koruyabilmek için dedim .	çaktı	5	Past
Ne diyeceğimi bilemedim .	diyeceğimi	1	Fut
O kendi götüremez miymiş .	götüremez	2	Pres
Bu herhangi bir rahatlama sağlamıyor ki , en fazla o sorunu nasıl çözeceğime ilişkin tavsiye almış oluyorum .	çözeceğime	12	Fut
Bugün yeni teknolojiler ancak bütünüyle bilimsel bilgiler temelinde üretilebilir hale gelmiştir .	üretilebilir	8	Pres
Oturup sigara yaktım , telaşe halimin geçmesini bekledim .	yaktım	2	Past
dörtyüzotuz trilyon ciroyla Türkiye'nin en büyük yirmiüç'üncü kuruluşu olan TPAO ve ikibinbir yılı vergi rekortmeni Kıyı Emniyeti , gelirlerinin yüzde on'unu bütçeye aktaracak .	aktaracak	22	Fut
birlikte , barın yakınına kadar sokulabildik .	sokulabildik	5	Past
Ama burada sorumluluk kişiye düşüyor .	düşüyor	4	Pres
Serhat , Öyle bir şey öneriyorsun ki Kemal , dedi , bu öyle bir çırpıda karar verilebilecek bir şey değil .	öneriyorsun	5	Pres
Sabaha doğru yapılan aşklar ya da aşk yapma gücünü bulamayıp da ertesi günleri de sürdürülen gezintiler .	bulamayıp	9	Pres
Soruları sürekli tekrarladığınızı fark etseler bile utangaç ifadelerini bir kenara bırakıp sinirlenmez , sıkıldıklarını belli etmezler .	tekrarladığınızı	2	Past
o " Devletin ırkı olmaz " anlayışı temelinde tüm yurttaşlar , " TC yurttaşlığı " üst kimliğinde buluşacak .	buluşacak	17	Fut
Bu heyecana nasıl dayanabilirim . diye mırıldandı Celal .	dayanabilirim	3	Pres
Nusret Senem : Bu başvurumuzda birkaç noktaya değinmişlerdi .	değinmişlerdi	7	Pqp
Yaralılardan Burak Altındağ'ın abisi Vecdi Altındağ da , kardeşinin bilgisayar mühendisi olduğunu ve iş için Diyarbakır'a gittiğini belirtti .	gittiğini	16	Past
Geyiklerin alışık olmadıkları bu durum karşısındaki olgun davranışları , hatta kızak hattının tam ortasındaki düşüşlerimde dahi bana basmamaya özen göstermeleri çarpıcıydı ; sanki aramızda bir sıcaklık doğmuştu .	doğmuştu	26	Pqp
Şükran Hanım , ağzının şarap koktuğunu düşünerek sustu .	koktuğunu	5	Past
Dinamonun çalıştırdığı telsizden kurulan bağlantı , uçağın ineceği gölü tarif etmişti rehbere .	ineceği	7	Fut
Ne kadar zengin olursan ol , diyor , seyirci olduktan sonra ( al işte Nurettin Bey ; sattı yedi , sattı yedi şimdi beş parasız , onun bunun eline bakıyor ) sıfırı tüketirsin .	sattı	17	Past
Ben onu bir an önce eve getirmek istemiştim ama veteriner İki ay dolmadan annesinden ayırmayın .	dolmadan	12	Pres
Orda bana bir şiir okudu , Allah taş etsin tek kelimesini anlamadım .	etsin	8	Pres
Adam başını salladı .	salladı	2	Past
Bu arada , aynı bilim dünyasından bu konuda aykırı sesler çıkaran birkaç bilim insanına kulak verelim .	çıkaran	10	Pres
" Arçelik , ikibinüç yılında ihracatını yüzde otuz'un üzerinde artırarak , beşyüzelli milyon çıtırlarla çıkarmayı hedefliyor .	artırarak	9	Pres
Daha doğrusu takipsizlik kararı verilmişti .	verilmişti	4	Pqp
Ferda , Böyle bir konuda deneme yanılma oynanabilir mi , Selma'cım ? diye konuştu .	oynanabilir	7	Pres
Kapı aralanır gibi oluyor , büyük bir gürültü ile yeniden çarpıp kapanıyordu .	aralanır	1	Pres
Yanlış düşünüyor olabilirim ; ama böyle bir saplantım var .	olabilirim	2	Pres
Kamu personeline ödenecek aylık ve ücretlerin belirlenmesinde esas alınacak katsayılar ile sözleşme tavan ücretlerini belirleme yetkisi tasarıya konmayarak bu konu Bakanlar Kurulu'na bırakıldı .	bırakıldı	22	Past
Şirketin patronu olan okul arkadaşım her zaman giydiği birbirinin aynı siyah takım elbiseleri , inanılmaz derecede parlak kravatlarıyla öğlen yemeğine giderken kapıdan kafasını uzatıp Kaç ? diye soruyordu , ona o ana kadar okuyup kaydettiğim cinayetlerin sayısını söylüyordum .	uzatıp	23	Pres
Bir ara köpeği kimin dolaştıracağına karar veremedikleri için kavgaya bile tutuştular .	dolaştıracağına	4	Fut
Yine sinirlendim .	sinirlendim	1	Past
Bunları söylerken iki adımda Ömür Uzatma Kıraathanesi'nin kapısına varmıştı .	Uzatma	5	Pres
İzlenimlerini ertesi sabah , duru gün ışığında kaleme alması daha sağlıklı olacaktı .	olacaktı	11	Fut
Ağustos güneşi epeyce yatmış olduğu halde etkisini sürdürüyordu .	yatmış	3	Past
Tarihi , içinden dersler çıkarılacak cep kılavuzu olmaktan kültür boyutuna taşımak gerekiyor .	çıkarılacak	4	Fut
Giremeyecek , dedim umutsuzlukla .	Giremeyecek	0	Fut
Bahse girebilirdim ki : i ) şu anda Kemal'in ortaya attığı fikirler bugün değilse bile yarın genel kabul görecektir .	görecektir	18	Fut
Uçak motorlarında buzlanma yoktur .	buzlanma	2	Pres
Kız kardeşim saçlarını evde kendisi boyardı .	boyardı	5	Past
Tecrübeli editör kesiminin görüşü , " mesele , yayın ilkeleri arasına bunu katmak değil , pratikte ne yapılacağının iyi bilinmesi ve eğitimin önemidir " şeklinde .	yapılacağının	17	Fut
Sezer veto edebilir , referanduma getirebilir .	getirebilir	5	Pres
yirmibeş cesedin kimliğinin ise DNA incelemesiyle belirleneceği bildirildi .	incelemesiyle	5	Pres
Üniversiteye lise bitirme derecesine göre alınıyor .	alınıyor	5	Pres
Ben : Azıcık pencereyi açayım mı ?	açayım	4	Pres
Hiç evlenmemiş , tek başına yaşayan bu kadın eroin bağımlısı genç bir delikanlıyla özlemini çektiği ana - oğul ilişkisi yaşadığını söylüyor .	evlenmemiş	1	Past
Kurtulup buraya gelmeyi başardım .	başardım	3	Past
Irak savaşının Kasım Aralık - ayından önce olmayacağı varsayımıyla borsada bir hareketlilik beklenebilir .	beklenebilir	12	Pres
Güneş yeniden bulutların kalın örtüsü ardında kaybolmuştu .	kaybolmuştu	6	Pqp
" Buradaki üst düzey görüşmelerimizde turizm için ellerinden geleni yapacaklarını söylediler .	söylediler	10	Past
Birbirimize hiç dokunmadan , ben onun ellerine o da benim gözlerime bakarak sevişirdik kalabalığın içinde .	sevişirdik	12	Past
Esin de Özer de Uykudan Önce programı gibi dinlediler anlattıklarımı , bir yandan esniyorlardı bir yandan da gözleri sevinçle parlıyordu .	parlıyordu	19	Past
Esin de Özer de Uykudan Önce programı gibi dinlediler anlattıklarımı , bir yandan esniyorlardı bir yandan da gözleri sevinçle parlıyordu .	dinlediler	8	Past
üç ) İMKB endekslerine paralel seyir göstermeyi hedefleyen A tipi endeks fonlar : Bu kategorideki fonlar yılı İMKB'deki kayba paralel kapattılar .	göstermeyi	6	Pres
O gece rüyamda ben balerin olmuştum .	olmuştum	5	Pqp
Tamam usta ya , girmiyorum , bir işeyip geleceğim , diye yanıtladı çocuk .	geleceğim	8	Fut
İyi ki ordu sesini yükseltti , şimdi ne yapacaklar bakalım , deyip bekledik .	bekledik	12	Past
Bitecek bu şaşkın serüven ...	Bitecek	0	Fut
Ama onun bir an görünebileceği bir yerden ayrı kalmaya dayanamıyorsun .	görünebileceği	4	Fut
Başka ne yapabilirim ki .	yapabilirim	2	Pres
Ama kaçtın ondan .	kaçtın	1	Past
Elini , rengi atmış kirli beyaz , uzun donunun içine soktu , orasına burasına yapışmış kumları temizledi .	yapışmış	14	Past
Buraya uğra , bir kadeh içtikten sonra , kentin merkezine ineriz .	içtikten	5	Past
Bu davanın sağlıklı görülebilmesi için de askeri savcının hazırladığı kararların ve bu kararlara alt yapı oluşturan raporların tamamının askeri savcılıktan istenmesi ve dava ile ilgili kişilerce incelenmesi gerekiyordu .	görülebilmesi	3	Pres
Bunu sınıfça başarabileceğimizden emin değilim .	başarabileceğimizden	2	Fut
Yalnız kadavranın gelmesi iki gün gecikti .	gecikti	5	Past
CHP'lilerin tarım ve sağlık sektörüne destek amacıyla verdiği önergeler ise " gider Başesgioğlu " olduğu gerekçesiyle kabul edilmedi .	edilmedi	17	Past
Ağbime güvenirim .	güvenirim	1	Pres
Kapı dışarıdan vuruluyor , hafifçe itiliyor , aralanıyor , yeniden kapanıyordu .	kapanıyordu	10	Past
Ormanlarda , sularda dans ediyordum .	ediyordum	4	Past
Ardından Jul , ellerini küçük masanın üzerinde birleştirip , okuduğu kitaptan söz etti .	birleştirip	7	Pres
Doğu Anadolu'da ulaşımın zor olduğu arazide dev boruların taşınması ve inşaat makinelerinin geçmesi için yapılacak yollar , bölgedeki sarp arazide yeni ulaşım olanakları sağlayacak .	taşınması	8	Pres
Başbakanlık'ta gazeteciler ile sohbet eden Şahin , önceki hükümetin memur maaşlarına hedef enflasyona göre zam yapma sözü verdiğini , ancak kendilerinin ikibinüç zammını geçmiş enflasyonlara göre vermeyi planladıklarını söyledi .	planladıklarını	27	Past
Yurdundan kopup gelen aile , büyük kentin kendine uygun bir yerinde , önce başını sokacak bir göz oda ve çevrelediği alanın odadan kopuk bir yerinde helasını yapıyordu .	sokacak	14	Fut
Raporlarda , tanıkların uçağın sağ kanadı aşağıda , diğeri yukarıda olarak dalış halinde gelip yere vurduğunu , vurmayı müteakip bir ateş topu meydana geldiğini beyan ettiği yeralıyordu .	yeralıyordu	26	Past
Timur , Artık kendi yalnızlığımda tutunacak dal kalmamıştı , ruhsal çöküntümün önüne geçemiyordum , madde bana başlangıçta ihtiyacım olan şeyleri verdi : deliğimi kapattı , eksikliğimi giderdi .	tutunacak	5	Fut
Fatih'in , gemileri Haliç'e karadan indirme planının Fatih'in kafasından çıkmadığını , Said Nursi'nin - i de arkasına Nurcu ordularını toplayıp başkente yürüme planları yapmadığını işitiyorsunuz .	işitiyorsunuz	24	Pres
Şimdi de yaşayacaksınız .	yaşayacaksınız	2	Fut
Oh , iyi ki aradın Maryline .	aradın	4	Past
Artık duygularının , hastalıklarının ağrılarını kesecek uyuşturucu da olmadığı için neye sığınacağını bilemeyecek hale geliyor .	kesecek	5	Fut
İnsanlar , beyinlerinde ya da genlerinde mantıkla donanmış olarak doğmazlar .	doğmazlar	9	Pres
Bunu yapmayanların yöneticileri şahsen sorumlu tutulacaklar .	tutulacaklar	5	Fut
Bize gideceğiz , dedi .	gideceğiz	1	Fut
Biliyordum seveceklerini .	seveceklerini	1	Fut
Ama eğer olacaksa sürecin uzaması ekonomik açıdan Türkiye için ciddi dezavantajlar da doğuruyor .	olacaksa	2	Fut
Bazı bilim adamları evrenin genişlemesini tanımlayan anda ortaya çıkan matematiksel tekilliği Tanrı sandılar ve Tanrı'nın evreni o noktada yarattığını düşündüler .	genişlemesini	4	Pres
Acemi vücutlarının , aldıkları alkolün de etkisiyle , ancak çırpınış düzeyine ulaştırabildiği göbek dansını kesen turistlerin yerlerine oturmaları birkaç dakika bile sürmezdi .	ulaştırabildiği	11	Past
Belki de rastlayacaksınız ona .	rastlayacaksınız	2	Fut
Bir mektup getirmiştim Mahmut Beye .	getirmiştim	2	Pqp
Ana Jet Üs Komutanlığı'na ait iki adet CASA - dört keşif uçağı , eğitim uçuşu için Erhaç Havaalanı'ndan kalkışlarından kısa bir süre sonra iddiaya göre havada çarpıştıktan sonra çakıldı .	çarpıştıktan	26	Past
Bila , " Sizinle ilgili izlenimlerimi yazacağım , isterseniz , bu söylediklerinizi de yazayım , ancak teypteki ifadenizi de yazmak zorundayım " karşılığını verdi .	söylediklerinizi	11	Past
Niye susmuştunuz ben dönüp baktığımda ! ?	susmuştunuz	1	Pqp
Anladım ki bu taşınma kararımdan hoşnut , doğallaştırıp sıradanlaştırmaya çalışıyor , ama nafile , ben başlayacak bu yeni beraberliğin taze heyecanını bastıracak halde değilim .	başlayacak	15	Fut
Sonra da adamdan sayılıp başımıza bela olacaksınız ! diye bağırdı .	olacaksınız	6	Fut
İkimiz de kendimizi yenik hissediyorduk , bu , ilişkimiz süreceği anlamına geliyordu .	süreceği	9	Fut
Kendini o halinle yeni doğmuş bebeklere benzetmiştin .	doğmuş	4	Past
Aldatma üstüne kurulmuş bir mekanizma .	Aldatma	0	Pres
İkimiz de aynı anda Taşhan'ın kapısına bir kadının yaklaştığını gördük .	gördük	9	Past
Sana gölgede yatma dedik sıpa .	dedik	3	Past
Üçümüz birden girsek , dedi Miskoye , sen konuşsan .	konuşsan	8	Pres
Elli bin kağıtlık sigaradan içmem , dedi .	içmem	4	Pres
O geceye doğru yolculuğa çıktığından ( biraz zorlanacak tabii , onda da beyin meyin kalmamış ) dalıp gidiyor .	zorlanacak	7	Fut
Diğer taraftan bilimin her teorik atılımı , yeni bir kavramsal yapının oluşturulup eski bazı kavramlardan kopuşu içerdiği için , ideolojide bir dönüşüme yol açar .	kopuşu	15	Pres
Kadınlar rahatça mağazada dolaşmaya , satış elemanlarıyla konuşmaya , ürünleri incelemeye , sorular sormaya , ürünleri denemeye ve sonunda satın almaya daha yatkın .	konuşmaya	7	Pres
Hazine garantileri nedeniyle doğabilecek ödemeler için de üçyüzyirmialtı trilyon liralık ödenek ayrıldı .	doğabilecek	3	Fut
Marul göbeğini soyup aynı ritüel kadın için de geçerli tabi .	soyup	2	Pres
Hangi aday kazanırsa kazansın birlikte mücadeleyi sürdüreceklerini ifade eden Çelebi , ANAP'ı ayağa kaldırmak için hep birlikte çaba harcayacaklarını söyledi .	sürdüreceklerini	6	Fut
Okuyucunun , bu antik değeri olan ancak yeniymiş gibi sunulan çürütülmüş felsefi dizgelere karşı savunmasız kalmaması gerekiyor .	çürütülmüş	10	Past
Ben İngilizcesinden okuyorum .	okuyorum	2	Pres
Baktı olmayacak , beni yanağımdan öptü , saçlarımı okşadı .	öptü	5	Past
Tüketici kredisinin yabancı para birimi cinsinden kullanılması durumunda , geri ödemeye ilişkin taksitlerin ve toplam kredi tutarının hesaplanmasında , hangi tarihteki kurun dikkate alınacağına ilişkin bilginin sözleşmede yer alması koşulu getiriliyor .	alması	28	Pres
Cumartesileri tenis kursuna yazılmak istediğimi anneme söyledim .	yazılmak	3	Pres
Onun güzelliğine duyduğum hayranlıkla başlayan ilişki daha sonra kesin bir cinsel bağımlılığa dönüşmüş ve hep öyle sürmüştü , hatta bir ara artık onun güzelliğini bile fark edemez hale gelmiştim .	duyduğum	2	Past
Geceyi böylece geçirebilecektik .	geçirebilecektik	2	Past
Sevdikçe , sevdiklerinden daha çok korkan insanların , başkalarına inanılmaz , tuhaf ve yabancı gözüken davranışlarını Sevda'ya anlatmam mümkün değildi .	sevdiklerinden	2	Past
Bu çekinmesiz , sıcak davranışlı , içinde biriktirdiği derinliği dışa da yansıtmaktan kaçınmayan sarışın kız , gelebileceğini söylemişti .	biriktirdiği	7	Past
Perakendecilikte araştırmaları ve metodoljik çalışmalarıyla tanınan Underhill , dünyada " Why We Buy : The Science of Shopping " ( Neden satın Alıyoruz : Alışveriş Bilimi ) adlı kitabıyla tanındı .	Alıyoruz	22	Pres
Bir mısır tarlasına girip boydan boya koşarak geçtiler .	geçtiler	7	Past
Gözlerinde korku ve acı ile bize bakıyordu .	bakıyordu	6	Past
dortyuz-besyuz milyarlık bir katkı daha yapacaklar " dedi .	yapacaklar	5	Fut
Kızını çok beğendik .	beğendik	2	Past
Öteki kadını nereden duydunuz .	duydunuz	3	Past
Geldiğin günü çok iyi hatırlıyorum .	Geldiğin	0	Past
KÜTÜK , yaşadıklarını şöyle anlattı : " Yapımcıyla konuşup dizide oynamak istediğimi söyledim .	söyledim	12	Past
Şirketin patronu olan okul arkadaşım her zaman giydiği birbirinin aynı siyah takım elbiseleri , inanılmaz derecede parlak kravatlarıyla öğlen yemeğine giderken kapıdan kafasını uzatıp Kaç ? diye soruyordu , ona o ana kadar okuyup kaydettiğim cinayetlerin sayısını söylüyordum .	söylüyordum	37	Past
İnsanlara özgü zannettiğim bir çok özelliğin hayvanlar aleminde de geçerli olabileceğini daha önce hiç düşünmemiştim .	düşünmemiştim	14	Pqp
İncecik bacaklarını birbirinin üzerine atmıştı , geniş koltuğun üzerinde rahatça oturuyordu .	atmıştı	4	Pqp
Ancak Batı'nın şekerle başlayan ve ağrı kesicilerle devam eden bağımlılıkları onlara da ulaşmıştı .	ulaşmıştı	12	Pqp
paralel bağlanabiliyor ; ama bir trafik kazasında insanların paralel bağlanabileceğini ilk kez duyuyorum .	bağlanabileceğini	9	Fut
Ölüler konuşmadığı için mi böyle yapılır dedim .	konuşmadığı	1	Past
Hemen hemen planlanmamış alışverişin tamamı mağazada dokunarak yapılmış alıverişlerdir .	yapılmış	7	Past
Şimdilerde yeni bir korku edindiniz .	edindiniz	4	Past
Senin de kendini asma ihtimalin var mı , yok mu .	asma	3	Pres
Gevşemiyor bir türlü ...	Gevşemiyor	0	Pres
Bazen çabuk söner böyle şeyler , dedim .	söner	2	Pres
Rumların , Kıbrıs Türklerine yönelik uygulayacağı tedbirler ve AB'nin KKTC'yi IMF'nin - AKP'lilerin ederek Türk tarafındaki bazı çevrelere yapacağı yardım , halkta bölünmeye yol açabilir .	bölünmeye	22	Pres
Dört yıl önce , tüm bağlantımı kesip attığım geçmişim geri döndü .	kesip	6	Pres
Gülce ile bir grup gidip fiyatları öğrenecek .	öğrenecek	6	Fut
Bu ara pek vaktim olmuyor .	olmuyor	4	Pres
Hadi lan , dedi Katana , sopa yiyeceğiz Naci Beyden .	yiyeceğiz	7	Fut
Mükelleflerin son dört yıldaki vergi matrahlarını artırmaları ve borçlarını uzun vadeli taksitlerle ödemeleri halinde vergi incelemesi yapılmamalı .	yapılmamalı	16	Pres
Ee kolay değil oğlum kaç aydır bakıyorlar alışır insan ne kadar olsa .	bakıyorlar	6	Pres
Dolayısıyla , bilimsel teorilerin bazı kavramları oluşturup kullanabilmeleri , toplumun ideolojik düzeyinin o kavramların ortaya çıkmasına elveren bir olgunluğa ulaşmış olmasını gerektirir .	elveren	16	Pres
O haftayı iple çektiğimi dün gibi hatırlıyorum .	çektiğimi	3	Past
Bu komisyonlar , arazilerini satın almak için köylülere sunulacak fiyat teklifini belirlemede söz sahibi olacaklar .	olacaklar	14	Fut
Filmle alıştıracaklar .	alıştıracaklar	1	Fut
İstanbul Milletvekili Kemal Derviş kokteyle katılmadı .	katılmadı	5	Past
Yay sesleri dindi yavaş yavaş , uyum sağlandı .	sağlandı	7	Past
Kerem bana baktı .	baktı	2	Past
Ramiz yerinden kalkmış Naci Beyin yanına kadar sokulmuştu .	sokulmuştu	7	Pqp
Yatak odamı beğeneceksin ama .	beğeneceksin	2	Fut
Uyandım ve sabah rolü bana verdiklerine dair telefon alacağımı bilerek tekrar uyudum .	alacağımı	8	Fut
Her şey bitmişti , anlamıştım .	bitmişti	2	Pqp
" Bu tanımla , örneğin Almanya'da şirket kuran vergisini Alman hükümetine ödeyen fakat Türk vatandaşı olan kimseler yerli ama Türkiye'de yıllardan beri yerleşik bulunan bizler yabancı oluyoruz " diyen ' , teknik bir hata olabileceğine dikkat çekti .	olabileceğine	34	Fut
Dere yatağından getirilip köpeklerin erişemeyeceği bir yükseklikteki kütük setin üstüne istiflenmiş buz bloklarından bıçağıyla kopardığı parçaları kovaya dolduruyor .	dolduruyor	17	Pres
Bu koca yuvarlak Dünya'nın etrafında dönüyordu .	dönüyordu	5	Past
Ayak parmaklarından , yumruk yaptığı ellerine kadar tüm vücudunun kıtırdadığını duyumsadı .	duyumsadı	10	Past
- Artık olmaz , onu kıramam .	kıramam	5	Pres
Önce kahvelerimizi içelim de ...	içelim	2	Pres
O zamanlar toprağı bol olsun Sayın Tului Sönmez ile konuyu tartışmış ve ondan epey şey öğrenmiştim .	öğrenmiştim	15	Pqp
Ama onun bir an görünebileceği bir yerden ayrı kalmaya dayanamıyorsun .	kalmaya	8	Pres
Sanılıyordu ki , ülkenin devasa sorunlarına , dair , basmakalıp siyaset tiradlarının düellosunu kazanan muzaffer olacaktı .	olacaktı	15	Past
Evet , Ali Babaoğlu'nun dediği gibi ben de bu zeka pırıltılarından etkilendim .	etkilendim	11	Past
Timur , Artık kendi yalnızlığımda tutunacak dal kalmamıştı , ruhsal çöküntümün önüne geçemiyordum , madde bana başlangıçta ihtiyacım olan şeyleri verdi : deliğimi kapattı , eksikliğimi giderdi .	kalmamıştı	7	Pqp
Evin arkasındaki ormandan çıkmış , az ilerideki çitlerle çevrili alana doğru yürüyordu geyik sürüsü .	yürüyordu	11	Past
Kendini o halinle yeni doğmuş bebeklere benzetmiştin .	benzetmiştin	6	Pqp
Birden , geldiğini duydum , parktaki kalabalık karıştı .	karıştı	7	Past
Ben akşama vurulacak insanların o sırada neler yaptığını merak ederek cinayet haberlerini kesip dosyalarına koyardım ; arada ilginç bir cinayet çıkarsa , kimin , nerede , nasıl öldürdüğünü yanımda taşıdığım özel cinayet defterime kendim için kaydederdim .	vurulacak	2	Fut
Onu bulacağınıza eminim .	bulacağınıza	1	Fut
Onlara hiç anlamıyorlarmış gibi gelirken birden en can alıcı soruyu , nasıl olup da bulup sorabilirler .	gelirken	4	Pres
Bu öngörülerin doğruluğunu sınayacak olanlar yine gözlem ve deneylerdir .	sınayacak	3	Fut
İnanmıyorsanız , Türkiye'nin kentlerinde ve kasabalarında bir pazar günü sokağa çıkın .	çıkın	10	Pres
Aklıma aradığımız sekreter için gazeteye verdiğimiz ilan geldi .	verdiğimiz	5	Past
İnsanları ikiye ayırıyor annem ( sayacağı iki kalem de olsa mutlaka parmaklarını avucuna kapatarak sayacak ; birincisi yaşayanlar ( bunlar başkalarını da yaşatıyor ) , ikincisi yaşayanları seyredenler ( bunlar da başkalarının sırtına yük oluyorlar ) .	sayacağı	5	Fut
Şahin , TSMF Avrupa Birinci Bölge Direktörü BDDK ' ile yarın başlayacak görüşmelerin en önemli gündeminin memur ve işçilere yapılacak zam ile atıl istihdam olduğunu belirtti .	başlayacak	11	Fut
Konuşmayı sevmezdi , konuşunca da iyi konuşurdu .	konuşurdu	6	Past
Konuşmayı sevmezdi , konuşunca da iyi konuşurdu .	sevmezdi	1	Past
Gece yarısı sokaklarında dolaşıyor , zamanın geçmesini bekliyordum .	geçmesini	6	Pres
O kayıtsızlığıyla beni yerden yere vurdu , ben uğradığım muamele karşısında kapıldığım dehşetle kendimi yerden yere vurdum .	vurdum	16	Past
Yaşlandıkça tuhaflaşıyorsun .	Yaşlandıkça	0	Pres
İçeriye girdiğimizi fark eden olmamıştı .	olmamıştı	4	Pqp
İşçiler şöyle karşılık verdiler : Çalıştığımız fabrikalarda , yararlı olmayan şey yoktur .	Çalıştığımız	5	Past
Boş zamanlarımda bazen cinayetlerin işlendiği yerlerde dolaşıp çevreye bakınır , cinayet anını gözümde canlandırmaya uğraşırdım .	uğraşırdım	14	Past
Baktı olmayacak , beni yanağımdan öptü , saçlarımı okşadı .	Baktı	0	Past
Bunların yararını da görmüştü .	görmüştü	3	Pqp
Bu başarı tüm Arçelik çalışanlarının yarattığı sinerjinin ürünüdür .	yarattığı	5	Past
Erdoğan'ın milletvekili ve başbakan olmasını sağlayacak düzenlemede , Sezer'in karşı çıktığı , doğrudan başbakanlık getirecek yüzdokuz . madde yerine ara seçimi düzenleyen yetmişsekiz . madde üzerinde değişiklik yapacaklarını belirten Şahin , şu mesajı verdi : .	sağlayacak	5	Fut
Saffet bunu görünce , yörenin daha yavaş ritimli , eski bir türküsünü çalmaya başlardı .	başlardı	13	Past
Evet , buraya bir şey anlatmak için gelmiştim , dedi Kerem .	gelmiştim	7	Pqp
Hızla yerimden kalkıp , Taşhan'dan dışarıya çıktım .	çıktım	6	Past
Sezer'in , " erteleme değil , af " diye nitelendirdiği yasayı veto etmesi , AB uyum yasaları ile öne açılan Erdoğan'ı etkilemeyecek .	etkilemeyecek	21	Fut
Bu tevazuyu gerektiriyor .	gerektiriyor	2	Pres
Daha sonra babanızın , sizinle yalnızken öleceğinden korktunuz .	öleceğinden	6	Fut
Bunun cezasını babası askerliğinde çok çekmişti .	çekmişti	5	Pqp
Çoğulu çoğul yapmayı anlamam .	anlamam	3	Pres
Kesilmiş , iç organları temizlenmiş ve soğuğun etkisiyle kaskatı olmuş dört geyik , boynuzları , başları , bacakları ile kamyona taşındı .	taşındı	20	Past
Onu tanıyorsunuz o zaman , dedi .	tanıyorsunuz	1	Pres
Çok alışmıştım Kahve'ye belki vazgeçersin almaktan , annem de alıştığı için kalır diyordum kendi kendime .	diyordum	12	Past
Emaye bobin teli üretecekler .	üretecekler	3	Fut
Bu konuda Cumhurbaşkanı Ahmet Necdet Sezer'in de " Türban tartışması bitmiştir " diyerek son noktayı koyduğu belirtildi .	belirtildi	16	Past
Hükümetin hedefleri tutturabilmek için önümüzdeki yaklaşık on günlük süreçte yeni gelir artırıcı veya harcama azaltıcı tedbir paketleri hazırlaması gerekiyor .	tutturabilmek	2	Pres
Konuştun mu onunla .	Konuştun	0	Past
Sezginler ne ile uğraştığını o güne kadar tam olarak bilemese de Senem başlarına gelebilecekleri tahmin edebiliyor ve bu yüzden Sezginler'i uyarma ihtiyacını hissediyordu .	hissediyordu	22	Past
Önce Tanrı'nın ve Bey'in kulu olmadığımızı öğrendik ; sonra dünyayı değiştirebileceğimizi .	değiştirebileceğimizi	10	Fut
Oraya nasıl ulaşılacağını , nereden gidileceğini hiç bilmiyorum .	ulaşılacağını	2	Fut
Hülya kolumu tutmuştu .	tutmuştu	2	Pqp
Çelikkale Sokağı'nda manevra kıyafetli iki Harp Okulu öğrencisi bizi durdurdu .	durdurdu	9	Past
Dünkü Amerikalı iki paket bırakmıştı .	bırakmıştı	4	Pqp
Kemal'in sözlerini tekrarlayarak , sevgilinin uyurkenki beş ayrı halini yirmisekizer , Hülya'nın gözkapaklarına çöküp toplanan buğunun renklerini otuzbeşer defa gözlerimin önünden geçirdikten sonra , uyuyamayacağımı anlayıp doğruldum .	uyuyamayacağımı	24	Fut
Gece yarısı sokaklarında dolaşıyor , zamanın geçmesini bekliyordum .	dolaşıyor	3	Pres
Sonra sen de bir kertenkele oluverip o göbekli , geniş burunlu , kırmızı yüzlü adamın öptüğü , ellerini gezdirdiği ince beyaz derinden ve hatta ruhundan kurtulmak istemiştin .	istemiştin	26	Pqp
Yarın akşam , bana burada kaldığım evi bulan - ev de tanıdığım bir profesörün ya - Madam Kuve'ye yemeğe çağrılıyım .	bulan	7	Pres
Hepimiz Cumhuriyet devrinde doğmuştuk .	doğmuştuk	3	Pqp
Kalkmaya hazırlanan masadaki iki genç kadının ayaklarının oynamaya başladığını , ince hırkalarının altında omuzlarının titrediğini , parmaklarının tempo tuttuğunu gördü , sevindi .	sevindi	21	Past
Şimdi bir hukuk maratonu başlıyordu .	başlıyordu	4	Past
Ya havayı katılaştırır , seferleri kaldırır , yollarını kaparlarsa .	katılaştırır	2	Pres
Timur , Artık kendi yalnızlığımda tutunacak dal kalmamıştı , ruhsal çöküntümün önüne geçemiyordum , madde bana başlangıçta ihtiyacım olan şeyleri verdi : deliğimi kapattı , eksikliğimi giderdi .	geçemiyordum	12	Past
Aşınmış mermer merdiveni tırmandım .	tırmandım	3	Past
ATO Başkanı Sinan Aygün , altı bankanın temerrüt faizini düşüreceğini , diğer bankalarla da görüşmelerin halen devam ettiğini söyledi .	düşüreceğini	9	Fut
Yataktan kalkıp balkona çıkmış , bir sigara yakmıştı .	yakmıştı	7	Pqp
Arabanın altına girip gebereceksiniz .	gebereceksiniz	3	Fut
Bunu kendisine yapılmış saygısızlık sayıyordu , gurbet ellerde bulduğum işe gitmemi yediremiyordu kendine .	yapılmış	2	Past
Bir solukta ufaklığı , annemle yaptığımız anlaşmayı , bu köpeği ne kadar çok istediğimi herşeyi ama herşeyi en ince ayrıntısına kadar anlattım .	yaptığımız	5	Past
Takipsizlik karar metni yalnızca anne ve babaya gönderilmişti .	gönderilmişti	7	Pqp
Sinan yollamıştı Almanya'dan .	yollamıştı	1	Pqp
Planla Kıbrıs'ın Rumların denetimi altına verildiğini , nüfus aktarımının da Rumlar lehine gelişeceğini ifade eden Linn , " Bu da Kıbrıslı Türklerin kendi ülkelerinde bağımsızlıklarının sonu olacaktır " dedi .	olacaktır	26	Fut
Bu çekinmesiz , sıcak davranışlı , içinde biriktirdiği derinliği dışa da yansıtmaktan kaçınmayan sarışın kız , gelebileceğini söylemişti .	söylemişti	17	Pqp
Irak savaşının Kasım Aralık - ayından önce olmayacağı varsayımıyla borsada bir hareketlilik beklenebilir .	olmayacağı	7	Fut
Tüketici kredisinin yabancı para birimi cinsinden kullanılması durumunda , geri ödemeye ilişkin taksitlerin ve toplam kredi tutarının hesaplanmasında , hangi tarihteki kurun dikkate alınacağına ilişkin bilginin sözleşmede yer alması koşulu getiriliyor .	ödemeye	10	Pres
İlla okuyacaklar .	okuyacaklar	1	Fut
Eyvah ! Mantara basıyoruz galiba .	basıyoruz	3	Pres
Oysa askeri savcılığın takipsizlik kararında pervane buzlanmasından değil , motor buzlanmasından dolayı uçağın düştüğü ifade ediliyordu .	ediliyordu	15	Past
Burjuvazinin siyasal devrimlerle iktidarı ele geçirip , hakim sınıf konumunu sağlamlaştırmasıyla birlikte , bilimi , idealizme karşı mücadelede materyalizmin temel mevzisi olmaktan çıkartacak , bilim ile dini barıştıracak yeni bir ideolojik ortam yaratma arayışları baş göstermiştir .	yaratma	32	Pres
Hangisini sen kazandın ki ? deyip dik dik bakmıştı yüzüme .	bakmıştı	8	Pqp
Geceleri kakıp , konuklara sunulacak rakı , votka , viski ne bulursam ; birer ikişer yudum kafama dikmeden , bölük pörçük uykumu bile sürdüremiyorum .	sunulacak	4	Fut
Bir süre sessiz yürüdük .	yürüdük	3	Past
Davetin Aralık 2002'de Ankara'ya gelerek Erdoğan ile görüşen Yunanistan'ın ana muhalefet lideri Karamanlis tarafından yapıldığını kaydeden Dişli , buna yönelik çalışmalarda bulunulduğunu bildirdi .	bulunulduğunu	21	Past
Rakı soframızın vazgeçilmez bir üyesi daha .	vazgeçilmez	2	Pres
Yerimden fırladım , kapıyı hızla açıp Ömür Uzatma Kıraathanesi'nden dışarıya çıktım .	çıktım	10	Past
Bu insanın kaptırıp gidebileceği bir şey .	kaptırıp	2	Pres
Ben annemden izin koparabilmek için onca dil dökmüş , onca gün sabırla beklemiştim .	beklemiştim	12	Pqp
Ne soracağımı anlamıştı , sor , dedi gönülsüzce .	anlamıştı	2	Pqp
Aygün , tüccar ve sanayicinin ödeyemediği vergilerden dolayı sıkıntı içinde olduğunu , bunların bir kısmı için icra işlemi başlatıldığını aktararak , ' düzenleme talebinde bulunduklarını ifade etti .	aktararak	19	Pres
Sezginler ne ile uğraştığını o güne kadar tam olarak bilemese de Senem başlarına gelebilecekleri tahmin edebiliyor ve bu yüzden Sezginler'i uyarma ihtiyacını hissediyordu .	gelebilecekleri	13	Fut
İyice hastaydı , diyor , karnı davul gibi şişmişti .	şişmişti	8	Pqp
Recep , pantolonunu giymiş , gömlek cebinden çıkardığı sigarayı ağzına koymuştu .	koymuştu	10	Pqp
Stas , evin dışındaki yine kütüklerden inşa edilmiş depoda yeni avlanmış bir yaban koyununun derisini ve boynuzunu gösteriyor misafire .	avlanmış	10	Past
Babasına koşmuş yumurcak .	koşmuş	1	Past
Bilim tarihinde , çok uzun ve zahmetli bir kolektif sürecin ürünü olan mantığı saymazsak , iki önemli teorik atılım dönemi vardır .	saymazsak	13	Pres
Tutamadım kendimi aga .	Tutamadım	0	Past
Bu komisyonlar , arazilerini satın almak için köylülere sunulacak fiyat teklifini belirlemede söz sahibi olacaklar .	sunulacak	8	Fut
Kaç kez denemişti ; iki türküden sonra balıkçılar , utangaç hallerinden sıyrılıp , tarihin değil , doğanın kendilerine verdiği niteliği yeğleyerek , masalarda oturan yabancı kadınlara göz süzmeye başlıyorlardı .	başlıyorlardı	28	Past
Başını çaresizlikle iki elinin arasına almıştı .	almıştı	5	Pqp
Tek Cumhuriyet demiş , saymamış , durmuş .	saymamış	4	Past
Nedenini anlayamadığım bu terk edilme korkusu ve kendime itiraf etmekten bile utandığım hırpalayıcı kıskançlığımla , aptalca olduğunu bile bile daha çok kadınla birlikte oluyor ve sonunda korktuğuma uğrayıp bir başka erkek için terk ediliyordum .	hırpalayıcı	12	Pres
Sonra da adamdan sayılıp başımıza bela olacaksınız ! diye bağırdı .	sayılıp	3	Pres
İstatistiklere baktığımızda bu seviyenin mevcut belirsizlik unsurlarının ortadan kalkması durumunda ikibinüç yılında da büyük bir olasılıkla test edilebileceğini tahmin edebiliriz .	baktığımızda	1	Past
Bazı bilim adamları evrenin genişlemesini tanımlayan anda ortaya çıkan matematiksel tekilliği Tanrı sandılar ve Tanrı'nın evreni o noktada yarattığını düşündüler .	sandılar	12	Past
Sonra , patron olduğunu anımsatmak için , soymakta olduğu patatesleri bırakıp , bir çay doldurdu , masalardan birine geçti , sabahtan beri bakıla bakıla paçavra gibi olmuş gazeteyi eline aldı .	doldurdu	14	Past
Sözgelimi , Gümrük Birliği gibi bir yolculuğa çıkarken , çevresindeki duvarları yıkmaya çalışınca , eski eşyayla yenilerin bakışması gibi , hüzünlü ve çarpıcı yalnızlıklar yaşayan bir ülkeyi ...	yıkmaya	11	Pres
Yaptığı nice düşüncesizlikleri başına kakmak istemedim , şunun şurasında birlikte yaşamaya başlayalı ne kadar oldu , yaparsam küstahlık olur .	yaparsam	16	Pres
Bilgiye , yeni askeri araçların geliştirilmesi ve devlet düzeninin sağlamlaştırılmasının aracı gözüyle bakan Roma , teoriyi , vakit kaybından başka bir işe yaramayan bir etkinlik sayarak hor görmüştür .	sayarak	25	Pres
Ürünlerinizin konuşulduğu bir atmosfer yaratabiliyorsanız , ürün kendi kendini satacaktır .	konuşulduğu	1	Past
Olası Irak operasyonunda Türkiye'den taleplere ilişkin son kararın alınacağı MGK öncesinde Ankara'ya gelen ABD'nin iki bakan yardımcısı yirmi milyar dolarlık paket açacak .	alınacağı	8	Fut
içine alır , besler , büyütür , korur .	korur	7	Pres
Ne tuhaf , daha önce dikkatimi çekmemişlerdi .	çekmemişlerdi	6	Pqp
TKP avukatları , bunun dışında , şu ana kadar yuzelli partilinin hakkında bildiri dağıtmaktan soruşturma açıldığını söylediler .	dağıtmaktan	13	Pres
Buraya uğra , bir kadeh içtikten sonra , kentin merkezine ineriz .	ineriz	10	Pres
Eskilerin tasannu dedikleri türden .	dedikleri	2	Past
Buyur etmişler .	etmişler	1	Past
Önüne gelenle yatıp kalkıyormuşum .	gelenle	1	Pres
' seçim döneminde kendisini Çankaya Köşkü'ne çıkaracağı yolunda Milli Görüş tabanına propaganda yaptığını öne süren kapatılan RP'nin Genel Başkanı Necmettin Erbakan'a ' milletvekilleri sert tepki gösterdi .	çıkaracağı	6	Fut
Hemen yarım saat sonra bunlar olay yerine ulaşıyor .	ulaşıyor	7	Pres
İyi tanıyamadık onu .	tanıyamadık	1	Past
Acemi vücutlarının , aldıkları alkolün de etkisiyle , ancak çırpınış düzeyine ulaştırabildiği göbek dansını kesen turistlerin yerlerine oturmaları birkaç dakika bile sürmezdi .	oturmaları	17	Pres
Sevilme peşinde koşan ve sevmeyi bilemeyen iki genç , yasal ve yasal olmayan uyuşturucuların etkisiyle sevme oyunu oynayacaklar ve minik bağımlı çocuklar dünyaya getirecekler .	oynayacaklar	17	Fut
Her şey bitmişti , anlamıştım .	anlamıştım	4	Pqp
Hiçbir şey anlatamıyorum işte .	anlatamıyorum	2	Pres
Kristof Kolomb'un , öyle insanlık adına keşiflere çıkmış bir seyyah değil , yeni zenginlikler peşinde koşan ve tayfasına kan kusturan zalim bir kaptan olduğunu fark ediyorsunuz .	kusturan	19	Pres
Dosyanın bütün olarak ilgiyle okunacağını düşünüyoruz .	okunacağını	4	Fut
Bazı geceler kulağımı kapısına dayar , dayak yerken attığı çığlıkları dinlerdim .	dayar	4	Pres
Çevresi gerçekten geniş olan bu genç kız , erkek arkadaş olarak hep hastalıklı , kendisine bakıcılık yapabileceği kültürlü ve bağımlı erkekleri seçiyor .	yapabileceği	16	Fut
İki yıl öncesine kadar senin oturduğun kasanın başında genç bir kız oturuyordu .	oturduğun	5	Past
Dışarının parlak güneş ışığını yansıtarak çoğaltan beyazından bir anda karanlığın içinde bulduk kendimizi .	yansıtarak	4	Pres
Arsel , daha önce Koç Holding'de Enerji ve Maden Grubu Başkanlığı yapmış , Dünya Kamhi Birliği Başkan Yardımcılığı görevine seçilmişti .	seçilmişti	19	Pqp
Çok alışmıştım Kahve'ye belki vazgeçersin almaktan , annem de alıştığı için kalır diyordum kendi kendime .	alışmıştım	1	Pqp
home lideri Recep Tayyip Erdoğan'ı taşıyan uçağın Pekin'e zorunlu iniş yapacağının duyulmasının ardından olayı Türkiye'ye bildirmek isteyen gazetecilerle işadamları arasında kısa süreli bir gerginlik yaşandı .	yapacağının	10	Fut
Ay çoktan batmıştı .	batmıştı	2	Pqp
Ama şimdi o anlatmak istediklerimi nasıl anlatacağımı bilmiyorum .	anlatacağımı	6	Fut
Çok yer kaplamayan bir kitaplık rafıyla ikiye bölünmüş salonda , havagazı yakan şömineyle , salonun bu yanındaki pencerelere doğru uzanan sedirin üzerindeydim .	kaplamayan	2	Pres
Sen de ! Ablasının eğilen başı doğruldu .	doğruldu	6	Past
Öğle yemeğinden sonra kadavra üzerinde yapacağımız çalışmayı asistanıma anlatırken kapı çaldı .	anlatırken	8	Pres
Bu kuruluşlar da paralarını Merkez Bankası veya muhabiri niteliğindeki Ziraat Bankası'nda açacakları hesaplarda toplayacaklar .	toplayacaklar	13	Fut
ikibiniki sonu itibariyle tamamlanmayan projelere ikibinüç'te harcama yapılmayacak .	yapılmayacak	7	Fut
Aaa , diyorlar , kimi elini saygıyla göğsüne bastırıyor kimi de , işte orada duracaksın anlamında ileri doğru uzatıyor ; büyük adamdı .	bastırıyor	8	Pres
Bu yüzden , çaldığı iki ağır türkünün ardından yine kıvrak bir göbek dansına , ya da bir bozlağa geçer , balıkçılar oturmayacak olurlarsa , kaş göz işaretleri yaparak , masalarına gitmeleri gerektiğini anlatırdı .	oturmayacak	21	Fut
O başrolde olmalıdır .	olmalıdır	2	Pres
altı yıl önce Aysun Hanım'la evlenen Ulusu , kaderinin bu denli tesadüfi çizilebileceğini bilemezdi belki .	çizilebileceğini	12	Fut
Kertenkelelerin değiştirdiği derileri duvar diplerinden topladığın çocukluk günlerini hatırlamıştın .	hatırlamıştın	8	Pqp
Bu insanın kaptırıp gidebileceği bir şey .	gidebileceği	3	Fut
Nasıl da zorluyor kapıyı ...	zorluyor	2	Pres
Eski kulübeyi ise mutfak haline getirmişti .	getirmişti	5	Pqp
Yanına annesini de alan Şıkel , " Herkes beni zaten yanlış tanıyor , ne desem boş , inanılmaz derecede bunaldım .	tanıyor	11	Pres
Sanırım o zaman da gelmemişti .	gelmemişti	4	Pqp
Mebrure birden heyecanlanmıştı .	heyecanlanmıştı	2	Pqp
Bu ilişkiyi bitirelim , böyle yürütemeyeceğim , dedi .	yürütemeyeceğim	5	Fut
Kaç kez denemişti ; iki türküden sonra balıkçılar , utangaç hallerinden sıyrılıp , tarihin değil , doğanın kendilerine verdiği niteliği yeğleyerek , masalarda oturan yabancı kadınlara göz süzmeye başlıyorlardı .	süzmeye	27	Pres
Hem daha çok küçük , sen nasıl bakacaksın Kahve'ye .	bakacaksın	7	Fut
Üstelik Kemal'in dediğinde herkesin her şeyini ortaya dökmek yok ki .	dediğinde	2	Past
Oysa kıçlarını kaldırma zahmetine katlansalardı kendilerine bıraktığım dosyada yapacağım deneylerin üreme organlarıyla ilgili olduğunu , gönderilecek kadavranın cinsiyetinin de önemle dişi olması gerektiğini görebilirlerdi .	gönderilecek	15	Fut
Onun bir çocuk olmadığını , takındığı çocuksu tavırların aslında bir maske olduğunu bir tek ben biliyordum .	takındığı	5	Past
Bu yüzden alışveriş bilimini yaratırken antroplojinin katkısı tartışılmaz .	yaratırken	4	Pres
Erten'e , ne de bana ulaşmış değil .	ulaşmış	5	Past
Kadın uyuduysa okur , dedi adam .	uyuduysa	1	Past
Aygün , kredi kartı faiz oranlarının yüzde 118'lere kadar çıktığını , bir aylık ödemenin yapılmaması halinde temerrüdün devreye girmesiyle faiz oranlarının yüzde 375'e kadar yükseldiğini belirterek bunun akılla , Anayasa'yla ve demokrasiyle bağdaşmadığını söyledi .	çıktığını	9	Past
Göğüs ve karın bölgesinde geniş bir daire çizerek , Şuramda kocaman bir delik vardı .	çizerek	7	Pres
Rumların , Kıbrıs Türklerine yönelik uygulayacağı tedbirler ve AB'nin KKTC'yi IMF'nin - AKP'lilerin ederek Türk tarafındaki bazı çevrelere yapacağı yardım , halkta bölünmeye yol açabilir .	uygulayacağı	5	Fut
Bunu yapamayacağını biliyordun .	yapamayacağını	1	Fut
Recep , oğlanın fiyakayla uzattığı sigarayı elinin tersiyle iteledi .	uzattığı	4	Past
Öyle bir felsefe ki bu , kendi içinde bir çelişkiyi taşıyor ; varoluşla yaşamanın birbirine hiç uygun düşmeyeceğini , bu ikisi arasındaki çelişkiyi anlatıyor .	düşmeyeceğini	17	Fut
Yedi saatlik yolculuk boyunca - ki yetmiş kilometre kat edecektik - bir tek eve rastlamanın mümkün olmadığı bir coğrafya .	edecektik	9	Fut
Eriklerden başları dönmüştü .	dönmüştü	2	Pqp
Anne iyice sağlığına kavuşunca bir de ben gidip bu adamı göreyim diye düşünmüş ve kızın peşine takılıp şehrin ucundaki eve gitmiş .	düşünmüş	12	Past
Yolculuk , başka bir kentte olmak , hep karşılaştığım yeni şeyler , derinden derine izini süren heyecan dirilik yaratmıştı bende .	yaratmıştı	18	Pqp
Gözün kanlanmış , sol gözün , dedi Gül Abla .	kanlanmış	1	Past
Eski Devlet Bakanı ve Başbakan Yardımcısı , Toplumcu Kurtuluş Partisi ( TKP ) Lefkoşa Milletvekili Mustafa Akıncı da , " Denktaş'ın , izlediği politikayla Kıbrıs'ı kalıcı taksime götürdüğünü " öne sürdü .	sürdü	30	Past
İnsanların başka türlü , belki de kendileri oldukları , bayağılaştıkları , sıradanlaştıkları , tenlerinin gizini bir süre birbirlerine açıp kapadıkları bütün o antik tapınaklar ...	kapadıkları	19	Past
Sonra , patron olduğunu anımsatmak için , soymakta olduğu patatesleri bırakıp , bir çay doldurdu , masalardan birine geçti , sabahtan beri bakıla bakıla paçavra gibi olmuş gazeteyi eline aldı .	geçti	18	Past
Güvenemem ona , anlıyor musun beni ? Hızlı araba kullanmayı , geceyi , içkiyi ve kadınları seven , arada kadife gibi yumuşayıveren , bazen sessiz ve suskun ...	seven	16	Pres
Oradan oraya seğirtmelerim bitecek , bitip de baş başa kalacak , baş başa kalınca da uzun uzun hayatlarımızın özetlerini çıkarıp bu hayatların görünen ucuna doğru birbirimize el verecek durumda değilim .	kalacak	9	Fut
Üretici güçlerin gelişimine olan etkisi , bu dönemde dolaylıdır .	Üretici	0	Pres
Madem Suna istiyorsunuz , sırf Suna olsun diye az diretmemiştim , Söyledik ya , dedim , kulak asmadınız ki .	diretmemiştim	9	Pqp
Milli Eğitim Bakanı Erkan Mumcu'yla da görüşen Unakıtan , temel eğitimin oniki yıla çıkarılacağı sözü aldı .	çıkarılacağı	13	Fut
Ben susmuyordum : Hayır ! Hayır ! Tavandan üstüme kan damlıyordu .	susmuyordum	1	Past
Anne iyice sağlığına kavuşunca bir de ben gidip bu adamı göreyim diye düşünmüş ve kızın peşine takılıp şehrin ucundaki eve gitmiş .	takılıp	16	Pres
Yargıtay Başsavcısı Sabih Kanadoğlu , Emniyet'ten gelen bilgilerin , DEHAP'ın seçime girebilmek için belirlenen örgütlenme sınırını aşamadığı iddiasını içerdiğini partiye bildirdi .	girebilmek	11	Pres
Yani bu model , bize de uygun düşüyor .	düşüyor	7	Pres
Bir o , bir ben , hiç önceden kararlaştırmadan , kendiliğinden bir o , bir ben , olup bitenleri anlatmaya başladık ... dese diye , sabırsızlana sabırsızlana dinledim onu .	sabırsızlana	26	Pres
bırakın ben götüreyim .	bırakın	0	Pres
Muammer elinde viski şişesiyle belirmişti .	belirmişti	4	Pqp
Ben de yeni kadınlar buluyordum , daha önceleri tanıştığım , bir - iki günlüğüne birlikte olduğum kadınları arayıp onlarla ilişkilerimi sıkılaştırıyordum .	tanıştığım	8	Past
Başka güne alırız doğum günümü .	alırız	2	Pres
Aaa , diyorlar , kimi elini saygıyla göğsüne bastırıyor kimi de , işte orada duracaksın anlamında ileri doğru uzatıyor ; büyük adamdı .	duracaksın	14	Fut
Tatarca uyuyan topraklar anlamına gelen Sibirya'nın bu insan yaşamaz taygasında kızağın kırılması , geyiğin kaçması , hatta avlanan kurtların saldırısı bir bakıma hayata noktayı koymak anlamına geliyordu .	kırılması	11	Pres
Kitaplar eskimemişti belki .	eskimemişti	1	Pqp
Tüm bir kış bozulmadan kalmış karın içinde kenardan köşeden , ağaç aralarından ya da çalı diplerinden yürümüş farklı farklı hayvanların dağlarıydı buralar .	yürümüş	16	Past
Bir arkadaşına İstanbul'dan getirtmişti .	getirtmişti	3	Pqp
Neleri sevmediklerine gelince , müşteri , beklemeyi , kendisine gereksiz soruların sorulmasını , stokta kalmamış ürünleri , okunamayan fiyat etiketlerini ve rahatsız edici hizmeti sevmez .	sevmez	24	Pres
Yürüyelim mi biraz , sakıncası yoksa ?	Yürüyelim	0	Pres
Olası bir savaşta , Türkiye büyük zararlarla karşı karşıya kalacak .	kalacak	9	Fut
Meyhaneye gelip masaya oturunca kravatını çözer , ince ucunu elinin sol bileğine bağlar , kalın ucunu ensesinden aşırtıp sağ eliyle tutardı .	aşırtıp	17	Pres
Sanayi ve Ticaret Bakanı Ali Coşkun Tüketici yasasındaki değişikliğin iki hafta içinde TBMM'ye sunulacağını bildirdi .	sunulacağını	13	Fut
Çoğu , çok kere beni daha çok falan filan bulurlarmış .	bulurlarmış	9	Past
Annenin veya babanın hemen evleneceğini neden aklına getiriyorsun ?	evleneceğini	4	Fut
Haber vermemesi çok tuhaf .	vermemesi	1	Pres
Kapı tokmağını defalarca çalmış .	çalmış	3	Past
Oğlan pantolonunu , gömleğini giyinmiş , donunu kayığın üstüne sermişti .	sermişti	9	Pqp
Esin'le Özer birbirlerine baktılar Özer Prensesi ben koruyacağım ! dedi , Esin de gülümseyerek odanın ortasında dönmeye başladı yeniden : Ben bir prensesim , ben bizim evin prensesiyim . diye mırıldanarak .	koruyacağım	7	Fut
" Yapılan düzenleme , suç türü ve suç tarihi ayrımı yapılmaksızın , tüm hak yasaklamaları için öngörülmüş sürekli bir uygulama niteliğinde olmayıp af yasalarına özgü olduğu biçimde , yalnızca belli tarihe kadar işlenen suçları kapsamaktadır .	işlenen	32	Pres
Nasıl bir viski vereyim sana .	vereyim	3	Pres
üç ) İMKB endekslerine paralel seyir göstermeyi hedefleyen A tipi endeks fonlar : Bu kategorideki fonlar yılı İMKB'deki kayba paralel kapattılar .	hedefleyen	7	Pres
Yani ... günah çıkaralım işte .	çıkaralım	3	Pres
Giderek doğruluğuna inandığım ifade şu olmuştur : Yaşantı , hayat tarzı , evi biçimlendirir .	Giderek	0	Pres
Çöktü koltuğa , pıtır pıtır dökülüyor gözyaşları .	dökülüyor	5	Pres
Yattığı yerde , kumların üzerinde gerinebildiği kadar gerindi .	gerinebildiği	5	Past
Keskin toplum eleştirisi , esprili ve zeki özeleştiri , bir çeşit kara mizah , bilgi düzeylerinin çok üstünde bir entelektüel performans onlarla tanışanları şaşırtır ve çarpar .	tanışanları	22	Pres
İsim değiştiren bir örgütün faaliyetleri ilerde de haber konusu olabileceğine göre , bu konuda bir tavır belirlemek önemli .	olabileceğine	9	Fut
Celal uzaktan kumandayı elimden alıp , yuzelli yıl önce yağmur grisi gökler altında yağmur yeşili çayırlarda bir metre mesafeyle yürüyerek sevişen aşıklar hakkındaki İngiliz TV filmlerinden birini buldu , kumanda aletini aramıza değil öbür yanına koydu .	yürüyerek	19	Pres
Boru hattının geçeceği bölgelerde sivil toplum örgütlerinin de katılımıyla teklif komisyonları kurulacak .	geçeceği	2	Fut
Sonunda Esin Abi şimdi bizim bir köpeğimiz mi olacak ? deyince anlattıklarımın sadece bir kısmını dinlediklerini anladım .	dinlediklerini	15	Past
the , " Irak'ta muhtemel bir çatışmanın Türkiye ekonomisi üzerindeki etkilerini görüşeceğiz .	görüşeceğiz	11	Fut
Bartın'ın karanlık ve sessiz gecesi ikimizi de örtmüştü .	örtmüştü	7	Pqp
Uyum paketinin ele alındığı toplantının ardından açıklama yapan Başbakan Yardımcısı Ertuğrul ' , daha önce otuzaltı madde olarak açıklanan paketin otuziki'ye düşürüldüğünü belirtti .	düşürüldüğünü	21	Past
İşte o zaman , bu turistik yörenin olağanüstü tarihine merak duyanlar , buradaki insanların birkaç bin yıl önceki bir uygarlığın torunları olduğunu bilenler , tarihten bir sahnenin canlanmakta olduğunu sezerlerdi .	canlanmakta	27	Pres
Ayakta alkışladık .	alkışladık	1	Past
Örneğin sakız çiğnememi yasaklıyor .	yasaklıyor	3	Pres
Onu döven adam da şurada , şu ağacın altındaki .	döven	1	Pres
( İsim vermiyorum .	vermiyorum	2	Pres
Erkek delisi olmuş , başına vurmuş yalnızlık .	vurmuş	5	Past
Nereden biliyorsunuz ? diye sordu .	biliyorsunuz	1	Pres
Başbakan Abdullah Gül imzasıyla dün tüm valilere gönderilen genelgede yoksullukla mücadele için ilk adım olarak Ramazan Bayramı öncesi yoksullara ulaştırılmak üzere onsekiz trilyonluk kaynak ayırdığı belirtildi .	ulaştırılmak	19	Pres
Uçağın gövde ( tekne ) sigortasının tüm riskinin Türk Hava Yolları ( THY ) tarafından yabancı reasürans şirketlerine sigorta ettirildiğini bildiren Ray Sigorta Genel Müdürü Ercüment Çetin Alanya , yolcu mali mesuliyeti sigortalarının kendilerinde olduğunu söyledi .	ettirildiğini	19	Past
Kafamın yetmediği fen derslerinde düşünürdüm : Aynı hoca ağabeyime de böyle anlatmış .	düşünürdüm	4	Past
Yapılacak mevzuat değişikliği ile mevzuattaki " sır " kavramı yeniden belirlenecek .	belirlenecek	10	Fut
Olsun , dediler , yeter ki cezan büyük olmasın , gerisi önemli değil .	olmasın	8	Pres
Yıllanmış şarap gibi .	Yıllanmış	0	Past
Biz kızlar Gülce'nin önerisine oy vereceğiz .	vereceğiz	5	Fut
Sesler değişse bile duyguların seslere kattığı tonlamalar değişmez , ne kadar saklamak isteseler de bunu beceremezler , bir köpekten kokularını saklayamayacakları gibi benden de seslerini saklayamazlardı .	saklayamayacakları	20	Fut
Kendinden emin bir biçimde Taşhan'ın kapısını itip içeri girdi .	girdi	8	Past
Çocukluğumuz hep Anadolu'da geçti .	geçti	3	Past
Önlüğü ile iç çamaşırları sıyrılıp karnı açığa çıkmıştı .	sıyrılıp	4	Pres
' seçim döneminde kendisini Çankaya Köşkü'ne çıkaracağı yolunda Milli Görüş tabanına propaganda yaptığını öne süren kapatılan RP'nin Genel Başkanı Necmettin Erbakan'a ' milletvekilleri sert tepki gösterdi .	kapatılan	15	Pres
Ramiz yerine oturana dek de gözlüklerinin üstünden izledi .	izledi	7	Past
Burjuvazinin siyasal devrimlerle iktidarı ele geçirip , hakim sınıf konumunu sağlamlaştırmasıyla birlikte , bilimi , idealizme karşı mücadelede materyalizmin temel mevzisi olmaktan çıkartacak , bilim ile dini barıştıracak yeni bir ideolojik ortam yaratma arayışları baş göstermiştir .	barıştıracak	27	Fut
Seçimden önce dosyası Yargıtay'a gönderilen Akgündüz'ün yargılaması , Siirt'ten bağımsız milletvekili seçilmesi nedeniyle durdurulmuştu .	durdurulmuştu	13	Pqp
Sen de benim yaşıma gel , sana da alırlar göreceksin .	alırlar	8	Pres
Ana'yı arayan yabancı , sizden biraz daha uzun boyluydu , dedi Jul .	arayan	1	Pres
Bahse girebilirdim ki : i ) şu anda Kemal'in ortaya attığı fikirler bugün değilse bile yarın genel kabul görecektir .	attığı	10	Past
Bir hanımefendi sakız çiğnemez , deyip kesip atıyor .	kesip	6	Pres
Giderdik konserlere , tiyatrolara , sinemalara .	Giderdik	0	Past
CHP Genel Başkanı Deniz Baykal da , Kıbrıs yaklaşımı nedeniyle " derin devletin son temsilcisi " diye tanımlanarak protesto edildi .	tanımlanarak	17	Pres
Hey , Ömer , kalk oğlum , geç kalmışız .	kalmışız	8	Past
Bu dönemde , teori , bilimin çeşitli alanlarında , yeni kavramsal yapılanmalarla bilimi yeni düzlemlere taşımış ; geçmişin kavramsal yapılanmalarında köklü bir kopuşla bilimin önünde yeni ufuklar açmıştır .	kopuşla	22	Pres
Zeynep : Yemin ederim ki kimseye bir şey söylemeyeceğim .	söylemeyeceğim	8	Fut
Bana hissettirir bunu .	hissettirir	1	Pres
Mücadele ... diye mırıldandı adam .	mırıldandı	3	Past
Ben akşama vurulacak insanların o sırada neler yaptığını merak ederek cinayet haberlerini kesip dosyalarına koyardım ; arada ilginç bir cinayet çıkarsa , kimin , nerede , nasıl öldürdüğünü yanımda taşıdığım özel cinayet defterime kendim için kaydederdim .	kaydederdim	35	Past
Kendimi katilin yerine koyardım , onun o son anda , tetiği tam çekerken neler hissettiğini anlamaya çalışırdım .	koyardım	3	Past
Ama verdikleri çekleri , ' Nakit ödeme yapacağız ' diye aldılar , beş parasız kaldım .	yapacağız	7	Fut
Oturduğu köşeden bağırıp duruyordu .	bağırıp	2	Pres
Gideceğiz , dedim .	Gideceğiz	0	Fut
Doğu Anadolu'da ulaşımın zor olduğu arazide dev boruların taşınması ve inşaat makinelerinin geçmesi için yapılacak yollar , bölgedeki sarp arazide yeni ulaşım olanakları sağlayacak .	sağlayacak	23	Fut
Türkçe'ye çevrilen konuşmasını ben seslendirmiştim radyoda .	seslendirmiştim	4	Pqp
Bir yerlerde buluşamayacakları besbelliydi .	buluşamayacakları	2	Fut
Başbakanlık'ta gazeteciler ile sohbet eden Şahin , önceki hükümetin memur maaşlarına hedef enflasyona göre zam yapma sözü verdiğini , ancak kendilerinin ikibinüç zammını geçmiş enflasyonlara göre vermeyi planladıklarını söyledi .	vermeyi	26	Pres
Kız içeri girmedi .	girmedi	2	Past
Taşhan'ın kapısını itip içeriye girdim .	itip	2	Pres
Sorumluluk nedir hiç öğrenmemişti ki .	öğrenmemişti	3	Pqp
Süryani Kadim Meryem Ana Kilisesi Vakfı Başkanı Yakup Tahincioğlu ve İstanbul Protestan Kilisesi Vakfı Başkanı Kirkor Ağabaloğlu , yönetmelikle kendi cemaatlerine yine mal edinme hakkı verilmediğini ifade etti .	verilmediğini	25	Past
Bu gece ulaştırmam gerek ...	ulaştırmam	2	Pres
Eee , sen tarlaya yemek götürdün , biz ne yapacağız .	yapacağız	9	Fut
Bir kadınla bir erkeğin oynayabileceği bütün oyunları oynamış , kadınlığı da erkekliği de sonuna kadar yaşamıştık .	oynayabileceği	4	Fut
Kurtulup buraya gelmeyi başardım .	Kurtulup	0	Pres
şaşılaştı gözleri .	şaşılaştı	0	Past
Haftanın sorunsuz atlatılacağı tahmin ediliyor .	atlatılacağı	2	Fut
Damarlarına bir sıcaklık yayılmıştı .	yayılmıştı	3	Pqp
Usulde bir hata yoktu , başvuru reddedilmişti .	reddedilmişti	6	Pqp
Onu tanıyanlar Bakırköy'de en yatmayacak insan diye tanımlıyor .	yatmayacak	4	Fut
Çevreyi araştırırlar .	araştırırlar	1	Pres
Benim sileceğim araba Mersedes , BMW falan olacak .	sileceğim	1	Fut
Gün boyu ormanda odun kesip kamyona yüklemekten yorgun düşmüş dört kişi depoya kamyonu yaklaştırmanın yollarını aradı .	yaklaştırmanın	13	Pres
İnsanlara özgü zannettiğim bir çok özelliğin hayvanlar aleminde de geçerli olabileceğini daha önce hiç düşünmemiştim .	zannettiğim	2	Past
Kardeşinin bilincinin yerinde olduğunu , ancak konuşmadığını ve ailesini sormadığını ifade eden Mehmet Karamutlu , şöyle konuştu : .	konuşmadığını	6	Past
Anneme yeni sınıf arkadaşlarımı çağırmak istediğimi söyledim .	söyledim	6	Past
Kutup porsuğunu ( Gulo gulo l . ) bu adla anıyorlardı .	anıyorlardı	10	Past
Patlıcan , deyimlerimize de girmiştir .	girmiştir	4	Past
Türkler , Çinliler , Moğollar ve Kitaylar arka arkaya saldırıp yirmibeş yıl süren bir savaş sonunda Tunguzları toparlanamayacak şekilde yıktılar .	toparlanamayacak	17	Fut
Ali'yi üzmeden bu köpeği çok sevdiğimi ve ona sahip olabilmek için ne çok engeli aştığımı anlatmalıydım .	anlatmalıydım	15	Past
Örneğin matematikte yüzyıllara dayanmış ve matematiğin gelişmesinde itici güç rolü oynamış kestirimlerin yakın geçmişte kanıtlanmış olması , bazıları tarafından matematiğin altın çağını yaşadığının bir göstergesi olarak kabul ediliyor .	yaşadığının	22	Past
Görünen o ki Bitlis dosyası askeri makamlarca açılmamak üzere çoktan kapatılmıştı .	kapatılmıştı	10	Pqp
Kalktım , sarıldım boynuna , zoraki öptürdü pembeliğini koruyan yanaklarını .	Kalktım	0	Past
Kız pekmezi kaptığı gibi evine koşmuş .	kaptığı	2	Past
Doldurduğu bardağın yarısı boşaldı ağzına .	Doldurduğu	0	Past
Tamam , geliyorum .	geliyorum	2	Pres
Ben Erbakan'ın yanında onun yanlışlarına ortak olsaydım kırk defa bakan olurdum , elli defa genel başkan olurdum .	olurdum	10	Past
70'lere kadar gidebildim .	gidebildim	2	Past
Size kalırsa nal toplayacağız " diye tepki gösterdiler .	toplayacağız	3	Fut
Bila , " Sizinle ilgili izlenimlerimi yazacağım , isterseniz , bu söylediklerinizi de yazayım , ancak teypteki ifadenizi de yazmak zorundayım " karşılığını verdi .	yazayım	13	Pres
Fatih'in , gemileri Haliç'e karadan indirme planının Fatih'in kafasından çıkmadığını , Said Nursi'nin - i de arkasına Nurcu ordularını toplayıp başkente yürüme planları yapmadığını işitiyorsunuz .	indirme	5	Pres
O anlatmak istediklerimi nasıl anlatacağımı bilmiyorum .	anlatacağımı	4	Fut
Demin övüp duruyordun patlıcanı !	duruyordun	2	Past
Yaka takmadığı için Naci Bey birkaç kez kocaman kafasına tahta cetvelle vurmuştu .	vurmuştu	11	Pqp
Arçelik olarak genelde tahminimizin üzerinde iyi bir yıl geçirdik .	geçirdik	8	Past
Oturup sigara yaktım , telaşe halimin geçmesini bekledim .	Oturup	0	Pres
Koha kentinde işçiler için , hiçbir süsü olmayan , içinde ise oturacakların tüm gereksinimlerinin düşünüldüğü evler yaptı .	oturacakların	11	Fut
Kadının eski kocası olduğunu tahmin ettiğim ; kır saçlı , lacivert takım elbiseli bir adam havuzun yanında ayakta duruyor , dalgın dalgın önündeki suyu seyrediyordu .	duruyor	18	Pres
Hayatlarının çizgilerini , hiç değilse çemberlere teğet dokundurabilselerdi .	dokundurabilselerdi	7	Past
Koşup alaca boğayı öpmüş .	öpmüş	3	Past
Yerde araç izinin olmaması ve kamyonun ilerleyecek yol bulamaması , ormanın bu bölümüne kasabadan sıkça gelinmediğini gösteriyordu .	bulamaması	8	Pres
Sonra Kuzey Avrupa'ya yayıldılar .	yayıldılar	3	Past
Annem onun için özel yemek kabı , özel el bezi - daha doğrusu ağız silme bezi - özel örtü , özel paspas gibi tüm eşyaları hazırlamıştı .	hazırlamıştı	25	Pqp
Yorum : Zago'nun tercümanının verdiği bilgiye göre futbolcu , bindokuzyuzdoksandokuz ve ikibinbir yıllarında Corriere dello Sport okurları arasında yapılan oylamayla Roma'nın o yılki en iyi oyuncusu seçilmiş .	oylamayla	19	Pres
Kardeşimin kurtulacağını biliyordum " diye konuştu .	kurtulacağını	1	Fut
Ben ağabeyleri olarak onların rahatını sağlamalı , onları zorluklardan kurtarmalıydım .	sağlamalı	5	Pres
Yola düştük .	düştük	1	Past
Sahnede dans edenler sanki insan değil de tüy gibi geldi bana .	edenler	2	Pres
Üniversiteyi bitirdikten sonra ilk girdiği şirketin müdürü delikanlıya yakın ilgi gösteriyor , baba ilgisi açlığı çeken delikanlı , çocuksu bir ben merkezcilikle müdürün ilgisini bir baba ilgisi olarak algılıyordu : Değerini bilen bir baba .	girdiği	4	Past
Artık duygularının , hastalıklarının ağrılarını kesecek uyuşturucu da olmadığı için neye sığınacağını bilemeyecek hale geliyor .	bilemeyecek	12	Fut
Ben de o gece kardeşlerimin yatma saati gelene kadar uzun uzun köpeğimizi anlattım onlara , ne de olsa o artık evimizin köpeğiydi .	gelene	7	Pres
Asıl düğümü çözmek ve en önemlisi hukuksal alt yapıyı sağlam temellere oturtabilmek için dokümanların tamamına ulaşmak gerekiyordu .	çözmek	2	Pres
Tombul dizleri , masanın altından Mahmut'un dizlerine yapışmıştı .	yapışmıştı	7	Pqp
Mali Barış'tan yararlanacakların hürriyeti bağlayıcı cezalarla ilgili düzenlemeler karşısında sorumlulukları devam etmeli .	düzenlemeler	7	Pres
Adını önce İngiltere ve Amerika'da duyuran Çağlayan , Paris'te yükselen yıldızını , başkentin gözde konser salonlarından ' Salla Gaveau'daki çılgın defilesiyle ' en iyiler ' arasına yazdırdı .	yazdırdı	26	Past
Komutanlar , Cumhuriyet'in temel dayanağı olan laikliği sarsacak gelişmelere ve görüntülere izin verilmemesi gerektiğini vurguladılar .	vurguladılar	14	Past
Yok abi , beyin meyin her şey bitmişti .	bitmişti	7	Pqp
Arınınki petek , kuşunki yuva , ayınınki in ; ama insanın barınağı hemen ev olmamış , çünkü ev başlangıcı barınak olan bir sürecin ifadesi aynı zamanda .	olmamış	14	Past
Yurdundan kopup gelen aile , büyük kentin kendine uygun bir yerinde , önce başını sokacak bir göz oda ve çevrelediği alanın odadan kopuk bir yerinde helasını yapıyordu .	kopup	1	Pres
Ne derdik .	derdik	1	Past
Barajın altında kalan siyasi partiler şoku atlatamadı .	atlatamadı	6	Past
Koşmaktan soluk soluğaydılar .	Koşmaktan	0	Pres
Öğle yemeğinden sonra kadavra üzerinde yapacağımız çalışmayı asistanıma anlatırken kapı çaldı .	yapacağımız	5	Fut
Hiç böyle düşünmemiştim , doğrusu bugüne kadar hiç böyle düşünmemiştim .	düşünmemiştim	9	Pqp
Sesinden tanıyordum kadınların mutsuzluğunu , sanki seslerinin özel bir kokusu oluyordu , kıyılmış tütün kıvamında , yanık gül yaprağı gibi kokuyordu sesleri , daha ilk notasında alıyordunuz kokusunu , bezgin , mesafeli ve biraz da düşmanca bir ses çıkarıyorlardı .	kokuyordu	20	Past
Ben Erbakan'ın yanında onun yanlışlarına ortak olsaydım kırk defa bakan olurdum , elli defa genel başkan olurdum .	olurdum	16	Past
Hazine tarafından dış borçlanmalar için verilebilecek garanti tutarı beşyüz milyon dolarla sınırlandırıldı .	verilebilecek	5	Fut
Yanakları hafifçe pembeleşmişti .	pembeleşmişti	2	Pqp
Bunlar senin Kutup Yıldızı'nın fikirleri , izlemen gereken yol da bu .	izlemen	6	Pres
Kaç kez denemişti ; iki türküden sonra balıkçılar , utangaç hallerinden sıyrılıp , tarihin değil , doğanın kendilerine verdiği niteliği yeğleyerek , masalarda oturan yabancı kadınlara göz süzmeye başlıyorlardı .	denemişti	2	Pqp
Nedenini anlayamadığım bu terk edilme korkusu ve kendime itiraf etmekten bile utandığım hırpalayıcı kıskançlığımla , aptalca olduğunu bile bile daha çok kadınla birlikte oluyor ve sonunda korktuğuma uğrayıp bir başka erkek için terk ediliyordum .	korktuğuma	26	Past
Hadi koşalım .	koşalım	1	Pres
Bu yanıtın düşündüklerimle hiç ilgisi yoktu , ama onunla korkularımı tartışacak bir cesaretim olsa zaten hayatım başka türlü olurdu .	tartışacak	10	Fut
Hazine'nin , bugün düzenleyeceği doksaniki gün vadeli , yirmiiki Ocak ikibinüç Büyükhanlı'nın bono ihalesinde itfa tarihi yirmidört Nisan ikibindört olarak belirlendi .	düzenleyeceği	3	Fut
Düşünmekten vazgeçti .	vazgeçti	1	Past
Kazadaki adam komaya girse , hepsi komaya girecektir .	girecektir	7	Fut
İnsanları ikiye ayırıyor annem ( sayacağı iki kalem de olsa mutlaka parmaklarını avucuna kapatarak sayacak ; birincisi yaşayanlar ( bunlar başkalarını da yaşatıyor ) , ikincisi yaşayanları seyredenler ( bunlar da başkalarının sırtına yük oluyorlar ) .	kapatarak	13	Pres
Yarın akşam , bana burada kaldığım evi bulan - ev de tanıdığım bir profesörün ya - Madam Kuve'ye yemeğe çağrılıyım .	kaldığım	5	Past
Saime Sezginler aylarca çalışmış , kardeşinin arkadaşlarıyla saatlerce konuşmuş , kitaplar tercüme etmiş , ettirmiş ve bir uzmanın sahip olacağı teknik bilgiyi öğrenmişti .	öğrenmişti	22	Pqp
Çok alışmıştım Kahve'ye belki vazgeçersin almaktan , annem de alıştığı için kalır diyordum kendi kendime .	kalır	11	Pres
nasıl anlatacağımı biliyorum , basit : üzülüyordum .	anlatacağımı	1	Fut
içine alır , besler , büyütür , korur .	besler	3	Pres
Park kurşun sesleri ile yankılanmış .	yankılanmış	4	Past
Cumhuriyet'in temel niteliklerinden sapmayacak bir kadroyuz " karşılığını verdi .	sapmayacak	3	Fut
Kamu Personeli Seçme Sınavı Sistemini değiştireceklerini kaydeden Şahin , şimdiye kadar sınavı kazananların haklarının saklı tutulacağını , ancak bundan böyle her yıl ihtiyaç kadar alım için yeni sınavlar yapılacağını belirtti .	yapılacağını	28	Fut
Dinamonun çalıştırdığı telsizden kurulan bağlantı , uçağın ineceği gölü tarif etmişti rehbere .	çalıştırdığı	1	Past
NA'nın on iki basamağında , tıpkı bir bebek gibi duygularıyla tanışmayı öğreniyorlar .	öğreniyorlar	11	Pres
Onların gürültülü neşesi , duyduğum yalnızlık duygularını azaltıyordu , ama neler konuştuklarını da anlamıyordum .	anlamıyordum	13	Past
Sen içebilirsin .	içebilirsin	1	Pres
Ancak , bu amaçla yapılacak düzenlemelerde aksi ispat edilmedikçe mükellef beyanının doğru olarak kabul edileceği şeklinde ve benzeri hükümlere yer verilmemeli .	edileceği	14	Fut
Boru hattının geçeceği bölgelerde sivil toplum örgütlerinin de katılımıyla teklif komisyonları kurulacak .	kurulacak	11	Fut
Bu çekinmesiz , sıcak davranışlı , içinde biriktirdiği derinliği dışa da yansıtmaktan kaçınmayan sarışın kız , gelebileceğini söylemişti .	kaçınmayan	12	Pres
Siz dükkandan çıkıp onların arasına gireceksiniz ve yürümeye başlayacaksınız .	gireceksiniz	5	Fut
- İstemiyorum .	İstemiyorum	1	Pres
Yaklaşık bir ay sonra maestro kürsüsünde kalp krizi geçirip ölecekti , Paris'te .	ölecekti	9	Fut
Mahmut Beyi aramıştım .	aramıştım	2	Pqp
Ağar meydan okudu .	okudu	2	Past
Yanına annesini de alan Şıkel , " Herkes beni zaten yanlış tanıyor , ne desem boş , inanılmaz derecede bunaldım .	bunaldım	19	Past
Onların dallardan yolup yolup attığı erikleri önlüğündeki torbaya dolduruyordu .	yolup	3	Pres
Çıkmak istemez .	Çıkmak	0	Pres
Ancak kapsamı genişletiliyor .	genişletiliyor	2	Pres
Gördüğü , tanıdığı , rastladığı erkekler ...	tanıdığı	2	Past
Öyleyse ben de oturup bir üvey baba masalı yazayım .	yazayım	8	Pres
Baykal'la fotoğraf çektirmek için birbirleriyle yarışan kadınlar , uzun süre sıra beklemek zorunda kaldı .	yarışan	5	Pres
Bütün delilleri , dosyayı inceleme hakkına sahipiz hukuki olarak , fakat bu haktan mahrum edildik .	edildik	14	Past
Gittikleri mekanlar , seçtikleri giysiler , arabalar sürekli değişiyor .	değişiyor	8	Pres
Muammer çayları getirmişti .	getirmişti	2	Pqp
Yolu yarılamıştık neredeyse .	yarılamıştık	1	Pqp
Önce hayatlarının çizgileri teğet değdi birbirine ...	değdi	4	Past
Yaka paça indirdi .	indirdi	2	Past
O halde ? Bilmeyecek ne var ?	Bilmeyecek	3	Fut
Binamıza isim bulmak diye bir mesele çıkmıştı .	çıkmıştı	6	Pqp
Bu yüzden , çaldığı iki ağır türkünün ardından yine kıvrak bir göbek dansına , ya da bir bozlağa geçer , balıkçılar oturmayacak olurlarsa , kaş göz işaretleri yaparak , masalarına gitmeleri gerektiğini anlatırdı .	anlatırdı	32	Past
Bu herhangi bir rahatlama sağlamıyor ki , en fazla o sorunu nasıl çözeceğime ilişkin tavsiye almış oluyorum .	rahatlama	3	Pres
Anlatırım tabii Ayhan .	Anlatırım	0	Pres
Ben de mutlaka tenis öğreneceğim .	öğreneceğim	4	Fut
Cevap vermedim .	vermedim	1	Past
Bu İdaresi epey adam yetiştirmiş .	yetiştirmiş	4	Past
Henüz oraya varmadan önceki ara sokaklardan birinde , göstermek istediğim küçük bir bar vardı .	istediğim	9	Past
Böyle bir saldırıyla karşılaşan bir geyik çobanı sabah , heyecanla olanları anlatmıştı yola çıkarlarken .	anlatmıştı	11	Pqp
Ortada böyle bir ihtimal yokken sen kendi kendine kuruntular yaratıyorsun .	yaratıyorsun	9	Pres
Oysa insan bir kez anımsamaya başlarsa gizlediklerini , beyninin içine giren kurt onu kemirir , yeni korkular , daha büyük , daha dehşetli korkular , en olmayacak düşünceler , günahlar , suçlar yaratır .	anımsamaya	4	Pres
Heyecanlanmıştım birden .	Heyecanlanmıştım	0	Pqp
Lange Leidsewards Straat'da Kierkegaard okuyan kıza , kendisiyle yeniden görüşmekten sevinç duyacağımı söylemiş , ertesi gün öğleye doğru , onun oturduğu sokağın başındaki o güzel , iki katlı kahveye çağırmıştım onu .	çağırmıştım	29	Pqp
Ulaştırma Bakanı Binali Yıldırım da , kazayla ilgili beşi bakanlık , biri THY görevlisi altı kişiden oluşan kaza - kırım ekibi oluşturduklarını ve kaza yerinde incelemelerini sürdüreceklerini kaydetti .	sürdüreceklerini	26	Fut
Sen de benim yaşıma gel , sana da alırlar göreceksin .	göreceksin	9	Fut
Bakanlar Kurulu'nun sosyal yardımları beş kata kadar artırma yetkisi kullanılarak maaş artışının gerçekleştirilmesi düşünülüyor .	gerçekleştirilmesi	12	Pres
Salondan çıkarken herkesin yüzünün güldüğünü fark ettim .	güldüğünü	4	Past
Son zamanlarda anne , hastalanıp yataklara düşmüş .	hastalanıp	4	Pres
Doktorlar kısa sürede kendisini toparlayacağını , ameliyatların iyi geçtiğini söyledi " dedi .	toparlayacağını	4	Fut
Onun güzelliğine duyduğum hayranlıkla başlayan ilişki daha sonra kesin bir cinsel bağımlılığa dönüşmüş ve hep öyle sürmüştü , hatta bir ara artık onun güzelliğini bile fark edemez hale gelmiştim .	gelmiştim	28	Pqp
Evet , ürkütücü , dedi Kerem .	ürkütücü	2	Pres
En yakınımıza bile anlatamadığımız şeyleri ona anlatalım .	anlatalım	6	Pres
Deliği alkolle , haplarla , kokainle , LSD ile ya da eroin ile doldurmam fark etmiyordu .	doldurmam	13	Pres
Artık hiçbir şey avutamaz beni , kendimi kandırabileceğim bir şey yok .	avutamaz	3	Pres
Hiçbir şey anlatamadım , diye acıyla inledi .	anlatamadım	2	Past
Sevilme peşinde koşan ve sevmeyi bilemeyen iki genç , yasal ve yasal olmayan uyuşturucuların etkisiyle sevme oyunu oynayacaklar ve minik bağımlı çocuklar dünyaya getirecekler .	sevme	15	Pres
O barışın temelleri yıllar önce Norveç'te , ormandaki bir dağ evinde atılmıştı .	atılmıştı	11	Pqp
İTÜ'ye girdi ..	girdi	1	Past
Cumhuriyetçi Türk Partisi ( and ) Genel Sekreteri Ferdi Sabit Soyer de " Poor's'un planına halkın sahip çıktığını " söyledi .	çıktığını	17	Past
Komutanlar , Cumhuriyet'in temel dayanağı olan laikliği sarsacak gelişmelere ve görüntülere izin verilmemesi gerektiğini vurguladılar .	sarsacak	7	Fut
Üniversitede hocayız desek Şüpheli kişi olacağız çünkü .	olacağız	5	Fut
Kaybedecek neyim var ki ? diyor yaşlı kadın .	Kaybedecek	0	Fut
İstatistiklere baktığımızda bu seviyenin mevcut belirsizlik unsurlarının ortadan kalkması durumunda ikibinüç yılında da büyük bir olasılıkla test edilebileceğini tahmin edebiliriz .	edilebileceğini	17	Fut
Görmüyorlar mıydı : Girişten mağlup başlıyor , gelişme bölümünün ortasına bile sağ salim varamıyordum ; sonucu da felaket oluyordu bu durumda tabii .	Görmüyorlar	0	Pres
" Kimliği , askeri künyesinden saptanan Tuncer , bekardı .	saptanan	5	Pres
Bakın , şu demir korkulukların ardında görünen kapılar .	Bakın	0	Pres
Bir ara babanızla annenizin ayrılacağından korktunuz .	ayrılacağından	4	Fut
İzzettin Doğan ve Alevi Bektaşi Kültürü Derneği Başkanı Ali Balkız gibi Alevi temsilcileri oturdu .	oturdu	13	Past
Rus sömürgeciler Sibirya'ya adım attıklarında karşılarında savunmasız halkları bulmuşlardı .	bulmuşlardı	8	Pqp
Ama bu düşünceleri neden buraya aktardığım , elbette merak edilecektir ...	edilecektir	9	Fut
Len Ti , işçilerin yeni evlerinden memnun olmadıklarını duydu .	olmadıklarını	7	Past
Cennet bekçisi İrfan oynamayı bırakıp bir köşeye çekilmişti .	çekilmişti	7	Pqp
Ben de o gece kardeşlerimin yatma saati gelene kadar uzun uzun köpeğimizi anlattım onlara , ne de olsa o artık evimizin köpeğiydi .	yatma	5	Pres
Ben konuşsam .	konuşsam	1	Pres
Akşit ise Çin seyahatinden en kazançlı turizm sektörünün çıktığını kaydederek , şöyle konuştu : .	çıktığını	8	Past
Aynada kendimi çok beğendim .	beğendim	3	Past
Zeynep merak ve endişeyle kardeşine baktı : Orhan sen benden bir şeyler gizliyorsun ?	baktı	5	Past
Dünyaya yayabilsek .	yayabilsek	1	Pres
Şimdi birini oradan oraya alarak tayin edeceksiniz , öbürünü açığa alacaksınız , öbürünü sorgulayacaksınız .	alacaksınız	10	Fut
o Köye dönüş projesi başlatılacak .	başlatılacak	4	Fut
Daha sonra babanızın , sizinle yalnızken öleceğinden korktunuz .	korktunuz	7	Past
Kafamı dinleyeceğim " dedi .	dinleyeceğim	1	Fut
Kamu Personeli Seçme Sınavı Sistemini değiştireceklerini kaydeden Şahin , şimdiye kadar sınavı kazananların haklarının saklı tutulacağını , ancak bundan böyle her yıl ihtiyaç kadar alım için yeni sınavlar yapılacağını belirtti .	tutulacağını	15	Fut
Meyhaneye gelip masaya oturunca kravatını çözer , ince ucunu elinin sol bileğine bağlar , kalın ucunu ensesinden aşırtıp sağ eliyle tutardı .	oturunca	3	Pres
Sokağa çıkmamaya hazırlandık .	hazırlandık	2	Past
İhtiyaç olabileceği düşüncesiyle evin etrafında gün boyu bekleyecek on kadar geyik seçildikten sonra diğerleri serbest bırakıldı .	bekleyecek	7	Fut
" Buna rağmen bugüne kadar mülk edinmemizde bize hep azınlık gibi davranıldı ve zorluk çıkartıldı .	edinmemizde	6	Pres
Ben bir hizmet insanıyım , söylerim , söylediğimin arkasından giderim ve bana neye mal olursa olsun ben bununla iftihar ederim .	söylerim	5	Pres
Madem Suna istiyorsunuz , sırf Suna olsun diye az diretmemiştim , Söyledik ya , dedim , kulak asmadınız ki .	istiyorsunuz	2	Pres
Birkaç haftaya kadar geyikler doğurmaya başlayacak .	başlayacak	5	Fut
Hastaneye yatırmışlar kaç defa , biraz düzelir gibi oluyor , ay geçmeden başlıyor daha beter içmeye .	içmeye	15	Pres
Bu rahat davranışlı New Yorklu kız , tedirginlikleri büyütmeye elverişli içimi sakinleştirmişti .	sakinleştirmişti	11	Pqp
İkilinin elinde Askeri Savcılığın verdiği takipsizlik kararı ve KKK Uçuş Emniyet Kurulu'nun düzenlediği müşterek kanaat raporu vardı .	düzenlediği	12	Past
Ölüsünü eve getirdiklerinde , diyorum , elimi masanın hizasında tutarak , şu kadarcık bir çocuktum .	tutarak	9	Pres
Bakanlar Kurulu , kamu personeline ödenecek aylık ve ücretlerin belirlenmesinde esas alınacak katsayılar ile sözleşme tavan ücretlerini gelecek hafta belirleyecek .	belirleyecek	19	Fut
Alışveriş merkezlerinde raf etiketinde belirtilen fiyatla kasa fiyatı arasında farklılık olması durumunda satışın tüketici lehine olan fiyat üzerinden yapılması öngörülüyor .	öngörülüyor	19	Pres
Türkiye'nin yapacağı hibe ve yardımlarla ilgili olarak da Cumhurbaşkanı ve Başbakan'ın yetkileri saklı kalmak kaydıyla hükümetin belirleyeceği kişi ve kuruluşlar yetkili olacak .	belirleyeceği	16	Fut
Ara ara aklıma takılan soruları da anlatır gibi , ona mı , kendime mi , bilmeden sordum .	anlatır	6	Pres
İşi şakaya vurdum , iyi ya , dedim , Ceza'nın cezası da bitse keşke ; kimbilir daha kaç tanker şarap içmem gerekecek .	vurdum	2	Past
Diskoteği sandığı kadar ürkütücü bulmadı , belki de gençlere uyum sağlamak için ister istemez içtiği iki kadeh viski yüzünden .	bulmadı	4	Past
Sobanın üstünde içme suyuna dönüşecek daha sonra bunlar .	dönüşecek	4	Fut
Kahve iyi gelirdi .	gelirdi	2	Past
İyi ki ordu sesini yükseltti , şimdi ne yapacaklar bakalım , deyip bekledik .	yapacaklar	8	Fut
Annemle babam benimle ilgilenmiyor demek istemiyorum ; ama ben onlarla daha fazla birlikte olmak istiyorum .	istemiyorum	5	Pres
Cami avlusundan koşarak çıktılar .	çıktılar	3	Past
Nereye gitmiş olabilir Osman .	gitmiş	1	Past
Toplantılarda masrafın bölüşülmesi kuralını da sanırım Atila Sav önermişti .	bölüşülmesi	2	Pres
Dağdaki üç beş bin - silahlı adamın , geleceğini tehdit edemeyeceğini anlıyor .	edemeyeceğini	10	Fut
Yaz nasıl içinden geliyorsa .	Yaz	0	Pres
Ama çoğunun teorileri tartışılır olmaktan çıkmıştı ...	çıkmıştı	5	Pqp
Ailesinden kalan , harcasa harcasa bitiremeyeceği kadar çok parası olan bu kadınla tanışmamın öyküsü bile tek başına bir kitap konusu olabilir .	bitiremeyeceği	5	Fut
Oysa kıçlarını kaldırma zahmetine katlansalardı kendilerine bıraktığım dosyada yapacağım deneylerin üreme organlarıyla ilgili olduğunu , gönderilecek kadavranın cinsiyetinin de önemle dişi olması gerektiğini görebilirlerdi .	yapacağım	8	Fut
Neden yeni alternatifler üretilemedi .	üretilemedi	3	Past
- İstemesen de gidelim .	İstemesen	1	Pres
Dört yıl depoda bekleyen ve soğuk duvarların arasında hapsedilen geçmişim , bana dünyayla arasına duvarlar ören bir masal ülkesini hatırlattı .	hapsedilen	8	Pres
" Söz konusu meblağ sosyal yardımlaşma ve dayanışma vakıflarına gönderilmiştir .	gönderilmiştir	9	Past
Erdoğan'ın milletvekili ve başbakan olmasını sağlayacak düzenlemede , Sezer'in karşı çıktığı , doğrudan başbakanlık getirecek yüzdokuz . madde yerine ara seçimi düzenleyen yetmişsekiz . madde üzerinde değişiklik yapacaklarını belirten Şahin , şu mesajı verdi : .	getirecek	14	Fut
Oktay Sarıtop nazik bir dille kaleme aldığı eleştirisinde " Türkiye'nin en iyi gazetesi olan Milliyet'i her zaman takdir ettiğimi bilmenizi isterim " diyor .	isterim	20	Pres
Anlatacağım öyle bir şey ki !	Anlatacağım	0	Fut
( Hızlı ve kolay kazanılmış parayı tüketmek için aşırı bir enerji harcıyor ; para sayesinde istedikleri her şeyi yapabileceklerini sanıyorlar .	yapabileceklerini	18	Fut
Görgü tanığı köylüler , uçakların havada çarpıştıktan sonra yere çakıldığını ve gökyüzünde açılan paraşütler gördüklerini söyledi .	çakıldığını	9	Past
İrem sarılık olduğu için İstanbul'a gitmişlerdi " diye konuştu .	gitmişlerdi	5	Pqp
Ayrılıkların hüzünleriyle yeni birlikteliklerin neşesi birbirine karışıyor , aynı günde birkaç duyguyu bir - iki saat arayla yaşıyordum .	yaşıyordum	17	Past
Berkeley ve yazarlarının savlarının , benzerliğine demeyeceğim , aynılığına dikkat ediniz !	demeyeceğim	6	Fut
Ford , yeni yasadaki " yerlilik tanımı " kapsamına girmediği için açılan yeni yemek ihalelerine katılamayacak .	katılamayacak	15	Fut
Ancak , duvarların boşluğu sınırlandırması , her yapıda , özellikle evde , o hacmi mekanlaştırmaz .	mekanlaştırmaz	14	Pres
Evenleri , modern dünya insanına göre daha bağımsız kılıyordu bu durum .	kılıyordu	8	Past
Bu kuruluşlar da paralarını Merkez Bankası veya muhabiri niteliğindeki Ziraat Bankası'nda açacakları hesaplarda toplayacaklar .	açacakları	11	Fut
Anladım ki bu taşınma kararımdan hoşnut , doğallaştırıp sıradanlaştırmaya çalışıyor , ama nafile , ben başlayacak bu yeni beraberliğin taze heyecanını bastıracak halde değilim .	bastıracak	21	Fut
Yanında oturan annesinin , ağzına zorla tıkıştırdığı lokmayı bir hamlede yuttu ; parmakları darbukanın derisini okşadı ; başını çevirip , arkası dönük oturduğu sahneye baktı .	oturduğu	22	Past
Ramiz hala anlatmakta diretiyor : Evde yemek götürecek kimse yoktu , diyor , sonra annem bana ...	götürecek	7	Fut
Herkesin vicdanına yükleniyorsun .	yükleniyorsun	2	Pres
Geldik ! diye bağırdı Kerem .	bağırdı	3	Past
Ben dün gece siz yattıktan sonra evden kaçtım .	kaçtım	7	Past
Kibirli , kendisinin en zeki olduğuna inanan ben merkezci kişinin birilerini kendisine rehber seçmesi mümkün değildir .	seçmesi	13	Pres
Dere yatağından getirilip köpeklerin erişemeyeceği bir yükseklikteki kütük setin üstüne istiflenmiş buz bloklarından bıçağıyla kopardığı parçaları kovaya dolduruyor .	erişemeyeceği	4	Fut
Zamanı geldiğinde Saffet ile Recep sahnede yerlerini aldılar .	aldılar	7	Past
Ne soracağımı anlamıştı , sor , dedi gönülsüzce .	soracağımı	1	Fut
Demek ki ; toplumların kültür ve yaşantı farklılıkları ortadan kalktıkça , yörelerdeki yapı teknolojisi benzeştikçe ve yapı endüstrisinin durumu benzeşip , malzemeler aynılaştıkça , evlerin farklılığı ortadan kalkabilir .	kalkabilir	27	Pres
Bir o , bir ben , hiç önceden kararlaştırmadan , kendiliğinden bir o , bir ben , olup bitenleri anlatmaya başladık ... dese diye , sabırsızlana sabırsızlana dinledim onu .	sabırsızlana	25	Pres
Cumartesi günü de Singapur'dan dönmüştü .	dönmüştü	4	Pqp
Şimdi bu büyük korkunuzu yaşayacaksınız .	yaşayacaksınız	4	Fut
Taşhan'ın duvarına yaslandı .	yaslandı	2	Past
Bugün doksaniki gün vadeli referans bono ihalesi ile piyasaların önüne çıkılacak .	çıkılacak	10	Fut
Oraya nasıl ulaşılacağını , nereden gidileceğini hiç bilmiyorum .	gidileceğini	5	Fut
Bu da bölgedeki ticarete katkıda bulunacak .	bulunacak	5	Fut
Oysa insan bir kez anımsamaya başlarsa gizlediklerini , beyninin içine giren kurt onu kemirir , yeni korkular , daha büyük , daha dehşetli korkular , en olmayacak düşünceler , günahlar , suçlar yaratır .	gizlediklerini	6	Past
Ben bir dolaşıp geleceğim , dedim .	geleceğim	3	Fut
Siz , sonsuza dek yürüyeceksiniz .	yürüyeceksiniz	4	Fut
Şostakoviç dinleteceğim sana .	dinleteceğim	1	Fut
Şangır ! Oldu işte , battı ortalık .	Oldu	2	Past
Ufaklık için de bir açıklamaya ihtiyacım olacaktı belli ki Köpek de nöbetçimiz olacak .	olacaktı	6	Fut
Konuşmayı biraz uzatır , işlerin yoğunluğundan filan söz edersiniz .	uzatır	2	Pres
Güneş ağaçların arkasına inerken kasabaya yollandı kamyon .	yollandı	5	Past
Buraya uğra , bir kadeh içtikten sonra , kentin merkezine ineriz .	uğra	1	Pres
Oğlunuza aldığınız o kitabın arkasını okurken , kendinize , gerçek korkularınızı sordunuz , anımsayın .	sordunuz	11	Past
Sloganla çarpıcı tanıtma yapmaya çalıştım .	tanıtma	2	Pres
Onların dallardan yolup yolup attığı erikleri önlüğündeki torbaya dolduruyordu .	attığı	4	Past
Yerde araç izinin olmaması ve kamyonun ilerleyecek yol bulamaması , ormanın bu bölümüne kasabadan sıkça gelinmediğini gösteriyordu .	ilerleyecek	6	Fut
Bu sözler , Batılı yiyecek ve tedavi kültürünün Evenlere ulaşmadan önceki durumu özetliyordu aslında .	özetliyordu	12	Past
Onların gürültülü neşesi , duyduğum yalnızlık duygularını azaltıyordu , ama neler konuştuklarını da anlamıyordum .	konuştuklarını	11	Past
Eve geldiklerinde de çok yorgundurlar veya yapacakları bir şeyler vardır .	yapacakları	6	Fut
Sokaklar birbirine karıştı .	karıştı	2	Past
Daha da kötüsü , bu gerçeği bilmeme rağmen , her seferinde elimde olmadan hep aynı şeyi yapıyordum , bunun önüne geçemiyordum .	geçemiyordum	20	Past
Hazine , bugün doksaniki gün vadeli referans bono ihalesi düzenleyecek .	düzenleyecek	9	Fut
Sırtına yapışan kumlar , otlar bile uyandıramadığına göre çok yorgun olmalıydı .	yapışan	1	Pres
Kargadan korkan darı ekmez .	korkan	1	Pres
Ürünlerinizin konuşulduğu bir atmosfer yaratabiliyorsanız , ürün kendi kendini satacaktır .	satacaktır	9	Fut
Gerçekten de bu bin yılda önce evrenin merkezinde değil , Güneş etrafında dönen sıradan bir gezegende olduğumuzu öğrendik ; sonra sıradan bir canlı türü olduğumuzu .	olduğumuzu	16	Past
ÖDP'nin sempozyum , konser , panel gibi etkinlikleri duyurmak için bastırdığı bazı afişler de seçim yasakları kapsamında sayıldı ve polis tarafından toplatıldı .	sayıldı	17	Past
" Gönüllü " uygulanacak projeye göre , " zorunlu " olarak boşaltılan köylere dönüş imkanı verilecek , " terörden " mağdur olan köylülere tazminat ödenecek .	ödenecek	24	Fut
Ayhan bitirmiş İTÜ'yü , tamir edemiyor bir basit ütüyü ...	bitirmiş	1	Past
İşçi Partisi ve Aydınlık gazetesinin çeşitli davaları dahil belalı denebilecek pek çok davayı alıp , üzerine gitmekten çekinmiyordu .	denebilecek	9	Fut
Onu en iyi okullarda okuttum diyerek kendisini rahatlatma yollarını arıyordu .	okuttum	4	Past
Dil bükmüş , bize uydurmuşuz .	uydurmuşuz	4	Past
Çok sevineceğim .	sevineceğim	1	Fut
Evet , dayanamıyorum .	dayanamıyorum	2	Pres
O gün çaya karıştırılacak miktarı çarçabuk sağıp , soğuktan üşüyen ellerini sıvazlayarak içeri koştular .	karıştırılacak	3	Fut
Örneğin , annelerin bebek arabalarını rahatça sürecek genişlikte koridorlar olmaması 20'li 30'lu yaşlarındaki kadın müşteri kitlesinin bu mağazayı tercih etmemesine neden olacaktır .	olacaktır	21	Fut
Yaklaştım yanına .	Yaklaştım	0	Past
Güneş batarken ve eylül rüzgarları kuruyan otların üstünde belli belirsiz gezinirken buluşmalıydınız .	buluşmalıydınız	11	Past
Bugün iyice kalabalıklaşan kervan altı saatlik yolculukla kasabaya ulaşacak .	ulaşacak	8	Fut
Bir defasında laf oraya gelir gibi oldu , derhal , halledilmemiş bir başka tartışmayı açarak herkesi sürükledim .	sürükledim	16	Past
Kızakları geyiklere bağlayan deri kayışları gözden geçirdi Yura .	bağlayan	2	Pres
Kışkırtıcıların , provokatörlerin sesleri duyulmuyor .	duyulmuyor	4	Pres
Bir süre kepenkleri inmiş dükkanların önünden yürüdüm , gece zamanı karanlık ve sessiz duran şadırvana bir göz attım .	yürüdüm	6	Past
Elini , rengi atmış kirli beyaz , uzun donunun içine soktu , orasına burasına yapışmış kumları temizledi .	soktu	10	Past
Çöktü koltuğa , pıtır pıtır dökülüyor gözyaşları .	Çöktü	0	Past
Ne ondan bahsedebildim , ne yaşadıklarımdan ...	yaşadıklarımdan	5	Past
Halbuki arada gidip günah çıkardın mı , kendini bir miktar yırtmış hissediyorsun , temizlenmiş hissediyorsun , aynı haltı yiyeceğini bilsen bile bir güvencen var .	yırtmış	10	Past
Dünyada düşünülecek onca güzel şey varken , senin kuruntular yaratman ve onların içinde bunalman akıl alacak gibi değil .	yaratman	9	Pres
Beni tanır , gelip karşısına oturduğumu hisseder .	tanır	1	Pres
Orada olmalıyım şimdi .	olmalıyım	1	Pres
Şimdi hiçbir şeye yaramadıklarını düşünsem de , yaşayabilmek için yazmak ! Böylece , o beklemekle , aramakla , bütün bu zaman parçalarını dolduracak olan boşlukla ve sıkıntıyla dolu yaşam çizgimi belirledim sanıyorum .	dolduracak	22	Fut
Hey , Ömer , kalk oğlum , geç kalmışız .	kalk	4	Pres
Tanrı öldü ve biz sokağa bırakıldık .	öldü	1	Past
CHP desteğini sürdürdü , vetolu yasa yine Köşk'e gitti .	sürdürdü	2	Past
Bütün bunlara rağmen , Sav familyası imajını zedelemeyerek aynı okulları bitirdim ben de .	bitirdim	10	Past
Kardeşinin bilincinin yerinde olduğunu , ancak konuşmadığını ve ailesini sormadığını ifade eden Mehmet Karamutlu , şöyle konuştu : .	sormadığını	9	Past
Az ilerde , sokağın başında kapısı kapalı duran Taşhan beni bir mıknatıs gibi kendine çekiyordu .	çekiyordu	14	Past
İnşaat ortamına ve getireceği değişikliklere alışması için hazırlanan tanıtım filmi ile alıştırılacak ve bilgilendirilecek olan köylüler , çalışma ekiplerine hizmet satabilecekler .	bilgilendirilecek	13	Fut
Göğüs geçiriyordu ara sıra .	geçiriyordu	1	Past
Şirket aleyhine bir tazminat davası olacaktı .	olacaktı	5	Fut
Muhalifleri , halkın yüzde kırk bir buçuğunun oy desteğine mazhar olmuşlarsa , bu sonuca asla razı olmuyorlar .	olmuyorlar	16	Pres
" Gönüllü " uygulanacak projeye göre , " zorunlu " olarak boşaltılan köylere dönüş imkanı verilecek , " terörden " mağdur olan köylülere tazminat ödenecek .	uygulanacak	3	Fut
Olacakları bilmiştim edasıyla başını usul usul sallıyordu .	bilmiştim	1	Pqp
Dün gece , insanlar hakkında bazen acele hüküm verdiğimi kavradım .	verdiğimi	8	Past
Kırılacak kızım yavaş .	Kırılacak	0	Fut
Diyarbakır'da bir inşaat firmasında proje müdürü olarak çalışan inşaat mühendisi Servet Karadağ , evlendikten sonra da eşini yanından hiç ayırmadı .	evlendikten	13	Past
Sabah olup da saatimin zili çaldığında kuşlarla gökyüzünde bale yaparak uçuyordum .	uçuyordum	10	Past
Kamulaştırmalarda , inşaatın kontrolörlüğünü yapacak olan İngiliz BP'nin isteği üzerine ' uluslararası standartlar ' uygulanacak .	uygulanacak	14	Fut
Yürüdüğümüz yol bitmiş , daha dar bir sokak açılmıştı önümüzde .	açılmıştı	8	Pqp
Sonunda elde kalanın doyum mu , doyumsuzluk mu olduğuna karar veremediğin , tütsülerin savrulduğu anıt - mezarlar ...	veremediğin	10	Past
J , ziyareti sırasında Türkiye ekonomisinin genel durumu üzerinde de duracaklarını ifade etti .	duracaklarını	10	Fut
Balıkların parasını ödeyecekler .	ödeyecekler	2	Fut
Yaşamının son dönemlerinde kendini dine ve astrolojiye veren Newton'un , İngiltere'deki meşruti monarşiden esinlenerek formüle ettiği hızlaştırma çözümü bu açıdan tipik sayılabilir .	sayılabilir	21	Pres
Ayrılıkların hüzünleriyle yeni birlikteliklerin neşesi birbirine karışıyor , aynı günde birkaç duyguyu bir - iki saat arayla yaşıyordum .	karışıyor	6	Pres
Eski Devlet Bakanı ve Başbakan Yardımcısı , Toplumcu Kurtuluş Partisi ( TKP ) Lefkoşa Milletvekili Mustafa Akıncı da , " Denktaş'ın , izlediği politikayla Kıbrıs'ı kalıcı taksime götürdüğünü " öne sürdü .	izlediği	22	Past
Bir boşluğun içindeydim ve tutunabileceğim bir şey yoktu .	tutunabileceğim	4	Fut
Kanım birden beynime fırladı , kafatasımı dağıtarak tavana doğru fışkırmaya başladı .	fırladı	3	Past
Başbakan Yardımcısı Mehmet Ali Şahin , Biriçim lideri Recep Tayyip Erdoğan'ın başbakanlığıyla ilgili olarak Anayasa'nın yüzdokuz . maddesinde değişiklik yapılmasına karşı çıkan Cumhurbaşkanı Ahmet Necdet Sezer ile sürtüşmemek için diğer maddelerde değişiklik yapacaklarını söyledi .	sürtüşmemek	27	Pres
On sekiz yaşında sırasıyla , içki , kokain ve eroinle tanışıyor .	tanışıyor	10	Pres
Askerler , Anayasa çiğnendi diye rejime müdahale etmişler , sonra da Anayasayı toptan kaldırarak yeniden başka bir metin yazdırmışlardı .	yazdırmışlardı	18	Pqp
Bütün bu olasılıklardan daha da can sıkıcı olanı , zamansız uyanan ayıların civarda olabileceği endişesiydi .	olabileceği	13	Fut
Kalmayız , dedi , koşa koşa gideriz , erikleri de senin heybene doldururuz .	doldururuz	12	Pres
Fatih'in , gemileri Haliç'e karadan indirme planının Fatih'in kafasından çıkmadığını , Said Nursi'nin - i de arkasına Nurcu ordularını toplayıp başkente yürüme planları yapmadığını işitiyorsunuz .	toplayıp	19	Pres
Madde kullanımı arttıkça acı eşiği de intihara , ölüme varana kadar yükseliyor .	yükseliyor	11	Pres
Biri kazanmış .	kazanmış	1	Past
Keşke duymasaydım .	duymasaydım	1	Past
Zekametre yok ki ölçülsün .	ölçülsün	3	Pres
Sevgilinin ışıksız pencerelerine uzaktan bakarken kalbim böyle küt küt atmamıştı .	atmamıştı	9	Pqp
Bakalım daha nelere sokacak Grek burnunu ...	sokacak	3	Fut
Kız aklımdan çıkıp gitmişti .	gitmişti	3	Pqp
Dondurmacıya beklemesini söylediler .	söylediler	2	Past
Buz kesiyorum gitgide , aldırdığı yok .	aldırdığı	4	Past
Serpilip gelişemedi .	gelişemedi	1	Past
Sesinden tanıyordum kadınların mutsuzluğunu , sanki seslerinin özel bir kokusu oluyordu , kıyılmış tütün kıvamında , yanık gül yaprağı gibi kokuyordu sesleri , daha ilk notasında alıyordunuz kokusunu , bezgin , mesafeli ve biraz da düşmanca bir ses çıkarıyorlardı .	çıkarıyorlardı	38	Past
Bağımlıların en önemli özelliği , tıpkı bir çocuk gibi ben merkezci olmaları ve kimsenin kendilerini anlayamadığını sanmaları .	sanmaları	16	Pres
İki adım yürümüştüm ki , Ceza ! diye seslendi .	yürümüştüm	2	Pqp
Bu kızgınlığım yüzünden sana normal davranamıyorum .	davranamıyorum	5	Pres
Çok yakışıklıydı , hemen fark etmiştim .	etmiştim	5	Pqp
Bir kadınla bir erkeğin oynayabileceği bütün oyunları oynamış , kadınlığı da erkekliği de sonuna kadar yaşamıştık .	yaşamıştık	15	Pqp
Tamam ! tamam ! Hadi çabuk anlat , meraktan öleceğim .	öleceğim	9	Fut
Uçak seferlerini de artıracağız .	artıracağız	3	Fut
Birçok durumda onların satın almayacakları birşeye bakmalarını sağlamak çok zordur .	almayacakları	4	Fut
Ben yavrumdan nasıl ayrılırım ? Onu nerelere gönderirim ? diye adamın ayaklarına kapanmış zavallı kadın .	gönderirim	7	Pres
maddeyi değerlendirmeye ağırlık vereceğiz .	vereceğiz	3	Fut
Felsefe bölümünü bitiren Alev çok iyi İngilizce ve Fransızca konuşuyor .	bitiren	2	Pres
Tecrübeli editör kesiminin görüşü , " mesele , yayın ilkeleri arasına bunu katmak değil , pratikte ne yapılacağının iyi bilinmesi ve eğitimin önemidir " şeklinde .	bilinmesi	19	Pres
Artık Beyoğlu'na , geceleri içki içmek için çıkışları azaltmıştım .	azaltmıştım	8	Pqp
Buna göre bakanlık soruşturmayı yenileyebilirdi .	yenileyebilirdi	4	Past
Sürekli olarak bir duygudan bir başkasına atlamak , hiçbirini tam yaşamadan , hepsini şöyle bir hissedip geçmek beni yormaya başlamıştı .	yaşamadan	10	Pres
Kırmızı yandı , arabalar duruyor .	duruyor	4	Pres
Buna sorun çözme diye bakamazsınız .	bakamazsınız	4	Pres
Bir romanda anlatılmaya değmeyecek kadar bildik , binlerce yıldan beri yaşanan duygulardı bunlar , ama deneyimlerim bana bir şey öğretmişti : En korkunç gerçekler , söylenmeye değmeyecek kadar basit olan bildik gerçeklerdi .	bildik	5	Past
Ağabeyinizi öldürmek ya da kanın fışkırışını görmekten çok , bu düşüncenizin başkalarınca bilineceğinden korktunuz .	bilineceğinden	12	Fut
ikibiniki sonu itibariyle tamamlanmayan projelere ikibinüç'te harcama yapılmayacak .	tamamlanmayan	3	Pres
- Niye çizgi - roman kahramanının hayatını yazıyorsun peki , çizgi - roman kahramanının çizilmesi gerekmez mi .	çizilmesi	14	Pres
Bayındır Sokak'taki bekar evimden çıktım .	çıktım	4	Past
Esin de Özer de Uykudan Önce programı gibi dinlediler anlattıklarımı , bir yandan esniyorlardı bir yandan da gözleri sevinçle parlıyordu .	esniyorlardı	13	Past
Bazı Cumhuriyet Bebeleri hükümete girdiler .	girdiler	4	Past
Mezarların yanına konan tuz ve çamurlu suyun yaraları iyileştirdiği iddiaları da yayılınca , " kömürlüğe " Türkiye'nin her yanından insan akmaya başlamıştı .	iyileştirdiği	8	Past
Bana bak , geliyorum yanına ha , kalk haydi !	geliyorum	3	Pres
Artık hiçbir şey avutamaz beni , kendimi kandırabileceğim bir şey yok .	kandırabileceğim	7	Fut
Zor şey oraya yeniden girebilmek .	girebilmek	4	Pres
Eşi geri döndükten sonra da bir süre İstanbul'da kalmayı planlayan genç kadın , aniden fikir değiştirip dönmeye karar verdi .	döndükten	2	Past
Rum Kesimi'nin AB'ye üye olması durumunda Türkiye - AB ilişkilerinde sürekli sürtüşme yaşanacak .	yaşanacak	12	Fut
Oysa tebligat yapılmamıştı .	yapılmamıştı	2	Pqp
O parktan kurtulana pek rastlamadım .	kurtulana	2	Pres
Ne kadar zengin olursan ol , diyor , seyirci olduktan sonra ( al işte Nurettin Bey ; sattı yedi , sattı yedi şimdi beş parasız , onun bunun eline bakıyor ) sıfırı tüketirsin .	bakıyor	29	Pres
Son defa da aynı yokuşun başında durup ışıklı pencerelere bakmıştım .	bakmıştım	9	Pqp
Eroin bağımlılarıyla iki ay süren çalışmam boyunca onlardaki zeka pırıltıları beni etkiledi .	çalışmam	5	Pres
Yaşamı çekilmez hale getiriyorsunuz .	getiriyorsunuz	3	Pres
Ağlamaya başladım .	başladım	1	Past
Uçağın tam inişi sırasında yolculardan birinin cep telefonu açtığının tespit edildiğini bildiren Yıldırım , " Cep telefonunun açılmaması gerekirdi .	gerekirdi	18	Past
Böylece kazanları Hablemitoğlu ürünümüze katma değer kazandıracağız .	kazandıracağız	6	Fut
Komşuların kapılarını teker teker çalıp iş istemiş .	istemiş	6	Past
Nasıl başlayacağımı bilemiyorum .	başlayacağımı	1	Fut
Kemal'in sözlerini tekrarlayarak , sevgilinin uyurkenki beş ayrı halini yirmisekizer , Hülya'nın gözkapaklarına çöküp toplanan buğunun renklerini otuzbeşer defa gözlerimin önünden geçirdikten sonra , uyuyamayacağımı anlayıp doğruldum .	tekrarlayarak	2	Pres
Ve bir ilkokul öğrencisiyle , yirmilerindeki bir kadının aşkına hiç kimse artık hiçbir şey söyleyemeyecek .	söyleyemeyecek	14	Fut
" Buna rağmen bugüne kadar mülk edinmemizde bize hep azınlık gibi davranıldı ve zorluk çıkartıldı .	davranıldı	11	Past
Kabaklık eden adama kabak demeyin .	demeyin	4	Pres
Bakın soluk soluğa kaldınız .	Bakın	0	Pres
Yeğenlerin Zübeyde Halayı unutmalarını hoş görmek gerekir , kolay olmuyor bu işler .	unutmalarını	3	Pres
Önlüğü ile iç çamaşırları sıyrılıp karnı açığa çıkmıştı .	çıkmıştı	7	Pqp
Bir cumartesi sabahı kahvaltıda annem bana iyi bir haber vereceğini söyledi .	vereceğini	9	Fut
Olacakları bilmiştim edasıyla başını usul usul sallıyordu .	sallıyordu	6	Past
Sevgilinin ışıksız pencerelerine uzaktan bakarken kalbim böyle küt küt atmamıştı .	bakarken	4	Pres
Kaçtım , kurtuldum oradan , diyordunuz , dedi .	Kaçtım	0	Past
Nesnel bir gerçekliğin ve buna ilişkin nesnel yasaların varlığının kabulü , bilginin doğruluğunun ölçütünün pratik olması ilkesini beraberinde getirir .	getirir	18	Pres
Böyle bir saldırıyla karşılaşan bir geyik çobanı sabah , heyecanla olanları anlatmıştı yola çıkarlarken .	çıkarlarken	13	Pres
Yapılacak mevzuat değişikliği ile mevzuattaki " sır " kavramı yeniden belirlenecek .	Yapılacak	0	Fut
Acı çekmemek için duyguları öldürmek gerekiyor .	çekmemek	1	Pres
O parktan kurtulana pek rastlamadım .	rastlamadım	4	Past
Belki bir daha hiç giremeyeceğim oraya .	giremeyeceğim	4	Fut
Harun Yahya ve yazarlarının herbiri sanki reenkarnasyona uğramış Berkeley ! İlgili okura , Bertrand Russell'ın Türkçe'ye de çevrilmiş olan The History of Western Philosophy adlı kitabının Berkeley bölümünü okumalarını salık veririm .	okumalarını	28	Pres
Diyarbakır'da yaşanan uçak kazasında yaşamlarını yitiren insanların yolcu sorumluluk sigorta tazminatları yaş , eğitim , gelir düzeyi ve sosyal statüko gibi özelliklere göre belirlenecek .	belirlenecek	23	Fut
Kahveden çıkarak alana doğru yürüdük .	yürüdük	4	Past
Oğlan kurulmuş yay gibi fırladı yerinden : .	kurulmuş	1	Past
Bonnor : Fiziksel bir süreci betimlemeye çalışan matematiksel bir modelde ortaya çıkan tekillik genellikle kuramın çöktüğüne işaret eder .	eder	17	Pres
Mezarların yanına konan tuz ve çamurlu suyun yaraları iyileştirdiği iddiaları da yayılınca , " kömürlüğe " Türkiye'nin her yanından insan akmaya başlamıştı .	yayılınca	11	Pres
Kız başka gidecek yeri olmadığından damda yaşamaya başlamış .	gidecek	2	Fut
Bugünün Türkiye'sinde yaşayanlar çözecekler Türkiye'nin sorunlarını .	çözecekler	3	Fut
Ailesinden kendisine büyük bir miras kalmış olan karısını , türlü numaralar çevirip Bakırköy Akıl Hastalıkları Hastanesi'ne yatırıyor .	çevirip	11	Pres
Melek kaç tane sattın ? diye yaklaştı Memo .	yaklaştı	6	Past
Siz dükkandan çıkıp onların arasına gireceksiniz ve yürümeye başlayacaksınız .	başlayacaksınız	8	Fut
Sağlık Bakanı Recep Akdağ ile görüşmesinde de ' , hükümetin Sağlıkta Dönüşüm Projesi'ne finans desteği verebileceklerini söyledi .	verebileceklerini	15	Fut
Ayhan , bu notları bana verdi ve dedi ki : Benim anlatacaklarım bu kadar .	anlatacaklarım	11	Fut
Türban konusunu da açan komutanlar , bu konuda Anayasa Mahkemesi'nin kararı ile Cumhurbaşkanı'nın yaptığı uyarıyı anımsatarak toplumu gerecek davranışlardan kaçınılması gerektiğini anlattılar .	gerecek	17	Fut
Lange Leidsewards Straat'da Kierkegaard okuyan kıza , kendisiyle yeniden görüşmekten sevinç duyacağımı söylemiş , ertesi gün öğleye doğru , onun oturduğu sokağın başındaki o güzel , iki katlı kahveye çağırmıştım onu .	oturduğu	20	Past
Bir yasaklamanın içindeydik .	yasaklamanın	1	Pres
Olayın ikiyüzkırkyedi mağduru olduğu ifade edilen fezlekede , Akgündüz'ün , TCK'nın " W dolandırıcılık " suçunu tanımlayan beşyüzdört . maddesinin sekiz . fıkrasının ikiyüzkırkyedi kez uygulanması suretiyle cezalandırılması istendi .	cezalandırılması	27	Pres
Geçmek bilmedi sanki .	Geçmek	0	Pres
iki milyar yüzatmışyedi milyon altıyüzdoksan bin lira olan Başbakanlık Müsteşarı'nın maaşı iki milyar ikiyüzyetmişaltı milyon yetmişdört bin beşyüz liraya çıkacak .	çıkacak	19	Fut
İlk kez NA ile karşılaştığımda bir çıkış yolu olduğunu gördüm ; iyileşme yolu .	karşılaştığımda	4	Past
Beyin Takımı diye isim edindiler .	edindiler	4	Past
Artık duygularının , hastalıklarının ağrılarını kesecek uyuşturucu da olmadığı için neye sığınacağını bilemeyecek hale geliyor .	sığınacağını	11	Fut
Mahmutla kadın birbirlerine sarılmışlardı .	sarılmışlardı	3	Pqp
Hemen oracıkta kafanı bir güzel tıraşlayıvermiştin .	tıraşlayıvermiştin	5	Pqp
Öyle oyuncu öyle oyuncu ki anlatamam .	anlatamam	5	Pres
Birçok kez eroinden kurtulmak için yurtdışında değişik hastanelerde yatmış ama her seferinde kendisinden daha bencil olan eroine dönmüştü .	dönmüştü	17	Pqp
Ona her şeyi yazdım .	yazdım	3	Past
SP Genel Başkanı Recai Kutan ise iktidara gelirlerse ilk yapacakları icraatın IMF ile yapılan anlaşmaları yırtıp atmak olacağını kaydetti .	yapacakları	9	Fut
Bir romanda anlatılmaya değmeyecek kadar bildik , binlerce yıldan beri yaşanan duygulardı bunlar , ama deneyimlerim bana bir şey öğretmişti : En korkunç gerçekler , söylenmeye değmeyecek kadar basit olan bildik gerçeklerdi .	öğretmişti	19	Pqp
Bankanın , cari faizin yüzde yirmibeş fazlası temerrüt faizi aldığını bildiren Demiray , " Çıkacak olan yasa gecikme faizini cari faizin yüzde elli fazlası ile sınırlıyor .	Çıkacak	14	Fut
Bir anda her şeyimi alabilecek güçtedir .	alabilecek	4	Fut
Nasıl kaldıracağım ?	kaldıracağım	1	Fut
Harekatın çeşitli nedenlerle ertelenmesinin kısa vade için piyasaları olumlu etkileyeceği düşünülebilir .	etkileyeceği	9	Fut
Görgü tanığı köylüler , uçakların havada çarpıştıktan sonra yere çakıldığını ve gökyüzünde açılan paraşütler gördüklerini söyledi .	çarpıştıktan	6	Past
Nefes nefese kalmıştım .	kalmıştım	2	Pqp
Paketin salı günkü Bakanlar Kurulu toplantısında ele alınacağını ifade eden IMF , " Aynı gün ' sevk etmeye çalışacağız " dedi .	alınacağını	7	Fut
Bana değil de arkamda duran , dönüp baksam benim göremeyeceğim bir şeye , belki de bir aslana bakıyordu .	göremeyeceğim	9	Fut
Küçük bir dalga , ayaklarını örtüp , geri çekilirken ayağının altındaki kumların da denize doğru kaydığını fark etti .	örtüp	5	Pres
Önce Serpil Biriçim , sonra Fikret Bila Bey'i aradım ..	aradım	8	Past
Tam üç yıl önce onsekiz Ocak ikibin'de ' yüz endeksi yirmi ile tarihinde gördüğü en yüksek kapanış seviyesi ile günü bitirmişti .	gördüğü	13	Past
Ses dalgalarının ulaştığı insanlar , müziğin başlayacağını anladılar ; ama Recep'in biraz önce gördüğü darbukalı çocukta daha başka şeyler oldu .	başlayacağını	6	Fut
Saime Sezginler o güne kadar yayınlandığından haberi bile olmadığı Aydınlık gazetesi ile ilk kez bu haber üzerine tanıştı .	yayınlandığından	5	Past
Bizimkinde , bilinmeyen bir Öteki Dünya'da aklımıza hayalimize gelmeyecek cezalara uğrama korkusu var .	gelmeyecek	8	Fut
Oradan oraya seğirtmelerim bitecek , bitip de baş başa kalacak , baş başa kalınca da uzun uzun hayatlarımızın özetlerini çıkarıp bu hayatların görünen ucuna doğru birbirimize el verecek durumda değilim .	kalınca	13	Pres
Olur , alayım .	alayım	2	Pres
Yaşamöyküsünü sürdürelim .	sürdürelim	1	Pres
Asistanım söylediklerime gülüyor , bir yandan da elindeki notları temize çekmeye çalışıyordu .	söylediklerime	1	Past
Kamu Personeli Seçme Sınavı Sistemini değiştireceklerini kaydeden Şahin , şimdiye kadar sınavı kazananların haklarının saklı tutulacağını , ancak bundan böyle her yıl ihtiyaç kadar alım için yeni sınavlar yapılacağını belirtti .	değiştireceklerini	5	Fut
Geçmiş ola .	ola	1	Pres
Biz partide Atila Ağbiyi çok severiz .	severiz	5	Pres
Durum böyle olsaydı , ona şu kentin en canlı yeri olan alandaki kahvelerden birinde rastlardım şimdiye kadar .	rastlardım	14	Past
Kurtulmak istemiyorum .	istemiyorum	1	Pres
Şimdi birini oradan oraya alarak tayin edeceksiniz , öbürünü açığa alacaksınız , öbürünü sorgulayacaksınız .	sorgulayacaksınız	13	Fut
Bırakamazsınız o parkı .	Bırakamazsınız	0	Pres
Sana açmayacağıma söz vermiştim ...	açmayacağıma	1	Fut
Şunu niçin düşünmüyorsun , diye başladı Hülya yeniden , bu insanların hemen hepsi çeşitli zamanlarda özel birtakım konularını seninle konuşurlar , sana danışırlar , senin söyleyeceklerine önem vermeye hazırdırlar .	söyleyeceklerine	25	Fut
Ya havayı katılaştırır , seferleri kaldırır , yollarını kaparlarsa .	kaparlarsa	8	Pres
Sadece donuk bakışlarla etrafını süzüyor .	süzüyor	4	Pres
Hazine yüksek borçlanmaya çalışacak .	çalışacak	3	Fut
Ayhan ise grubu yurtseverce kurmuş .	kurmuş	4	Past
Yerleştir yerleştirme , devşir devşirme sınavları falan filan yok ...	yerleştirme	1	Pres
Keşke benim de böyle bir evim olsa başımı sokacak .	sokacak	8	Fut
