- Nie zorganizowano zawodów na odpowiednim poziomie , na przykład w skokach do wody czy siatkówce , bo Zimbabwe nie spodziewa się w tych dyscyplinach osiągnięć .	zorganizowano	2	0
- Wyciągnij go spod ziemi , ale muszę go mieć dzisiaj .	Wyciągnij	1	2
Skontaktuję się z mamą trojaczków w najbliższych dniach .	Skontaktuję	0	1
– chętnie posłucham jeszcze raz . .	posłucham	2	1
W 1991 dokonano kolejnych zmian administracyjnych .	dokonano	2	0
- Znowu zajmujesz się jakimś morderstwem ?	zajmujesz	2	2
Koniecznie zadzwoń i przeproś za zwłokę .	przeproś	3	2
- W takim razie poproszę o nie na chwilę .	poproszę	4	1
no pan optuje za Niemcami .	optuje	2	3
Rosjanie zajęli Baranowicze i biją się na przedmieściach Wilna .	biją	4	3
- Ty tylko udasz , że nic nie widział eś .	udasz	3	2
Ludzi to drażni , złości .	drażni	2	3
Niewielkie zmiany odczują osoby oddające krew .	odczują	2	3
Jak realizowano budżet ?	realizowano	1	0
Zwiększono nakład , objętość , pojawiły się nawet honoraria .	Zwiększono	0	0
Psychiatra przysuwa krzesło do leżanki i siada obok Bartodzieja z notesem w ręku .	przysuwa	1	3
Commercial Union od 1991 roku działa również na rynku naszych ubezpieczeń życiowych .	działa	5	3
No idź już , wracaj do powozu .	wracaj	4	2
Nocą słyszymy skrzypienie , jakby ktoś przechadzał się po niebie ułożonym ze starych , drewnianych desek .	słyszymy	1	1
No , może powtórzysz to jeszcze raz !	powtórzysz	3	2
Wiatr go przynosi z Edessy do Rzymu .	przynosi	2	3
Odpowiadam ogólnie na Twoją radosną twórczość .	Odpowiadam	0	1
- Weź sobie , Madziu , kochankę , zobaczysz wtedy , jakie to cudowne uczucie .	Weź	1	2
Stłuces głobe !	Stłuces	0	2
Przez cały czas trwania ćwiczenia oddychaj , zwracając szczególną uwagę na wydech .	oddychaj	5	2
Przecież jej nie ma .	ma	3	3
Dziękujemy w imieniu Agnieszki Kulig .	Dziękujemy	0	1
Nie chcę , by jakoś specjalnie się mną opiekowano czy głaskano .	opiekowano	8	0
Również teraz stwierdzono , że jest to umyślne działanie osób trzecich .	stwierdzono	2	0
I kłopoty przez to nasz car - batiuszka ma .	ma	8	3
Spaceruję sobie wzrokiem po ścianach , suficie , meblach i przedmiotach .	Spaceruję	0	1
- Spodziewałem się , że tak odpowiesz , Sarai !	odpowiesz	6	2
Co to wszystko obchodzi polskich klientów firm ubezpieczeniowych ?	obchodzi	3	3
Zgłoś się …	Zgłoś	0	2
Trudniej było się zdecydować , na co pójdę .	pójdę	7	1
Rozmaite padliny wieszano na Sienkiewiczu , ale ja w jego obronie zawsze staję .	staję	12	1
Tak się gada .	gada	2	3
Jeśli sumienie na to wam zezwala .	zezwala	5	3
Anglosasi sądzą , że czas jest ich sprzymierzeńcem .	sądzą	1	3
Rozdzieram kopertę .	Rozdzieram	0	1
Teraz kmieci zamieniono w niewolników .	zamieniono	2	0
IPN lustruje nazwy ulic .	lustruje	1	3
Może jesteśmy przeczuleni , ale nazwa sugeruje , że Uniqua unika płacenia odszkodowań .	sugeruje	6	3
Wiesław Morawski traktuje swoją winnicę hobbystycznie .	traktuje	2	3
Informacje i dokumenty , którymi dysponujemy , wskazują jednak , że poseł kłamie .	dysponujemy	5	1
Uwierz mi .	Uwierz	0	2
Uważam , że pomógł .	Uważam	0	1
I montujemy z tego dziewięćdziesięciominutowy program .	montujemy	1	1
Zaczyna się zjadanie domu , niszczenie domu , nim się dom rozpadnie .	rozpadnie	11	3
Uważam , że pomógł .	Uważam	0	1
– Robisz się religijny , kiedy mówisz o piłce nożnej .	Robisz	1	2
Przekaż jej moje . . .	Przekaż	0	2
W oddzielnych grupach ćwiczą panie i panowie , później znów spotykają się i odbywają wspólnie zajęcia choreograficzno - taneczne .	ćwiczą	3	3
Prowadźcie mnie do głównego .	Prowadźcie	0	2
– sika w Stanach ?	sika	1	3
Pracuję w dziale płac .	Pracuję	0	1
Pluj i jedz , wymagała .	Pluj	0	2
Czemu godzę się na tortury pod obojętnym światłem wielkiej lampy ?	godzę	1	1
Jeśli odczuwasz zbyt silną potrzebę izolacji , samotności , nie pozwól na zamknięcie się w swoich myślach , obawach i wyobrażeniach .	pozwól	10	2
- Teraz pojedziemy na szóste .	pojedziemy	2	1
Biznesmena Roku wybierano na Pomorzu już po raz szósty .	wybierano	2	0
Mordercy nie znaleziono .	znaleziono	2	0
- Węszy też po całym banku .	Węszy	1	3
- Idź już .	Idź	1	2
Inwestor chce wystartować za kilka miesięcy .	chce	1	3
Przeziębicie się !	Przeziębicie	0	2
Już wówczas zaczęto go przygotowywać do przyszłej akcji na Wschodzie .	zaczęto	2	0
W dniu Debaty zamykam się razem ze stosem dokumentacji w pokoju redakcyjnym , wyłączam telefon komórkowy i nie ma mnie praktycznie dla nikogo .	wyłączam	13	1
Nie odwódźcie mnie . . .	odwódźcie	1	2
Zapytam , jakiej pomocy oczekuje .	oczekuje	4	3
- Oto głoszę Twoje Królestwo .	głoszę	2	1
Zauważono też nagminne zaniżanie zarobków pracowników za dni urlopowe lub chorobowe .	Zauważono	0	0
Zaczekasz na nas czy pójdziemy razem ?	Zaczekasz	0	2
Zaraz wydam dyspozycje .	wydam	1	1
Odkładam książki , gaszę komputer .	gaszę	3	1
- Słuchaj , ty pewnie wyższą akademię talmudyczną w Mirze ukończył eś ?	Słuchaj	1	2
Ja stoję w bruździe i w uniesionej ręce trzymam zapalony fanarek .	trzymam	8	1
Ale nie obawiaj się .	obawiaj	2	2
Regulaminowe decyzje , po wnikliwej analizie protokołu z tego pojedynku , podejmie Wydział Dyscypliny BOZPN .	podejmie	11	3
Łapcie się za portfele !	Łapcie	0	2
Masz im dać najlepsze dwa pokoje .	Masz	0	2
Jedziemy do Havru , ten stary kozioł płaci .	Jedziemy	0	1
- Robisz twarożek ?	Robisz	1	2
- Wy się też starzejecie .	starzejecie	4	2
Nie życzę sobie , aby do mych lokatorów przywożono paczki prawie o świcie .	przywożono	8	0
- Protestuję !	Protestuję	1	1
Usiądź wygodnie , bo chcę przedstawić ci pewien pomysł . . .	Usiądź	0	2
Radni liczą na zyski z podatków .	liczą	1	3
Kocham polskich chłopów hodujących polską brukselkę . . .	Kocham	0	1
- Od dawna tu mieszkasz ?	mieszkasz	4	2
Z takiej zawiesiny w Polsce odzyskiwano spirytus .	odzyskiwano	5	0
- Spróbuję .	Spróbuję	1	1
Nie gniewaj się . . .	gniewaj	1	2
- Jedziemy do Paryża .	Jedziemy	1	1
Podczas pogrzebów nie biją dzwony .	biją	3	3
Giełda ogłosiła oficjalnie , że pełną gotowość systemu przywrócono dopiero w nocy .	przywrócono	8	0
W poniedziałek we wczesnych godzinach popołudniowych podano , że zdołano uratować siedemset dwadzieścia dwie osoby .	podano	6	0
Przewieziono go do szpitala .	Przewieziono	0	0
Na zakończenie chcę powiedzieć , że klub Unii Demokratycznej wnioskuje o skierowanie projektu do odpowiednich komisji .	wnioskuje	9	3
Rozpalą nimi pierwszą watrę przy szałasie .	Rozpalą	0	3
Błagam , nie chorujcie i żadnych kłopotów nie miejcie !	miejcie	8	2
- A ja myślał em , że niosę jej pocieszenie . . .	niosę	7	1
Zapalono wszystkie lampy , ustawiono ruchome wieszadła , kelnerzy w oczekiwaniu gości spacerowali po korytarzach hotelowych .	ustawiono	4	0
Nie jesteś już młodzieńcem i lepszej kariery nie zrobisz .	zrobisz	8	2
Ale ty wrócisz .	wrócisz	2	2
Bierzemy pod lupę najbliższych sąsiadów .	Bierzemy	0	1
W każdej palecie kiełkuje 160 nasion .	kiełkuje	3	3
Teraz ma roczek i czasem bawimy sie w cienie na ścianie .	bawimy	5	1
Przeglądam dziennik swój .	Przeglądam	0	1
Nie boisz się wilków ?	boisz	1	2
Zapukano do drzwi .	Zapukano	0	0
Zgodnie z podjętymi na wtorkowym spotkaniu ustaleniami , targi eksporterów oraz wystawy turystyczne odbędą się w przyszłym roku .	odbędą	13	3
Większość skradziono w Berlinie , Hamburgu , Kilonii i Bremie .	skradziono	1	0
- Pozwólmy mu trochę pomyśleć nad swoimi manierami .	Pozwólmy	1	1
Rozmawiam , dyscyplinuję .	dyscyplinuję	2	1
Czy dostrzegasz jakieś skutki tej wystawy ?	dostrzegasz	1	2
Takie parlamentarne metody nie odpowiadają mi , rozumiecie ?	odpowiadają	4	3
- O mnie się nie martwcie .	martwcie	5	2
- Pocieszasz mnie .	Pocieszasz	1	2
Od tego zależą losy SLD .	zależą	2	3
Koniec przedstawienia , teraz kretyni biją brawa i proszą o bisy . . .	biją	5	3
Powiedz , jeśli wiesz !	wiesz	3	2
Oddzielnie myjemy rzodkiewki i jej liście , od których oddzielamy części zepsute .	oddzielamy	9	1
Nie przepadamy za tym .	przepadamy	1	1
No , nie mitręż , dziewczyno .	mitręż	3	2
- Masz , bierz .	bierz	3	2
– Korepetycje jej dajesz ?	dajesz	3	2
Pomódlcie się ze mną .	Pomódlcie	0	2
Zaczaja się na zebry , hieny i szakale .	Zaczaja	0	3
Może w to nie wierzysz , ale większość tak powstała .	wierzysz	4	2
Wybierz dowolny chat , umów się z przyjacielem na określoną godzinę i rozmawiaj do woli .	rozmawiaj	12	2
- Nie znam Ab - Rahama .	znam	2	1
Rozumisz , Dziunia ?	Rozumisz	0	2
Omawiana książka jeszcze raz to potwierdza .	potwierdza	5	3
Jacht odholowano do portu w Kołobrzegu .	odholowano	1	0
Obydwu sprowadź natychmiast do sztabu !	sprowadź	1	2
- Może spotkasz swojego starego znajomego , Szmidta .	spotkasz	2	2
- Wyśpijcie się i przyjdźcie rano .	Wyśpijcie	1	2
– Przepraszam , ale nie widziała m powodu …	Przepraszam	1	1
Przyzwoitość każe szanować gości i ja właśnie w ten elegancki sposób uszanuję Jagodowe wakacje .	każe	1	3
wszyscy znajomi tam jadą . .	jadą	3	3
W innych miejscach znaleziono wyszlifowane i porysowane przedkarbońskie skały podłoża .	znaleziono	3	0
Ja też sobie tak czytam posty i nie widzę takiej manii .	czytam	4	1
– Od której ty urzędujesz tam teraz ?	urzędujesz	4	2
Lech Kaczyński nie żałuje , że jego filmowa kariera się nie rozwinęła , a do swojego aktorskiego talentu podchodzi z rezerwą .	żałuje	3	3
Nie pozwól , by ścigali cię na oko .	pozwól	1	2
Ty coś ćwiczysz ?	ćwiczysz	2	2
— Dlaczego nie osądzono komunistów ?	osądzono	3	0
- To jest raczej kwestia otwarcia na ludzi , którzy się polityką nie interesują .	interesują	13	3
Dlatego odprawia msze za spokój królewskiej duszy .	odprawia	1	3
Nie ruszaj się .	ruszaj	1	2
- Jak pan sądzi , zobaczycie się z Bagsikiem w tym tysiącleciu ?	zobaczycie	5	2
Alibi było , ale przy okazji sfotografowano tego wysokiego , przystojnego mężczyznę .	sfotografowano	6	0
– Nie piernicz .	piernicz	2	2
– Wiedzą o tym wszyscy w dziale przydzielania funduszy .	Wiedzą	1	3
Realizuje ono wśród młodzieży w całym kraju program profilaktyki , który uzyskał akceptację Państwowej Agencji Rozwiązywania Problemów Alkoholowych .	Realizuje	0	3
Po kolejnych 30 minutach lekarze stwierdzają śmierć kolarza .	stwierdzają	5	3
I w końcu wróci do niej .	wróci	3	3
Na Zalewie Szczecińskim z trudem przedzieramy się przez gęstą krę lodową .	przedzieramy	5	1
Mnie wypędzono .	wypędzono	1	0
Moja żona wybiera się do Tunezji , strzeżcie się , Tunezyjczycy .	strzeżcie	7	2
Wielu już marzy , aby w przyszłym roku zostać kantorem .	marzy	2	3
Nie twierdzę , że prowadzimy wojnę promową .	prowadzimy	4	1
To się w głowie nie mieści !	mieści	5	3
Wówczas postawiono nas na nogi i kazano iść dalej .	postawiono	1	0
- Jak pan sądzi , zobaczycie się z Bagsikiem w tym tysiącleciu ?	sądzi	3	3
Przy wynoszeniu rannego w pojedynkę ujmujemy go oburącz pod ramiona .	ujmujemy	5	1
Nie zakłada inwestowania w firmę w upadłości .	zakłada	1	3
Wykształciuchy bronią się przed premierem .	bronią	1	3
Za chwilę przysłano woźnego , żeby nas pilnował .	przysłano	2	0
Ewakuujcie się na drugą stronę rzeki .	Ewakuujcie	0	2
Wtacza się pociąg .	Wtacza	0	3
Klienci bardzo chętnie gwałcą i matkę , i syna .	gwałcą	3	3
Firmy nominowano w pięciu kategoriach , w zależności od wielkości zatrudnienia .	nominowano	1	0
Bez tabletki nie zasnę .	zasnę	3	1
- Myślę , że jest to zupełnie normalne .	Myślę	1	1
życzę miłego wieczoru .	życzę	0	1
Trąb , pan dyrektor prosi .	Trąb	0	2
Czym w końcu różnią się tak naprawdę republikanie od demokratów ?	różnią	3	3
I lepiej nie pytaj , co robię zimą .	pytaj	3	2
- Dokąd idziesz ?	idziesz	2	2
Ale i wiem , że teraz kłamiesz .	kłamiesz	6	2
Budzisz się .	Budzisz	0	2
Czyli oszukujesz prawowitą władzę .	oszukujesz	1	2
– przepraszam . .	przepraszam	1	1
Dziwi się , że ludzie ustępują mu z drogi , że go widzą . . .	Dziwi	0	3
Co tracisz , co zyskujesz ?	tracisz	1	2
- Nie da rady , coś dziwnego się dzieje .	da	2	3
Z pewnością młodemu człowiekowi nie pomagają zainteresowania seksualne , które koncentrują się na doznaniach fizycznych .	pomagają	5	3
Po naszym reportażu punkt o odwołaniu zarządu zdjęto z porządku obrad .	zdjęto	7	0
Oznacz wszystkie pola ze skarbami .	Oznacz	0	2
Opiszę ci wszystko !	Opiszę	0	1
Najciekawsze opinie wydrukujemy .	wydrukujemy	2	1
Słońce świeci prosto we mnie .	świeci	1	3
Furtka skrzypi , Dostojewski wystaje z pyska psa .	skrzypi	1	3
Nowoczesną motorówkę do patrolowania Wisły ukradziono policjantom z Torunia .	ukradziono	5	0
Czy mogę spocząć na ganeczku ?	mogę	1	1
Czy pan hrabia ceni jego wyroby ?	ceni	3	3
znowu się tutaj odwołam do faktów .	odwołam	3	1
Zaprosimy cię na otwarcie , przysięgam .	Zaprosimy	0	1
Radio zapisuje tekst komunikatu .	zapisuje	1	3
- Legnij !	Legnij	1	2
- Nie patrz tak .	patrz	2	2
- Niech Kwaśniewski się nie wtrąca .	wtrąca	5	3
Jemu zarzucono nakłanianie do aborcji .	zarzucono	1	0
Uratujcie wierzącego chrześcijanina Walerego Marczenkę !	Uratujcie	0	2
– Ja w każdym razie wybieram chłodny prysznic .	wybieram	5	1
Nikt nie domyśla się , co tkwi w środku .	tkwi	6	3
Szanuję ale nie podzielam .	Szanuję	0	1
Odbywają się one w 100 fabrykach i PGR-ach .	Odbywają	0	3
Stanowi to 0,7 proc . budżetu państwa i jest najniższą od trzech lat sumą przeznaczaną na kulturę .	Stanowi	0	3
- Uważasz , że tylko dlatego jestem artystką , że mi się dobrze płaci ?	Uważasz	1	2
Saperzy polscy i radzieccy poszukują min i niewypałów .	poszukują	4	3
Pospiesz się .	Pospiesz	0	2
Na pewno masz jakiś specjalny , alarmowy numer .	masz	2	2
Osiągniesz korzyść prestiżową i finansową .	Osiągniesz	0	2
Gdy Cahirowi czupryna nieco mocniej przyschnie do czerepu , powędrujemy ku Toussaint .	powędrujemy	9	1
Jak myślicie ?	myślicie	1	2
Część młodych osób chce pracować w państwowej firmie , bo to daje zabezpieczenie socjalne .	daje	11	3
Jeszcze z parasolem występuje Dominika Bukowska i pani Jagoda ogłasza kolejną przerwę .	występuje	3	3
Przedostatni figuruje Artur Balazs , poseł i minister rolnictwa , a zamyka ją Stefan Oleszczuk z UPR-u , starosta kamieński .	zamyka	11	3
– ależ nie przesadzaj . .	przesadzaj	3	2
Popełniasz błąd .	Popełniasz	0	2
Trafi do szpitala psychiatrycznego .	Trafi	0	3
Tato , pozwól mi !	pozwól	2	2
Ciągle jeszcze wybieramy naszych bohaterów i ich losy z miarką społeczną .	wybieramy	2	1
Jeśli w młodości nie przyzwyczaimy organizmu do tego życiodajnego płynu , organizm przestanie wytwarzać laktozę , enzym niezbędny do trawienia cukru mlecznego .	przyzwyczaimy	4	1
Wypraszam sobie takie porównania .	Wypraszam	0	1
Kupmy jej srebrne .	Kupmy	0	1
I koniecznie zabierz ze sobą jakąś książkę .	zabierz	2	2
Tym razem zapowiada się liczniejsze grono .	zapowiada	2	3
Już wrosłem w to środowisko i uważam , że potrafię pogodzić swoje sprawy .	uważam	6	1
Prezentowano gospodarstwa agroturystyczne i przetwórstwo rolno - spożywcze .	Prezentowano	0	0
Strzeż się , Segubie !	Strzeż	0	2
- Tyle nie wytrzymam .	wytrzymam	3	1
Dzięki temu po wyjęciu dwóch foteli uzyskamy dodatkową powierzchnię bagażową .	uzyskamy	6	1
Niech Ci słońce zawsze świeci I niech czas radośnie leci !	świeci	4	3
dom odpada z kilku względów .	odpada	1	3
O tej rozmowie zapominamy .	zapominamy	3	1
W tych pierwszych związkach nastolatki doświadczają smaku ludzkiej miłości , odkrywają siłę fascynacji i wzajemnego przyciągania siebie .	doświadczają	5	3
Myślisz , że ktoś na coś czeka , a on już uciekł . . .	Myślisz	0	2
– towarzyskie dziecko mamy ?	mamy	3	1
Po zakończeniu prac zapomniano o ponownym ich umieszczeniu .	zapomniano	3	0
Powtarzaj je tak często , jak to jest potrzebne .	Powtarzaj	0	2
W naszej kantynie fabrycznej zmniejszono nam obiad o jedno danie .	zmniejszono	4	0
Za nic nie zrobię z siebie pajaca .	zrobię	3	1
- Ja pana znam .	znam	3	1
jeździ . .	jeździ	0	3
To państwo Kaczyńscy wiedzą i rządu do dymisji nie podadzą .	podadzą	9	3
Nie twierdzę , że prowadzimy wojnę promową .	twierdzę	1	1
Radujmy się z nimi , bo żyją !	żyją	6	3
W miniony piątek przegłosowano ten wniosek .	przegłosowano	3	0
Obie części składamy podszewką do środka , zszywamy po brzegach , obszywamy lamówką .	obszywamy	11	1
W całym kraju ścięto jeszcze niewiele .	ścięto	3	0
Kojarzysz mi się z egzotyczną czarownicą .	Kojarzysz	0	2
Jeszcze niedawno informowano , że skradziono 60 starych ksiąg , teraz okazało się , że brakuje ponad 90 pozycji .	skradziono	5	0
Do wytworzenia pary i utrzymywania ognia we właściwej temperaturze służy oddzielny palnik gazowy .	służy	9	3
- Sama zatelefonuję .	zatelefonuję	2	1
- Wierzyła m , że żyjesz . . .	żyjesz	5	2
Szympansy uprawiają politykę .	uprawiają	1	3
Wątpię , by kiedykolwiek u nas taki film nakręcono .	nakręcono	8	0
- Nie rozumiem , co mogę dla ciebie .	rozumiem	2	1
Jak mnie wyceniasz ?	wyceniasz	2	2
Zastanówmy się , jak można je zwalczać w sklepie ?	Zastanówmy	0	1
Menda jesteś i naprawdę już mię wkurzasz .	wkurzasz	6	2
Weźmiemy to pod uwagę , przygotowując zmiany .	Weźmiemy	0	1
Mieszkamy w Kuźni Raciborskiej .	Mieszkamy	0	1
- Trochę boimy się pojawić tam na naszych tandemach .	boimy	2	1
Odchodzę , ale ciało moje zostaje .	Odchodzę	0	1
- Od dłuższego czasu w środowisku prawniczym szeroko komentowano zniszczenie umorzenia .	komentowano	8	0
Zarzucił mu Pan , że utrwala sejmokrację .	utrwala	5	3
" Zrobimy " !	Zrobimy	1	1
- Nie powtarzaj mi tego , bo jeszcze zmienię zdanie .	powtarzaj	2	2
Wracają i pracują solidnie .	pracują	2	3
Mamy nadzieję , że Państwowa Komisja Wyborcza zainteresuje się tym trikiem .	zainteresuje	7	3
Może zostaniesz kiedyś kierowcą rajdowym .	zostaniesz	1	2
- Wiem , kogo cytujesz !	cytujesz	4	2
Zlitujcie się nad sędziami .	Zlitujcie	0	2
Pracujemy nad tą grupą dzień i noc .	Pracujemy	0	1
Nie zajedziesz nigdy , nie odwiedzisz .	odwiedzisz	5	2
Dlaczego uważacie , że księża to złodzieje ? ?	uważacie	1	2
Kiedyś uduszono jej jedynego syna Amadeusza .	uduszono	1	0
Działajmy nocą , najlepiej na kolanach .	Działajmy	0	1
Kiedy wdychasz powietrze , czuj to .	czuj	4	2
Może wytrzymam . . .	wytrzymam	1	1
- Nalej po kieliszku .	Nalej	1	2
- Witam mojego kochanego autora !	Witam	1	1
Widać , że gabinet Millera stopniowo traci kontakt z rzeczywistością .	traci	6	3
bo jedziesz przez most w Dęblinie . .	jedziesz	1	2
- Nie twierdzę , że jesteśmy bez winy , ale w zasadzie zarzut ten mógł by dotyczyć strony państwowej .	twierdzę	2	1
Nie wspominajcie o ojczyźnie , jej mitach i tradycjach .	wspominajcie	1	2
Nie wprowadzono prywatnej własności ziemi , nie zniszczono feudalnego imperium dyrektorów kołchozów .	wprowadzono	1	0
Dobre imię dano ci na chrzcie , nasz drogi radco .	dano	2	0
Ale sam pomysł z nagrodą uważam za dobry .	uważam	5	1
Nie podjęto jednak w tej sprawie żadnych decyzji .	podjęto	1	0
Praca dla polonistek się znajdzie .	znajdzie	4	3
- Spodziewał em się , że tak odpowiesz , Sarai !	odpowiesz	7	2
Położono na niej nową nawierzchnię asfaltową .	Położono	0	0
- Ty mnie wcale nie słuchasz !	słuchasz	5	2
I nie ma pan nic do ukrycia .	ma	2	3
Pędzę do pokojówki z tą hiobową wieścią .	Pędzę	0	1
- Jeśli czegoś nie lubię , nie zrobię tego za żadne pieniądze .	lubię	4	1
W okna wstawiono kraty i podmurowano ściany .	podmurowano	5	0
Zbroimy się !	Zbroimy	0	1
Taty już nie ma .	ma	3	3
Nikomu nie postawiono zarzutów .	postawiono	2	0
Bracie Gęgaczu , rozchmurz swą fizys !	rozchmurz	3	2
Zdziwisz się , ale wielu głosowało za Bośnią .	Zdziwisz	0	2
Napijecie się kawy ?	Napijecie	0	2
- Pójdziesz za to siedzieć , wiesz ?	Pójdziesz	1	2
Za pomaganie funkcjonariuszom MO Konstanty odpowie teraz przed sądem .	odpowie	5	3
Wcześniej nie zauważyła m , że z tego palanta wycieka palantyna .	wycieka	9	3
- To znaczy , że mnie też okłamujesz ?	okłamujesz	7	2
Wiadomo , że ostatecznie zawiedzie się na tej idei Stagiryta .	zawiedzie	4	3
- Nie układa się jej pod rynkowego konkurenta , ale warto wiedzieć , w co on gra .	gra	16	3
Bogu zawierzam i w Bogu pokładam nadzieję .	pokładam	5	1
Nawet laik wie , że do 1939 r . nie błyszczeliśmy specjalnie w kinie .	wie	2	3
Dzięki poradnikowi dowiadujemy się , że roczną deklarację oznaczają cyfry 01 .	dowiadujemy	2	1
– może zadzwonimy ?	zadzwonimy	2	1
Oszukasz mnie .	Oszukasz	0	2
Nie uważam , żeby na przykład Marksa szczególnie kompromitował romans ze służącą .	uważam	1	1
Oczywiście niech Pan po przyjeździe się zgłasza .	zgłasza	6	3
Po zdjęciu serwetki i położeniu jej na kolanach na małym talerzyku spożyjemy przekąskę .	spożyjemy	11	1
Przyznam , że nie jestem najlepszy w te klocki .	Przyznam	0	1
Elżbieta rozstaje się z mężem , zabiera synka i ze Śląska przenosi się do Tarnowa .	zabiera	6	3
Zaprosimy cię na otwarcie , przysięgam .	przysięgam	5	1
Powołano specjalny zespół mający wyjaśnić przyczyny i okoliczności tragedii .	Powołano	0	0
- Myślisz ?	Myślisz	1	2
Kto pierwszy wstaje od stołu ?	wstaje	2	3
- Wynosimy się .	Wynosimy	1	1
– dobrze co macie na aukcję ?	macie	3	2
Za nimi Toyotą syn Doroty wiezie Marcina .	wiezie	5	3
- Nic nie mów . . .	mów	3	2
I zawsze dziwię się , że była m taka .	dziwię	2	1
- Weź wiadra i chodź ze mną nad rzekę .	Weź	1	2
– jeszcze dziesięć godzin wyjeżdżę i zdaję . .	wyjeżdżę	4	1
- Stoimy nad Odrą , na odwiecznie polskiej , piastowskiej ziemi .	Stoimy	1	1
Nie przemierza go kondukt , nie biją dzwony .	przemierza	1	3
- Na razie nie planujemy kolejnych dzieci .	planujemy	4	1
Zrób kolację .	Zrób	0	2
- Prowadzi edukację humanitarną , pomaga uchodźcom , powodzianom .	Prowadzi	1	3
Użyto gazów łzawiących i ogłuszających granatów .	Użyto	0	0
Wypowiadamy się w sondach telewizyjnych a czasami przesyłamy także nasze opinie elektronicznie .	Wypowiadamy	0	1
Nie wierzycie im ?	wierzycie	1	2
- Jak utrwalacie wyniki kuracji po trzech miesiącach ?	utrwalacie	2	2
Niedługo w sprawie umocujemy dodatkowego prokuratora , aby przyspieszyć prace .	umocujemy	3	1
Tam weterynarz przeprowadził sekcję , z której jasno wynika , że pies padł z powodu wysokiej temperatury .	wynika	8	3
Znajdujemy się u początku naszego eksperymentu .	Znajdujemy	0	1
Postarajmy się wyśledzić je od początku .	Postarajmy	0	1
- Nie wierz złośliwcom !	wierz	2	2
" Odczytaj " .	Odczytaj	1	2
Małachowski zarzuca Kościołowi milczenie wobec wystąpień nacjonalistycznych i antysemickich .	zarzuca	1	3
Uznano , że poszlaki były wątłe i niepewne , zwłaszcza podobieństwo papieru i sznurka .	Uznano	0	0
Możesz wracać .	Możesz	0	2
Pocałuj mnie .	Pocałuj	0	2
- Witaj , synu Arana .	Witaj	1	2
Beczkę kładzie się na stojak i tak się ją zostawia .	kładzie	1	3
W samej Warszawie w Internecie swoje auta eksponuje już kilkadziesiąt komisów .	eksponuje	7	3
Należy się cieszyć , że w tych wielkich odkryciach uczestniczą nasi koledzy .	uczestniczą	9	3
- Siadaj .	Siadaj	1	2
A może ją radykalnie zmieniono od czasów , kiedy chodziła m na religię ? .	zmieniono	4	0
- Rysiek , dam ci ciężarówkę , ale mi nią przywieziesz Nałkowską z Adamowizny i Gojawiczyńską ze Stawiska !	przywieziesz	10	2
- Pytam , co sądzisz , a nie czy byłeś .	Pytam	1	1
Wątpię , by kiedykolwiek u nas taki film nakręcono .	Wątpię	0	1
może wpadnę do Gumy po pieróg .	wpadnę	1	1
Wynikła awantura , ale w duchu przyznano bosmanowi rację .	przyznano	6	0
- A ludzie jak reagują ?	reagują	4	3
- Nie nudź .	nudź	2	2
Tańczono zapamiętale , wykrzykując i piosenką dogryzając sobie wzajemnie .	Tańczono	0	0
Nie sprzeciwiaj mi się , dobrze ? . . .	sprzeciwiaj	1	2
Dziś , po odkryciach Zygmunta Freuda , to zapomniane w średniowieczu dziedzictwo wchodzi do naszej codzienności i znajduje w niej swoje miejsce .	wchodzi	12	3
Jeszcze niedawno informowano , że skradziono 60 starych ksiąg , teraz okazało się , że brakuje ponad 90 pozycji .	informowano	2	0
Wykonano ją chałupniczo , ale nie powstydził by się ich żaden fachowiec .	Wykonano	0	0
Zwycięskie drużyny otrzymają nagrody pieniężne .	otrzymają	2	3
Wybierzmy tych , którym chcemy pomóc .	Wybierzmy	0	1
grasz no .	grasz	0	2
Wywiozą nas do Polski !	Wywiozą	0	3
Tu też gram .	gram	2	1
Sprawą zajęła się policja , która sprawdza wszelkie okoliczności .	sprawdza	6	3
Mogą przy okazji oberwać .	Mogą	0	3
Ale uważaj .	uważaj	1	2
I ciągle mi się zdaje , że się wyleczę , jakby czas mógł mi w tym pomóc .	wyleczę	8	1
Nic nie zmieniamy .	zmieniamy	2	1
Dzięki cyfrowej telewizji satelitarnej istnieje też możliwość połączenia z Internetem czy udziału w kursach przygotowujących do matury albo egzaminu na studia .	istnieje	4	3
Utnij na dwie dulki i schodź , bo palić się strasznie chce .	schodź	5	2
- Wypijesz ?	Wypijesz	1	2
Magdzie zrobiono cewnikowanie .	zrobiono	1	0
Idź już , dziecko , idź .	Idź	0	2
W sobotę podporucznik Ziemba przeniósł swoje łóżko do kuchni , rowery wstawiono do pokoju podporucznika Kowalika .	wstawiono	11	0
Może Ci się przyda .	przyda	3	3
- Macie 15 minut . ?	Macie	1	2
Nie znoszę bezczynności .	znoszę	1	1
Robimy przeciąg i rozbieramy się .	rozbieramy	3	1
Posłowie chcą , by wybierano tych przedstawicieli spośród członków rady Kasy Chorych .	wybierano	4	0
- Wyśpijcie się i przyjdźcie rano .	przyjdźcie	4	2
Pytała ś , jak zarabiam ?	zarabiam	4	1
- Ale wybieramy .	wybieramy	2	1
Przeglądam kartki notatnika .	Przeglądam	0	1
- Powinno być łatwiej , bo Husajna nie otaczają fanatycy .	otaczają	8	3
Jeżeli Golędzinów nadjedzie , wygra wielką stawkę .	nadjedzie	2	3
Niektóre z nich nie przyjmują już zgłoszeń .	przyjmują	4	3
– co ty opowiadasz ?	opowiadasz	3	2
- Przepraszam , nie rozumiem .	rozumiem	4	1
Celuj dobrze . . .	Celuj	0	2
- Zatrzymaj się , bo strzelę !	strzelę	5	1
Opublikowano też felieton pułkownika Bosaka .	Opublikowano	0	0
- Jemu nie sprzedam .	sprzedam	3	1
Przepisuję im leki uspokajające , herbatki nasenne i zapewniam , że Amerykanie strzegą naszego bezpieczeństwa .	zapewniam	8	1
- Weź pilota , wyłącz kmiota , niech się nie miota .	miota	10	3
Z czego mam się cieszyć , że kości rozsiejemy po świecie ?	rozsiejemy	8	1
Pozwolą Państwo , że coś przypomnę .	przypomnę	5	1
No , bywaj .	bywaj	2	2
Ale młodzież nie chce się ruszyć ze wsi , bo mieszkania są albo niedostępne , albo bardzo drogie .	chce	3	3
Broń cię , Panie Boże .	Broń	0	2
Widzą nagle Cygana z Jadźką .	Widzą	0	3
Piranię wyłowiono też w wodach Brdy .	wyłowiono	1	0
Fabrykę zaplombowano , konfiskując także podejrzane materiały .	zaplombowano	1	0
Ty przejrzyj na oczy .	przejrzyj	1	2
Biorę torbę i wychodzę .	Biorę	0	1
Spróbuję , ale nie będzie to łatwe .	Spróbuję	0	1
– Może napisz do niej .	napisz	2	2
Wypraszam sobie , żeby ś szydziła ze mnie .	Wypraszam	0	1
- Skąd ty bierzesz takie powiedzonka ?	bierzesz	3	2
- Zrobiono mi tym wielkie świństwo , bo po waszym artykule ludzie się ze mnie śmieją .	Zrobiono	1	0
Ale odmówiono wszczęcia sprawy .	odmówiono	1	0
Elegancko się ubiera .	ubiera	2	3
Startować w nich mogą wszyscy chętni .	mogą	3	3
W tym roku Zagłębie też nie płaci .	płaci	6	3
Uczymy ich na kursach ogólnych i specjalistycznych .	Uczymy	0	1
Panią prezes noszono na rękach .	noszono	2	0
Dawaj , bo zarzygasz .	Dawaj	0	2
Staję koło stołu i czekam .	Staję	0	1
Jeśli resort zaakceptuje programy , będzie je finansować .	zaakceptuje	2	3
może se cofasz licznik .	cofasz	2	2
Zgadzając się co do celu , uważamy , że metoda jego osiągnięcia nie jest dobra .	uważamy	6	1
Królową Mody wybrano na rok 1935 znaną pieśniarkę Werę Bobrowską .	wybrano	2	0
– nie boi się pan ?	boi	2	3
Ona nie zostanie .	zostanie	2	3
W ten sposób tworzono podwaliny sztuki nowoczesnej .	tworzono	3	0
Pruszyński zaciera ręce .	zaciera	1	3
Dawno już widziała m , że tu stoisz .	stoisz	7	2
- Tylko mu lodów nie daję .	daję	5	1
Cyfry nas nie interesują , tylko zdobywamy rynek .	zdobywamy	6	1
Sławny pianista utracił dłonie w wypadku , ale przeszczepiono mu ręce straconego mordercy .	przeszczepiono	8	0
on zje .	zje	1	3
- Nie przesadzaj .	przesadzaj	2	2
- Próbowali śmy jej tutaj pomóc , ale w końcu zabrano ją do najlepszego szpitala w Kijowie .	zabrano	10	0
Jak się ją trenuje ?	trenuje	3	3
Nadal nie wiedzą , jaka będzie matura .	wiedzą	2	3
- Obejrzyj go sobie dokładnie .	Obejrzyj	1	2
Na czele stoi król - Ashantehene , otoczony radą starszych .	stoi	2	3
Kościół nie zobowiązuje katolików do tego , aby wierzyli w cuda .	zobowiązuje	2	3
Ale nie musimy się aż tak spieszyć .	musimy	2	1
Usmaż jeszcze kiedyś faworki , błagam .	Usmaż	0	2
Dziś znów ubecja krąży po osiedlu .	krąży	3	3
Naprawdę tego żałuję .	żałuję	2	1
– Puśćcie !	Puśćcie	1	2
- Zrobimy pana landrata na szosie w podgórskim pejzażu .	Zrobimy	1	1
3mamy ! !	3mamy	0	1
I dlatego ich potępiamy .	potępiamy	3	1
Zwodujcie Wałęsę .	Zwodujcie	0	2
Sprawę wyjaśnimy .	wyjaśnimy	1	1
Klienci bardzo chętnie gwałcą i matkę , i syna .	gwałcą	3	3
Oburzamy się , że prezydent Juszczenko stawia pomniki Banderze i pielęgnuje pamięć o nim i jego bandziorach .	Oburzamy	0	1
Rozwijano taśmę , wbijano paliki , ustawiano płotki , a w niebie i w krzewach śpiewały ptaki .	wbijano	3	0
Zgadzam sie z Tobą . . .	Zgadzam	0	1
Czemu mi ją obrzydzacie ?	obrzydzacie	3	2
mów dalej .	mów	0	2
Nie psuj im humorów .	psuj	1	2
- Nie znasz jej .	znasz	2	2
Potajemnie przygotowują prezenty .	przygotowują	1	3
Mówmy o czymś przyjemniejszym .	Mówmy	0	1
Oskarżano nas , że w Bielicznej sprzedali śmy prywatnemu nabywcy kilkaset hektarów wraz z cmentarzem i cerkwią .	Oskarżano	0	0
– przepraszam .	przepraszam	1	1
Opinia publiczna sprzyja Małkowskiemu .	sprzyja	2	3
Nie jadamy mięsa , a sto złotych nie starcza .	jadamy	1	1
Stalowa linka była opuszczona , deskę umocowano do zaczepu i uniesiono do pionu .	umocowano	6	0
Ażeby takim przykrym kolizyom zaradzić , puszczamy w świat ten oto podręcznik .	puszczamy	6	1
Błogosławię jej , na ile mogę .	Błogosławię	0	1
– zrób jeszcze herbatę .	zrób	1	2
Zdarza się , że kompresja niszczy nerki .	niszczy	5	3
Niemieccy policjanci twierdzą , że w rachubę nie wchodzi kolizja z innym pojazdem .	wchodzi	8	3
- Myśleli śmy , że się nie uda .	uda	7	3
Za Chruszczowa bibliotekę zlikwidowano .	zlikwidowano	3	0
Myślę o tym człowieku , który mnie podglądał .	Myślę	0	1
– Nie twierdzę , że działamy najlepiej i nie popełniamy błędów .	działamy	5	1
Miejsc tych tragedii nie wizytują premierzy , ministrowie czy samorządowi notable .	wizytują	4	3
Wchodzimy w wiraż , coraz bardziej zbliżając się do sklepienia kanału , które naraz przybiera jaskrawoniebieski kolor z domieszką fosforyzującego fioletu .	Wchodzimy	0	1
Mówią , że kobieta wcale nie była w ciąży .	Mówią	0	3
– nie opisuj tylko zjedz . .	zjedz	4	2
Zdradzisz nam sekrety urody Cosmodziewczyny ?	Zdradzisz	0	2
- Nie tęskni Pan za niespełnionym marzeniem ?	tęskni	2	3
Nie zajedziesz nigdy , nie odwiedzisz .	zajedziesz	1	2
Czy zdążymy przed deszczem pochować pana Sierożę ?	zdążymy	1	1
- Daj , podpiszę .	podpiszę	3	1
– nie jeżdżę przez te okolice .	jeżdżę	2	1
Jemu się spowiadamy z drobnych grzeszków .	spowiadamy	2	1
Objęto nim sto dwadzieścia jeden zakładów .	Objęto	0	0
- Mieszkamy tu wszyscy od urodzenia , lecz nigdy jej nie widzieliśmy .	Mieszkamy	1	1
Po rozwodzie zwykle pozbawiano ich prawa do opieki nad dziećmi .	pozbawiano	3	0
Spekulowano nawet , że odejdzie z partii wraz z Jurkiem .	Spekulowano	0	0
I tak zostanie .	zostanie	2	3
O tym , że dzieci przeżywają koszmar , dorośli dowiadują się najczęściej przypadkiem .	przeżywają	5	3
Sprowadzono go depeszą .	Sprowadzono	0	0
„ Pogadam ze Stanleyem .	Pogadam	1	1
- Uciekaj .	Uciekaj	1	2
Czasami przypali zupę , czasami stłucze talerz z pomidorówką .	stłucze	5	3
W pełni popieramy tę zmianę .	popieramy	2	1
Tak ją tu wszyscy nazywamy .	nazywamy	4	1
- No widzicie ?	widzicie	2	2
Łamią się piersi , trzeszczy kość , próchnieją dłonie , twarze bledną . . .	trzeszczy	4	3
Witam na pierwszym krótkim spotkaniu .	Witam	0	1
– Czy oni znają jakąś prawdę , czy mogą znać jakąś prawdę ?	mogą	8	3
Możecie mi to wytłumaczyć ? ?	Możecie	0	2
Sto lat temu w Tucholi na gaz zapalano latarnie .	zapalano	7	0
- To wypracowuje się na codziennych , mozolnych próbach .	wypracowuje	2	3
- Znowu zajmujesz się jakimś morderstwem ?	zajmujesz	2	2
Szafę zamykamy na klucz i obiecujemy sobie otworzyć ją dopiero po egzaminach .	obiecujemy	5	1
ja im tłumacze .	tłumacze	2	1
Nie zatamujesz krwi fałszywym bandażem .	zatamujesz	1	2
Śpiewa ją na koncertach , bo publika , nie zawsze trzeźwa , domaga się .	Śpiewa	0	3
Postawisz mi pizzę ?	Postawisz	0	2
Ewakuuje się ludzi z kolejnych miejscowości .	Ewakuuje	0	3
Wkrótce będziesz w dużo lepszej kondycji .	będziesz	1	2
- A trafisz ?	trafisz	2	2
Przewiduję obopólne korzyści .	Przewiduję	0	1
- Pójdziesz za to siedzieć , wiesz ?	Pójdziesz	1	2
Gdzież ja tyle zarobię .	zarobię	3	1
Używaj zawsze tych samych słów i określeń .	Używaj	0	2
Wracajcie do Polski !	Wracajcie	0	2
W Konstancinie-Jeziornie i Spale przygotowują się piłkarskie reprezentacje do nadzwyczaj ważnych spotkań .	przygotowują	4	3
Aby pomóc przewodnikom w sporządzeniu spisu potrzebnych rzeczy , podajemy przykładowe zestawy sprzętu dla poszczególnych działów prac na kolonii .	podajemy	9	1
Pojazd poddano szczegółowej kontroli .	poddano	1	0
O wywiad z prezydentem zabiegam od 3 miesięcy .	zabiegam	4	1
W inscenizację umiejętnie wkomponowano wspomnienia nauczycieli i byłych uczniów .	wkomponowano	3	0
Pod żadnym pozorem nie zgadzaj się na pozostanie w domu w przyszły weekend .	zgadzaj	4	2
Siedzimy naprzeciw siebie , pijemy herbatę , jemy piernik domowego wypieku .	Siedzimy	0	1
– dej spokój .	dej	1	2
Wybierz dowolny chat , umów się z przyjacielem na określoną godzinę i rozmawiaj do woli .	Wybierz	0	2
Ty patrz , co ty widzisz .	patrz	1	2
Rosyjscy eksperci uważają , że De Beers wzbogaca się nieuczciwie kosztem innych członków kartelu .	wzbogaca	7	3
Nie wprowadzono prywatnej własności ziemi , nie zniszczono feudalnego imperium dyrektorów kołchozów .	zniszczono	7	0
Zamyka oczy , jakoś tak dziwnie sapie .	sapie	6	3
- Nie trza , damy se sami radę !	damy	4	1
Wolał by m , aby nowe zasady wprowadzono już od roku 1999 .	wprowadzono	7	0
W obliczu trudnej sytuacji na rynku pracy , 9-miesięczna przygoda w wojsku wydaje się dla nich niemiłą perspektywą .	wydaje	12	3
Zastanów się nad tym !	Zastanów	0	2
Może to dla Ciebie niewiele znaczy , ale MI twój wiersz podobał się bardzo .	znaczy	5	3
już rozpoczynam .	rozpoczynam	1	1
Nie niszcz mojego dzieła !	niszcz	1	2
Zatrzymuje się przed innymi drzwiami i puka w umówiony sposób .	puka	6	3
- Odpocznij trochę , dziecko .	Odpocznij	1	2
Zapalono wszystkie lampy , ustawiono ruchome wieszadła , kelnerzy w oczekiwaniu gości spacerowali po korytarzach hotelowych .	Zapalono	0	0
Nika , nie gap się .	gap	3	2
Od kilkunastu miesięcy w kraju działa Agencja Cenowa .	działa	5	3
Za chwilę kardynałowie i biskupi wyniosą obraz Matki Bożej Jasnogórskiej na ołtarz przed kościołem .	wyniosą	5	3
- Całkowicie zgadzam się z odkryciami naukowców .	zgadzam	2	1
- Czy różnice interesów w koalicji nie przeszkodzą w kontynuowaniu reform ?	przeszkodzą	7	3
Zawsze milczysz niepotrzebnie .	milczysz	1	2
- Patrz !	Patrz	1	2
I uważaj , co mówisz !	uważaj	1	2
Zaliczmy banana do żywotnych i nie będzie wyjątku . . .	Zaliczmy	0	1
Cieszymy się , że ojciec przybył , brakuje nam ludzi .	Cieszymy	0	1
Z przodu oboma dłońmi chwytamy za przedramię zgięte w stawie łokciowym .	chwytamy	4	1
– już się nie zastanawiają .	zastanawiają	4	3
Unikaj słów o podwójnym znaczeniu .	Unikaj	0	2
Kolor pełni w obu rodzajach reklamy bardzo interesującą funkcję .	pełni	1	3
Powiedzieli , że dom płonie .	płonie	4	3
Nie pozwól , by ścigali cię na oko .	pozwól	1	2
Ten fakt nie podlega dyskusji .	podlega	3	3
Jeśli pogoda dopisze , będziemy wykonywać te prace bez przerwy .	dopisze	2	3
Najchętniej jada golonkę z piwem i staropolskiego schabowego z kostką .	jada	1	3
Nie przyznam się , o czym myślał em .	przyznam	1	1
I wszystkim obalonym zwyczajom wrócono ich dobre imię .	wrócono	4	0
- Jeszcze będziecie mieli rozrywkę , zobaczycie .	zobaczycie	6	2
– pójdę do Jędrzeja .	pójdę	1	1
Przywileje jednych utrzymują się dzięki mizerii innych .	utrzymują	2	3
Posłuchajcie , prześmiewa się z naszej drogi , chichocze .	Posłuchajcie	0	2
- Nie śpiesz z tym .	śpiesz	2	2
- Skaczesz , rozglądasz się i wracasz .	Skaczesz	1	2
- Czy pan chce zakneblować usta ludziom , którzy na ulicach protestują przeciwko rządzącym ?	protestują	11	3
Wszystkich ich wzywano na policję i przesłuchiwano .	przesłuchiwano	6	0
Wg mnie chrzanisz .	chrzanisz	2	2
Musicie go przyprowadzić .	Musicie	0	2
Tak myślisz ?	myślisz	1	2
Czołgi i wozy pancerne strzegą więzienia , do którego ciężarówki wojskowe bez przerwy przywożą aresztowanych .	strzegą	4	3
– Bo chyba pana Macierewicza trzymają się żarty .	trzymają	5	3
I wyrzucano .	wyrzucano	1	0
W grobie znaleziono szczątki kilku osób .	znaleziono	2	0
Żyje dzięki komuś , kto rozumiał to hasło .	Żyje	0	3
- Pogaaaniaaaj !	Pogaaaniaaaj	1	2
Zobacz , płyty są w skrytce przed tobą .	Zobacz	0	2
Ale nie robimy mu łaski .	robimy	2	1
Cały teren splantowano , a niedługo zostanie wykonane nowe ogrodzenie .	splantowano	2	0
Idzie zima .	Idzie	0	3
Natychmiast wyruszymy .	wyruszymy	1	1
A jednak się żegnam .	żegnam	3	1
– Wyglądasz staro .	Wyglądasz	1	2
Ewakuowano 200 gości hotelowych .	Ewakuowano	0	0
Kiedy rysuje , odlewa wielkie postaci w brązie i tworzy delikatne maski z żywicy , nigdy nie zatrzymuje się na jednym egzemplarzu .	odlewa	3	3
Tracę wolny czas .	Tracę	0	1
W szpitalach wreszcie zaczęto je traktować podmiotowo .	zaczęto	3	0
Dwa lata leży w aktach ohyda .	leży	2	3
- Piszcie zgodnie z sumieniem .	Piszcie	1	2
Poniosę cię .	Poniosę	0	1
Także w ubiegłym roku zniszczono nagrobki na cmentarzach w Gdyni i Kielcach .	zniszczono	4	0
Z obu stron drogi zaczęto strzelać do nich z granatników i broni maszynowej .	zaczęto	4	0
Dlatego część historyków fińskich kwestionuje badania Silvennoinena , zarzucając mu pogoń za sensacją .	kwestionuje	4	3
Wtedy Bóg złapie to całe towarzystwo łącznie ze mną i wrzuci w ogień piekielny , a będzie tam płacz i zgrzytanie zębów .	wrzuci	10	3
- Powtarzam i wykonuję .	wykonuję	3	1
Niemcy ciągle kontratakują w Normandii .	kontratakują	2	3
- Szybko mijają te kraje .	mijają	2	3
– słuchaj .	słuchaj	1	2
Wyrzekliśmy się naszych zasad i małpujemy kraje , które pogrążyły się w nihilizmie moralnym !	małpujemy	5	1
Ale może wrócę .	wrócę	2	1
Wkrótce zawiniemy do Trondheim .	zawiniemy	1	1
To jest środowisko , które dzisiaj narzuca ton władzy w Polsce .	narzuca	6	3
Zwykle w zimę odżywiamy się nieźle .	odżywiamy	3	1
– za dwadzieścia minut się zbieram . .	zbieram	5	1
W 10 sklepach sprzedawcy odmówili , żądając okazania dokumentów , w jednym przypadku alkohol sprzedano .	sprzedano	14	0
- Umiesz markować na kasie ?	Umiesz	1	2
Sprawą zajmują się policjanci z 6 komisariatu na Górnej .	zajmują	1	3
Sama je wymyślam .	wymyślam	2	1
Uświadamiasz sobie , że myślisz .	Uświadamiasz	0	2
- Dlaczego jej pomagasz ?	pomagasz	3	2
W ministerstwie unikają komentarzy .	unikają	2	3
Zdaniem lekarzy , szpitale cierpiące na brak pieniędzy podejmują drastyczne programy oszczędnościowe .	podejmują	8	3
- A ja się nigdy nie przyzwyczaję do tego barbarzyństwa .	przyzwyczaję	6	1
Opcja ta ogranicza odpowiedzi do 145 bajtów .	ogranicza	2	3
Opodal przeciągnięto niedawno linię wysokiego napięcia .	przeciągnięto	1	0
Niczego mi nie oszczędzono .	oszczędzono	3	0
Zaraz spróbuję lepiej wyjaśnić , co mam na myśli .	spróbuję	1	1
Do skomplikowanych wzorów używamy deski przywiązanej do sznurka .	używamy	3	1
Otwiera oczy .	Otwiera	0	3
- Może razem jechać , weźmiemy motor ?	weźmiemy	5	1
Nie udźwignie już miecza krwawego ręka syna struchlała .	udźwignie	1	3
Latem wyganiano zwierzęta przed świtem .	wyganiano	1	0
Czy gdzieś już w Polsce modlono się do telewizora ? ? ?	modlono	5	0
- Przeprowadzono w nich kontrole .	Przeprowadzono	1	0
- Niech pan zajmie miejsce .	zajmie	3	3
W kierunku zachodnim przewożono ich mercedesem .	przewożono	3	0
Ja klękam , uklęknijcie ze mną . . .	uklęknijcie	3	2
Miasto burzymy .	burzymy	1	1
- A wiesz , czym zajmuje się tutaj ?	wiesz	2	2
W oddzielnych grupach ćwiczą panie i panowie , później znów spotykają się i odbywają wspólnie zajęcia choreograficzno - taneczne .	odbywają	13	3
- Obrażacie nas .	Obrażacie	1	2
Ściany osłonowe zewnętrzne wykonano z żywic epoksydowych .	wykonano	3	0
Weź Lolkę i idźcie na górę .	idźcie	3	2
Wiecie także , iż w wielu miejscach toczą się walki z siłami , które w imię swych egoistycznych interesów chcą powstrzymać pochód postępu na świecie .	Wiecie	0	2
A przyjrzyj się treści katechezy w Polsce międzywojennej .	przyjrzyj	1	2
Odwiedzają moją sąsiadkę , bladą dziewczynę spod ściany .	Odwiedzają	0	3
- Dzieci , co mówicie .	mówicie	4	2
Pomyśl też o innej możliwości .	Pomyśl	0	2
Okazuje się , że zaproszona grupa baletowa prawdopodobnie będzie musiała zrezygnować z udziału w festiwalu .	Okazuje	0	3
Romansuje z sekretarką ?	Romansuje	0	3
Przestaję myśleć jasno .	Przestaję	0	1
Przyznaje , że w jej życiu skończyła się pewna epoka .	Przyznaje	0	3
Stoi i patrzy .	Stoi	0	3
- Napijmy się .	Napijmy	1	1
- Słyszę silny szum i tętnienie .	Słyszę	1	1
– chodź tu .	chodź	1	2
Uważam , że już niedługo będziemy mogli oglądać filmy .	Uważam	0	1
Chodźcie za mną .	Chodźcie	0	2
Wiecie , kiedy się odzywa ?	Wiecie	0	2
Już teraz wielu rzeczom podołamy .	podołamy	4	1
- A niby czemu przeczę ?	przeczę	4	1
Podwyżka zmniejszy ponoszone przez spółkę straty .	zmniejszy	1	3
Szanuję to .	Szanuję	0	1
Jeśli nie zatrąbisz , ośmieszysz nas .	zatrąbisz	2	2
W Warszawie pada śnieg .	pada	2	3
W dniu Debaty zamykam się razem ze stosem dokumentacji w pokoju redakcyjnym , wyłączam telefon komórkowy i nie ma mnie praktycznie dla nikogo .	zamykam	3	1
Często wykorzystujemy znajomości i dojścia zaprzyjaźnionych osób .	wykorzystujemy	1	1
Jeśli państwo zaczekacie , mogę zapłacić tę sumę w przyszłym tygodniu .	zaczekacie	2	2
- Dlaczego pytasz ?	pytasz	2	2
- Zamykam dyskusję .	Zamykam	1	1
Ostatecznie postępowanie umorzono .	umorzono	2	0
– a co tam kombinujesz z tym rondelkiem ?	kombinujesz	4	2
Niektóre sale pałacyku w Karolinie przeznaczono na małe muzeum .	przeznaczono	5	0
Dwa tygodnie temu oddano do użytku salę gimnastyczną przy II Liceum Ogólnokształcącym .	oddano	3	0
Właścicielom wystarcza kino domowe , a bogate panie nie potrafią docenić kunsztu Anny Jaxy - Chamiec .	wystarcza	1	3
W poniedziałek we wczesnych godzinach popołudniowych podano , że zdołano uratować siedemset dwadzieścia dwie osoby .	zdołano	9	0
- Ty nie wiesz ?	wiesz	3	2
Nad głową ojca dyrektora od kilku tygodni gromadzą się czarne chmury .	gromadzą	7	3
Tu przydzielono legię włoską .	przydzielono	1	0
- Wielu z nich rzeczywiście nawiązuje do debaty w mediach , ale niech ich wiarygodność ocenia prokurator .	nawiązuje	5	3
Napiszcie , co robić .	Napiszcie	0	2
Układy ACC technologiczne stosuje się przede wszystkim do obróbki zgrubnej w celu maksymalizacji wydajności obróbki .	stosuje	3	3
Chłodna i metodyczna , troszczysz się bardzo o wypełnianie swych obowiązków .	troszczysz	4	2
Skórkę zostawia się na talerzu .	zostawia	1	3
Równocześnie wznoszono nowoczesne dzielnice mieszkaniowe .	wznoszono	1	0
- Weź te ręce , gówniarzu !	Weź	1	2
Słyszymy dzwony z oddali , szczekanie psa , odgłosy zasypiającego Przymorza .	Słyszymy	0	1
W pełni popieramy tę zmianę .	popieramy	2	1
W tej sytuacji utworzono ligi międzyuczelniane .	utworzono	3	0
Wydaje się , że ktoś idzie , a on już leży na ziemi .	leży	10	3
Zmuś ziemię , by wykarmiła swoje nędzne dzieci .	Zmuś	0	2
Wszyscy się pocą .	pocą	2	3
Czy tak zachowuje się dżentelmen ?	zachowuje	2	3
Niemal bez przerwy gramy w turniejach europejskich .	gramy	3	1
- Polecisz .	Polecisz	1	2
- Jak często występujecie przed publicznością ?	występujecie	3	2
Wejdźcie więc do podziemnych lochów pełnych zasadzek i niespodzianek .	Wejdźcie	0	2
Mylisz się .	Mylisz	0	2
Wstaję , wyglądam przez okno .	wyglądam	2	1
- Zaraz , zaraz , już wstaję !	wstaję	6	1
Kiedy wdychasz powietrze , czuj to .	czuj	4	2
Nie łudźmy się , że będziemy pierwsi .	łudźmy	1	1
O szczegóły poprosimy porucznika Achselringa .	poprosimy	2	1
Przebywa tam nadal .	Przebywa	0	3
Udzielam głosu pierwszemu mówcy , senatorowi Czai .	Udzielam	0	1
Wiem , że tu przyjdziecie .	przyjdziecie	4	2
Z pomocy skorzysta ok. 300 rodzin .	skorzysta	2	3
Zaproponowali , że przerobią telefon tak , by można było z niego bezpłatnie rozmawiać .	przerobią	3	3
Codziennie dowożą jej jedzenie i wodę .	dowożą	1	3
Więc skąd o tym wiesz ?	wiesz	4	2
Kochaj siebie !	Kochaj	0	2
Kochaj siebie !	Kochaj	0	2
Błagam , nie chorujcie i żadnych kłopotów nie miejcie !	Błagam	0	1
To bardzo denerwujące , bo nie wiesz , o czym mówisz .	wiesz	6	2
Uważano , że są one w dużym stopniu dziedziczne .	Uważano	0	0
Przyjechano tylko raz .	Przyjechano	0	0
Chciał spać , ale nie pozwolono mu .	pozwolono	5	0
- Mówię , żeby ś wiedziała .	Mówię	1	1
Zaczynam grę .	Zaczynam	0	1
się nazywam .	nazywam	1	1
Rozdają publiczne pieniądze na rzecz Kościoła katolickiego , modlą się żarliwie przed kamerami , marzą o cenzurze obyczajowej .	marzą	14	3
Mogę walczyć , choć z zasady nie biję kobiet .	biję	7	1
Czy nie brzmi nazbyt trywialnie ?	brzmi	2	3
Niech pan pomyśli , jaką rodzice mieli by niespodziankę , gdyby pan ukończył siedem klas .	pomyśli	2	3
Rozmaite padliny wieszano na Sienkiewiczu , ale ja w jego obronie zawsze staję .	wieszano	2	0
– Nie przychodzicie razem z małym do Piaskownicy ?	przychodzicie	2	2
Poszukuję wszelkich materiałów .	Poszukuję	0	1
Nakryto tu silną stację nadawczą .	Nakryto	0	0
Odjadę wkrótce .	Odjadę	0	1
A któż z Was nie czuje się pokrzywdzony ?	czuje	5	3
- Nie mów tak !	mów	2	2
– Mam , ale na razie nie ujawniam .	ujawniam	7	1
Czarna suka posapuje .	posapuje	2	3
A teraz oddajemy głos naszej drogiej doktor Bernie .	oddajemy	2	1
Dzieci spędzają noce w oddziale noworodków .	spędzają	1	3
Ponadto bardzo pragniesz się podobać .	pragniesz	2	2
W turnieju kobiet w pool - bilardzie rywalizowano o puchar burmistrza Ciechocinka .	rywalizowano	7	0
Idę płakać nad moim losem .	Idę	0	1
Urządzimy też prywatny gabinet .	Urządzimy	0	1
Pozmywaj i ogarnij kuchnię .	Pozmywaj	0	2
Już 9 dni z nim się męczę . . .	męczę	6	1
Zatrzymano 138 osób .	Zatrzymano	0	0
Okrzyczą go zdrajcą .	Okrzyczą	0	3
Mimo to naukowcy zalecają ostrożność w rozpowszechnianiu komórek wśród dzieci i młodzieży .	zalecają	3	3
Uwielbia tańczyć , kołysana na rękach .	Uwielbia	0	3
Ze stadionu zniknie także bieżnia lekkoatletyczna .	zniknie	2	3
Takie parlamentarne metody nie odpowiadają mi , rozumiecie ?	rozumiecie	7	2
Powrócono do szkoleń politycznych , na których trzeba było walczyć z wszechogarniającą sennością .	Powrócono	0	0
- Jako człowiek próżny chętnie wracam do rzeczy przyjemnych .	wracam	5	1
Wszystko błyszczy , kręci się , tańczy .	kręci	3	3
Ponoszę porażki , niepowodzenia wychowawcze .	Ponoszę	0	1
Dochodzą niepokojące sygnały dotyczące prywatyzacji stoczni .	Dochodzą	0	3
Na koniec doszywamy pętelkę do powieszenia .	doszywamy	2	1
Będę więc dalej pracować , pojutrze lecę do Meksyku , ale w sobotę wracam .	lecę	6	1
Wszelkie informacje podane poniżej dotyczą jedynie wypadków sprawdzonych .	dotyczą	4	3
Stawiam przed nim Sikorskiego , mimo wszystko .	Stawiam	0	1
Zapytał mnie w pewnym momencie , czy do niego pójdę .	pójdę	9	1
– zaraz się rozgadam . .	rozgadam	3	1
Skąd wzięto tyle szmalu ?	wzięto	1	0
Rozumiesz mnie ?	Rozumiesz	0	2
Obu szwedzkim dyplomatom zarzucono też działalność wykraczającą poza ich oficjalny status .	zarzucono	3	0
Wystarczy , że celnik na niego spojrzy .	spojrzy	6	3
- Wstydź się , Zuzanno , tak kłamać , zapłacił ci za Jadzię .	Wstydź	1	2
Teraz umocnią się na rynku .	umocnią	1	3
Posłuchajcie , prześmiewa się z naszej drogi , chichocze .	chichocze	8	3
On jej wyrywa .	wyrywa	2	3
– kto tym ludziom pomaga ?	pomaga	4	3
- Słowo daję , że się nie gniewam .	gniewam	7	1
Słyszałam , że nieźle sobie radzisz .	radzisz	5	2
Tylko spróbuj !	spróbuj	1	2
Nie czuję się przekonany .	czuję	1	1
- Idę się położyć , jutro muszę raniutko wstać .	Idę	1	1
Żonaty , ma 20-letnią córkę .	ma	2	3
Nazywa się Bonda .	Nazywa	0	3
- Zostaw babcię w spokoju , nie widzisz , że to jeszcze panna .	Zostaw	1	2
Kup ją , a przekonasz się , że odmieni także twoje .	przekonasz	4	2
- Pytam , co sądzisz , a nie czy byłeś .	sądzisz	4	2
A przecież parę razy podrabiano mi przecież dokumenty i jakąś współpracę .	podrabiano	4	0
Nawet Nagroda Nobla mu nie dorównuje !	dorównuje	5	3
- Analfabetyzmowi wydali śmy zdecydowaną walkę , spodziewamy się niebawem zlikwidować go całkowicie .	spodziewamy	7	1
Wróćmy na Kościelec , na jego piękną zachodnią ścianę .	Wróćmy	0	1
Tam stawiamy nosze .	stawiamy	1	1
Oczywiście do tych protokołów komisja sięgnie .	sięgnie	5	3
Wszystko się kołysze , obie jednostki płyną .	płyną	6	3
Czy czasami nie zapłacono dwa razy za to samo ?	zapłacono	3	0
Na szczególną uwagę zasługują wyraźnie zaakcentowane potrzeby pracy nad własnym charakterem .	zasługują	3	3
Czasem schodzisz na ziemię .	schodzisz	1	2
Podobną akcję przeprowadzono w czasie wojny w Zatoce Perskiej w 1990 r.	przeprowadzono	2	0
- Idź spać .	Idź	1	2
– Tam ludzie chcą odpocząć .	chcą	3	3
Wszystko wskazuje na to , że dopuszczono się umyślnego podpalenia .	dopuszczono	6	0
A ty , Adam , nic nie kombinuj .	kombinuj	7	2
– ty czytasz Jackowi bajki do snu tak na fotelu ?	czytasz	2	2
Później połączono go z lądem groblą .	połączono	1	0
A znamy i dawniejsze .	znamy	1	1
20 osób ewakuowano w nocy z czwartku na piątek z domu przy ul. Wawrzyniaka .	ewakuowano	2	0
Zabijecie je .	Zabijecie	0	2
Wschodni wiatr ludzi nie popędza do głupstw .	popędza	4	3
- Zalewasz .	Zalewasz	1	2
Pokaże także adresy różnych instytucji , wyświetli kolorowy rozkład jazdy i poda repertuar kin czy teatrów .	wyświetli	6	3
Wisła w Toruniu przekroczyła stan alarmowy o 80 cm , a wody wciąż przybywa .	przybywa	13	3
Informuję , że zgłosili się posłowie w celu wygłoszenia oświadczeń poselskich .	Informuję	0	1
I nie tracić czujności , bo wtedy , kiedy wierzysz , że szczęście jest blisko , tak jak teraz , pojawia się archanioł z mieczem .	wierzysz	9	2
Dotyczy ta ballada przygody filozoficznej chłopka-roztropka .	Dotyczy	0	3
- Może pan zdradzić , dlaczego pan tak interesuje się tą górą ?	interesuje	8	3
Nie odwódźcie . . .	odwódźcie	1	2
Chcemy odwiedzić kolegów .	Chcemy	0	1
Na ciałach ofiar nie stwierdzono żadnych obrażeń .	stwierdzono	4	0
Myślę , że tak właśnie powinni zachowywać się odpowiedzialni kandydaci .	Myślę	0	1
Ułoży się most , star przejedzie , kratownice wrócą na miejsce , zatrzemy ślady i poczekamy .	zatrzemy	12	1
Bardzo zachęcam do wizyty w ICM i stałego korzystania z jej usług .	zachęcam	1	1
W połączeniu z manipulowaniem ostrością tworzy to klimat z pogranicza jawy i nierzeczywistości o niejasnej proweniencji .	tworzy	5	3
Prokuratura Apelacyjna współpracuje w tej sprawie z oddziałami CBŚ we wspomnianych miastach i Urzędami Kontroli Skarbowej .	współpracuje	2	3
Jego zakład działa już 11 lat .	działa	2	3
- Macie rację , tylko Hiszpanie mogli wymyślić barok .	Macie	1	2
Bandytów nie złapano .	złapano	2	0
Odebrano im łup i zrabowaną broń .	Odebrano	0	0
Szeptano , że ma źle w głowie .	Szeptano	0	0
Chodź , wyskoczymy na chwilę .	wyskoczymy	2	1
- Weźmiesz mu szczyptę , jeżeli usnął .	Weźmiesz	1	2
Woli produkować .	Woli	0	3
Czym latają nasze VIP-y ?	latają	1	3
– jak wy się na tym łóżku mieścicie teraz ?	mieścicie	7	2
Słyszysz mnie ?	Słyszysz	0	2
Spluwę włożę do buzi , nacisnę spust .	włożę	1	1
Rodzice w różnym stopniu angażują się w wychowanie dzieci .	angażują	4	3
Dyrektor Sender niepokoi się , czy to nie jest jakaś Solidarność .	niepokoi	2	3
Robi mi się przykro , a jednocześnie ogarnia mnie złość .	ogarnia	7	3
- Pomagasz mi .	Pomagasz	1	2
- Szoruj , no !	Szoruj	1	2
Wzrośnie w tym roku dostępność studiów wyższych .	Wzrośnie	0	3
- Chłopaka w beznadziejnym stanie przywieziono do Zabrza .	przywieziono	5	0
Zawsze mówię , że mogę pracować , bo mam dobre zdrowie , a to jest darmo dane .	mówię	1	1
Przyjdziesz dziś po obiedzie ?	Przyjdziesz	0	2
Policja przesłuchuje świadków , zbiera informacje , zabezpiecza ślady .	przesłuchuje	1	3
- A co pana najbardziej stresuje ?	stresuje	5	3
– chcesz porysować .	chcesz	1	2
To naprawdę zdarza się bardzo rzadko .	zdarza	2	3
- Walendziak dyscyplinuje .	dyscyplinuje	2	3
- Zaśniesz sam .	Zaśniesz	1	2
Teraz zwłoki Odiego leżą w chłodni .	leżą	3	3
Iracki dyktator twierdzi , że to skutki pocisków uranowych , a nie jego arsenału bakteriologiczno - chemicznego .	twierdzi	2	3
W pracy pytano mnie , dlaczego tak źle wyglądam .	pytano	2	0
Nie puszczamy w powietrze materiałów obciążających .	puszczamy	1	1
– chłopaki zaśpiewają jakąś ckliwą melodię . .	zaśpiewają	2	3
Przypuszczam , że chodzi raczej o to , iż wybrał się samowolnie !	Przypuszczam	0	1
Miasto Detroit do tej pory płonie , a wyjątkowo upalna pogoda sprzyja rozszerzaniu się pożarów .	sprzyja	11	3
Ale tak się nasz naród rozprasza . . .	rozprasza	5	3
Wracamy do szosy i jedziemy w stronę sąsiedniego Falsztyna .	jedziemy	4	1
- A wiesz , czym zajmuje się tutaj ?	wiesz	2	2
- Przechodzimy do głosowania nad założeniami polityki pieniężnej na 1995 r .	Przechodzimy	1	1
Każdy duży sklep samoobsługowy lub mięsny wyposażono w krajalnice do wędlin .	wyposażono	6	0
- Wytłumaczysz .	Wytłumaczysz	1	2
i zmieniono to i się rozpadło wszystko .	zmieniono	1	0
– Masz takie męskie dłonie , January .	Masz	1	2
Nie odwódźcie . . .	odwódźcie	1	2
Zerkasz na grafik i widzisz , ze dzisiaj to jego obowiązek .	Zerkasz	0	2
W 1979 utworzono tu Szkołę Mistrzów Pszczelarskich .	utworzono	2	0
Po drodze nachyla się ku lampie stojącej na stole .	nachyla	2	3
Ich ciała pogrzebano w pobliżu .	pogrzebano	2	0
Na północy i wschodzie strzelano .	strzelano	4	0
- Nie wiem , czy mnie puszczą , może będą się bali .	puszczą	6	3
- Zbliżają się wybory prezydenckie .	Zbliżają	1	3
Nie martw się , już przechodzę .	przechodzę	5	1
- Dziękuję bardzo .	Dziękuję	1	1
Około jedenastej śniadania się kończyły , zamawiano czarne kawy , herbaty i kapucyny .	zamawiano	6	0
Powoduje wysokie bezrobocie i sprawia , że państwo zadłuża się na bardzo wysoki procent .	zadłuża	8	3
Wiemy również , ile to powinno kosztować .	Wiemy	0	1
Ostatnio tyle razy wyobrażała m sobie , że się do niego zbliżam .	zbliżam	11	1
Słuchaj , Piotr był zalany , spadał ze schodów , wyskakiwał z okna .	Słuchaj	0	2
Fascynują mnie także ludzie , z którymi współpracuję .	Fascynują	0	3
Przechodzimy do głosowania .	Przechodzimy	0	1
Ratuj się , kto może .	Ratuj	0	2
Moim zdaniem przesadzasz .	przesadzasz	2	2
Pozmywaj i ogarnij kuchnię .	ogarnij	2	2
Nie próbuj go oświecać .	próbuj	1	2
Ale zdecydowanie nie pozwalam , abyś nazywał mnie głupią albo pozbawioną rozumu .	pozwalam	3	1
W każdej chwili mogę zostać szoferem w Prezydium Rady Ministrów .	mogę	3	1
Obudzimy Anamarię o dwunastej .	Obudzimy	0	1
Ofiara miała przy sobie polski paszport i dzięki temu łatwo ją zidentyfikowano .	zidentyfikowano	11	0
Jak to wszystko człowiek wytrzymuje , nie wiem .	wytrzymuje	4	3
Nie daj się schwytać , nie daj się otropić .	daj	1	2
- Przyzwyczajajmy dzieci do picia mleka !	Przyzwyczajajmy	1	1
Utnij na dwie dulki i schodź , bo palić się strasznie chce .	Utnij	0	2
Podlewajcie kwiaty .	Podlewajcie	0	2
Tak długo zwracaj wolność , aż poczujesz , że jest to całkowicie szczere i autentyczne .	zwracaj	2	2
Kontraścikiem buchnie !	buchnie	1	3
Pokazano w tym filmie wieś spółdzielczą w skrócie . . .	Pokazano	0	0
Zajmujemy się sobą , myślimy o swoich ambicjach , urazach .	Zajmujemy	0	1
Monopoliści nakręcą inflację .	nakręcą	1	3
Decydując się na życie mnisze , Siostra odbiera sobie możliwość bycia matką .	odbiera	7	3
Preferujesz moralnośc opartą na miłosci bliźniego ?	Preferujesz	0	2
– e chyba nie wiesz ?	wiesz	4	2
na powodzian zbierają pieniądze .	zbierają	2	3
W siedzibie kłodzkiego starostwa powiatowego dowiaduję się , że Średzińskiego nie lubią tu , bo to postkomuch , a powiatem rządzi egzotyczna koalicja złożona z platformersów i byłych pisowców .	dowiaduję	5	1
Skończ już z tymi wspomnieniami , Siostro !	Skończ	0	2
Odpokutujecie za to !	Odpokutujecie	0	2
Tylko niektórzy użalają się na forach internetowych nad swoim losem .	użalają	2	3
- Gramy !	Gramy	1	1
Słucham , usłyszał em raźny głos matki .	Słucham	0	1
Ani my ciebie nie pobudzamy , ani ty się nie dzielisz .	dzielisz	10	2
- ROZMAWIAM , ZAWIERAM ZNAJOMOŚCI .	ROZMAWIAM	1	1
Nie ma lekarza , który wszystkim dogodzi .	dogodzi	6	3
Umiera w swoim ogrodzie .	Umiera	0	3
Tylko nie skacz .	skacz	2	2
Możesz z nim pójść do dowolnego obwodu .	Możesz	0	2
Przechodzimy do kolejnego pytania .	Przechodzimy	0	1
– Bywa , że rolnicy jeszcze przynoszą pisma .	przynoszą	6	3
" Szymonie , czy miłujesz Mnie ? "	miłujesz	4	2
Nie stwierdzono żadnych urazów kostnych " .	stwierdzono	1	0
nie strofujcie go .	strofujcie	1	2
Trzeci zapatrzy się gdzieś w przestrzeń .	zapatrzy	1	3
- Powtarzam i wykonuję .	Powtarzam	1	1
Trzymaj , włóż to do tego swojego plecaczka .	włóż	2	2
- Rozbierajcie się i chodźcie do środka .	Rozbierajcie	1	2
Mogą jedynie domagać się wynagrodzeń po wydaniu orzeczenia .	Mogą	0	3
Serce , rozumiesz . . .	rozumiesz	2	2
Uśpijcie mnie .	Uśpijcie	0	2
- My tu o wzniosłych rzeczach mówimy .	mówimy	6	1
spytasz się Wojtka w piątek ?	spytasz	0	2
- Bądź ostrożny ; bądź zawsze .	bądź	4	2
ja też się w to pobawię kiedyś . .	pobawię	5	1
Sąsiadka opiekuje się mocno starszym panem .	opiekuje	1	3
- Skaczesz , rozglądasz się i wracasz .	rozglądasz	3	2
Patrz przed siebie i czytaj w brodzie .	czytaj	4	2
Muszę wyjść od mojego sąsiada .	Muszę	0	1
Nakładamy rękawice ochronne , zapinamy swetry i wychodzimy na pokład .	wychodzimy	7	1
Może się okazać , że zbyt surowo oceniasz siebie .	oceniasz	7	2
Sąsiadów nikt sobie nie wybiera .	wybiera	4	3
W Tczewie w Radzie Miejskiej zasiada 23 radnych .	zasiada	5	3
Wstaję , wyglądam przez okno .	wyglądam	2	1
Spece od wizerunku doradzają Jarosławowi Kaczyńskiemu , żeby zapuścił wąsy , bo to odróżni go od brata .	doradzają	3	3
Jadę tramwajem .	Jadę	0	1
A my na te konto gruchniem sobie piwa .	gruchniem	5	1
Mucha spaceruje też po ścianie , dostrzegam ją spod przymrużonych powiek .	dostrzegam	6	1
- Patrz .	Patrz	1	2
Polscy producenci nie dają za wygraną , dotrzymując kroku modzie i zachodnim nowinkom .	dają	3	3
Przez chwilę siedzą w milczeniu , patrząc przez okno .	siedzą	2	3
Może masz telefon do niej ?	masz	1	2
" Józefie , chodź , to inny przedział . . . "	chodź	3	2
Bo teraz mogę swoją ideę realizować wszędzie .	mogę	2	1
Mówimy o sytuacji , w której budżet musi jednocześnie wytrzymać skutki rosyjskiego kryzysu i koszty tegorocznych reform .	Mówimy	0	1
Miasto Detroit do tej pory płonie , a wyjątkowo upalna pogoda sprzyja rozszerzaniu się pożarów .	płonie	5	3
Witamy , witamy . . .	witamy	2	1
Tej dziwce zaś już bobu zada !	zada	5	3
- Tylko ja o tym wiem , a ty jeszcze nie wiesz .	wiesz	11	2
Z jego zeznań wynika , że wczoraj około godziny 15 podjechał samochodem na ulicę Grażyńskiego .	wynika	3	3
W forcie więziono również Rosjan , Francuzów i Jugosłowian i niemieckich antyfaszystów .	więziono	2	0
Na razie nie ma jednak takiej potrzeby , bo linie 9 , 17 i 34 w pełni wystarczają do obsługi osiedla .	wystarczają	17	3
Siadam w kącie i usypiam , budząc się na Gare du Nord .	usypiam	4	1
Popatrz , Mike !	Popatrz	0	2
– a dużo osób ma odrobiony piątek . .	ma	4	3
A więc może nieświadomie wyrządza mu krzywdę .	wyrządza	4	3
- Czy w szkołach pobliskich pracują nauczyciele z mniejszości ?	pracują	5	3
Ale nie pozbędziemy się problemu .	pozbędziemy	2	1
Idź natychmiast do niego .	Idź	0	2
Załóżmy , że jesteś złośnik i awanturnik .	Załóżmy	0	1
Zabieram ze skarbca tylko wczorajszy obrót .	Zabieram	0	1
Dla zdławienia partyzantów działających w górach rząd mobilizuje poważne siły zbrojne .	mobilizuje	7	3
Aktorstwo bardzo pochłania i to przenosi się na życie prywatne .	pochłania	2	3
Sporządzono także portrety pamięciowe napastników .	Sporządzono	0	0
Odrzutowiec z hukiem przekraczał barierę dźwięku , patrzyłem , jak rozpruwa niebo .	rozpruwa	10	3
Skoczę i przyniosę .	przyniosę	2	1
Jezus przynosi życie .	przynosi	1	3
Tomasz Gudzowaty poluje kamerą na lwy , gepardy , lamparty .	poluje	2	3
– rozwiązuje krzyżówki . .	rozwiązuje	1	3
Od wolnej woli wybaw nas , Panie .	wybaw	3	2
Zobaczymy , co zwiozą nam do młodni .	zwiozą	3	3
- Widzisz ?	Widzisz	1	2
Pytam , czy przekonała już kiedyś jakiegoś nauczyciela , że powinien zmienić pracę .	Pytam	0	1
- Teraz ubieraj się już , Simonne .	ubieraj	2	2
Może narażę się na krytykę ze strony pana premiera Pawlaka , ale wciąż zbyt wielkie znaczenie przywiązujemy do umów międzyrządowych .	narażę	1	1
- Ja ich nie obgaduję .	obgaduję	4	1
Dlaczego coś w rodzaju balonika wkładasz mi na głowę ?	wkładasz	5	2
Częściowo zdewastowano też chodnik na ulicy Młyńskiej .	zdewastowano	1	0
Odkryto wiele nadużyć .	Odkryto	0	0
Za taniochę ludek chętnie drogo płaci .	płaci	5	3
Meldował em , nie reagujesz .	reagujesz	4	2
Jego winę przejmują dzieci , wnuki .	przejmują	2	3
- Prześlę .	Prześlę	1	1
- Nie przesadzaj z tym zaufaniem .	przesadzaj	2	2
- A jakie przylatują , żeby spędzić z nami zimę ?	przylatują	3	3
Płacimy i idziemy na dworzec .	Płacimy	0	1
- I ja go kocham .	kocham	4	1
My takiej nie prowadzimy , nie wykonujemy zadań publicznych dla zysku , ale dla dobra mieszkańców .	wykonujemy	6	1
Lustrują pod wodą całe wschodnie wybrzeże Bałtyku .	Lustrują	0	3
Gdyby wiedział , nigdy , przenigdy by się to nie zdarzyło , bezwzględnie przyrzeka poprawę .	przyrzeka	13	3
Wtacza się pociąg .	Wtacza	0	3
Sięgam do kieszeni .	Sięgam	0	1
Ty się wstydzisz ? !	wstydzisz	2	2
Zaprzestań dążenia .	Zaprzestań	0	2
Na kolację , oprócz gulaszu , był chleb i masło , a do masła dodano nóż .	dodano	14	0
Kiedyś musieli za to płacić rodzice , teraz sami finansujemy nasze przyjemności .	finansujemy	9	1
Ale może wrócę .	wrócę	2	1
Ptaki te chętnie korzystają z pokarmu wykładanego dla parkowych łabędzi .	korzystają	3	3
Etiopczycy kontynuują atak , choć pod koniec ubiegłego tygodnia władze Erytrei poinformowały o wycofaniu swych oddziałów ze wszystkich spornych terenów nadgranicznych .	kontynuują	1	3
– Powieś hamak i połóż się w nim .	Powieś	1	2
Zaczynasz się dusić i myślisz tylko o tym , żeby się wyrzygać .	Zaczynasz	0	2
Nie zwracano na niego uwagi .	zwracano	1	0
Starczy mi sił .	Starczy	0	3
Jestem za ujawnieniem dokumentów IPN-u , niech każdy je oceni .	Jestem	0	1
Pod żadnym pozorem nie zgadzaj się na pozostanie w domu w przyszły weekend .	zgadzaj	4	2
Znaleziono przy nich skradzione zegarki oraz pistolet - straszak .	Znaleziono	0	0
- Idę się położyć , jutro muszę raniutko wstać .	Idę	1	1
Nie żałuję tego .	żałuję	1	1
Wszak w tej chwili interpretuję myśl ludzką sprzed 22 wieków . . .	interpretuję	4	1
W innych spotkaniach towarzyskich uzyskano następujące wyniki .	uzyskano	4	0
zatrzymano kilku kłusowników .	zatrzymano	0	0
Tutaj odpoczywam .	odpoczywam	1	1
Jak to skończysz , spróbuj Stendhala i Buddenbrooków Tomasza Manna . . .	skończysz	2	2
Bywa , że dzieci ulegają nam , podporządkowują się naszej woli .	Bywa	0	3
Zrobiono to poza moimi plecami .	Zrobiono	0	0
Bar , rozległą antresolę , poręcze i schody zrobiono z wypolerowanej stali .	zrobiono	8	0
Myślę , że to także była niefortunna wypowiedź .	Myślę	0	1
Czym to uzasadnisz ?	uzasadnisz	2	2
Na razie żeglarze z całego świata odpoczywają i bawią się w Talinie .	odpoczywają	6	3
Wyborcom oświadczono , że będą musieli przyjść nieco później .	oświadczono	1	0
Na koniec zacieramy ślady .	zacieramy	2	1
Bo krzyż zdążono już umieścić na ścianie katedry górującej nad miastem .	zdążono	2	0
No , zobaczymy .	zobaczymy	2	1
Padają Zakłady Cegielskiego w Poznaniu , a dialog przenosi się na ulice .	przenosi	8	3
Obie części składamy podszewką do środka , zszywamy po brzegach , obszywamy lamówką .	składamy	2	1
Ja wszystko zanotuję , a żona podpisze .	zanotuję	2	1
Składamy serdeczne podziękowania wszystkim tym , dzięki którym powstała nasza placówka .	Składamy	0	1
– Nie piernicz .	piernicz	2	2
Niedługo w sprawie umocujemy dodatkowego prokuratora , aby przyspieszyć prace .	umocujemy	3	1
Nim się nasze drogi rozejdą .	rozejdą	4	3
Nie kieruję się przy tym ideologią wegetariańską , choć z nią sympatyzuję .	sympatyzuję	11	1
Chłopiec wstaje , otwiera drzwi .	otwiera	3	3
Ja widział em ich niewiele , ale wciąż i wciąż mnie przed nimi ostrzegano .	ostrzegano	13	0
Później zabroniono podawać podroby .	zabroniono	1	0
Nie strasz klientów .	strasz	1	2
- Nie traktuję tego tak katastroficznie .	traktuję	2	1
Ostatnio sprzedano cztery pod elektrownie wiatrowe .	sprzedano	1	0
Prezes SSN deklaruje , że w kolejnych etapach zatrudni niemal wszystkich pracowników produkcyjnych .	deklaruje	2	3
Ona nie puszcza .	puszcza	2	3
Nie stwierdzono żadnych uchybień .	stwierdzono	1	0
Oddzielnie myjemy rzodkiewki i jej liście , od których oddzielamy części zepsute .	myjemy	1	1
Opowieść uczestniczy także w pochodzie performatywów , stwarza wzory i poglądy .	stwarza	7	3
Ambicje polityków coraz mocniej ciągną nas na dno .	ciągną	4	3
Mieszkam w domu niedaleko drogi .	Mieszkam	0	1
Myślicie skończyć do zimy ?	Myślicie	0	2
Zaprosimy cię na otwarcie , przysięgam .	Zaprosimy	0	1
– Ubierz się jakoś , do ludzi idziesz .	Ubierz	1	2
- Nie powtarzaj mi tego , bo jeszcze zmienię zdanie .	powtarzaj	2	2
Nadążacie , Towarzysze ?	Nadążacie	0	2
Witamy , witamy . . .	Witamy	0	1
Każdy sąd rzetelnie dokumentuje .	dokumentuje	3	3
- A ja wam mówię , że jesteście na bańce .	jesteście	7	2
Woziła m cię w wózku po bazie i myślała m , że oszaleję .	oszaleję	12	1
Spośród nich wybierzemy trzy najlepsze .	wybierzemy	2	1
Ma tylko tatę .	Ma	0	3
Śpiewającą męską siódemką dyryguje na estradzie po mistrzowsku Charles Bailly .	dyryguje	3	3
Niektórzy pytają , po co to robię ?	robię	6	1
Kiedy go wciśniemy , wycisza wszystkie dźwięki .	wycisza	4	3
Rozmażesz sobie makijaż .	Rozmażesz	0	2
- Nie gniewaj się , pomyśl , zrobili śmy im taką przyjemność .	pomyśl	5	2
Obstawimy łoże tabliczkami . . .	Obstawimy	0	1
Przygotowano też rozmaite zestawy upominkowe w estetycznych opakowaniach .	Przygotowano	0	0
Z instytucji tej korzysta ok. 2000 dzieci .	korzysta	3	3
- Ciągle nasłuchujesz ?	nasłuchujesz	2	2
A my nic nie robimy .	robimy	4	1
Przebiegające pod miastem chodniki kopalni zalano wodą , a wzgórze zgniło i zapadło się w ziemię jak przydeptane .	zalano	5	0
Mam pracę do czerwca , rozbieramy teraz czwarty piec .	rozbieramy	5	1
W ZUS nie ukrywają , że lekarzom trudno udowodnić , iż nadużywają swych kompetencji .	nadużywają	11	3
A w wakacje niech pojedzie na kolonie lub się szkoli , żeby awansować .	pojedzie	4	3
W okolicach Ełku i Giżycka nie pracują 3 linie .	pracują	6	3
Państwu to się opłaci .	opłaci	3	3
- Czy ty nie rozumiesz ?	rozumiesz	4	2
Choć dziecko złożyło na policji zeznania , sprawców nie zatrzymano .	zatrzymano	9	0
Przez wiele ostatnich lat te działania ośmieszano i uznawano za coś , co nas nie dotyczy .	dotyczy	15	3
Pomyśl też o innej możliwości .	Pomyśl	0	2
- Chodźmy tam !	Chodźmy	1	1
Wspieramy bezpieczną aborcję .	Wspieramy	0	1
Ten niekorzystny stan pogłębia się .	pogłębia	3	3
Tym głównie Stronnictwo będzie się różniło od większości europejskich partii chadeckich , w których liberalizm gospodarczy miesza się z ideami socjaldemokratycznymi i nauką społeczną Kościoła .	miesza	16	3
Może w dużych ośrodkach miejskich ludzie zagłosują na Juszczenkę , ale we wsiach poparcie dla Janukowicza będzie ogromne .	zagłosują	6	3
Wybaczamy mu .	Wybaczamy	0	1
W ostatnim momencie chwytam w dłonie jakiś kabel .	chwytam	3	1
Czasem cisnę spust , a ten diabeł uprze się i nie wystrzeli .	uprze	7	3
Między miniaturowym arcydziełem a banalną grafomanią wyrasta obszar kompletnej pustki .	wyrasta	6	3
Stalowa linka była opuszczona , deskę umocowano do zaczepu i uniesiono do pionu .	uniesiono	10	0
- Ja ci się pośmieję ! "	pośmieję	4	1
Możesz sobie w tym pomóc .	Możesz	0	2
Nie słuchaj ich wszystkich , nie czytaj żadnych książek .	słuchaj	1	2
Pogardzono wartościami życia zbiorowego , on zniechęcił się do gminnego prostactwa .	Pogardzono	0	0
wiesz co .	wiesz	0	2
Podlewajcie kwiaty .	Podlewajcie	0	2
Rodziny , które zdecydują się kupić na kredyt własne M , mogą liczyć na pomoc finansową .	zdecydują	3	3
Na koniec wyniki podliczono by w blasku jupiterów na wielkiej konwencji ogólnopolskiej .	podliczono	3	0
Widzi pan , że telefonuję .	telefonuję	4	1
I montujemy z tego dziewięćdziesięciominutowy program .	montujemy	1	1
Smarkaci mężczyźni gonią tylko za ładną buzią i modną sukienką .	gonią	2	3
Zresztą nie obrażaj mnie !	obrażaj	2	2
Puszczam Jego dłoń .	Puszczam	0	1
Pozwolisz , że pójdę na balkon ?	Pozwolisz	0	2
Rzecznik armii powiedział , iż na miejscu dokonano aresztowań .	dokonano	7	0
Uśmiechnij się do nich i zejdź im z oczu .	Uśmiechnij	0	2
Ochmistrz ma otwartą kabinę , dla przyzwoitości pukam w uchylone drzwi .	pukam	7	1
Co to znaczy ?	znaczy	2	3
- Przesadzasz ?	Przesadzasz	1	2
I szukaj korka w polu !	szukaj	1	2
- Spróbuję .	Spróbuję	1	1
Tak już chyba na serio nie mówimy , a nasz cyniczny wiek jakąś aurę śmieszności wokół słowa zbudował .	mówimy	6	1
a ile płacicie ?	płacicie	2	2
Czy sądzisz , że teraz , po tych wszystkich latach , rzucę dom , dzieci i pójdę za tobą ?	pójdę	16	1
- Nie gadaj dużo , tylko bierz za sznur .	gadaj	2	2
Listy od widzów czyta i niszczy .	czyta	3	3
Nie kieruję się przy tym ideologią wegetariańską , choć z nią sympatyzuję .	sympatyzuję	11	1
Porastają ją wiekowe akacje , lipy i inne drzewa liściaste .	Porastają	0	3
Mieszkam z koleżanką .	Mieszkam	0	1
– ale możesz być pracownikiem fizycznym . .	możesz	2	2
Wszyscy znamy historię Abrahama i Izaaka .	znamy	1	1
We wrocławskim zoo trzymamy je w kilku grupach .	trzymamy	3	1
Weź Lolkę i idźcie na górę .	Weź	0	2
Część młodych osób chce pracować w państwowej firmie , bo to daje zabezpieczenie socjalne .	chce	3	3
Czekam na uzasadnienie wyroku .	Czekam	0	1
Wiecie także , iż w wielu miejscach toczą się walki z siłami , które w imię swych egoistycznych interesów chcą powstrzymać pochód postępu na świecie .	toczą	7	3
- Pisz , pisz .	pisz	3	2
Będzie z czego wybierać .	Będzie	0	3
- Przymierzymy jeszcze !	Przymierzymy	1	1
Może się okazać , że zbyt surowo oceniasz siebie .	oceniasz	7	2
Czy godnie przystępuję .	przystępuję	2	1
Czego jeszcze należy się bać ?	należy	2	3
- Komu zwracasz uwagę ?	zwracasz	2	2
– co chcesz ?	chcesz	2	2
Jeżeli zamierzasz nadal szukać Krzywosza , proszę bardzo .	zamierzasz	1	2
Zobaczcie , jakiego ja mam zawsze koło siebie .	Zobaczcie	0	2
Ale widzisz , mnie chodzi o coś innego .	widzisz	1	2
Idź lepiej na podwórze , pobiegaj !	pobiegaj	5	2
Nagle zauważam , że balkon chwieje się i pęka .	zauważam	1	1
Wtórna samotność zdaje się jeszcze cięższa .	zdaje	2	3
Pana Sławomira zakwaterowano w pawilonie I .	zakwaterowano	2	0
I innych dzieciatych też nie uwielbiam .	uwielbiam	5	1
- Tylko nie strzelajcie , swoi idą .	strzelajcie	3	2
Tutaj jedynie pokrótce opiszemy ten standard i nieco uzupełnimy zaprezentowane w wymienionych artykułach informacje .	uzupełnimy	8	1
– Może napisz do niej .	napisz	2	2
Dziwnej kompanii , ośmielę się zauważyć .	ośmielę	3	1
Każdy człowiek ma je inne .	ma	2	3
- Knujecie !	Knujecie	1	2
A ja zadzieram głowę wysoko .	zadzieram	2	1
Odnotowano ponadto kilkanaście zachorowań .	Odnotowano	0	0
Nie przeszkadza im to uczestniczyć we mszy świętej .	przeszkadza	1	3
Chce uruchomić przewozy w Raciborzu-Markowicach i Nieborowicach .	Chce	0	3
Słuchaj , co ci rzeknie herold !	rzeknie	4	3
Stasys zawsze czerpie ze wspomnień dzieciństwa .	czerpie	2	3
- Domyślam się , że to był dowcip ?	Domyślam	1	1
Obecnie staramy się to maksymalnie uprościć i są już tego efekty .	staramy	1	1
Zwracajmy szczególną uwagę na bezpieczeństwo dzieci .	Zwracajmy	0	1
- Rozumiem .	Rozumiem	1	1
Posiadam spore zbiory i wciąż poszukuję nowych .	Posiadam	0	1
Oryginalne lampy zdobyto z zasobów niemieckich przeznaczonych dla Wehrmachtu .	zdobyto	2	0
W niedzielę 7 czerwca o godz . 17 Odra podejmuje Inę , a Mieszko o tej samej godzinie u siebie gra z Dąbrovią .	podejmuje	9	3
Ja już nie mogę !	mogę	3	1
– Zakładamy klub muzyczny .	Zakładamy	1	1
- Oczywiście , przecież nie robię filmów dla siebie .	robię	5	1
Co nie zostawia śladu ?	zostawia	2	3
Ty jutro wyjeżdżasz , ja tu zostaję .	wyjeżdżasz	2	2
Przychodzimy , aby szczątek ostatni od zagłady uchronić .	Przychodzimy	0	1
Witam , Poszukuję jakiegoś opracowania na temat początków rozwoju przemysłu w Białymstoku .	Witam	0	1
O wywiad z prezydentem zabiegam od 3 miesięcy .	zabiegam	4	1
Pracuję w dziale płac .	Pracuję	0	1
Wszystko zaczyna się nieźle układać .	zaczyna	1	3
Dostrzegła m , że patrzą na mnie ze współczuciem .	patrzą	4	3
Wcześniej nie zauważyłam , że z tego palanta wycieka palantyna .	wycieka	8	3
Wczoraj koło cmentarza w Sianowie znaleziono kilkuletniego chłopca .	znaleziono	5	0
Nie odpowiem pani raczej na to pytanie .	odpowiem	1	1
- Oddaję ci , bracie Nachorze , terafim ojca naszego .	Oddaję	1	1
- Chcesz poprowadzić ?	Chcesz	1	2
A ja oddaję za sześćdziesiąt pięć .	oddaję	2	1
Na tym kończymy rozpatrywanie punktów porządku dziennego w dniu dzisiejszym .	kończymy	2	1
Lubicie wyciągać z ludzi . . .	Lubicie	0	2
Dlatego podwyższa oprocentowanie udzielanych kredytów .	podwyższa	1	3
Nie pozostawiajmy ich bez opieki .	pozostawiajmy	1	1
A może się mylę ?	mylę	3	1
Ponieważ skóra w tym miejscu wiotczeje najszybciej , zacznij używać kremu pod oczy , który działa trochę silniej .	zacznij	8	2
- Ja zawsze jestem z drużyną , gramy do jednej bramki .	gramy	7	1
Ułoży się most , star przejedzie , kratownice wrócą na miejsce , zatrzemy ślady i poczekamy .	poczekamy	15	1
- Sława , Maryna i Krzysztof podbiegają i odbierają od niej paczki .	podbiegają	6	3
Nasz system polityczny ewoluuje w kierunku dwóch wielkich bloków .	ewoluuje	3	3
Teraz wystarczy na dwa razy więcej .	wystarczy	1	3
Łódź odnaleziono porzuconą i ogołoconą z silnika i kosztownego wyposażenia .	odnaleziono	1	0
Zapytaj Andrzeja .	Zapytaj	0	2
- Dajemy sygnał organizacjom terrorystycznym .	Dajemy	1	1
Dlaczego nie działa ?	działa	2	3
– Ale teraz chcę . . .	chcę	3	1
- Jeśli ma to dla was jakieś znaczenie , ręczę za niego .	ręczę	9	1
Za rakietami przeciwpancernymi suną majestatycznie olbrzymie srebrzyste cygara .	suną	3	3
- Nie mogę niczego obiecać .	mogę	2	1
Nie powie swojej mamie , że jesteście razem , bo to mogło by ją przygnębić .	jesteście	6	2
W tym krótkim okresie okazało się , że wielu kierowców nie stosuje się do wprowadzonych ograniczeń .	stosuje	11	3
Prezes OSP Stanisław Kocot wyjaśniał , że będą to nowoczesne , otwierane za pomocą pilota bramy , które znacznie ułatwią strażakom wyjazdy do akcji .	ułatwią	19	3
Najwięcej z nich dotyczy Wrocławia .	dotyczy	3	3
Wynajmujemy pokój prywatny w biurze obsługi turystów .	Wynajmujemy	0	1
– Kręci !	Kręci	1	3
Ma całe mury .	Ma	0	3
Policjanci z pobliskiego komisariatu przyznają , że docierają do nich sygnały o rozbojach .	przyznają	4	3
- Będzie rosół z piachem .	Będzie	1	3
- Zastanów że się .	Zastanów	1	2
Oznacz wszystkie pola ze skarbami .	Oznacz	0	2
pijesz taką wodę ?	pijesz	0	2
Kocham ciebie .	Kocham	0	1
Poproszę o urlop , paszport leży w domu .	leży	5	3
Usmaż jeszcze kiedyś faworki , błagam .	błagam	5	1
Trafił do Tary , ale zgodnie z umową nadal miano przyjeżdżać po jego krew .	miano	9	0
- Wyniesiesz mnie ?	Wyniesiesz	1	2
Rozwijano taśmę , wbijano paliki , ustawiano płotki , a w niebie i w krzewach śpiewały ptaki .	Rozwijano	0	0
– Mam , ale na razie nie ujawniam .	Mam	1	1
Czytasz te słowa .	Czytasz	0	2
Sprawą zainteresował się referat I-szy i przez kontrolę korespondencji może uzyskamy dalsze miejsca zachowanych rzeczy .	uzyskamy	10	1
- Nie uznaję .	uznaję	2	1
W Polsce staram się jeździć wolniej .	staram	2	1
Serdecznie dziękujemy .	dziękujemy	1	1
Rezolucja wypowiada się przeciwko istnieniu narodowych sił nuklearnych , ale nie przeciwko samej broni nuklearnej .	wypowiada	1	3
Zróbmy powtórkę . . .	Zróbmy	0	1
Pisano biografie i pamiętniki .	Pisano	0	0
Ma na imię Mikołaj .	Ma	0	3
Ludzie giną i ludzie zwyciężają .	zwyciężają	4	3
- Masz , bierz .	bierz	3	2
Tym razem postawiono na casting także w mniejszych miastach .	postawiono	2	0
Ale jest dzień i pogoda przygniata świat ciężkim tłokiem .	przygniata	5	3
Pokazano jej lichą zagrodę , naprzeciw wiejskiego cmentarza .	Pokazano	0	0
Koniecznie zadzwoń i przeproś za zwłokę .	zadzwoń	1	2
Jak sądzisz ?	sądzisz	1	2
Znaleziono go w grobowcu Ramzesa III .	Znaleziono	0	0
Nie cały Izrael cieszy się z przybycia papieża .	cieszy	3	3
Słucham i uszom nie dowierzam .	dowierzam	4	1
Jego dyrektor tłumaczy , że to za sprawą długów zostawionych przez poprzedników .	tłumaczy	2	3
- Musisz .	Musisz	1	2
( Przepisuję z karty po włosku dla większej autentyczności ) .	Przepisuję	1	1
Raz na cztery lata wybieramy swoich przedstawicieli do rad gmin .	wybieramy	4	1
Tak długo zwracaj wolność , aż poczujesz , że jest to całkowicie szczere i autentyczne .	poczujesz	6	2
- Jako człowiek próżny chętnie wracam do rzeczy przyjemnych .	wracam	5	1
Z trudem dostrzegam siedzących pod oknem Stefana i Wiktora .	dostrzegam	2	1
– no czasami tak bywa . .	bywa	4	3
Jest cieślą , zna się na tym .	zna	3	3
- Żyj wiecznie , panie nasz .	Żyj	1	2
Dlaczego jeszcze nie śpisz ?	śpisz	3	2
Zaatakowano go bezpośrednim ogniem .	Zaatakowano	0	0
Internet pozwala komunikować się poprzez rozliczne kanały rozmów w czasie rzeczywistym .	pozwala	1	3
– też nie jesz mięsa ?	jesz	3	2
– Od której ty urzędujesz tam teraz ?	urzędujesz	4	2
- Ależ wybacz .	wybacz	2	2
Takich opadów nie notowano tu od 6 lat .	notowano	3	0
- Skąd go znasz ? !	znasz	3	2
- Po co tu chodzicie ?	chodzicie	4	2
- Słowo daję , że się nie gniewam .	daję	2	1
Kochajcie się , bądźcie parą w pytkę .	Kochajcie	0	2
Spędź godzinę z piękną dziewczyną , a wyda ci się minutą .	Spędź	0	2
- Ewa , posłuchaj , to na pewno minie . . .	posłuchaj	3	2
Ulice zajmą pojazdy napędzane siłą ludzkich mięśni .	zajmą	1	3
Nie czekajcie na mnie i nie oglądajcie się .	oglądajcie	6	2
Odzyskano ukradzione przedmioty .	Odzyskano	0	0
Nieźle tam zarabia , ale niejednokrotnie chwali się drogimi rzeczami kupionymi za pieniądze , które syn tego pana zostawia na utrzymanie ojca .	zarabia	2	3
- Zbądź obawy , ojcze .	Zbądź	1	2
- Wiem , że wiesz , ale chciała m nawiązać rozmowę .	wiesz	4	2
Kocham cię w kapeluszu i w berecie .	Kocham	0	1
Krystyna Kofta ogłosiła , że przyjmuje na siebie misję walki o równouprawnienie Bożen z Krystynami i za dwa lata zaprosiła panie do Trójmiasta , by równość tę udowodnić .	przyjmuje	5	3
Powiedz prawdę , ty przecież nigdy nie kłamiesz .	kłamiesz	7	2
Fascynują mnie także ludzie , z którymi współpracuję .	współpracuję	7	1
Zapytali , czy rozpoznaje chłopaka na zdjęciu .	rozpoznaje	3	3
Czym to uzasadnisz ?	uzasadnisz	2	2
Porozumienie to podpisano bez wstępnego konsultowania się z rządem .	podpisano	2	0
I od tamtej pory czekam , żeby wskazal PAn róznice .	czekam	4	1
Przepraszam was , że się rozżalił em . . .	Przepraszam	0	1
Nie pamiętam szczegółów , ale coś podobnego już zaszło .	pamiętam	1	1
Prowadzone obecnie postępowanie rozstrzygnie , kto zawinił .	rozstrzygnie	3	3
Z ich opinią liczono się nie tylko w redakcji , ale również w środowiskach literackich i teatralnych .	liczono	3	0
Skoro pogrąża się w rozpaczy i gniewie .	pogrąża	1	3
Siadam w kącie i usypiam , budząc się na Gare du Nord .	Siadam	0	1
Robię się czerwony i zeskakuję z okna .	Robię	0	1
- Jak pan sądzi , zobaczycie się z Bagsikiem w tym tysiącleciu ?	zobaczycie	5	2
Sam nie dam rady .	dam	2	1
- Będziemy udawali , że śpimy .	śpimy	5	1
- Uwierzy !	Uwierzy	1	3
Tanio wezmę . . .	wezmę	1	1
– Robię to tylko z nudów .	Robię	1	1
- Słyszysz ?	Słyszysz	1	2
- Ludzie starsi gubią się w technicznych problemach z tym związanych , a takie ciągłe zabawy ze zmianą pasma nadawania to brak szacunku dla abonentów .	gubią	3	3
- Nie ucz dziada , jak charchać !	ucz	2	2
W tej pozycji oddychasz spokojnie i równo przez 3 minuty .	oddychasz	3	2
masz jedną za drzwiami . .	masz	0	2
- Wierzysz w to ?	Wierzysz	1	2
Wszechpolaków przybywa .	przybywa	1	3
Rządowy projekt chroni dzieci i młodzież .	chroni	2	3
Większość utrzyma pracę .	utrzyma	1	3
I koniecznie zabierz ze sobą jakąś książkę .	zabierz	2	2
Postawicie nam ćwiartkę , a my już damy facetowi radę .	damy	7	1
Mam pracę do czerwca , rozbieramy teraz czwarty piec .	rozbieramy	5	1
Odwróć go trochę na bok , już dosyć cię opaskudził .	Odwróć	0	2
Od samotności niepoczytalnej i obłędu uchroń nas , Panie .	uchroń	5	2
- Wwozisz do Polski kapitał , bierzesz adwokata , który w krótkim czasie załatwia wszystkie prawne problemy .	bierzesz	6	2
Ranną przetransportowano śmigłowcem do zakopiańskiego szpitala .	przetransportowano	1	0
Policja przypuszcza , że najnowszy ładunek został porzucony przez spłoszonego niedoświadczonego terrorystę .	przypuszcza	1	3
Nie czuje się pani trochę odsunięta przez Leppera ?	czuje	1	3
Nie omieszkam tego tematu poruszyć .	omieszkam	1	1
- Wiecie , kto to jest Andrzej Wroński ?	Wiecie	1	2
Jeżeli nieszczęściem zakochasz się we mnie .	zakochasz	2	2
Grodzicki nie chciał się wyrzec nadziei , że odzyska syna .	odzyska	8	3
– Policzysz , jak zechcesz .	Policzysz	1	2
Dla uczczenia tego zdarzenia przynoszę filiżanki .	przynoszę	4	1
Do najważniejszej pracy przystąpiono w farbiarni .	przystąpiono	3	0
Zaproponowane odszkodowanie pokazuje , że pan minister dotrzymał słowa .	pokazuje	2	3
Czy nasze indywidualne cele pokrywają się z celem grupy jako całości ?	pokrywają	4	3
Henryk Sadurski , inżynier metalurg , nie ma pracy od kilku lat .	ma	7	3
- Jadę w stronę Palazzo di Giustizia .	Jadę	1	1
Mówimy o wyborach .	Mówimy	0	1
Więźniowie dostają przepustki .	dostają	1	3
– bo on tak się zwraca do kolegów i koleżanek . .	zwraca	5	3
Zaręczam wam , że ubrań nie znajdziecie .	znajdziecie	6	2
Dzięki nim zmniejsza się u chorego zaleganie afektu , rozładowują się utrwalone stereotypy uczuciowe , obiektywniej widzi swoją sytuację .	rozładowują	9	3
Przedstawiamy dziś rasę niezwykle rzadką , niehodowaną w Polsce .	Przedstawiamy	0	1
Nie wymagaj od naszych czegoś więcej .	wymagaj	1	2
Usiądź wygodnie , bo chcę przedstawić ci pewien pomysł . . .	chcę	4	1
Niech żyją okupanci .	żyją	1	3
Wsuwa się pod głowę leżącego , błądzi palcami po jego twarzy .	błądzi	6	3
Nie pomyślał em o tym , że nie był on przytwierdzony do postumentu , zdejmowano go przecież rokrocznie .	zdejmowano	14	0
Lubi dobrą muzykę i piesze górskie wycieczki .	Lubi	0	3
- A CO TO ZNACZY NAPRAWDĘ ?	ZNACZY	4	3
Rozglądam się i nie wierzę własnym oczom .	wierzę	4	1
Tak więc ostrzegam i odradzam .	ostrzegam	2	1
Okazało się , że wózek i wszystkie półmiski z rybami zabrano na trójkę do Teodora .	zabrano	10	0
– Ubierz się jakoś , do ludzi idziesz .	idziesz	7	2
Pokażemy mu .	Pokażemy	0	1
Pisze , iż jego rządy trwały lat 36 i że jego następcą był Włodzimierz .	Pisze	0	3
Nie zrobiono nic .	zrobiono	1	0
- I tobie niech zawsze zdrowie służy .	służy	6	3
Sprawę wyjaśnimy .	wyjaśnimy	1	1
Tak się nieraz zastanawiam .	zastanawiam	3	1
Często tu goszczę i jestem serdecznie przyjmowany .	goszczę	2	1
Nie okpisz jej .	okpisz	1	2
Czy uważa Pan , że dzisiejsi studenci już się nie buntują ?	buntują	10	3
Odrobina zazdrości utrzyma miłość w dobrej formie .	utrzyma	2	3
( dzia ? ! ? )	dzia	1	3
„ Bawi się ze mną .	Bawi	1	3
- Wybaczy pan , Profesorze . . .	Wybaczy	1	3
Wracajcie pod szyb po ludzi , siekiery i kilofy .	Wracajcie	0	2
Spiskowano wokół Saddama w sposób nieprawdopodobnie aktywny .	Spiskowano	0	0
- Znowu sięgnę do wspomnień z okresu , kiedy mieszkał em w Krakowie .	sięgnę	2	1
W najbliższym czasie rynek prawdopodobnie ochłonie i dojdzie do korekty .	ochłonie	5	3
Opaski przeglądamy w lipcu i niszczymy znajdujące się tam gąsienice .	przeglądamy	1	1
Kiedy miała m pięć lat , posłano mnie do szkoły .	posłano	6	0
- Zdarzało się , że uderzyłem butnego Niemca z Wehrwolfu , ale tego nie obejmuje akt oskarżenia .	obejmuje	14	3
– Zamierzam rozmawiać i dzielę się z panią różnymi wrażeniami .	Zamierzam	1	1
- Dziękuję bardzo , Panie Senatorze .	Dziękuję	1	1
Nie wspominajcie o ojczyźnie , jej mitach i tradycjach .	wspominajcie	1	2
- Przykryj go .	Przykryj	1	2
- Ulegam przemocy .	Ulegam	1	1
Nikt mnie raczej nie bierze za jajcarza , z którym można sobie pożartować , prawda ?	bierze	4	3
Teraz składamy paskowy patchwork , ocieplenie i podszewkę , zszywamy wzdłuż prostego brzegu i obszywamy lamówką .	składamy	1	1
To nie przedszkole , nie mazgaj się .	mazgaj	5	2
Zaciągam się papierosem i próbuję przypomnieć sobie dawnego Dziedziuszkę .	próbuję	4	1
- Żartujesz .	Żartujesz	1	2
Przechodzimy do głosowania .	Przechodzimy	0	1
Nie pracuje i razem z teściową wychowuje dzieci .	wychowuje	6	3
Niektóre rzeki nie zamarzają w ogóle .	zamarzają	3	3
Chętnie porozmawiam na ten temat .	porozmawiam	1	1
W tym przypadku również zalano odcinek asfaltem .	zalano	4	0
Szafę zamykamy na klucz i obiecujemy sobie otworzyć ją dopiero po egzaminach .	zamykamy	1	1
Aż trudno uwierzyć , że jeszcze kilkanaście dni temu ptaszki ćwierkały , że zostawi stację Waltera i przeniesie się do TVP .	przeniesie	17	3
Jednocześnie tacy ludzie chcą się dalej kształcić i rozwijać , żeby potem móc zmienić pracę na lepszą .	chcą	3	3
Dlatego uważam , że wspólna Europa mogłaby istnieć na fundamencie kultury .	uważam	1	1
Słuchaj , czy mogła by ś mi pożyczyć sto złotych ?	Słuchaj	0	2
Piszę o tym za zgodą kapitana Domejki .	Piszę	0	1
Przytul się mocno I podnieś głowę Patrząc w ich oczy Moim spokojem .	Przytul	0	2
- Nie wciskaj mi kitu .	wciskaj	2	2
Ale konia i wóz oddasz ?	oddasz	4	2
Czy istnieje coś takiego jak miłość partnerska ?	istnieje	1	3
Pamiętasz , jak my śmy kiedyś tak rozmawiały o tym , że trzeba szukać ideału . . .	Pamiętasz	0	2
Nic nie mów , proszę .	mów	2	2
Wisła w Toruniu przekroczyła stan alarmowy o 80 cm , a wody wciąż przybywa .	przybywa	13	3
Jedną pustą wmurowano między epitafiami porucznika Ludwika Ratajczaka i majora Leona Recheńskiego .	wmurowano	2	0
- Dopóki rząd i koalicja nie podejmą decyzji , dopóty każdy może wypowiadać swoje zdanie .	podejmą	6	3
Co uznają śledczy , pokaże czas .	pokaże	4	3
- Weź pilota , wyłącz kmiota , niech się nie miota .	Weź	1	2
Na morskiej jednostce mogą być zatrudnione tylko te osoby , które posiadają aktualne świadectwo zdrowia .	posiadają	11	3
Zaczął eś dobrze , wiesz , o kogo chodzi .	wiesz	4	2
Tłumaczenia pozostawiają wiele do życzenia .	pozostawiają	1	3
Jeśli w sercu pojawi się niepewność , nie dramatyzuj .	dramatyzuj	8	2
Dlaczego na Niego krzyczę ?	krzyczę	3	1
Nie wiem , dlaczego ją tak powitano .	powitano	6	0
Popatrz na tych młodych KZT .	Popatrz	0	2
Kup ją , a przekonasz się , że odmieni także twoje .	Kup	0	2
– Przyjedź szybko do Nowolipska .	Przyjedź	1	2
Ale głową muru nie przebijesz . . .	przebijesz	4	2
Jeżeli unosisz ją , wtedy unoszą się także ramiona .	unosisz	1	2
Rozwijano taśmę , wbijano paliki , ustawiano płotki , a w niebie i w krzewach śpiewały ptaki .	ustawiano	6	0
Kiedy nie mamy ochoty na towarzystwo , każdy ma swój pokój .	mamy	2	1
– masz !	masz	1	2
- Ja im pokażę .	pokażę	3	1
Witam wszystkich klubowiczów ! ! !	Witam	0	1
Na ich grobach złożono również wiązanki kwiatów i zapalono znicze .	zapalono	8	0
Zachęcam do zalogowania się !	Zachęcam	0	1
W ostatnim momencie chwytam w dłonie jakiś kabel .	chwytam	3	1
Bez tej ostatniej nie ma narodu .	ma	4	3
Lecz w porze kolacyjnej do drzwi zapukano .	zapukano	6	0
Dlatego zdecydowano się go rozebrać .	zdecydowano	1	0
Nikogo nie odnaleziono .	odnaleziono	2	0
Nie zdążę odebrać huku .	zdążę	1	1
I przeczytaj coś o Simone de Beauvoir .	przeczytaj	1	2
Przypominam jeszcze , że za parę minut przejedzie dwóch rowerzystów .	Przypominam	0	1
Załadowano na nie bagaż .	Załadowano	0	0
- Gadaj .	Gadaj	1	2
Chodzimy dwa razy w tygodniu do kina , do teatru .	Chodzimy	0	1
Przystępujemy do głosowania nad całością projektu ustawy .	Przystępujemy	0	1
– Zagrajmy w pokera .	Zagrajmy	1	1
Na polach Domatowa i Polchowa usypano wysokie mogiły .	usypano	5	0
– Jak leziesz , pizdo !	leziesz	2	2
Więc kim się staniesz , gdy nie pojmiesz ich prostego języka , ich naturalnych gestów ?	pojmiesz	7	2
On wydobędzie od pana informację , która pomoże Mühlhausowi ująć mordercę .	wydobędzie	1	3
Znaczna koncentracja tego gazu w przyziemnej warstwie atmosfery sprzyja więc podwyższaniu temperatury powierzchni Ziemi .	sprzyja	8	3
Rabi Eleazar ben Cwi nie szemrze .	szemrze	5	3
- Przyrzekniesz mi .	Przyrzekniesz	1	2
- Pomagasz mi .	Pomagasz	1	2
Bogu zawierzam i w Bogu pokładam nadzieję .	zawierzam	1	1
Obstępują solenizanta , śpiewają sto lat , a maluchy wręczają kolorowe paczki .	Obstępują	0	3
- Za jakąś kuszą się lepiej rozejrzyj .	rozejrzyj	6	2
6 lat temu jej dziecko zamordowano .	zamordowano	5	0
Trumna tonie w kwiatach .	tonie	1	3
ja tak nie znoszę .	znoszę	3	1
Wybudujecie nową , za co ?	Wybudujecie	0	2
Nie patrz tak .	patrz	1	2
Ja nie mam takich uprawnień i nie uczestniczę w przesłuchaniach .	uczestniczę	7	1
Uklęknijcie . . .	Uklęknijcie	0	2
Rwą się pociski .	Rwą	0	3
Do dziś w sądownictwie pracują osoby , które rozpoczynały swoją karierę w latach stalinowskich .	pracują	4	3
Masz jeszcze jakieś inne kłopoty ?	Masz	0	2
Artyści poprowadzą biesiadę śląsko - bawarską .	poprowadzą	1	3
Uczula i sprzyja miażdżycy , a nawet nowotworom .	Uczula	0	3
W tych pierwszych związkach nastolatki doświadczają smaku ludzkiej miłości , odkrywają siłę fascynacji i wzajemnego przyciągania siebie .	odkrywają	10	3
– Policzysz , jak zechcesz .	zechcesz	4	2
Usunięto krzewy i drzewa samosiejki .	Usunięto	0	0
Kole i mnie .	Kole	0	3
Stoją wszędzie na tarasie , w ogrodzie , przy oknach .	Stoją	0	3
- Widzę , że pan niezbyt się przejął tą zbrodnią .	Widzę	1	1
Chociaż wcale sie do tego nie przyznają . .	przyznają	6	3
Od zbłąkanych misjonarzy uchroń nas , Panie .	uchroń	3	2
Nie dowie się .	dowie	1	3
- Pisz , pisz .	Pisz	1	2
- Widzę siebie w przyszłej Radzie .	Widzę	1	1
Alkoholu jeszcze nie podano , popielniczki błyszczały czyste i nie skażone .	podano	3	0
Starszego aspiranta w prowincjonalnym ośrodku skierowano na badania psychiatryczne .	skierowano	5	0
Nawet podziwiam .	podziwiam	1	1
Mąci się wszystko .	Mąci	0	3
Siadam w kącie i usypiam , budząc się na Gare du Nord .	Siadam	0	1
Nikt niczego nie wybiera , coś wybiera za nas .	wybiera	3	3
Zawiadomiono policję i prokuraturę .	Zawiadomiono	0	0
- Skaczesz , rozglądasz się i wracasz .	rozglądasz	3	2
Odkładam książki , gaszę komputer .	Odkładam	0	1
Czy kolega czytuje wcześniejsze posty ?	czytuje	2	3
Następuje ciąg dalszy Mszy świętej .	Następuje	0	3
Niestety w Biblii nie ma nic o żadnych książeczkach .	ma	4	3
Jak to skończysz , spróbuj Stendhala i Buddenbrooków Tomasza Manna . . .	spróbuj	4	2
Nie martw się , już przechodzę .	martw	1	2
Dlatego solidnie się zmęcz .	zmęcz	3	2
– Wcale się nie martwię .	martwię	4	1
Pójdziesz do domu .	Pójdziesz	0	2
– Przecież pan wie .	wie	3	3
Przeczytaj o tym w książkach i odłóż książki .	Przeczytaj	0	2
Wiec po jaka cholerę skarżysz mi sie tutaj , kto co zaczął ?	skarżysz	4	2
Zgodnie podkreślają , że bracia Kaczyńscy nie lubią hucznych imprez .	podkreślają	1	3
Sprawdzamy wyrostki kolczyste i łuki kręgów .	Sprawdzamy	0	1
Frajer odjedzie .	odjedzie	1	3
Wynajmujemy pokój prywatny w biurze obsługi turystów .	Wynajmujemy	0	1
W strukturze współczesnego systemu szkonictwa wyższego w Polsce państwowe i niepaństwowe uczelnie dzielimy na dwie kategorie .	dzielimy	12	1
Podczas pogrzebów nie biją dzwony .	biją	3	3
Przeciwnie , z takich skojarzeń kpią sobie oni w kilku utworach .	kpią	5	3
Postaramy się spełnić jej życzenie .	Postaramy	0	1
- Sam go sobie stworzysz .	stworzysz	4	2
Idę coś zjeść .	Idę	0	1
Pracownię przekazano nieodpłatnie .	przekazano	1	0
Dlaczego tak na mnie krzyczysz ?	krzyczysz	4	2
W opowieści biblijnej uderza ścisłość historyczna w odtwarzaniu obyczajów egipskich .	uderza	3	3
- Wspomniał eś , że rzadko widujesz się z rodziną .	widujesz	6	2
- Zabierz od niej walizkę , ty byku !	Zabierz	1	2
Wówczas postawiono nas na nogi i kazano iść dalej .	kazano	6	0
Ale przedtem wyceń mnie .	wyceń	2	2
W Berchtesgaden specjalnością jest tor saneczkowy , na którym osiąga się niebywałe prędkości .	osiąga	9	3
Ośrodki badania opinii publicznej publikują właśnie swe najświeższe sondaże , które potwierdzają utrzymujące się od wielu miesięcy trendy .	potwierdzają	11	3
Kiedy wdychasz powietrze , czuj to .	wdychasz	1	2
Jeśli jednak różnice te nie pozwalają wam zbudować takiego formalnego porozumienia , dajcie zielone światło do współdziałania ludziom tworzącym wasze ugrupowania .	pozwalają	5	3
Nie chciała zdradzić , dlaczego się z nim rozstaje .	rozstaje	8	3
Weźmy na przykład pomnik w centrum wsi .	Weźmy	0	1
Nie gniewaj się . . .	gniewaj	1	2
Nie wyobrażam sobie wprowadzania w życie indywidualnych planów .	wyobrażam	1	1
Zmarłych żołnierzy francuskich i bawarskich pogrzebano na cmentarzu przykościelnym .	pogrzebano	5	0
Ty się wstydzisz ? !	wstydzisz	2	2
- W pani wierszach , które zawsze tak intensywnie portretują otoczenie i pejzaż , nie ma śladu Warszawy .	ma	15	3
- Chcemy również upowszechnić ten rodzaj sportu wśród osób niepełnosprawnych .	Chcemy	1	1
Osiągniesz korzyść prestiżową i finansową .	Osiągniesz	0	2
Bądź wdzięczny , okazuj wdzięczność wszystkiemu , co żyje .	okazuj	3	2
Pytam ją , jak dojść do miasta .	Pytam	0	1
Teraz składamy paskowy patchwork , ocieplenie i podszewkę , zszywamy wzdłuż prostego brzegu i obszywamy lamówką .	zszywamy	9	1
Pozwolisz , że pójdę na balkon ?	pójdę	3	1
słuchaj a masz tą książkę tu może ?	słuchaj	0	2
- Sądy podchodzą do tajnych współpracowników bardzo liberalnie , nie eliminują z życia społecznego agentów .	podchodzą	2	3
Szczególnie serdecznie zapraszamy do współpracy nowo powstałe firmy .	zapraszamy	2	1
Bandyci odjeżdżają .	odjeżdżają	1	3
Wiedział em , że przyjdziecie .	przyjdziecie	4	2
- Dziękuję bardzo , Pani Senator .	Dziękuję	1	1
- Zbądź obawy , ojcze .	Zbądź	1	2
Pod koniec gotowania dodajemy sos sojowy i na kilka minut pozostawiamy pod przykryciem .	pozostawiamy	10	1
Zaręczam wam , że ubrań nie znajdziecie .	Zaręczam	0	1
Nie ma wątpliwości !	ma	1	3
Nie ma się nigdy zakochiwać .	ma	1	3
Po obejżeniu tych trzech filmów z niepokojem oglądam wiadomości .	oglądam	7	1
Potem proszono ich o wykonanie odwrotnego zadania .	proszono	1	0
Wierzę panu na słowo .	Wierzę	0	1
– Ufasz miejscowym ?	Ufasz	1	2
Pożar zauważono po godz. 14 .	zauważono	1	0
- Przykryj go .	Przykryj	1	2
Ruszam palcami i widzę , jak się poruszają .	Ruszam	0	1
Możecie iść do domu .	Możecie	0	2
Wynoście się stąd !	Wynoście	0	2
W niedzielę po parkiecie snuje się już tylko kilkanaście osób .	snuje	4	3
– Wyjdziesz już ?	Wyjdziesz	1	2
Sam się pan przekona .	przekona	3	3
W Pikardii ewakuowano 700 osób , woda zalała ponad 1800 domów .	ewakuowano	2	0
Nie skupia się na przedmiotach , raczej otacza się przedmiotami .	skupia	1	3
- Nie tęskni Pan za niespełnionym marzeniem ?	tęskni	2	3
Niezadługo nadjedzie .	nadjedzie	1	3
Za najważniejszych nazistowskich zbrodniarzy powszechnie uznawano Hitlera , Himmlera i Goebbelsa .	uznawano	5	0
Może nauczysz się wreszcie , jak się takie rzeczy załatwia .	nauczysz	1	2
Olbrzymie tiry parkują na osiedlowych ulicach .	parkują	2	3
PRZYGOTUJ SIĘ .	PRZYGOTUJ	0	2
A ogrzewania wyłączyć nie możemy , bo to zaszkodzi świeżo zakonserwowanym freskom w obu synagogach .	możemy	4	1
- Nie jedź do Jerozolimy !	jedź	2	2
Popatrz , jak inni poruszają ustami .	Popatrz	0	2
" Zrobimy " !	Zrobimy	1	1
Nie ruszaj się .	ruszaj	1	2
S-check wykrywa zdradę do dwóch tygodni od momentu jej popełnienia .	wykrywa	1	3
W okna wstawiono kraty i podmurowano ściany .	wstawiono	2	0
- Przyrzekniesz mi coś , Hunt .	Przyrzekniesz	1	2
Co wolisz ?	wolisz	1	2
Narconon to najskuteczniejszy program , jaki wymyślono .	wymyślono	6	0
Georges Mathieux w kostiumie szermierza dźga płótno pędzlem umieszczonym na szpadzie .	dźga	5	3
Oddaję się niecnym praktykom .	Oddaję	0	1
- Wwozisz do Polski kapitał , bierzesz adwokata , który w krótkim czasie załatwia wszystkie prawne problemy .	Wwozisz	1	2
Ustalili śmy ze Stachem , że jeszcze trochę pociągnę pismo dla honoru domu i odejdę .	odejdę	14	1
Chcesz przez to powiedzieć , że Mendelejew musiał udowodnić , że istnieją nieznane pierwiastki .	Chcesz	0	2
Kocham was wszystkich .	Kocham	0	1
Okulary od siebie z pokoju przynosi , druty za uszy zawija .	zawija	10	3
Nie czekajcie na mnie i nie oglądajcie się .	czekajcie	1	2
Jakie renty otrzymują u was inwalidzi ?	otrzymują	2	3
- Niech Pan ześle anioła , by prowadził was w drodze .	ześle	3	3
Poza tym , spotykam się z nimi na gruncie zawodowym .	spotykam	3	1
- Ja już chyba , chłopak , tobie na dzisiaj podziękuję .	podziękuję	10	1
Jakie rodzaje mięsa zamraża się z przeznaczeniem na zaopatrzenie rynku detalicznego ?	zamraża	3	3
– Wątpię .	Wątpię	1	1
– weźmiesz wódkę i przyjdziesz ?	weźmiesz	1	2
Uważajcie , czy nie zmienia koloru .	Uważajcie	0	2
Nie słuchaj ich wszystkich , nie czytaj żadnych książek .	czytaj	6	2
- Postaram się .	Postaram	1	1
Moim zdaniem przesadzasz .	przesadzasz	2	2
- Trzymam cię za słowo .	Trzymam	1	1
Ale najbardziej cieszę się z tego , że Aga mnie nie ustawia .	cieszę	2	1
Książkę wydrukowano w Polsce na zlecenie paryskiej Edition Cercle d'Arts .	wydrukowano	1	0
Trzymajcie się !	Trzymajcie	0	2
Wielkość strat oszacowano na około 1500 złotych .	oszacowano	2	0
Czy Milon zdecyduje się na powrót ?	zdecyduje	2	3
Stoję przed obliczem celnika .	Stoję	0	1
Sprawą zainteresował się referat I-szy i przez kontrolę korespondencji może uzyskamy dalsze miejsca zachowanych rzeczy .	uzyskamy	10	1
Talent już nie wystarcza .	wystarcza	3	3
Rozglądam się i nie wierzę własnym oczom .	Rozglądam	0	1
Urządzimy też prywatny gabinet .	Urządzimy	0	1
- Czy znasz dziesięciu sprawiedliwych w tym grodzie ?	znasz	2	2
Ty coś ćwiczysz ?	ćwiczysz	2	2
Ponadto badania te świadczą , że koncentraty alkoholowe różnych roślin są dobrym środkiem zapobiegawczym przeciw grypie .	świadczą	3	3
Kupicie dom ?	Kupicie	0	2
Poproszono Zygmunta o coś innego .	Poproszono	0	0
Słuchaj , co ci rzeknie herold !	Słuchaj	0	2
i kończymy powolutku .	kończymy	1	1
Postaraj się mnie zrozumieć .	Postaraj	0	2
- Ja się z tobą drażnię ?	drażnię	5	1
Chcemy , by lepiej rozumiały siebie , a one tego nie potrafią .	Chcemy	0	1
Ty jutro wyjeżdżasz , ja tu zostaję .	wyjeżdżasz	2	2
Wczoraj na lodowisko wylano wodę .	wylano	3	0
DZIŚ idę płakać nad moim losem , rozumiesz ?	idę	1	1
Widzicie , lyrijski orzeł czarny i rivskie rauty czerwone .	Widzicie	0	2
– jest ale idź do fotolabu powiedzieć . .	idź	3	2
Później innego uczestnika spotkania znaleziono martwego w jego domu letniskowym pod Belgradem .	znaleziono	4	0
Trafia na oddział intensywnej terapii .	Trafia	0	3
Pracowano przez całą noc przy świetle reflektorów .	Pracowano	0	0
Uczę się hebrajskiego .	Uczę	0	1
Z jednej strony umówił em się z państwem dziennikarzami , że zakończymy o godzinie 17 .	zakończymy	11	1
Balkon spadł , a ja wiszę na kablu .	wiszę	5	1
Leci z Milwaukee do Pekinu na chiński Nowy Rok .	Leci	0	3
Pocałuj ją , a zobaczysz , że tylko krok dzieli cię od najważniejszego .	zobaczysz	4	2
Pocałuj ją , a zobaczysz , że tylko krok dzieli cię od najważniejszego .	Pocałuj	0	2
Bóg raczy wiedzieć .	raczy	1	3
— W sprawie wywiadu moja sekretarka skontaktuje się z pańską sekretarką .	skontaktuje	6	3
W historii szuka tylko starych bredni , które już zna .	zna	9	3
Zadzwonimy do Patrycji . . .	Zadzwonimy	0	1
Na ich grobach złożono również wiązanki kwiatów i zapalono znicze .	złożono	3	0
Już nie dajesz dupy , dupa należy się tobie .	dajesz	2	2
Prosto ze szkolnej ławy zawleczono go do więzienia .	zawleczono	4	0
Nie daj się schwytać , nie daj się otropić .	daj	6	2
I dotrzymam .	dotrzymam	1	1
Idę coś zjeść .	Idę	0	1
- Skąd mogę mieć zaufanie ?	mogę	2	1
I tak za parę dni wracam .	wracam	5	1
To dobrze , że sprawa wraca do prokuratury .	wraca	5	3
Premier zapewnił , że z pełną determinacją przygotowujemy się do wejścia do UE .	przygotowujemy	7	1
Przeprowadza się Departament jakiegoś Ministerstwa .	Przeprowadza	0	3
Nie jadam po dziewiątej .	jadam	1	1
Mogli by w nich uczestniczyć kandydaci Unii Wolności oraz Wałęsa i Olszewski , jeśli tylko zechcą i będą mieli poparcie 15 parlamentarzystów i 300 radnych .	zechcą	15	3
Ale sposobu na usmażenie mózgu ode mnie nie dostaniesz .	dostaniesz	8	2
Policja odwozi ją na komisariat .	odwozi	1	3
- Przyjechał em przed wojną , pracował em i pracuję u Francuzów . . .	pracuję	9	1
Posłużono się amerykańską zastawką doktora Starra .	Posłużono	0	0
– a do Dusznik jedziecie ?	jedziecie	4	2
- Jak często otrzymujecie takie meldunki ?	otrzymujecie	3	2
Niech państwo płaci !	płaci	2	3
- Skąd go znasz ? !	znasz	3	2
- Jeśli czegoś nie lubię , nie zrobię tego za żadne pieniądze .	zrobię	7	1
Uwolniono też polskiego ambasadora w Jemenie .	Uwolniono	0	0
O przygotowaniu do studiów wyższych wspominano w dalszym punkcie .	wspominano	5	0
Teraz Bóg jeden raczy wiedzieć .	raczy	3	3
No , włóż szybko koszulę !	włóż	2	2
Wszystkich ich wzywano na policję i przesłuchiwano .	wzywano	2	0
- Mam konkretną prośbę .	Mam	1	1
Dwoisz się i troisz , aby rozwiązać kilkadziesiąt praktycznych problemów równocześnie .	Dwoisz	0	2
Liczył em na to , że przyjdziecie z tym do mnie .	przyjdziecie	6	2
Daję dzieciom wiele swobody w naszym domku pod Warszawą .	Daję	0	1
Ja otworzę . . . "	otworzę	1	1
- Więc przeczy pani ?	przeczy	2	3
Ten bóg nazywa się Leszek Miller .	nazywa	2	3
Adres niech dobrodziej spisze z dowodu osobistego .	spisze	3	3
Zamierzam odwiedzić te miejsca w przyszłości .	Zamierzam	0	1
– Ach , mówisz o pomarańczowej !	mówisz	3	2
Boję się miast , boję się luksusu eleganckich metropolii .	boję	4	1
Przedostatni figuruje Artur Balazs , poseł i minister rolnictwa , a zamyka ją Stefan Oleszczuk z UPR-u , starosta kamieński .	figuruje	1	3
Z Jackiem Kuroniem współpracowali śmy i nadal współpracujemy .	współpracujemy	7	1
Widzę Łzy w kącikach jego oczu .	Widzę	0	1
Nie interesuje ich seks bez uczucia .	interesuje	1	3
Przygotowuje się nowy transport do Niemiec .	Przygotowuje	0	3
Chcesz zobaczyć orła ?	Chcesz	0	2
Muszę trochę odsapnąć .	Muszę	0	1
Teraz straszą budynki ogołocone z szyb i armatury .	straszą	1	3
– Mama gładzi dłoń Dziadka .	gładzi	2	3
- Dostała m twój list , przyjedź , jeśli chcesz . . .	przyjedź	6	2
Wielu wywiadów nie udzielam .	udzielam	3	1
NIK podkreśla , że w czasie prywatyzacji AWRSP następowało pogorszenie sytuacji ekonomicznej Polski .	podkreśla	1	3
– Policzysz , jak zechcesz .	Policzysz	1	2
– Czy używasz prezerwatyw ?	używasz	2	2
Czekają nas ciężkie czasy " .	Czekają	0	3
Nie mogę na to patrzeć .	mogę	1	1
We wtorek w Annopolu , gdzie Wisła przekroczyła stan alarmowy o 34 cm , ogłoszono alarm przeciwpowodziowy .	ogłoszono	14	0
Trzymajcie się !	Trzymajcie	0	2
Niczego nie widzisz !	widzisz	2	2
– Policzysz , jak zechcesz .	zechcesz	4	2
Pod koniec gotowania dodajemy gomasio i natkę pietruszki .	dodajemy	3	1
Stare gmachy , dostojne i omszałe , coraz bardziej upodobniają się do mamutów , wchłanianych w błoto epoki polodowcowej .	upodobniają	9	3
Odpowiedz na nie też .	Odpowiedz	0	2
Sporadycznie tylko osiągają ceny powyżej 10000 zł .	osiągają	2	3
Irenka także nie śpi .	śpi	3	3
Podnoszę słuchawkę .	Podnoszę	0	1
Nie sądzisz ?	sądzisz	1	2
– jakie śmieci pijesz ?	pijesz	3	2
Tymczasem miednice wypełnione podrobami przenoszono do kuchni .	przenoszono	4	0
KOKS MUSI BYĆ !	MUSI	1	3
- Oto głoszę Twoje Królestwo .	głoszę	2	1
Gdy we wspomnianych dwu pionach narożnikowych ktoś się kąpie , wówczas woda spływa w dół nawilgacając po drodze niżej położone mieszkania .	spływa	12	3
Kaneyasu pomyślał , że niepotrzebnie lakierowano stół .	lakierowano	5	0
Wiele pociągów odwołano .	odwołano	2	0
Chodź do kuchni , zrobimy sobie coś dobrego , kupiłem to hiszpańskie wino , które lubisz , wypijemy po kieliszku .	lubisz	15	2
- Muszę i chcę .	chcę	3	1
Siadam w kącie i usypiam , budząc się na Gare du Nord .	usypiam	4	1
Na razie nikomu nie przedstawiono zarzutów .	przedstawiono	4	0
Pragnę nadmienić , że nie wszystkie marzenia i oczekiwania wywołują sny odwrotne .	Pragnę	0	1
Przyznam się , że nie pamiętam już tak chłodnego początku października .	pamiętam	5	1
- Czy ktoś z pań posłanek i panów posłów pragnie zabrać głos w sprawie przedstawionych propozycji ?	pragnie	9	3
Ale , Yennefer , wydaj te polecenia szybko .	wydaj	4	2
Na parterze pozostanie Księgarnia Literacka .	pozostanie	2	3
- Nie zajmujemy się leczeniem , ale poprawiamy społeczne funkcjonowanie .	poprawiamy	7	1
Pisze przemówienia , opracowania , ekspertyzy .	Pisze	0	3
Posiadam spore zbiory i wciąż poszukuję nowych .	poszukuję	5	1
Chcemy , by byli wybierani przez radnych .	Chcemy	0	1
- Ja chrapię ?	chrapię	2	1
Czy my wszyscy zasługujemy na życie w państwie rządzonym przez państwa Kaczyńskich ?	zasługujemy	3	1
Chłopak trafia do szpitala .	trafia	1	3
- Dlaczego z nimi jeździsz ?	jeździsz	4	2
Uśmiechnij się do nich i zejdź im z oczu .	zejdź	5	2
Od instynktu samozachowania wybaw nas , Panie .	wybaw	3	2
Telewizor stoi na małym stoliczku .	stoi	1	3
Leżymy na łóżku i oglądamy film .	oglądamy	4	1
A tragarzy nie słuchaj .	słuchaj	3	2
Ten sam ksiądz występuje na dokumencie lokacyjnym Tczewa z 1260 r .	występuje	3	3
Panuję nad negatywnymi nastrojami .	Panuję	0	1
Czy nasze indywidualne cele pokrywają się z celem grupy jako całości ?	pokrywają	4	3
Następnie podgrzewamy i przesączamy przez gęste sito .	podgrzewamy	1	1
Kiedy dostaniesz pieniądze ?	dostaniesz	1	2
Weź to pod uwagę .	Weź	0	2
Chyba przyznasz , że przyjemniej obcuje się z osobami myślącymi i sympatycznymi .	przyznasz	1	2
- Powróćmy do reformy podatkowej .	Powróćmy	1	1
Wisła w Toruniu przekroczyła stan alarmowy o 80 cm , a wody wciąż przybywa .	przybywa	13	3
- Idź !	Idź	1	2
Po odparciu ataku i ujęciu 10 terrorystów zawrócono konwój do bazy w Al Kut .	zawrócono	7	0
Rzecz dotyczy berlińskiej olimpiady w 1936 roku i przynależności państwowej triumfatora .	dotyczy	1	3
Idź lepiej na podwórze , pobiegaj !	Idź	0	2
Czy jeszcze kiedyś spotkam Anię ?	spotkam	3	1
Nikt nie zatrzyma rozwoju medycyny .	zatrzyma	2	3
Ułatwi ona włączenie się do ruchu jadącym z Koziegłów do Poznania .	Ułatwi	0	3
Szmigielski działa też w komisji ogródków działkowych , komisji mieszkaniowej i radzie osiedla ; ma biuro w piwnicy .	działa	1	3
Niech płaszczą się przed groźnym wieprzem !	płaszczą	1	3
Przekazuj zasady prostym językiem .	Przekazuj	0	2
- Czekam .	Czekam	1	1
Podczas świąt we wszystkich kościołach diecezji radomskiej odczytano list biskupa Zygmunta Zimowskiego .	odczytano	7	0
Do pupy polecam maść robioną w aptece .	polecam	2	1
Wysyłamy panu gratis lodowy dom . "	Wysyłamy	0	1
- Idźcie na dół .	Idźcie	1	2
Wracamy do szosy i jedziemy w stronę sąsiedniego Falsztyna .	Wracamy	0	1
- Podtrzymaj mnie , bo jeszcze nie czuję nóg .	Podtrzymaj	1	2
Jesteś impulsywna , bardzo żywo na wszystko reagujesz .	reagujesz	7	2
– w plecaku też nie masz . .	masz	5	2
- Kto uczestniczy w tej naradzie ?	uczestniczy	2	3
Wracamy do pokoju .	Wracamy	0	1
Można , bo istnieją historyczne analogie .	istnieją	3	3
- Skaczesz , rozglądasz się i wracasz .	wracasz	6	2
No , kolego pośle , chyba pan w siebie wierzy albo nie wierzy .	wierzy	9	3
- Rysiek , dam ci ciężarówkę , ale mi nią przywieziesz Nałkowską z Adamowizny i Gojawiczyńską ze Stawiska !	dam	3	1
- Już się o ciebie nie martwię .	martwię	6	1
Potem roztworem chemicznym starannie spryskano bezcenne posągi i stare mozaiki .	spryskano	4	0
- Kochasz mnie ?	Kochasz	1	2
– pokaż . .	pokaż	1	2
Osadza się na odzieży oraz trwałych nieprzepuszczalnych powierzchniach takich jak beton czy asfalt .	Osadza	0	3
W tym przypadku również zalano odcinek asfaltem .	zalano	4	0
A sprawa jest poważna , większość firm z udziałem kapitału zagranicznego wykazuje zerowy albo ujemny zysk .	wykazuje	11	3
Cenimy Pana za honor .	Cenimy	0	1
Wspaniale przy tym odpoczywam .	odpoczywam	3	1
Dlaczego mrozimy mięso ?	mrozimy	1	1
Podzielam ten pogląd .	Podzielam	0	1
Wzrasta temperatura rozmów o prawyborach w AWS .	Wzrasta	0	3
Na groblach wybudowano jedenaście betonowych śluz wałowych .	wybudowano	2	0
Pomyślano również o indywidualnych turnusach .	Pomyślano	0	0
Starczy tego rzępolenia , łajzy !	Starczy	0	3
Nie przypuszczasz , że mogła się zdarzyć .	przypuszczasz	1	2
Kiedy zaczniemy wreszcie kontrolować budynki mieszkalne i ich stan techniczny ?	zaczniemy	1	1
Przesądzają o winie ?	Przesądzają	0	3
Nadążacie , Towarzysze ?	Nadążacie	0	2
Nacierają na nas wrogie czołgi .	Nacierają	0	3
Podobnie jest ze świeczkami , ustawmy je tak , by kot nie mógł ich strącić .	ustawmy	5	1
Widzę sterczące w górę żurawie studzienne .	Widzę	0	1
- Sądy podchodzą do tajnych współpracowników bardzo liberalnie , nie eliminują z życia społecznego agentów .	eliminują	10	3
Powiedz coś do nas . . .	Powiedz	0	2
Chcesz mi w głowie przewrócić ?	Chcesz	0	2
Wypchnięto nas ze sklepu .	Wypchnięto	0	0
- Wybaczy pan , Profesorze . . .	Wybaczy	1	3
Ze zrozumieniem przyjmują lekkomyślny gest .	przyjmują	2	3
- Macie przecież jakieś zainteresowanie ?	Macie	1	2
Straty generalnej nikt nie podlicza .	podlicza	4	3
Odrabiamy je w gruncie rzeczy do dzisiaj .	Odrabiamy	0	1
Wszystkim polecam .	polecam	1	1
– idziesz ?	idziesz	1	2
Niemcy słuchają .	słuchają	1	3
- Nie ucz dziada , jak charchać !	ucz	2	2
Wygrzebuję z kieszeni monetę dwudziestocentimową i podchodzę do automatu .	Wygrzebuję	0	1
Wykąpiemy się na golasa .	Wykąpiemy	0	1
Witam wszystkich grupowiczów ! ! !	Witam	0	1
W redakcji świetnie radzono sobie beze mnie .	radzono	3	0
Nie chcę , by jakoś specjalnie się mną opiekowano czy głaskano .	głaskano	10	0
W hotelu pozostanie intendent , mały pochylony , skromny człowiek .	pozostanie	2	3
Dotyczy to na przykład usług telekomunikacyjnych , transportowych , ubezpieczeniowych , finansowych .	Dotyczy	0	3
Moje pojawienie się w studiu przyjęto oklaskami .	przyjęto	5	0
Ponadto wykładano o spółdzielczości rolniczej i handlu rolniczym .	wykładano	1	0
Ciągle chwytam się pozorów .	chwytam	1	1
Wiele ptaków owadożernych zimą zmienia jadłospis na roślinny .	zmienia	4	3
Lubisz sensacje .	Lubisz	0	2
Przypomnij sobie .	Przypomnij	0	2
W skład Grupy wchodzą firmy i ludzie powiązani z interesami postkomunistów .	wchodzą	3	3
Jadę do Katowic w sprawach różnych , poprzecznych i podłużnych , jak mówią moje dzieci .	Jadę	0	1
Jako metal szlachetny nie wypiera wodoru z kwasów , reaguje jedynie z gorącym kwasem azotowym i siarkowym , redukując je do odpowiednich tlenków .	reaguje	9	3
" Nie piszę , żeby uratować ludzkość .	piszę	2	1
Le Pen straszy zjednoczoną Europą .	straszy	2	3
Z zasady oglądam trzecią próbę generalną .	oglądam	2	1
Czego się napijesz ?	napijesz	2	2
Codziennie nakładam nawilżający krem na całe ciało .	nakładam	1	1
Fałszywego księdza przewieziono do więzienia w Rawiczu .	przewieziono	2	0
A ona nie doczeka się pochwały i może popadać w kolejne frustracje .	doczeka	3	3
Oburzamy się , że prezydent Juszczenko stawia pomniki Banderze i pielęgnuje pamięć o nim i jego bandziorach .	pielęgnuje	10	3
Ale czasza szamocze się , nie ulega .	ulega	6	3
Pieniędzy nie odzyskano do dziś .	odzyskano	2	0
- Nawet po śmierci potrafisz się kurwić .	potrafisz	4	2
Zresztą umówimy się w budzie .	umówimy	1	1
Od zbłąkanych misjonarzy uchroń nas , Panie .	uchroń	3	2
Nie odpowiem pani raczej na to pytanie .	odpowiem	1	1
Dlatego ceni się sumienność , odpowiedzialność , perspektywiczne myślenie .	ceni	1	3
Nasze działania nie zagrażają nikomu .	zagrażają	3	3
Nie jestem w stanie przewidzieć jakiejkolwiek sensownej daty .	jestem	1	1
Nie odcinam się od przeszłości .	odcinam	1	1
Kochamy Polskę , lecz fakty składające się na polską rzeczywistość działają nam na nerwy .	Kochamy	0	1
Na pewno zrobisz to lepiej ode mnie .	zrobisz	2	2
Naprawdę rzadko się zdarza w województwie , że w jakiejś dziedzinie sięgamy po pierwsze miejsca .	sięgamy	11	1
Mówię ogólnie .	Mówię	0	1
Nasi politycy nie dostrzegają Przełomu .	dostrzegają	3	3
Nad głową ojca dyrektora od kilku tygodni gromadzą się czarne chmury .	gromadzą	7	3
Wojciech Onyszkiewicz działa społecznie .	działa	2	3
- Nie sypiasz od dawna , co się dzieje ?	sypiasz	2	2
Andrew zauważył , że przykuto go za nogę do ściany , żelazna obręcz obejmowała kostkę .	przykuto	4	0
Wracają i pracują solidnie .	Wracają	0	3
Specjaliści Paribas mówią przede wszystkim o doskonałej kondycji gospodarki amerykańskiej , która winduje kurs dolara .	winduje	12	3
– dlaczego tego już nie produkują ?	produkują	5	3
wy macie łirpula lodówkę ?	macie	1	2
W ubiegłym roku w czerwcu okna w komunalnym mieszkaniu Salwockich wybijano trzy razy .	wybijano	10	0
Nie chcę nic sugerować , ale jest tam jedna fajna , prawie bezbłędna poetka .	chcę	1	1
Jeszcze po południu zawieszony prezes największego polskiego ubezpieczyciela nie wiedział , czy członkowie rady podejmą jakieś decyzje w jego sprawie .	podejmą	14	3
Wtorek przyniósł postęp , jakiego się nawet nie spodziewano .	spodziewano	8	0
Uważają nas za moskalofilów , takich zaprzańców antyukraińskich , podczas gdy sami deklarują ukraiński patriotyzm .	deklarują	12	3
Nie wypowiadamy czegoś …	wypowiadamy	1	1
Docierają pracodawcy .	Docierają	0	3
Śmierć nie uniemożliwia kontaktu .	uniemożliwia	2	3
Albo zesłać mu śmierć , zanim się zestarzeje .	zestarzeje	7	3
– Jadę do Frisco .	Jadę	1	1
Zanurz się we mnie . . .	Zanurz	0	2
Przygotujemy wszystko i wtedy napijemy się maty .	Przygotujemy	0	1
Społeczeństwo wychowywano w ślepym posłuszeństwie wobec Cesarstwa .	wychowywano	1	0
– nie opisuj tylko zjedz . .	opisuj	2	2
A o czym szepczesz ?	szepczesz	3	2
Dawaj opończę .	Dawaj	0	2
Posiada Pan jedynie dyplom magistra filozofii . . .	Posiada	0	3
Ale takiej nikt nie złapie !	złapie	4	3
Nie sprzeciwiaj mi się , dobrze ? . . .	sprzeciwiaj	1	2
Zbliżają się ferie , już niedługo pociągi z Warszawy do Zakopanego zapełnią się młodzieżą .	Zbliżają	0	3
Skoncentruj się na przestrzeni pomiędzy dwoma profilami .	Skoncentruj	0	2
Urządzono kaskady i wodotryski .	Urządzono	0	0
100-tysięcznym Grudziądzem rządzi lewica .	rządzi	2	3
- Zatrzymaj się , bo strzelę !	Zatrzymaj	1	2
Rozdają publiczne pieniądze na rzecz Kościoła katolickiego , modlą się żarliwie przed kamerami , marzą o cenzurze obyczajowej .	modlą	8	3
nie przejmuj się . .	przejmuj	1	2
Była typową polską postępową inteligentką czyli agnostyczką , i wzmianek o chodzeniu do kościoła u niej nie upatrzysz .	upatrzysz	17	2
Toteż aby poprawić sytuację materialną wielu rodzin , nie musimy zmieniać zapisów ustawy budżetowej .	musimy	9	1
Poślij po niego , niech przyjdzie i zaświadczy .	Poślij	0	2
Budynek podpalono .	podpalono	1	0
RADA BEZPIECZEŃSTWA omawia skargę Zambii z powodu powtarzających się aktów agresji ze strony rasistowskiej RPA .	omawia	2	3
Ela łyka powietrze głębiej , głębiej . . .	łyka	1	3
Witam wszystkich na grupie !	Witam	0	1
Zapraszam do comiesięcznej lektury i do następnego konkursu .	Zapraszam	0	1
No , nie mitręż , dziewczyno .	mitręż	3	2
W dawnej Polsce starannie go przestrzegano .	przestrzegano	5	0
Możesz zmieniać pracę lub mieć dwa zawody .	Możesz	0	2
Jedynie opisywane przez panią żółwie na Seszelach się p . . .	p	8	3
Wieczorem nie siedź przed telewizorem .	siedź	2	2
Rozmaite padliny wieszano na Sienkiewiczu , ale ja w jego obronie zawsze staję .	staję	12	1
nie wstydzicie się tego ?	wstydzicie	1	2
- Prosimy zachować czujność .	Prosimy	1	1
Policja przypuszcza , że najnowszy ładunek został porzucony przez spłoszonego niedoświadczonego terrorystę .	przypuszcza	1	3
Poprawcie mnie , jeśli się mylę .	Poprawcie	0	2
- Może lepiej nam się poszczęści .	poszczęści	5	3
– nic nie zrobisz .	zrobisz	3	2
Czy zdajesz sobie sprawę z tego , że nie jesteś ochrzczony ?	zdajesz	1	2
Pracujemy nad tą grupą dzień i noc .	Pracujemy	0	1
Przez całą niedzielę sprawdzano każdy wątek i potencjalnych sprawców .	sprawdzano	3	0
No idź już , wracaj do powozu .	idź	1	2
– oj no nie szkodzi no .	szkodzi	4	3
Motyl , który drzemie przysiadłszy na dzwonie .	drzemie	3	3
Zostawisz chwaścik , a jutro , pojutrze wyrośnie ożóg .	Zostawisz	0	2
Obecnie dzierżawi ponad 8 tys . km łączy cyfrowych .	dzierżawi	1	3
Wydaje się , że powrót do pracy jest swoistym lekarstwem .	Wydaje	0	3
Możecie się ze mnie śmiać . . .	Możecie	0	2
- Oto walczę na froncie Kościoła i tam dbam o prawdziwą wiarę .	dbam	8	1
Ale taka większość powstanie .	powstanie	3	3
Zdecydują o tym rady krajowe SLD i Unii Pracy oraz Rada Naczelna PSL .	Zdecydują	0	3
Może jesteśmy przeczuleni , ale nazwa sugeruje , że Uniqua unika płacenia odszkodowań .	unika	10	3
- A wyglądam na takiego ?	wyglądam	2	1
Nie licz na udany romans .	licz	1	2
Tutaj mamy jakąś pomieszaną wersję .	mamy	1	1
- Musisz .	Musisz	1	2
Nie dziwię się .	dziwię	1	1
- Jak Pan sądzi , na kogo głosują ?	głosują	7	3
Stwierdzono , że stosunkowo wysokie zarobki mają pielęgniarki bloku operacyjnego .	Stwierdzono	0	0
Bywa , że dzieci ulegają nam , podporządkowują się naszej woli .	ulegają	4	3
Może narażę się na krytykę ze strony pana premiera Pawlaka , ale wciąż zbyt wielkie znaczenie przywiązujemy do umów międzyrządowych .	przywiązujemy	16	1
Dziwi się , że ludzie ustępują mu z drogi , że go widzą . . .	widzą	12	3
Można powiedzieć , że teraz stoisz twarzą w twarz z Twoim upokorzeniem .	stoisz	5	2
- Weź te ręce , gówniarzu !	Weź	1	2
Działacze liczą , że związek nie będzie ścigany z całą surowością .	liczą	1	3
Jednocześnie następują dynamiczne , ale dostosowane do realiów społecznych i kapitałowych przekształcenia własnościowe .	następują	1	3
czy ty wierzysz w świat radykalnie wegetariański ?	wierzysz	2	2
Sex Pistols gramy od paru ładnych lat na specjalne okazje .	gramy	2	1
– Nie możesz mi otworzyć ?	możesz	2	2
Może tego doczekają .	doczekają	2	3
Ale i wiem , że teraz kłamiesz .	kłamiesz	6	2
- Tylko mi nie wyjeżdżaj z animą !	wyjeżdżaj	4	2
Oto się zbliża , już go widzę .	zbliża	2	3
Za słabo garbowano Musze skórę w Gross Rosen .	garbowano	2	0
Wybierz dowolny chat , umów się z przyjacielem na określoną godzinę i rozmawiaj do woli .	umów	4	2
Mimo wprowadzenia stanu wojennego i militaryzacji kopalń czterobrygadówka nie powraca .	powraca	9	3
– co chesz ?	chesz	2	2
Poza tym powinna być bardziej dostępna dla zainteresowanych osób , które zechcą przechować w nim ważne osobiste dokumenty .	zechcą	11	3
Nie uchroniono się od wypadków .	uchroniono	1	0
– Słucham ?	Słucham	1	1
Przyznam , że sam był em zdziwiony . . .	Przyznam	0	1
Zobaczymy , co zwiozą nam do młodni .	Zobaczymy	0	1
Kobiety w więzieniu doskonale łagodzą obyczaje .	łagodzą	4	3
ci tłumaczę .	tłumaczę	1	1
Zapowiada się kolejna bezsenna noc .	Zapowiada	0	3
W gabinecie sadza na fotelu , siada obok i w obecności rodziców streszcza mu , co jej opowiedzieli .	sadza	2	3
Trupy wrzucono do Gopła .	wrzucono	1	0
– Zawrzyj pokój z samą sobą .	Zawrzyj	1	2
Zaprószono ogień i wybuchł poważny pożar na górnych piętrach .	Zaprószono	0	0
Dziwnej kompanii , ośmielę się zauważyć .	ośmielę	3	1
Weźmy dzieje sztuki tego okresu .	Weźmy	0	1
- Zatłukł mojego męża , a po trzech miesiącach go wypuszczono .	wypuszczono	10	0
W sobotnią noc na parkingu dyskoteki w Nowych Bielicach uszkodzono dwa samochody .	uszkodzono	9	0
- Z wiekiem człowiek zwalnia i rozgląda się wokół .	zwalnia	4	3
Plan , jeśli ma się powieść , musi być przede wszystkim możliwy .	musi	7	3
Mnie samą zaangażowano .	zaangażowano	2	0
Mówmy , że ktoś nieśmiały jest też bardziej wrażliwy , milszy .	Mówmy	0	1
Jeśli jednak różnice te nie pozwalają wam zbudować takiego formalnego porozumienia , dajcie zielone światło do współdziałania ludziom tworzącym wasze ugrupowania .	dajcie	12	2
Nie wierzycie im ?	wierzycie	1	2
Z tego płynie nauka również dla innych szefów wojewódzkich .	płynie	2	3
Niepostrzeżenie wracamy do domu i nad ranem obwieszczamy światu odkrycie niecodziennego zjawiska .	wracamy	1	1
Macie ten kalendarz przy sobie ?	Macie	0	2
Czasami przypali zupę , czasami stłucze talerz z pomidorówką .	przypali	1	3
Wypowiadamy się w sondach telewizyjnych a czasami przesyłamy także nasze opinie elektronicznie .	przesyłamy	7	1
Jednak nawet wtedy eksperci zgodnie twierdzili , że boom internetowy kiedyś wróci .	wróci	11	3
nie lubię . .	lubię	1	1
Popatrz , jak inni poruszają ustami .	Popatrz	0	2
Mieszkał z ojcem i nie chciał , żeby ktoś wiedział , że płaci takie duże rachunki .	płaci	12	3
Czy sądzisz , że teraz , po tych wszystkich latach , rzucę dom , dzieci i pójdę za tobą ?	sądzisz	1	2
Teraz umocnią się na rynku .	umocnią	1	3
W dusznej od papierosowego dymu izbie tłoczono się okropnie .	tłoczono	6	0
- Nie jedź do Jerozolimy !	jedź	2	2
Nie daj pogoni się zbliżyć .	daj	1	2
Nie sądzę , by m zawiódł kogokolwiek .	sądzę	1	1
Po czym ogłoszono , że olimpiadę zawiesza się do odwołania .	ogłoszono	2	0
- Czy ja dobrze słyszę ?	słyszę	4	1
" Dąbrowska odnotowuje , że zarys którejś z nowel Kowalska w pośpiechu rzuciła na papier po francusku " .	odnotowuje	2	3
- Naukowo udokumentowano przypadek Francuzki , która zmarła w wieku 122 lat .	udokumentowano	2	0
Strajk zawieszono .	zawieszono	1	0
Podajemy w miseczkach lub na talerzach .	Podajemy	0	1
- Jak sobie wyobrażasz kino bez aktorów ?	wyobrażasz	3	2
Oj , słyszą .	słyszą	2	3
Jeśli weźmiemy pod uwagę sprawność i wydajność akumulatorów wanadowych , projekt wydaje się zupełnie realny .	weźmiemy	1	1
- Ale ty w Boga nie wierzysz .	wierzysz	6	2
- Macie chyba trzecią szklaneczkę . . .	Macie	1	2
Nie robimy z tego tajemnicy .	robimy	1	1
Nie zatrzymuję cię .	zatrzymuję	1	1
- Przyzwyczajajmy dzieci do picia mleka !	Przyzwyczajajmy	1	1
- Całkowicie zgadzam się z odkryciami naukowców .	zgadzam	2	1
Społeczeństwo wychowywano w ślepym posłuszeństwie wobec Cesarstwa .	wychowywano	1	0
Pan co robi we Francji ?	robi	2	3
Czynię to .	Czynię	0	1
Patrzę na drzwi , bo ktoś idzie po schodach .	Patrzę	0	1
Zaciągam się papierosem i próbuję przypomnieć sobie dawnego Dziedziuszkę .	próbuję	4	1
Harcerze zbierają niepotrzebne rowery , aby po naprawie przekazać je Domowi Dziecka w Kórniku-Bninie .	zbierają	1	3
Staruszkę ze zmiażdżoną prawą stopą przewieziono do szpitala przy ulicy Cegłowskiej .	przewieziono	5	0
Przyjrzyj się fotografiom i rysunkom w podręczniku przedstawiającym przykład krajobrazu śródziemnomorskiego .	Przyjrzyj	0	2
Jeżeli jesteś za granicą , głosuj z ważnym polskim paszportem .	głosuj	5	2
Okna przysłonięto żałobnym kirem .	przysłonięto	1	0
Tak więc ostrzegam i odradzam .	odradzam	4	1
I szukaj korka w polu !	szukaj	1	2
Oni będą zarabiać więcej , a prąd podrożeje .	podrożeje	7	3
Witaj , witaj .	Witaj	0	2
Jaką kwotę łącznie wypłacono ?	wypłacono	3	0
Odwrotnie nie przekazuje się żadnych wiadomości .	przekazuje	2	3
– pokaż !	pokaż	1	2
Po raz ostatni połączono się ze stacją w sobotę przed wieczorem .	połączono	3	0
Zaciskam powieki .	Zaciskam	0	1
- Zapewne miał by m i to , i to , gdyż oba rozwiązania mieszczą się w programie i w myśleniu mojego zaplecza politycznego .	mieszczą	14	3
- To rekin , a ty się boisz , że przy pierwszej okazji wytarmoszę go za płetwy .	boisz	7	2
Poczęstowano nas kawą , a nie wódą .	Poczęstowano	0	0
- Nie zrobisz tego .	zrobisz	2	2
Nie znaczy to , że rezygnuję ze sportu .	znaczy	1	3
Kupiono za granicą oranżerie , marmurowe posągi .	Kupiono	0	0
W latach sześćdziesiątych , już jako sztygar oddziałowy , pamiętam odbiory przygotowywanych do rozruchu ścian dokonywane przez dyrektora Śniegonia .	pamiętam	9	1
- Jeśli lud przestanie słuchać naszych nauk , zostanie pożarty przez pogan !	przestanie	3	3
Lubi Polaków .	Lubi	0	3
Gotujemy na małym ogniu 15 minut .	Gotujemy	0	1
W wielkim domu znajdziesz dwie malowane brody .	znajdziesz	3	2
- Biegnij , Jaskier !	Biegnij	1	2
W październiku zeszłego roku w Warszawie odzyskano skradzionego opla .	odzyskano	6	0
Towarzysz jego wzywał Jezusa i jego Matkę , a tacy ludzie jak Esteban wołają te słowa tylko twarzą w twarz ze śmiercią .	wołają	13	3
Dziękuję , że mimo trudności odwiedza mnie Pan i komentuje moje teksty .	Dziękuję	0	1
- A ty się zamknij !	zamknij	4	2
- Chcesz nas w to wrobić ?	Chcesz	1	2
Przystępujemy do głosowania .	Przystępujemy	0	1
Wybierz się do miasta Łodzi .	Wybierz	0	2
tutaj mówimy o Sekule ale też są problemy no .	mówimy	1	1
Jeśli w sercu pojawi się niepewność , nie dramatyzuj .	dramatyzuj	8	2
Mamo , proszę , zgódź się , tylko tym razem .	zgódź	4	2
Jak sądzisz ?	sądzisz	1	2
Dziewczyny konkurują tylko przed publicznością , w garderobie sobie pomagają .	konkurują	1	3
Zostawiono drzewa wskazane przez specjalistów .	Zostawiono	0	0
Jakoś się pogodzimy .	pogodzimy	2	1
- Nie zna ich pan ?	zna	2	3
Występujesz gdzieś teraz ?	Występujesz	0	2
Dzieło skradziono przedwczoraj z Biblioteki Polskiej Akademii Nauk w Krakowie .	skradziono	1	0
- Nie gadaj dużo , tylko bierz za sznur .	bierz	6	2
Skomplikowany zabieg przeprowadzono w jednej z klinik w Szanghaju .	przeprowadzono	2	0
Stań prosto , ze stopami rozstawionymi na szerokość ramion , wyprostuj plecy i wciągnij brzuch .	wciągnij	13	2
Za to w wyniku referendum mogą stracić fotele .	mogą	5	3
- Przynajmniej żyjemy ; jeszcze nas nie eksterminują .	żyjemy	2	1
Umiera w swoim ogrodzie .	Umiera	0	3
Ja stoję w bruździe i w uniesionej ręce trzymam zapalony fanarek .	stoję	1	1
- Ciągle nasłuchujesz ?	nasłuchujesz	2	2
