Ehdotetut Euroopan yhdenvertaisten mahdollisuuksien teemavuosi 2007 ja Euroopan kulttuurien välisen vuoropuhelun teemavuosi 2008 ovat tärkeitä aloitteita , joilla lisätään tietoisuutta näistä asioista ja joilla edistetään tavoitteiden saavuttamista .	näistä	20	Ela
Mulla ei ole puukko matkassa .	Mulla	0	Ade
Minä tykkään ja et se on väärin	Minä	0	Nom
Sinulle , jolta intti on vielä suorittamatta , voin sanoa , että kyllä sen läpi selviää , jos vain on huumorintajua eikä rasita itseään turhilla pohdinnoilla .	Sinulle	0	All
Enkä tiiä ees ketää , kuka käyttäis	ketää	3	Par
Leon mukaan ” Mitro Repo on opiskelunsa aikana ja pappisvihkimisessään sitoutunut tähän kirkon perinteeseen ” .	tähän	11	Ill
Sit ku puhuttiin et jos mennään johonki semmoseen paikkaan mis ois mahdollisesti vaikka jotain jameja ni onks se torstai just se päivä millon ne onnettomat paikat mitkä ne pistää sitte kiinni jos ne pistää	mis	9	Ine
Jos itsellekin on sattunut kertymään vähän ylikiloja , innostutaan vertailemaan vararenkaita laihduttajan kanssa : minunhan tässä pitäisi laihduttaa eikä sinun .	minunhan	14	Gen
b ) aiheuttaa huomattavia menetyksiä henkilöille , joita asia koskee , ja	joita	7	Par
Teidät käsitetään opiskelijoina , mutta älkää unohtako olevanne myös ainutlaatuisia ihmisiä .	Teidät	0	Acc
Villit huhut kertovat mm. muuan uskalikosta , joka matkusti pienessä autossa eläinlääkärin , kolmen fuksianpunaisen fyysikon ja diplomi-insinöörin kanssa Helsinkiin Matlun Klusterille tanssimaan pöydillä palaten Otaniemeen mukanaan järjestölehtipornon hienoin saavutus .	muuan	4	Nom
Ei se milloinkaan meiltä ihan tietymättömissä ollut .	meiltä	3	Abl
Et sä viitsis soittaa Eilalle ja mut sullakaan ei oo niiden puhelinnumeroo , vai onks sul .	sul	15	Ade
He rakastavat toisiaan .	toisiaan	2	Par
Näin sinne sinutkin	sinutkin	2	Acc
Tässä minä nyt istun , elintoiminnot hidastuen kokoajan .	Tässä	0	Ine
Vai voiko tosiaan pitää paikkansa , että minun neljäs olohuoneeni , jonne tulen arki-iltana juomaan teetä ja pelaamaan lautapelejä kavereiden kanssa , on jollekin laittautumisen , aloittelun ja jatkojen väliin jäävä bilepaikka ?	jollekin	23	All
Mikäli kaikki menee hyvin , myöhemmin on tiedossa vielä toinen haastattelukierros , ja jos senkään jälkeen ei ole onnistunut vakuuttamaan haastattelijoita olemattomista kyvyistään , voi työsopimus olla kourassa hyvinkin pian .	senkään	14	Gen
Kerro Marjut keneltä sä oot saanu tän .	tän	6	Gen
Eikä hällä ollu mitään papereit siinä itsellään	hällä	1	Ade
Mitäpä mies .	Mitäpä	0	Par
- Mitämitä , Lasarin S-market ja Alko avattu ? ! ? !	Mitämitä	1	Par
Näillä sanoilla yritän lohduttaa miestäni joka aamu , kun hän aukaisee silmänsä ja näkee ensimmäisenä minut .	Näillä	0	Ade
Joulu on eräällä tavalla jäänyt taakse , talvi on tullut oikein kunnolla ja kodissa vallitsee joulun jälkeinen kaaostila … ;)	eräällä	2	Ade
Tuolla tavalla meistäkin olisi tullut kuuluisia .	meistäkin	2	Ela
Vaksi tuli ihmettelemään piruako siinä norkoilin , minä selvitin etsiväni työnjohtajaa ja se kysyi ketä niistä .	ketä	14	Par
Teos sai nimekseen Sinulle	Sinulle	3	All
Ja senhän minä tekisin .	senhän	1	Gen
silt on tästä pudonnu tää osa mis on sen nimi	silt	0	Abl
He huolehtivat toinen toisestaan .	toisestaan	3	Ela
Erääseen kammioon unohtunut hallintovirkamies kuuli uudistushankkeesta .	Erääseen	0	Ill
Ihan normaalia lapsen toimintaa , mutta monilla vaihe jää pysyvästi päälle .	monilla	6	Ade
Ja sinulla oli se vasta ostettu kävelypuku .	sinulla	1	Ade
Siitähän on jo 10 vuotta !	Siitähän	0	Ela
Ja nyt tuntuu siltä , että on pakko jatkaa .	siltä	3	Abl
Merja Larivaara on tässäkin kaunotarpoliisi Ilona Lumme ja Niko Saarela asiaan kuuluva hönttipoliisi Muilu .	tässäkin	3	Ine
En koskaan saa tätä anteeksi , enkä tule koskaan saamaankaan .	tätä	3	Par
Ninan äiti teki meille minihameet , joilla me sitten paistateltiin Norssissa .	joilla	6	Ade
Tosilla oli todella iso tukkapehko .	Tosilla	0	Ade
No minäkös siihen sanomaan , ettei kukaan huoli tuon näköistä mihinkään .	minäkös	1	Nom
vadelmahillo antaa mukavaa yhteismakua muidenkin marjojen kanssa .	muidenkin	4	Gen
Samassa häntä alkoi ärsyttää koko tapahtuma .	häntä	1	Par
Vimin keskeinen idea on , ettei kumpaakaan kättä tarvitse siirtää näppäimistöltä ( esimerkiksi hiirelle ) minkään toiminnon , kuten tallentamisen , ajaksi .	minkään	15	Gen
Nimi johtui siitä , että potilas sai niin kovan päänsäryn , että se teki hänet hulluksi .	hänet	14	Acc
Joku nimesi hänet pubissa Euroopan rumimmaksi mieheksi , joka ei ymmärrä jääkiekosta senkään vertaa kuin KuPSin kannattaja jalkapallosta .	senkään	12	Gen
Hän puree huuliaan , saa ne näyttämään siltä kuin olisi suudellut rakastaan tunteja .	siltä	7	Abl
Vetoomusvaliokunta ei tietenkään ole mikään maailman napa , se on kuitenkin tämän Euroopan parlamentin valiokunta , joka on erilainen kuin muut .	muut	20	Nom
Haagin ohjelman mukaan yhteisiin perusperiaatteisiin perustuvien puitteiden olisi muodostettava pohja EU:n tuleville aloitteille , joissa määritellään selkeät tavoitteet ja arviointikeinot .	joissa	14	Ine
olin käyttäytynyt täysin rauhallisesti aina siihen asti , kun tulivat paikoille .	siihen	5	Ill
Huomaan , että komissio ja ympäristöjärjestöt uskovat , että käytännössä voitaisiin saavuttaa paljon enemmän ja että muutamat jäsenvaltiot ovat joka tapauksessa sitoutuneet alentamaan merkittävästi ilman epäpuhtauksia - vaikka se ei pidäkään paikkaansa kaikkien kohdalla .	muutamat	16	Nom
Sen sijaan että orjuuttaisimme itseämme hamassa tulevaisuudessa epämääräisesti häämöttävän palkinnon toivossa , tulisi meidän vapautua suorituspaineistamme , karistaa ylimääräinen vastuuntunto harteiltamme ja ryhtyä nauttimaan raukeasta elämästä .	itseämme	4	Par
4 ) Lisätään 7 artiklaan kohta seuraavasti , jolloin nykyisestä ainoasta kohdasta tulee 1 kohta :	ainoasta	10	Ela
maasta toiseen muuttaminen	toiseen	1	Ill
Kaikki ovat turtuneita arkeen , sen pyörittämiseen sekä joka päivä toistuviin samoihin rutiineihin .	samoihin	11	Ill
Sinun täytyy lähteä	Sinun	0	Gen
Ja kun hän oli humalassa , hänelle tuli valheellisen turvallinen olo sellaisessa mielentilassa teki helposti varomattomuuksia .	hänelle	6	All
Miltä nyt tuntuu ?	Miltä	0	Abl
Talovahtina ties kuinka monennetta kertaa	monennetta	3	Par
Siitä vain läksyjä lukemaan .	Siitä	0	Ela
– Sitä pitää varmaan kysyä siltä itseltään .	itseltään	6	Abl
Se minua sapettaa niin helvetisti .	minua	1	Par
Eikä itsestään huolehtiminen mitään turhamaisuutta ole – muuta kuin niiden akkojen mielestä , jotka ovat miehensä toivomuksesta tai laiskuuttaan alkaneet niihin säkkeihin pukeutua .	muuta	7	Par
Mull on tossa viimene rulla saat sen se on kahenkymmenen neljän kuvan et sil nyt kuvaa jonkun verran jo ,	Mull	0	Ade
Tarkemmat rakenteet ( jokaisessa taulussa indeksi id-sarakkeessa ) voit vilkaista tekstin lopusta .	jokaisessa	3	Ine
Arduinoon on saatavilla erilaisia ” laajennuksia ” , shieldejä , joilla sitä saa laajennettua esim. GPS-trackeriksi tai GSM-puhelimeksi .	joilla	10	Ade
Accenturen mannekiinin Tiger Woodsin komistamien Powerpoint-kalvojen ihmettelyn jälkeen lähdemme tekemään kiertokäynnin accenturelaisten työtiloihin muutamaa kerrosta ylempänä .	muutamaa	13	Par
Itselleni ja pojalleni .	Itselleni	0	All
Joo muutamissa sekunneissa ymmärrän , ettei niin huonoa vitsiä voi olla olemassa ja alan itkeä .	muutamissa	1	Ine
Kolmanneksi tässäkin raportissa ympäristönäkökohtien sisällyttäminen Lissabonin strategiaan vaikuttaa todella pelkältä nimelliseltä eleeltä .	tässäkin	1	Ine
Kummallakin oli ase kädessään .	Kummallakin	0	Ade
Mistä he pitävät ja mistä eivät .	he	1	Nom
Myös joitain nopeakasvuisia mäntylajikkeita , kuten montereynmäntyä ( Pinus Radiata ) voidaan käyttää hiokkeen valmistuksessa .	joitain	1	Par
meillä voisi olla tarve tukea ja kannustaa sitä , mikä meidän suomalaisessa kulttuurissamme on hyvää , niin filmissä kuin kirjallisuudessa kuin paljossa muussakin .	muussakin	22	Ine
Kello on varastettu joltakulta .	joltakulta	3	Abl
Siitä minäkin olen tänään nauttinut .	Siitä	0	Ela
Eihän meillä olisi silloin ollut edes tilaa millekään junanradalle , hyvä kun itse mahduttiin kaikki yhtaikaa lattialle seisomaan .	millekään	7	All
Toisilla kaljaa oli kaljaa , mutta toisilla ei .	Toisilla	0	Ade
Lopulliset iltamenot jäi itseltä väliin , kun parin päivän minimi-yöunet ja väsymys alkoi painaa liikaa .	itseltä	3	Abl
( 16 ) Kaikille matkustajille olisi annettava perustiedot korvausvastuuseen sovellettavista säännöistä , jotta he voivat tarvittaessa ottaa lisävakuutuksen ennen matkaa .	Kaikille	3	All
Joka tapauksessa puhun myöhemmin enemmän joistakin tarkistuksista , joissa käsitellään näitä näkökohtia .	joissa	8	Ine
Mut minä en tunne kettää .	kettää	4	Par
Ensinnäkin hän oli nuori ja toisekseen aurinko ilkkui hänelle enimmän osan vuodesta kotimaan kamaralla , piiloutui milloin minnekin pilvien taakse tai kieltäytyi osan aikaa edes näyttäytymästä .	hänelle	8	All
Meidän pitäisi kannattaa tätä mietintöä ja antaa hänelle tukemme .	hänelle	7	All
Joskus biisin loppupuolella he ovat keränneet paikalle sen verran ihmisiä että puu saadaan ilmaan tyvipäästä ja minut raahataan väkisin pois lepäämästä .	minut	16	Acc
Laulua saatiin kuulla paljon ja korkealta ; joku epäili lokiin eräiden miespuolisten festeilijöiden kivesten kadonneen .	eräiden	10	Gen
Ma oon ollu , sillon tällön tollasessa , erilaisis tilaisuuksis niin ku säestämässä , jotai yksillaulajaa tai , sellasta , esimerkiks jossai häissä mä oon olluj ja , tommosissa	jossai	21	Ine
– Siihen on tietysti monia syitä .	monia	4	Par
Tositilanne on nimittäin se , ettei kellään vaikuttaisi olevan juuri minkäänlaista yleispätevää käsitystä siitä , mitä tuo 27 tunnin työmäärä käytännössä tarkoittaa .	kellään	6	Ade
Eilen halusin vielä ryypätä , koska jokainen lukemani " viini " sana sai minut muistelemaan suloista punaista nestettä , mutta tänään minusta on alkanut tuntua , kuin kaikki Chinaskin juoma alkoholi vaikuttaisi minussakin ja saisi minutkin kärsimään kroonista krapulaa .	minutkin	35	Acc
Jone katsoo hetken silmiin , vilkaisee rannalle ja katsoo minua jälleen .	minua	9	Par
Minun on pakko käydä maksamassa sähkölasku , meiltä on pantu sähköt poikki .	meiltä	7	Abl
He eivät saaneet hevosta taltutettua ja se pääsi heiltä pakoon .	heiltä	8	Abl
Haluaisin kysyä teiltä , isiltä ja äideiltä , jotka annatte lapsillenne ilmakivääreitä lahjoiksi , että tiedättekö mitä lapsenne niillä tekevät ?	teiltä	2	Abl
Tuletko sinä ?	sinä	1	Nom
On meillä lomaa .	meillä	1	Ade
Tää on tän verran ku se on .	tän	2	Gen
Ei nainen tai vaimo ole mikään tavara , joka haetaan itselle sitten , kun mieli tekee .	itselle	10	All
Kyl se niin on et ei täs elämäs mittään saa jos nyt yhteen tonttiin juuttuu .	mittään	8	Par
Kenelläkään muulla ei ollut lippua kuin minulla .	Kenelläkään	0	Ade
Ei kenelläkään muulla ole sellaista nenää jollainen minulla on .	muulla	2	Ade
Jotkin niistä parantavat selvästi neuvoston yhteistä kantaa ja näin ollen komissio hyväksyy ne kokonaisuudessaan , periaatteessa tai osittain .	Jotkin	0	Nom
Kansankoti Ruotsin tuleva kuningatar saa naida kenet haluaa .	kenet	6	Acc
Jos minulla olisi pedagogista tajua ja lasiliike ja sika , minä opettaisin sen sian ruokapalkintojen avulla .	minulla	1	Ade
Niin , visualisointeja voisin ehkä noista tehdä , saa nähdä .	noista	5	Ela
Minä ostin leipää .	Minä	0	Nom
Moneltakos se yöjuna lähtee .	Moneltakos	0	Abl
Kas siinäpä kysymys .	siinäpä	1	Ine
- Ei mulla ole ketään muuta .	muuta	5	Par
Oom mä pyrkiny aina kesällä siim pari viikkoo , lähtemään tonne meiäm mummol luom maalle	meiäm	11	Gen
Kaikille sattuu vahinkoja .	Kaikille	0	All
Sit se oli itte ollu tää naapurin pikkupoika semne et ku sil oli ollu ittellää synttärit ni se oli aina seissy ninku ovella tällee näi vastassa ku vieraat tuli et LAHJA LAHJA	itte	3	Nom
siinähä o hirveesti englanninkielisiä termiä	siinähä	0	Ine
Useimmilla on mies mukana .	Useimmilla	0	Ade
- Opettaja , mä näin sut eilen kaupungilla .	sut	5	Acc
Pitää muistaa aina se , että pyritään syöttämään edes siihen suuntaan mihi se kaveri on menossa .	mihi	11	Ill
Se maa tulee kestämään yli vielä sinunkin elinaikasi .	sinunkin	6	Gen
Näin tehtyäni pohdin muutaman hetken siirtymistä kofeiinipitoisen aamiaisen pariin keittiöön , mutta huoneilman hyytävä kylmyys ja jäsenieni uninen kohmeisuus pakottavat minut palaamaan peiton alle vielä viideksitoista minuutiksi .	minut	20	Acc
Minä teetin muurarilla autioon taloon uunin .	Minä	0	Nom
Yleisesti voidaan todeta , että paikalliset identiteetit eivät ole kadonneet mihinkään liitosten myötä .	mihinkään	10	Ill
Kuumenna rasva pannulla , lisää curry ja pyöräytä , lisää keitetty pasta ja muut mausteet ja paista pasta kevyesti välillä sekoitellen .	muut	13	Nom
Kummassakin puolueessa on Koivistolla vankka kannatus .	Kummassakin	0	Ine
Mulla on kahvi valmistumassa .	Mulla	0	Ade
Sillä käytiin kirjeenvaihtoa ja luotiin runoutta .	Sillä	0	Ade
Olin matkalla ystäväni kosteille syntymäpäiväkutsuille , ja ajattelin haaveillen sitä kuinka olin pakottanut hänet kutsumaan sinutkin .	sinutkin	15	Acc
Pyydät häntä istumaan vieressäsi psykologiassa , seuraavassa jaksossa kaikissa samoissa kursseissa ja teistä tulisi nopeasti hyvät ystävät , haluaisit jotain enemmänkin .	samoissa	9	Ine
Meidän on pohdittava kaikkea tätä Basel II -sopimuksen yhteydessä , jossa – sisäistä tai ulkoista – luokitusta sovelletaan yhä enemmän pienten ja keskisuurten yritysten rahoitukseen .	Meidän	0	Gen
Pakistanissa suojeltavat terroristit ovat uhka paitsi Intialle myös muulle maailmalle ja siten myös Euroopan unionille .	muulle	8	All
Olisitte kilttejä toisillenne .	toisillenne	2	All
päätin etten kerro kummastakaan koska vaikka Hanna on maailman kaunein nainen se saattaa silti alkaa haukkua .	kummastakaan	3	Ela
Minusta näyttää nyt vahvasti siltä , että Nato ei ole tajunnut tätä tosiasiaa , Sacirbey sanoi toimittajille .	siltä	4	Abl
Paras luokitus on harvoilla yrityksillä	harvoilla	3	Ade
Linnuilla on varsin etevä aisti vaaratilanteisiin eikä tästä syystä tämä ollut tohtinut asettua näytille ruokalassa , ties vaikka olisi joutunut soppakattilaan ja miehen suuhun saakka .	tästä	7	Ela
Mitä sä siinä teet .	Mitä	0	Par
" Valdas " , mies esitteli itsensä .	itsensä	6	Gen
Mull oli vähän hommaa saada se puuhaan jotain et mä ehdin koluta siellä	Mull	0	Ade
Sulla ittelläs mittään olluk kus sä tähän tulit .	Sulla	0	Ade
Ihmiset jotka on helpoin leimata -sossupummit , narkkarit työttömät ja vain olevat olennot , muut oudot ja kertakäyttökusipäät- ovat vain tiedostaneet olevansa paskaa ja eivät siksi hakeudukaan ruokapöydälle , ettei tule kaikille mielipahaa .	kaikille	31	All
Minusta elikko ei väliittänyt mitään , vaikka muutamien metrien päästä räpsin kuvia ... .	muutamien	7	Gen
Meidät on nimitetty tähän parlamenttiin tekemään historiaa .	Meidät	0	Acc
Tämäkö on ihmisen aikaansaamaa ?	Tämäkö	0	Nom
Täytteenä on kinuskikermavaahtoa ja kotimaisia vadelmia ja toisessa välissä säilykepersikkaa ja sitruunarahka-kermaseosta .	toisessa	7	Ine
Teos sai nimekseen Sinulle	Sinulle	3	All
Ei minua pelottanut puheet kuumista ja jäätävistä työskentelyolosuhteista , minä halusin olla yhtä ison koneen kanssa ja kiskoa ihmisiä ja tavaroita pitkin raiteita .	minua	1	Par
Mistähän sitä aloittaisi ?	Mistähän	0	Ela
asunto , jota tarjotaan vuokralle	jota	2	Par
Sama terminologia on periytynyt monien muidenkin kielten kielioppeihin .	muidenkin	5	Gen
kuka tahansa voi tilata sähkönsä keneltä tahtoo .	keneltä	5	Abl
Tuossa ledinäytössä on 16 liitäntää , mutta käytän niistä vain yhdeksää .	Tuossa	0	Ine
Perryn mietintö antaakin viimevuotisen Gutiérrez Díazin ja vuoden 1995 Kuhnin mietintöjen jälkeen todellista syvyyttä tälle vetoomusvaliokunnalle .	tälle	14	All
Pyydä sitä avaamaan kaappinsa , tai onhan sinulla itselläsikin avain kaikkiin kaappeihin .	itselläsikin	8	Ade
Koko päivän ajan omatuntoni ruoskii minua käsiin levinneistä aikatauluista , koulutöiden aloittamisen siirtämisestä ja muusta yleisestä saamattomuudesta .	minua	5	Par
Verkkojen luona , joita on vedessä 261 kappaletta , on tehtävä ensin puoli tuntia lapiotöitä ennen kuin pääsee tuuratöihin .	joita	3	Par
Yhdistynyt Eurooppa on kaikkien eurooppalaisten koti , myös niiden , jotka eivät vielä tänään kuulu unioniimme , mutta jotka haluavat olla mukana työssä yhdistyneen Euroopan hyväksi .	jotka	10	Nom
Komissio edistää ja tukee jäsenvaltioiden pyrkimyksiä , jotka liittyvät työllisyyteen , sosiaaliasioihin sekä miesten ja naisten yhtäläisiin mahdollisuuksiin .	jotka	7	Nom
Itsensä helliminen on aikamme harraste .	Itsensä	0	Gen
Kyl niilki on varmaa oikee kello , ja jos se on eri ajassa ku tää , ni minkä mä sille voin ?	niilki	1	Ade
Sinähän joit sitä aika paljon viime keväänä ?	Sinähän	0	Nom
Se ketä ei tästä pidä ei ymmärrä hyvästä elokuvasta yhtään mitään	tästä	3	Ela
Niihin tumma sointuisi kuin luonnostaan – tumma tukka , marmorinvaalea iho .	Niihin	0	Ill
Toisilleen he eivät asiaa kertoneet .	he	1	Nom
ton Lauran näinkin sillon sillon Pirjon häissä kun olin kuokkimassa kirkossa .	ton	0	Gen
Linnulla oli paksu harmaa höyhenpeite , kiivaasti tykyttävä rinta sekä nappisilmät , jotka nyt rellottivat kiinni .	jotka	12	Nom
g ) ' Montrealin yleissopimuksella ' tarkoitetaan Montrealissa 28 päivänä toukokuuta 1999 allekirjoitettua eräiden kansainvälistä ilmakuljetusta koskevien sääntöjen yhtenäistämisestä tehtyä yleissopimusta .	eräiden	13	Gen
Sinä olit kuultavana .	Sinä	0	Nom
Mut sillo oli jo pikkujoulut justtii et mihkään ei tainnu päästäkkää .	mihkään	7	Ill
6 ) jäsenvaltioilla on yksinomainen toimivalta yleisen järjestyksen ylläpitämisessä ja sisäisen turvallisuuden varmistamisessa sekä sen määrittelemisessä , mitkä toimenpiteet kussakin tilanteessa ja vaiheessa ovat välttämättömiä ja suhteellisia tavaroiden vapaan liikkuvuuden edistämiseksi alueellaan ,	kussakin	19	Ine
Reitesi lepää omieni päällä ja ihosi pinnalla oleva nukka on herkintä , mitä sinussa on .	sinussa	13	Ine
Kun joltakulta otetaan pois toivo , viedään samalla hänen rationaalisuutensa , Alony sanoo .	joltakulta	1	Abl
jokaiseen nakkiin meni 2 siivua pekonia , joten aika tuhtia syötävää olivat , vaan hyviä .	jokaiseen	0	Ill
Adoptiovanhemmiksi eivät käy ketkä hyvänsä	ketkä	3	Nom
Muutoksia perustellaan tarpeella pienentää maasta toiseen leviävien kriisien todennäköisyyttä .	toiseen	5	Ill
- ( PT ) Euroopan parlamentin hyväksymässä päätöslauselmassa otetaan esiin huolenaiheita , joista olemme samaa mieltä , ja esitetään ehdotuksia , joita kannatamme , vaikka olemmekin joistakin kohdista eri mieltä .	joistakin	26	Ela
On löytynyt uusia kantoja , joihin penisilliinit eivät pure .	joihin	5	Ill
Miltähän tuntuisi jos olisi siivooja .	Miltähän	0	Abl
Kummallakin oli ase kädessään .	Kummallakin	0	Ade
Huomasin Jussin tulleen ulos päärakennuksesta , huikkasin sille että menis Mollan toiselle puolelle hiljaa kiertäen , mutta se tyhmä juoksi suoraan mun luo ja alko meuhkaamaan että mitä mä tällä ilmalla teen näin kaukana meidän tilalta .	toiselle	11	All
Pelin idea taisi jäädä siihen osallistuneillekin hieman arvoitukseksi .	siihen	4	Ill
Hän tiesi kaikkien kutsuvan sitä kaljamahaksi , joten hän antoi mennä .	kaikkien	2	Gen
Joidenkin ehdokkaiden kotisivuna on puolueen kotisivu , joillakin oli facebookin etusivu , joillakin wordpressin etusivu .	joillakin	7	Ade
Kääpiäinen oli tylsistynyt , se oli päässyt tai joutunut eläkkeelle , en käsittänyt kumpaa .	kumpaa	13	Par
Teetin työn toisilla	toisilla	2	Ade
Mikäli häpeä , estot ja oma kontrollointi estävät meiltä tämän nautinnon , vaikuttaa se kaikkeen muuhunkin elämässämme .	muuhunkin	15	Ill
Otaniemen säätila takasi kostean olon myös holittomalle osalle festiväkeä , jota vahvisti kuraisella ruohikolla pelattu parijalkapallo .	jota	10	Par
Sulle ei yhtää kamppaari maistus .	Sulle	0	All
Koska suurin osa työntekijöistä tekee enimmät duuninsa asiakkaiden tiloissa , ei juuri kenelläkään toimitusjohtajaa lukuun ottamatta ole omaa toimistoa .	kenelläkään	12	Ade
Tiina sano että tilloo hänellenni semmonen , semmonen pakki mitä- millä nuotiolla keitettää .	hänellenni	4	All
Taustalla voi selvästi nähdä vetoomuksen " meille kannattaa tulla , meillä et saastuta luontoa " .	meille	6	All
Suomen ja Kiinan kahdenvälinen kauppa on hyvä esimerkki siitä , kuinka kaksi toisiaan täydentävää taloutta voi hyötyä toinen toisestaan .	toisestaan	18	Ela
b ) ' yhteisön lentoliikenteen harjoittajalla ' tarkoitetaan lentoliikenteen harjoittajaa , jolla on asetuksen ( ETY ) N:o 2407/92 säännösten mukainen jäsenvaltion myöntämä voimassa oleva liikennelupa ;	jolla	11	Ade
Onko kellään kokemusta alueelta ?	kellään	1	Ade
Meistä yli kolmekymppisistä monet ovat päässeet kiinni " kunnon kansalaisen " elämään : työ , perhe ja oma koti .	Meistä	0	Ela
Näyttöä demokratisoitumisesta saadaan ensi kesän paikallisneuvostojen vaaleissa , joihin on tulossa useampia ehdokkaita .	joihin	8	Ill
Heille annettiin itselleenkin tunnustusta .	itselleenkin	2	All
Päinvastoin , määrittelen itsenikin ensisijaisesti ammattinimikkeeni perusteella .	itsenikin	3	Gen
Älä tee sitäkään .	sitäkään	2	Par
Toisilla taas vähän lyhyempi .	Toisilla	0	Ade
Saimme heiltä sähkeen hääpäivänä , ja myös äidiltä ja siskoilta tuli sähke .	heiltä	1	Abl
Selvät ja fiksut pukevat muutenkin liivit päälleen , mutta moniko humalapäissään muistaa ne ?	moniko	9	Nom
Tasavallan presidentin virka-asunto Mäntyniemi tarjoaa yllätyksen toisensa jälkeen .	toisensa	6	Gen
EU:n ja Tunisian assosiaationeuvosto , joka ottaa huomioon Euroopan yhteisöjen ja niiden jäsenvaltioiden sekä Tunisian tasavallan välisestä assosiaatiosta tehdyn Euro–Välimeri-sopimuksen , sekä katsoo seuraavaa :	niiden	11	Gen
Aho ei suostunut sanomaan , kenet pankin johdosta pitäisi erottaa .	kenet	5	Acc
Päävalmentaja ilmaisee asian näin : " Jani tekee mitä haluaa , muut mitä osaavat . "	muut	11	Nom
meiltä meni vähän yli kolme tuntia ennen kuin löysimme hänet .	meiltä	0	Abl
Kullakin jäsenvaltiolla on oikeus jättää tämän asetuksen soveltamisalan ulkopuolelle sellaiset tavarakuljetukseen tarkoitetut tieliikenteen moottoriajoneuvot , joiden hyötykuorma tai suurin sallittu massa kuormattuna on tiettyä rajoitusta pienempi .	Kullakin	0	Ade
Näiden kokousten perusteella komissio päätteli , että vaikka joistakin artikloista vaikuttaisi aiheutuvan ongelmia , ongelmat eivät koske kaikkia jäsenvaltioita .	joistakin	8	Ela
Mikäs meidän muumien on täällä elellessä .	Mikäs	0	Nom
Seminaari antoi kuulijoille hyvän käsityksen siitä , mihin kaikkeen Linux nykyään kykenee ja missä sitä käytetään kaupallisesti .	kaikkeen	8	Ill
Tuolla tavalla olisi meistäkin tullut kuuluisia .	meistäkin	3	Ela
Näin lehdessä ilmoituksen , jolla etsittiin tutkimushenkilöitä Alzheimer-projektiin jollekin Turun yliopiston laitokselle .	jollekin	8	All
Näille viidelle ojennettiin kullekin salmiakkia .	Näille	0	All
Saatteks te selvää tästä ?	tästä	3	Ela
Kuka tuo Virosta ikkunat , ketä tekee ite .	ite	7	Nom
Tuskin kukaan voi vakavissaan väittää , että tilanne olisi enää vuonna 1993 tullut kenelläkään yllättäen .	kenelläkään	13	Ade
Ennen kaikkea oliko hän varmasti tietoinen mitä teki muille .	muille	8	All
Kenellä on paras valmennusjärjestelmä , menestyy .	Kenellä	0	Ade
Voi että tulispa niit lisää ,	niit	3	Par
Jos sana on vanhentunut , leikillinen tai halventava , milloin se on mitäkin niistä ?	mitäkin	12	Par
Samoin , jos jaksaisin , luultavasti muistaisin mistä sen ostin .	mistä	7	Ela
Kaikista mieluiten olisin viettänyt päiväni makuupussissa , mutta kun siinä on hieman vaikea kävellä . ;)	Kaikista	0	Ela
Itselleen se tömäytti myös .	Itselleen	0	All
Antaako taloudellinen riippumattomuutemme Neuvostoliitosta meille aikaisempaa vapaammat kädet ja miten EY-maiden mahdollisesti aggressiiviseksikin muotoutuva idänpolitiikka meihin vaikuttaa , ovat avainkysymyksiä .	meihin	15	Ill
Näiden unelmien sivussa , lukion viimeisenä vuotena kaikuisi käytävillä tämä suru-uutinen ; hän oli vienyt henken itseltään , ei kestänyt yksinäisyyttä ja masennusta enää , ja stressi ylioppilaskokeista oli laukaissut tämän vyyhdin pillereiden avulla .	itseltään	16	Abl
Näytössä on molemmissa numeroissa 7 eri osaa , joissa jokaiselle on oma ledi .	jokaiselle	9	All
Annammeko tämän jatkua sanomatta mitään ?	mitään	4	Par
Lisättäköön tähän , että itse asiassa M45 eli Plejadit ( Seulaset ) ovat kirkkain syvän taivaan kohde ( avoin tähtijoukko ) , mutta tähän aikaan en siitä ollut tietoinen .	tähän	1	Ill
Vaihtoehdot ovat Katilla kovin harvassa .	harvassa	4	Ine
Toisessa kuvassa lapset pärskivät vettä toistensa päälle nauraen .	Toisessa	0	Ine
Miltäpä kuulostaisi esimerkiksi italian kielikurssi Italian Salernossa ?	Miltäpä	0	Abl
Ensimmäisen sukupolven Agila oli uudelleen nimetty versio Suzuki Wagon R:stä , jota valmistettiin Japanissa .	jota	11	Par
Tälle paperille painetaan mm. tehtaan toisen omistajan , New York Timesin viikonloppuliite	Tälle	0	All
Minun on sääli häntä .	häntä	3	Par
Meistä voi tulla	Meistä	0	Ela
Hänessä on jotain outoa .	Hänessä	0	Ine
Muutamat jäsenvaltiot näyttävät tulleen neuvotteluihin mukanaan kirjekuori , jossa on muutamia laskelmia , ja kieltäytyneen tekemästä minkäänlaisia myönnytyksiä asettaakseen itselleen realistiset tavoitteet .	Muutamat	0	Nom
Hän on vuosilomalla , ja minun ymmärtääkseni vielä jossain etelässä .	minun	5	Gen
Hän haukkui miehiä siihen malliin , että välillä tuntui olevan syytetyn penkillä kaikkien feministien huohottaessa niskaan .	kaikkien	12	Gen
Ei sen puoleen , etteikö minulla olisi ollut omia näkemyksiä .	minulla	5	Ade
ku mä kävin neuvonnast kysyy ni se sano et kysy tolta	tolta	10	Abl
Siitä vain läksyjä lukemaan .	Siitä	0	Ela
Hyvinvointi on sittenkin aika paljon itsestä kiinni , Rauramo pohtii .	itsestä	5	Ela
Molemmat emot huolehtivat poikasista , jotka ovat pesäpakoisia .	jotka	5	Nom
mihil lien ne myyjät männy	mihil	0	Ill
Millä te Australiassa eläisitte ?	Millä	0	Ade
Toisilleen he eivät asiaa kertoneet .	Toisilleen	0	All
toisen pääl ei voi nukkuu ollenkaa ku se pitää nii kauheeta metelii	toisen	0	Gen
Emme voi sysätä vastuutamme muille , sillä asettuessaan ehdokkaaksi Euroopan parlamenttivaaleissa jokainen meistä otti tehtävänsä vapaaehtoisesti vastaan .	muille	4	All
Robert I osallistui veljensä Ludvigin seurassa seitsemännelle ristiretkelle ja sai surmansa eräässä hyökkäyksessa Mansourahin linnoitusta vastaan vuonna 1250 .	eräässä	11	Ine
Meillä oli loukkaantuneita pelaajia ja moni ajatteli vain omaa tulevaisuuttaan pelaajana tässäkin turnauksessa .	tässäkin	11	Ine
Ja mikäs on silloin tällöin matkustaessa , kun on löytänyt rinnalleen miehen , joka antaa vaimolleen runsaasti vapautta .	mikäs	1	Nom
Sit meil oli kauheen mukavaa .	meil	1	Ade
Kyllä se hyvin meni , vaikka kyllä aina laulaa hiljempaa kun muut kuuntelee takana .	muut	11	Nom
En usko , että kenelläkään oli mielessä 2-1 maalin jälkeen , että matsi oli selvä .	kenelläkään	4	Ade
Me laskimme ne vieressä kuohuvaan koskeen , josta uskoin niiden matkaavan aina maailman ääriin asti .	Me	0	Nom
eikä hän pitäisi pahana vaikka omatkin lapset tekisivät saman valinnan .	saman	8	Gen
Kenen kanssa sä olet ?	Kenen	0	Gen
Ensinnäkin kansallisten yhteyspisteiden oikeudellisessa asemassa ja erikoistumisaloissa ja niiden käyttöön annetuissa henkilöstö- ja rahoitusresursseissa sekä teknisissä laitteissa esiintyy huomattavaa kirjavuutta , joten yhteyspisteiden sitoutumisasteet ovat myös erilaisia .	niiden	8	Gen
Käännyin takaisin sinne mistä olin tullut , ja huomasin toisessakin päässä , ettei sielläkään ollut ovea .	toisessakin	9	Ine
Sinähän osaat jo sen ulkoa .	Sinähän	0	Nom
Häntä kuulusteltiin sisäpiiritiedon väärinkäytöstä Saunalahden osakkeilla vuonna 2005 .	Häntä	0	Par
Täytyy osaa eka tulkita sitä oikein et voi tajuu mist on kyse .	mist	9	Ela
Komissio on ehdottanut , että tähän uuteen asetukseen sisällytettäisiin useita ehdotuksia , joilla muutettaisiin huomattavasti voimassa olevaa aikaisempaa asetusta .	tähän	5	Ill
Olisin erittäin tyytyväinen , jos saisimme täällä aikaan uuden arvion , jossa tuotaisiin esiin paljon enemmän kuin vain ne asiat , joita olemme käsitelleet tähän mennessä .	tähän	24	Ill
Miksi emme hae itsellemme sitä nautintoa , jota kaipaamme ?	itsellemme	3	All
Haluan myös antaa hänelle tunnustusta siitä tehokkaasta tavasta , jolla hän on etsinyt teollisuuden mielipiteitä ja myös ottanut niistä vaikutteita , mikä on mielestäni järkevää .	hänelle	3	All
Sen sijaan ruohonpäristäjän merkitystä ei olekaan enää niin helppo arvata .	Sen	0	Gen
Ensimmäinen autolasti saapui oikeaoppisesti ajoissa paikalle , mutta sai odottaa toista , jonka navigaattori ei ollut aivan ammattitasoa .	toista	10	Par
Minun täytyy mennä	Minun	0	Gen
Mitäpä se mulle kuuluu .	Mitäpä	0	Par
Yhtäkään ei jäänyt myymättä , halvin maksoi 16_000 mk plus alv:n .	Yhtäkään	0	Par
Outokummun Magnets Oy:llä on ollut enemmän tilauksia kuin tehdas on voinut ottaa vastaan tähän mennessä .	tähän	13	Ill
Sinäpä sen sanoit .	Sinäpä	0	Nom
Sulla ittelläs mittään olluk kus sä tähän tulit .	mittään	2	Par
Hyvin harvat ovat kiinnostuneita hänen teoriastaan .	harvat	1	Nom
Ymmärsin hyvin häne näkökulman , varsinkin kun ite saatoin karannutta lehmää mutaisissa saappaissa , joiden käytöstä yhteiseksi hyödyksi minua luultavasti jopa nuhdeltaisiin .	häne	2	Gen
Jossaki vaiheessa sillon ku ma olin kansakoulussa ni , sekä muv veljeni että minä nin , meill oli , koulum puolesta semmonen , me osallistuttiin semmoseen koulupuutarhahommaan ,	meill	16	Ade
Miksi pitää kiinni kenestäkään , kun myöhemmin pakotetaan kuitenkin päästämään irti ?	kenestäkään	3	Ela
Valinta miljoonien lauseiden joukosta on minun tekoni .	minun	5	Gen
Pysykää toisistanne erillään .	toisistanne	1	Ela
Mitä sitten mahdolliseen ydinvoiman lisärakentamiseen tulee , viimeisimpien kokemusten läntisestä naapurimaastamme Ruotsista tulisi antaa itse kullekin ajattelemisen aihetta .	kullekin	15	All
Minut valtasi lämmin ja rauhallinen olo .	Minut	0	Acc
( 5 ) toissijaisuusperiaatteen mukaisesti yhteisten tilastostandardien laatiminen yhdenmukaisten tietojen tuottamiseksi on toimintaa , joka voidaan toteuttaa tehokkaasti ainoastaan yhteisötasolla , vaikka tiedot kerätään kussakin jäsenvaltiossa virallisten tilastojen laatimisesta vastaavien virastojen ja laitosten johdolla ,	kussakin	24	Ine
Anja muute kirjotti ni se vaa puhu et hän vois järjestää jotkut pikkujoulut heillä ku hää ei oo koskaa järjestäny mitää pileitä ja hänest ois niiku kivaa niiku sit nähä kaikkia .	heillä	13	Ade
On ensiarvoisen tärkeää , että etiopialaisten odotukset vaalitulosten oikeellisuudesta toteutuvat , ja vaalitarkkailuvaltuuskunta tekee kaikkensa varmistaakseen , että näin tapahtuu .	kaikkensa	14	Gen
Niillä pesii useita lajeja , mm. uhanalaisia kuikkia ja selkälokkeja .	Niillä	0	Ade
À eli à ( a ja gravis ) on ranskankielisestä prepositiosta lainattu tapa merkitä kappalehintaa tai muuta yksikkökohtaisesti laskettavaa ominaisuutta .	muuta	16	Par
Mul on tota nää on ollu kaikki tästä näi mitä nytte mä sain semmosta rasvaa nii nää on ollu kaikki ihan punasena tästä .	Mul	0	Ade
Mullahan oli muuten älyttömän upeet soittajatkin tällä levyllä .	Mullahan	0	Ade
Monille riittää , että jonkin asian takana on gallupin mukaan 51 prosenttia kansalaisista .	Monille	0	All
Lomaa meillä on .	meillä	1	Ade
Jälleen parisataa sivua tarinaa ihmelapsesta , jolla on kympin keskiarvot , joka juoksee rajun jätkän vauhdilla pikamatkoja kuin Zola Budd konsanaan .	jolla	6	Ade
suomalainen graniitti on se perustus , jolta hänen presidentin virka-asuntonsa kohoaa .	jolta	6	Abl
Oli kolmosluokan ensimmäinen päivä , aurinko oli kirkas ja meillä molemmilla oli uudet hienot shortsit ja lenkkarit , niillä olisi hyvä pelata jalkapalloa välitunneilla .	molemmilla	10	Ade
Sanoi : ” olisimme tämänkin matkan hinnalla saaneet käsirahan keskuslukitukseen ” .	tämänkin	4	Gen
Miltähän tuntuisi jos olisi oma siivooja	Miltähän	0	Abl
EU:n kahdenvälisten viisumisopimusten yhtenä tavoitteena on ilman muuta kuitenkin oltava , että helpotetaan kaikkien liikkuvuutta , eikä ainoastaan tiettyjen ryhmien liikkumista .	kaikkien	13	Gen
Liikeniskö teiltä yhtä mankkaa vähäks aikaa ?	teiltä	1	Abl
Niillä on se luulo , ettei niiden tartte maksaa velkojaan eikä mitään .	Niillä	0	Ade
se oli parasta mitä minulle saattoi tapahtua .	minulle	4	All
Jossakin tilaisuudessa oli naisille ja miehille eri kakut , ja miehet saivat kerrankin kokea millaista on olla syrjityssä asemassa .	Jossakin	0	Ine
Sen arvoitukset avautuvat myöhemmin .	Sen	0	Gen
Minun on ikävä häntä .	häntä	3	Par
kuka tahansa voi tilata sähkönsä keneltä tahtoo .	keneltä	5	Abl
Mulla on kylmä	Mulla	0	Ade
Kussakin alakomitean kokouksessa voidaan käsitellä yhtä , useampaa tai kaikkia edellä luetelluista aloista .	Kussakin	0	Ine
Siit mun piti sulle sanookki et me otettiin se .	Siit	0	Ela
Häntä ilahdutti erityisesti ajeluun osallistunut Volvo BV 544 , jollaisen hän itse oli omistanut 50-luvulla .	Häntä	0	Par
Mut et sellaist ihmisist mist sä näät niinku et , et ne tykkää susta ni sellasten kanssa on hirvee helppo olla	mist	4	Ela
Teille olisi puhelu .	Teille	0	All
Teen näin varmistaakseni sen , ettei Euroopan unionin tarvitse puuttua asioihin seuraavan kerran , kun jollakin suurella eurooppalaisella joella tapahtuu onnettomuus , koska näin voi tapahtua , ellemme laajenna kuluttajansuojalainsäädäntöä koskemaan myös tätä alaa .	jollakin	15	Ade
Eikä hänen pitäisi verrata tätä turhautumisen tunnetta siihen , jota hän tuntee seistessään lähellä rakastaan , mutta hän tekee niin .	jota	9	Par
Kolmanneksi komissio on suhtautunut täysin välinpitämättömästi näiden ihmisten ahdinkoon .	näiden	6	Gen
Säädökset kieltävät meiltä asiaan puuttumisen	meiltä	2	Abl
Mieliala kohoaa , päivävireys paranee ja koko olo kohentuu , joiltakin katoavat kesäksi kilotkin .	joiltakin	10	Abl
a ) aiheuttaa konkreettisesti tai muulla tavalla vakavaa häiriötä tavaroiden vapaalle liikkuvuudelle estämällä , viivyttämällä tai hankaloittamalla niiden tuontia jäsenvaltioon , niiden vientiä jäsenvaltiosta tai niiden kuljettamista jäsenvaltion kautta ,	muulla	5	Ade
Ei mutta kato että eihän se nyt sua nyt aivan huali näännyttää yhtä ihmistä .	sua	7	Par
" Requiem " on siitä erikoinen , että Tabucchi on tehnyt sen portugaliksi ( 1991 ) ja käännättänyt muilla italiaksi ( 1992 ) .	muilla	18	Ade
Joku kaunis päivä , ehkä päivä 76 tai 93 , hän pyytää sinua ystäväksi ja suostut , odotat häntä aina koneella ja keksit etukäteen mitä sanoisit hänelle .	sinua	12	Par
Vapautusta edeltäneinä kuukausina hän eli väärän nimen turvin eräässä eteläisen Belgian pienessä kylässä .	eräässä	8	Ine
Avauspäivän toritapahtumaan oli leivottu maailman suurin karjalanpiirakka , jolla oli mittaa 45 metriä .	jolla	8	Ade
Koirat antavat itsestään vieraalle varsin susimaisen vaikutelman kiiluvine silmineen .	itsestään	2	Ela
investointi maksaa itsensä takaisin	itsensä	2	Gen
Mitä aiot tehdä ?	Mitä	0	Par
Sitäkin on sopiva hetki miettiä , miten me kehitämme edunvalvontaamme .	Sitäkin	0	Par
Kansliapäällikkö halveksi miestä koko loppuikänsä luonnehtien häntä kansliapäällikköaikansa tyhmimmäksi oikeusministeriksi .	häntä	6	Par
Eikä tänään must ollu niin hirvittävän kuumaa ku -- ainakaan nyt illalla	must	2	Ela
Niillä on se luulo , ettei niiden tartte maksaa velkojaan eikä mitään .	niiden	6	Gen
Itse tehty jäätelö ei välttämättä tule halvemmaksi kuin ostettu , mutta siihen saa taatusti mieleisensä maut .	siihen	11	Ill
Hyvinvointi on sittenkin aika paljon itsestä kiinni , Rauramo pohtii .	itsestä	5	Ela
Siitäkin huomasi , että hän ei ollut tosi mies .	Siitäkin	0	Ela
Perustetaan kansallisia ohjelmia , joilla kaksisuuntainen lähestymistapa pannaan täytäntöön	joilla	4	Ade
Uniaika on läsnä joka hetki : se on täysin toinen todellisuuden taso , joka on olemassa limittäin ihmisten kosmoksen kanssa .	toinen	9	Nom
minun ansiostani nämä kissat elävät .	minun	0	Gen
Hän kätteli minut	minut	2	Acc
Jonkun täytyi rikkoa ne , että ihmiset osaisivat elää , koska se taito on täysin unohtunut .	Jonkun	0	Gen
Alue oli Palestiinan arabien asuttama , ja nämä ajettiin käydyssä sodassa pois kodeistaan .	nämä	7	Nom
oltais haluttuk kammatakkim poikaa mut poika ei siitäkään tykänny .	siitäkään	7	Ela
Miksi niin moni mies kertoo , kuinka ” se makasi kuin lahna , ei koskettanut minun kalua tai mitään muutakaan paikkaa , se odotti vain valmista , ei edes suudellut ” .	minun	15	Gen
Tämäkin päätellään nokkelasti − teatteri .	Tämäkin	0	Nom
Jeltsinin uusi arvovalta tuli näkyviin tavasta , jolla hän pani järjestykseen kokousta alkupäivät johtaneen Vitali Kazakovin .	jolla	7	Ade
Varkaat ovat niin taitavia , etteivät uhrit useinkaan edes huomaa , kun heiltä häviää pankkikortti automaatilla asioinnin yhteydessä .	heiltä	12	Abl
Joskin tässä suhteessa lienee osuvampaa verrata valtakuntaa siihen ujoon serkkuun , joka jokaisessa sukujuhlassa mielellään ei nosta itsestään metakkaa ja joutuu myös hintelyytensä vuoksi aina istumaan nurkkapöydässä .	jokaisessa	12	Ine
Nimeä kysytään , koska jos jollekin käy huonosti , silminnäkijältä saatetaan tarvita tietoja siitä , mitä todella tapahtui .	jollekin	5	All
Joitakin kontakteja ei edes saa ilman tätä .	Joitakin	0	Par
Siitäpä olenkin ylpeä .	Siitäpä	0	Ela
Niillä menee läpi sit tälläset niinku tää hymy et sä oot nii valoinen- valoisa ja myönteinen ja hymyilevä kyl sä varmasti onnistut ja muuta ni ni mä sanoin omalla kohdalla et kylhän sä hymyilet ihan nätisti mutta .	Niillä	0	Ade
Meistä tulee onnellisia .	Meistä	0	Ela
Tuostahan voi saada vaikka minkälaisen taudin .	Tuostahan	0	Ela
Heille itselleen taputettiin .	Heille	0	All
Meille tuodaan - joskin myös meiltä viedään - ulkomailta uutta lehmäainesta .	meiltä	5	Abl
Kokonaan toinen kysymys on , teenkö enää koskaan elokuvia , ja siihen kysymykseen minulla ei ole vastausta .	toinen	1	Nom
Jokaisessa diktatuurissa syntyy kuitenkin kapina , koska kansalaiset alkavat aina jossain vaiheessa vaatia vapauksia .	Jokaisessa	0	Ine
Mitä se tarkottaa ? ”	Mitä	0	Par
Sinua etsii vaalea , symppis , 28v , omillaan toimeentuleva yh-äiti	Sinua	0	Par
Osasyynä tähän(kin) opetteluun on ollut laiskuus eli mukavuudenhalu ; en jaksanut kohdistaa putkea muutaman tunnin havainnoinnin ajaksi , vaan mielummin etsin kohteet manuaalisesti .	tähän(kin)	1	Ill
Komission ja parlamentin välillä oli kiistaa , montako erityisdirektiiviä tulisi ottaa mukaan .	montako	7	Nom
Nuo viivästykset ja valitukset huolestuttivat kansalaisia ja johtivat kesäkuun 6. , 7. ja 8. päivän traagisiin tapahtumiin , joihin vaalitarkkailuvaltuuskunta otti heti julkisesti kantaa .	joihin	18	Ill
Sitä paitsi voin vielä tunnustaa , että en minä sitä ensimmäisellä kerralla huomannut vaan minulle huomautettiin siitä	minulle	14	All
Piste suureni suurenemistaan ja lopulta vanhus sai vanhoilla silmillään selkoa , mistä oli kyse .	mistä	11	Ela
Sinulle tämä on tärkeä tilaisuus , minulle se on ainoa .	Sinulle	0	All
Jos yhteisön ulkopuoliset lentoliikenteen harjoittajat huolehtivat kaikista kuljetuksista , 1 ja 2 kohtaa sovelletaan vain yhteisöön , yhteisöstä tai sen sisällä tehtäviin kuljetuksiin . "	kaikista	6	Ela
Ari : Mä ajattelenki just niitä ihmisiä ketkä on niinku ihan normaalilinjoilla liikkuu .	ketkä	7	Nom
Muutamat henkilöt edistivät projektia sovittamalla Vimin muun muassa UNIXille ja DOSille .	Muutamat	0	Nom
He seisoivat eteisessä kasvokkain .	He	0	Nom
Heidät lakaisi syrjemmälle vaatimus , että aktiivipoliitikkoa ei voi valita korkeaan , vallankäyttöä valvovaan virkaan .	Heidät	0	Acc
Ei kenelläkään muulla ole sellaista nenää kuin minulla .	muulla	2	Ade
Se oli kuitenkin lähellä Järntorgetia , rauta- ja kuparikaupan keskusta eikä Mårten halunnut muuttaa sieltä muualle , vaikka hänellä olisikin pian varaa rakennuttaa itselleen kartano Tukholman liepeille .	itselleen	23	All
Ka niin kyllä myö on huomennakki on ajateltu että lähettään jonnekki ajeleksimmaan kahtelemmaan varsinni jos tämmönen keli on ni ,	myö	3	Nom
Joille tämä ei sovi , voivat perua tai lykätä matkansa .	Joille	0	All
Niitä tarkistuksia , joilla mahdollisuuksia itsekäsittelyyn rajoitetaan monella tavalla muun muassa niin , että oikeus itsekäsittelyyn rajoitetaan koskemaan ainoastaan merellä työskentelevää henkilökuntaa , ei voida hyväksyä .	monella	7	Ade
Myymistä se on itsensäkin myyminen ; oikeastaan se vasta myymistä onkin !	itsensäkin	3	Gen
EU:n naapurimaille on tehtävä selväksi , millaiset edellytykset niiden on täytettävä , jotta viisumimenettelyjä ensiksikin aidosti yksinkertaistetaan ja toiseksi jotta pakollisesta viisumivaatimuksesta jonakin päivänä luovutaan .	niiden	8	Gen
Yhtä säännöllisiä olivat nämä kävelyt lähemmäksi merta ja vasta perillä ymmärsin , miksi olin tullut .	nämä	3	Nom
Vuonna 2006 järjestettävässä ensimmäisessä kokouksessa on tarkoitus keskustella lisää eräistä asioista , jotka on jäsenvaltioiden täytäntöönpanotoimien arvioinnin yhteydessä todettu ongelmallisiksi ja olennaisen tärkeiksi .	eräistä	9	Ela
Mulla on kylmä	Mulla	0	Ade
- Mulla on sauna varattuna .	Mulla	1	Ade
Pakko alkaa lukemaan ranskankielisiä lehtiä ja kirjoja ja mentävä jollekin kurssille syksyllä , oli sen verran traumaattinen kokemus toi kielen unohtaminen .	jollekin	9	All
Meiltä unohtui eväät .	Meiltä	0	Abl
Teillä onkin edessä sellainen remontti , että itku vielä pääsee , mies naurahteli .	Teillä	0	Ade
Minä olinkin koneessa näkevinäni hänet , mutta en luottanut silmiini ...	hänet	4	Acc
No niin , tästäkin päivästä tuli rajoittunut , sillä jalkaani vihloo aivan jatkuvalla syötöllä .	tästäkin	3	Ela
Vieressä kuuluisi olla käsivarsi tai edes selkä , mutta ei , se on taas missälieneejossain ylitöissä .	missälieneejossain	14	Ine
Siin o varmaa joku puoltoisttonnii on vuokra sit siinä .	Siin	0	Ine
Lähdin etsimään ihmisiä tuolta asemalta , jos vaikka joku voisi auttaa .	tuolta	3	Abl
Tämä on elämäni pohjanoteeraus .	Tämä	0	Nom
prosessivertaus nyt ei aivan täsmälleen siihen tietysti sovi mutta mutta saman tyyppisiä elementtejä siinä on materiaalihankintaa ö asian tutkimista päätöstä siitä että tälläiseen työhön ryhtyy ja ja sitten sen toteuttaminen mh määrätyssä aikataulussa jonka on itsellensä mhh luonut	itsellensä	35	All
Mitäs me noille laulettas ?	noille	2	All
Kenenkään ei ole pakko ostaa kyseisiä elintarvikkeita , mutta me uskomme , että niille ihmisille , jotka niitä haluavat ostaa , tulisi myös antaa mahdollisuus saada runsaasti tietoa aiheesta .	Kenenkään	0	Gen
Kukakohan sen sanoi ?	Kukakohan	0	Nom
Kenen avulla he käyvät sotaa ?	Kenen	0	Gen
Mutta meillä naisilla on myös vastuu – vastuu pukeutua hyvännäköisesti ja huolitella itsemme niin , että tunnemme itsemme kauniiksi ja seksikkääksi .	itsemme	17	Gen
Mille Kari nauraa ?	Mille	0	All
Euroopassa , joka on olevinaan sosiaalinen , tuomitsemme myös komission kyynisyyden , joka on ajanut nämä työntekijät suuriin vaikeuksiin – työntekijät , joista eräät ovat lastensa pääasiallisia elättäjiä ja joista monet ovat naisia .	monet	30	Nom
tästäkin huolimatta laitan näiden kuvan tänne ja suosituksen kokeilla .	tästäkin	0	Ela
Elokuvia heiltä syntyi peräti 1480 kappaletta .	heiltä	1	Abl
Gorgon on sirkustaiteilija jo ties kuinka monennessa polvessa	monennessa	6	Ine
Joidenkin mielestä sen pitäisi kuitenkin tapahtua muuttamalla jo olemassa olevan joukkueen kotipaikkaa uuden seuran perustamisen sijaan .	Joidenkin	0	Gen
Nää vissii jää nää kuvat tänne	Nää	0	Nom
Joidenkin tarkistusten tarkoituksena näyttää kuitenkin olevan niiden toimien hidastaminen tai jopa lopettaminen , jotka on toteutettu Euroopan satamien toiminnan vireyttämiseksi ja , kuten aiemmin mainitsin , sekä vientiämme muualle maailmaan helpottavan pitkänmatkan meriliikenteen mahdollisuuksien että lyhyenmatkan meriliikenteen parantamiseksi .	niiden	6	Gen
Noita oli aikalailla 200 kassia !	Noita	0	Par
Elikkä , onks teil se hakemus täytetty sitte jo	teil	3	Ade
Näissä vasemmisto piti hallussaan 51 departementtia 101:sta , ja vahvisti näissäkin otettaan .	näissäkin	10	Ine
Muutoksen on lähdettävä meistä itsestämme tai sitten se jää tulematta .	itsestämme	4	Ela
Tuomioistuin voi myös määrätä ehdollisen vankeuden täytäntöönpantavaksi vain osaksi , jolloin rangaistus jää muulta osin ehdolliseksi entisin koeajoin .	muulta	13	Abl
Näyttääkö tuo sinusta tulehtuneelta ?	sinusta	2	Ela
Olisi mukava tietää mihin se pitää viedä , mikäli siihen tulee vika .	mihin	3	Ill
Marko kyseli Twitterissä tuon näytön kytkentöjä , joten piirsin eräälle common cathode-tyyppiselle näytölle sellaiset ( riippuu täysin näytön tyypistä ja valmistajasta ) .	eräälle	9	All
Sä tiedät että mä oon seurannut sua siitä asti kun mä näin sut .	sut	12	Acc
Kenellä on paras valmennusjärjestelmä , menestyy .	Kenellä	0	Ade
Kun on kyse tällaisesta tapauksesta , eli direktiivistä , joka hyväksyttiin - huomatkaa - yksimielisesti , meiltä puuttuu mahdollisuus tarkistaa direktiiviä automaattisesti kymmenen vuoden kuluttua , jos yksi jäsenvaltio sitä pyytää .	meiltä	16	Abl
Minusta tuntuu , että siitä tulee susi	Minusta	0	Ela
Siitä , voidaanko EU:sta erottaa , ei ole olemassa säännöksiä tai sopimuksia .	Siitä	0	Ela
Huoneessaan pieni poika leikki pakonomaisesti leluautoillaan , esitti itselleen ettei mitään ollut tapahtunutkaan , vaikka sen huudon peittämiseksi olisi korvien päälle tarvittu kahdet kädet lisää , ' antakaa minut anteeksi ' .	itselleen	8	All
– Ongelman kärjistymisen voisi monessa tapauksessa välttää tarttumalla härkää sarvista heti , kun ensimmäiset merkit ongelmista ilmenevät .	monessa	4	Ine
Peruskarsinnan jälkeen pidetään välipalaveri ja päätetään ketkä kutsutaan haastatteluun .	ketkä	6	Nom
Vuoden mittaan saattaa tulla ja tuleekin elämään kuuluvia eripuraisuuksia joko syystä tai tyhjästä , mutta jouluna muistetaan kaikki se hyvä , mitä on toisilta saatu .	toisilta	23	Abl
Näistä yksi , siis vain yksi rupesi kasvattamaan itseään kuin kide .	Näistä	0	Ela
Yhtä hankalaa on jäällä nyt kalastajalla itselläänkin .	itselläänkin	6	Ade
Uskoisin , että taso on parempi mitä moni kuvittelee .	moni	7	Nom
Sieltä mistä me kaikki olemme tulleet , sieltä minne me kaikki vielä menemme .	mistä	1	Ela
tästähä ei tuu mitää tästä meijän hyvästelystä	tästähä	0	Ela
Haluan myös onnitella komissiota , koska meillä on nykyään käytettävissämme hyvä ja suorasukainen selvitys vallitsevasta tilanteesta .	meillä	6	Ade
myykö kasvattaja vain raakit ja jättää parhaat lupaukset itselleen ?	itselleen	8	All
Mårten selosti tarkkaan , mihin hintaan Johanin oli myytävä kuparia ja paljonko hän saisi enintään maksaa kuparin toimittajille .	mihin	4	Ill
Asiantuntijamme voivat varmaankin antaa paljon sellaista perustietoutta , joka säästää teiltä aikaa ja rahaa .	teiltä	10	Abl
Kokous voidaan kutsua koolle jommankumman sopimuspuolen pyynnöstä , jonka asianomainen sihteeri toimittaa toiselle sopimuspuolelle .	jommankumman	4	Gen
Kuulkaapa tätä .	tätä	1	Par
ajateltti ett ei sateevarjo kukkaam pitäis siäl .	kukkaam	4	Nom
Aho ei suostunut sanomaan , kenet pankin johdosta pitäisi erottaa .	kenet	5	Acc
Jos nyt Suomen kansa viisaudessaan päättää olla liittymättä tähän me ollaan näin paljon tähän nyt jo satsattu niin kuka tästä sitten vastaa tästä valtavasta katastrofista --	tästä	19	Ela
Kerrottuani tämän tarinan , nostit minut ylös ja halasit lujaa .	minut	5	Acc
Viirupallokala kasvaa luonnossa noin 30 cm pitkäksi , akvaariossa sen koko jää puoleen tästä .	tästä	13	Ela
Muista asiakirjoista käy ilmi täysin tavanomainen kielikoulutuksen suunnittelu ajanjaksolle 2004–2005 , mutta yhtäkkiä , kesäkuussa 2004 , opettajat saivat kuulla äkillisestä irtisanomisestaan .	Muista	0	Ela
Mikäli häpeä , estot ja oma kontrollointi estävät meiltä tämän nautinnon , vaikuttaa se kaikkeen muuhunkin elämässämme .	meiltä	8	Abl
Mistä lie johtuu , mutta Sibelius-viulukilpailun yleisökoostumus ei ole ollut aivan nuorimmasta päästä .	Mistä	0	Ela
Laita lapsi asialle , mene itse perässä	itse	5	Nom
Tää on jotain niin mahtavaa !	Tää	0	Nom
Millä te Australiassa eläisitte ?	Millä	0	Ade
Niillä on se luulo , ettei niiden tartte maksaa velkojaan eikä mitään .	mitään	11	Par
me kirjotettaa että häne joko täytys antaa potkut tälle miehelle tai jos tätä Kivistä ei ole ennemmin näkynä juovuksissa ni lähettää hänet viipymättä kottii	häne	3	Gen
Jos niilt kysyy et ootsä niin kun kavereiden kans ulkona tai jotain nin eiei en mä ehi oikeen kun mä aina har- mä harrastan sitä ja harrastan tätä	niilt	1	Abl
Puhu puhu vaan , ei sinua kukaan usko .	kukaan	6	Nom
Jotkin paikat tuntuivat vaativan hieman lisää työtä .	Jotkin	0	Nom
Se oli sinulta tosi kauniisti tehty ;	sinulta	2	Abl
Mull on niinku iha semmonen fiilis että että että mie haluaisin kyllä yhen kunnon drinkin tänä iltana	Mull	0	Ade
En halua luovuttaa aarteitani jollekin , joka väittää , että ne kuuluvat hänelle , koska hänellä on pitempi nenä tai erimuotoiset sukuelimet .	jollekin	4	All
Hän teki kaiken niin kuin hän oli nähnyt toistenkin tekevän .	toistenkin	8	Gen
- He tulivat synnintuntoon .	He	1	Nom
Noilla kolmella juoksulla Hamina murskasi Haapajärven selkärangan .	Noilla	0	Ade
Kerro Marjut keneltä sä oot saanu tän .	tän	6	Gen
Eile oli kyl must iha älyttömän kuuma .	must	3	Ela
Tässä valtiovalta on pelkästään tarkkailevassa asemassa .	Tässä	0	Ine
Joidenkin ehdokkaiden kotisivuna on puolueen kotisivu , joillakin oli facebookin etusivu , joillakin wordpressin etusivu .	Joidenkin	0	Gen
Haluaisin kysyä teiltä , isiltä ja äideiltä , jotka annatte lapsillenne ilmakivääreitä lahjoiksi , että .	teiltä	2	Abl
( 4 ) Tässä asetuksessa säädetyt toimenpiteet ovat sokerin hallintokomitean lausunnon mukaiset ,	Tässä	3	Ine
Sen tarkoituksena on päästä Guinnesin Ennätyskirjaan suurimmalla joukkutanssilla joka on Michael Jacksonin Thriller .	Sen	0	Gen
Kun tämä kuoli , Bithynian kuningas Nikomedes sekaantui yllättäen valtataisteluun ja julisti tukevansa erästä poikaa , jonka hän väitti olevan kuningas Ariarathes VI:n kolmas poika .	erästä	13	Par
tuntui siltä , että loppukilpailussa voi käydä vaikka kuinka hyvin .	siltä	1	Abl
Näin jääkiekon maailmanmestaruuden ( joita ilmeisesti tulee vain 16 vuoden välein ) ohella on mukava nostaa esiin suomalaisten harrastelijoiden ( tai ei ehkä enää pelkkien harrastelijoiden ) tekemä pioneerityö , jolla he pyrkivät uudistamaan tapaa , jolla elokuvia tehdään .	joita	4	Par
Me kysyttiin , että eikö ole vaarana , että alaikäiset ostavat automaateista kaljaa .	Me	0	Nom
Ehkä juuri dopingin ansiosta ( tai no mistä muustakaan ) aika moni oma joukkueemme putosi jo alussa , jotta pääsi harrastamaan lisää dopingia jonnekin lämpimään .	muustakaan	8	Ela
Mikäs meän oli ollessa .	meän	1	Gen
Minkähän niminen keittiömestari meillä mahtaa silloin juhannuksena olla ?	Minkähän	0	Gen
Mitä henkilötiedoilla tehdään , Veikkaus Oy Ab:n tiedottaja Johanna Seppälä ?	Mitä	0	Par
Tässäkin tilanteessa katsoisin , että laiha sopu oli parempi kuin lakkojen alkaminen , PALTAn varatoimitusjohtaja Harri Hietala kuvailee neuvottelutulosta Ylelle .	Tässäkin	0	Ine
A : Mulla on varmaan lämpöä , taitaa olla flunssa tulossa .	Mulla	2	Ade
No kukas se sieltä tulee ?	kukas	1	Nom
Millä homma saataisiin toimimaan ?	Millä	0	Ade
Kenelle soitat useimmin Suomeen ?	Kenelle	0	All
Mistä tiedetään , paljonko työtä tietty kurssi on opiskelijalta vaatinut ?	Mistä	0	Ela
Kello on joltakulta varastettu .	joltakulta	2	Abl
Linnasta lähetetyt varoitukset otettiin vastaan ensimmäisenä vartiovuorenmäeltä , josta ne välitettiin edelleen kaupunkiin päin .	josta	8	Ela
Niitten jälkeen kävi aikamoinen parku eri puolueissa kuinka meitä kohdeltiin näin , miten tää nyt näin meni , siinä meni meiltä vaalivoitto ja muuta tämmöstä .	Niitten	0	Gen
Kuka tutkii mitä - ja millä hinnalla ?	Kuka	0	Nom
Näistä valitaan finaaliehdokkaat soveltuvuustutkimusta varten , heitä on yleensä kolmesta viiteen .	Näistä	0	Ela
Perehdytän teidät sambaan .	teidät	1	Acc
Sitten se sanoi minulle , että ota Alfas ja mene .	minulle	3	All
Ja juhlavampia , kesäisempiä korkkareita en omistakaan , joten noille toisille oli tilausta .	noille	9	All
Poliisit kertoivat silminnäkijöiden arvioita olevan useampiakin .	useampiakin	5	Par
Meil oli ennen vanhaan taas toi nii olikii velimies ja ja tota noin ni se tuli kerran töistä kotiin Keravalla ja meni pyyhkäs lähikauppaan .	Meil	0	Ade
Täst on patteri loppui .	Täst	0	Ela
Se sanokin että hoida ite lehmäs , ja painu siihen suuntaan missä sanoin sen pyörän olevan .	siihen	9	Ill
Tuo kone , joka sinne oli laskeutunut tuntui olevan syynä siihen , ettei uudessa laajennusosassa toiminut mikään niin kuin olisi pitänyt .	siihen	10	Ill
Heissä on jotakin samaa , terävä lintumainen olemus .	Heissä	0	Ine
Loki osaa kertoa vain sitsien ulkopuolisista tapahtumista , sillä toinen lokikirjamme hävisi sitsien saatossa .	toinen	9	Nom
Näiden lisäksi kiinnostavaa olisi tehdä myös high-speed salamatriggeri ja muutamia muita valokuvaukseen liittyviä sovelluksia .	Näiden	0	Gen
Tämä ei ole vaikuttanut yhdessäkään tapauksessa äänestystulokseen , koska enemmistöt eivät ole muuttuneet .	yhdessäkään	4	Ine
Mitä väliä .	Mitä	0	Par
Joidenkin niistä odotetaan liittyvän EMN:n täysjäseniksi vuonna 2006 .	Joidenkin	0	Gen
Huiput urheilkoot ja heitä seurattakoon .	heitä	3	Par
Kysyn neuvoston puheenjohtajalta , onko hän samaa mieltä kanssani arviossaan , että Kuuban hallituksella on kuljettavana vielä pitkä matka täyttääkseen demokratialausekkeessa edellytetyt velvoitteet niin assosiointisopimusta varten kuin solmiakseen muita siteitä Euroopan unionin kanssa .	samaa	6	Par
Ja juhlavampia , kesäisempiä korkkareita en omistakaan , joten noille toisille oli tilausta .	toisille	10	All
Sen tekee hyvällä autolla neljässä tunnissa .	Sen	0	Gen
Samoihin aikoihin hän valtasi myös rikkauksistaan kuuluisan Kolkhiksen .	Samoihin	0	Ill
Kaikki se puuttuu meiltä .	meiltä	3	Abl
Kirjassa mietitään , millaisia koulutuksellisia ja kasvatuksellisia tarpeita aateluus , pappeus , porvarius ja talonpoikainen maatalous asettivat säätyihin kuuluville ja toisaalta niihin pyrkiville pojille ja tytöille .	niihin	21	Ill
Häntä verrataan Muhammad Aliin .	Häntä	0	Par
Samassa yhteydessä asuinalue purettiin .	Samassa	0	Ine
Ja että yhdestä tukista käytetään aina pareittain tulevat laudat , toinen toiselle ja toinen toiselle puolelle ; siten ne taipuvat samalla tavalla .	toiselle	14	All
Jos minä menisin kysymään joltakin naiselta Espan puistossa , syökö tämä makkaratuotteita usein ja minkä ikäinen hän on , minut vietäisiin mustamaijaan .	minut	19	Acc
Kaikkeen tottuu .	Kaikkeen	0	Ill
Vastahan sinä tulit ja olet pirusti myöhässä .	sinä	1	Nom
Ja että yhdestä tukista käytetään aina pareittain tulevat laudat , toinen toiselle ja toinen toiselle puolelle ; siten ne taipuvat samalla tavalla .	toiselle	14	All
Luennon jälkeinen lounastauko kuluu raivoisaan selviytymistaisteluun Macciavellin keskipäivän jonoviidakossa , ja ruokapöytäkeskustelu pyörii muuan nimeltä mainitsemattoman kahden opintopisteen kurssin aiheuttaman infernaalisen työmäärän ja tästä syntyvän paniikin ympärillä , minkä lisäksi jaamme ahdistuksemme myös ehtimisestä seuraavalle luennolle .	muuan	13	Nom
Muistakaa opiskella , hakea kesätöitä , mutta ehkä ennen kaikkea : pitää huolta toisistanne ja muistaa vaihtaa myös vapaalle ettei opiskelu lehden teeman mukaisesti kävisi liian työstä !	toisistanne	13	Ela
Hän puolustelee eläinten kidutusta sillä , että eläimetkin syövät toisiaan ja tämä on hänen mielestään " jäänyt kettutytöiltä täysin huomiotta " .	toisiaan	9	Par
Ja silloin minä ensimmäistä kertaa kunnolla näen hänet silmissäni .	hänet	7	Acc
Jostain aivokuolleesta syystä jänistän lennokkien keruusta henkilöllisyyteni varjelemiseksi ja lähden paikalta koska en kuulu koko kurssille .	Jostain	0	Ela
Muille ei kukaan ole koskaan voinut siitä puhua .	Muille	0	All
Siellä hän karismallaan sai useita nuoria miehiä kiinnostumaan jesuiittaurasta , minkä lisäksi hänestä itsestään tuli vaikutusvaltainen henkilö Portugalin hovissa .	itsestään	13	Ela
En tuntenut Kostjaa itse asiassa lainkaan , olin tavannut hänet lapsena , mutta hän oli oleskellut miltei koko elämänsä Ranskassa .	itse	3	Nom
Meiltä puuttuu asunnosta hattuhuone .	Meiltä	0	Abl
Jolle Mara jää käteen , on presidentti .	Jolle	0	All
Älä sitten puhu tästä kenellekään .	tästä	3	Ela
tottakai me otamme heitä sitä varten , että heillä olisi mahdollisuus myös urallaan edetä .	heitä	3	Par
- Mitäs tässä .	Mitäs	1	Par
Niin tekis mieli kysyä että kuka sitten tästä vastaa loppujenlopuks .	tästä	7	Ela
Meidät mielletään kuuluvaksi nokialaiseen musiikkielämään .	Meidät	0	Acc
Josta sinä aina sanoit , että Täti Vihreä .	sinä	1	Nom
Useimmat ovat taittelukaavioidensa mukaisia monisteita , mutta joukossa on mitä mielikuvituksellisimpia variaatioita samasta teemasta .	samasta	12	Ela
se ol Hiakal trenkin , ja sanos et se hyppäs yli aeraj ja häm putos sen suust ja häm pääs puuhu ja sit se , ol puuj juures pystös se susi , ja nual vert ko tul häne reirestäs	häm	18	Nom
Meiltä hoituvat isot ja pienet tilaisuudet ammattitaidolla ja kokemuksella	Meiltä	0	Abl
Olin varmasti jättänyt ne siihen , jätän ne aina Nikon viereen .	siihen	4	Ill
Minä en jaksa tätä elämää	Minä	0	Nom
Mulla ei ole mitään päälle pantavaa .	Mulla	0	Ade
Minkä ikänen olit ku alotit lätkän ?	Minkä	0	Gen
Heillä on rahaa vaikka toisille jakaa .	toisille	4	All
Meidän täytyy kannattaa näiden eurooppalaisten oikeutta Euroopan unionin jäsenyyteen heti , kun he täyttävät eurooppalaiset perusvaatimukset .	he	12	Nom
Minä haluan sen kiinni niitten kaikkien naisten takia , mutta en Järven .	Minä	0	Nom
Hitsi et se oli tylyy se ku meil oli : .	meil	7	Ade
He ovat jo hyvissä ajoin päättäneet äänestää , mutta ratkaisevat vasta vaalitaistelun loppusuoralla , ketä .	He	0	Nom
Venäjän pääministeri Vladimir Putin haukkuu Yhdysvaltoja maailmantalouden loiseksi , joka ei elä varojensa mukaan ja siirtää vastuun taakan muille maille .	muille	18	All
Seinät olivat valkoiset , ovet puuta , ja niissä oli kirkkaat kromiset kahvat .	niissä	8	Ine
Loput kaksi liitäntää ovat joko common cathode ( yhteiskatodi ) tai common anode ( yhteisanodi ) tyyppisiä , joista kumpikin on kytketty omalle numerolleen jokaiseen 7:ään osaan .	jokaiseen	24	Ill
– Missä lapset ovat ?	Missä	1	Ine
Esineet , joista emme oikeasti pidä ja joihin emme koskaan koske keräävät pölyn lisäksi negatiivista energiaa .	joista	2	Ela
Johan susta tuli mulle varsinainen riesa !	susta	1	Ela
Jotta ei loukkaisi ketään , tyttö oli hiljaa .	ketään	3	Par
Joka tapauksessa puhun myöhemmin enemmän joistakin tarkistuksista , joissa käsitellään näitä näkökohtia .	joistakin	5	Ela
3 ) Eläinperäisissä elintarvikkeissa olevien eläinlääkejäämien enimmäismääriä vahvistettaessa olisi määriteltävä ne eläinlajit , joissa jäämiä voi esiintyä , sallitut pitoisuudet jokaiselle hoidetusta eläimestä saadulle lihakudokselle ( kohdekudos ) ja jäämien valvonnan kannalta merkityksellisen jäämän luonne ( merkkijäämä ) .	joissa	13	Ine
Mulla olis kaikenlaista juotavaa huoneessani .	Mulla	0	Ade
Eiköhän tuosta meillekin murusia heltiä .	meillekin	2	All
Näistä vahinkokuvista tulee aina todella outoja .	Näistä	0	Ela
se ol Hiakal trenkin , ja sanos et se hyppäs yli aeraj ja häm putos sen suust ja häm pääs puuhu ja sit se , ol puuj juures pystös se susi , ja nual vert ko tul häne reirestäs	häne	37	Gen
Johannan päällä on kirkkaampia värejä kuin mistä hän itse pitää .	mistä	6	Ela
En sanonu Jussille mitään , mielestäni häne käytös tällaisella ilmalla oli ollut hieman törkeetä .	häne	6	Gen
Sekö että istuu autossa tunnin ylimääräistä ?	Sekö	0	Nom
Mihin niitä kelaatteja sitten käytetään ?	Mihin	0	Ill
Kaikkien päät kääntyvät minuun .	minuun	3	Ill
Moitti minua , että so on minun ja palvelusväen vika ko tyär puhhuu ko runsunen jätkä .	so	4	Nom
Säädökset estävät meiltä asiaan puuttumisen	meiltä	2	Abl
Panttila on sen verran kettu mies , ett ei häntä kovin helppo ole ohittaa .	häntä	9	Par
Näin sieltä sinutkin	sinutkin	2	Acc
Kun puhelinkeskustelussa antaa lausuntoja , ei voi välttyä siltä , ett eikö jotakin väärinkäsityksiä syntyisi .	jotakin	12	Par
Sepäs sattui .	Sepäs	0	Nom
Türki ( 1000-luvulta lähtien türkčä tai türk tili , myöhemmin türkī ) on eräiden turkkilaisten kansojen historiallisista kirjakielistä käytetty nimitys .	eräiden	13	Gen
- Ei mulla ole ketään muuta .	mulla	2	Ade
Jotenkin sille kaikelle kiltteydelle ja miellyttämisen halulle on vain niin vaikea laittaa aikuisen nimilappua .	kaikelle	2	All
ei te häirittem meitä vähääkää	te	1	Nom
Tässä Yhdysvaltain eräässä asukasluvultaan pienimmässä osavaltiossa esivaalit järjestetään tulevana tiistaina .	eräässä	2	Ine
Kaisulla on itselläänkin paljon tekemistä .	itselläänkin	2	Ade
Turun yliopiston tuottaa eri alojen asiantuntijoita ja tutkimusta yhteiskunnan jokaiselle sektorille .	jokaiselle	9	All
Olisi mukava tietää mihin se pitää viedä , mikäli siihen tulee vika .	siihen	9	Ill
Silmälasit välähtivät , kun Ilkka poimi jonkin paperin pinosta ja siirsi sen toiseen .	jonkin	6	Gen
Mut sen kerkee koukkaa teilt vielä jos se nyt oli nii et sil ei sit ollu	teilt	4	Abl
Vaadimme , että tiedotusvälineet saavat toimia vapaasti ja että opposition edustajat saavat näkyvyyttä niissä .	niissä	13	Ine
Naisia rangaistiin , joll eivät he synnyttäneet vähintään kolmea lasta .	he	5	Nom
Termi voi olla käytössä myös kiinteistöyhtiöissä , erityisesti jos niihin sovelletaan asunto-osakeyhtiölakia lain tai yhtiöjärjestyksen perusteella .	niihin	9	Ill
Apteekkari suri ainoan ystävänsä , nimismiehen kovaa kohtaloa ja joi itsensä puolessa vuodessa hengiltä .	ainoan	2	Gen
Hän saapui suojatielle , teiden risteykseen ja kuuliaisena poikana katsoi kumpaankin suuntaan liikenteen varalta , vaikka tiesi jollain tasolla ettei sieltä kuitenkaan autoa tulisi .	kumpaankin	10	Ill
Jostain syystä en enää edes muista mistä .	Jostain	0	Ela
Minäkään en pidä siitä , liittomme on vahva .	Minäkään	0	Nom
Jos papereihin on uskomista , niin Reinhold Ryynäsellä kokemusta oli vaikka toisille jakaa .	toisille	11	All
Luennolla olijoita pyydettiin lopulta kutakin poimimaan läheinen lennokki .	kutakin	4	Par
Samassa yhteydessä valitustuomioistuin kaksinkertaisti naisen neljätoista kertaa joukkoraiskanneiden miesten tuomioiden pituudet .	Samassa	0	Ine
Niitä tuntui naurattavan hysteerisesti oma puolivillainen tilansa .	Niitä	0	Par
En käsittänyt syitä tälle lainkaan .	tälle	3	All
Sinähän seuraat täältä saakka asioita .	Sinähän	0	Nom
Se sinun ihmeellinen Lassesi pistää rahasi kurkustaan alas ja juottaa vielä muita naisia .	sinun	1	Gen
Menkäämme itseemme .	itseemme	1	Ill
Hän tarkasteli tutkimuksessaan lasten näkemyksiä hyvästä hoidosta haastattelemalla lapsia , joilla oli kokemuksia sairaalahoidosta .	joilla	10	Ade
Nainen pysähtyi jalkakäytävän reunaan , katsoi kumpaankin suuntaan tielle kuten kuuluukin , toivotti Jalmarille huomenet ja alkoi paukuttaa lautaisia yhteen niin , että hampaista paikat irtoilivat .	kumpaankin	6	Ill
Mikri Vuoma oli tuonu meile hillat , sienet , potut ja poronlihat .	meile	4	All
Nyt tilanne on heidän mukaansa liian usein se , että ensimmäinen yritys viestiä tutkimuksestaan on väitöskirjatiedotteen laatiminen .	heidän	3	Gen
Varsinkin halpatyövomana laittomat siirtolaiset ovat joustava työvoimareservi , jolla ei ole oikeuksia , oli kysymyksessä työturvallisuus , työajat tai palkat .	jolla	8	Ade
Kenelläkään muulla ei ollut lippua kuin minulla .	muulla	1	Ade
Kuka sen on sanonut , että terroristit ovat partaisia , epämääräisen näköisiä nahkatakkimiehiä ?	Kuka	0	Nom
– Me emme ole tehneet sinunkauppoja .	Me	1	Nom
Venäjänhän asioita on jo pitkään hoideltu pikapaikkauksin , presidentin ukaasein , jotka saattavat olla ristiriidassa lain kanssa mutta joilla saadaan lakia nopeammin muutoksia aikaan .	joilla	18	Ade
Ne muutamat joiden suonia verenhimo vielä pakotti , tekivät joitakin laimeita yrityksiä .	muutamat	1	Nom
Etenkin urheilijoiden ravintoa olisi säänneltävä järkevästi , koska tässä on ensiksikin kyse kuluttajan terveydestä - jotta kuluttajaa suojeltaisiin väärien tietojen aiheuttamilta pettymyksiltä ja ennakkoodotuksilta - toiseksi on kyse myös näiden elintarvikkeiden vaikutuksista .	näiden	29	Gen
Mutta on aivan liian myöhäistä ajatella , en voi enää liikkua tästä , en voi muuta kuin odottaa .	muuta	15	Par
Eräät katalonialaiset ja baskiedustajat torjuivat uuden hymnin korostaen , että heidän kansoillaan on jo käytössä omat hymnit .	Eräät	0	Nom
Sinulle , jolta intti on vielä suorittamatta , voin sanoa , että kyllä sen läpi selviää , jos vain on huumorintajua eikä rasita itseään turhilla pohdinnoilla .	jolta	2	Abl
Näille viidelle ojennettiin kullekin salmiakkia .	kullekin	3	All
Miksen minä koskaan tehnyt niin kun olin vielä elossa , kun minulla oli vielä jalat joita heilutella laiturilla , kädet joilla olisin todella koskettanut toista ihmistä ja päästänyt jonkun lähelleni .	joilla	20	Ade
Näin ei ole jokaisessa jäsenvaltiossa , koska eläkkeet kuvastavat erityisiä kulttuurisia ja historiallisia tilanteita .	jokaisessa	3	Ine
Minussa ei ole sijaa arktisuudelle sen paremmin kuin arkisuudellekaan	Minussa	0	Ine
Nyt ku tosta puuttuu tosta komerosta toine ovi ni nyt o vähemmä tilaa työntää kenkiä .	tosta	2	Ela
Sen vuoksi valiokunta päätti esittää tarkistuksia , jotka estävät tällaisen rehujen palauttamisen .	Sen	0	Gen
Sul on vääräs ajas ku se on seis koko ajan . ”	Sul	0	Ade
He aliravitsivat häntä	häntä	2	Par
Joillekin voi tietysti järjestyä palkkaamalla hoitaja kotiin .	Joillekin	0	All
Tarkistussoitto muulle porukalle , jotka olivat heränneet Turussa aamuviideltä ja kömpineet bussiin kuudelta , ja saimme kuulla että yhdeksältä olisi ensimmäinen peli oman joukkueemme , Jyrki Pulliainen ja Takapaksin Palomiehet , osalta .	muulle	1	All
Se ei viitsinyt edes soittaa ovikelloa vaan astui sisään muina miehinä omilla avaimillaan , mikä minusta ei ollut erityisen korrektia .	minusta	15	Ela
Ihmisten mittakaavassa niiden lennolla oli mittaa puoli miljoonaa vuotta .	niiden	2	Gen
Mitä sä olet mieltä siitä asiasta ?	Mitä	0	Par
Sä kysyit mitä kellon on , ja tää on nyt tän verran .	tän	10	Gen
Monet ovat hurmaantuneet tähänkin mennessä .	tähänkin	3	Ill
Tämä on mielenkiintoinen tapaus .	Tämä	0	Nom
Ilpo sormeili rahojaan ja osti harvemman .	harvemman	5	Gen
Yhtä asiaa ihmettelivät muutkin	muutkin	3	Nom
Sinua on hauska kiduttaa , mutta saat syyttää itseäsi .	Sinua	0	Par
Tuo olkikoira , jonka aamulla nimesin Pyroksi , taitaa olla jokin lapsuuden kaipuun ikoni , esine joka linkittää tämän hetken siihen hetkeen , jolloin en tiennyt huomisesta mitään .	siihen	20	Ill
Sinun kanssasi on mukava jutella	Sinun	0	Gen
Kaikissa nykyaikaisissa satamissa pitäisi sallia itsekäsittely , jos se on mahdollista , sekä laivalla että maissa .	Kaikissa	0	Ine
Jotkin Välimeren alueen kumppaneista suhtautuvat varmasti erittäin myönteisesti kaikkiin näihin toimiin .	Jotkin	0	Nom
Yht’ äkkiä naisella oli kummassakin kädessään isot käsilautaset , jonkinlaiset symbaalit joita ainakin marssimusiikissa käytetään .	kummassakin	4	Ine
Sillä ei ole takkia päällä edes talvipakkasella .	Sillä	0	Ade
Mikäli häpeä , estot ja oma kontrollointi estävät meiltä tämän nautinnon , vaikuttaa se kaikkeen muuhunkin elämässämme .	kaikkeen	14	Ill
Aina toki löytyy myös niitä , jotka eivät osaa antaa anteeksi toisille , saatikka itselleen .	toisille	11	All
Hän olisi ollut valmis uhrautumaan eläinten puolesta , miksei ihmistenkin , useimpien .	useimpien	11	Gen
Teille minä olen herra majuri .	Teille	0	All
Miltä nyt tuntuu ?	Miltä	0	Abl
Kaikissa Suomen antennikodeissa televisio pimeni , jos kotiin ei oltu hankittu digisovitinta .	Kaikissa	0	Ine
Molemmat ehdokkaat käyttivät kaatuneiden sotilaiden tarinoita oman näkemyksensä ajamiseen .	Molemmat	0	Nom
Mä vien sut oikeuteen ja mä tapan sut !	sut	2	Acc
Jotka miettivät olevansa Jeesuksen kanssa samalla puolella kun Hän tulee , ovat sitä jo nyt .	Jotka	0	Nom
Monessa Etelä-Euroopan maassa julkinen velka on kestämättömällä tasolla , ja maassa kuin maassa 2009 lamaa torjuttiin ottamalla lisää lainaa .	Monessa	0	Ine
Järjestelmäasiantuntija hyötyy samoista asioista , mutta sen lisäksi tulee löytyä halua keskittyä johonkin tiettyyn osa-alueeseen , kuten ohjelmointiin , tietokantoihin tai testaukseen .	samoista	2	Ela
Sit se oli itte ollu tää naapurin pikkupoika semne et ku sil oli ollu ittellää synttärit ni se oli aina seissy ninku ovella tällee näi vastassa ku vieraat tuli et LAHJA LAHJA	ittellää	14	Ade
Mut minä en tunne kettää .	kettää	4	Par
He rutistivat otsaansa uusia uria miettiessään , kumpi tulee ennen , huipputiedemies vai huippuyliopisto .	He	0	Nom
Tietysti rakastan sinuakin .	sinuakin	2	Par
Et sä viitsis soittaa Eilalle ja mut sullakaan ei oo niiden puhelinnumeroo , vai onks sul .	sullakaan	7	Ade
Kun uskomme itseemme , unelmiimme ja pidämme kiinni näistä kahdesta , voimme tehdä mitä ikinä haluamme .	itseemme	2	Ill
Pisteitä tarkkaillaan , ja niiden kertymisen avulla seurataan opintojen etenemistä .	niiden	4	Gen
- Luonnon- ja lääketieteen tutkijat ovat kovin riippuvaisia projektirahoituksesta palkan lisäksi , koska monet tutkimusmenetelmät vaativat infrastruktuuria , joka itsessään , tai jonka käyttö maksaa , Jaakkola toteaa .	itsessään	19	Ine
Sillä tulee olemaan yksi talouspoliittinen hallitus , yksi valuutta ja yksi yhteinen ulkopolitiikka .	Sillä	0	Ade
samalla luokalla oltii , kolmannesta luokasta lähtie ollaan käytyk koulua , yhtä aikaa , siit lähtie ollaa tunnettut toisemme , vuodesta neljäkymmentä .	toisemme	18	Gen
Uskon sinun tulevan	sinun	1	Gen
Miltä tuntuisi , jos työnantajasi voisi silmäillä geenejäsi työhönotossa ?	Miltä	0	Abl
Kenestä se tuoksu oli jäänyt ?	Kenestä	0	Ela
Kumpikin on tottunut puhumaan mallina .	Kumpikin	0	Nom
Hän lupaa lähettää Sinulle SALT-paperinsa heti kun se on kirjoitettu .	Sinulle	3	All
heiltä puuttui halu sovinnon etsimiseen .	heiltä	0	Abl
Samastakin määrästä siitepölyä eri ihmiset voivat saada eri tavalla allergiaoireita .	Samastakin	0	Ela
Meiltä kun puuttuvat nämä vuoristot , varsinkin Pohjanmaalta .	Meiltä	0	Abl
He olisivat siis ilman turvaa 65:nteen ikävuoteen asti , jolloin heidän eläkkeensä olisi noin 500 euroa kuukaudessa .	heidän	10	Gen
Norjassa Ruijan puolella sekä ylimmässä Lapissa on alueita , joilta sopulit ovat kadonneet .	joilta	9	Abl
Seuraa ote eräästä tavanomaisesta torstaipäivästä .	eräästä	2	Ela
OIKEIN MUKAVAA JA MAKOISAA VAPPUA KAIKILLE BLOGISSANI PIIPAHTAVILLE .	KAIKILLE	5	All
vaikea saadas selvää kuvaa siitä , siitäkään .	siitäkään	6	Ela
Mul on kello . ”	Mul	0	Ade
Minäkö se laulan ja huojun ?	Minäkö	0	Nom
Mulle pitää yleensä aina olla makkaran kanssa sinappia , vaan nämä eivät kaivanneet mitään peittämään omaa hyvää makuaan .	Mulle	0	All
eihän ne ni ihtiisäj juovuksiij juonnu .	ihtiisäj	3	Par
Sen sijaan eräästä toisesta firmasta soitettiin takaisin toukokuussa ja kolmannesta paikasta soitettiin vasta kesäkuussa . ”	eräästä	2	Ela
Siks mä aloin jo juoksemaan Mollaa kohti , mutta se näytti hermostuvan mun juoksusta , ja lähti itekin pois päin siitä kohtaa missä se ois voinu vielä kahlata puron yli .	mun	12	Gen
He tulevat tekemään töitä , joita amerikkalaiset ja maassa laillisesti olevat siirtolaiset eivät halua tehdä .	He	0	Nom
Arduino on italialainen keksintö , mutta alustoja on saatavilla hyvin monia erilaisia .	monia	10	Par
Siitä on hyötyä itselle ja muille .	itselle	3	All
Kun puhelinkeskustelussa antaa lausuntoja , ei voi välttyä siltä , etteikö jotakin väärinkäsityksiä syntyisi .	siltä	8	Abl
samassa yhtteyvessä Tiina sano että tilloo hänellenni semmonen , semmonen pakki millä nuotiolla keitettää .	hänellenni	6	All
Visualisoinnit on tehty neljästä kysymyksestä , jotka valitsin yksinkertaisten vastausvaihtoehtojen ” Kyllä ” ja ” Ei ” perusteella .	jotka	6	Nom
Vittuako se kenellekään kuuluu , moottoripyörämies sanoi .	kenellekään	2	All
Gallin ja Aholan tutkimuksessa kävi kuitenkin ilmi , että työantajat harvoin tietävät tästä mahdollisuudesta , ja aloite koulutukseen hakemisesta tulee yleensä opiskelijalta itseltään .	itseltään	22	Abl
Suoraviivaisimmat luokittelijat ovat niputtaneet Breivikin kanssa samaan psykopaattijoukkoon kaikki , jotka ovat uskaltaneet puhua maahanmuuton lieveilmiöistä .	jotka	10	Nom
Sama terminologia on periytynyt monien muidenkin kielten kielioppeihin .	Sama	0	Nom
Entinen Ylen pääjohtaja Sakari Kiuru ( sd ) liittyi eilen Demariin kirjoittamassaan kolumnissa niihin , jotka --	niihin	13	Ill
Kaikilla oli kiire rintamalle , eikä kenelläkään näyttänyt olevan aikaa minulle .	kenelläkään	6	Ade
taputin häntä lepyttävästi polvelle .	häntä	1	Par
Kenellekään ei voinut jäädä epäselväksi , kenen poika hän oli .	Kenellekään	0	All
Heitä huolettaa se , että julkisuus omii heidät .	Heitä	0	Par
Minä tosiaan ajattelin nyt vaan poiketa morjestamaan sinua , täällä sinun omissa kotioloissasi .	Minä	0	Nom
Mitä se tähän kuuluu ?	tähän	2	Ill
Siinä ei puhuta mitään siitä , mihin pitäisi päästä , mitkä ovat uudet strategiat , uudet kehityslinjat .	mitään	3	Par
Uutta Garboa minusta ei tullut , sillä halusin säilyttää oman tyylini .	minusta	2	Ela
Kun vanhalla Saintillani ajoin öisiä , rikkinäisten katulamppujen valaisemia katuja , ajattelin ' turha toivo , ei avaruus ole Orkideapolun astronauttia varten , eivätkä nämä kädet sinusta otetta edes saisi ' .	sinusta	26	Ela
Sen lupa oli myönnetty 19. lokakuuta ja lupahakemuksen liitteenä oli ampumaseuran todistus jäsenyydestä .	Sen	0	Gen
Kerro Marjut keneltä sä oot saanu tän .	keneltä	2	Abl
Juu , kyllä sitä minullakin korvat kutisevat aina välillä allergian takia .	minullakin	4	Ade
Syytteen mukaan sisäpiirikauppoja on tehty 23 pörssikaupassa ja saatu yli 3 milj. euroa voittoja , jotka on saatettu pimittää verottajalta .	jotka	15	Nom
Tämä ilmenee eräästä komission puheenjohtajan Santerin Euroopan parlamentin puhemies Gil-Roblesille 11. marraskuuta 1997 lähettämästä kirjeestä .	eräästä	2	Ela
Heidät pitäisi saattaa YK:n ihmisoikeuskomission eteen vastaamaan kansanmurhasta .	Heidät	0	Acc
Haluan korostaa , että toimikunnat ovat hyvät ihmiset juuri Teitä varten ja kaikille avoimia !	Teitä	9	Par
Nyt myös muun muassa käyttäjäkunnan on sovellettava direktiiviä , ja me olemme saaneet siihen mukaan yhteiskäsitteen , jotta tiedämme , mistä puhumme .	mistä	20	Ela
Komeat kengät on sinullakin .	sinullakin	3	Ade
Tosiasiassa en tiennyt hänestä sen enempää kuin itsestänikään .	itsestänikään	7	Ela
He saivat jonkun pulaan .	He	0	Nom
Niit on erityyppisii .	Niit	0	Par
Olin jo varma , että eroamme , mutta muutamien hermosavujen jälkeen Mies palasi takaisin sänkyyni .	muutamien	8	Gen
Vilkaisu ylös saa meidät epäilemään tehtävän onnistumista : kaukana kaukana suoraan yläpuolellamme näyttää olevan .	meidät	3	Acc
Hienoa , lompakkonikin oli jäänyt sinne mistä tulin .	mistä	6	Ela
- Joo mää tuon .	mää	2	Nom
Mul oli semmost asiaa että eilen tuli tieto siitä Jyväskylästä että ne on tullu ne kirjat .	Mul	0	Ade
Uusissa kasvua ja työllisyyttä koskevissa yhdennetyissä suuntaviivoissa jäsenvaltioita kehotetaan toteuttamaan toimia , joilla parannetaan maahanmuuttajien työllisyyttä .	joilla	12	Ade
Sen jälkeen kun homoja muutenkin alkoi telkkarissa olla ihan omana itsenään ?	Sen	0	Gen
Monella on jo käytössään GSM-puhelin .	Monella	0	Ade
Senhän olemme jo usein todenneet , että seksistä , sen tavoista ja haluista on vaikeaa keskustella , varsinkin kumppanin kanssa .	Senhän	0	Gen
Miehellä on paljon omaisuutta , joten voi kysyä , onko se osittain tai kokonaan kertynyt riistämällä toisilta .	toisilta	16	Abl
Ni menee tuntikin joka mum mielestä on aika pitkä aika ni jopa tunti yhden otsikon miettimiseen .	mum	4	Gen
Jossakin vaiheessa hän huomasi , että tummalle iholle on erittäin vaikea löytää oikean sävyisiä meikkituotteita .	Jossakin	0	Ine
Itse olen vuosien saatossa osallistunut kahteen kahteen ulkomailla ja moneen Suomessa järjestettyyn kesäyliopistoon .	moneen	9	Ill
Toimintasuunnitelma perustuu 19. ja 20. lokakuuta pidettyyn konferenssiin , jossa käsiteltiin ihmiskaupan torjuntaa sekä siihen liittyviä toimia ja parhaita käytäntöjä Euroopassa ja jonka järjestivät puheenjohtajavaltio Yhdistynyt kuningaskunta , komissio ja Ruotsi .	siihen	14	Ill
Voi olla , että tämä voi olla typerimpiä tapoja lähteä maailmasta , ehkä minulle nauretaan , etten keksinyt parempaakaan kuin jäätyminen kuoliaaksi .	minulle	13	All
Ne saattaa sej jälkee mennä jonnekkit toimistoo istumaa	sej	2	Gen
Hänhän asuu muualla .	Hänhän	0	Nom
Sanoiko hän muuta ?	muuta	2	Par
Ensimmäinen ihminen kenet löysin , oli ikäiseni oloinen nainen .	kenet	2	Acc
- Sinusta ei ole ollut täällä muuta kuin harmia .	Sinusta	1	Ela
Sanoin Jussille , että tulisi mullekin ilmottamaan tämän kirjeen saatuaan , mikäli ei joutuisi välittömästi arestiin .	mullekin	5	All
Liekö vaikka jotakuta ärsyttäisi , tiedä häntä .	jotakuta	2	Par
On täällä ollut pahempiakin tapauksia ja hekin ovat selviytyneet , hoitaja lohdutteli .	hekin	6	Nom
Ei mene kuin muutama päivä kun kuuluu että uusi pääosanesittäjä kiduttaa ohjaajaa , tekee kaiken mahdottomaksi kaikille , on piru .	kaikille	16	All
Häntä riivasi raivoisa mustasukkaisuus .	Häntä	0	Par
Sen avulla saavutetaan tavoite , jonka me kaikki olemme jakaneet alusta alkaen , ja olen tässä yhteydessä pahoillani siitä , että esittelijä Jarzembowski pitää riittämättömänä sitä , mitä siinä on esitetty .	Sen	0	Gen
Ostaisit sä mullekin kahvia .	mullekin	2	All
Osa aidsin aiheuttamaa tyrmistystä on vastuullisuus , joka on äkisti palautettukin ihmisten itsensä kannettavaksi .	itsensä	12	Gen
En mä halua tehdä tätä , mutta ei mulla ole parempiakaan ideoita .	tätä	4	Par
Muutamat jäsenvaltiot näyttävät tulleen neuvotteluihin mukanaan kirjekuori , jossa on muutamia laskelmia , ja kieltäytyneen tekemästä minkäänlaisia myönnytyksiä asettaakseen itselleen realistiset tavoitteet .	itselleen	19	All
Vuonna 2004 niiden keskimääräinen asukaskohtainen BKT oli 72 prosenttia EU:n keskiarvosta , ja useimmissa tapauksissa alhaisempi kuin millään muulla alueella kyseisissä maissa .	muulla	18	Ade
moneen suuntaan aktiivinen	moneen	0	Ill
Varovaisen mutta todenmukaisen arvioni , joka perustuu laserin lailla leikkaavaan tarkkailukykyyni , mukaan 75 % toiseen naiseen liittyvistä riidoista eivät liity millään tavalla mustasukkaisuuteen .	toiseen	15	Ill
Lisäksi muutamilla saarilla esiintyy myös kallio- ja hiekkarantoja .	muutamilla	1	Ade
Kyselyn mukaan sekä Clinton että Obama saisivat kumpikin noin 33 prosenttia demokraattien äänistä ja kolmanneksi tulisi John Edwards , joka saisi kyselyn mukaan 20 prosenttia annettavista äänistä .	kumpikin	7	Nom
Kumpaa katsot mieluummin Prätkähiiriä vai tanssiesitystä .	Kumpaa	0	Par
Ja taatusti en mene Raiviolle puhumaan yhtään mitään .	mitään	7	Par
Tässäkö se muka oli ?	Tässäkö	0	Ine
Tuostahan sinä voit saada vaikka minkälaisen taudin .	Tuostahan	0	Ela
Eurooppalaisten siirtolaisten tulo kuitenkin jatkui ja Te Rauparaha kieltäytyi myymästä heille uusia alueita .	heille	10	All
Näette sen ylläni huomisessa risteilypostauksessa eräässä sovituskuvassa .	eräässä	5	Ine
Pupu hoitaa pihat ja istutukset , mikä vähän kuin vahingossa on jättänyt minulle jäljelle talonmiehen , ylläpitäjän roolin .	minulle	12	All
Sirolalta on itseltään jäänyt huomiotta seikka , että eläin toimii pääasiassa vaistojensa mukaan .	itseltään	2	Abl
Oli jo liian myöhä lähteä ajamaan ryöväreitä takaa ja seuraavan yön lumisade peitti heidän jälkensä .	heidän	13	Gen
Nyt on tästäkin viikonlopusta selvitty !	tästäkin	2	Ela
Seitsemän henkeä jätti käyttämättä hissiä , mutta jokaisessa tapauksessa jättivät koska he nauroivat liian kovaa .	jokaisessa	7	Ine
Sen ilma tuntui tunkkaiselta , hiekkaiselta ja betoniselta .	Sen	0	Gen
Näistä huiputtajista olikin tulossa uuden hännänhuippuyliopiston arvostetuimpia tiedemiehiä , sillä vanhasta otsanryppyihin perustuvasta arvomaailmasta irtautuminen oli jo osoittautunut mahdottomaksi .	Näistä	0	Ela
Kehitetään innovatiivisia lähestymistapoja , joilla estetään syrjintä työmarkkinoilla	joilla	4	Ade
Kumpikaan ehdokkaista ei suostunut suoralta kädeltä mainitsemaan , mitä muutoksia heidän hallitusohjelmaansa on tehtävä vakavan talouskriisin johdosta .	heidän	10	Gen
On meistä itsestämme kiinni , kuinka kauas kantoinen sen antama selviytymisen , unelmien toteuttamisen ja kiitollisuuden tunne on .	itsestämme	2	Ela
Velkojen hoito viivästyy ja velkaongelma pahenee usein yhdestä ja samasta syystä : velka on suomalaiselle häpeä .	samasta	9	Ela
Eräälläkin tuomarityttösellä oli kankaiset tennarit jalassa .	Eräälläkin	0	Ade
Tämä ystävyys oli verrattain nuori , vasta kaksikymmentäviisi vuotta vanha , ensimmäinen solmittu ystävyyssuhde uudessa maassa .	Tämä	0	Nom
Tietenkin kaikella on syynsä .	kaikella	1	Ade
Pannahisen kännykkä oli yön aikana tyhjentynyt , ja kuten monella muullakin , oli Jalmarillakin tapana luottaa tähän nykyajan ihmeeseen herätyskellona .	muullakin	10	Ade
Hän huolestuneena tiedusteli , mahtaisimmeko jaksaa majoittaa heitä niin usein .	heitä	7	Par
Mut et säkään taida tajuta .	säkään	2	Nom
Anja muute kirjotti ni se vaa puhu et hän vois järjestää jotkut pikkujoulut heillä ku hää ei oo koskaa järjestäny mitää pileitä ja hänest ois niiku kivaa niiku sit nähä kaikkia .	hänest	23	Ela
Se kurssi tekisi varmaan hyvää itse kullekin , Kati tuumasi .	kullekin	6	All
jonkinlaista mainosta jollekin	jollekin	2	All
Jommankumman täytyy olla väärässä tai matkia toista .	Jommankumman	0	Gen
Kenellä oli noussut vuokra , kenellä ei .	Kenellä	0	Ade
Heillä ei ole harrastuksia , koska he rakentavat taloa .	Heillä	0	Ade
Jos haluaa että jotain tapahtuu itselle on itse tehtävä jotain .	itselle	5	All
Mutta koko tää ajattelu siis siitä että et on niinku tiukka itsekuri ja tähtää kirjallisesti määrittelemiinsä päämääriin nii eiks tää oo ihan samaa ku se mitä työssä tekee .	samaa	22	Par
Leppoisia välipäiviä itse kullekin ! :)	kullekin	3	All
Mä en tiiä nyt yhtää mitää yhtää mistää	mistää	7	Ela
Suomikin on hänelle mahdollinen asiakas , jos se sitä haluaa .	hänelle	2	All
Sinulla on onnea - paitsi että lupaa ottaa Sinut vastaan hän myös osoittaa lämmintä mielenkiintoa sinun vaiheitasi kohtaan .	Sinut	8	Acc
Siihen on tarkoitus päästä keräämällä yhteen ja asettamalla saataville jo olemassa olevia tietoja sekä tarkastelemalla uudelleen ja analysoimalla olemassa olevia merkityksellisiä tietoja .	Siihen	0	Ill
- Tiiätkö , mää oon kelannu .	mää	3	Nom
Koska olemme itkeneet yhdessä niin monesti , on meillä enää jäljellä suuri rakkaus toisiimme .	toisiimme	13	Ill
Ehkä hänen ihonsa itkee , jonkin hänessä on pystyttävä siihen .	hänessä	6	Ine
Syöhän tätä .	tätä	1	Par
Siellä oli nyt ne kirjalliset ohjeet , tutustutte niihij ja katotaan .	niihij	8	Ill
Tänään kuitenkaan ei uusia asukkaita ollut ilmaantunut , niitä tippui tähän vuodenaikaan harvakseen .	tähän	10	Ill
Rakkauden ja valon täyttämää kevättä Sinulle ! :)	Sinulle	5	All
Tai siis puolirikollinen hullu , joten mitähän se mustasukkaisuus siis edes tarkoittaa .	mitähän	6	Par
Inhimillinen unohdus vai tosi anarkistinen veto , siinäpä pähkinä purtavaksi .	siinäpä	7	Ine
Häntä pelottaa puhua vieraita kieliä .	Häntä	0	Par
On ehkä mahdollista , että lapsena olin nähnyt sellaisen jossain ja tajunnut haluavani samanlaisen .	jossain	9	Ine
“ Niil on eri kello ku mulla ? ”	Niil	1	Ade
Mulla suattaa olla vellinkeittäjä katottuna .	Mulla	0	Ade
Innostui tuosta Perttikin niin , että samalta seisomalta sosiaalitoimistoon meni .	tuosta	1	Ela
Tämä ei ole vain velvollisuus , vaan myös meidän etumme mukaista .	Tämä	0	Nom
Hänelle on tärkeä saavuttaa , rakentaa , valloittaa ja omistaa .	Hänelle	0	All
Tosca haukkui innoissaan kun näki minut ovella .	minut	5	Acc
Refereitä miettiessä ensimmäisenä tuli mieleen Sinut .	Sinut	5	Acc
Eräiden salaliittoteoreetikoiden mukaan kyykkäfinaali oli ns. sopupeli ja johtui ennen kisaa lyödystä ” voittaja järjestää ensi vuoden Festit ” -vedosta .	Eräiden	0	Gen
Ruskistin kyljykset paistinpannulla tilkassa öljyä ( kaksi kyljystä mahtui just ja just ruskistumaan samanaikaisesti isolle pannulle ) + ripsottelin mustapippurirouhetta ja suolaa lihoille ja lisäsin samalle pannulle ruskistumaan omenalohkot ja otin ne sitten lautaselle odottamaan ... .	samalle	25	All
He joutuivat tappiolle ja menettivät alkuperäisen maansa Pohjoissaaren pohjoisessa nurkassa .	He	0	Nom
Kenelle kanava annetaan , on ennen kaikkea poliittinen kysymys .	Kenelle	0	All
Kahtiajaon yhteiskunnassa tätä keskustelua käydään liian vähän .	tätä	2	Par
on vaikea saadas selvää kuvaa siitä , siitäkään .	siitäkään	7	Ela
meillä voisi olla tarve tukea ja kannustaa sitä , mikä meidän suomalaisessa kulttuurissamme on hyvää , niin filmissä kuin kirjallisuudessa kuin paljossa muussakin .	muussakin	22	Ine
Start- ja stop-toiminnot laitan myöhemmin saman nappulan alle .	saman	5	Gen
Ottamatta tässä huomioon kansallisten yhteyspisteiden varsinaiseen perustamiseen liittyviä henkilöstö- , toimitila- ja tietotekniikkajärjestelyitä , EMN:n toiminnan keskeiset tulokset vuodesta 2002 aina tähän hetkeen voidaan noiden periaatteiden pohjalta esittää seuraavasti :	tähän	21	Ill
Ma oon ollu , sillon tällön tollasessa , erilaisis tilaisuuksis niin ku säestämässä , jotai yksillaulajaa tai , sellasta , esimerkiks jossai häissä mä oon olluj ja , tommosissa	jotai	14	Par
Teen erilaisia office concepteja meidän tälle asiakas " firmalle " , kivaa ja mielenkiintoista , mutta aika työlästä :)	tälle	5	All
ICT-talossa pidettiin samaan aikaan myös ICT Kampus -rekrytointitapahtuma , joka oli keskittynyt erityisesti kesätöiden tarjontaan .	samaan	2	Ill
Alakomitea arvioi jäljempänä luetelluilla aloilla tapahtunutta edistystä , tarkastelee niillä mahdollisesti ilmeneviä ongelmia ja ehdottaa toimia niiden ratkaisemiseksi .	niillä	9	Ade
Hän oli kaikkensa yrittänyt .	kaikkensa	2	Gen
mä pidin itteeni semmosena fiksuna ja sen takia oli pää auki aina ja joka paikassa ja .	itteeni	2	Par
( 9 ) Vaikka on tunnustettua , että EKP:n perussäännön 34.1 artiklan nojalla antamissa asetuksissa ei anneta mitään oikeuksia eikä aseteta mitään velvollisuuksia rahaliittoon osallistumattomille jäsenvaltioille , perussäännön 5 artikla koskee sekä rahaliittoon osallistuvia että siihen osallistumattomia jäsenvaltioita .	siihen	35	Ill
Tämäkö se paikka on ?	Tämäkö	0	Nom
Saanen kysyä sinulta seuraavat kysymykset : - -	sinulta	2	Abl
Heille taputettiin itselleenkin .	itselleenkin	2	All
Molemmissa tulee samanlainen olo , hiukan ahdistava ja kalsea , ja sitä pitää ponnistella viihtyäkseen .	Molemmissa	0	Ine
Josta sinä aina sanoit , että Täti Vihreä .	Josta	0	Ela
Ainoa ovi on salin takapäässä , joten luennolta on helppo poistua .	Ainoa	0	Nom
Sit meil oli kauheen mukavaa .	meil	1	Ade
Siihenkö sitä nyt ollaan rakastuttu , kaupungin kauneimpaan naiseen ?	Siihenkö	0	Ill
− Risto Lammintausta on monellakin tavalla ainutlaatuinen ihminen tällä alalla Suomessa .	monellakin	4	Ade
Seminaari antoi kuulijoille hyvän käsityksen siitä , mihin kaikkeen Linux nykyään kykenee ja missä sitä käytetään kaupallisesti .	mihin	7	Ill
Voin nähdä sieluni silmin kuinka äidin musta , pitkä tukka hulmuaa tuulessa ja hän hymyilee kääntyessään katsomaan minua .	minua	17	Par
Kenties jotakuta kiinnostaa tämän takana oleva simppeli koodikin , joten laitetaan näytille kun kerta ohjelmointi-kategoriaan tämän postaan .	jotakuta	1	Par
Jos joku kenet milloin jättää , niin se olen kyllä minä .	kenet	2	Acc
Kuule kun tota mä löysin kaks tämmöst perunkirjaa jos näis nyt olis sinne pankkii mitkä mä oon ottanu joskus jäljen- yhes jäljentämös	näis	9	Ine
Kenellekään siitä ei kehdannut kertoa , ei edes äidille .	Kenellekään	0	All
Samoihin aikoihin hän myös tapasi Stanley Donwoodin , taiteilijan joka on vuodesta 1994 ollut tärkeä osa Radioheadin albumien ja singlejen kansien ulkoasujen teossa .	Samoihin	0	Ill
En mä sua huijais , niinku en ketää muutakaan . ”	ketää	7	Par
No minäkös siihen sanomaan , ettei kukaan huoli tuon näköistä mihinkään .	siihen	2	Ill
Joihinkin anisviinoihin lisätään sokeria valmistusvaiheessa .	Joihinkin	0	Ill
Älä sie märise - met kaajoimme kolmeen havumajaan ainakin tusinan ukkoja .	met	4	Nom
Heille itselleenkin taputettiin .	itselleenkin	1	All
ajatus oli sekö , että aloitetaan kysymyksistä ?	sekö	2	Nom
Kummastakin maasta tuli näin itsenäinen .	Kummastakin	0	Ela
Kenellä oli noussut vuokra , kenellä ei .	kenellä	5	Ade
Vaikuttaa myös siltä , että moottori sisäänajauduttuaan kunnolla parani .	siltä	2	Abl
Useita kertoja viikossa , jopa päivässä , olen ajatellut , että tästä kirjoitan ja tämän muistan varmasti , mutta tietokoneen ääressä inspiraationi katoaa ja huomaankin kirjoittelevani turhia viestejä samoille typerille foorumeille .	samoille	28	All
On minultakin kysytty , miten voin ampua jonkun viattoman luontokappaleen .	minultakin	1	Abl
Sinua on hauska kiduttaa , mutta saat syyttää itseäsi .	Sinua	0	Par
Olisi pitänyt löytää vanha tukeva juuttikankainen säkki , joita ei varmaan enää edes valmisteta	joita	8	Par
Marjaisan herkun voi tehdä muistakin marjoista kuin mustikasta ... .	muistakin	4	Ela
Nämä tehtävät on määritelty perussäännössä ja eräissä tapauksissa perustamissopimuksen 107 artiklan 6 kohdassa tarkoitetuissa neuvoston säännöksissä .	eräissä	6	Ine
Jos oli , kysyi tämä heiltä , osaisivatko he pelata biljardia .	heiltä	5	Abl
- Ettei sinulla ole jotakin mikä kuuluu niille .	jotakin	4	Par
Myös avioeron hän hyväksyy , jos ei kerran tule toinen toisensa kanssa juttuun	toisensa	10	Gen
" Tuohan on imartelevaa " , Nadja Pyykkö vastaa .	Tuohan	1	Nom
Sitten nainen alkoi ylittää katua , varoen tarkoin ettei astuisi muille kuin valkoisille viivoille .	muille	10	All
Niihin osallistuvat lukiolaiset saavat opintopistehyvityksen kurssista , mikäli tulevat yliopistoon opiskelemaan .	Niihin	0	Ill
Me emme saaneet kuulla tästä Kallelta mitään .	mitään	6	Par
Poika oli pelannut viime lauantaina ystävineen läpi yön uutta Wrath of the Lich King -lisäosaa , joka on Svenska Dagbladetin mukaan ollut huolenaihe muidenkin pelaajien vanhemmille .	muidenkin	23	Gen
Toki tykkään joskus pienestä luksuksesta , mutta kaikkein tärkeintä hyvinvoinnilleni on se , että saan tehdä elämässä niitä asioita , jotka herättävät minussa onnen tunteita .	minussa	22	Ine
silt on tästä pudonnu tää osa mis on sen nimi	mis	6	Ine
Jos yhtään tunnen Sinua .	Sinua	3	Par
Savugeneraattori on yksinkertaisimmillaan eräissä moottoritorpedoveneissä ; venäläiset kehittivät erittäin suositun keinon : he laskivat erillisestä putkistosta raakaa naftaa torpedoveneen kuumiin pakoputkiin , jolloin nafta kiehui ja muodosti paksua savua .	eräissä	3	Ine
Myyntipalvelumme kunnia-asia on auttaa Sinua toteuttamaan yksilöllinen , juuri sinun näköisesi juhlatilaisuus .	Sinua	4	Par
Häpeä voi saada ihmisen kieltämään seksuaaliset tarpeensa , kirjoittaa Heidi Lindgren eräässä lehtiartikkelissa .	eräässä	11	Ine
Tutkimustulosten perusteella suositellaan näiden tuotteiden käytön vähentämistä , ylilääkäri sanoo Taloussanomille .	näiden	3	Gen
Itse neljänkympin kriisissä , senhän näki päältä .	senhän	4	Gen
Siitä mitä on arvovapaa opetus ja tutkimus voisi keskustella paljonkin	Siitä	0	Ela
Heille ei annettu etukäteen mitään tietoa irtisanomissuunnitelmista .	Heille	0	All
ku mä kävin neuvonnast kysyy ni se sano et kysy tolta	tolta	10	Abl
Eräät yrittävät hankkia lisäansiota esimerkiksi taksinkuljettajina tai vartiointitehtävissä .	Eräät	0	Nom
- Mut mee Janican tai Eetvartin luokse , nekin tykkää Killersistä ...	nekin	8	Nom
Kuule tota liikeniskö teiltä yhtä mankkaa vähäks aikaa	teiltä	3	Abl
Mäkin muistin sut heti .	sut	2	Acc
En siis kuulu niihin , joiden kuusi lentää pihalle vasta sitten , kun siinä ei ole jäljellä yhtään neulasta …	niihin	3	Ill
Onneksi olin tästä tietoinen , joten vältyin pettymykseltä .	tästä	2	Ela
Välillä taantuma laskee tunnelmaa , mutta uutteralla työllähän siitäkin selvitään .	siitäkin	8	Ela
Vuosittain professorit kokoontuivat keskinäiseen tuloskeskusteluun , jossa he mittasivat toistensa otsaryppyjen syvyyttä ja sitten taputtivat kohteliaasti niille , joilla oli kaikkein syvimmät rypyt .	joilla	18	Ade
Siksi minusta ei tullut sirkusihmistä , vaan näyttelijä .	minusta	1	Ela
Tämä tarkoittaa sitä , että tätä kysymystä koskevan sovittelumenettelyn esteet voitiin poistaa .	tätä	5	Par
Mie en tie missä asti se ois sitte lähin linja-autopysäkki .	Mie	0	Nom
Monien merkkien mukaan tunturisopulit ovat syksyllä lähdössä vaellukselle , ja silloin Pohjois-Lappi kuhisee sopuleita .	Monien	0	Gen
Katsokaas kun minun täytyy aina aamulääkkeiden jälkeen tehdä kävelylenkki ; lääkäri on määrännyt .	minun	2	Gen
Heinonen valotti ritarisotilaiden elämää suhteessa keskiaikaisiin ritaritarinoihin , jotka edelleen elävät osana eurooppalaista tarinaperinnettä .	jotka	8	Nom
Valmet on valmistanut tähän asti lähes puolet Calibroista .	tähän	3	Ill
- Ei kummankaan tarvitse olla väärässä .	kummankaan	2	Gen
Juuri kun olin astumassa tukevalle lattialle takaisin , sain huomata tuon venäläisen yrittävän työntää minua hissikuiluun kokonaan .	minua	14	Par
Oma miehenikin tarkisti tämän kirjoituksen ja totesi minulle ykskantaan että ” olen eri mieltä ” .	minulle	7	All
Kyllä minä ymmärrän , että sinä laihtua haluat , mutta en sitä , miksi siitä pitää amerikkalaisille maksaa .	sinä	5	Nom
Että niin rappioitunut ja alkoholisoitunut elämänpakenija voi saada elätettyä itsensä runoillaan ja luennoillaan , mutta minä , näennäisesti pirteä ja selväjärkinen , en saa mitään aikaiseksi .	mitään	24	Par
Mitä varte siun täytyy periaatteita kannattaa tommosissa .	siun	2	Gen
Annetaan ihmisille esim. tiedotuskampanjoiden , näyttelyjen ja monikulttuuristen tapahtumien välityksellä enemmän tietoja maahanmuuttajista , jotta heidät hyväksytään paremmin yhteiskunnassa	heidät	15	Acc
Sen jälkeen yrityksen pitoaika on noin 4-8 vuotta , jonka jälkeen kuluu vielä puolesta vuodesta vuoteen ns. exit -vaiheeseen , Routila sanoi .	Sen	0	Gen
Merinäköala on oltava , ei odotuksessa olisi muuten mitään mieltä .	mitään	8	Par
Tuostahan sinä voit saada vaikka minkälaisen taudin .	Tuostahan	0	Ela
Suhteellisen absurdia oli lukea aamubussissa metro-lehdestä juttua tapahtumasta , josta oli vasta tulossa kotiin :D	josta	9	Ela
Kansa on opetettu luottamaan viranomaisiin , heiltä saa avun tilanteessa kuin tilanteessa .	heiltä	6	Abl
Oletetaan , että minulla on se mitä sinä ja ne muut haluavat .	minulla	3	Ade
Polkupyörällä tarkoitetaan yhden tai useamman henkilön tai tavaran kuljettamiseen rakennettua , vähintään kaksipyöräistä , polkimin tai käsikammin varustettua moottoritonta ajoneuvoa .	useamman	4	Gen
Kun kassit saatiin kuosiin ja ihmisiä alkoi virrata laivaan , pystytimme Mintun kanssa ilmoittautumispisteen ja jakelimme lahjakasseja kaikille .	kaikille	17	All
Suomen ja Kiinan kahdenvälinen kauppa on hyvä esimerkki siitä , kuinka kaksi toisiaan täydentävää taloutta voi hyötyä toinen toisestaan .	toisestaan	18	Ela
Tuossa näkyy sinutkin .	sinutkin	2	Acc
Työn tulokset ratkaisisivat sen , mitä kenellekin maksetaan palkkaa .	kenellekin	6	All
Että siitäs saisin .	siitäs	1	Ela
Suomen ja Kiinan kahdenvälinen kauppa on hyvä esimerkki siitä , kuinka kaksi toisiaan täydentävää taloutta voi hyötyä toinen toisestaan .	toisiaan	12	Par
” Vaan jonkunhan nekin työt on tehtävä . ”	jonkunhan	2	Gen
Sinua ei näkynyt Kekkosen hautajaisissa .	Sinua	0	Par
Järjestetään eritasoisia koulutuspaketteja , joissa otetaan huomioon erilaiset koulutustaustat sekä aiemmat tiedot vastaanottavasta valtiosta	joissa	4	Ine
jotta he voivat nämä edellytykset täyttää , heidän persoonansa täytyy olla jakautunut .	heidän	7	Gen
Yksi ainoa kysymys : Kenellä on positiivisia muistoja hyttysistä ?	Kenellä	4	Ade
Suomalaiset taitavat olla vähän kateellisia meille , mutta olkoot vain , siihen heillä on meidän lupa !	meille	5	All
Mistä tiedät , tuleeko hän jo tänään ?	Mistä	0	Ela
Yhdysvallat juhli vankien vapautusta heidän laskeuduttua Kaliforniaan Los Angelesin lähistöllä Burbankin lentokentälle .	heidän	4	Gen
1. Monille tiedekuntamme opiskelijoille rakkaan SPSS-ohjelmiston käyttökurssi : kaksi tuntia luennointia , kahdeksan tuntia harjoituksia .	Monille	1	All
Mieheni ei laita koskaan tomaatteja ja kurkkuja samalle leivälle .	samalle	7	All
Kulttuurin evoluutio ja aivojen evoluutio kulkivat rinta rinnan , kumpikin toistaan edistäen .	toistaan	10	Par
Jos hän niin olisi tehnyt näiden 32 julkisuuden vuoden aikana , häntä ei enää olisi .	häntä	11	Par
Tähänkin on varmasti jäsenvaltioissa varauksia , jotka halutaan kiertää tällä väliaikaisella sopimuksella .	Tähänkin	0	Ill
Sen massa on 1,9 Maan massaa .	Sen	0	Gen
Kysyin heiltä , olihan uimarenkaat mukana .	heiltä	1	Abl
Sitten heristelin sormeani ja varoittelin Doraa , ettei hänelle jää tästä ajasta muuta muistoa kuin kauhea krapula .	hänelle	8	All
Tuolle värille on oma sanansa , tyttö miettii , muttei ihan tavoita sitä .	Tuolle	0	All
Sanoisin , etten tiedä mitään ärsyttävämpää kuin se , että joku kuvaa minua , vaikka nimenomaan olen sanonut , etten halua naamaani kameran eteen . :/	minua	12	Par
Mutta jotenkin tämä sopi vain minulle , halusin että tunnen kuinka elintoimintoni hiipuvat .	minulle	5	All
Äiti puhui minulle aina saksaa .	minulle	2	All
Mikään jäsenvaltio ei ole ratifioinut yleissopimusta .	Mikään	0	Nom
Hyvää uutta vuotta Sinulle ! :)	Sinulle	3	All
Ja sitte se tietysti semmoinen iso pullo ja sitä olisi tietysti riittänyt ja meille että ottakaa nyt että ei ku ei ole kiire ja muuta .	muuta	24	Par
Te , kansliapäällikkö Rauta , olette häpäissyt itsenne .	itsenne	7	Gen
Enimmäkseen hän törmää nuoriin perheisiin , joissa ei ole ennen lapsen tuloa tehty ruokaa edes itselle .	itselle	15	All
s oli kuulemma- mä en ite huamannu mut se oli kuulemma Ruatsis ja Ruatsin laival ni ihan sairaasti juonu .	s	0	Nom
Tuosta lukutaidon asteesta niin minä lisäisin siihen vielä löylyä .	Tuosta	0	Ela
Olen juuri kuullut uutisen , jonka mukaan pääoppositiopuolue vetäytyy petosepäilyjen tutkimisprosessista , koska väitteiden mukaan , sen edustajia on estetty osallistumasta siihen .	siihen	21	Ill
Mitä paskaa sä jauhat ?	Mitä	0	Par
meiän täytyy itte vahtia noita saatanan osakkeita	itte	2	Nom
Näistä opettajista riippuvaisia perheitä uhkaa todellakin köyhyys .	Näistä	0	Ela
Minussa ei ole sijaa arktisuudelle sen paremmin kuin arkisuudellekaan .	Minussa	0	Ine
Joillakin tytöistä vannehame vaihtuu toiseksi hetkessä .	Joillakin	0	Ade
Toisaalta myös pienet ja lyhyet kurssit voivat olla sisällöltään tarpeellisia , ja suppeudestaan huolimatta niistäkin on pakko antaa jotain pisteitä .	niistäkin	14	Ela
meiltä on pantu sähköt poikki .	meiltä	0	Abl
Simo kommentoi sitä hiljaa vierustoverille : ” Ei tossa ole mitään järkeä . ”	tossa	8	Ine
Kaikille maksettaisiin ensin 2,4 prosentin korotus tai vähintään 200 markkaa lisää kuukaudessa .	Kaikille	0	All
Mutta minun ei olisi tarvinnut huolehtia , sillä hän ei enää nostanut katsettaan minuun , siirteli vain jalkojaan pitkin hiekkaa ja katseli sitä melko lumoutuneena .	minuun	13	Ill
Toivottavasti olen väärässä , mutta vaikuttaa siltä , että uusimmissa kansainvälisen yhteisön päätöksissä Iranin johdon sallitaan edelleen toimia oman mielensä mukaan .	siltä	6	Abl
Niin että virtaus oli varmasti itsestä poispäin .	itsestä	5	Ela
Valmet on valmistanut tähänkin asti lähes puolet Calibroista .	tähänkin	3	Ill
Tai oikeastaan ihmisten typeryys , tietämättömyys , välipitämättömyys ja laiskuus , joka niihin liittyy .	niihin	12	Ill
Sit se rupes kattoon et mikäs se tuolla lihatiskil oj jossei heidän Ville heh hi hi kissa istu siel lihatiski ääressä heh katto silmät ymmyrkäisinä kanoja grillissä	mikäs	5	Nom
me teemme kaikkemme , ettei niin tapahdu .	kaikkemme	2	Gen
Samat aiheet toistuivat myös kehittämisehdotuksissa , mikä kertoo uuden tutkinnon asiakaskunnan erilaisista koulutuskokemuksista ja -odotuksista sekä koulutusohjelmien tasoeroista : jossain on onnistuttu hyvin , toisaalla on vielä kehitettävää .	Samat	0	Nom
Sinulle minä joka puhun olen sinä .	Sinulle	0	All
Voimme uskotella itsellemme , ettei seksi ole tärkeää , että tyydytyksen saaminen ei ole tärkeää .	itsellemme	2	All
Kehotan siis kollegojani äänestämään tätä sopimusehdotusta vastaan , varsinkin kun neuvosto vielä kehtaa kiistellä muutamista miljoonista .	muutamista	14	Ela
Haluaisin kysyä teiltä , isiltä ja äideiltä , jotka annatte lapsillenne ilmakivääreitä lahjoiksi , että .	teiltä	2	Abl
Ihmeellistä , että pari vuotta sitten rakastin tasaista tunnusmerkitöntä ( pääsykoekirjojen kieli tunkee vahingossakin sanastooni ) rintakehääni , mutta nyt toivoisin edes yhden ihmisen kiinnittävän huomiota siihen , ettei minulla ole rintaliivejä .	siihen	26	Ill
et nyt täsä on viäl aikka siihem pualtoista kuukaut melkke .	siihem	6	Ill
“ Mist tiiät ? ”	Mist	1	Ela
Peruskarsinnan jälkeen pidetään välipalaveri ja päätetään ketkä kutsutaan haastatteluun .	ketkä	6	Acc
Husseinin mukaan surmattu oli huutanut moneen kertaan apua hänen ollessaan paikalla .	moneen	5	Ill
Pullojakin sain joskus poisvietäväksi , ja joistain niistä sai rahaakin .	joistain	6	Ela
Onko kenellekään tullut koskaan mieli kysyä itseltään ” Miksi minun pitäisi haluta seksiä ? ”	itseltään	6	Abl
Pääsky kulkee hyllyjen välissä puolijuoksua , improvisoi , poimii mukaan milloin mitäkin umpimähkään .	mitäkin	11	Par
Ritva on opettanut minut käyttämään erilaisia mausteyrttejä .	minut	3	Acc
vaikka työnjohtaja itte oliskin tota mukana ryyppäämässä tai noin ni se voi kenet tahansa , minä sain ainaki sen käsityksen , erottaa .	kenet	12	Acc
Ei sellainen tuntunut silloin tärkeältä , koska elämä täyttyi muusta itselle paljon keskeisemmästä .	itselle	10	All
Joku nimesi hänet pubissa Euroopan rumimmaksi mieheksi , joka ei ymmärrä jääkiekosta senkään vertaa kuin KuPSin kannattaja tietää jalkapallosta .	senkään	12	Gen
- Tässä säässä eivät kulje kuin kruunun miehet , salakuljettajat ja ryssän vakoojat .	Tässä	1	Ine
Teidät ammuttaisiin järvelle kuin sorsat .	Teidät	0	Acc
jonkin lahja jollekin	jollekin	2	All
Noihin tavitsee kuitenkin kaikenlaista optoerottimista moottoreihin , joten opeteltavaa riittää .	Noihin	0	Ill
Lapsista on nyt monilla yskää	monilla	3	Ade
Hän tekee myös ei-kenellekään suunnattuja lauluja .	ei-kenellekään	3	Ade
kunnes hän lopulta tietää kaiken ei-mistään .	ei-mistään	5	Ela
Otaniemen alkuasukkaat olivat onnistuneesti järjestäneet meille ekskun VTT:n koereaktori FIR-1:selle , jonka meille esitteli ilmiselvä tohtori Emmett Brown .	meille	5	All
Harva uskoo , että Suomen idänkauppa nousee enää koskaan suhteessa samalle tasolle kuin se oli 1980-luvulla .	Harva	0	Nom
Miltä luulisit , että näyttäisin , jos kasvattaisin viikset ?	Miltä	0	Abl
Haluamme ja asetamme itsellemme ehtoja sille , milloin meillä on oikeus , tilaisuus ja mahdollisuus toteuttaa sitä mitä elämältä toivomme .	itsellemme	3	All
Kyllä voimme , mutta vanhempamme voivat taas itse syyttää omia vanhempiaan ihan samasta asiasta .	samasta	12	Ela
Sit kup puhuttiin et jos mennään johonki semmoseen paikkaan mis ois mahdollisesti vaikka jotain jameja	mis	9	Ine
Kirjassa perehdytään myös siihen , miten kasvatettiin yhteinen rahvas eli yhteiskunnan vähäosaiset , joita olivat esimerkiksi tilattomien lapset , orvot , huutolaiset ja mustalaislapset .	siihen	3	Ill
Pitäkää huolta toisistanne .	toisistanne	2	Ela
Useimmilla on kesävaatetus , olipa tuuli kuinka raaka tahansa ja satoipa lunta tai ei .	Useimmilla	0	Ade
Te Rauparaha myi heille maata nykyisen Nelsonin alueelta Golden Bayssa .	heille	3	All
Vastaava tapaus oli hiljattain esillä , kun italialainen 13-vuotias peliaddikti joutui peliputken jälkeen sairaalaan , koska ei tajunnut ympäröivästä maailmasta mitään .	mitään	20	Par
Saanen kysyä sinulta seuraavat kysymykset : --	sinulta	2	Abl
Kirjallisuuspiireihin minulla on hyvät suhteet .	minulla	1	Ade
Niitten jälkeen kävi aikamoinen parku eri puolueissa kuinka meitä kohdeltiin näin , miten tää nyt näin meni , siinä meni meiltä vaalivoitto ja muuta tämmöstä .	meiltä	20	Abl
kenellä keskosista on oikeus jäädä henkiin ja kenellä ei .	kenellä	7	Ade
2. Kuhunkin alaan liittyvät tilastolliset muuttujat , niiden määrittely ja niiden erittelyyn käytettyjen nimikkeistöjen tasot esitetään liitteissä .	Kuhunkin	1	Ill
Minkä vuoksi he pynttäytyvät voidakseen kiskoa siideriä kantakapakassa keski-ikäisten juoppojen , vasta juomaluvan saaneiden pikkulasten ja alkoholisoituvien nuorten aikuisten joukossa ?	Minkä	0	Gen
Meil on puol viiteen .	Meil	0	Ade
Sil on tuuria näkyy , se kun oli semmonen peli vielä siinä , siihen piti kaks markkaa panna ni siitähän tuli useampi kymppi romahti .	Sil	0	Ade
Tai ehkä ne ovat jotenkin väärän kokoiset alun perinkin tähän sänkyyn , tähän huoneeseen , tähän asuntoon .	tähän	15	Ill
Heillä on rahaa vaikka toisille jakaa .	toisille	4	All
Nyt iski sellainen kevätkaipuu , ettei mitään rajaa . :(	mitään	6	Par
Mä otan tän , ota sä toi kun se on isompi .	tän	2	Gen
Kun traagisten perhetarinoiden taustoja aletaan setviä , muistelevat naapurit yleensä , että siinäpä oli hiljainen ja pidetty mies .	siinäpä	12	Ine
Esittelijänä minun on kuitenkin todettava , että meiltä on mennyt liian kauan päästä tähän , missä nyt olemme .	meiltä	7	Abl
Myös yksittäisiä tapauksia voidaan ottaa käsittelyyn kumman tahansa sopimuspuolen pyynnöstä .	kumman	6	Gen
Liikaa ei saa kiintyä mihinkään , ei kehenkään , ei paikkaan eikä kotiin , ei ihmiseen eikä eläimeen .	kehenkään	7	Ill
Sulla ittelläs mittään olluk kus sä tähän tulit .	ittelläs	1	Ade
Hänessä on jotain outoa .	Hänessä	0	Ine
Meidät ohjattiin suureen huoneeseen jossa oli kymmenkunta tiukkailmeistä miestä .	Meidät	0	Acc
siis työkö että tulis	työkö	1	Nom
Molemmilla on syystä tai syyttä - miten vain - kömpelyyden ja harrastajamaisuuden leima .	Molemmilla	0	Ade
Totesin että mikäs siinä sitten , olkoot , ja jatkoin matkaani .	mikäs	2	Nom
Ei tässä ole viime aikoina tullut paljon mitään luettua .	mitään	7	Par
Missähän mättää ?	Missähän	0	Ine
Kaisulla on hänelläkin paljon tekemistä .	hänelläkin	2	Ade
Hän ja muut velkaantumisen asiantuntijat kertovat Taloussanomille viisi tyhmyyttä , jolla velkaantunut ajaa itsensä yhä syvemmälle velkasuohon .	itsensä	13	Gen
( 3 ) Eräitä lopullisia tavoitteita ei ole pystytty saavuttamaan 15 päivän marraskuuta 2005 mennessä , jolloin päätöksen 1999/730/YUTP voimassaolon on määrä päättyä , ja toisia tavoitteita olisi vahvistettava edellä mainitun päivämäärän jälkeen .	Eräitä	3	Par
– Hoitotieteellisesti ajatellen potilaalla on oikeus kaikkeen tietoon , joka jollain tavalla liittyy hänen sairauteensa , professori Helena Leino-Kilpi pohti esitellessään voimavaraistumista tukevan potilasohjauksen teoreettista perustaa .	kaikkeen	6	Ill
Tässäkin kaupungissa ilmansuunnat ovat oikeastaan ihan väärin .	Tässäkin	0	Ine
Itse painiskelin samojen kysymysten äärellä jokunen vuosi sitten .	samojen	2	Gen
Sain näytteet eräältä meikkitaiteilijalta , joka on toiminut kosmetiikka-alalla yli kymmenen vuotta .	eräältä	2	Abl
On minultakin kysytty , miten voin ampua jonkun viattoman luontokappaleen .	minultakin	1	Abl
- Ei jumalauta mä tapan sut !	sut	5	Acc
Eiköhän tuosta meillekin murusia heltiä .	tuosta	1	Ela
Tämä koskee esimerkiksi vuonna 1979 hyväksyttyä luonnonvaraisten lintujen metsästystä koskevaa direktiiviä , jota yhteisön tuomioistuin myöhemmin kovensi neuvoston selän takana .	Tämä	0	Nom
Joidenkin tarkistusten tarkoituksena näyttää kuitenkin olevan niiden toimien hidastaminen tai jopa lopettaminen , jotka on toteutettu Euroopan satamien toiminnan vireyttämiseksi ja , kuten aiemmin mainitsin , sekä vientiämme muualle maailmaan helpottavan pitkänmatkan meriliikenteen mahdollisuuksien että lyhyenmatkan meriliikenteen parantamiseksi .	Joidenkin	0	Gen
Jari tunnustaa olevansa nyt siinä tilanteessa , mistä Joel tempoi itsensä irti keväällä 1994 .	itsensä	10	Gen
Me hyväksyimme vaatimuksen .	Me	0	Nom
Menekki yllätti meidätkin .	meidätkin	2	Acc
yrittäjät ovat panneet kaikkensa likoon palvellakseen asiakkaitaan mahdollisimman hyvin .	kaikkensa	3	Gen
Minä ostin graavia lohta ja uusia perunoita , ja tietysti tilliä .	Minä	0	Nom
Toi ihmettelee välillä että m- nukun selkä häneem päin	häneem	7	Ill
Keiden jumalia aiot tästä lähtien totella ?	tästä	3	Ela
Maavoimilla savugeneraattoreita asennettiin joihinkin panssarivaunuihin ; samoin tykistöllä on olemassa erityisiä savukranaatteja , joiden toiminta perustuu kuoren sisällä palavaan kemikaaliseokseen ; savu purkautuu pyrstössä olevien reikien kautta .	joihinkin	3	Ill
Merkkejä tästähän on jo olemassa .	tästähän	1	Ela
Jonkun verran pitää liikkua .	Jonkun	0	Gen
Kumpikaan ehdokkaista ei suostunut suoralta kädeltä mainitsemaan , mitä muutoksia heidän hallitusohjelmaansa on tehtävä vakavan talouskriisin johdosta .	Kumpikaan	0	Nom
on , pakko tässä kysyä että , mistä sinä nyt päädyit tämmöisiin ajatuksiin .	mistä	7	Ela
Kuten aiemminkin , The Black Eyed Peas on saanut tällekin albumilleen mukaan kuuluisia artisteja :	tällekin	9	All
Mä vien sut oikeuteen ja mä tapan sut !	sut	7	Acc
Kehotan teitä tarkastamaan ja varmistamaan saamienne tietojen todenperäisyyden , sillä minulle on kerrottu , että Lontooseen ei lennetä yhtään suoraa lentoa tällä viikolla .	teitä	1	Par
Niin poika upotti äitinsä suruun ; suruun , joka ajoi rekkakuskin koomaan , taittoi metrikaupalla teräskaidetta ja veti puoleensa vilkkuvia valoja , suruun , josta nousemiseksi olisi tarvittu kahdet kädet lisää .	josta	24	Ela
Mul oli semmost asiaa että eilen tuli tieto Jyväskylästä että ne on tullu ne kirjat .	Mul	0	Ade
Kerro Marjut keneltä sä oot saanu tän .	keneltä	2	Abl
Senaatin komitea etsii nyt papereita , jotka kertovat Hillary Clintonin osuudesta Madison Guarantyn tilien hoidossa .	jotka	6	Nom
Siirryin toiseen päähän takaisin , ja huomasin nyt siinä olevan samanlainen ovi , piilotettuna .	toiseen	1	Ill
Jos sydämessämme on rakkautta , saa läheisemmekin rakkautta meiltä .	meiltä	8	Abl
Tässä aikaisessa vaiheessa Thom Yorke soitti kitaraa ja lauloi , sekä kehitti kappaleiden sävellys- ja sanoitustaitoaan .	Tässä	0	Ine
Kenelle ei ole paljon annettu , siltä ei voi paljon vaatia .	Kenelle	0	All
Pitäisikö heidän nyt oikeasti ryhtyä keksimään joitain ihan uusia huippujuttuja ?	joitain	6	Par
Muistutan heille , että parlamentti taisteli kovasti saadakseen ihmisoikeuslausekkeen kaikkiin vapaakauppasopimuksiinsa .	kaikkiin	9	Ill
Okei , saan olla fiiliksissä tosta Suomen lipusta ...	tosta	5	Ela
Tässä ei ole mitään yllättävää .	Tässä	0	Ine
- Keitä te olette ja miksi tungette tänne iltamyöhällä ?	Keitä	1	Par
Kun tässä lähdettiin liikkeelle ja puhuttiin siitä mikäs , on käytännössä , se , niinkun se tavoite meillä , niin se oli kai , mää määrittelin sen lukijaksi kasvaminen .	mikäs	7	Nom
Mull on tossa viimene rulla saat sen se on kahenkymmenen neljän kuvan et sil nyt kuvaa jonkun verran jo ,	sil	13	Ade
Hollantilaiset kyllä osaa juhlia , jos on jäänyt jollekin epäselväksi ;)	jollekin	8	All
Jälleen valittiin kolme edustajaa kultakin paikkakunnalta .	kultakin	4	Abl
Mut et sellaist ihmisist mistä sä näät niinku et , et ne tykkää susta niinku iha omana ittenä ni sellasten kans on hirvee helppo olla .	susta	13	Ela
Juna lähti ajallaan , mikä hämmästytti minua , koska kaikkien tuhatkunnan matkustajan passit oli leimattava ja matkatavarat tarkastettava .	kaikkien	9	Gen
Mä luulen et sil on neljä	sil	3	Ade
Vim ( Vi IMproved ) on Bram Moolenaarin luoma Vi-editoriin perustuva avoimen lähdekoodin terminaalipohjainen tekstieditori , joka toimii monissa käyttöjärjestelmissä ja on erityisesti ohjelmoijien suosiossa .	monissa	18	Ine
Miltä mahtaisi tuntua ?	Miltä	0	Abl
Eräitä tase-eriä koskevia lisätietoja raportoidaan neljännesvuosittain kantatietoina .	Eräitä	0	Par
Mitä sinä haluat ?	Mitä	0	Par
Onko kenellekään tullut koskaan mieli kysyä itseltään ” Miksi minun pitäisi haluta seksiä ? ”	minun	9	Gen
Samat aiheet toistuivat myös kehittämisehdotuksissa , mikä kertoo uuden tutkinnon asiakaskunnan erilaisista koulutuskokemuksista ja -odotuksista sekä koulutusohjelmien tasoeroista : jossain on onnistuttu hyvin , toisaalla on vielä kehitettävää .	jossain	19	Ine
Näistä kaksi pääsuuntaa ovat sitoutuminen ja välinpitämättömyys .	Näistä	0	Ela
Tämä on minun ostamani ja viimeistä markkaa myöten minun maksamani .	minun	8	Gen
Mistä he pitävät ja mistä eivät .	mistä	4	Ela
Nuoret saavat kiittää kaikesta Muuramen kuntaa .	kaikesta	3	Ela
Eikä hällä ollu mitään papereit siinä itsellään	itsellään	6	Ade
Ketä Chanel enemmän kiinnostaa , voi hankkia Axel Madsenin kirjan Coco Chanel .	Ketä	0	Par
onks toi Sini kertonu kun mä puhuin vähä et mull on perjantain synttärit ni vois mennä johonki	johonki	16	Ill
