У п'ятницю , 27 листопада , на екрани Великої Британії виходить стрічка " Керол " , яка вже набула розголосу через свій сюжет – кохання двох жінок , пише газета Telegraph .	Британії	9	Gen
Я заказала книжку " Гаррі Поттер і прокляте дитя " 1 жовтня .	Гаррі	4	Nom
... Голубан затулив Зеленського , Дорн затулив Голубана , кулічі й паски затулили Дорна , сніг затулив кулічі й паски ...	Голубана	7	Acc
З найближчими приятелями ми почали якраз перед тим готуватися до перевороту , який мав вивільнити Західну Україну від радянського союзу .	Україну	16	Acc
Залюбки цитований в історичній літературі мандрівник ( 20-ті роки XV ст . ) Ланоа докладно оповідає про татарську людність району поміж Дністром та Дніпром , що перебувала тут під зверхністю Витовта , але із своїми тубільними князьками .	Витовта	30	Gen
Ось що весь час вибиває і " ріже " професійно та ідеально вибудуваний епатажний засексуалений публічний образ Даші Астаф’євої .	Астаф’євої	18	Gen
" Наша нарада в Криму знову підтвердила спільну рішучість зберегти й посилити в майбутній мирний період ту єдність мети і дій , що зробила в сучасній війні перемогу можливою і безперечною для Об'єднаних Націй .	Криму	4	Loc
З моменту відкриття в 1949 р . на нашій території перших алмазів у долині р . Базавлук цей мінерал потім траплявся у понад сотні місць .	Базавлук	16	Nom
Але Сосницький по камінчику , як Клапан , довбає і з усіх сил тримає себе , щоб не кинутись на неї з криком " ура " !	Клапан	6	Nom
У надзвичайно живописних ілюстраціях Софії Ус гармонійно поєднуються олія і акварель .	Софії	4	Gen
Всі вони будуть безпосередньо пов’язані з найневдалішою акцією в історії ОУН , а саме нападом на пошту в Городку 1932-го .	ОУН	10	Gen
У Чернівцях ми цілий тиждень виписували дані про столітні насадження із спеціальних книг в управлінні лісів .	Чернівцях	1	Loc
Це одна з надзвичайно важливих сцен у драмі Лесі Українки « Руфін і Прісцілла » .	Українки	9	Gen
Олександр - Зенон Курбас народився 25 лютого 1887-го в Самборі – тепер райцентр Львівської області .	Самборі	9	Loc
У 1959 році , коли Лі Куан Ю вперше став прем'єр - міністром , ВВП на душу населення в країні становив усього 400 дол . США .	Куан	6	Nom
Це перший відомий випадок загибелі силовика США в бою від приходу до влади президента Дональда Трампа 20 січня .	Дональда	14	Gen
Левко озирається довкола , зітхає немічно худими грудьми і манить Марфу пальцем за пошту .	Марфу	10	Acc
Іноді приходив Лаціс , латиш , котрий сформував у заповіднику експериментальний загін швидкого реаґування у боротьбі з браконьєрами .	Лаціс	2	Nom
Я вже й не кажу про те , що Руссо тоді , як мандрував Сковорода , Європа ще не знала , — та чи й був Сковорода у Женеві ?	Європа	16	Nom
Сьогодні зранку - зранечку , зранечку - зісвітаночку Славік залетів у школу й на коридорі , наче велосипедист у коня ( Equus ) , врізався в завучку Надію Петрівну Проскурню .	Надію	27	Acc
– Уважайте на нього , щоб не покинув університету і не вступив до театру , – звертається колишня актриса театру " Руська бесіда " у Львові Ванда Янович до Хоми Водяного .	Хоми	29	Gen
Гриць Купецький ( Борис Марков ) очолить « Українську Далекосхідну Січ » — перейменований СУМ , а Михайло Гнатів вирішить нелегально перейти радянський кордон .	СУМ	14	Acc
Пів пачки каро вистачило , щоби винайняти автобус від Ворохти до Чотирнадцятого кілометра , коли на ботанічну практику приїхали з Любліна Рената , Йоланта , Дорота , Аґнешка , Дорота , Малґося , Йоана і Беата .	Ворохти	9	Gen
Невже ти ніколи не чув про Павла Тичину , що цей автор всесоюзного і європейського маштабу є членом Вапліте і творець тих пісень , що їх щоразу співає гордість нашої Республіки капеля " Думка " ?	Тичину	7	Acc
Радий був би дістати від Вас дозвіл послати Вам свою : « Антологію римських поетів » , 2 ) « Камену » та 3 ) 1-у частину свого курсу історії нового українського письменства .	Камену	20	Acc
Під час репетицій Курбас передає своє бачення гри .	Курбас	3	Nom
Нині Валентин Щербачов часто супроводжує команду ветеранів київського « Динамо » , а не так давно був з ними в зоні АТО .	Валентин	1	Nom
Ми навіть були приготовили склад першого уряду Зеленої України , який складався з найбільш знаних українців на Далекому Сході поза межами СССР » , — згадував Купецький .	СССР	21	Gen
Село Половинчик згадується у циклі « Русалонька із 7 - В » Марини Павленко .	Павленко	13	Gen
Глави держав - учасників антигітлерівської коаліції – президент США Франклін Рузвельт , прем'єр - міністр Великої Британії Вінстон Черчилль та голова Ради народних комісарів СРСР Йосиф Сталін – протягом тижня обговорювали майбутній політичний устрій світу .	Франклін	9	Nom
1924-го Лесь Курбас працював на Одеській кіностудії .	Курбас	2	Nom
— Дядечку Левку , а од Мишка є письомце ?	Мишка	6	Gen
Марія Василівна не те що би хотіла попсувати результати життя й творчості малого негідника , ні — швидше майбутні дії Марії Василівни мали абсолютно виховний характер !	Василівна	1	Nom
І « Стодолю » з ними , подумав він , лиш уголос цього не сказав .	Стодолю	2	Acc
Повне ім’я Мікі — Раміль .	Раміль	4	Nom
У нас у Керелівці всі свято впевнені , що Тарас народився таки в нашому селі , а не в Моринцях .	Тарас	9	Nom
— Є також чутка , що до уряду втягають старого віком Льойда Джорджа , який , до речі , у своїх спогадах гостро висмівав Черчіля , як недотепу .	Льойда	11	Acc
У кафе навпроти нашого будинку хтось здав партію солдатських ґалуазів - капрал у пачках , незмінних від двадцять сьомого року .	ґалуазів	9	Gen
Через чотири роки колектив перевели до Харкова .	Харкова	6	Gen
Безладно розкидану по усьому Лондону де було ще лише три такі ж схожі за зовнішнім виглядом та розмірами будівлі .	Лондону	4	Loc
Мр . Фред Кетлінг поміркував , а потім нерадо запропонував від себе одно веселе місце на Бродвею з джез - бендом , неграми і зовсім голісінькими леді .	Кетлінг	3	Nom
Пів пачки каро вистачило , щоби винайняти автобус від Ворохти до Чотирнадцятого кілометра , коли на ботанічну практику приїхали з Любліна Рената , Йоланта , Дорота , Аґнешка , Дорота , Малґося , Йоана і Беата .	Малґося	31	Nom
В неокласичний французький рух не можна не зарахувати ще й Мусса , вояку й патріота , який , побиваючи « бошів » , дістав медаль , а виспівуванням війни дістав поетичну премію Сюллі Прюдома .	Мусса	10	Acc
Ніхто з попередників Дональда Трампа не відвідував Велику Британію так скоро після вступу на посаду .	Трампа	4	Gen
Спочатку ви кажете що в Могилянці заборонений плагіат , а потім показуєте на Дні ФПвН сцену з тарганом !	Могилянці	5	Loc
Мр . Морріс зайняв — № 847 , а мр . Кетлінг зайняв — № 848 .	Морріс	2	Nom
Теоретичні заняття проводив відомий Шпільмарк , онук знаменитого Шпільмарка .	Шпільмарка	8	Gen
На півночі ці групи обмежені річкою Пасьйон , на сході обмежені — низькою болотистою рівниною , а на півдні обмежені — невеликим , глибоким ( до 4 м ) яром струмка Сан - Фелікс .	Фелікс	33	Nom
Двох міністрів усунено , Бівербрук від'їде до Вашінгтона , здається до Воєнної Ради ; за те до кабінету уряду ввійшов відомий зі своєї большевицької агітації Кріппс як льорд печаті і міністр для Палати Громад .	Вашінгтона	7	Gen
У надзвичайно живописних ілюстраціях Софії Ус гармонійно поєднуються олія і акварель .	Ус	5	Gen
Також пошепки розповідали історії про жахливу книгу , першоджерело усіх єресей , автором якої був Гольдштейн і яка таємно поширювалася по всіх усюдах .	Гольдштейн	15	Nom
Тому , ніщо не може бути краще , ближче і тепліше саме українського ГП ;)	ГП	13	Gen
Тому я сиділа на підвіконні кав’ярні , пила міцний чорний чай з м’ятою і малювала вже внутрішній Казімеж .	Казімеж	17	Acc
Поруч була війна в Угорщині , на Закарпатті сконцентрувалися військові резерви .	Угорщині	4	Loc
Фактично півтора десятка смертників зводяться лише до трьох сяк - так помітних фігур : богомільного капітана , лайливого реднека і пані Деніелс .	Деніелс	21	Gen
На червону доріжку 37-річна " дівчина Бонда " вийшла в розшитому пайєтками чорному комбінезоні від " Armani " , виставивши на огляд чималу частину своїх грудей , але цнотливо закривши соски бретелями .	Бонда	6	Gen
Це Віня таке навіяв ?	Віня	1	Nom
Мр . Фред Кетлінг поміркував , а потім нерадо запропонував від себе одно веселе місце на Бродвею з джез - бендом , неграми і зовсім голісінькими леді .	Бродвею	16	Loc
Славіка , Слави , Славунчика !	Слави	2	Gen
Заходи розпочнуться 31 травня 2017 року о 9 . 30 у Сумах на площі Незалежності урочистим відкриттям і закінчаться 2 червня о 16 . 00 церемонією нагородження переможців змагань .	Сумах	11	Loc
Анжела просто хотіла , щоби АПП ( так ми називали історичку ) пояснила текст листівки .	Анжела	0	Nom
При спробі перетину Державного кордону на міжнародному пункті пропуску « Бачівськ » співробітниками Сумської митниці Державної фіскальної служби був зупинений рейсовий автобус Одеса - Москва .	Москва	24	Nom
Сьогодні , припустивши мерзенну й безсовісну думку про смерть Марії Василівни , члени педколективу , що делегували завучку з вінком , добряче зіпсували свою оцінку , яку Марія Василівна виставляла кожній особі на цій землі ( професійний рефлекс ) .	Василівни	10	Gen
Пізніше в неї був закоханий Ярослав Галан , тоді ще нормальний український драматург .	Галан	6	Nom
І прізвище хрещеного батька записано " Дяденко " , а в нас таких прізвищ нема .	Дяденко	6	Nom
Депутат Верховної Ради УРСР 3 - 4-го скликань .	УРСР	3	Gen
Оскільки жінка типу матері Ґракхів , або Жанни д'Арк робить , як казав Б . Шов — з овець мужчин , то тип Андромахи навпаки , робить з мужчин те , що робила з ними Цирцея ...	Ґракхів	4	Gen
« Єва чи еманципантка — між цими двома типами мусите вибирати » !	Єва	1	Nom
Там ви можете побачити що видання " в'язня Азкабану " готується на грудень 2017 року .	Азкабану	8	Gen
День народження ближчає , а книги Гаррі Поттера від ілюстратора Джима Кея все нема :((	Джима	10	Gen
Вже кілька років поспіль вони з бабцею зимували у Франківську .	Франківську	9	Loc
Йонатан Голслах — професор міжнародної політики у Вільному університеті Брюсселя .	Брюсселя	9	Gen
Але цим турбуватися не треба : Ваш Сковорода — все-таки дитя українського ґрунту .	Сковорода	7	Nom
Мати в « Науці » Руданського вчить свого сина стелитися , гнутися , коли того вимагає вигода .	Руданського	5	Gen
Автор проекту « Сімейний екстрім » , котрий ( через відсутність зацікавлення з боку наших телекомпаній ) проводить в екзотичних країнах південно - східної Азії .	Азії	24	Gen
Долучені до інших підпільників , яких спіткала така сама доля , ці троє націоналістів у середині 1930-х візьмуть участь у вишколах хорватських підпільників - « усташів » в Італії , а в 1937-му вирушать на Далекий Схід .	Італії	28	Loc
Саме в такій редакції ( просто підтримати , без подальших наслідків та дій ) радив поставити на голосування питання член земельної комісії Вадим Андрієвський .	Вадим	22	Nom
Адріан був моїм вчителем , був молодим і найкращим флористом на Західній Україні .	Адріан	0	Nom
Якраз тоді він подарував мені блок справжнього мальборо , переданого з Америки .	Америки	11	Gen
Київстар при зміні тарифного плану без попередження повісив мені замість гудків ... Океан Ельзи .	Ельзи	13	Gen
Так от , вони там робили горбик , а я взяв в Тішки біговел , і давай ганяти по тим горбикам .	Тішки	12	Gen
Модерністське розмежування політики і мистецтва не означало для Лесі Українки зречення громадянського служіння .	Українки	9	Gen
Міністерство Правди яке займалося виробництвом новин , освіти , розваг та образотворчого мистецтва .	Правди	1	Gen
Молдавські володарі , що , здавалося би , міцно сиділи в Білгороді на Дністрі , терпіли тут наявність „ татарського царевича “ ще до нової татарської хвилі часів Менглі - Герая .	Дністрі	13	Loc
Міський голова поставив на голосування пропозицію депутата Андрія Саука підтримати петицію і доручити юридичному відділу міськради звернутися до прокуратури та з позовом до суду .	Саука	8	Gen
Американські слідчі сподіваються переконати Пола Манафорта , екс-керівника передвиборчої кампанії президента США Дональда Трампа , співпрацювати з ними у розслідуванні можливої змови між штабом Трампа і Росією .	Трампа	24	Gen
У нашому класі були програвач і підбірка платівок з промовами Брежнєва .	Брежнєва	10	Gen
Марін Ле Пен , якій вдається поєднувати патріотичний пафос із московськими грошима , що зобов’язують її фактично працювати в інтересах недружньої до Франції зовнішньої сили , ідеально пасує до окресленої державної формації .	Франції	22	Gen
« Камену » Сосюрі не вислав , бо казали мені — він у Криму .	Криму	13	Loc
– Раніше зими були такі , що снігу випадало по півметра , а то й більше , – розповідає директор Колочавського музею в Міжгірському районі на Закарпатті Василь Дербак , 73 роки .	Дербак	28	Nom
ледь не забула вкотре сказати , що джуд лоу звісно ж неймовірний актор .	лоу	8	Nom
Мені щиро жаль - я любила Америку ( зараз поставлю собі New York , NY у виконанні Сестер Тельнюк : попрощатися з тою , яку любила ) .	Тельнюк	18	Nom
Інше вікно виходило на внутрішнє подвір’я нечинного костелу Миколая .	Миколая	8	Gen
Головні його запаси виявлено в осадових відкладах Українського щита у правобережній частині Полісся ( північна частина Волинської , Рівненської , Житомирської і Київської областей ) .	Полісся	12	Gen
Зокрема , депутат від " Народного фронту " Анатолій Дирів кнопкодавив під час голосування за законопроект № 5247 про призначення позачергових виборів Сєвєродонецької міської ради Луганської області .	Дирів	9	Nom
Її учителем української мови був Василь Щурат , біологію викладав Мельник , а географію викладала Олена Степанів .	Степанів	16	Nom
Ввечері 2 березня , якраз напередодні дня народження Насірова , у Феофанії відбулось чергове дійство , головними дійовими особами якого були слідчі і " напівпритомний , ледь живий " український чиновник .	Феофанії	11	Loc
– Яка основна пристрасть Жана на всю дію ?	Жана	4	Gen
Про скандал у пісочниці : як Гройсман відібрав в Омеляна паровозики , а також про Тіну Кароль та двері в Нарнію у шафі поліцейського — у новій серії « #@)₴?$0 з Майклом Щуром »	Тіну	15	Acc
Офіційно наш батальйон називався МУ і Пр .	Пр	6	Nom
А Волтер - це не просто чарівник в чорній сорочці і з усім цим набором магічних фетишів , які вони понапозичали з серіалів про чародійок .	Волтер	1	Nom
Для Тетяни Кисельчук , головного редактора bit.ua , вона стала кар’єрним викликом - на таких " посиденьках " їй запропонували посаду головного редактора , хоч подібного досвіду управління у неї не було .	Кисельчук	2	Gen
То Ліна , сестра , просила вам передати , я берегла до Різдва …	Ліна	1	Nom
Доки Більбо підбирав камінці , павук дістався до Бомбура — і незабаром ґномові прийшов би кінець .	Більбо	1	Nom
Гуртові яви живі , мальовничі , ефекти акустичні давали досконалу оману " , – відгукується на виступ у Львові критик Степан Чарнецький у часописі " Неділя " .	Чарнецький	21	Nom
Твір написаний середньоверхньонімецькою мовою на основі незакінченої поеми Кретьєна де Труа — « Персеваль , або повість про Грааль » ( фр . Perceval , le Conte du Graal ) .	Труа	10	Gen
Ці Умови доступні для ознайомлення на офіційному сайті ТОВ « Нова пошта » novaposhta.ua ( далі за текстом – Сайт ) .	novaposhta.ua	13	Nom
Глави держав - учасників антигітлерівської коаліції – президент США Франклін Рузвельт , прем'єр - міністр Великої Британії Вінстон Черчилль та голова Ради народних комісарів СРСР Йосиф Сталін – протягом тижня обговорювали майбутній політичний устрій світу .	Йосиф	25	Nom
Павла Петровича друга книжка ще in spe .	Павла	0	Gen
Багато разів військові медики будили Пуню вночі , вішали у петлю , відраховували певну кількість секунд , виймали з петлі і надавали невідкладну допомогу .	Пуню	5	Acc
Навіть якщо ця шуба колись зводила з розуму пів - Хрещатика ...	Хрещатика	10	Gen
Плов приготував біженець із Узбекистану .	Узбекистану	4	Gen
Якщо явні порушення законодавства і махінації у цій справі і були , то їх скоїли 10 років тому , виводячи землі з лісового фонду , вважає незалежний журналіст , відомий політичний оглядач Леонід Швець .	Швець	33	Nom
Славіка , Слави , Славунчика !	Славунчика	4	Gen
У свою чергу речник Манафорта Джейсон Малоні відмовився коментувати дані повідомлення .	Малоні	6	Nom
Ви почитайте , що цей дурень говорить у Івченка другому дурневі , якого автор чомусь називає « Руссо » .	Івченка	8	Gen
За тими повідомленнями , в сутичці в районі Якла цієї провінції загинули троє чільних діячів « Аль-Каїди » , а загалом до 41 бойовика , а також 16 цивільних людей .	Аль-Каїди	16	Gen
У царині міжнародної безпеки Велика Британія була партнером США у кожній масштабній інтервенції останніх 25 років : від Перської затоки до Афганістану , Іраку та Лівії .	Іраку	23	Gen
Погроза Володимира Винниченка перейти в сусідню літературу , писати для російського читача , краще здатного оцінити талановитого автора , спричинила серйозний конфлікт .	Винниченка	2	Gen
А саме на Арараті стояв чи не найпотужніший ретранслятор радіо « Свобода » .	Арараті	3	Loc
Навчальний курс пройшли 75 фахівців психолого - медико - педагогічних консультацій Запорізької області , де з липня 2016 року Благодійний Фонд Порошенка спільно з Міністерством освіти і науки України реалізує експериментальний проект по впровадженню практичної моделі інклюзивного освітнього середовища .	Порошенка	21	Gen
Вони ж не знають , що вони родичі , цим і відрізняються від наглих Серсеї з Джейме .	Серсеї	14	Gen
Але виникає думка , що все йде до втілення мрії тієї ж Дейнеріс - зламати колесо .	Дейнеріс	12	Gen
Юрко навмисне стріляв у стіну , поступово укладаючи вензель королеви Вікторії , бо так робив Шерлок Голмс .	Вікторії	10	Gen
Телескоп « Габбл » після сервісного обслуговування 1997 року , під час відокремлення від шатлу « Дискавері »	Дискавері	16	Nom
– Брата Жана , – говорить Бучма .	Бучма	6	Nom
" Курбас блискуче провів свій дебют і був нагороджений оплесками глядачів , – згадує актриса Ганна Юрчакова виступ театру " Руська бесіда " у Самборі 1912 року .	Самборі	24	Loc
Таким же чином « забув » у власному гаманці пакет з амфетаміном і 37-річний громадянин Молдови .	Молдови	15	Gen
У Сопоті я ходив ранковим холодним берегом , шукаючи рибалок зі свіжою рибою .	Сопоті	1	Loc
Князь подумав , що ми якісь дуже серйозні люди зі Львова , бо лише там нормальні бандити дозволяють собі не встидатися української .	Князь	0	Nom
Соболевський і Яґіч здебільшого не виходили за рамці філологічної школи , хоча перший також приділяв увагу дослідженню діалектів .	Соболевський	0	Nom
В неокласичний французький рух не можна не зарахувати ще й Мусса , вояку й патріота , який , побиваючи « бошів » , дістав медаль , а виспівуванням війни дістав поетичну премію Сюллі Прюдома .	Сюллі	32	Gen
Аушвіц став для світу символом Голокосту , геноциду й терору .	Аушвіц	0	Nom
Нині покійний український дисидент Леонід Плющ казав про « позаморальні демократії » , що формуються як у розвинених капіталістичних країнах , так і в третьому світі .	Леонід	4	Nom
В Люшневатій біля Витовтового броду на Першотравенщині знайдено було недавно плиту з написом , на жаль , знищеним при тому ( відомості Одеської Краєвої Інспектури Охорони Пам’ятників матеріяльної культури ) .	Першотравенщині	6	Loc
Вінстон встромив кінчик пера у ручку для пера та облизав його щоб позбутися масткого бруду .	Вінстон	0	Nom
Щодо розцяцькованого похоронного вінка в руках завучки Надії Петрівни Проскурні й загалом цієї пишної історії , то всі дороги вели до дев’ятикласника Ярослава Копчука .	Ярослава	22	Gen
Господарями кордону було подружжя Салтикових .	Салтикових	4	Gen
— Англійський король приняв на авдієнції новоіменованого мін . Стеффорда Кріппса і тим наче підкреслив його значення .	Кріппса	10	Acc
У 1949 році , зазнавши поразки від комуністичних збройних формувань Мао Цзедуна , підтримуваних СРСР , на острів Тайвань із материка втік очільник Гоміньдану генералісимус Чан Кайші .	Тайвань	18	Nom
Карачапов , бережіться !	Карачапов	0	Nom
У 1937 році в Берліні відбуваються переговори Коновальця та генерала Миколи Капустянського з представниками японського посольства й генштабу .	Берліні	4	Loc
Гриць Купецький ( Борис Марков ) очолить « Українську Далекосхідну Січ » — перейменований СУМ , а Михайло Гнатів вирішить нелегально перейти радянський кордон .	Марков	4	Nom
Один близький товариш позичив у мене дуже багато грошей і втік до Америки .	Америки	12	Gen
У місті Бучачі якийсь час діяли водночас 2 ГЕС : одна називалася міською ( вважалася комунальною ) , інша називалася — « на Топольках » , яка після відновлення діє й нині .	Бучачі	2	Loc
А для нас Боб Марлі якраз тоді був найголовнішою музикою , ми проживали своє реґґі .	Боб	3	Nom
В старшого лейтенанта Окатова коліна згиналися в обидва боки .	Окатова	3	Gen
З вагона потяга Львів — Адлер я дивився на Східну Україну .	Україну	10	Acc
Вуйко Влодко телефонував до Франківська татові , щоби він переконав мене не відмовлятися від військової підготовки .	Франківська	4	Gen
Важливо зберігати санкційну політику ЄС щодо РФ до повного відновлення суверенітету і територіальної цілісності України , включно з Кримом	ЄС	4	Gen
Щодо розцяцькованого похоронного вінка в руках завучки Надії Петрівни Проскурні й загалом цієї пишної історії , то всі дороги вели до дев’ятикласника Ярослава Копчука .	Надії	7	Gen
А глава Національного банку Валерія Гонтарєва заявляє , що Міжнародний валютний фонд надіслав фінальну версію меморандуму співпраці 1 березня .	Валерія	4	Nom
У домі римського патриція Руфіна була прегарна фреска , зображення Венери та Адоніса .	Венери	10	Gen
Перший поїзд до Сибіру був кримінальним .	Сибіру	3	Gen
ВВП на душу населення Тайваню ( $ 145 ) тоді мало відрізнявся від Ефіопії або Сомалі .	Ефіопії	13	Gen
Регіт стих ; усі похнюпили очі у землю ; одна тільки Галя гостро дивилася на всіх гультяїв — і червона краска грала на її щоках , тоді як серце підкидалося в грудях , а груди поривчато дихали .	Галя	11	Nom
Олександр - Зенон Курбас народився 25 лютого 1887-го в Самборі – тепер райцентр Львівської області .	Зенон	2	Nom
У червні музиканти відвідали Переяслав-Хмельницький та виступили на фестивалі « Рок - Булава » .	Переяслав-Хмельницький	4	Acc
Юра звучить по-нашому , тому це ім’я підійшло братові .	Юра	0	Nom
АПП , зауваживши , що Пуня кусає під партою канапку , дозволила йому їсти відкрито на її уроках .	АПП	0	Nom
Її учителем української мови був Василь Щурат , біологію викладав Мельник , а географію викладала Олена Степанів .	Мельник	10	Nom
Клод Сімон , Гемінґвей , Бернанос , Мальро , ті згадані вище відомі письменники були сучасниками або майже сучасниками подій громадянської війни .	Мальро	7	Nom
Режисер звертає увагу на танцівницю Валентину Чистякову .	Валентину	5	Acc
З них випливає , що хрестив Тараса піп Олексій Базаринський ( Кониський пише - Іван Базаринський ) .	Олексій	8	Nom
Дуже задоволена була зі свого партнера Катерина Рубчакова , яка грала Анну .	Анну	11	Acc
ТОКІО , 21 лютого .	ТОКІО	0	Nom
Загалом Валентин Щербачов є автором 5 книг про спорт та 42 фільмів про екстремальні експедиції .	Валентин	1	Nom
Рятує фільм знову Девід у виконанні Майкла Фассбендера .	Девід	3	Nom
На півночі ці групи обмежені річкою Пасьйон , на сході обмежені — низькою болотистою рівниною , а на півдні обмежені — невеликим , глибоким ( до 4 м ) яром струмка Сан - Фелікс .	Сан	31	Nom
В цю ж купу йде й сонетист Жак Шаню , якого преміювала навіть французька академія ( тільки цих своїх , релігійних , патріотичних і т . інш . вона й преміює ! ) .	Жак	7	Nom
— Є у мене тепер пан Коцький , то він тебе розірве .	Коцький	6	Nom
Згоріло все причандалля , яким ми прикрасили бар — великі довоєнні знимки Заліщиків , аванґардові плакати з Праги , мій домашній програвач з колекцією платівок , пучки макових головок , вінки часнику і снопики кримської марихуани .	Заліщиків	12	Gen
Вуйко Влодко відбував термін у Хабаровську , ще далі , ніж Чита і Чита - три .	Хабаровську	5	Loc
Вуйко Осип , який був начальником медичного поїзда УГА , а тому мав шанс закінчити медичні студії лише у Празі , добре розумів становище військових еміґрантів і скуповував картини без огляду на якість .	Празі	19	Loc
Тут мені на думку сплив уривок з фільму Мориса Шевальє під назвою “ Любов опівдні ” , в якому тато - детектив відгадав , що його донька закохалася , бо що не день стала мити голову .	Мориса	8	Gen
Власний оглядач видання Тім Робі назвав фільм " видатним твором американського мистецтва " .	Тім	3	Nom
Тету Міру це нервувало .	Міру	1	Acc
... Голубан затулив Зеленського , Дорн затулив Голубана , кулічі й паски затулили Дорна , сніг затулив кулічі й паски ...	Дорна	13	Acc
Від Красної Поляни до лісничівки на кордоні треба було ще двадцять кілометрів іти пішки .	Поляни	2	Gen
Доній написав черговий пост про Баригу та зраду .	Доній	0	Nom
У межах Українського щита , а також в окремих районах складчастої системи Українських Карпат і Кримських гір , Донецької складчастої області залягають й різноманітні напівдорогоцінні камені .	Карпат	13	Gen
Глухий та монотонний ритм важкої ходи солдатських чобіт формував тло для блеючого голосу Гольдштейна .	Гольдштейна	13	Gen
Провідною темою твору є пошуки Святого Грааля , проте ці пошуки несуть , насамперед , психологічний характер .	Грааля	6	Gen
Ви почитайте , що цей дурень говорить у Івченка другому дурневі , якого автор чомусь називає « Руссо » .	Руссо	17	Nom
Наша вчителька називала нас гнилою інтелігенцією , буржуазними націоналістами , і ми писали безконечні диктанти з книжок Брежнєва « Мала земля » , « Відродження » , « Цілина » і « Спогади » .	Брежнєва	17	Gen
Цей підрозділ формувався на основі добровольців від політичної партії " Братство " Дмитра Корчинського .	Дмитра	12	Gen
Тепер експеримент , коли 50 % понадпланових надходжень митних зборів направляються на ремонт доріг , розповсюджуємо на всю Україну	Україну	18	Acc
Сьогодні , припустивши мерзенну й безсовісну думку про смерть Марії Василівни , члени педколективу , що делегували завучку з вінком , добряче зіпсували свою оцінку , яку Марія Василівна виставляла кожній особі на цій землі ( професійний рефлекс ) .	Марії	9	Gen
Останні стверджують , що приймати Трампа в Букінгемському палаці — ганьба для королеви .	Трампа	5	Acc
У цьому позиції ОУН та Японії збігалися , адже на Далекому Сході , зокрема в Приамур’ї , українці становили величезну групу , а окрему територію , відому як Зелений Клин , ще на початку XX століття заселяли переважно вони .	Японії	5	Gen
Заходив вечір , і хлопець , поблукавши трохи по Шевченківському бульвару , вирішив таки навідати Надійку , що спинилась у подруг недалеко критого ринку .	Надійку	15	Acc
Якогось року татовою службовою машиною була п’ятидверна волга , списана зі станції швидкої допомоги , такі швидкі їздили перед появою рафіків .	волга	7	Nom
Художник Джим Кей взяв перерву на 1 рік .	Кей	2	Nom
Вона закінчила акторські студії в Ленінграді , він — двічі доктор фізики і математики .	Ленінграді	5	Loc
Байдужість Європи в 1930-х до подій в Іспанії , заплющування очей на те , що насправді відбувалося , здається , можна порівняти з байдужістю сучасної Європи до того , що відбувається на її теренах , в Україні .	Іспанії	7	Loc
Петро Порошенко та Гурбангули Бердимухамедов обговорили також питання залучення українських компаній до реалізації інфраструктурних проектів у Туркменістані .	Петро	0	Nom
Основою усього навчання була азбука Морзе .	Морзе	5	Gen
Посол Нолькен повідомив у Стокгольм , що Російська імперія на межі державного перевороту і що війська не будуть битися за Анну Леопольдівну .	Леопольдівну	21	Acc
У 1937 році в Берліні відбуваються переговори Коновальця та генерала Миколи Капустянського з представниками японського посольства й генштабу .	Миколи	10	Gen
Виїжджають до Білої Церкви , а потім виїжджають – до Умані .	Умані	10	Gen
Тільки тут можна побачити 12 видів ковили : ковилу Лессінга , тирсу , Граффа , азовську , Браунера , відокремлену , вузьколисту , дивну , пухнастолисту , облудну , українську та шорстку .	Лессінга	9	Gen
З них випливає , що хрестив Тараса піп Олексій Базаринський ( Кониський пише - Іван Базаринський ) .	Базаринський	15	Nom
70 років тому , 27 січня 1945 року браму табору Аушвіц відкрили солдати 100-ї Львівської дивізії з батальйону майбутнього Героя України , полтавчанина Анатолія Шапіро .	Анатолія	23	Gen
А через центр пролягає головний бульвар міста — бульвар Шевченка , рясно висаджений каштанами та вкладений плиткою .	Шевченка	9	Gen
Виступ Мирослава Мариновича на конференції National Media Talk « Роль незалежних медіа в Україні »	Мариновича	2	Gen
3 листопада 1937 року розстріляний у лісовому урочищі Сандармох у Карелії	Карелії	10	Loc
Телескоп « Габбл » після сервісного обслуговування 1997 року , під час відокремлення від шатлу « Дискавері »	Габбл	2	Nom
Непересічній події 100-літньої давнини присвячено ряд заходів , організованих Львівською митрополією УГКЦ та Національним музеєм ім . Андрея Шептицького ( м . Львів , пр . Свободи , 20 ) .	Львів	22	Nom
У цьому позиції ОУН та Японії збігалися , адже на Далекому Сході , зокрема в Приамур’ї , українці становили величезну групу , а окрему територію , відому як Зелений Клин , ще на початку XX століття заселяли переважно вони .	Приамур’ї	15	Loc
Це одна з надзвичайно важливих сцен у драмі Лесі Українки « Руфін і Прісцілла » .	Лесі	8	Gen
По мовчанці мр . Віллі Морріс запримітив мимоходом , що з нагоди неділі здалося б у відповідний спосіб перебути сьогоднішній вечір .	Віллі	4	Nom
Співрозмовники УП , знайомі з матеріалами кримінального провадження , звертають увагу на те , що єдиний із затриманих , хто мав відношення до МВС – Павло Полчанов .	Павло	25	Nom
А в нас існує Уляна Супрун - улюблена моя міністерка :)	Супрун	5	Nom
Історія Антея , готового повісити арфу на вербі й задовольнитися всього лиш хатнім визнанням ( значущий для цієї авторки мотив , не раз актуалізований у творах різних років ) , дає його землякам « добрий приклад » .	Антея	1	Gen
Співрозмовники УП , знайомі з матеріалами кримінального провадження , звертають увагу на те , що єдиний із затриманих , хто мав відношення до МВС – Павло Полчанов .	УП	1	Gen
« Камену » я Вам уже послав .	Камену	1	Acc
Із сірчаних руд Прикарпаття попутно можна вилучати сировину для виробництва стронцію .	Прикарпаття	3	Gen
Проект модернізації Ан - 32 , а також програми з ремонту бойових літаків та вертольотів були обговорені керівництвом ДК « Укроборонпром » з Головою делегації Збройних сил Республіки Бангладеш паном Наімом Насаном .	Ан	2	Gen
70 років тому , 27 січня 1945 року браму табору Аушвіц відкрили солдати 100-ї Львівської дивізії з батальйону майбутнього Героя України , полтавчанина Анатолія Шапіро .	Аушвіц	10	Nom
І відкіля це лихо взялося ? і чого воно до них вчепилося ? чим була Мотря Остапові ?.. чим вона тепер осталася ?..	Мотря	15	Nom
І раптом Адріян зрозумів , навіщо вона тут .	Адріян	2	Nom
Американські слідчі сподіваються переконати Пола Манафорта , екс-керівника передвиборчої кампанії президента США Дональда Трампа , співпрацювати з ними у розслідуванні можливої змови між штабом Трампа і Росією .	Манафорта	5	Acc
Оксана в « Боярині » на власному трагічному досвіді переконалася , що Росія та Україна – це антагоністичні світи , різні культурні традиції .	Росія	12	Nom
Чи славнозвісні 4 К є дійсно правдивим поглядом фашизму на ролю жінки - про це нижче .	К	3	Nom
Спочатку гори було видно навіть з вікна нашого помешкання на третьому поверсі у центрі Франківська , але потім десь на околицях побудували високі будинки , і панорама зникла .	Франківська	14	Gen
Омонівці з Одеси патрулювали всі центральні вулиці .	Одеси	2	Gen
Через кілька місяців після дембеля Раїль розбився на мотоциклі , їдучи до дівчини , з якою про все домовився .	Раїль	5	Nom
Ввечері 2 березня , якраз напередодні дня народження Насірова , у Феофанії відбулось чергове дійство , головними дійовими особами якого були слідчі і " напівпритомний , ледь живий " український чиновник .	Насірова	8	Gen
Крім того , читаючи цю статтю , О . Кандиба додав усно цілий ряд приміток і пояснень .	Кандиба	9	Nom
Двоє безпосередніх учасників нападу Гриць Купецький та Григорій Файда , а також провідник дрогобицької боївки УВО — ОУН Михайло Гнатів нелегально покинуть межі Польщі й опиняться на Заході .	ОУН	17	Gen
Їхні назви не випадкові і пов’язані з населеними пунктами ( часто невеличкими селами ) , біля яких було виявлено мінеральні джерела , — Свалява , Кваси , Поляна , Шаян .	Свалява	23	Nom
Джон Сіддгартга , мандрівний в’язень ноттінгемський — так Юрко Андрухович назвав його у присвяченій Джонові « Перверзії » .	Юрко	8	Nom
Там не було електрики , і вона щовечора декламувала Цвєтаєву при нафтовій лампі .	Цвєтаєву	9	Acc
Але тієї миті Більбо метнув .	Більбо	3	Nom
Твір написаний середньоверхньонімецькою мовою на основі незакінченої поеми Кретьєна де Труа — « Персеваль , або повість про Грааль » ( фр . Perceval , le Conte du Graal ) .	Грааль	18	Acc
Дуже вимовною видається її реакція на польську рецепцію « Кассандри » : « З польської статті мені найбільше сподобалось те , що « Кассандра » страшна для поляків .	Кассандри	9	Gen
— Є також чутка , що до уряду втягають старого віком Льойда Джорджа , який , до речі , у своїх спогадах гостро висмівав Черчіля , як недотепу .	Джорджа	12	Acc
Я навмисно туди йшла , оскільки дуже люблю цей район Кракова .	Кракова	10	Gen
Посол Нолькен видав необхідну суму .	Нолькен	1	Nom
Поїхав , - каже Юрій Васильович , - я й зо мною Платон Кречет , Галушка й дзвонар Квазимодський із собору Паризької богоматері .	Васильович	5	Nom
Сьогодні , припустивши мерзенну й безсовісну думку про смерть Марії Василівни , члени педколективу , що делегували завучку з вінком , добряче зіпсували свою оцінку , яку Марія Василівна виставляла кожній особі на цій землі ( професійний рефлекс ) .	Марія	27	Nom
" Курбас блискуче провів свій дебют і був нагороджений оплесками глядачів , – згадує актриса Ганна Юрчакова виступ театру " Руська бесіда " у Самборі 1912 року .	Юрчакова	16	Nom
Мальована кераміка Болгарії виявила лише дуже нечисленні форми на ніжці .	Болгарії	2	Gen
Те , що Харків - прифронтове місто , пізнати вже по тому , як публіка слухає " Ми , депортовані .	Харків	3	Nom
Тета Міра не любила свого радянського паспорта , бо у графі « место рождєнія » було записано — Скрентон , США .	Скрентон	18	Nom
Фацик був одним із тих трьох людей у моєму житті , яких я вважав досконалішими у всьому без винятку .	Фацик	0	Nom
Її предложено японцям , і представник ОУН відбув з послом Японії в Варшаві ґрунтовну розмову .	Варшаві	12	Loc
Прем’єр - міністр Великої Британії Тереза Мей першою серед іноземних лідерів зголосилася зустрітися з президентом Трампом після його інавгурації .	Британії	4	Gen
Модерністське розмежування політики і мистецтва не означало для Лесі Українки зречення громадянського служіння .	Лесі	8	Gen
Лі Куан Ю : « Корупція є однією з рис азійського способу життя .	Ю	2	Nom
І сама сторінка з записом про реєстрацію Тараса чомусь збереглася значно краще за попередні та наступні .	Тараса	7	Gen
Вінстон залишався стояти спиною до телезахисту .	Вінстон	0	Nom
До 2050 р . населення всіх великих регіонів світу , за винятком Африки , майже на чверть становитимуть люди у віці 60 років або старше .	Африки	12	Gen
У вже покійного Валентина Чемериса є чудовий роман “ Приречені на щастя ” про двох учених майбутнього , які вирішили погуляти на щойно відкритій планеті земного типу .	Чемериса	4	Gen
Тета Міра ціле життя пила дуже багато води , і ця заборона і страждання сестри призвели до цілковитої неможливості ковтання .	Міра	1	Nom
Дуже був подивований роз’ясненням Міністра Кириленка відносно нападів на звільнених керівників .	Кириленка	5	Gen
Вуйко Влодко відбував термін у Хабаровську , ще далі , ніж Чита і Чита - три .	Чита	11	Nom
Капітан Карельський був чесним офіцером .	Карельський	1	Nom
... Голубан затулив Зеленського , Дорн затулив Голубана , кулічі й паски затулили Дорна , сніг затулив кулічі й паски ...	Зеленського	3	Acc
Це й є те , чого вам не розкажуть про Харків у жодному ЗМІ .	Харків	10	Acc
У 1937 році в Берліні відбуваються переговори Коновальця та генерала Миколи Капустянського з представниками японського посольства й генштабу .	Коновальця	7	Gen
Усіма військовими справами ЗУНР відав ДСВС , що діяв до 9 червня 1919 року та поділявся на Військову канцелярію ДСВС і 16 відділів .	ДСВС	5	Nom
Також на водосховищі побудований спеціальний перелив в річку Вілію , за допомогою якого вода може переливатись , якщо її занадто багато .	Вілію	8	Acc
Найменше літніх людей буде в майбутньому в Африці — лише 10 % населення .	Африці	7	Loc
Розвиток залізниці на початку XIX ст . зробив доступними для багатьох людей поїздки на морські узбережжя , де були громадські курорти Європи , а також до зон відпочинку з термальними водами в Баден - Бадені .	Бадені	34	Loc
Крім українських медиків , на Сумщину завітають команди із країн Прибалтики , Польщі , Молдови , Білорусі , Казахстану » .	Прибалтики	10	Gen
У 17му році 3го ілюстрованого Поттера не буде .	Поттера	5	Gen
Мабуть , найбільш іронічним і потенційно небезпечнішим прикладом зв'язку між юнгізмом та неоязичництвом виявилася та видатна роль , яку юнгівські твори зіграли у відродженні « Релігії германців » або нордичного язичництва в Європі , Англії та Північній Америці .	Англії	34	Loc
( “ Сибір неісходиму ” було нерішучою рукою закреслено густим чорним чорнилом , а вгорі тою ж рукою написано знову : “ Сибір неісходиму ” . )	Сибір	2	Acc
Свого часу глядачі не стримували сміху ( чи обурення — як хто ) , коли у “ Прометеї ” персонажі знімали шоломи на нерозвіданій планеті , мацали руками невідомі об’єкти різного ступеня живості тощо .	Прометеї	17	Loc
У 1995-му Сінгапур із 26_000 дол . США на душу населення обійшов Британію ( 19_700 ) .	Сінгапур	2	Nom
( Щербицьким Москва замінила Шелеста пізніше , в червні 1972-го , коли каток репресій уже був розкручений на повну . )	Шелеста	4	Acc
Японія признає португальську владу на Тіморі .	Тіморі	5	Loc
Якось знайомі з Америки запропонували їй влаштувати виставку Новаківського у Нью-Йорку .	Новаківського	8	Gen
Вперше ми побачили Джона у совєтській військовій шапці , на місці зірки був приліплений великий портрет Боба Марлі .	Марлі	17	Gen
Твір написаний середньоверхньонімецькою мовою на основі незакінченої поеми Кретьєна де Труа — « Персеваль , або повість про Грааль » ( фр . Perceval , le Conte du Graal ) .	Персеваль	13	Nom
Джеффрі Йохай , колишній зять Пола Манафорта - екс-голови кампанії президента США Дональда Трампа - зустрічався зі слідчими в рамках розслідування справи про можливе відмивання грошей чи податкові порушення під час співпраці Манафорта з Партією регіонів .	Джеффрі	0	Nom
Пізніше він переїде до Шанхая , де очолить українську громаду .	Шанхая	4	Gen
Будете жити під російськими прізвищами й не будете брати участі в житті української еміграції у Харбіні » , — заявив оунівцям полковник Акікуза , який спершу опікувався націоналістами .	Харбіні	15	Loc
" До Умані завітав представник села Дзензелівка і попросив нас приїхати до них на тиждень з виставами , – пише актор Василь Василько .	Дзензелівка	6	Nom
Пів пачки каро вистачило , щоби винайняти автобус від Ворохти до Чотирнадцятого кілометра , коли на ботанічну практику приїхали з Любліна Рената , Йоланта , Дорота , Аґнешка , Дорота , Малґося , Йоана і Беата .	Йоланта	23	Nom
Після Йордану ми знімали з неї прикраси , різали ялицю на окремі гілки і так спалювали у печі в кімнаті .	Йордану	1	Gen
Днями в одному ( інтернаціональному ) товаристві довелося стати свідком дискусії - а чи знала ж американська розвідка , що Росія готує війну проти України ?	Росія	20	Nom
Ваш Мик . Зеров	Зеров	3	Nom
У місті Київ з 2009 року працює дельфінарій " НЕМО " ТОВ " Нерум " , розташований у Голосіївському районі за адресою проспект Академіка Глушкова , 9 .	Нерум	13	Nom
Загальна кількість загиблих у провінції Сінд складає від 830 - 1,213 осіб .	Сінд	5	Nom
Треба ще більш рішуче відгородитися не лише від фемінізму ( амазонства ) , але й від чотирьох К , що відгомоном грають навіть серед тих , які того зрікаються .	К	17	Gen
Одарка почала й собі на Гната .	Одарка	0	Nom
Певною мірою це стосується також Покуття , Буковини , Волині та Поділля .	Покуття	5	Gen
Якраз тоді у нашому місті вперше з’явився Джон .	Джон	7	Nom
Також , група СКМ , кінцевим бенефіціаром якої є бізнесмен Ринат Ахметов , заявляє , що її підприємства на тимчасово неконтрольованих територіях Донецької та Луганської областей будуть продовжувати працювати відповідно до законодавства України .	СКМ	3	Nom
Колумбієць був сусідом Маркеса через паркан , а болівієць боявся , коли на Менчилі ми припалювали сиґарети від гарячого повітря над тубусом нафтової лампи .	Маркеса	3	Gen
При спробі перетину Державного кордону на міжнародному пункті пропуску « Бачівськ » співробітниками Сумської митниці Державної фіскальної служби був зупинений рейсовий автобус Одеса - Москва .	Одеса	22	Nom
Ще у ті часи , коли їх щойно почали експортувати з Куби , і ними були заповнені овочеві крамниці , і всі вважали їх якоюсь гидотою у порівнянні з дефіцитними помаранчами і мандаринами .	Куби	11	Gen
І сам Тарас писав , що народився в Керелівці .	Керелівці	8	Loc
У Стокгольмі дійшли висновку , що достатньо одного тільки виду шведських військ , щоб влада Анни Леопольдівни і німців зруйнувалася , а нова імператриця в подяку за допомогу щедро наділить шведського короля російськими землями .	Стокгольмі	1	Loc
Навіть святий Миколай залишав свої мандаринки для тети Міри у торбинці , прив’язаній до клямки її покою .	Міри	8	Gen
Крім українських медиків , на Сумщину завітають команди із країн Прибалтики , Польщі , Молдови , Білорусі , Казахстану » .	Казахстану	18	Gen
У п'ятницю , 27 листопада , на екрани Великої Британії виходить стрічка " Керол " , яка вже набула розголосу через свій сюжет – кохання двох жінок , пише газета Telegraph .	Керол	13	Nom
У Підлютому , де учениці гімназії проводили частину літніх вакацій поруч з патроном гімназії митрополитом Шептицьким , тета Міра ніколи не брала участі у ранкових дівчачих боях за право застеляти ліжко митрополита .	Підлютому	1	Loc
Про техніку виробу ніжок не можна говорити позитивно , бо тонка глина і висока техніка опрацювання не дозволяють на такі сліди додаткового заповнювання ніжок як у Югославії .	Югославії	26	Loc
Юрко хотів пофотографувати кілька старих будинків , призначених до знесення .	Юрко	0	Nom
Після третього ходу Пуня оголосив , що визнає себе переможеним і привітав чемпіона .	Пуня	3	Nom
У Юрка була ціла купа запраних вишуканих тонких білих сорочок з мереживами , перламутровими ґудзиками і вигаптуваними монограмами , які не хотів брати ніхто з тих , кому призначалася допомога .	Юрка	1	Gen
На mi-carême ( середина посту ) санремосці сподівались знов карнавальних розривок , але їх перенесли в Бордігеру ( се маленьке місто коло Сан-Ремо , тепер воно вже так як передмістя , бо злилось віллами і садами з Сан-Ремо ) .	Сан-Ремо	22	Gen
Непересічній події 100-літньої давнини присвячено ряд заходів , організованих Львівською митрополією УГКЦ та Національним музеєм ім . Андрея Шептицького ( м . Львів , пр . Свободи , 20 ) .	Шептицького	18	Gen
Мотря повернулася , вийшла .	Мотря	0	Nom
Дзядзьо і близько не міг знати про щось таке , але і не міг хоча би вдавати , що п’є за перемогу червоної армії в Угорщині .	Угорщині	25	Loc
Ви ж можете з ними балакати з англійським презирством , крізь зуби — і дивитися на них , як Монблан дивиться на Шамуні .	Шамуні	22	Acc
Спеціальну премію імені Майкла Джексона за досягнення у музичній кар’єрі вручили барбадоській виконавиці у стилі ритм-н-блюз Ріанні .	Майкла	3	Gen
На другому місці за популярністю запитів розташувалася наукова фантастика " Прибуття " , а на третьому місці розташувалася – режисерська робота Мела Гібсона , військова драма " З міркувань совісті " .	Мела	21	Gen
Петро Порошенко та Гурбангули Бердимухамедов обговорили також питання залучення українських компаній до реалізації інфраструктурних проектів у Туркменістані .	Туркменістані	16	Loc
Яґіч підсумовував уже 1884 р . : " Як не припускати для XI століття повного розвитку руських наріч , коли вже різні дрібниці їхні ясно прозирають із пам’яток .	Яґіч	0	Nom
Гуртові яви живі , мальовничі , ефекти акустичні давали досконалу оману " , – відгукується на виступ у Львові критик Степан Чарнецький у часописі " Неділя " .	Степан	20	Nom
Почнімо з того , що Київ не обмежується туристичними затертостями типу того - таки Хрещатикомайдану і Маріїнського парку .	Хрещатикомайдану	14	Gen
У мене Анжеліна Джолі відмовляється грати у фільмі .	Анжеліна	2	Nom
У листі також йдеться про те , що Валентин Щербачов має намір відстоювати в суді свою професійну честь і гідність .	Валентин	8	Nom
Вітайте Сосюру ; низенький уклін Хвильовому ( хай їде з Харкова ! ) і побажання всього найкращого Вам —	Сосюру	1	Acc
Свого часу пів - Ірландії виїхало в штати , і чи згубило це Ірландію ?	Ірландії	4	Gen
Сьогодні , припустивши мерзенну й безсовісну думку про смерть Марії Василівни , члени педколективу , що делегували завучку з вінком , добряче зіпсували свою оцінку , яку Марія Василівна виставляла кожній особі на цій землі ( професійний рефлекс ) .	Василівна	28	Nom
Поїхав , - каже Юрій Васильович , - я й зо мною Платон Кречет , Галушка й дзвонар Квазимодський із собору Паризької богоматері .	богоматері	22	Gen
Нагадаємо , восени 2015-го року Куриленко народила первістка , сина Александра .	Александра	10	Acc
Про коломийську гімназію я знав від п . Мелетія Кічури , з яким часто і приязно зустрічаюся тут , у Києві .	Кічури	9	Gen
Подейкують , що за цю роль пані Бланшет може бути номінована на " Оскар " .	Оскар	13	Acc
День народження ближчає , а книги Гаррі Поттера від ілюстратора Джима Кея все нема :((	Поттера	7	Gen
Двоє безпосередніх учасників нападу Гриць Купецький та Григорій Файда , а також провідник дрогобицької боївки УВО — ОУН Михайло Гнатів нелегально покинуть межі Польщі й опиняться на Заході .	Гнатів	19	Nom
Двоє безпосередніх учасників нападу Гриць Купецький та Григорій Файда , а також провідник дрогобицької боївки УВО — ОУН Михайло Гнатів нелегально покинуть межі Польщі й опиняться на Заході .	УВО	15	Gen
І біжить на Хруща дивитись старе й мале .	Хруща	3	Acc
Про скандал у пісочниці : як Гройсман відібрав в Омеляна паровозики , а також про Тіну Кароль та двері в Нарнію у шафі поліцейського — у новій серії « #@)₴?$0 з Майклом Щуром »	Омеляна	9	Gen
Він іде на філософію ! – відповідає Хома .	Хома	7	Nom
Насамкінець маю сказати , що триптих із босхівської майстерні справді є лише однією із загадкових « копій » в експозиції Музею Ханенків .	Ханенків	21	Gen
Як в Голландії .	Голландії	2	Loc
Нині Валентин Щербачов часто супроводжує команду ветеранів київського « Динамо » , а не так давно був з ними в зоні АТО .	Щербачов	2	Nom
З купи грубого шутру я вхопив кілька камінців і з усього розмаху тричі вцілив у голову Біди з малої відстані .	Біди	16	Gen
Але всеодно в інтертелекома і покриття 3G краще , і кращі тарифи , про що писав я в сусідній темі	інтертелекома	3	Gen
8 - 10 лютого у Запоріжжі , в рамках соціальної програми дружини Президента України Марини Порошенко , проходив третій етап спеціалізованих тренінгів « Інклюзивна освіта – рівень свідомості нації .	Марини	14	Gen
Ліда спить .	Ліда	0	Nom
Японці заняли Тімор	Тімор	2	Acc
Щодо розцяцькованого похоронного вінка в руках завучки Надії Петрівни Проскурні й загалом цієї пишної історії , то всі дороги вели до дев’ятикласника Ярослава Копчука .	Петрівни	8	Gen
Я дуже чутлива до того , як події , що відбулися в Іспанії в 1936 – 1939-му , позначаються на сьогоденні .	Іспанії	12	Loc
Призначити ЛАБУША Віталія Васильовича головою Любашівської районної державної адміністрації Одеської області з 11 серпня 2017 року зі строком випробування один місяць та оплатою праці відповідно до законодавства .	ЛАБУША	1	Acc
Озброюємо броварських тітушок і направляємо їх захищати інтереси Сапожко та всієї броварської мафії , бо вони - патріоти , а хто проти них - агенти кремля і злочинці	Сапожко	8	Gen
Оскільки жінка типу матері Ґракхів , або Жанни д'Арк робить , як казав Б . Шов — з овець мужчин , то тип Андромахи навпаки , робить з мужчин те , що робила з ними Цирцея ...	Жанни	7	Gen
Їздили городами і співали про Марусеньку , про Дунай , про хустину і стрілецьку могилу .	Марусеньку	5	Acc
СТАРШИЙ БРАТ НАГЛЯДАЄ ЗА ТОБОЮ , казав напис , доки темні очі зазирали глибоко у їство Вінстона .	Вінстона	16	Gen
Далай - лама , що здійснював 10-денну поїздку в Австралію і Нову Зеландію , закликав пам'ятати про проблему глобальної зміни клімату .	Зеландію	12	Acc
Це , думав він з неоднозначною огидою — це був Лондон , головне місто Злітно - посадкової Смуги Один , третя з найбільш населених провінцій Океанії .	Океанії	25	Gen
Коли вже буде хоча б відремонтовано дитячий майданчик між вулицями Лагунової та Гагаріна , біля садочку " Ромашка " ?	Гагаріна	12	Gen
А Гельця мусить лишитися тут , у криївці , Гельця мусить жити .	Гельця	1	Nom
Все , що стосується бюджету , виплат зарплат , закупівель МАУ , нафтопереробки , ГОКів , феросплавних заводів , здійснювалося через банк .	МАУ	10	Gen
« Дуже важлива солідарна позиція країн ЄС , вже висловлена лідерами Німеччини , Франції , Великої Британії , що санкції мають тривати до повного виконання Мінських угод , тобто , до повернення Україною контролю над кордоном .	Британії	16	Gen
Ніхто з попередників Дональда Трампа не відвідував Велику Британію так скоро після вступу на посаду .	Дональда	3	Gen
Також в Центрі зберігається особиста бібліотека I . М . Гончара , що нараховує 2_750 книг .	I	6	Gen
Тут мені на думку сплив уривок з фільму Мориса Шевальє під назвою “ Любов опівдні ” , в якому тато - детектив відгадав , що його донька закохалася , бо що не день стала мити голову .	Шевальє	9	Gen
Оскільки жінка типу матері Ґракхів , або Жанни д'Арк робить , як казав Б . Шов — з овець мужчин , то тип Андромахи навпаки , робить з мужчин те , що робила з ними Цирцея ...	д'Арк	8	Gen
Ви можете здійснювати платежі через Інтернет - банк Приват24 , додатки Privat24 , SMS - банкінг , термінали самообслуговування , банкомати , у відділеннях , зателефонувавши на номер 3700 .	Приват24	8	Acc
Чому японці хотіли говорити про українські справи саме у Варшаві , годі сказати , але можна здогадуватись , що саме там знаходились найбільш досвідчені в українській проблемі люди » , — згадував керівник політичної референтури ОУН Дмитро Андрієвський .	ОУН	35	Gen
Трава була настільки яскравішою від нашої , наскільки у Прибалтиці блідіша .	Прибалтиці	9	Loc
Тоді тета Міра ледве вижила .	Міра	2	Nom
Шановна " А-ба-ба ... " , чи плануєте випустити оновлене видання " Фантастичних звірів " Ролінґ з додатковою інформацією про 6 нових звірят , новою передмовою Ньюта та новими ілюстраціями ?	Ньюта	26	Gen
— Ще тому кілька днів спротивився прем'єр Великої Британії , Черчіль всяким змінам у свому кабінеті , а сьогодні вже є вістка , що в уряді Черчіля проведені зміни .	Черчіль	10	Nom
Телескоп названо на честь Едвіна Габбла .	Едвіна	4	Gen
Народний художник УРСР ( 1956 ) .	УРСР	2	Gen
Суцільності « Кларнетів » вона не має , але « Плуг » перевершить .	Плуг	10	Acc
" За даними джерел , Мінюст домагається співпраці від Йохая у зв'язку з розслідуванням справи Манафорта через можливе відмивання коштів чи податкові порушення під час його співпраці з проросійськими партіями в Україні " , - зазначає видання .	Йохая	9	Gen
Проте недарма показали момент , де йшла мова ніби Рейгар таємно обвінчався з Ліанною , отже Джон Сноу законний і легітимний спадкоємець залізного трону .	Сноу	17	Nom
Тета Міра була сестрою мого діда Богдана , маминого тата .	Богдана	6	Gen
Довший час ми виглядали в них як пропащі європейці в опіумних притонах Індокитаю .	Індокитаю	12	Gen
Натомість Зілинський , прекрасний діалектолог , де-не-де у своїх діалектних дослідженнях наважувався робити висновки історичного ґатунку , що ніяк не підтверджувалися пам’ятками й залишалися чистісінькими спекуляціями ( які він сам пізніше мусив спростовувати ) .	Зілинський	1	Nom
Якраз у листопаді п’ятдесят шостого загинув дідо Мар’яни .	Мар’яни	7	Gen
Який руйнівний вплив має на статеві взаємини неприємний запах з рота , бачимо вже в настановах Корану , де є цілий параграф , що дозволяє дружині розвестися зі своїм чоловіком , коли в того повсякчас смердить із рота .	Корану	16	Gen
Вони познайомилися з бабцею у Читі .	Читі	5	Loc
Якось знайомі з Америки запропонували їй влаштувати виставку Новаківського у Нью-Йорку .	Америки	3	Gen
Хруща ведуть !.. " — викрикують з усіх боків по селу .	Хруща	0	Acc
Води Сивашу багаті на кухонну та інші солі .	Сивашу	1	Gen
Каракєджбі і цього було замало , він визнав мене після спеціальної перевірки — за п’ятнадцять секунд треба було знайти острів Робінзона Крузо .	Робінзона	20	Gen
Але вона послухала Тіріона і допомогла Джону .	Тіріона	3	Acc
Господи ! і за що ти мене отак караєш на сім світі ? — скрикнула Мотря і знову залилась сльозами .	Мотря	15	Nom
Однак в уряді Лі Куан Ю прекрасно розуміли , що « європейську кашу » зі « східних інгредієнтів » не звариш .	Лі	3	Gen
Я запропонував йому покурити добрих сиґарет , якраз мав подаровану пачку не знаного у нас житану .	житану	15	Gen
Джеффрі Йохай , колишній зять Пола Манафорта - екс-голови кампанії президента США Дональда Трампа - зустрічався зі слідчими в рамках розслідування справи про можливе відмивання грошей чи податкові порушення під час співпраці Манафорта з Партією регіонів .	Манафорта	6	Gen
Дівчинка навчилась вирізати ножицями гнійні рани , заки три дні чекала на Каракєджбу , якого посадили на губу за те , що зачинив кількох нестаранних солдатів у пивниці з відкритими бочками лізолу .	Каракєджбу	12	Acc
У нас Шабунін і кардинал Любомир Гузар , то вже близькі порівнювані величини ?	Шабунін	2	Nom
За Теона чи Яру ?	Яру	3	Acc
Ще одного близького приятеля Лариси Косач , перекладача Максима Славинського , замученого по другій світовій у радянській тюрмі , звинувачено в тому , що « опинився в таборі буржуазно - націоналістичної еміграції у Празі » .	Лариси	4	Gen
Нагадуємо , Аушвіц - один із найбільших концентраційних таборів нацистської Німеччини , який розташували на території Польщі ( біля м . Освенцим ) впродовж 1940 - 1945 рр .	Аушвіц	2	Nom
Раніше в неділю в Ємені засоби інформації цитували слова неназваних єменських посадовців про те , що в операції у провінції Аль-Бейда брали участь кілька вертольотів .	Ємені	4	Loc
Єдиний адекватний член екіпажу корабля “ Заповіт ” ( якщо не брати до уваги героя Джеймса Франко ) — ШІ - автопілот , яку тупі людиська посилають під три чорти , назвавши кілька циферок .	Франко	16	Acc
В одній з авдиторій стояло антикварне піаніно « Вайнбах » без половини необхідних струн , і ми з Фациком і Мациком грали в шість рук пісні « Бітлз » із самвидавівських фотокопій нот .	Бітлз	27	Gen
Поїхав , - каже Юрій Васильович , - я й зо мною Платон Кречет , Галушка й дзвонар Квазимодський із собору Паризької богоматері .	Галушка	15	Nom
Серед воїнів , які пройшли вогняне горнило Афганістану , міститься більш ніж 160 тисяч наших земляків	Афганістану	7	Gen
Гнат наскоро робить з комори ( що через сіни ) хату , ставить стола , лави , стільці , чіпляє в куті кілька образів і перебирається з Марією на самостійне господарювання .	Гнат	0	Nom
Вуйко Влодко відбував термін у Хабаровську , ще далі , ніж Чита і Чита - три .	Влодко	1	Nom
Марія Василівна не те що би хотіла попсувати результати життя й творчості малого негідника , ні — швидше майбутні дії Марії Василівни мали абсолютно виховний характер !	Марії	20	Gen
Варто зазначити , що Валентин Щербачов — володар відзнаки « Всенародне визнання » Спілки журналістів України , у 1992 - 1999 роках очолював Федерацію спортивних журналістів України .	Валентин	4	Nom
В Ужгороді його застрелив совєтський офіцер .	Ужгороді	1	Loc
За 9 км північніше від АЕС проходить залізнична лінія Шепетівка — Здолбунів — Львів , на якій розташована залізнична станція Кривин , до якої примикає під'їзна залізнична колія електростанції .	Шепетівка	9	Nom
Сей Корраді знаменитий на всю гімназію своїм пустуванням .	Корраді	1	Nom
Він цінний , змістовний , це не порожнє місце , як динамічний Сковорода Поліщука або лубенський телеграфіст Івченка ( « В тенетах далечини » ) .	Івченка	17	Gen
Як завжди , обличчя Еммануеля Гольдштейна , Ворога Народу , спалахнуло на екрані .	Еммануеля	4	Gen
Звичайно Ваші книги роздягають мою пенсійну картку але я це роблю з гордістю за мою Україну .	Україну	15	Acc
" Курбас блискуче провів свій дебют і був нагороджений оплесками глядачів , – згадує актриса Ганна Юрчакова виступ театру " Руська бесіда " у Самборі 1912 року .	Курбас	1	Nom
Вітаю Україну зі світлим святом Стрітення Господнього !	Україну	1	Acc
Того ж 1935 р . він прочитав цю доповідь на засіданні Історично - філологічного товариства в Празі .	Празі	16	Loc
Якось на Великдень Анжела знайшла у місті антирадянську машинописну листівку .	Великдень	2	Acc
Наталья плакала , бо це було втручанням у біоценоз .	Наталья	0	Nom
Саме запереченню потужного впливу Михайла Драгоманова « лесезнавці » присвятили дуже багато праці .	Драгоманова	5	Gen
Пуня зробив ще один хід і сказав , що дружня нічия влаштувала б усіх .	Пуня	0	Nom
Посудина на ніжці є одною з характеристичних форм неолітичної паскової кераміки від середньоєвропейської рессенської групи до українського Трипілля , Болгарії і Диміні .	Болгарії	19	Gen
Згадайте лише як спіймали на хабарі екс-заступника міністра охорони здоров’я Романа Василишина , який довгий час до того працював головним лікарем Жовтневої лікарні в Києві ?	Василишина	11	Acc
Про скандал у пісочниці : як Гройсман відібрав в Омеляна паровозики , а також про Тіну Кароль та двері в Нарнію у шафі поліцейського — у новій серії « #@)₴?$0 з Майклом Щуром »	Гройсман	6	Nom
Спеціальну премію імені Майкла Джексона за досягнення у музичній кар’єрі вручили барбадоській виконавиці у стилі ритм-н-блюз Ріанні .	Джексона	4	Gen
Роланд - це не типовий непробивний герой , який всіх перемагає помахом руки з револьвером .	Роланд	0	Nom
І просто на підвіконні біля порепаної бегонії плямистої ( Begonia maculata ) Марія Василівна помішала майже вистиглий кминовий ( Carum carvi ) чайок у гарній блакитній чашечці з позолоченою окантовкою у формі листочків .	Марія	12	Nom
Зокрема частина подій повістей « Русалонька із 7 - В або прокляття роду Кулаківського » , « Русалонька із 7 - В проти русалоньки з Білокрилівського лісу » відбуваються в даному населеному пункті .	Кулаківського	13	Gen
Вінстон бачив О’Браєна можливо вже безліч разів протягом багатьох років .	О’Браєна	2	Acc
Навіть у Північній Ірляндії , де ірляндці не мають свого уряду , відносяться вони до англійців з неохотою .	Ірляндії	3	Loc
Марія від злості розривається .	Марія	0	Nom
Гнат мовчить .	Гнат	0	Nom
До речі буде запримітити , що мр . Віллі Морріс мав ресторан при Вестчестрі - авеню , а мр . Фред Кетлінг був босом у фабриці яринних консерв на 10-му стріті .	Вестчестрі	13	Loc
Пуня підірвав себе у війську .	Пуня	0	Nom
Хто такий Доленго ?	Доленго	2	Nom
Лайк , якщо цнотлива , репост , якщо вчишся у Могилянці .	Могилянці	10	Loc
Мотря й Оришка роздумували , розгадували ...	Мотря	0	Nom
Лесю Українку цензурували надзвичайно пильно , адже в радянському іконостасі вона мала постати бездоганною марксисткою , « пролетарською інтернаціоналісткою » , « другом робітників » , предтечею соціалістичного реалізму et cetera .	Українку	1	Acc
Кріппс буде вже тепер диктувати в Англії під музику Сталіна .	Англії	6	Loc
Поїхав , - каже Юрій Васильович , - я й зо мною Платон Кречет , Галушка й дзвонар Квазимодський із собору Паризької богоматері .	Кречет	13	Nom
У Франківську тоді було дуже сутужно з кавою .	Франківську	1	Loc
На mi-carême ( середина посту ) санремосці сподівались знов карнавальних розривок , але їх перенесли в Бордігеру ( се маленьке місто коло Сан-Ремо , тепер воно вже так як передмістя , бо злилось віллами і садами з Сан-Ремо ) .	Бордігеру	16	Acc
Однак тепер їхні політичні курси в питаннях Близького Сходу , Росії , зміни клімату та ролі ООН суттєво різняться .	ООН	16	Gen
І якщо її врода зроблена штучним шляхом , тоді всі Ваші Кіра Найтлі , Діана Крюгер , Наталі Портман , Кейт Хадсон без макаяжу тихий жах , а макаяж - це також штучність .	Найтлі	12	Nom
Скажімо , четвертий ряд , дев’яте місце у кінотеатрі « Спартак » під час сеансу на чотирнадцяту двадцять .	Спартак	10	Nom
Найглибші шахти світу знаходяться в Індії ( шахта « Чемпіон - Риф » ) та в ПАР : « Тау-Тона » , « Вітватерсранд » ( глибина понад 4 , 5 км ) .	ПАР	16	Loc
Вінстон різко отямив себе та сів пряміше .	Вінстон	0	Nom
На листопадових канікулах я відмовлявся записуватися у почесну варту біля пам’ятника чекістам , бо треба було хоч кілька днів побути в осінньому Делятині .	Делятині	22	Loc
У сусідських наймах не здобудеш тої повноцінної слави , якою винагороджують геніїв ; Антей мусить торкатися таки рідної землі , аби не втратити силу й обдарування .	Антей	13	Nom
Тоді Франківськ був подібний на окуповане місто .	Франківськ	1	Nom
Дзядзя відразу ж відправили до Станіслава з призначенням на перший поїзд до Сибіру .	Станіслава	5	Gen
Юрко навмисне стріляв у стіну , поступово укладаючи вензель королеви Вікторії , бо так робив Шерлок Голмс .	Юрко	0	Nom
Казала , що ночувала в Домахи , але злі язики говорили , що вона деінде проводила свої ночі .	Домахи	5	Gen
Політрук Маркідонов дозволив мені не конспектувати лекцій політзанять , бо я міг без помилки показати на політичній мапі світу столиці всіх країн — учасниць Варшавського блоку .	Маркідонов	1	Nom
Як не шепталися , що вони талановитіші від Вас , як не говорили , що з Вас лише « співець національного безсилля часів пролетарської революції » ( Семенко ) , — а за Вами плентаються в ар’єрґарді .	Семенко	27	Nom
Весь цей час я придивлявся до трави і молодого листя , щоби переконатися , що на Кавказі все інакше .	Кавказі	16	Loc
Призначити ЛАБУША Віталія Васильовича головою Любашівської районної державної адміністрації Одеської області з 11 серпня 2017 року зі строком випробування один місяць та оплатою праці відповідно до законодавства .	Віталія	2	Acc
Ще одного близького приятеля Лариси Косач , перекладача Максима Славинського , замученого по другій світовій у радянській тюрмі , звинувачено в тому , що « опинився в таборі буржуазно - націоналістичної еміграції у Празі » .	Косач	5	Gen
Прапорщик Деренько був начальником найпотужнішої радіостанції .	Деренько	1	Nom
Проведене у 2016 році дослідження Держстату виявило , що в 45 , 7 % домогосподарств грошей було достатньо , але заощаджень не робили , 43 , 2 % постійно відмовляли собі в найнеобхіднішому , окрім харчування .	Держстату	5	Gen
Що Ви не пускаєте « Сковороди » , це добре : « Сковорода » потребує окремого видання .	Сковорода	12	Nom
Старший сержант Каракєджба місяць перед тим начитався ротапринтних матеріалів для службового користування про методику вишколу американських зелених беретів .	Каракєджба	2	Nom
До варшавської зустрічі було підготовлено й окремий пакет пропозицій , одна з яких передбачала допомогу японців акціям ОУН у Маньчжурії .	ОУН	17	Gen
Петро Порошенко та Гурбангули Бердимухамедов обговорили також питання залучення українських компаній до реалізації інфраструктурних проектів у Туркменістані .	Порошенко	1	Nom
Міжнародна авіакосмічна виставка AeroIndia проводиться в Індії вже в одинадцяте і за цей час стала центром з розвитку співпраці оборонних підприємств авіаційної галузі в усій Азії .	Індії	6	Loc
( Пасковою керамікою О . Кандиба називав неолітичну « Вапсікегатік » ) .	Кандиба	5	Nom
Одного з найвідоміших спортивних коментаторів України Валентина Щербачова відсторонено від коментування матчів « Євро - 2016 » .	Щербачова	7	Acc
Дівчина мордувала кошеня ( дали 2 роки умовно ) - народ злиться бо мало ; Коломойський наєбав країну на 150 млрд - народ мовчить .	Коломойський	15	Nom
— Ще тому кілька днів спротивився прем'єр Великої Британії , Черчіль всяким змінам у свому кабінеті , а сьогодні вже є вістка , що в уряді Черчіля проведені зміни .	Черчіля	26	Gen
Нас запросили до столу Князя .	Князя	4	Gen
На Київщині правоохоронці затримали 15 учасників злочинного угруповання , які тримали комплекс борделів в Києві і області .	Київщині	1	Loc
Британські фінансові уряди намагаються стягнути воєнні податки з англійців - плутократів , які з вибухом війни втікли до ЗДА , щоб не брати участі у боях .	ЗДА	18	Gen
Ой , Гнат , Гнат !	Гнат	2	Nom
Справа не лише в тому , що , записавшися в хор римського Мецената , співець зраджує свій край і свою мову .	Мецената	12	Gen
Фільм зняли за романом Патрісії Хайсміт " Ціна солі " , який вийшов друком ще у 1951 році .	Патрісії	4	Gen
Припинивши співпрацю з японцями , оунівці інтегруються в українське життя Харбіна .	Харбіна	10	Gen
Тета Міра привчила нас з братом до ґрейпфрутів .	Міра	1	Nom
Ба більше : було ініційоване розслідування проти дружини і сина самого Лі Куан Ю – з допитами і всіма необхідними за законом процедурами .	Лі	11	Gen
Він відчайдушно намагався витиснути з себе хоча б трохи дитячих спогадів які б дали змогу дізнатися йому чи завжди Лондон був таким .	Лондон	19	Nom
На півночі ці групи обмежені річкою Пасьйон , на сході обмежені — низькою болотистою рівниною , а на півдні обмежені — невеликим , глибоким ( до 4 м ) яром струмка Сан - Фелікс .	Пасьйон	6	Nom
Клод Сімон , Гемінґвей , Бернанос , Мальро , ті згадані вище відомі письменники були сучасниками або майже сучасниками подій громадянської війни .	Бернанос	5	Nom
( Щодо марксизму , захоплення яким нібито знівелювало « згубний » вплив Драгоманова , то коментаторам зоставалося тільки сподіватися , ніби читачі обмежаться лише їхніми примітками .	Драгоманова	12	Gen
Приїхавши після Чити до Делятина , тато кілька місяців удавав у школі , що не розуміє української .	Чити	2	Gen
Коли Сосницький зривається згори й потім понуро сидить , мені стає нудно .	Сосницький	1	Nom
Поруч була війна в Угорщині , на Закарпатті сконцентрувалися військові резерви .	Закарпатті	7	Loc
Найглибші шахти світу знаходяться в Індії ( шахта « Чемпіон - Риф » ) та в ПАР : « Тау-Тона » , « Вітватерсранд » ( глибина понад 4 , 5 км ) .	Тау-Тона	19	Nom
У нас , виходить , закінчилося безробіття , з кадрами напряжонка , й Ольгу Петрівну Лішик ми замінити ніким не можемо .	Петрівну	14	Acc
Призначити Надзвичайного і Повноважного Посла України в Королівстві Таїланд БЕШТУ Андрія Петровича Надзвичайним і Повноважним Послом України в Республіці Союз М’янма за сумісництвом .	М’янма	20	Nom
З них випливає , що хрестив Тараса піп Олексій Базаринський ( Кониський пише - Іван Базаринський ) .	Тараса	6	Acc
Коли приїхав Антоні Міро з Іспанії , ми з Ігорем повели його саме туди , бо на міську каву Міро запізнився .	Міро	19	Nom
А глава Національного банку Валерія Гонтарєва заявляє , що Міжнародний валютний фонд надіслав фінальну версію меморандуму співпраці 1 березня .	Гонтарєва	5	Nom
Команди змагатимуться на території дитячого табору відпочинку « Зоряний » ПАТ « Сумихімпром » ( с . Вільшанка Сумського району ) .	Вільшанка	17	Nom
Як відомо , агенти ФБР провели обшук у будинку Пола Манафорта , вилучивши документи та інші матеріали .	Манафорта	10	Gen
Деніелс просто прожила найдовше , ото й усе .	Деніелс	0	Nom
У 2007 році доходи Еністон за підрахунками журналу Форбс склали $ 14 мільйонів .	Еністон	4	Gen
Прочитала на Вашому сайті про книгу " Сіроманець " Миколи Вінграновського .	Вінграновського	10	Gen
Гриць Купецький ( Борис Марков ) очолить « Українську Далекосхідну Січ » — перейменований СУМ , а Михайло Гнатів вирішить нелегально перейти радянський кордон .	Купецький	1	Nom
Я та й то плюнув на них у своїй « Камені » в примітках до латинських перекладів .	Камені	10	Loc
Для тих , хто в Варшаві : 1 лютого в Teatrze Polskim будуть - Сестри Тельнюк !	Тельнюк	15	Nom
– Уважайте на нього , щоб не покинув університету і не вступив до театру , – звертається колишня актриса театру " Руська бесіда " у Львові Ванда Янович до Хоми Водяного .	Ванда	26	Nom
Напередодні в ужгородському нічному клубі " KontraBass " Даша виступила в новому для себе амплуа – діджея .	Даша	8	Nom
А завдяки тому , що ячмінь не дуже боїться холодів , його сіють у Фінляндії аж біля Північного кола , в Тибеті й Непалі сіють — на захмарній висоті у пів - Евересту .	Непалі	23	Loc
У цьому позиції ОУН та Японії збігалися , адже на Далекому Сході , зокрема в Приамур’ї , українці становили величезну групу , а окрему територію , відому як Зелений Клин , ще на початку XX століття заселяли переважно вони .	ОУН	3	Gen
Державне підприємство « Конструкторське бюро „ Південне “ ім . М . К . Янгеля » було створено 1951 як конструкторський відділ Південного машинобудівного заводу з виробництва військових ракет .	Янгеля	14	Gen
Молдавські володарі , що , здавалося би , міцно сиділи в Білгороді на Дністрі , терпіли тут наявність „ татарського царевича “ ще до нової татарської хвилі часів Менглі - Герая .	Білгороді	11	Loc
А на Заході , як відомо , середній клас виокремлюють не так за номінальним доходом , як відносно доходів решти .	Заході	2	Loc
І чи ви не маєте в планах видати чудові вірші Тамари Коломієць ?	Коломієць	11	Gen
Як відомо , агенти ФБР провели обшук у будинку Пола Манафорта , вилучивши документи та інші матеріали .	ФБР	4	Gen
Раніше в неділю в Ємені засоби інформації цитували слова неназваних єменських посадовців про те , що в операції у провінції Аль-Бейда брали участь кілька вертольотів .	Аль-Бейда	20	Nom
Найглибші шахти світу знаходяться в Індії ( шахта « Чемпіон - Риф » ) та в ПАР : « Тау-Тона » , « Вітватерсранд » ( глибина понад 4 , 5 км ) .	Індії	5	Loc
А крайній південь АРК зайнятий Кримськими горами .	АРК	3	Gen
І не тільки про Харків .	Харків	4	Acc
1922 року заснував у Києві мистецьке об’єднання ” Березіль ” .	Києві	4	Loc
« Парціфаль » став джерелом для однойменної музичної драми Ріхарда Вагнера 1882 року .	Ріхарда	9	Gen
І якщо її врода зроблена штучним шляхом , тоді всі Ваші Кіра Найтлі , Діана Крюгер , Наталі Портман , Кейт Хадсон без макаяжу тихий жах , а макаяж - це також штучність .	Хадсон	21	Nom
Хотілося мститись на комусь , а що під рукою Гнат , то на нього все .	Гнат	9	Nom
І якщо її врода зроблена штучним шляхом , тоді всі Ваші Кіра Найтлі , Діана Крюгер , Наталі Портман , Кейт Хадсон без макаяжу тихий жах , а макаяж - це також штучність .	Кіра	11	Nom
ВВП на душу населення Тайваню ( $ 145 ) тоді мало відрізнявся від Ефіопії або Сомалі .	Тайваню	4	Gen
Я хотів би , щоб моїми устами зараз промовляв до вас Валерій Марченко , мій табірний побратим , який заплатив за своє вільне журналістське слово багатьма роками увʼязнення і мученицькою смертю .	Марченко	12	Nom
Попри те що більшість британців не приймають поглядів і політики нового президента США , Мей звернулася до колеги з теплими словами .	Мей	14	Nom
А завдяки тому , що ячмінь не дуже боїться холодів , його сіють у Фінляндії аж біля Північного кола , в Тибеті й Непалі сіють — на захмарній висоті у пів - Евересту .	Тибеті	21	Loc
Їхні назви не випадкові і пов’язані з населеними пунктами ( часто невеличкими селами ) , біля яких було виявлено мінеральні джерела , — Свалява , Кваси , Поляна , Шаян .	Шаян	29	Nom
Сині Марфині очі запливають слізьми і сяють угору на дядька Левка — ще синіші .	Левка	10	Acc
Це перший відомий випадок загибелі силовика США в бою від приходу до влади президента Дональда Трампа 20 січня .	Трампа	15	Gen
Пожовкло в Мотрі у віччю , заколихався світ , пішло все ходором ...	Мотрі	2	Gen
Твір написаний середньоверхньонімецькою мовою на основі незакінченої поеми Кретьєна де Труа — « Персеваль , або повість про Грааль » ( фр . Perceval , le Conte du Graal ) .	Кретьєна	8	Gen
Чому японці хотіли говорити про українські справи саме у Варшаві , годі сказати , але можна здогадуватись , що саме там знаходились найбільш досвідчені в українській проблемі люди » , — згадував керівник політичної референтури ОУН Дмитро Андрієвський .	Варшаві	9	Loc
Останній мешкав і працював у Варшаві , перебуваючи в тісному контакті з польським політикумом .	Варшаві	5	Loc
На моєму місці незримо стоять усі , хто , як і мої колеги з Українського католицького університету , творять сьогодні нову натхненну Україну .	Україну	22	Acc
Пуню лікували у полковій медчастині .	Пуню	0	Acc
Він був головним дяком у Станиславові , організатором дяківського руху на Галичині і редактором часопису « Дяківський Глас » .	Галичині	11	Loc
Мотря нічого не одказала , — тільки жалібно дивилася .	Мотря	0	Nom
— Остапа ...	Остапа	1	Gen
У Франківську вона коштувала щодня інакше , у межах двох копійок .	Франківську	1	Loc
Марія Василівна , як актриса після важкої ролі , інколи виходила з образу “ вчительки з великої літери ” й ставала тією , кого треба покарати .	Марія	0	Nom
Так , стрічка шикарно знята , музика від Джеда Курцеля традиційно чудова , а Фассбендер божить .	Джеда	8	Gen
Джон Сіддгартга , мандрівний в’язень ноттінгемський — так Юрко Андрухович назвав його у присвяченій Джонові « Перверзії » .	Джон	0	Nom
— З-під Манчжурії .	Манчжурії	2	Gen
У домі римського патриція Руфіна була прегарна фреска , зображення Венери та Адоніса .	Адоніса	12	Gen
Японія признає португальську владу на Тіморі .	Японія	0	Nom
Оскільки жінка типу матері Ґракхів , або Жанни д'Арк робить , як казав Б . Шов — з овець мужчин , то тип Андромахи навпаки , робить з мужчин те , що робила з ними Цирцея ...	Андромахи	23	Gen
У Читі він зійшовся з урками .	Читі	1	Loc
Проте я охочіше би більше часу провів у компанії Девіда , адже по той бік андроїда існує — суцільна біда , а не персонажі .	Девіда	9	Gen
Коли буде другий ілюстрований Поттер в Ашані ??	Ашані	6	Loc
Переконування українських родичів , що Майдан – не фашистський , бурхливо сприймалися на тому кінці телефонного дроту як прагнення їх обманути .	Майдан	5	Nom
Ми будуємо нову Україну .	Україну	3	Acc
Крім українських медиків , на Сумщину завітають команди із країн Прибалтики , Польщі , Молдови , Білорусі , Казахстану » .	Білорусі	16	Gen
Не турбуйтеся Олексій , це нормально , так , там є невелика розбіжність .	Олексій	2	Nom
Мр . Віллі Морріс добув з горішньої кишені камізельки зложений у восьмеро папір .	Віллі	2	Nom
Також Валентин Щербачов є засновником проекту « Національний реєстр рекордів України » .	Щербачов	2	Nom
Одного з найвідоміших спортивних коментаторів України Валентина Щербачова відсторонено від коментування матчів « Євро - 2016 » .	Валентина	6	Acc
Сьогодні зранку - зранечку , зранечку - зісвітаночку Славік залетів у школу й на коридорі , наче велосипедист у коня ( Equus ) , врізався в завучку Надію Петрівну Проскурню .	Петрівну	28	Acc
Ви ж можете з ними балакати з англійським презирством , крізь зуби — і дивитися на них , як Монблан дивиться на Шамуні .	Монблан	19	Nom
У свою чергу речник Манафорта Джейсон Малоні відмовився коментувати дані повідомлення .	Манафорта	4	Gen
" Невідомо , чи було щось з наданих Йохаєм даних корисним для розслідування справи Манафорта " , - пише CNN .	Манафорта	14	Gen
У нас у Керелівці всі свято впевнені , що Тарас народився таки в нашому селі , а не в Моринцях .	Моринцях	19	Loc
Її учителем української мови був Василь Щурат , біологію викладав Мельник , а географію викладала Олена Степанів .	Василь	5	Nom
Її предложено японцям , і представник ОУН відбув з послом Японії в Варшаві ґрунтовну розмову .	ОУН	6	Gen
Фацик хотів половити щук на блешню .	Фацик	0	Nom
Праворуч мр . Кетлінга , себто на 849-м кріслі , сидів уже бородатий добродій , що від нього на цілу англійську милю пахло чистокровним ірландцем .	Кетлінга	3	Gen
Перша у світі дослідно - промислова гідрошахта побудована у 1939 в Україні , на Донбасі ( трест « Орджонікідзевугілля » ) .	Орджонікідзевугілля	18	Nom
А вже Михайла Грушевського та Володимира Винниченка очорнено найстрашнішими епітетами , і зостається тільки дивом дивуватися , як же могла Лариса Косач знатися та ще й листуватися з такими звироднілими й аморальними людьцями .	Винниченка	6	Acc
Біда жив своїм життям .	Біда	0	Nom
Тоді Мікі варив справжній чифір .	Мікі	1	Nom
Сьогодні Сінгапур займає у рейтингу Transparency International ( 2009 рік ) 4-е місце за чистотою від корупції у світі та посідає 1-е – в Азії .	Азії	24	Loc
Щодо розцяцькованого похоронного вінка в руках завучки Надії Петрівни Проскурні й загалом цієї пишної історії , то всі дороги вели до дев’ятикласника Ярослава Копчука .	Копчука	23	Gen
На закриття ралі очікується приїзд в . о . Міністра охорони здоров’я України Уляни СУПРУН .	СУПРУН	14	Gen
Алгоритм Д . Хаффмана та алгоритм Шеннона — Фано передбачають перекодування даних .	Шеннона	6	Gen
Також , 24 травня Печерський райсуд Києва відпустив під заставу в розмірі 15 млн гривень колишнього начальника Державної податкової служби в Луганській області Олександра Антипова .	Антипова	24	Acc
Для Тетяни Кисельчук , головного редактора bit.ua , вона стала кар’єрним викликом - на таких " посиденьках " їй запропонували посаду головного редактора , хоч подібного досвіду управління у неї не було .	Тетяни	1	Gen
Шановна " А-ба-ба ... " , чи плануєте випустити оновлене видання " Фантастичних звірів " Ролінґ з додатковою інформацією про 6 нових звірят , новою передмовою Ньюта та новими ілюстраціями ?	Ролінґ	15	Gen
На другому місці за популярністю запитів розташувалася наукова фантастика " Прибуття " , а на третьому місці розташувалася – режисерська робота Мела Гібсона , військова драма " З міркувань совісті " .	Гібсона	22	Gen
Тета Міра любила співати нам або сама собі таку пісеньку — я тішуся , як спати йду , і вранці я знова встаю , яка дурненька я , яка дурненька я .	Міра	1	Nom
Діафрагма Вінстона стислася .	Вінстона	1	Gen
Маю два чудові ілюстровані видання Гаррі Поттера .	Поттера	6	Gen
У сценах з Девідом і для Девіда Рідлі Скотт нарешті шкварить на повну , даруючи нам найсильніші моменти фільму : стартовий діалог з Вейландом , сповнену якогось божественного піднесення зустріч з грудоломом і особливо сцену з флейтою .	Девіда	6	Gen
ну якщо в тебе є покриття 3G від київстару чи лайф ....	лайф	10	Gen
А завдяки тому , що ячмінь не дуже боїться холодів , його сіють у Фінляндії аж біля Північного кола , в Тибеті й Непалі сіють — на захмарній висоті у пів - Евересту .	Евересту	32	Gen
— Ще 17 грудня заняли американські і голяндські війська португальську частину острова Тімор .	Тімор	12	Nom
Джеффрі Йохай , колишній зять Пола Манафорта - екс-голови кампанії президента США Дональда Трампа - зустрічався зі слідчими в рамках розслідування справи про можливе відмивання грошей чи податкові порушення під час співпраці Манафорта з Партією регіонів .	Йохай	1	Nom
Колумбієць був сусідом Маркеса через паркан , а болівієць боявся , коли на Менчилі ми припалювали сиґарети від гарячого повітря над тубусом нафтової лампи .	Менчилі	13	Loc
– І лише у Мені у дні скорботних дат навіть нікуди покласти квіти пам’яті .	Мені	4	Loc
7 вересня « ТЕЛЬНЮК : Сестри » виступлять на території « Софії Київської » [ Київ , вул . Володимирська , 24 ] за участю Симфонічного оркестру та хору Заслуженого академічного ансамблю пісні і танцю Збройних Сил України	ТЕЛЬНЮК	3	Nom
У його створенні нас традиційно надихнула Італія , де особливо цінують домашній затишок і не задовольняються звичайними вузькими та більш жорсткими диванами .	Італія	6	Nom
ну якщо в тебе є покриття 3G від київстару чи лайф ....	київстару	8	Gen
Романи про Віннету - наче дитяча катеринка , популярна в совіцькому дитинстві іграшка .	Віннету	2	Acc
Ванна була повна прохолодної води , і Софі , швидко роздягнувшись , лягла у неї .	Софі	7	Nom
Також , група СКМ , кінцевим бенефіціаром якої є бізнесмен Ринат Ахметов , заявляє , що її підприємства на тимчасово неконтрольованих територіях Донецької та Луганської областей будуть продовжувати працювати відповідно до законодавства України .	Ахметов	11	Nom
Американські слідчі сподіваються переконати Пола Манафорта , екс-керівника передвиборчої кампанії президента США Дональда Трампа , співпрацювати з ними у розслідуванні можливої змови між штабом Трампа і Росією .	Пола	4	Acc
Князь сам , без своїх людей , мав провести нам коротеньку екскурсію .	Князь	0	Nom
Голос Гольдштейна перетворився на справжнє блеяння вівці і на мить його обличчя стало овечим .	Гольдштейна	1	Gen
Перша у світі дослідно - промислова гідрошахта побудована у 1939 в Україні , на Донбасі ( трест « Орджонікідзевугілля » ) .	Донбасі	14	Loc
Тільки тут можна побачити 12 видів ковили : ковилу Лессінга , тирсу , Граффа , азовську , Браунера , відокремлену , вузьколисту , дивну , пухнастолисту , облудну , українську та шорстку .	Браунера	17	Acc
У Довгому ми пішли ввечір на чеське пиво .	Довгому	1	Loc
А за вузькою Тайванською протокою лежав колосальний маоїстський Китай – багатолюдний , агресивний і невблаганний .	Китай	8	Nom
Мої родичі купили їх , щоби підтримати еміґрантів — старшин армії УНР , які щось малювали , а тоді продавали своє малювання на доброчинних виставках у галицьких містах .	УНР	11	Gen
Однак , незважаючи на судові справи і протести громадськості , дельфінарій " НЕМО " не збирається втрачати " годівницю " , тому почав шукати нове місце свого розташування .	НЕМО	12	Nom
Голова комітету Верховної Ради у закордонних справах Ганна Гопко приєдналася до флешмобу # 22PushUpChallenge , який запустили на підтримку ветеранів АТО .	Ганна	7	Nom
Незабаром націоналістична група отримала нове завдання — працювати з радянськими утікачами - українцями , яких утримували в концтаборі неподалік Харбіна .	Харбіна	19	Gen
Натомість ми пішли в інший заклад — під готелем « Львів » .	Львів	10	Nom
а правда ж цьогоріч на Ночі Поттера 25 лютого конкурси будуть не лишень дитячі ?	Поттера	6	Gen
Навіщо співати таку пісню , яка відверто слабка , і бажати собі кліп як у Ріани , і це не тільки стосується Яремчук .	Яремчук	22	Gen
Марія Василівна не те що би хотіла попсувати результати життя й творчості малого негідника , ні — швидше майбутні дії Марії Василівни мали абсолютно виховний характер !	Марія	0	Nom
Їздили городами і співали про Марусеньку , про Дунай , про хустину і стрілецьку могилу .	Дунай	8	Acc
— Англійський король приняв на авдієнції новоіменованого мін . Стеффорда Кріппса і тим наче підкреслив його значення .	Стеффорда	9	Acc
У вже покійного Валентина Чемериса є чудовий роман “ Приречені на щастя ” про двох учених майбутнього , які вирішили погуляти на щойно відкритій планеті земного типу .	Валентина	3	Gen
Біда не зважав на школи .	Біда	0	Nom
Ми з татом робили чудове калинове вино , і в одній порожній кімнаті були лише десятилітрові бутлі рожевого вина , відреставрований комод і шнурки з випраними і вивареними пеленками Марчика .	Марчика	29	Gen
Також Валентин Щербачов є засновником проекту « Національний реєстр рекордів України » .	Валентин	1	Nom
Крім українських медиків , на Сумщину завітають команди із країн Прибалтики , Польщі , Молдови , Білорусі , Казахстану » .	Сумщину	5	Acc
( Щербицьким Москва замінила Шелеста пізніше , в червні 1972-го , коли каток репресій уже був розкручений на повну . )	Москва	2	Nom
Нагадуємо , Аушвіц - один із найбільших концентраційних таборів нацистської Німеччини , який розташували на території Польщі ( біля м . Освенцим ) впродовж 1940 - 1945 рр .	Освенцим	21	Nom
Потрібно неодмінно додати той факт , що служба Надзвичайних ситуацій Броварів не пристосована до нових завдань , пов’язаних із гасінням пожеж на висоті більшій за 9 поверхів , пожежних депо нового типу немає .	Броварів	10	Gen
У 1937 році в Берліні відбуваються переговори Коновальця та генерала Миколи Капустянського з представниками японського посольства й генштабу .	Капустянського	11	Gen
У фракції Демальянсу таких людей немає взагалі .	Демальянсу	2	Gen
У п'єсі Франка ніби для нього написані такі слова Анни : " І боюсь його , і жити без нього не можу .	Анни	9	Gen
Маленький і легенький Пуня вибіг на лід .	Пуня	3	Nom
Певною мірою це стосується також Покуття , Буковини , Волині та Поділля .	Поділля	11	Gen
Двоє безпосередніх учасників нападу Гриць Купецький та Григорій Файда , а також провідник дрогобицької боївки УВО — ОУН Михайло Гнатів нелегально покинуть межі Польщі й опиняться на Заході .	Гриць	4	Nom
Ось що весь час вибиває і " ріже " професійно та ідеально вибудуваний епатажний засексуалений публічний образ Даші Астаф’євої .	Даші	17	Gen
Сили немає передавати того убозтва духового й поетичного , яке так докладно , щоправда , спізнившись навіть од цих на десять років , перекопіював Зеров для українського прикладу .	Зеров	24	Nom
Проект модернізації Ан - 32 , а також програми з ремонту бойових літаків та вертольотів були обговорені керівництвом ДК « Укроборонпром » з Головою делегації Збройних сил Республіки Бангладеш паном Наімом Насаном .	Укроборонпром	20	Nom
Час від часу Джон їздив автостопом до Ноттінгему по пенсію .	Джон	3	Nom
Мені щиро жаль - я любила Америку ( зараз поставлю собі New York , NY у виконанні Сестер Тельнюк : попрощатися з тою , яку любила ) .	Америку	6	Acc
Про скандал у пісочниці : як Гройсман відібрав в Омеляна паровозики , а також про Тіну Кароль та двері в Нарнію у шафі поліцейського — у новій серії « #@)₴?$0 з Майклом Щуром »	Нарнію	20	Acc
Невже ти ніколи не чув про Павла Тичину , що цей автор всесоюзного і європейського маштабу є членом Вапліте і творець тих пісень , що їх щоразу співає гордість нашої Республіки капеля " Думка " ?	Вапліте	18	Gen
Навіть пізніш , за Хаджі - Герая , татарські люди на північ від Дніпра були в тому февдальному прикордонному утворенні , що на чолі його стояв князь Семен Олелькович .	Дніпра	13	Gen
І Марина падала навколюшки , молила матір божу , щоб велика заступниця наслала мир на її рідну сторону і захистила від напасті !	Марина	1	Nom
Ваш Мик . Зеров	Мик	1	Nom
Гуртові яви живі , мальовничі , ефекти акустичні давали досконалу оману " , – відгукується на виступ у Львові критик Степан Чарнецький у часописі " Неділя " .	Львові	18	Loc
Нині покійний український дисидент Леонід Плющ казав про « позаморальні демократії » , що формуються як у розвинених капіталістичних країнах , так і в третьому світі .	Плющ	5	Nom
Пів пачки каро вистачило , щоби винайняти автобус від Ворохти до Чотирнадцятого кілометра , коли на ботанічну практику приїхали з Любліна Рената , Йоланта , Дорота , Аґнешка , Дорота , Малґося , Йоана і Беата .	Дорота	29	Nom
Була якось в садибі - музеї Карла Мая в Радебойлі , нарешті дізналась про нього більше .	Радебойлі	9	Loc
Як зазначає Б . Вербер : « Сінгапур – держава демократична , але для того , щоб громадяни не голосували як попало , на виборчому бюлетені пишеться номер картки виборця » .	Сінгапур	7	Nom
Ти завжди з зацікавленням стежиш за оголошеннями театрів — і напевно з жагою чекаєш побачити нову п'єсу автора " 97 " т . Куліша — " Народний Малахій " .	Малахій	27	Nom
Автомобільна дорога державного значення Бердичів — Шепетівка — Острог , від якої здійснений головний в'їзд до АЕС , проходить на відстані 6 , 3 км на північ від електростанції .	Бердичів	4	Nom
Чи може вона від одних фашистівських гасел , як від дотику чудодійної палиці , перетворюватися з матері яничар і « дурних курчат » в героїчну матір відважних Ґракхів ?	Ґракхів	27	Gen
Юрко звідкись дістав цілий мішок промоційних пачок чудових сиґарет бенсон і ґеджес , у кожній пачечці вміщалося три сиґарети .	ґеджес	11	Nom
До Красної Поляни їхалося перевантаженим пазом справжнім серпантином .	Поляни	2	Gen
Правда , коректив був в особі моєї матері та в листах дядька Драгоманова , якого вважаю своїм учителем , бо дуже багато завдячую йому в моїх поглядах на науку , релігію , громадське життя і т . і .	Драгоманова	12	Gen
Київстар при зміні тарифного плану без попередження повісив мені замість гудків ... Океан Ельзи .	Київстар	0	Nom
Пів пачки каро вистачило , щоби винайняти автобус від Ворохти до Чотирнадцятого кілометра , коли на ботанічну практику приїхали з Любліна Рената , Йоланта , Дорота , Аґнешка , Дорота , Малґося , Йоана і Беата .	Любліна	20	Gen
В « Синах » Стефаника бачимо матір , що з німим докором дивиться на синів , які тікають з-під рідної стріхи боронити рідну землю .	Стефаника	4	Gen
Пам’ятаєте , як Вам безбожно заздрили і тайкома ненавиділи в « Музагеті » … за хист , якого самі не мали .	Музагеті	11	Loc
Це для ворога військові славетної 72-ої бригади , які захищали Авдіївку , - « Чорна бригада » , а для нас – світле і хоробре військо !	Авдіївку	10	Acc
Єдиний адекватний член екіпажу корабля “ Заповіт ” ( якщо не брати до уваги героя Джеймса Франко ) — ШІ - автопілот , яку тупі людиська посилають під три чорти , назвавши кілька циферок .	Заповіт	6	Nom
Добре нині відомі « Поляна Квасова » , « Свалява » , « Лужанська » , « Шаянська » тощо .	Лужанська	13	Nom
Пів на третю ночі я дописала статтю і через помилку Віндоус жодного слова не збереглося .	Віндоус	10	Gen
Славіка , Слави , Славунчика !	Славіка	0	Gen
У неділю , 26 лютого , працівниками внутрішньої та власної безпеки Держприкордонслужби спільно з Національною поліцією , затримано старшого інспектора прикордонної служби Сумського прикордонного загону у званні « старший лейтенант » .	Держприкордонслужби	11	Gen
Для прикладу , типовий росіянин автоматично резонує на версії змови Заходу проти Росії .	Заходу	10	Gen
Щастя ще , що Михайло розважливий , а Гнат не говіркий .	Гнат	8	Nom
Село Половинчик згадується у циклі « Русалонька із 7 - В » Марини Павленко .	Половинчик	1	Nom
По мовчанці мр . Віллі Морріс запримітив мимоходом , що з нагоди неділі здалося б у відповідний спосіб перебути сьогоднішній вечір .	Морріс	5	Nom
– Уважайте на нього , щоб не покинув університету і не вступив до театру , – звертається колишня актриса театру " Руська бесіда " у Львові Ванда Янович до Хоми Водяного .	Водяного	30	Gen
- Приїздіть , - просить , - та й приїздіть до нас у Дзвонкове пополювати .	Дзвонкове	13	Acc
В основному польські переклади авторів з цілого світу , недоступних в СРСР в українському чи російському виданнях .	СРСР	11	Loc
Головні ролі у стрічці виконують Руні Мара ( продавчиня ) і Кейт Бланшет ( Керол ) .	Кейт	11	Nom
Вперше ми побачили Джона у совєтській військовій шапці , на місці зірки був приліплений великий портрет Боба Марлі .	Боба	16	Gen
І сам Тарас писав , що народився в Керелівці .	Тарас	2	Nom
Нетішинське водосховище ( Ставок - охолоджувач Хмельницької АЕС ) створене у 1986 році на річці Гнилий Ріг яка впадає в Горинь .	Горинь	20	Acc
Цілком може бути , що вуличні протести проти Марін виявляться ще масовішими , ніж марш американських жінок , обурених Трампом .	Марін	8	Gen
У 2007 році доходи Еністон за підрахунками журналу Форбс склали $ 14 мільйонів .	Форбс	8	Nom
До варшавської зустрічі було підготовлено й окремий пакет пропозицій , одна з яких передбачала допомогу японців акціям ОУН у Маньчжурії .	Маньчжурії	19	Loc
— У Палаті Громад у Лондоні відбудеться у найближчому тижні дебата зприводу здобуття Сінгапуру японцями .	Лондоні	5	Loc
А вже Михайла Грушевського та Володимира Винниченка очорнено найстрашнішими епітетами , і зостається тільки дивом дивуватися , як же могла Лариса Косач знатися та ще й листуватися з такими звироднілими й аморальними людьцями .	Косач	21	Nom
Про рік 1874-й я знав від С . О . Єфремова , який знайшов ще листи , писані Вами з Відня до видавництва « Вік » .	Єфремова	10	Gen
У домі римського патриція Руфіна була прегарна фреска , зображення Венери та Адоніса .	Руфіна	4	Gen
Праця з неолітичним матеріялом з розкошів у Старчеві Американської Експедиції до Югославії та Білгородського музею дала мені змогу пізнати техніку виробу посудини на ніжці в цій групі .	Югославії	11	Gen
Барабан пристосував зі старої пральної машини « Ардо » .	Ардо	7	Nom
То було перше місце у Франківську , де можна було попити ґлінтвайну .	Франківську	5	Loc
Сосницький гасає в ріжні боки .	Сосницький	0	Nom
Що Ви не пускаєте « Сковороди » , це добре : « Сковорода » потребує окремого видання .	Сковороди	5	Gen
Юрко досконало вивчив усі оповідання про Голмса , він міг безпомилково назвати прізвища навіть другорядних героїв , усі топоніми і власні назви садиб , маєтків і замків , що згадувалися у будь-якому оповіданні .	Голмса	6	Acc
Особисто я вибираю і п'ю пиво в залежності від настрою , а на певній одній торгівельній марці не зупиняюсь - в кожній є своє улюблене : Львівське світле , Чернігівське біле , Славутич Ice , Оболонь біле ...	Славутич	32	Nom
За Теона чи Яру ?	Теона	1	Acc
Підписав Указ про нагородження генерал - полковника Геннадія Воробйова орденом Богдана Хмельницького I ступеня посмертно .	Геннадія	7	Gen
Усіма військовими справами ЗУНР відав ДСВС , що діяв до 9 червня 1919 року та поділявся на Військову канцелярію ДСВС і 16 відділів .	ЗУНР	3	Gen
... Голубан затулив Зеленського , Дорн затулив Голубана , кулічі й паски затулили Дорна , сніг затулив кулічі й паски ...	Голубан	1	Nom
Поява Кріппса в уряді Черчіля — це дальший крок до большевизації Англії .	Черчіля	4	Gen
Убиту браконьєрами лосиху з Чернігівщини шкода , але писати , що вона була вагітна ...	Чернігівщини	4	Gen
Команди змагатимуться на території дитячого табору відпочинку « Зоряний » ПАТ « Сумихімпром » ( с . Вільшанка Сумського району ) .	Сумихімпром	12	Nom
— Ще тому кілька днів спротивився прем'єр Великої Британії , Черчіль всяким змінам у свому кабінеті , а сьогодні вже є вістка , що в уряді Черчіля проведені зміни .	Британії	8	Gen
У травні гурт виступив на сцені міжнародного фестивалю татуювань « TattoCollection 2015 » та разом з гуртом YouCrane влаштував міні - тур містами Західної України з завершальним концертом у Києві .	Києві	29	Loc
Підписав Указ про нагородження генерал - полковника Геннадія Воробйова орденом Богдана Хмельницького I ступеня посмертно .	Хмельницького	11	Gen
Тому Тіріон говорить прямо , що Джон вклепався по самі вуха .	Тіріон	1	Nom
Бангладеш та « Укроборонпром » домовляються про модернізацію « АНів »	АНів	9	Gen
Та Ісус добре знався на економіці .	Ісус	1	Nom
Премію MTV Video Music Awards - 2016 вночі на 29 серпня вручили у Нью-Йорку .	Нью-Йорку	13	Loc
Ініціатор акції – доцент кафедри філософії та теорії права нашого університету Сергій Мисевич , висловив окремі слова вдячності :	Мисевич	12	Nom
Тут , зокрема в місті Харбіні , була доволі численна українська громада , і звідси було зручно формувати базу для впливу на Червону армію та українське населення прикордонних областей .	Харбіні	5	Loc
Згідно з інформацією сайту Національної поліції , Полчанов служив в роті поліції " Свята Марія " .	Марія	14	Nom
Бойовий досвід ветеранів Афганістану став дуже цінним для перших кроків оновлених Збройних Сил .	Афганістану	3	Gen
У 1995-му Сінгапур із 26_000 дол . США на душу населення обійшов Британію ( 19_700 ) .	Британію	12	Acc
Унікальні за складом і кількістю солей води затоки Сиваша дають можливість видобувати окис магнію та його солі , бром і кухонну сіль .	Сиваша	8	Gen
Посол Нолькен повідомив у Стокгольм , що Російська імперія на межі державного перевороту і що війська не будуть битися за Анну Леопольдівну .	Анну	20	Acc
Це десятки гектарів яскраво - червоної півонії тонколистої , і саме тут трапляються три види червонокнижних тюльпанів : Шренка , змієлистий та дібровний .	Шренка	18	Acc
У мене Анжеліна Джолі відмовляється грати у фільмі .	Джолі	3	Nom
Ось Карачапов : він здатний схопити людину , що попала в скрутне становище , взяти її за горло й душити доти , поки ні копійки не лишиться в неї .	Карачапов	1	Nom
До Кутаїсі ми прилетіли зранку з польського міста Катовіце , позаяк набагато дешевше летіти звідти , ніж з України .	Катовіце	8	Nom
Коли ж воліли спокійного і затяжного напивання , запускали Тома Вейтса або Елємент оф крайм .	Тома	9	Acc
Подібна витівка його попередника Миколи Митлюка коштувала йому життя .	Митлюка	5	Gen
Марфа , якщо поблизу не видко людей , нескоро віддає йому листа , мліючи з ним на грудях , і шепоче , шепоче …	Марфа	0	Nom
Про с . Кобаки і снятинський період дещо розповідав мені Антон І . Онищук .	Антон	10	Nom
Та тому , що минулого року в Харкові наша бригада виборола переможне місце і таким чином ми це право заслужили , – зазначив Сергій Бутенко .	Сергій	23	Nom
Міжнародна авіакосмічна виставка AeroIndia проводиться в Індії вже в одинадцяте і за цей час стала центром з розвитку співпраці оборонних підприємств авіаційної галузі в усій Азії .	Азії	25	Loc
Можна герба замовляти , бо чим не Жорж Дю Руа ?	Руа	9	Nom
Через вас на Сибір ще підеш ...	Сибір	3	Acc
Молдавські володарі , що , здавалося би , міцно сиділи в Білгороді на Дністрі , терпіли тут наявність „ татарського царевича “ ще до нової татарської хвилі часів Менглі - Герая .	Менглі	28	Gen
З них випливає , що хрестив Тараса піп Олексій Базаринський ( Кониський пише - Іван Базаринський ) .	Кониський	11	Nom
Коли справді стався землетрус десь у вісімдесят першому , наша сім’я була єдиною з кількаповерхової камениці у Франківську , котра ніяк не зреаґувала на трясення .	Франківську	17	Loc
Черкаси — це місто , де немає бетонних джунглів , стовпів пилу та поодиноких берізок край дороги .	Черкаси	0	Nom
Космічний телескоп « Габбл » ( англ . Hubble Space Telescope , HST ) — американський оптичний телескоп , розташований на навколоземній орбіті 1990 року .	Габбл	3	Nom
Бангладеш та « Укроборонпром » домовляються про модернізацію « АНів »	Укроборонпром	3	Nom
Степан " .	Степан	0	Nom
Грали " Марусю Богуславку " .	Марусю	2	Acc
Ой , Гнат , Гнат !	Гнат	4	Nom
— Отой волоцюга , блудяга ... покинув на Дону жінку з дітьми ... приплівся сюди на мою голову ...	Дону	8	Loc
Отець Головацький не знав , що через кілька років вони стануть родичами , що у Читі дзядзьо одружиться із сестрою жінки його брата .	Головацький	1	Nom
Мар'яно , " Граф Монте-Крісто " виходив українською ще далекого 1924 року , три з чотирьох томів оцифровані , можна завантажити тут : http://toloka.to/t73252	Монте-Крісто	4	Nom
Terra Mariana – Земля Діви Марії – таку назву отримало нове князівство у складі Священної Римської імперії , утворене 2 лютого 1207 року на території Лівонії – сучасних Латвії та Естонії .	Естонії	30	Gen
Татарські оселі за XV ст . були також в сучасній Бесарабії на межі або навіть за межею лісостепу — від татарського „ кишла нового “ пішла назва суч . Кишинева .	Бесарабії	10	Loc
Вона знає , що , як нагадує один з героїв « Оргії » , « Рим ходив у Грецію до школи » , що претензії на роль старшого брата у слов’янській сім’ї цілковито безпідставні .	Грецію	18	Acc
У Франківську був такий час , коли ми з найближчими однокласниками щодня після школи кілька годин ходили містом .	Франківську	1	Loc
Чує Мотря , та боїться озирнутись : їй чогось соромно , страшно .	Мотря	1	Nom
1924-го Лесь Курбас працював на Одеській кіностудії .	Лесь	1	Nom
В Люшневатій біля Витовтового броду на Першотравенщині знайдено було недавно плиту з написом , на жаль , знищеним при тому ( відомості Одеської Краєвої Інспектури Охорони Пам’ятників матеріяльної культури ) .	Люшневатій	1	Loc
Поява Кріппса в уряді Черчіля — це дальший крок до большевизації Англії .	Кріппса	1	Gen
Вплив книжки Кримського на пізніших істориків української мови був помітний .	Кримського	2	Gen
Засмалених юнаків у синіх і червоних штанцях вона дразнила своїми духовитими десу , червоними підв’язками — Вер була брюнетка — і прозорістю довгих чорних панчіх .	Вер	16	Nom
Він був головним дяком у Станиславові , організатором дяківського руху на Галичині і редактором часопису « Дяківський Глас » .	Станиславові	5	Loc
Мр . Фред Кетлінг прочитав програму від дошки до дошки , потім добув годинник , що вказував чверть на сему , і сказав коротко :	Кетлінг	3	Nom
Поки що 119 трупів були доставлені в лікарню Шахід Аббасі , 219 тіл доставлені в JPMC ( місцевий госпіталь ) та ще близько 98 загиблих доставлені у Цивільний Госпіталь .	Аббасі	9	Nom
У сценах з Девідом і для Девіда Рідлі Скотт нарешті шкварить на повну , даруючи нам найсильніші моменти фільму : стартовий діалог з Вейландом , сповнену якогось божественного піднесення зустріч з грудоломом і особливо сцену з флейтою .	Рідлі	7	Nom
Він цінний , змістовний , це не порожнє місце , як динамічний Сковорода Поліщука або лубенський телеграфіст Івченка ( « В тенетах далечини » ) .	Поліщука	13	Gen
Поки що 119 трупів були доставлені в лікарню Шахід Аббасі , 219 тіл доставлені в JPMC ( місцевий госпіталь ) та ще близько 98 загиблих доставлені у Цивільний Госпіталь .	Шахід	8	Nom
Вони тоді жили у Моршині .	Моршині	4	Loc
Представникам ОУН дали час на вивчення російської мови , а далі розпочався системний вишкіл під контролем японської розвідки : прослуховування лекцій , опрацьовування відповідних комуністичних праць і ретельне читання радянської преси .	ОУН	1	Gen
Міністерство Правди містило , як казали плітки , три тисячі кімнат від першого до останнього поверху , та відповідну за розмірами розгалужену підземну систему .	Правди	1	Gen
Сьогодні Індія має 850 тис . програмістів , вона стала світовим лідером у створенні програмного забезпечення і експортує його більше ніж на 30 млрд . дол .	Індія	1	Nom
Так , недавно кілька читачів охарактеризували як « джинсу » цілком невинний матеріал на « Українській правді » про мого колишнього студента Руслана Кавацюка , оскільки текст видався їм занадто добрим і позитивним , щоб бути правдою .	Кавацюка	23	Acc
Свого часу пів - Ірландії виїхало в штати , і чи згубило це Ірландію ?	Ірландію	13	Acc
— Зробити таку машину прикортіло весною , — тим часом розказує Володя .	Володя	11	Nom
Тож у середині 1930-х до Харбіна перекинуто кількох членів ОУН , які одразу зайняли помітні ролі в Українській національній колонії , зокрема в Союзі української молоді ( СУМ ) , і почали видавати часопис « Далекий Схід » .	Харбіна	5	Gen
Навіть жорстке обличчя О’Браєна щільно почервоніло .	О’Браєна	3	Gen
Ці фрагменти — вочевидь , усе , що залишилось нам від “ Прометея 2 ” — надто вже виділяються на тлі океану кретинізму , що панує в “ Заповіті ” .	Заповіті	28	Loc
Тільки тут можна побачити 12 видів ковили : ковилу Лессінга , тирсу , Граффа , азовську , Браунера , відокремлену , вузьколисту , дивну , пухнастолисту , облудну , українську та шорстку .	Граффа	13	Acc
– Брата Жана , – говорить Бучма .	Жана	2	Acc
Фільм зняли за романом Патрісії Хайсміт " Ціна солі " , який вийшов друком ще у 1951 році .	Хайсміт	5	Gen
В Лісабоні перейшовся туди - сюди - маєш квадріцепс мрії , невтамовний апетит і двадцять компліментів .	Лісабоні	1	Loc
Прочитала на Вашому сайті про книгу " Сіроманець " Миколи Вінграновського .	Миколи	9	Gen
Нині ж — абсолютно без будь-якого попередження , анулюють договір на репортажі на УР ( під картинку з Євро ) .	УР	13	Loc
Подібна витівка його попередника Миколи Митлюка коштувала йому життя .	Миколи	4	Gen
А вже наступної ж миті він був єдиним цілим з усіма тими людьми що були поруч та все що вони казали про Гольдштейна здавалося правдою йому .	Гольдштейна	22	Acc
Один з нас навіть вліпив знимку Марлі у свій паспорт .	Марлі	6	Gen
В суботу , 5 серпня Приймальна комісія НаУКМА працюватиме до 18 - 00 !	НаУКМА	7	Gen
— Є також чутка , що до уряду втягають старого віком Льойда Джорджа , який , до речі , у своїх спогадах гостро висмівав Черчіля , як недотепу .	Черчіля	24	Acc
Підписав Указ про нагородження генерал - полковника Геннадія Воробйова орденом Богдана Хмельницького I ступеня посмертно .	Богдана	10	Gen
Ще один приклад можливості комплексного використання — горючі сланці Карпат .	Карпат	9	Gen
Його двоюрідний брат Раїль ніколи не знав жінки і не їздив на мотоциклі .	Раїль	3	Nom
Першою приятелькою Марії стала Ганна .	Марії	2	Gen
Крім українських медиків , на Сумщину завітають команди із країн Прибалтики , Польщі , Молдови , Білорусі , Казахстану » .	Молдови	14	Gen
Знову ж таки Сноу не хотів приносити клятву вірності Дені не з гордості , не з принципів сепаратизму півночі , а тому що ніс відповідальність перед своїми васалами , і не хотів присягати на вірність незнайомій йому людині .	Сноу	3	Nom
Навіть пізніш , за Хаджі - Герая , татарські люди на північ від Дніпра були в тому февдальному прикордонному утворенні , що на чолі його стояв князь Семен Олелькович .	Герая	6	Gen
На його городчику росла верба , привезена з Канева , стояв бюст Аполлона .	Канева	8	Gen
І просто на підвіконні біля порепаної бегонії плямистої ( Begonia maculata ) Марія Василівна помішала майже вистиглий кминовий ( Carum carvi ) чайок у гарній блакитній чашечці з позолоченою окантовкою у формі листочків .	Василівна	13	Nom
Йонатан Голслах — професор міжнародної політики у Вільному університеті Брюсселя .	Йонатан	0	Nom
Образи його знаходяться у Празі в костелах Францішканів і Капуцинів та у Мельнику .	Мельнику	12	Loc
Навіщо співати таку пісню , яка відверто слабка , і бажати собі кліп як у Ріани , і це не тільки стосується Яремчук .	Ріани	15	Gen
Кріппс буде вже тепер диктувати в Англії під музику Сталіна .	Кріппс	0	Nom
Ну ex.ua офіційно закрились самі .	ex.ua	1	Nom
Навпаки , доробок Соболевського , Шахматова та Яґіча був значний .	Яґіча	7	Gen
Власний оглядач видання Тім Робі назвав фільм " видатним твором американського мистецтва " .	Робі	4	Nom
На думку британських політиків , Трамп не зможе ігнорувати союзників Америки .	Америки	10	Gen
Автомобільна дорога державного значення Бердичів — Шепетівка — Острог , від якої здійснений головний в'їзд до АЕС , проходить на відстані 6 , 3 км на північ від електростанції .	Острог	8	Nom
Глави держав - учасників антигітлерівської коаліції – президент США Франклін Рузвельт , прем'єр - міністр Великої Британії Вінстон Черчилль та голова Ради народних комісарів СРСР Йосиф Сталін – протягом тижня обговорювали майбутній політичний устрій світу .	СРСР	24	Gen
Ще одного близького приятеля Лариси Косач , перекладача Максима Славинського , замученого по другій світовій у радянській тюрмі , звинувачено в тому , що « опинився в таборі буржуазно - націоналістичної еміграції у Празі » .	Максима	8	Acc
Ім'я Волтера Вайта нагадує поета Волта Вітмена , що відіграло важливу роль у сюжеті , аж до середини фінального п'ятого сезону .	Вітмена	6	Acc
До 1999 р . діяла гідрошахта Шахта « Піонер » .	Піонер	8	Nom
— Чорнила слізьми не розмаж , — каже Левко і одвертається : жде .	Левко	8	Nom
8 - 10 лютого у Запоріжжі , в рамках соціальної програми дружини Президента України Марини Порошенко , проходив третій етап спеціалізованих тренінгів « Інклюзивна освіта – рівень свідомості нації .	Запоріжжі	5	Loc
Дзядзя відразу ж відправили до Станіслава з призначенням на перший поїзд до Сибіру .	Сибіру	12	Gen
Тому Тіріон говорить прямо , що Джон вклепався по самі вуха .	Джон	6	Nom
Нас не дивує , коли таким могильним запахом з насолодою упиваються Зерови й Могилянські , але нас обурює , коли про цю насолоду шамрикають і деякі пролетарські письменники .	Могилянські	13	Nom
Моя подруга отримала біометричний паспорт і вже їздила з ним до Франції .	Франції	11	Gen
і готові до питань а-ля назвіть повне ім*я Дамблдора ...	Дамблдора	8	Gen
Звичайно це реклама , але , оскільки автор наполягає шо він хоче поради я , як щирий фанат і ентузіаст ОС Windows , і лояльний користувач корпорації майкрософт , кажу - правильно , ти правильно вибираєш .	майкрософт	27	Nom
Як зварили , почали радитись , кому йти кликати на обід пана Коцького .	Коцького	12	Acc
Так , стрічка шикарно знята , музика від Джеда Курцеля традиційно чудова , а Фассбендер божить .	Курцеля	9	Gen
Соболевський і Яґіч здебільшого не виходили за рамці філологічної школи , хоча перший також приділяв увагу дослідженню діалектів .	Яґіч	2	Nom
Тепер японці висадилися на Тиморі і знищили американську і голяндську залогу .	Тиморі	4	Loc
Ім'я Волтера Вайта нагадує поета Волта Вітмена , що відіграло важливу роль у сюжеті , аж до середини фінального п'ятого сезону .	Волта	5	Acc
Найдешевші ПЕРСИКИ , які вдалося знайти на Привокзальному ринку у Львові , — по 12 гривень за кілограм , і то — молдовські .	Львові	10	Loc
Той , що коло Чилі .	Чилі	4	Gen
Буднього робочого дня Марія одягає святкові одяги .	Марія	3	Nom
Її предложено японцям , і представник ОУН відбув з послом Японії в Варшаві ґрунтовну розмову .	Японії	10	Gen
Спершу планували зустрітися у Шотландії .	Шотландії	4	Loc
Ця заввага літературознавця погано корелює зі свідченням самої поетеси у листі до Ольги Кобилянської : « … вчилась тільки того , що мені подобалось , а читала все , що запорву , без жадної заборони .	Кобилянської	13	Gen
Коли це веде лисичка свого пана Коцького .	Коцького	6	Acc
Навіть добре знаючи про повішаних угорськими військовими гуцулів у першу світову , про погром на Красному Полі .	Полі	16	Loc
Співрозмовники УП , знайомі з матеріалами кримінального провадження , звертають увагу на те , що єдиний із затриманих , хто мав відношення до МВС – Павло Полчанов .	Полчанов	26	Nom
Мотря утерла рукавом сльози й простогнала ...	Мотря	0	Nom
Час від часу Джон їздив автостопом до Ноттінгему по пенсію .	Ноттінгему	7	Gen
До речі буде запримітити , що мр . Віллі Морріс мав ресторан при Вестчестрі - авеню , а мр . Фред Кетлінг був босом у фабриці яринних консерв на 10-му стріті .	Віллі	8	Nom
Армійський особіст багато разів викликав мене вночі на співбесіду , пропонуючи вступати у вище училище КҐБ на факультет урядового зв’язку .	КҐБ	15	Gen
У його поляресі лежала квитанція на штраф за безквитковий проїзд у підміському поїзді Стрий — Івано-Франківськ , виписана гражданіну Сідхардхє .	Івано-Франківськ	15	Nom
« Ось якого листа надіслав мені Валентин Щербачов .	Валентин	6	Nom
Тета Міра купувала в « Дружбі » неймовірну кількість книжок .	Міра	1	Nom
Про коломийську гімназію я знав від п . Мелетія Кічури , з яким часто і приязно зустрічаюся тут , у Києві .	Мелетія	8	Gen
Тоді тільки люди трохи забули про Хруща , як жнива настали .	Хруща	6	Acc
Єдиний адекватний член екіпажу корабля “ Заповіт ” ( якщо не брати до уваги героя Джеймса Франко ) — ШІ - автопілот , яку тупі людиська посилають під три чорти , назвавши кілька циферок .	Джеймса	15	Acc
Від Красної Поляни до лісничівки на кордоні треба було ще двадцять кілометрів іти пішки .	Красної	1	Gen
У Читі часто були піщані бурі .	Читі	1	Loc
Terra Mariana – Земля Діви Марії – таку назву отримало нове князівство у складі Священної Римської імперії , утворене 2 лютого 1207 року на території Лівонії – сучасних Латвії та Естонії .	Марії	5	Gen
Пріоритетною у колекції Музею є збірка українських народних картин , зокрема , славнозвісних « Козаків Мамаїв » , а також ікон народного письма ( 500 одиниць ) .	Мамаїв	15	Gen
– Уважайте на нього , щоб не покинув університету і не вступив до театру , – звертається колишня актриса театру " Руська бесіда " у Львові Ванда Янович до Хоми Водяного .	Львові	25	Loc
Молдавські володарі , що , здавалося би , міцно сиділи в Білгороді на Дністрі , терпіли тут наявність „ татарського царевича “ ще до нової татарської хвилі часів Менглі - Герая .	Герая	30	Gen
А Сара не безчестила фараона , вона більше того , зробила йому честь , ставши під його владу .	Сара	1	Nom
Екіпаж “ Заповіту ” — це фактично еліта з еліт , 18 найдостойніших космонавтів , яким доручили вкрай відповідальне завдання : перевезти і пильнувати колоністів .	Заповіту	2	Gen
Хто слухає соціологію реклами у Осипчук ?	Осипчук	5	Gen
Каракєджбі і цього було замало , він визнав мене після спеціальної перевірки — за п’ятнадцять секунд треба було знайти острів Робінзона Крузо .	Крузо	21	Gen
У 1949 році , зазнавши поразки від комуністичних збройних формувань Мао Цзедуна , підтримуваних СРСР , на острів Тайвань із материка втік очільник Гоміньдану генералісимус Чан Кайші .	Мао	10	Gen
( ні в Києві , ні у Львові , ні в Дніпрі - в жодному іншому місті , де я досі читала на презентаціях цей текст , подібної реакції не було ) .	Дніпрі	11	Loc
В одній з авдиторій стояло антикварне піаніно « Вайнбах » без половини необхідних струн , і ми з Фациком і Мациком грали в шість рук пісні « Бітлз » із самвидавівських фотокопій нот .	Вайнбах	8	Nom
Він вдарився , з глухим звуком , об ніс Гольдштейна та відскочив ; його голос лунав невблаганно .	Гольдштейна	9	Gen
Цей причинок ставить собі завдання розглянути деякий матеріял паскової кераміки з Південно - Східньої Европи під оглядом техніки посудини на ніжці , що може кинути світло теж на питання споріднености окремих форм та груп ( подунайського неоліту ) .	Европи	14	Gen
Вітайте Сосюру ; низенький уклін Хвильовому ( хай їде з Харкова ! ) і побажання всього найкращого Вам —	Харкова	10	Gen
Мовою Новосуржу їх називали : Мініправда , Мінімир , Мінілюб та Мінідостаток .	Новосуржу	1	Gen
Тепер тільки Оришка розібрала своє лихо .	Оришка	2	Nom
Він пропонував одружитися , але тета Міра навіть думати про таке не збиралася , бо Галан постійно шпортався і падав на усіх гірських стежках .	Міра	6	Nom
Унікальні кристали масою 68 кг і 117 кг знайдено на Житомирщині .	Житомирщині	10	Loc
Замовила нову книжку Роальда Дала - сподіваюсь , вона сподобається моїм малим не менше за " Чарлі та шоколадну фабрику " .	Дала	4	Gen
Як зазначає видання , Йохай також є фігурантом федерального розслідування в рамках справи про спільні з Манафортом угоди з нерухомістю .	Йохай	4	Nom
Той теж , як прийшов , то такого Лазаря скорчив ...	Лазаря	8	Acc
Ваша влада над ритмами росте невпинно , а таких речей , як перша поезія з « Плачу Ярославни » , як « Осінь » , як « Живем комуною » , в « Плузі » нема .	Ярославни	17	Gen
Французька неокласика , — де зануджений сонетист Мішель Вассон виписує сонетики , де бог , серце , сфінкс і Христос в оточенні інших щироміщанських і католицьких атрибутів танцюють поважний сонетовий кадриль .	Вассон	8	Nom
Спочатку ви кажете що в Могилянці заборонений плагіат , а потім показуєте на Дні ФПвН сцену з тарганом !	ФПвН	14	Gen
Татарські оселі за XV ст . були також в сучасній Бесарабії на межі або навіть за межею лісостепу — від татарського „ кишла нового “ пішла назва суч . Кишинева .	Кишинева	29	Gen
Народився 1981 року в Бельгії .	Бельгії	4	Loc
Повели Хруща у Гетьманське ; засадили в тюрму за залізні штиби ; давай випитувати та розпитувати .	Хруща	1	Acc
Нас не дивує , коли таким могильним запахом з насолодою упиваються Зерови й Могилянські , але нас обурює , коли про цю насолоду шамрикають і деякі пролетарські письменники .	Зерови	11	Nom
Дуже вимовною видається її реакція на польську рецепцію « Кассандри » : « З польської статті мені найбільше сподобалось те , що « Кассандра » страшна для поляків .	Кассандра	23	Nom
Домашня праця не цікавить більше Марію .	Марію	5	Acc
Член Ради Народніх Міністрів , котрому більшість Всенародніх Зборів УНР висловить недовірря , складає свою повновласть , і через 24 години після цього Всенародні Збори можуть приступити до заміщення його способом , вказаним в параграфі 53 .	УНР	9	Gen
Клод Сімон , Гемінґвей , Бернанос , Мальро , ті згадані вище відомі письменники були сучасниками або майже сучасниками подій громадянської війни .	Сімон	1	Nom
Поява Кріппса в уряді Черчіля — це дальший крок до большевизації Англії .	Англії	11	Gen
Телескоп названо на честь Едвіна Габбла .	Габбла	5	Gen
У царині міжнародної безпеки Велика Британія була партнером США у кожній масштабній інтервенції останніх 25 років : від Перської затоки до Афганістану , Іраку та Лівії .	Британія	5	Nom
Ще одним важливим пунктом стала « корпоративізація » Сінгапуру .	Сінгапуру	8	Gen
Ще одного близького приятеля Лариси Косач , перекладача Максима Славинського , замученого по другій світовій у радянській тюрмі , звинувачено в тому , що « опинився в таборі буржуазно - націоналістичної еміграції у Празі » .	Славинського	9	Acc
Призначити Надзвичайного і Повноважного Посла України в Королівстві Таїланд БЕШТУ Андрія Петровича Надзвичайним і Повноважним Послом України в Республіці Союз М’янма за сумісництвом .	БЕШТУ	9	Acc
До Арарату було зовсім близько .	Арарату	1	Gen
Світову славу здобули « Лужанська - 7 » , а також унікальна « Нафтуся » , що містить органічні речовини .	Нафтуся	13	Nom
А наш дах у Делятині попросту протікав .	Делятині	4	Loc
Кращі , ніж на сході , фізично - географічні умови сприяли концентрації степовиків саме в районі Дністрянсько - Дунайському , як це спостерігалося за часів Ногая .	Ногая	25	Gen
У Стокгольмі дійшли висновку , що достатньо одного тільки виду шведських військ , щоб влада Анни Леопольдівни і німців зруйнувалася , а нова імператриця в подяку за допомогу щедро наділить шведського короля російськими землями .	Анни	15	Gen
Коли приїхав Антоні Міро з Іспанії , ми з Ігорем повели його саме туди , бо на міську каву Міро запізнився .	Антоні	2	Nom
Сосницький раптом плигає :	Сосницький	0	Nom
Закриймо очі на те , що поломку “ Заповіта ” списали на безглузду причину типу “ на мою машину посвітило вранішнє сонце , тому в мене пом’явся кузов і фари розбились ” .	Заповіта	8	Gen
Черкаси поділені на квадрати й відстань від пункту А до пункту Б тут вимірюється кварталами .	Черкаси	0	Nom
Давно хотіла придбати " Алісу " , а тепер , коли з`явилася можливість , " товар відсутній " у київському інтернет - магазині .	Алісу	4	Acc
Олена Львівна Кульчицька ( 15 вересня 1877 , Бережани — 8 березня 1967 , Львів ) — український графік , маляр , педагог .	Львівна	1	Nom
Замовила нову книжку Роальда Дала - сподіваюсь , вона сподобається моїм малим не менше за " Чарлі та шоколадну фабрику " .	Чарлі	16	Acc
За 9 км північніше від АЕС проходить залізнична лінія Шепетівка — Здолбунів — Львів , на якій розташована залізнична станція Кривин , до якої примикає під'їзна залізнична колія електростанції .	Львів	13	Nom
Повірка виборів належить Судові УНР .	УНР	4	Gen
Мр . Фред Кетлінг прочитав програму від дошки до дошки , потім добув годинник , що вказував чверть на сему , і сказав коротко :	Фред	2	Nom
Каракєджба придумував спеціальні вправи — висіти на перекладині вниз головою , бігати смугою перешкод із зав’язаними очима .	Каракєджба	0	Nom
Зате як комедія “ Заповіт ” дуже навіть непоганий .	Заповіт	4	Nom
Виліз пан Коцький на стіл та почав їсти , аж за ушима лящить .	Коцький	2	Nom
Джеффрі Йохай , колишній зять Пола Манафорта - екс-голови кампанії президента США Дональда Трампа - зустрічався зі слідчими в рамках розслідування справи про можливе відмивання грошей чи податкові порушення під час співпраці Манафорта з Партією регіонів .	Манафорта	32	Gen
Було приємно бачити кріпкі й дужі ноги , вузькі стегна , плаский живіт , м’язисті руки , тверду шию , засмалені жовто - бронзові тіла й несховане бажання , але Вер нехтувала їх .	Вер	30	Nom
Довкола були яблуневі сади , і начальник медчастини прапорщик Бек вливав кожному , хто надкусив яблуко , десять літрів води з марганцівкою .	Бек	9	Nom
Він узяв з полиці пляшку з безбарвною рідиною на якій була простенька біла етикетка з написом ДЖИН ПЕРЕМОГА .	ПЕРЕМОГА	17	Nom
Маю два чудові ілюстровані видання Гаррі Поттера .	Гаррі	5	Gen
Олена Львівна Кульчицька ( 15 вересня 1877 , Бережани — 8 березня 1967 , Львів ) — український графік , маляр , педагог .	Бережани	8	Nom
Я налічила 6 великих яхт і 18 менших , а три великі пароходи стоять увесь час напроти нас нерухомо і щовечора наводять світло електричне на Сан-Ремо .	Сан-Ремо	25	Acc
Юрко досконало вивчив усі оповідання про Голмса , він міг безпомилково назвати прізвища навіть другорядних героїв , усі топоніми і власні назви садиб , маєтків і замків , що згадувалися у будь-якому оповіданні .	Юрко	0	Nom
Її клубом була крамничка іноземної літератури « Дружба » .	Дружба	7	Nom
Образи його знаходяться у Празі в костелах Францішканів і Капуцинів та у Мельнику .	Празі	4	Loc
Також на Донеччині міститься надзвичайної краси каньйон у долині річки Кальміус .	Кальміус	10	Nom
Terra Mariana – Земля Діви Марії – таку назву отримало нове князівство у складі Священної Римської імперії , утворене 2 лютого 1207 року на території Лівонії – сучасних Латвії та Естонії .	Лівонії	25	Gen
Інколи їх відвідує батько Валентини .	Валентини	4	Gen
Молодша від Курбаса на 12 років .	Курбаса	2	Gen
Вольфрам збільшив обсяг тексту , довів до кінця фабульні зв'язки та вніс деякі зміни в основний сюжет , розроблений Кретьєном , але в цілому дотримувався задуму останнього .	Вольфрам	0	Nom
Ми ж на той час прочитали весь багатотомник Дюма і могли розповісти багато чого , що не потрапило в екранізацію , — серіали були тоді скороченими версіями романів .	Дюма	8	Gen
Як завжди , обличчя Еммануеля Гольдштейна , Ворога Народу , спалахнуло на екрані .	Гольдштейна	5	Gen
В неокласичний французький рух не можна не зарахувати ще й Мусса , вояку й патріота , який , побиваючи « бошів » , дістав медаль , а виспівуванням війни дістав поетичну премію Сюллі Прюдома .	Прюдома	33	Gen
“ Чужий : Заповіт ” хоча і мав намір однаково потягати елементи з “ Чужого ” та “ Чужих ” , завдяки безликим і безмозким персонажам не працює ні як трилер , ні як бойовик .	Заповіт	3	Nom
Мало не сто років тому Микола Зеров радив не гаючись « перевіяти на току критики » наші мистецькі набутки , відсіяти полову , виважити все найдобірніше й означити тяглість національної традиції .	Зеров	6	Nom
Режисер звертає увагу на танцівницю Валентину Чистякову .	Чистякову	6	Acc
І дійшло до того , що Марія часом не приходила на ніч додому .	Марія	6	Nom
Хрущ іде !..	Хрущ	0	Nom
Він завис у Франківську .	Франківську	3	Loc
Втім , екіпаж корабля “ Заповіт ” запросто перепльовує усі здобутки попередників .	Заповіт	5	Nom
Доречі , про Гонтарєву .	Гонтарєву	3	Acc
Згадайте лише як спіймали на хабарі екс-заступника міністра охорони здоров’я Романа Василишина , який довгий час до того працював головним лікарем Жовтневої лікарні в Києві ?	Києві	24	Loc
Про це повідомив у « Фейсбуці » друг Валентина Щербачова , журналіст Віталій Довгич .	Фейсбуці	5	Loc
Останнє питання було найгострішим , тож до Відня було надіслано телеграму : « Посварилася з тіткою .	Відня	7	Gen
Коли підписали Мюнхенські угоди в 1938-му , розділили Чехословаччину , потисли одне одному руки й думали , що жодних наслідків це за собою не потягне .	Чехословаччину	8	Acc
" Все невеличке приміщення театру було густо насичене запахами аніліну й клею , – згадує початок 1918 року Леонід Болобан , учень студії Курбаса .	Болобан	19	Nom
Втім , лише на перший погляд , адже Організація українських націоналістів і безпосередньо Коновалець підтримували тісний контакт із японськими урядовими колами , а згодом за підтримки офіційного Токіо розбудовували свою мережу на Далекому Сході .	Коновалець	13	Nom
Державне підприємство « Конструкторське бюро „ Південне “ ім . М . К . Янгеля » було створено 1951 як конструкторський відділ Південного машинобудівного заводу з виробництва військових ракет .	К	12	Gen
Зазначається , що Йохай надав федеральним слідчим інформацію та документи понад 2 місяці тому .	Йохай	3	Nom
Проти виступив Сталін : сказав , що не хоче бачити чоловіків у спідницях і вважає шкідливими для здоров'я часті там тумани .	Сталін	2	Nom
Про коломийську гімназію я знав від п . Мелетія Кічури , з яким часто і приязно зустрічаюся тут , у Києві .	Києві	20	Loc
— Ну , Сосницький , давай у кумпанії ?	Сосницький	3	Nom
В Оришки затіпались челюсті , забігала по виду мишка .	Оришки	1	Gen
Ба більше : було ініційоване розслідування проти дружини і сина самого Лі Куан Ю – з допитами і всіма необхідними за законом процедурами .	Ю	13	Gen
Перед тим , як повіситися , пані Ірця принесла до нас свою колекцію срібного начиння і попросила , щоби ми віддали його урядові незалежної України .	Ірця	7	Nom
Добре нині відомі « Поляна Квасова » , « Свалява » , « Лужанська » , « Шаянська » тощо .	Свалява	9	Nom
Одарка почала й собі на Гната .	Гната	5	Acc
3 листопада 1937 року розстріляний у лісовому урочищі Сандармох у Карелії	Сандармох	8	Nom
Глави держав - учасників антигітлерівської коаліції – президент США Франклін Рузвельт , прем'єр - міністр Великої Британії Вінстон Черчилль та голова Ради народних комісарів СРСР Йосиф Сталін – протягом тижня обговорювали майбутній політичний устрій світу .	Британії	16	Gen
Джон Сіддгартга , мандрівний в’язень ноттінгемський — так Юрко Андрухович назвав його у присвяченій Джонові « Перверзії » .	Перверзії	16	Loc
Орбітальний телескоп для досліджень Сонця було запущено Великобританією 1962 року в рамках програми « Аріель » , а 1966 року NASA запустила в космос першу орбітальну обсерваторію OAO - 1 ( англ . Orbiting Astronomical Observatory ) .	Аріель	14	Nom
Щодо самої постаті Сковороди , то вона не історична .	Сковороди	3	Gen
Французька неокласика , — де зануджений сонетист Мішель Вассон виписує сонетики , де бог , серце , сфінкс і Христос в оточенні інших щироміщанських і католицьких атрибутів танцюють поважний сонетовий кадриль .	Мішель	7	Nom
Найбільшими покупцями є США ( на $ 18 , 9 млн ) , Німеччина ( на $ 10 млн ) і Польща ( на $ 5 , 6 млн ) .	Польща	21	Nom
Заєць розказав за пана Коцького вовкові , ведмедеві , дикому кабанові .	Коцького	4	Acc
Зелена кава з плантацій громадянської війни у Нікараґуа .	Нікараґуа	7	Loc
Також на Донеччині міститься надзвичайної краси каньйон у долині річки Кальміус .	Донеччині	2	Loc
– Раніше зими були такі , що снігу випадало по півметра , а то й більше , – розповідає директор Колочавського музею в Міжгірському районі на Закарпатті Василь Дербак , 73 роки .	Закарпатті	26	Loc
Ім'я Волтера Вайта нагадує поета Волта Вітмена , що відіграло важливу роль у сюжеті , аж до середини фінального п'ятого сезону .	Вайта	2	Gen
Головні ролі у стрічці виконують Руні Мара ( продавчиня ) і Кейт Бланшет ( Керол ) .	Руні	5	Nom
Уродженцем села є співак - бас , соліст хорової капели " Думка " Володимир Вітвиновський ( 1924 - 1999 ) , український поет Петриченко Олександр Тихонович ( 1923 ) .	Вітвиновський	14	Nom
У Стокгольмі дійшли висновку , що достатньо одного тільки виду шведських військ , щоб влада Анни Леопольдівни і німців зруйнувалася , а нова імператриця в подяку за допомогу щедро наділить шведського короля російськими землями .	Леопольдівни	16	Gen
При спробі перетину Державного кордону на міжнародному пункті пропуску « Бачівськ » співробітниками Сумської митниці Державної фіскальної служби був зупинений рейсовий автобус Одеса - Москва .	Бачівськ	10	Nom
Автор низки статей та книжок , працює радником кількох компаній , урядів країн , інституцій Євросоюзу .	Євросоюзу	15	Gen
Погроза Володимира Винниченка перейти в сусідню літературу , писати для російського читача , краще здатного оцінити талановитого автора , спричинила серйозний конфлікт .	Володимира	1	Gen
Вінстон повернув вимикача і голос дещо вщух , одначе слова що лунали ще можна було розібрати .	Вінстон	0	Nom
Коли ж воліли спокійного і затяжного напивання , запускали Тома Вейтса або Елємент оф крайм .	Вейтса	10	Acc
Тим часом матір нового президента США була шотландкою ; він не раз висловлював захоплення королевою і , як відомо , з нетерпінням чекає на гостини в Єлизавети II .	Єлизавети	26	Gen
Розвиток залізниці на початку XIX ст . зробив доступними для багатьох людей поїздки на морські узбережжя , де були громадські курорти Європи , а також до зон відпочинку з термальними водами в Баден - Бадені .	Баден	32	Nom
Цей підрозділ формувався на основі добровольців від політичної партії " Братство " Дмитра Корчинського .	Корчинського	13	Gen
Приїхали ми у Дзвонкове , зупинилися в земляка , перекусили - й зразу вирушили в ліс .	Дзвонкове	3	Acc
Хай не гнівається ( скажіть йому ) , що я не прислав рецензії на Дорошкевича .	Дорошкевича	14	Acc
Смажити люблю на соняшниковій рафінованій а салати заправляти - оливковою або справжньою натуральною олією , мені її з Вінниці родичі передають ..	Вінниці	18	Gen
Юрко звідкись дістав цілий мішок промоційних пачок чудових сиґарет бенсон і ґеджес , у кожній пачечці вміщалося три сиґарети .	бенсон	9	Nom
А завдяки тому , що ячмінь не дуже боїться холодів , його сіють у Фінляндії аж біля Північного кола , в Тибеті й Непалі сіють — на захмарній висоті у пів - Евересту .	Фінляндії	14	Loc
Інший знайомий з Франківська зустрічався у Львові з донькою шведської красуні і арабського багача .	Франківська	3	Gen
І якщо її врода зроблена штучним шляхом , тоді всі Ваші Кіра Найтлі , Діана Крюгер , Наталі Портман , Кейт Хадсон без макаяжу тихий жах , а макаяж - це також штучність .	Діана	14	Nom
Тета Міра виписувала в окремі зошити українські прізвища , систематизуючи їх за певними ознаками .	Міра	1	Nom
Через нього працівники американського посольства цілий місяць не видавали віз нікому з Франківська .	Франківська	12	Gen
А вже Михайла Грушевського та Володимира Винниченка очорнено найстрашнішими епітетами , і зостається тільки дивом дивуватися , як же могла Лариса Косач знатися та ще й листуватися з такими звироднілими й аморальними людьцями .	Володимира	5	Acc
І хочу також подякувати вам за чудову трилогію про джур : мій 10-річний син з минулої осені перечитав її тричі та називає Рутківського своїм улюбленим письменником :)	Рутківського	22	Acc
Призначити Надзвичайного і Повноважного Посла України в Королівстві Таїланд БЕШТУ Андрія Петровича Надзвичайним і Повноважним Послом України в Республіці Союз М’янма за сумісництвом .	Петровича	11	Acc
А у подорожі були вниз по Дніпру у 1995-му .	Дніпру	6	Loc
8 лютого 1965-го парламент Великої Британії заборонив рекламу сигарет на телебаченні .	Британії	5	Gen
Глави держав - учасників антигітлерівської коаліції – президент США Франклін Рузвельт , прем'єр - міністр Великої Британії Вінстон Черчилль та голова Ради народних комісарів СРСР Йосиф Сталін – протягом тижня обговорювали майбутній політичний устрій світу .	Сталін	26	Nom
Підписав Указ про нагородження генерал - полковника Геннадія Воробйова орденом Богдана Хмельницького I ступеня посмертно .	Воробйова	8	Gen
« Дуже важлива солідарна позиція країн ЄС , вже висловлена лідерами Німеччини , Франції , Великої Британії , що санкції мають тривати до повного виконання Мінських угод , тобто , до повернення Україною контролю над кордоном .	ЄС	6	Gen
Ба більше : було ініційоване розслідування проти дружини і сина самого Лі Куан Ю – з допитами і всіма необхідними за законом процедурами .	Куан	12	Gen
У місті Київ з 2009 року працює дельфінарій " НЕМО " ТОВ " Нерум " , розташований у Голосіївському районі за адресою проспект Академіка Глушкова , 9 .	НЕМО	9	Nom
Частина акторів разом із режисером на літо їдуть до Одеси .	Одеси	9	Gen
Це глибинна парадигма , яка закладена ще в часи формування доктрини Третього Риму і діє майже безвідмовно .	Риму	12	Gen
( “ Сибір неісходиму ” було нерішучою рукою закреслено густим чорним чорнилом , а вгорі тою ж рукою написано знову : “ Сибір неісходиму ” . )	Сибір	22	Acc
Згадайте лише як спіймали на хабарі екс-заступника міністра охорони здоров’я Романа Василишина , який довгий час до того працював головним лікарем Жовтневої лікарні в Києві ?	Романа	10	Acc
Початки підготовки полягали у вивченні досвіду спецслужб усього світу — всього , що могло бути доступним в СРСР .	СРСР	17	Loc
Однак 1762 року англійський ботанік Джон Гілл відніс цю рослину до роду Cyanus , який 1754 був виділений Філіпом Міллером із роду Centaurea .	Джон	5	Nom
Щиро дякуємо пані К . Лазор ( колишній дружині О . Кандиби ) за дозвіл надрукувати цей рукопис у нашому журналі .	Кандиби	11	Gen
Ірина , Івано-франківськ .	Івано-франківськ	2	Nom
Більше , ніж новини про перекриття частини Сагайдачного і 40 метрів ЯрВалу , мене радує тільки взривання пуканів водіїв , які впевнені , що місто існує тільки для їхніх гавнотачок	Сагайдачного	7	Gen
Був вересень , п’ятдесятиріччя приєднання Західної України до УРСР .	УРСР	8	Gen
Уродженцем села є співак - бас , соліст хорової капели " Думка " Володимир Вітвиновський ( 1924 - 1999 ) , український поет Петриченко Олександр Тихонович ( 1923 ) .	Петриченко	23	Nom
Вони прийшли по вас , друже « Кий » , — але він прийшов по мене !..	Кий	7	Nom
— Мамо , — питаю після того , як куці студентські новини розказано ( сесію здав , костюм ось купив ) , — а чого тітка Марфа Яркова на мене так дивиться ?	Яркова	27	Nom
Коли вже буде хоча б відремонтовано дитячий майданчик між вулицями Лагунової та Гагаріна , біля садочку " Ромашка " ?	Лагунової	10	Gen
Єдиний порядний вчитель української мови і літератури щодня водив Юрка до театру , на всі концерти класичної музики і художні виставки .	Юрка	9	Acc
Шерлок Голмс розпалив у ньому інтерес до знань .	Голмс	1	Nom
Доки Більбо підбирав камінці , павук дістався до Бомбура — і незабаром ґномові прийшов би кінець .	Бомбура	8	Gen
Сьогодні зранку - зранечку , зранечку - зісвітаночку Славік залетів у школу й на коридорі , наче велосипедист у коня ( Equus ) , врізався в завучку Надію Петрівну Проскурню .	Проскурню	29	Acc
До уваги мешканців та гостей Одеси !	Одеси	5	Gen
Варто зазначити , що Валентин Щербачов — володар відзнаки « Всенародне визнання » Спілки журналістів України , у 1992 - 1999 роках очолював Федерацію спортивних журналістів України .	Щербачов	5	Nom
Зійшлися вони докупи , стали думати , як би побачити пана Коцького , — та й кажуть :	Коцького	11	Acc
Якоїсь миті Вінстон ясно зрозумів що горлає разом із рештою та жорстоко , ба навіть брутально , лупить своєю п’ятою по обідку свого ж таки стільця .	Вінстон	2	Nom
Він просто про принцип Маха чув , але не зрозумів .	Маха	4	Gen
У листах авторка « Боярині » висловлюється навпростець : « … нам , українцям , не щастила доля ніколи в тій Московщині » .	Московщині	21	Loc
Посол Нолькен повідомив у Стокгольм , що Російська імперія на межі державного перевороту і що війська не будуть битися за Анну Леопольдівну .	Стокгольм	4	Acc
Всі вони однакові , і ті , що УНР будували , і ті , що до УСРР зараз примазуються .	УСРР	16	Gen
До речі буде запримітити , що мр . Віллі Морріс мав ресторан при Вестчестрі - авеню , а мр . Фред Кетлінг був босом у фабриці яринних консерв на 10-му стріті .	Морріс	9	Nom
Кріппс буде вже тепер диктувати в Англії під музику Сталіна .	Сталіна	9	Gen
Дзержинці дві години блокували берег , не наважуючись ступити на підталу кригу , вмовляючи Пуню здатися і навіть обіцяючи повну амністію .	Пуню	14	Acc
Сестра Віталія була нашою далекою родичкою по лінії Ігнатія .	Віталія	1	Nom
( ні в Києві , ні у Львові , ні в Дніпрі - в жодному іншому місті , де я досі читала на презентаціях цей текст , подібної реакції не було ) .	Києві	3	Loc
Пояс порвався на Кавказі , в горах Абхазії , на кордоні Пслух .	Абхазії	7	Gen
Джеффрі Йохай , колишній зять Пола Манафорта - екс-голови кампанії президента США Дональда Трампа - зустрічався зі слідчими в рамках розслідування справи про можливе відмивання грошей чи податкові порушення під час співпраці Манафорта з Партією регіонів .	Трампа	13	Gen
Інший знайомий з Франківська зустрічався у Львові з донькою шведської красуні і арабського багача .	Львові	6	Loc
Ісус ловив рибу .	Ісус	0	Nom
Головні ролі у стрічці виконують Руні Мара ( продавчиня ) і Кейт Бланшет ( Керол ) .	Мара	6	Nom
« Камену » Сосюрі не вислав , бо казали мені — він у Криму .	Камену	1	Acc
Цю китайську територію японські війська захопили на початку 1930-х і проголосили маріонеткову державу Маньчжоу-Го .	Маньчжоу-Го	13	Acc
А вже Михайла Грушевського та Володимира Винниченка очорнено найстрашнішими епітетами , і зостається тільки дивом дивуватися , як же могла Лариса Косач знатися та ще й листуватися з такими звироднілими й аморальними людьцями .	Лариса	20	Nom
Ніхто з попередників Дональда Трампа не відвідував Велику Британію так скоро після вступу на посаду .	Британію	8	Acc
Ці фрагменти — вочевидь , усе , що залишилось нам від “ Прометея 2 ” — надто вже виділяються на тлі океану кретинізму , що панує в “ Заповіті ” .	Прометея	12	Gen
Ефектна співачка Бейонсе , яка цьогоріч “ загребла ” аж шість статуеток , прибула з донькою , схудла Кім Кардаш’ян прибула — з чоловіком .	Кім	18	Nom
Про с . Кобаки і снятинський період дещо розповідав мені Антон І . Онищук .	Кобаки	3	Acc
( ні в Києві , ні у Львові , ні в Дніпрі - в жодному іншому місті , де я досі читала на презентаціях цей текст , подібної реакції не було ) .	Львові	7	Loc
Смерть Іслама Карімова ще не була публічно оголошена .	Карімова	2	Gen
ВВП на душу населення Тайваню ( $ 145 ) тоді мало відрізнявся від Ефіопії або Сомалі .	Сомалі	15	Gen
Найглибші шахти світу знаходяться в Індії ( шахта « Чемпіон - Риф » ) та в ПАР : « Тау-Тона » , « Вітватерсранд » ( глибина понад 4 , 5 км ) .	Вітватерсранд	23	Nom
Як відомо , агенти ФБР провели обшук у будинку Пола Манафорта , вилучивши документи та інші матеріали .	Пола	9	Gen
Замовила нову книжку Роальда Дала - сподіваюсь , вона сподобається моїм малим не менше за " Чарлі та шоколадну фабрику " .	Роальда	3	Gen
Олена Львівна Кульчицька ( 15 вересня 1877 , Бережани — 8 березня 1967 , Львів ) — український графік , маляр , педагог .	Львів	14	Nom
Марія Василівна , як актриса після важкої ролі , інколи виходила з образу “ вчительки з великої літери ” й ставала тією , кого треба покарати .	Василівна	1	Nom
Джеффрі Йохай , колишній зять Пола Манафорта - екс-голови кампанії президента США Дональда Трампа - зустрічався зі слідчими в рамках розслідування справи про можливе відмивання грошей чи податкові порушення під час співпраці Манафорта з Партією регіонів .	Пола	5	Gen
Вранці Степан вийшов до неї на пристань і довго махав кашкетом її хустині .	Степан	1	Nom
Мабуть , тому Лондон так поспішав запросити Трампа до Букінгемського палацу .	Трампа	7	Acc
" Курбас блискуче провів свій дебют і був нагороджений оплесками глядачів , – згадує актриса Ганна Юрчакова виступ театру " Руська бесіда " у Самборі 1912 року .	Ганна	15	Nom
Тільки моя мама може передавати консервований тунець у Норвегію .	Норвегію	8	Acc
Американські слідчі сподіваються переконати Пола Манафорта , екс-керівника передвиборчої кампанії президента США Дональда Трампа , співпрацювати з ними у розслідуванні можливої змови між штабом Трампа і Росією .	Трампа	13	Gen
Команди змагатимуться на території дитячого табору відпочинку « Зоряний » ПАТ « Сумихімпром » ( с . Вільшанка Сумського району ) .	Зоряний	8	Nom
Життя - це транспортна система Києва і ти в ній - метро на Троєщину	Троєщину	13	Acc
Скільки їй видав Шетарді — точно не встановлено .	Шетарді	3	Nom
У попередніх сезонах Гейл Ботікер дав Волту копію книги , яка неодноразово була показана з того часу .	Гейл	3	Nom
Тож у середині 1930-х до Харбіна перекинуто кількох членів ОУН , які одразу зайняли помітні ролі в Українській національній колонії , зокрема в Союзі української молоді ( СУМ ) , і почали видавати часопис « Далекий Схід » .	СУМ	27	Nom
Хочу звернутися до всіх жителів гуртожитку на Троєщині , а саме на Марини Цвєтаєвої .	Троєщині	7	Loc
Якось знайомі з Америки запропонували їй влаштувати виставку Новаківського у Нью-Йорку .	Нью-Йорку	10	Loc
Хочу звернутися до всіх жителів гуртожитку на Троєщині , а саме на Марини Цвєтаєвої .	Марини	12	Gen
У Джона був знайомий , якому треба було поїхати машиною в Україну .	Україну	11	Acc
Терра Маріана проіснувала до 1561-го , коли її поділили між собою Швеція і Велике князівство Литовське	Терра	0	Nom
Із Батумі приїхала десятикласниця , котра вже понад рік терпіла без Каракєджби .	Батумі	1	Gen
До Кутаїсі ми прилетіли зранку з польського міста Катовіце , позаяк набагато дешевше летіти звідти , ніж з України .	Кутаїсі	1	Gen
Їх цікавлять лише потужні пасажиропотоки , чим Україна наразі похвалитися не може » , — каже авіаційний експерт Богдан Долінце .	Долінце	19	Nom
Проте Оксанки ти не зможеш замінити ніким іншим .	Оксанки	1	Gen
Вер любила пляж , річку , смугу біло - жовтого піску , берег , верболіз , натовп .	Вер	0	Nom
Джеффрі Йохай , колишній зять Пола Манафорта - екс-голови кампанії президента США Дональда Трампа - зустрічався зі слідчими в рамках розслідування справи про можливе відмивання грошей чи податкові порушення під час співпраці Манафорта з Партією регіонів .	Дональда	12	Gen
Мабуть , тому Лондон так поспішав запросити Трампа до Букінгемського палацу .	Лондон	3	Nom
Терра Маріана проіснувала до 1561-го , коли її поділили між собою Швеція і Велике князівство Литовське	Маріана	1	Nom
У Читі наймоднішим набором вважалися тяжкі черевики , наручний годинник і велосипед .	Читі	1	Loc
Літак до Львова летів так низько , що в якомусь місці біля Криму було видно два моря .	Криму	12	Gen
Щодо розцяцькованого похоронного вінка в руках завучки Надії Петрівни Проскурні й загалом цієї пишної історії , то всі дороги вели до дев’ятикласника Ярослава Копчука .	Проскурні	9	Gen
Я вже й не кажу про те , що Руссо тоді , як мандрував Сковорода , Європа ще не знала , — та чи й був Сковорода у Женеві ?	Сковорода	26	Nom
Пояс порвався на Кавказі , в горах Абхазії , на кордоні Пслух .	Пслух	11	Nom
Непересічній події 100-літньої давнини присвячено ряд заходів , організованих Львівською митрополією УГКЦ та Національним музеєм ім . Андрея Шептицького ( м . Львів , пр . Свободи , 20 ) .	Андрея	17	Gen
Усіма військовими справами ЗУНР відав ДСВС , що діяв до 9 червня 1919 року та поділявся на Військову канцелярію ДСВС і 16 відділів .	ДСВС	19	Gen
Ми навіть були приготовили склад першого уряду Зеленої України , який складався з найбільш знаних українців на Далекому Сході поза межами СССР » , — згадував Купецький .	Купецький	26	Nom
Пояс порвався на Кавказі , в горах Абхазії , на кордоні Пслух .	Кавказі	3	Loc
Вчора отримав восьму частину Гаррі Поттера і щойно її дочитав .	Поттера	5	Gen
Вулиці Відня та тепла погода надихають на гарні думки , прогуляйтесь зі мною ;)	Відня	1	Gen
Охоронці пропускали мене , коли я йшов з вечірнього потяга з Франківська , несучи двох малих дітей , котрі вже спали .	Франківська	11	Gen
Коли станеться якась заворушка — казав він — то по Тарасові , якщо він загине офіцером , родина буде отримувати значно більшу пенсію .	Тарасові	10	Loc
Текст Василя Овсієнка - старий , але досі найбільш " підручниково " - інформативний , для тих , хто не застав і не пам'ятає : http://umoloda.kiev.ua/number/163/0/71564	Овсієнка	2	Gen
Я вже й не кажу про те , що Руссо тоді , як мандрував Сковорода , Європа ще не знала , — та чи й був Сковорода у Женеві ?	Женеві	28	Loc
Оришка пильно дивилася на неї .	Оришка	0	Nom
Джон Сіддгартга , мандрівний в’язень ноттінгемський — так Юрко Андрухович назвав його у присвяченій Джонові « Перверзії » .	Сіддгартга	1	Nom
У генеральному плані міста територія , на якій орендар – ТОВ “ Київщина - Житло ” – зводитиме багатоповерхівки , досі позначена як « ліси » , цей план не змінювався роками .	Київщина	12	Nom
Весь ФПвН буде вам вдячний .	ФПвН	1	Nom
Ооо , а я читаю це якраз в дорозі назад в київ ( сережка постійно в гаманці з собою )	київ	11	Acc
Toyota в рамках програми знайомства української аудиторії з гібридними технологіями представила креативну експозицію на Фестивалі вуличної їжі , який проходить у Києві .	Києві	21	Loc
Кримінальна поліція Мукачева провела ряд оперативних заходів та встановила , що цю крадіжку скоїв 33-річний непрацюючий мукачівець .	Мукачева	2	Gen
Перші зв’язки з японцями ОУН налагодить уже на початку 1930-х — у той час доволі гучною акцією , яку розглядала Ліга Націй , була пацифікація , котру поляки проводили на Галичині .	Галичині	30	Loc
На вул Короленка ( площа – 469 кв . м . ) приноситиме відповідно 159 грн на день і 4761 грн на місяць .	Короленка	2	Gen
Так , недавно кілька читачів охарактеризували як « джинсу » цілком невинний матеріал на « Українській правді » про мого колишнього студента Руслана Кавацюка , оскільки текст видався їм занадто добрим і позитивним , щоб бути правдою .	Руслана	22	Acc
У 1949 році , зазнавши поразки від комуністичних збройних формувань Мао Цзедуна , підтримуваних СРСР , на острів Тайвань із материка втік очільник Гоміньдану генералісимус Чан Кайші .	Кайші	26	Nom
Для тих , хто в Варшаві : 1 лютого в Teatrze Polskim будуть - Сестри Тельнюк !	Варшаві	5	Loc
Про с . Кобаки і снятинський період дещо розповідав мені Антон І . Онищук .	Онищук	13	Nom
Тут слово « тітка » позначало японців , « Оля » позначало — провідника націоналістичної групи .	Оля	9	Nom
Я хотів би , щоб моїми устами зараз промовляв до вас Валерій Марченко , мій табірний побратим , який заплатив за своє вільне журналістське слово багатьма роками увʼязнення і мученицькою смертю .	Валерій	11	Nom
На ґанку Карпової хати стоїть Марфа Яркова і веде мене очима .	Марфа	5	Nom
Згідно з інформацією сайту Національної поліції , Полчанов служив в роті поліції " Свята Марія " .	Полчанов	7	Nom
Прикрили fs.to .	fs.to	1	Acc
Було тут « утро » , що врядили приїжджі росіяни з Ніцци , але таке погане , що не тільки акторам , а навіть публіці було сором і ніяково дивитись одним на других …	Ніцци	11	Gen
Люблю я його дуже , але думаю , що для Парнасу йому не стає мови , а для масового читача він роблений і « холодний » .	Парнасу	10	Gen
Невже ти ніколи не чув про Павла Тичину , що цей автор всесоюзного і європейського маштабу є членом Вапліте і творець тих пісень , що їх щоразу співає гордість нашої Республіки капеля " Думка " ?	Павла	6	Acc
Тож у середині 1930-х до Харбіна перекинуто кількох членів ОУН , які одразу зайняли помітні ролі в Українській національній колонії , зокрема в Союзі української молоді ( СУМ ) , і почали видавати часопис « Далекий Схід » .	ОУН	9	Gen
В фізиці Аристотеля нема інерції .	Аристотеля	2	Gen
У нас у Керелівці всі свято впевнені , що Тарас народився таки в нашому селі , а не в Моринцях .	Керелівці	3	Loc
Текст Василя Овсієнка - старий , але досі найбільш " підручниково " - інформативний , для тих , хто не застав і не пам'ятає : http://umoloda.kiev.ua/number/163/0/71564	Василя	1	Gen
" За даними джерел , Мінюст домагається співпраці від Йохая у зв'язку з розслідуванням справи Манафорта через можливе відмивання коштів чи податкові порушення під час його співпраці з проросійськими партіями в Україні " , - зазначає видання .	Мінюст	5	Nom
Фінансова система України залишається чи не найбільш уразливим місцем у державі : попри заяви очільниці НБУ про « очищення » банківської сфери , у нас продовжується « банкопад » , не створено умов для відновлення кредитування реального сектору економіки .	НБУ	15	Gen
Ця заввага літературознавця погано корелює зі свідченням самої поетеси у листі до Ольги Кобилянської : « … вчилась тільки того , що мені подобалось , а читала все , що запорву , без жадної заборони .	Ольги	12	Gen
Коли буде другий ілюстрований Поттер в Ашані ??	Поттер	4	Nom
Програми Двох Хвилин Ненависті різнилися кожного дня , але не було жодної де б Гольдштейн не виконував головну роль .	Гольдштейн	14	Nom
Бангладеш та « Укроборонпром » домовляються про модернізацію « АНів »	Бангладеш	0	Nom
" За даними джерел , Мінюст домагається співпраці від Йохая у зв'язку з розслідуванням справи Манафорта через можливе відмивання коштів чи податкові порушення під час його співпраці з проросійськими партіями в Україні " , - зазначає видання .	Манафорта	15	Gen
Вчора отримав восьму частину Гаррі Поттера і щойно її дочитав .	Гаррі	4	Gen
Більше , ніж новини про перекриття частини Сагайдачного і 40 метрів ЯрВалу , мене радує тільки взривання пуканів водіїв , які впевнені , що місто існує тільки для їхніх гавнотачок	ЯрВалу	11	Gen
Із Батумі приїхала десятикласниця , котра вже понад рік терпіла без Каракєджби .	Каракєджби	11	Gen
Про рік 1874-й я знав від С . О . Єфремова , який знайшов ще листи , писані Вами з Відня до видавництва « Вік » .	Відня	20	Gen
Ти завжди з зацікавленням стежиш за оголошеннями театрів — і напевно з жагою чекаєш побачити нову п'єсу автора " 97 " т . Куліша — " Народний Малахій " .	Куліша	23	Gen
Половинчик — село в Україні , в Монастерищенському районі Черкаської області .	Половинчик	0	Nom
Двоє безпосередніх учасників нападу Гриць Купецький та Григорій Файда , а також провідник дрогобицької боївки УВО — ОУН Михайло Гнатів нелегально покинуть межі Польщі й опиняться на Заході .	Файда	8	Nom
Про це повідомив у « Фейсбуці » друг Валентина Щербачова , журналіст Віталій Довгич .	Щербачова	9	Gen
На Київщині правоохоронці затримали 15 учасників злочинного угруповання , які тримали комплекс борделів в Києві і області .	Києві	14	Loc
Дочекавшись особистого прийому , Джон зайшов до покою .	Джон	4	Nom
Майкл уклін тобі )))	Майкл	0	Nom
Парціфаль ( нім . Parzival ) — містично - куртуазна поема Вольфрама фон Ешенбаха .	Парціфаль	0	Nom
У нас , виходить , закінчилося безробіття , з кадрами напряжонка , й Ольгу Петрівну Лішик ми замінити ніким не можемо .	Лішик	15	Acc
Начальниця дитячої кімнати Смірнова не пропускала нагоди вдарити когось із затриманих гумовим шланґом з піском .	Смірнова	3	Nom
Будь ласка відгукніться ті , хто переходив в Могилянку з Острозької академії або хоча б підкажіть , де таких можна знайти ?	Могилянку	8	Acc
Салтиков посилав його у недоступні місця і дивився , чим займаються різні звірі .	Салтиков	0	Nom
« Дуже важлива солідарна позиція країн ЄС , вже висловлена лідерами Німеччини , Франції , Великої Британії , що санкції мають тривати до повного виконання Мінських угод , тобто , до повернення Україною контролю над кордоном .	Франції	13	Gen
Вона глянула ще раз на Мотрю , поступилася назад , простогнала , сіла мовчки на піл , узявшись холодними руками за крайню дошку , щоб не впасти .	Мотрю	5	Acc
Як повідомляє Укргідрометцентр , у неділю переважно без опадів , хоча в західних і північних областях вдень місцями існуватимуть невеликі опади .	Укргідрометцентр	2	Nom
На той час було зрозуміло – Німеччина , яка восени 1939-го розпочала Другу світову війну , незабаром капітулює .	Німеччина	6	Nom
Тета Міра купувала в « Дружбі » неймовірну кількість книжок .	Дружбі	5	Loc
Парціфаль ( нім . Parzival ) — містично - куртуазна поема Вольфрама фон Ешенбаха .	Ешенбаха	13	Gen
Найменше , один раз , зустрічаються символи « щ » , « б » , « з » , « - » , « . » .	щ	8	Nom
Дідо зв’язався з будапештськими архівами , і йому надіслали поштою всі відомі фотопортрети Земельвайса .	Земельвайса	13	Gen
Тарас не любив псів , голубів , малих дітей і циганів .	Тарас	0	Nom
Софі виросла на кінному заводі .	Софі	0	Nom
— Щоб ти оту гору розкопав , і щоб туди Дніпро йшов , а коло того Дніпра побудуй комори : щоб байдаки туди приставали , й щоб ти ту пшеницю продав на байдаки .	Дніпра	16	Gen
Лише громадяне УНР користуються з усієї повноти громадянських і політичних прав , беруть участь в орудуванню державним і місцевим життям через активну і пасивну участь у виборах до законодатних установ і органів місцевого самоврядування .	УНР	2	Gen
Першою приятелькою Марії стала Ганна .	Ганна	4	Nom
Найкраще природне лісовідновлення було у Берегометі .	Берегометі	5	Loc
У Підлютому , де учениці гімназії проводили частину літніх вакацій поруч з патроном гімназії митрополитом Шептицьким , тета Міра ніколи не брала участі у ранкових дівчачих боях за право застеляти ліжко митрополита .	Міра	18	Nom
У 1949 році , зазнавши поразки від комуністичних збройних формувань Мао Цзедуна , підтримуваних СРСР , на острів Тайвань із материка втік очільник Гоміньдану генералісимус Чан Кайші .	Гоміньдану	23	Gen
Глибина : зі сторони ХАЕС глибина досягає 20 метрів .	ХАЕС	4	Gen
Пророчиця Тірца радить не квилити , а розпалювати багаття й засівати землю : « Лежачим краю рідного немає .	Тірца	1	Nom
« Парціфаль » став джерелом для однойменної музичної драми Ріхарда Вагнера 1882 року .	Вагнера	10	Gen
Праця з неолітичним матеріялом з розкошів у Старчеві Американської Експедиції до Югославії та Білгородського музею дала мені змогу пізнати техніку виробу посудини на ніжці в цій групі .	Старчеві	7	Loc
Хочу звернутися до всіх жителів гуртожитку на Троєщині , а саме на Марини Цвєтаєвої .	Цвєтаєвої	13	Gen
Він — усе , що залишилося від тематики “ Прометея ” .	Прометея	9	Gen
7 вересня « ТЕЛЬНЮК : Сестри » виступлять на території « Софії Київської » [ Київ , вул . Володимирська , 24 ] за участю Симфонічного оркестру та хору Заслуженого академічного ансамблю пісні і танцю Збройних Сил України	Софії	11	Gen
Свого часу пів - Ірландії виїхало в штати , і чи згубило це Ірландію ?	штати	7	Acc
Курбас збирає акторів у трупу з назвою " Кийдрамте " .	Курбас	0	Nom
Черкаси поділені на квадрати й відстань від пункту А до пункту Б тут вимірюється кварталами .	Б	11	Nom
Він прив’язував її оголену до стовпа та пронизував безліччю стріл неначе Святого Себастіана .	Себастіана	12	Acc
Була якось в садибі - музеї Карла Мая в Радебойлі , нарешті дізналась про нього більше .	Мая	7	Gen
Можна герба замовляти , бо чим не Жорж Дю Руа ?	Жорж	7	Nom
На його городчику росла верба , привезена з Канева , стояв бюст Аполлона .	Аполлона	12	Gen
Одного з найвідоміших спортивних коментаторів України Валентина Щербачова відсторонено від коментування матчів « Євро - 2016 » .	Євро	13	Gen
" Все невеличке приміщення театру було густо насичене запахами аніліну й клею , – згадує початок 1918 року Леонід Болобан , учень студії Курбаса .	Курбаса	23	Gen
Він ніколи не міг дивитися на обличчя Гольдштейна без болючої емоційної суміші .	Гольдштейна	7	Gen
Про це повідомив у « Фейсбуці » друг Валентина Щербачова , журналіст Віталій Довгич .	Валентина	8	Gen
Або Гнат стриножить свою брикливу жінку , і вона сидітиме дома та працюватиме , або хай собі під ( енергійно ) три чорти вибирається з хати !	Гнат	1	Nom
Одну з найкращих світлин Чорногори — її навіть позичали в мене , щоби зробити поштівку — ми з ентомологом вкрали з вілли знаменитого львівського професора .	Чорногори	4	Gen
Десь за рік у відпустку після Угорщини приїхав один родич - офіцер .	Угорщини	6	Gen
Далай - лама , що здійснював 10-денну поїздку в Австралію і Нову Зеландію , закликав пам'ятати про проблему глобальної зміни клімату .	Австралію	9	Acc
Двох міністрів усунено , Бівербрук від'їде до Вашінгтона , здається до Воєнної Ради ; за те до кабінету уряду ввійшов відомий зі своєї большевицької агітації Кріппс як льорд печаті і міністр для Палати Громад .	Бівербрук	4	Nom
Випробування технології проводилось протягом грудня у Кембриджі ( Великобританія ) , і , як показали результати , доставка може тривати близько 30 хвилин , що значно швидше та ефективніше , ніж доставка багатьма іншими методами .	Кембриджі	6	Loc
Веземо з собою нещипаного півня ( по дорозі заїхали в село Феськівку , купили у господаря .	Феськівку	11	Acc
День народження ближчає , а книги Гаррі Поттера від ілюстратора Джима Кея все нема :((	Кея	11	Gen
Повне ім’я Мікі — Раміль .	Мікі	2	Gen
І хоча це нібито суперечить зацитованій вище поставі Потебні ( 1876 р . ) , насправді він сам учинив точнісінько так само , і , здається , нічого іншого мовознавцеві , власне , й не зостається .	Потебні	8	Gen
Від початку вісімдесятих у Франківську діяло нетипове кафе « Золотий початок » , де кукурудзу варили цілорічно .	Франківську	4	Loc
Автомобільна дорога державного значення Бердичів — Шепетівка — Острог , від якої здійснений головний в'їзд до АЕС , проходить на відстані 6 , 3 км на північ від електростанції .	Шепетівка	6	Nom
У нас , виходить , закінчилося безробіття , з кадрами напряжонка , й Ольгу Петрівну Лішик ми замінити ніким не можемо .	Ольгу	13	Acc
Рафаель брав у мене пару кубів спирту для промивання шифрувальної апаратури і вводив його собі внутрівенно .	Рафаель	0	Nom
ну якщо в тебе є покриття 3G від київстару чи лайф ....	3G	6	Nom
Пізніше почав грати свою найкращу роль – Михайла Гурмана в " Украденому щасті " .	Гурмана	8	Acc
А вже Михайла Грушевського та Володимира Винниченка очорнено найстрашнішими епітетами , і зостається тільки дивом дивуватися , як же могла Лариса Косач знатися та ще й листуватися з такими звироднілими й аморальними людьцями .	Грушевського	3	Acc
Сестра була однією з п’яти перших учнів Олекси Новаківського .	Новаківського	8	Gen
– Минулорічні змагання вкотре продемонстрували , що Сумщина має високопрофесійних фахівців , які надають якісну медичну допомогу жителям області .	Сумщина	7	Nom
Смерть Іслама Карімова ще не була публічно оголошена .	Іслама	1	Gen
Про це повідомили в Укргідрометцентрі у неділю , 26 лютого .	Укргідрометцентрі	4	Loc
Коли його й не преміювала французька академія , то знайшла щось похвалити закостеніла тепер Гонкурівська .	Гонкурівська	14	Nom
Я вже й не кажу про те , що Руссо тоді , як мандрував Сковорода , Європа ще не знала , — та чи й був Сковорода у Женеві ?	Руссо	9	Acc
Головні ролі у стрічці виконують Руні Мара ( продавчиня ) і Кейт Бланшет ( Керол ) .	Бланшет	12	Nom
У 1949 році , зазнавши поразки від комуністичних збройних формувань Мао Цзедуна , підтримуваних СРСР , на острів Тайвань із материка втік очільник Гоміньдану генералісимус Чан Кайші .	Цзедуна	11	Gen
У нашому класі ніхто , крім Пуні , не вмів порядно грати в шахи , тому його відправили на міський шаховий турнір .	Пуні	6	Gen
Донька Манафорта Джесіка подала на розлучення з Йохаєм у березні .	Манафорта	1	Gen
Побачивши щось таке , наша мила учителька змінилася на лиці і запровадила Анжелу саме до тієї завучки , про яку ми думали .	Анжелу	12	Acc
Я мав гребти одним веслом , а Фацик мав — закидати і тримати вудку , витягувати щук .	Фацик	7	Nom
Однак , в одному з підрозділів на Луганщині хлопці виховують собі у поміч диких вепрів .	Луганщині	7	Loc
У свою чергу речник Манафорта Джейсон Малоні відмовився коментувати дані повідомлення .	Джейсон	5	Nom
Алгоритм Д . Хаффмана та алгоритм Шеннона — Фано передбачають перекодування даних .	Хаффмана	3	Gen
Покійний акад . Ф . І . Успенський в свій час вповні виявив значіння татар в балканських подіях XIII — XIV ст .	Успенський	7	Nom
Станом на 2016 рік ВПС Республіки Бангладеш володіє 3 Ан - 32 .	Бангладеш	6	Gen
І ось серед величної тиші , що залягала світлу мистецьку святиню метрополії світу , загомоніли великою тугою , затремтіли лункими радощами й ударили глибоким болем серця всього народу колядки Леонтовича .	Леонтовича	29	Gen
( Пасковою керамікою О . Кандиба називав неолітичну « Вапсікегатік » ) .	Вапсікегатік	9	Acc
Він же Петю і життя позбавив ) .	Петю	2	Acc
