Крім українських медиків , на Сумщину завітають команди із країн Прибалтики , Польщі , Молдови , Білорусі , Казахстану » .	завітають	6	3
Звичайно це реклама , але , оскільки автор наполягає шо він хоче поради я , як щирий фанат і ентузіаст ОС Windows , і лояльний користувач корпорації майкрософт , кажу - правильно , ти правильно вибираєш .	кажу	29	1
Основне надходження води відбувається за рахунок стоку річки Гнилий Ріг .	відбувається	3	3
Миритися з таким станом справ нізащо не згоджується : « [ … ] я ніколи не згоджуся вступитися з дороги перед усякими перевертнями і покутними борзописцями з чужої літератури , – dafűr ich bin mir doch zu gut !	згоджуся	16	1
Влаштуй всесвітній комунізм .	Влаштуй	0	2
— Поневолі збожеволієш , коли таке ...	збожеволієш	2	2
Щохвилини перериваючись , поплескуємо ділянки лобкового горбка та пахв .	поплескуємо	3	1
Будь-яке пошкодження плеври супроводжується втратою герметичності плевральної порожнини .	супроводжується	3	3
Увіходить чоловік у хату , а вони йому кажуть :	кажуть	8	3
Або ти їй віддаєшся повністю , пірнаєш у неї з головою , або бавишся в цюцю - бабки , і тоді вона до тебе повертається задницею , а ти так і зостанешся вічним невдахою .	повертається	24	3
З’ясовуючи значення любовної мови , доходимо , нарешті , до ліжка і тут нова́ проблема : про що говорити і про що не говорити ?	доходимо	5	1
Переконайтеся , що у вашому інтернет - браузері дозволено використання Cookies і JavaScript .	Переконайтеся	0	2
АПП , зауваживши , що Пуня кусає під партою канапку , дозволила йому їсти відкрито на її уроках .	кусає	6	3
☀ Під гаслом неформальної освіти ми впроваджуємо зміни в українському суспільстві та культивуємо активний відпочинок для молоді .	культивуємо	12	1
Усі знають , що більшість тих підручників - відверта халтура .	знають	1	3
Виконання Мінських угод було заблоковано Росією та ватажками бойовиків самоназваних « народних республік » , оскільки Кремль очікує отримати у цьому році більш лояльні угоди з боку нової адміністрації США та низки європейських країн .	очікує	17	3
— Злодію , вбивце ! — вигукує чорт .	вигукує	6	3
П’ять років над ними сидітиму , а таки зроблю .	сидітиму	4	1
Office Професійний 2016 допоможе створювати , презентувати та публікувати професійні документи , а також обмінюватися ними завдяки функціям , що заощаджують час , оновленому сучасному зовнішньому вигляду та вбудованим засобам співпраці .	допоможе	3	3
Ви ж можете з ними балакати з англійським презирством , крізь зуби — і дивитися на них , як Монблан дивиться на Шамуні .	можете	2	2
Такі моделі зберігають систему виборної влади , політичний та економічний плюралізм , але нехтують етичними імперативами .	зберігають	2	3
І навіть як йду з гостей від батьків , кажу , що йду додому ..	кажу	9	1
Як думаєте , мене виженуть після першої сесії чи після другої ?	виженуть	4	3
Питаю у продавця , чим відрізняються кримські від молдовських .	Питаю	0	1
— Піду я , жінко , да хоч подивлюся на хрестини .	подивлюся	8	1
Фантастично красиво стає після зими — у квітні - травні , коли на кожній вуличці розцвітають вишні , яблуні , абрикоси , бузок .	розцвітають	15	3
Відтоді націоналісти матимуть доступ до японських дипломатів , а за кілька років спробують налагодити ближчий контакт .	матимуть	2	3
Легесенько надушуємо волосся на потилиці та за вухами , щоб , коли притуляємося та зближуємо голови , випромінювався запах .	притуляємося	12	1
Але написи на суперобкладинках не збігаються .	збігаються	5	3
Вартість перевезення перелічених типів відправлень визначається за тарифами на доставку документів , посилок , вантажів , шин - дисків і палет , які розміщені на Сайті .	визначається	5	3
Перегодом постає знеохота і до похмурої подружньої любові ( на жаль , утішати випадає здебільшого дружині ) .	постає	1	3
Подейкують , що за цю роль пані Бланшет може бути номінована на " Оскар " .	Подейкують	0	3
Звичайно , жодна поодинока зміна не створює окремої мови .	створює	6	3
Вона набрякає , виділяється багато слизу .	набрякає	1	3
Коли закінчу з " Людиною у високому замку " .	закінчу	1	1
ні ти , ні синок , мій колосок , чогось давно не снитесь , тільки привиджуєтесь .	снитесь	12	2
При цьому стискаються губи та щелепи , піднімається м’яке піднебіння , і завдяки скороченням м’язів язика харчова грудка проштовхується у глотку .	проштовхується	18	3
— Ой хто в лісі , хто за лісом , ідіть до мене вечеряти !	ідіть	10	2
Сорочкою прикриє гранату — тамті не побачать , поки не оточать його впритул .	прикриє	1	3
І що всі вони повернуться у Карпати .	повернуться	4	3
Тобто , був там один нормальний ДХ велосипед , але що робити йому на лівому березі , уявлення немаю .	немаю	18	1
У Стокгольмі дійшли висновку , що достатньо одного тільки виду шведських військ , щоб влада Анни Леопольдівни і німців зруйнувалася , а нова імператриця в подяку за допомогу щедро наділить шведського короля російськими землями .	наділить	29	3
Ти мав жити і ти жив , за звичкою що перетворилась на інстинкт — що кожен звук який ти видаси буде записано та , за виключенням коли ти у пітьмі , кожен твій рух буде ретельно розглянуто .	видаси	19	2
Озброюємо броварських тітушок і направляємо їх захищати інтереси Сапожко та всієї броварської мафії , бо вони - патріоти , а хто проти них - агенти кремля і злочинці	направляємо	4	1
Пиши мені про все , може , на Різдво приїду .	приїду	9	1
У його створенні нас традиційно надихнула Італія , де особливо цінують домашній затишок і не задовольняються звичайними вузькими та більш жорсткими диванами .	задовольняються	15	3
— Визволь нас , чоловіче , визволь нас , голубчику , випусти нас , соколику .	визволь	6	2
Чи маю я активувати свій продукт Office ?	маю	1	1
Те саме розуміється про цілу Раду Народніх Міністрів , коли їй буде висловлено недовірря в цілости .	розуміється	2	3
Старі вивіски , відкриті для публіки синагоги , ресторан " Шалом " і кав’ярні , де пропонують скуштувати чай по-Ізраєльськи .	пропонують	16	3
Пришлю на днях .	Пришлю	0	1
Видно , думаю собі , волосся умирає раніше , ніж людина …	умирає	6	3
Хай живе співпраця і братерство наших народів !	живе	1	3
А довкола розпускаються каштани .	розпускаються	2	3
Наведені вище пестощі мають подвійне значення , бо справляють приємність та збуджують також і жінку , що відчуває , як унаслідок її пестощів підводиться , надимається і готується до акту чоловічий прутень .	справляють	8	3
В « Синах » Стефаника бачимо матір , що з німим докором дивиться на синів , які тікають з-під рідної стріхи боронити рідну землю .	тікають	17	3
Обіцяйте мені , що будете його відмовляти від театру .	Обіцяйте	0	2
Клапан — боягуз , хапа дрібничками .	хапа	4	3
Потираючи у цьому місці усією долонею , даємо волю піднесенню та приємності .	даємо	7	1
Тоді ми кажемо : хіба тобі невідомо , що Вапліте завжди чесно і акуратно виплачувало свої векселі ?	кажемо	2	1
Про коломийську гімназію я знав від п . Мелетія Кічури , з яким часто і приязно зустрічаюся тут , у Києві .	зустрічаюся	16	1
Годі й казати про те , що міські бюджети традиційно мають дуже багато нагальних статей витрат , через що грошей на аеропорти , які є не надто прибутковими , не вистачає .	вистачає	30	3
Через вас на Сибір ще підеш ...	підеш	5	2
За якісь секунди виймає .	виймає	3	3
ФОП - єдинники , що не застосовують РРО , під час розрахунків із покупцем у місці проведення розрахунків за технічно складні побутові товари , що підлягають гарантійному ремонту , повинні застосовувати РРО .	підлягають	25	3
Дзядзьо і близько не міг знати про щось таке , але і не міг хоча би вдавати , що п’є за перемогу червоної армії в Угорщині .	п’є	19	3
Як сказав він « не хочу » , так усі злидні і кинулись йому на шию .	хочу	5	1
Кількість логічних дисків задає користувач залежно від ємності диска і його призначення .	задає	3	3
Мама сміється , брат і сестри обурюються і опираються : з якої радості вони будуть жертвами нашого з мамою флешмобу ?	обурюються	6	3
Тільки нікому не кажи , що давав , бо за це … виженуть мене .	кажи	3	2
Не бий мене та візьми до себе — я тобі у великій пригоді стану !	стану	13	1
Ви можете здійснювати платежі через Інтернет - банк Приват24 , додатки Privat24 , SMS - банкінг , термінали самообслуговування , банкомати , у відділеннях , зателефонувавши на номер 3700 .	можете	1	2
Мати просто цвіте серед гостей , неприсідає , кожного припрошує , - адже така подія !	цвіте	2	3
Виконуйте роботу раціональніше	Виконуйте	0	2
“ Я не любився ні з ким ще зроду , – щиро зізнається він Мавці .	зізнається	12	3
Оскільки вони ідіоти , то Чужий не викликає аж такого жаху ; це раніше потвора хитромудро полювала за людиськами і щоразу більше лякала своєю кмітливістю , а тут Чужому вистачає просто відкрити рота і космонавти самі йому туди застрибнуть .	вистачає	29	3
Я вже й не кажу про те , що Руссо тоді , як мандрував Сковорода , Європа ще не знала , — та чи й був Сковорода у Женеві ?	кажу	4	1
Якась рижа леді сидить з трьома англійцями і блакитна сталь її очей цвіте , вбираючи цю чорну постать геніального музики джаз - банду .	сидить	3	3
Якщо хлопця беруть за кума , то бажано щоб першою похресницею була дівчинка , і навпаки в дівчини - перший похресник хлопчик .	беруть	2	3
На відміну від них я дивлюся на ті події з дистанції , не так , як безпосередні учасники , маю зовсім інший досвід їх переживання .	маю	19	1
Особисто я вибираю і п'ю пиво в залежності від настрою , а на певній одній торгівельній марці не зупиняюсь - в кожній є своє улюблене : Львівське світле , Чернігівське біле , Славутич Ice , Оболонь біле ...	зупиняюсь	18	1
Щиро радію новому перекладу і з нетерпінням чекаю !!!	чекаю	7	1
Цілком може бути , що вуличні протести проти Марін виявляться ще масовішими , ніж марш американських жінок , обурених Трампом .	виявляться	9	3
Хай живе новий вільний світ на руїнах гітлерівської і большевицької тиранії !	живе	1	3
Процес згортання проходить через серію послідовних кроків , протягом яких змінюються оптичні властивості білка , весь процес у випадку GFP дикого типу займає біля 30 - 40 хвилин і називається « дозріванням » білка .	займає	22	3
Гнат наскоро робить з комори ( що через сіни ) хату , ставить стола , лави , стільці , чіпляє в куті кілька образів і перебирається з Марією на самостійне господарювання .	перебирається	25	3
Найменше , один раз , зустрічаються символи « щ » , « б » , « з » , « - » , « . » .	зустрічаються	5	3
Не здурите його своєю виставою , і він урятується , навіть якби ви мали зараз не гранату , а бомбу , й положили півгарнізона ?	урятується	8	3
Про настрої тодішньої « молодої України » свідчить хоча б щиросердно - радісний пасаж з листа до матері : « Вчора ми з кнакною були на концерті в пользу чорногорців , дуже гарний концерт був .	свідчить	7	3
Як часто мити волосся , залежить від природних властивостей ( сухе , жирне ) , пори року — взимку дужче просалюється , влітку — більше запилюється .	запилюється	25	3
Ми віримо , що це є священним обов'язком наших урядів перед своїми народами , а також перед народами світу " , – йшлося у підсумковому звіті Ялтинської конференції .	віримо	1	1
Він усміхається їй , щось тюрлюрлюкає голосом у такт фокстротові і , підкинувши догори палиці , обриває все .	обриває	16	3
Мама довго мовчить , потім зітхає і каже :	мовчить	2	3
Не бий мене та візьми до себе — я тобі у великій пригоді стану !	бий	1	2
Почнімо з того , що Київ не обмежується туристичними затертостями типу того - таки Хрещатикомайдану і Маріїнського парку .	обмежується	7	3
Такі аварії згубно діють на ґрунти , рослинність і тваринний світ .	діють	3	3
Левко озирається довкола , зітхає немічно худими грудьми і манить Марфу пальцем за пошту .	манить	9	3
Дуже вимовною видається її реакція на польську рецепцію « Кассандри » : « З польської статті мені найбільше сподобалось те , що « Кассандра » страшна для поляків .	видається	2	3
Кліп Бадоєв зняв гарно , він майстер своєї справи , справжній художник , але пісня не дотягує до кліпу , хочеться лишити відео і увімкнути на його фоні якусь якісну композицію .	хочеться	20	3
Вперше за останні півроку працюю з 11-ї і встаю , коли на вулиці вже є сонце .	встаю	8	1
– Ти зовнішніми засобами передаєш скульптуру католицького святого .	передаєш	4	2
Буде у вас трошки сміливості , беріться за 8 книжок .	беріться	6	2
Воно , мабуть , волітиме всі переговори вести через мене .	волітиме	4	3
Факт , що під час воєнних протистоянь усі пристрасті радикально загострюються .	загострюються	10	3
Натомість про доісторичне коріння лемківських , закарпатських і гуцульських говірок можна сперечатися ( див . 62 . 5 ) .	див	13	2
Відправлення , які за розмірами чи вагою перевищують допустимі обмеження , приймаються до перевезення лише за попередньою домовленістю Сторін .	перевищують	7	3
Як регулюється ковтання ?	регулюється	1	3
— Роздягайтесь , — закінчив дідок свою атестацію сумно .	Роздягайтесь	1	2
Ваше небажання друкувати останні розділи « Космічного оркестру » вітаю .	вітаю	9	1
Тільки тоді він вам повірить — коли я стоятиму поруч із вами !..	стоятиму	8	1
Чув він , коли вертається його дружинонька , як роздягається в темноті , розщіпає натягнену корсетку , думає про останній прощальний крадений поцілунок і всміхається до темноти ?	всміхається	24	3
Незабаром , можливо , я і декілька моїх приятелів одержимо пропозицію скласти літературний альманах .	одержимо	9	1
« Но , — говорить собі чоловік , — вже нагрівся , а тепер наїмся , бо й черево , чую , біду робить ... »	наїмся	14	1
Нас не дивує , коли таким могильним запахом з насолодою упиваються Зерови й Могилянські , але нас обурює , коли про цю насолоду шамрикають і деякі пролетарські письменники .	дивує	2	3
Не помагайте , отже , нічим ворогам людської свободи , але допомагайте її оборонцям !	помагайте	1	2
Розділи поділено на параграфи , що починаються з коротких рубрик « Ви дізнаєтесь » і « Пригадайте » .	починаються	6	3
Катай , серденько , катай , принесеш діткам гостинчика .	принесеш	6	2
Отець Головацький не знав , що через кілька років вони стануть родичами , що у Читі дзядзьо одружиться із сестрою жінки його брата .	стануть	10	3
А товщина ліній штрих - коду та відстань між ними кодують ті самі відомості .	кодують	10	3
Знаємо вже , про що не треба розмовляти у ліжку .	Знаємо	0	1
Інструмент негра підтримує мотивні заклики рояля своїм шумом і бубонінням .	підтримує	2	3
— Коли ж ти , — каже , — не хочеш мене слухати , так я тебе з'їм .	з'їм	17	1
Мода на татуювання створює можливості для низки стартапів , таких як курси таксидермістів , лимарські та палітурні майстерні .	створює	3	3
Постійно щось бухтить противним скрипучим голосом , матюкається сам до себе .	бухтить	2	3
Пошкоджує спочатку ранні сорти суниць , потім перелітає на пізніші , а потім перелітає на малину .	Пошкоджує	0	3
— Чорнила слізьми не розмаж , — каже Левко і одвертається : жде .	розмаж	4	2
Не знаю , чи цільно стріляв той прилад , але признаюся , що тоді вперше доводилось бачити таке дивовижжа та подивляти стрілецьку вигадливість .	признаюся	10	1
Нагуляла то виховуй сама одна з другою !	виховуй	2	2
Команди змагатимуться на території дитячого табору відпочинку « Зоряний » ПАТ « Сумихімпром » ( с . Вільшанка Сумського району ) .	змагатимуться	1	3
Або ти їй віддаєшся повністю , пірнаєш у неї з головою , або бавишся в цюцю - бабки , і тоді вона до тебе повертається задницею , а ти так і зостанешся вічним невдахою .	зостанешся	31	2
— Тільки Ви тихенько , — поінформував хтось пошепки , — ми сидимо от , як турки , бо не маємо права ані ходити , ані стояти , ані лежати …	маємо	20	1
В Лісабоні перейшовся туди - сюди - маєш квадріцепс мрії , невтамовний апетит і двадцять компліментів .	маєш	7	2
Наведені вище пестощі мають подвійне значення , бо справляють приємність та збуджують також і жінку , що відчуває , як унаслідок її пестощів підводиться , надимається і готується до акту чоловічий прутень .	надимається	25	3
Такий конфлікт часто призводить до того , що в момент ковтання надгортанник не закриває вхід до гортані й частинки їжі можуть потрапляти в дихальні шляхи .	закриває	13	3
Щиро дякуємо пані К . Лазор ( колишній дружині О . Кандиби ) за дозвіл надрукувати цей рукопис у нашому журналі .	дякуємо	1	1
Однак найчастіше запалення слизових оболонок різних частин повітроносних шляхів і легень спричиняють інфекційні захворювання .	спричиняють	11	3
Займаються в будинку № 17 на вул . Прорізній .	Займаються	0	3
Точніше , він сприймає правду як підступну провокацію , спрямовану на те , щоб затуманити його .	сприймає	3	3
— Зроби мені троє діл та й підеш собі додому , а як не зробиш , то я тебе з'їм !	з'їм	19	1
Після цього зануримо обидві руки в посудину з водою кімнатної температури і спробуємо за своїм відчуттям встановити , яка в ній вода — холодна чи гаряча .	зануримо	2	1
Знов пишемо , дитинка вискакує - і знов артистка запинається .	пишемо	1	1
Наведені вище пестощі мають подвійне значення , бо справляють приємність та збуджують також і жінку , що відчуває , як унаслідок її пестощів підводиться , надимається і готується до акту чоловічий прутень .	готується	27	3
— Одведи - таки та й одведи свою дочку в ліс : нехай її там звіряки з'їдять .	з'їдять	16	3
Крейдяна сосна , що росте на виходах крейди довкола Слов’янська , не трапляється більше ніде у світі .	трапляється	12	3
Грип — гостре інфекційне захворювання , яке спричиняють віруси кількох різновидів .	спричиняють	7	3
Благородна і в стрімкому вихорі - льоті , коли , налякана , не біжить , а стелеться над чагарником , над кущами , чи поміж дубо - клено - ясенових стовбурів ...	біжить	13	3
їсть то одне , то друге й попиває .	попиває	7	3
— То мій батечко дровця рубає .	рубає	5	3
Мимоволі він стає жертвою перестрілки і отримавши вогнепальне поранення , використовує винахід на собі .	використовує	10	3
Нічого , нарубаю дров , зваримо щось їсти , а далі воно покаже .	нарубаю	2	1
Членам Секції , що робили свої уваги до цієї праці , складаю свою щиру подяку .	складаю	11	1
Більше не дивитимусь .	дивитимусь	2	1
Гнатіву поталанить : під час нелегального переходу кордону його заарештують японці .	поталанить	1	3
І хоча це нібито суперечить зацитованій вище поставі Потебні ( 1876 р . ) , насправді він сам учинив точнісінько так само , і , здається , нічого іншого мовознавцеві , власне , й не зостається .	зостається	35	3
Ідея полягала не так у тому , щоб поповнити бюджет із кишень « дармоїдів » , як у стимулюванні роботодавців і працівників , які виплачують та отримують зарплати в конвертах , вийти з тіні .	виплачують	24	3
Легесенько надушуємо волосся на потилиці та за вухами , щоб , коли притуляємося та зближуємо голови , випромінювався запах .	надушуємо	1	1
2 травня з 07 : 00 до 22 : 00 вводиться тимчасове обмеження руху в районах Соборної площі та Куликового поля	вводиться	10	3
Припускаю , в наступному сезоні багато хто мимоволі перейде на бік зла , обернувшись на білих блукачів .	перейде	8	3
Коли я їхав до Делятина сам з двома малесенькими дітьми , кондуктори навіть не питалися , чи я маю білет .	маю	18	1
( Лише з 24-мільйонної Австралії і тільки в найурожайніші роки вивозять стільки само . )	вивозять	10	3
Ячмінні зерна обжарюють – виходить солод карамельного кольору .	виходить	4	3
Та візьме та й оддасть їй починки , а вона мерщій вскочить у хату до матері :	вскочить	11	3
Пророчиця Тірца радить не квилити , а розпалювати багаття й засівати землю : « Лежачим краю рідного немає .	радить	2	3
Я сиджу на кухні , їм сирну запіканку і запиваю колою .	запиваю	9	1
Вивчення фізики розширює коло ваших знань , відкриваючи нові горизонти пізнання .	розширює	2	3
Велику статеву чутливість знаходимо і вздовж промежинного шву , який сполучає задній прохід з мошонкою .	знаходимо	3	1
— Ховайтесь , казала лисичка , бо він як прийде , то розірве нас .	прийде	9	3
Ідея полягала не так у тому , щоб поповнити бюджет із кишень « дармоїдів » , як у стимулюванні роботодавців і працівників , які виплачують та отримують зарплати в конвертах , вийти з тіні .	отримують	26	3
Тепер несіть Софії .	несіть	1	2
У п'єсі Франка ніби для нього написані такі слова Анни : " І боюсь його , і жити без нього не можу .	можу	21	1
Але вона зрідка бере , хоч і часто сидить на сухому хлібові .	сидить	8	3
Плануйте своє життя гарно !	Плануйте	0	2
На дорогах вночі і вранці місцями існуватиме ожеледиця .	існуватиме	6	3
Ефективність антидоту різко знижується після цього часу .	знижується	3	3
Виявилося , що кава там коштує один долар .	коштує	5	3
Цей Порядок визначає механізм використання коштів , передбачених у державному бюджеті Господарсько - фінансовому департаменту Секретаріату Кабінету Міністрів України за програмою “ Розвиток електронного урядування ” ( далі - бюджетні кошти ) .	визначає	2	3
— Не брешіть , дядечку .	брешіть	2	2
Бо самі були такими ще не так давно і насправді впізнають у вас себе самих .	впізнають	10	3
Буває , що наглий обрив того напівмлосного трансу доводить до думки покінчити з собою і відчувається , як “ ломка ” у наркомана .	доводить	8	3
Гриць Купецький ( Борис Марков ) очолить « Українську Далекосхідну Січ » — перейменований СУМ , а Михайло Гнатів вирішить нелегально перейти радянський кордон .	вирішить	19	3
Пошкоджує спочатку ранні сорти суниць , потім перелітає на пізніші , а потім перелітає на малину .	перелітає	7	3
Свої рішення в цих справах він передає Всенароднім Зборам .	передає	6	3
Або Гнат стриножить свою брикливу жінку , і вона сидітиме дома та працюватиме , або хай собі під ( енергійно ) три чорти вибирається з хати !	сидітиме	9	3
Там же , в бутонах , личинка заляльковується , а через 7 - 11 днів лялечки перетворюються на жуків .	перетворюються	16	3
Звичайно , у піднесенні статевих чарів багато значать штучні , ро́блені запахи , але не забуваймо , що вони не повинні “ забивати ” власних , природних запахів .	забуваймо	15	1
До моменту потрапляння їжі на корінь язика цей процес є довільним ( хочу — ковтну , а не хочу — ще пожую ) .	хочу	18	1
Хай живуть вільні , самостійні держави усіх народів у братерській дружбі і співпраці !	живуть	1	3
— Та це я , — каже , — прийшов до тебе просить конячки , нема чим і протопить , поїду в ліс та назбираю хмизу .	назбираю	24	1
Вона набрякає , виділяється багато слизу .	виділяється	3	3
Образи його знаходяться у Празі в костелах Францішканів і Капуцинів та у Мельнику .	знаходяться	2	3
На ґанку Карпової хати стоїть Марфа Яркова і веде мене очима .	веде	8	3
Курбас збирає акторів у трупу з назвою " Кийдрамте " .	збирає	1	3
Посилання , яке не модифікується під час копіювання формули , називають абсолютним .	називають	10	3
З неперетравлених решток їжі формуються калові маси , які містять шкідливі для організму речовини .	формуються	4	3
Тут дехто бідкається що немає # зради на повернені Овочеві мільярди .	бідкається	2	3
Мене ж тягне вивести його на неї .	тягне	2	3
1 / 3 периметру водосховища займає бетонна дамба , відповідно рослинності там немає .	займає	5	3
Він приходить сюди та й плаче .	приходить	1	3
Парціфаль проходить шлях покаяння та внутрішнього переродження наївної душі та досягає досконалості .	досягає	10	3
ми всеньким студентським театром завітати плануємо .	плануємо	5	1
— Вислухайте мене !	Вислухайте	1	2
Відгадайте - но загадку : не тепер і не в четвер , а на день раніше , хоч тижнем пізніше .	Відгадайте	0	2
Люди скачуть , як кози !	скачуть	1	3
Будь ласка , заповніть анкету або завантажте своє резюме .	Будь	0	2
Сорочкою прикриє гранату — тамті не побачать , поки не оточать його впритул .	побачать	6	3
Однак лоукости зазвичай , перш ніж заходити на ринок , дуже довго вивчають його , йдуть лише туди , де робота гарантовано буде рентабельною .	вивчають	12	3
Ці викиди завдають великої шкоди екосистемам водойм , виводять з ладу водопроводи , розносять мікроби , завдають значних матеріальних збитків .	завдають	2	3
Замовлення тепер доставлятимуть просто на поріг покупця за допомогою безпілотних літальних апаратів та парашутів .	доставлятимуть	2	3
Та дівка питається його :	питається	2	3
Всі співають пишаються своїм званням студента найкращого ВНЗ України , а самі не можуть донести сміття до урни …	співають	1	3
Так , але , скажу вам , курка на 21 день сидіння має такий настрій , що прийняла б під свої крила цілий всесвіт .	скажу	4	1
Віднімаємо 150 тис . грн збору за паркування і отримуємо майже 830 тис . грн доходу на рік .	Віднімаємо	0	1
— Одведи - таки та й одведи свою дочку в ліс : нехай її там звіряки з'їдять .	одведи	6	2
Не плакатиме ж вона з ложкою в руках !	плакатиме	1	3
Друзі , тут існує така справа — ми ще з кількома хорошими людьми , за підтримки Спудейського братства НаУКМА робимо до дня Академії колекційну карткову гру “ CampUs ” із оригінальним ігроладом та правилами .	робимо	19	1
При поводженні з тваринами під час проведення спортивних , видовищних заходів , відео - та фотозйомок не допускається заподіяння їм травмувань , болю , знівечення , їх загибель .	допускається	17	3
Воно приємне , а до хорошого звикаємо швидко .	звикаємо	6	1
і готові до питань а-ля назвіть повне ім*я Дамблдора ...	назвіть	5	2
— Одначе ходім до тієї скелі .	ходім	2	1
Тета Міра любила співати нам або сама собі таку пісеньку — я тішуся , як спати йду , і вранці я знова встаю , яка дурненька я , яка дурненька я .	встаю	22	1
Звичайно це реклама , але , оскільки автор наполягає шо він хоче поради я , як щирий фанат і ентузіаст ОС Windows , і лояльний користувач корпорації майкрософт , кажу - правильно , ти правильно вибираєш .	вибираєш	35	2
— Чого ти плачеш ?	плачеш	3	2
Будь ласка відгукніться ті , хто переходив в Могилянку з Острозької академії або хоча б підкажіть , де таких можна знайти ?	підкажіть	15	2
Саме міжмолекулярна взаємодія зумовлює виникнення сил пружності та сил тертя .	зумовлює	3	3
У твердих тілах міжмолекулярні сили проявляють себе як сили пружності при різноманітних деформаціях і зумовлюють міцність тіла .	проявляють	5	3
Через 1 - 3 тижні після появи вузлів ( горбочків ) некротизована тканина легко відділяється або , підсихаючи , відпадає сама .	відпадає	19	3
Інерція є джерелом відцентрової сили , що розтягує мотузку , пружність мотузки є джерелом доцентрової сили , ці сили врівноважені , і ніхто нікуди не прискорюється , бо відстань між каменем і центром не змінюється .	змінюється	34	3
Крайові лійковидні квітки безплідні , вони приваблюють комах , які запилюють серединні трубчасті квітки .	запилюють	10	3
« Йдім окремими шляхами , але до спільної мети .	Йдім	1	1
Не печальтеся , дитятко .	печальтеся	1	2
Будь ласка відгукніться ті , хто переходив в Могилянку з Острозької академії або хоча б підкажіть , де таких можна знайти ?	відгукніться	2	2
Приходить туди , а той і питає :	питає	6	3
Кінець цього шву бачимо у вуздечці крайньої плоті — складці слизової оболонки , яка прикріплює крайню плоть до голівки прутня .	прикріплює	14	3
Другий як стій наложив ленту — і як затріскотить першому над головою !	стій	2	2
От замовлю собі багато - багато попкорну - і вболіватиму , чесно .	вболіватиму	9	1
Зволоживши краплиною духів плечі побіля вирізу на сукні , викличемо на тоді , як тіло розігріється , виділення милого запаху з-під того вирізу .	викличемо	9	1
Я йду , щоб повернутися !	йду	1	1
Заходи розпочнуться 31 травня 2017 року о 9 . 30 у Сумах на площі Незалежності урочистим відкриттям і закінчаться 2 червня о 16 . 00 церемонією нагородження переможців змагань .	розпочнуться	1	3
Он є комора , роби з неї хату і жий там , як хоч .	роби	4	2
Душа моя рветься , нема мені спокою !	рветься	2	3
На нашу країну припадає й більш як половина поставок на світовий ринок соняшникової олії .	припадає	3	3
Питають - розпитують , пишуть - записують .	розпитують	2	3
На початку цвітіння суниць та малини самки відкладають у бутони по одному яйцю , прогризаючи збоку кожного бутона заглибину .	відкладають	7	3
Автор низки статей та книжок , працює радником кількох компаній , урядів країн , інституцій Євросоюзу .	працює	6	3
І не поскаржишся ж нікому .	поскаржишся	2	2
Епітеліальна тканина , або епітелій , складається з клітин , що щільно прилягають одна до одної .	складається	6	3
Коли голод затьмарює твій погляд , ти просто береш TUC .	затьмарює	2	3
Інерція є джерелом відцентрової сили , що розтягує мотузку , пружність мотузки є джерелом доцентрової сили , ці сили врівноважені , і ніхто нікуди не прискорюється , бо відстань між каменем і центром не змінюється .	розтягує	7	3
Точну ціну колоди опублікую через кілька днів , як тільки своє слово скаже типографія .	скаже	12	3
Постанови параграфів 14 , 16 , 17 , 18 і 19 не торкаються нормовання спеціяльними законами виїмкового стану , який можна встановляти лише кожен раз окремим законом , згідно параграфів 79 - 80 .	торкаються	12	3
Скажи їй що .	Скажи	0	2
Про себе не маю що нового писати , бо я зовсім здорова , як і всі ці остатні дні .	маю	3	1
А ще , як йому скажу , що ти його полуденок з’їв , йо - йой , неборе !..	скажу	5	1
Тоді побачите , що чоловіча природа відтоді аніскілечки не помінялась і що у давніх смішних рекомендаціях міститься чимало правди .	побачите	1	2
Чув він , коли вертається його дружинонька , як роздягається в темноті , розщіпає натягнену корсетку , думає про останній прощальний крадений поцілунок і всміхається до темноти ?	вертається	4	3
Ти людина культурна , і невже ти ніколи не чув про поета , якого , крім руської , перекладають на польську , французьку , чеську , єврейську і німецьку мови .	перекладають	18	3
В кожному разі показується , що на великому просторі дністро - дун . области панував у формі посудини на ніжці спосіб виробу перше посудин , а потім додання до них дна .	показується	3	3
Розділи поділено на параграфи , що починаються з коротких рубрик « Ви дізнаєтесь » і « Пригадайте » .	дізнаєтесь	12	2
— Тоді тебе визволю від пекла , зроблю щасливим та багатим , якщо візьмеш мене за жону .	зроблю	7	1
Натомість , у найменш розвинутих країнах , дві третини з яких зазнають серйозного негативного впливу епідемії ВІЛ / СНІДу , середній показник очікуваної тривалості життя складає лише близько 50 – 55 років .	складає	25	3
Живе багатий год , живе й другий , дожидає діток — не дає йому бог !	дожидає	8	3
Суть декрету в тому , що громадяни , які працюють у рік менш як 183 дні , мають відшкодовувати витрати на соціальні блага , якими нібито користуються : безплатна медицина , державні дитячі садки й школи тощо .	користуються	26	3
Кажуть , дороге .	Кажуть	0	3
Як Office 365 , так і Office 2016 постачаються із 25-значним алфавітно - цифровим кодом , який слід застосувати для активації вашого продукту .	постачаються	8	3
Кажучи далі про статеву чутливість шкіри , маю зазначити , що , як правило , чоловіче тіло значно бідніше на нервові волокна , аніж жіноче .	маю	7	1
Характерною особливістю епітеліальної тканини є майже повна відсутність міжклітинної речовини й те , що під клітинами епітелію розташована тоненька базальна мембрана , яка їх підтримує .	підтримує	24	3
У лісі ще траплялися поодинокі партизанські загони , бо лісоруби — тато пішов працювати до них — голосно і монотонно співали , щоб почули лісовики , — ми не хочемо , ми мусимо .	хочемо	29	1
Режисер звертає увагу на танцівницю Валентину Чистякову .	звертає	1	3
Якщо можете допоможіть і підкажіть , що я маю робити	можете	1	2
Ну , ото журяться вони з жінкою , а далі кажуть :	кажуть	10	3
Усе , було , лає її , сердешну , та знущається над нею , та ще , було , й діда підцьковує , щоб згриз голову своїй дочці .	лає	4	3
Дівчата - товаришки її люблять і часто дають їй чого їсти — такого , що з дому приносять .	люблять	4	3
Хруща ведуть !.. " — викрикують з усіх боків по селу .	ведуть	1	3
Під час Другої світової війни японці знову звернуться до націоналістів із пропозицією співпраці .	звернуться	7	3
Натомість , у найменш розвинутих країнах , дві третини з яких зазнають серйозного негативного впливу епідемії ВІЛ / СНІДу , середній показник очікуваної тривалості життя складає лише близько 50 – 55 років .	зазнають	11	3
Через подорожчання , зазначають аналітики , знизяться платежі , а кількість людей , яким нічим буде платити , зросте в рази .	зазначають	3	3
Виїмок творять признані законом за безумних або божевільних , котрі находяться під опікою .	творять	1	3
— А зготуймо обід !	зготуймо	2	1
Якщо ви не знаєте , як це перевірити , забули пароль або виникли інші питання — зверніться в нашу Службу підтримки .	зверніться	16	2
Кидайте все і ходімо в ліс .	Кидайте	0	2
Під час ковтання дихання затримується , а надгортанник закриває вхід до дихальних шляхів .	затримується	4	3
Під час проведення практичних робіт у навчальному процесі забороняється вимагати від студентів виконання процедур , що призводять до смерті або травмування тварин , якщо це суперечить їхнім моральним або релігійним принципам .	суперечить	25	3
Відповідно паркувальний майданчик площею 806 кв . м . на вул . Возз’єднання приноситиме 258 грн на день і 7740 грн на місяць .	приноситиме	13	3
Це десятки гектарів яскраво - червоної півонії тонколистої , і саме тут трапляються три види червонокнижних тюльпанів : Шренка , змієлистий та дібровний .	трапляються	12	3
Він ізнов іде до того стовпа та й плаче .	плаче	8	3
Тільки нікому не кажи , що давав , бо за це … виженуть мене .	виженуть	12	3
Але Сосницький по камінчику , як Клапан , довбає і з усіх сил тримає себе , щоб не кинутись на неї з криком " ура " !	тримає	13	3
Як устану рано , то щоб це все було готове !	устану	1	1
Розв’язуючи задачу на уроці математики , слова , що позначають числа , записують цифрами , а математичні операції записують — спеціальними знаками .	записують	12	3
Ловить свою цесарку , позбавляє її життя , ошпарює , вкидає в свою машину .	ошпарює	8	3
підкажіть , у вівторок буде семінар чи лекція , і що готувати ??	підкажіть	0	2
Кожна функція і блок визначають свою власну локальну область видимості .	визначають	4	3
Цього пізнішого нашарування , звичайно , в живій мові XI ст . ще не було , отже й у пам’ятках його не віднайдемо .	віднайдемо	22	1
Я птицю на продаж до Черкаської області вожу .	вожу	7	1
І я , звичайно ж , прошу благословення у Бога , плоттю Якого є Слово , а ще іншим іменем – Правда .	прошу	6	1
Під час проведення практичних робіт у навчальному процесі забороняється вимагати від студентів виконання процедур , що призводять до смерті або травмування тварин , якщо це суперечить їхнім моральним або релігійним принципам .	забороняється	8	3
Нате вам осьо , вип’єте за його здоров’я .	Нате	0	2
— А от коврижку ніхто вдома не їсть , — скаржиться мама на моїх братів і сестер .	їсть	7	3
Ці фрагменти — вочевидь , усе , що залишилось нам від “ Прометея 2 ” — надто вже виділяються на тлі океану кретинізму , що панує в “ Заповіті ” .	панує	25	3
До цього часу , на жаль , ще велика частина наших матерей , бодай , як твердять наші поети , постала з цілком іншого матеріялу .	твердять	16	3
Вони безповоротно руйнують почуття безпеки у любові і розривають найістотніший зв’язок , що сполучає закоханих .	розривають	8	3
Приємно , коли увага застигає , й ти обережно , м’ягко повертаєш його в той бік , який тобі потрібний .	повертаєш	11	2
Робота з експериментальними тваринами може проводитися за наявності дозволу на проведення такого виду діяльності , що видається центральним органом виконавчої влади , що реалізує державну політику у сфері наукової діяльності .	видається	16	3
Як комашва , визбируємо смутки та прикрощі з цілого дня і подаємо їх на вечірнє базікання .	визбируємо	3	1
Ця рухливість дна вказує , що воно ще доліплювалось до стін посудин додатково .	вказує	3	3
Потрібно неодмінно додати той факт , що служба Надзвичайних ситуацій Броварів не пристосована до нових завдань , пов’язаних із гасінням пожеж на висоті більшій за 9 поверхів , пожежних депо нового типу немає .	немає	32	3
Про себе написав тільки , що склав іспита , надіється на стипендію і живе тим часом у знайомих .	надіється	9	3
Єдиний адекватний член екіпажу корабля “ Заповіт ” ( якщо не брати до уваги героя Джеймса Франко ) — ШІ - автопілот , яку тупі людиська посилають під три чорти , назвавши кілька циферок .	посилають	26	3
Обличчя негра спливається з ритмом , ніздрі ходять у такт , очі примружено соловіють і розтікаються у солодкій втомі , що знаменує екстаз музичної дії .	розтікаються	15	3
А через центр пролягає головний бульвар міста — бульвар Шевченка , рясно висаджений каштанами та вкладений плиткою .	пролягає	3	3
— Коли ж ти , — каже , — не хочеш мене слухати , так я тебе з'їм .	хочеш	10	2
У межах Українського щита , а також в окремих районах складчастої системи Українських Карпат і Кримських гір , Донецької складчастої області залягають й різноманітні напівдорогоцінні камені .	залягають	21	3
Він акомпанує вечір і цілу ніч і зовсім не механічно .	акомпанує	1	3
Шевченко каже : Думав доля зустрінеться , спіткалося горе .	зустрінеться	5	3
Не переймайтеся , сценаристів це не цікавило .	переймайтеся	1	2
Приношу вибачення видавництву що так часто вклинююсь в коментарі .	вклинююсь	6	1
Мою думку про нього Ви знаєте .	знаєте	5	2
Наприкінці кожного параграфа є рубрика « Підбиваємо підсумки » , яка допоможе вам краще запам’ятати головне .	допоможе	11	3
Стандартною вважається палета з площею піддона ( основи / крайніх точок габариту ) менше ніж 2 м2 .	вважається	1	3
Французька неокласика , — де зануджений сонетист Мішель Вассон виписує сонетики , де бог , серце , сфінкс і Христос в оточенні інших щироміщанських і католицьких атрибутів танцюють поважний сонетовий кадриль .	танцюють	27	3
Забороняється використання у видовищних заходах , у спорті , при організації дозвілля тварин , які важко переносять неволю , закритий простір , дресирування .	Забороняється	0	3
Тристоронній договір між ДП « Київський лісгосп » , міськрадою та забудовником передбачав , що лісгосп передає ці землі міськвладі , а та в свою чергу передає – у користування забудовником .	передає	26	3
Поздовжні рухи пальця тоді , як відчується , що твердне клітор , треба змінити на поперечні , під час яких палець перестрибує через його верх або легесенько шарудить уздовж бічних канавок .	відчується	6	3
Поганий буде вкраїнський Фейсбук , якщо ніхто цього не заперечить і не запропонує свій варіант .	запропонує	12	3
— Відпихайте !	Відпихайте	1	2
а вам що уявляється ?	уявляється	3	3
Я пишу куди тільки можу , бо не знаю що робити .	знаю	8	1
— Я не підбіжу , як доведеться тікати .	підбіжу	3	1
Не скажи ..	скажи	1	2
Гнат мнеться .	мнеться	1	3
Ясно , що тут ще інші фактори враховуються , але все ж таки ?	враховуються	7	3
Жде - жде — батька нема .	Жде	0	3
Гуртові яви живі , мальовничі , ефекти акустичні давали досконалу оману " , – відгукується на виступ у Львові критик Степан Чарнецький у часописі " Неділя " .	відгукується	14	3
Давай в Інтернеті дивитися .	Давай	0	2
Не помагайте , отже , нічим ворогам людської свободи , але допомагайте її оборонцям !	допомагайте	11	2
Сили беруться наче нізвідки .	беруться	1	3
А тут міститься скільки життя !	міститься	2	3
Спочатку я наївно думала , що , якщо побачила назву вулиці , яку знаю , то точно її знайду .	знайду	18	1
Тристоронній договір між ДП « Київський лісгосп » , міськрадою та забудовником передбачав , що лісгосп передає ці землі міськвладі , а та в свою чергу передає – у користування забудовником .	передає	16	3
— На середину , на середину сідайте , товаришу !.. — зашепотіли всі .	сідайте	6	2
Цілую міцно твою білу голову , а ти всіх поцілуй .	Цілую	0	1
Приміщення театру потребує ремонту .	потребує	2	3
Сонячної пори дивуймося , хвалімо , високо цінімо його чесноти , у хмарний час байдужіймо до принадливостей і витягаймо на денне світло негативні риси .	дивуймося	2	1
Розвиваючись і вивчаючи навколишній світ , ви пізнаєте й самих себе , а пізнаючи себе — пізнаєте світ .	пізнаєте	7	2
— Лягай спати , я це все пороблю .	пороблю	7	1
Потім в " керуванні дисками " стало ясно шо вона баче захисну MBR .	баче	10	3
Передбачається , що водоканал має сплачувати 95 % за спожиту електроенергію до моменту підписання договору , виконувати умови договору та забезпечувати 100-відсоткову оплату за спожиту електроенергію .	Передбачається	0	3
По дорозі зустрів поштаря — і от маю писати листа наново .	маю	7	1
Ця заввага літературознавця погано корелює зі свідченням самої поетеси у листі до Ольги Кобилянської : « … вчилась тільки того , що мені подобалось , а читала все , що запорву , без жадної заборони .	запорву	30	1
Замість серця в нього міститься торбочка з м'язів .	міститься	4	3
— Навіщо ж людину мучити , як вона й так мучиться ?	мучиться	10	3
Як ви вирішуєте проблему тонких перегородок в хаті , коли чути як скрипить ліжко і всякі інші звуки ...	скрипить	12	3
Нові Всенародні Збори скликає і відкриває Голова , вибраний попередніми Всенародніми Зборами , Уряд Голови триває весь час , поки не будуть скликані нові Збори і буде вибраний ними Голова .	скликає	3	3
Рана затягується , але разом з цим доктор виявляє , що він потрапив у дивний світ , який є дзеркальним відображенням .	виявляє	8	3
— Летімо далі !	Летімо	1	1
Під час форматування також створюється структура таблиці розміщення файлів на носії .	створюється	4	3
Ми завжди приблизно знали , хто з наших учителів безпосередньо співпрацює з КҐБ .	співпрацює	10	3
Вулиці Відня та тепла погода надихають на гарні думки , прогуляйтесь зі мною ;)	прогуляйтесь	10	2
Одначе розгляд фрагментів цього посуду дозволяє думати , що тут маємо аналогічну техніку , бо не трапляється , щоб ніжка відбивалась від дна посудини в площі здогадного перетину , натомість посудина розбивається все спільно з ніжкою .	маємо	10	1
Тож деякі сучасні систематики вказують прийнятою назвою цього виду Cyanus segetum Hill , а Centaurea cyanus вказують як синонім , водночас , інші вказують прийнятою назвою Centaurea cyanus , а Cyanus segetum вказують — синонімом .	вказують	4	3
Докази їх наявності мусять видобуватися шляхом копіткого аналізу , що його методи мають варіюватися залежно від жанру пам’ятки та її стосунку до мови щоденного вжитку .	мають	12	3
— Далі не жиєш !	жиєш	3	2
Кожний бо суб’єкт не тільки пасивно сприймає , а і творить мову .	сприймає	6	3
– Уважайте на нього , щоб не покинув університету і не вступив до театру , – звертається колишня актриса театру " Руська бесіда " у Львові Ванда Янович до Хоми Водяного .	Уважайте	1	2
Він не знав як її звуть , але він знав що вона працює у Відділі Фікцій .	звуть	5	3
Ерекція , тобто вставання , чоловічого прутня — то речовий доказ статевого впливу на чоловіка , й нема у почуттєво - еротичному житті жінки більшого нещастя , ніж те , що чоловік перестане відгукуватися готовністю на її пестощі .	перестане	32	3
А інформація подається через численні політичні фільтри - політкоректність , недискримінація , боротьба з гомофобією , сексизмами , екстремізмом , націоналізмом і тому подібне .	подається	2	3
Пам’ятаєте , як Вам безбожно заздрили і тайкома ненавиділи в « Музагеті » … за хист , якого самі не мали .	Пам’ятаєте	0	2
Таким чином не треба було виходити з палацика у ті святочні дні , коли муситься трапезувати під відкритим небом .	муситься	14	3
Лише геть наприкінці XVIII ст . з’являються перші тексти , свідомо скомпоновані українською мовою .	з’являються	6	3
Повели Хруща у Гетьманське ; засадили в тюрму за залізні штиби ; давай випитувати та розпитувати .	давай	12	2
Відправлення в гофрокартонних коробках , поєднані між собою стрейч - плівкою та скотчем , до перевезення не приймаються .	приймаються	17	3
Ооо , а я читаю це якраз в дорозі назад в київ ( сережка постійно в гаманці з собою )	читаю	4	1
Цю речовину містять також окремі вугільні пласти Львівсько Волинського басейну .	містять	2	3
І , зверніть увагу , жодної « західної » демократії !	зверніть	2	2
Ми його по-добросусідськи називаємо Ґоблін .	називаємо	3	1
Половина вас нехай тягне в одну сторону , а половина тягне в другу , то воно й розколеться .	розколеться	17	3
Для забезпечення можливості ремонту розподільних пристроїв або ділянок електромережі , не припиняючи енергопостачання споживачів , систему збірних шин розподільчих пристроїв секціонують .	секціонують	20	3
Проте дещо дається зробити .	дається	2	3
Питають - розпитують , пишуть - записують .	Питають	0	3
Як регулюється виділення шлункового соку ?	регулюється	1	3
У цій сфері нічо́го не зміниться , хіба що людей вирощуватимуть у пробірках і родина перестане існувати .	вирощуватимуть	10	3
Саме цей феномен спостерігався в розділених родинах , частина яких живе в Україні , а частина живе – в Росії .	живе	16	3
Той підхід — статичний , або систематичний , — контрастує з динамічним , що застосовуватиметься в дальшому викладі .	контрастує	9	3
Ранні прояви параної : коли я говорю чеською , мені здається , що це вигадана мова і люди навколо мені підігрують .	говорю	6	1
Я перекинусь пшеницею , а ти перекинешся дідом , та будеш стерегти мене .	перекинусь	1	1
Пригадайте : надходження їжі в шлунок стимулює секрецію залозами слизової оболонки гормону гастрину .	Пригадайте	0	2
Дякую всім , хто підтримував уряд і мене у ці півтора року .	Дякую	0	1
Навіть у Північній Ірляндії , де ірляндці не мають свого уряду , відносяться вони до англійців з неохотою .	відносяться	12	3
Ще раз дякую Вам за Вашу велику працю , за магію і чари !	дякую	2	1
Наприклад , у США йдеться про домогосподарства , які мають від 2 до 7 , 5 прожиткового мінімуму на члена сім’ї .	мають	9	3
Вони й почали ховатися : ведмідь лізе на дерево , вовк сідає за кущем , кабан заривається у хмиз , а зайчик лізе в кущ .	сідає	11	3
Почитавши ці рядки , ти , звичайно , не повіриш нам і скажеш : ви видаєте векселі , а де ваша ґарантія ?	видаєте	15	2
Коли ті чують , що летить ізнов , аж земля реве , так дівка каже :	реве	10	3
Замовила нову книжку Роальда Дала - сподіваюсь , вона сподобається моїм малим не менше за " Чарлі та шоколадну фабрику " .	сподобається	9	3
Він , за рекомендацією авторитетної особи , домовився з ними , що заплатить великі гроші за свою візу .	заплатить	12	3
Натомість сьогодні брехню породжують і обслуговують потужні індустрії , а відтак брехня чи напівправда стають радше правилом , ніж винятком .	обслуговують	5	3
Забороняється використання у видовищних заходах , у спорті , при організації дозвілля тварин , які важко переносять неволю , закритий простір , дресирування .	переносять	16	3
У цій сфері нічо́го не зміниться , хіба що людей вирощуватимуть у пробірках і родина перестане існувати .	перестане	15	3
в зимі більше нема сил перебувать , нумо рухатись далі	нема	3	3
Сьогодні Сінгапур займає у рейтингу Transparency International ( 2009 рік ) 4-е місце за чистотою від корупції у світі та посідає 1-е – в Азії .	займає	2	3
Пастух сказав братам своїм : « Ходім туди ! » — і всі пішли до світла .	Ходім	6	1
Якщо ви подивилися фільм , то знайте , що книжка зовсім не така і не про те .	знайте	6	2
Спочатку розвага , словесний двобій пори , коли народжуються почуття , далі він поступово обертається на правила гри , які обумовлюють мало не саме́ буття цього кохання .	обертається	14	3
Після цього самка підгризає квітконіжку , яка надламується і в'яне .	надламується	7	3
Дома мене стрічає мама , радіє , плаче і підставляє мені для поцілунку сині губи .	плаче	7	3
Або Гнат стриножить свою брикливу жінку , і вона сидітиме дома та працюватиме , або хай собі під ( енергійно ) три чорти вибирається з хати !	стриножить	2	3
Марія від злості розривається .	розривається	3	3
Дома мене стрічає мама , радіє , плаче і підставляє мені для поцілунку сині губи .	стрічає	2	3
— Ходімо ж оцією доріжкою .	Ходімо	1	1
— А я принесу капусти .	принесу	3	1
Ото вона пішла та й жене .	жене	5	3
Припускаю ( поки не доведено протилежне ) , що автори їх просто " не бачать " - не виокремлюють із дискурсу , яким послуговуються .	виокремлюють	18	3
Згадайте лише як спіймали на хабарі екс-заступника міністра охорони здоров’я Романа Василишина , який довгий час до того працював головним лікарем Жовтневої лікарні в Києві ?	Згадайте	0	2
Ці останні часом мають виповнене дно так , що стають властиво подвійними мисочками на ніжці .	мають	3	3
Я виходжу з-за клуба , в новенькому дешевому костюмі ( три вагони цегли розвантажив з хлопцями - однокурсниками , то й купив ) і з чемоданчиком у руці .	виходжу	1	1
Плоди миють у холодній воді , відділяють домішки , витримують у двох відсотковому розчині солі , щоб позбутися личинок малинового жука , і використовують для варення , консервування з цукром , приготування сиропів , соків , желе .	відділяють	6	3
Нема на світі людини , якій би це не подобалось , звісно , коли дивуються нею .	дивуються	14	3
Завдяки тому , що голівка чоловічого прутня дотикається до клітора і треться об нього , такі зносини доводять до оргазму .	дотикається	7	3
— Лягай спати , я це все пороблю .	Лягай	1	2
— Не хочу .	хочу	2	1
Він постукує пальцями по столу , розмова зайшла в глухий кут .	постукує	1	3
Нові Всенародні Збори скликає і відкриває Голова , вибраний попередніми Всенародніми Зборами , Уряд Голови триває весь час , поки не будуть скликані нові Збори і буде вибраний ними Голова .	відкриває	5	3
Не шелесне лист , не ворухнеться гілка .	шелесне	1	3
і ти усвідомлюєш що цих твоїх близьких вигнали з роботи , бо вони кілька місяців там не зявлялись , а завжди з тобою ?!	усвідомлюєш	2	2
Докази їх наявності мусять видобуватися шляхом копіткого аналізу , що його методи мають варіюватися залежно від жанру пам’ятки та її стосунку до мови щоденного вжитку .	мусять	3	3
Місто складається з трьох близько розташованих , але цілком самостійних архітектурних груп , позначених буквами латинського алфавіту : « А » , « В » і « С » .	складається	1	3
Зимують жуки під грудочками землі , опалим листям та іншими рослинними рештками .	Зимують	0	3
Ото раз на кілька років вирвешся в ті гори , а воно ллє і ллє , ллє і ллє , і туман , і не видно ніякої карпатської краси .	вирвешся	5	2
Великою кількістю джерел мінеральних вод з давніх - давен славиться Карпатський регіон .	славиться	9	3
Також ви знаєте , що під час копіювання формул посилання в них модифікуються .	модифікуються	12	3
— Дозвольте , я піду з вами	Дозвольте	1	2
Видавництво наше , здається , не любить листуватися .	любить	6	3
Він визнав , що час від часу вживає марихуану шляхом куріння , а цей пакетик він поклав до кишені , і забув за нього , оскільки не одягав куртку з минулого року .	вживає	7	3
Кода " : з перших же слів зал ціпеніє , і ти читаєш у гробовій тиші - з відчуттям , ніби ріжеш по живому .	читаєш	12	2
У портфель книжки або не вміщаються , або губляться десь на дні ...	вміщаються	5	3
Для його виготовлення вовну випарюють у гарячій воді 3 - 5 годин , потім промивають в холодній річковій воді .	промивають	14	3
Ритми колишуться , барабан здригається .	колишуться	1	3
Візьмеш мене й побачиш , як добре тобі буде .	побачиш	3	2
Раптом він хапається за дерев’яшки , наче вирішивши зім’яти весь цей музичний похід .	хапається	2	3
— Ти , Михайле , кажу , хоч би разочок на неї глянув .	кажу	5	1
У разі збільшення розміру заборгованості підприємства з виплати заробітної плати у поточному квартальному звітному періоді порівняно з попереднім аналогічним звітним періодом премія за такий поточний звітний період не нараховується .	нараховується	28	3
Сонячної пори дивуймося , хвалімо , високо цінімо його чесноти , у хмарний час байдужіймо до принадливостей і витягаймо на денне світло негативні риси .	витягаймо	18	1
Вдома харчуюсь бананами ( величенька в’язка 1 , 5 € ) та мандаринами ( кіло ~ 2 € ) .	харчуюсь	1	1
– Іди знов на сцену .	Іди	1	2
Перемінні та урізноманітнені подразники спричиняють те , що швидко зводиться і твердне клітор .	твердне	11	3
Вони й почали ховатися : ведмідь лізе на дерево , вовк сідає за кущем , кабан заривається у хмиз , а зайчик лізе в кущ .	лізе	6	3
Все це робить негр , наче не слухаючи мелодії й ритму танцю , що совгає й колише цілу залу людських тіл в екстатичному захваті .	колише	16	3
Яґіч підсумовував уже 1884 р . : " Як не припускати для XI століття повного розвитку руських наріч , коли вже різні дрібниці їхні ясно прозирають із пам’яток .	прозирають	25	3
Підійшовши ближче , я вклоняюся Марфі й кажу через молоденьку сосну ;	кажу	7	1
Але й так воно дуже гарно , коли стільки різних кораблів на парусах ( єсть яхти більші від дніпрових пароходів ) бігають по морю .	єсть	14	3
Ну мені подобаються неформатні речі ... коли присутній пошук нових концептів і напрямків .	подобаються	2	3
" За даними джерел , Мінюст домагається співпраці від Йохая у зв'язку з розслідуванням справи Манафорта через можливе відмивання коштів чи податкові порушення під час його співпраці з проросійськими партіями в Україні " , - зазначає видання .	домагається	6	3
Хмельницька АЕС щорік виробляє близько 14 — 15 млрд квт · г електроенергії — тобто 15 , 6 % виробництва АЕС України .	виробляє	3	3
— Не поспішай , газдику , спочиньмо тут на травичці зеленій .	спочиньмо	6	1
( З нетерпінням чекаю оприлюднення нової пісні Сестер - на моє " Од такої тоски ... " : чула студійний запис , це бомба ! )	чекаю	3	1
Якщо у вас для кожної точки треба свою СВ , :wink2: а рух залежить від СВ , то не морочте голову , а прямо кажіть , що у вас рух залежить від точки .	кажіть	24	2
Але дехто і такі купує .	купує	4	3
Як комашва , визбируємо смутки та прикрощі з цілого дня і подаємо їх на вечірнє базікання .	подаємо	11	1
« Що ж до мене , – звірялася Михайлові Драгоманову , – то я тільки генієві можу простить кепсько збудований вірш , та й то не завжди .	можу	16	1
На вул Короленка ( площа – 469 кв . м . ) приноситиме відповідно 159 грн на день і 4761 грн на місяць .	приноситиме	12	3
Він вривається какофонічною й аритмічною стукавнею в мелодію , де такти різко й дисонантно не сходяться , як два різних годинники .	сходяться	15	3
Марін Ле Пен , якій вдається поєднувати патріотичний пафос із московськими грошима , що зобов’язують її фактично працювати в інтересах недружньої до Франції зовнішньої сили , ідеально пасує до окресленої державної формації .	зобов’язують	14	3
Карачапов , бережіться !	бережіться	2	2
Традиційно кажу спасибі всім , хто дочитав моє полотно .	кажу	1	1
Людоньки , хто слухає основи літ . творчості , підкажіть будь ласка дз на понеділок .	слухає	3	3
Хоча працівники Google мають спільні цілі та бачення компанії , ми представляємо всі верстви населення , розмовляємо десятками різних мов , уособлюючи всесвітню спільноту наших користувачів .	представляємо	11	1
Це сприяє правильному відпочинкові серцевого м’язу .	сприяє	1	3
Але в середньому мити раз на тиждень жінці , а чоловікові мити й того частіше ( адже волосся коротше і сохне швидше ) .	сохне	20	3
Почитавши ці рядки , ти , звичайно , не повіриш нам і скажеш : ви видаєте векселі , а де ваша ґарантія ?	повіриш	9	2
У центральній частині Азовського моря серед відкладів гірських порід переважають глинисті мули .	переважають	9	3
— Він врятується , — сказала вона ; в голосі їй дзвеніли істеричні нотки : — Він вислизне , він хитрий .	врятується	2	3
Але це аж ніяк не робить мене викладачем , бо викладати я не вмію , ні генетиком , бо мої знання застаріли на сорок років .	вмію	13	1
А ще смакує кукурудзяна олія ...	смакує	2	3
Якщо тобі набридли нудні пари , які не дають практичних знань , то з нами ти отримуєш купу корисної інформації , яку зможеш застосувати в будь-якій сфері життя !	зможеш	22	2
Сподіваюсь , він вас не дуже мучив )	Сподіваюсь	0	1
Важко мені буде на харчі , та вже терпітиму .	терпітиму	8	1
У нього не виходить правильно вимовляти ім'я зятя .	виходить	3	3
Але млію від дівчат , що вдягаються як я вдома	млію	1	1
Коли сьогодні нарікаємо , " чому в нас у владі весь час містяться злочинці й дебіли " , непогано б розуміти - та от саме тому )) .	нарікаємо	2	1
Будь ласка , заповніть анкету або завантажте своє резюме .	завантажте	6	2
В цю ж купу йде й сонетист Жак Шаню , якого преміювала навіть французька академія ( тільки цих своїх , релігійних , патріотичних і т . інш . вона й преміює ! ) .	преміює	30	3
Буває , що наглий обрив того напівмлосного трансу доводить до думки покінчити з собою і відчувається , як “ ломка ” у наркомана .	відчувається	15	3
Можна вчитися , можна працювати , але вдома , в любові , якщо вони хочуть жити повним життям й уникати розчарувань та психічних негараздів , жінка повинна бути жінкою , а чоловік повинен бути — чоловіком .	хочуть	14	3
Тож деякі сучасні систематики вказують прийнятою назвою цього виду Cyanus segetum Hill , а Centaurea cyanus вказують як синонім , водночас , інші вказують прийнятою назвою Centaurea cyanus , а Cyanus segetum вказують — синонімом .	вказують	16	3
Марфа ворушить губами і проводжає мене далі , аж доки я не увійду в сосну “ велику ” ( у нас її називають ще : “ та , що твій тато садив ” ) .	увійду	12	1
Іноді набереш повний пакет , а виходить порядку десятки .	набереш	1	2
А забудовник в корупційному тандемі із владою міста все створює і створює потенційні загрози .	створює	9	3
Ще очевидніше модерна національна ідентичність виявляється в інтерпретації українсько - російських взаємин .	виявляється	5	3
Коли Ви чесні люди , коли Ви демократи - не слухайте большевицької брехливої пропаганди , не слухайте тих , які вихваляють червоний тоталітаризм і кажуть Вам виступати проти українців .	слухайте	16	2
Провідною темою твору є пошуки Святого Грааля , проте ці пошуки несуть , насамперед , психологічний характер .	несуть	11	3
Він сідає рівніше , зачісує обома руками жовту гриву й гупа рукою по столі .	зачісує	4	3
— Чого ти здихаєш ? — гримнув на неї голова .	здихаєш	3	2
Гормони дванадцятипалої кишки через кров підсилюють шлункову секрецію .	підсилюють	5	3
Допоможу , якщо вчиниш те , що накажу .	вчиниш	3	2
Маю два чудові ілюстровані видання Гаррі Поттера .	Маю	0	1
Ячмінні зерна обжарюють – виходить солод карамельного кольору .	обжарюють	2	3
У портфель книжки або не вміщаються , або губляться десь на дні ...	губляться	8	3
Схопивши , озирається , біжить у куточок і там наминає свій маслачок .	біжить	4	3
Переклади , про які Ви пишете .	пишете	5	2
Як уродила їм та пшениця — давай вони зерном ділитися .	давай	6	2
— Збирайся ж , дочко , та й ходім , — каже дід .	Збирайся	1	2
Ми пішли подивитися , як Лаціс працює у переслідуванні .	працює	6	3
Цей спосіб ліг в основу розвитку поодиноких форм , що на перший погляд навіть не мають між собою нічого спільного .	мають	15	3
Одержу — пришлю .	Одержу	0	1
— Піду я , жінко , да хоч подивлюся на хрестини .	Піду	1	1
Якщо вкладетесь у цей день , то , по ідеї , ще можна .	вкладетесь	1	2
Ловить свою цесарку , позбавляє її життя , ошпарює , вкидає в свою машину .	позбавляє	4	3
Топази знаходяться в різних місцях виходу на поверхню гірських порід Українського щита .	знаходяться	1	3
Хотілось би зпитати , ви плануєте друкувати книгу Коннора Франти " Робота в процесі " ?	плануєте	5	2
В цілому я зараз його не уявляю , але окремі описи в ньому люблю і перечитую завжди .	перечитую	15	1
Про них майже нічого не знаю та і не хочу знати .	хочу	9	1
" Підтримую військових і дякую українським воїнам за захист нашої свободи , територіальної цілісності та суверенітету ! " - написала Гопко .	Підтримую	1	1
Дзядзьо тим часом стукав якимось патиком у стелю , бо думав , що тамтешні діти їздять серед ночі на ровері , а мама питалася у брата , нащо він трясе ліжком .	їздять	15	3
Все це робить негр , наче не слухаючи мелодії й ритму танцю , що совгає й колише цілу залу людських тіл в екстатичному захваті .	совгає	14	3
Суцільності « Кларнетів » вона не має , але « Плуг » перевершить .	перевершить	12	3
Ось Карачапов : він здатний схопити людину , що попала в скрутне становище , взяти її за горло й душити доти , поки ні копійки не лишиться в неї .	лишиться	26	3
Завдяки тому , що голівка чоловічого прутня дотикається до клітора і треться об нього , такі зносини доводять до оргазму .	треться	11	3
— Я з ним прийду , але ви поховайтесь , бо він вас розірве .	розірве	13	3
Підписана вже давно і з радістю відкриваю кожен пост , багато чого з того публікую у своїй стрічці - хай друзі теж радіють .	радіють	22	3
Чи маю я носити сам мою тугу огненну , чи маю ховати мій смуток темний ?	маю	10	1
Дід довго одказувався : жаль було йому дочки , — та що ти зробиш з бабою ?..	зробиш	13	2
Чувак побачив , що патрульні заходять у під'їзд , хутко чкурнув у квартиру і причаївся .	заходять	5	3
— Попередньо птицю потрібно ошпарити кип'ятком , — інструктує винахідник .	інструктує	8	3
ГО ветеранів - будівельників налічує аж двох справжніх майданівців з майданівськими посвідченнями .	налічує	4	3
Мама сміється , брат і сестри обурюються і опираються : з якої радості вони будуть жертвами нашого з мамою флешмобу ?	сміється	1	3
Миски ці своєю профіляцією та технікою виробу тісно в’яжуться з формою мисок на ніжках з лендєльської та інших європейських груп паскового неоліту .	в’яжуться	8	3
По-перше , Ви тепер точно знаєте що праві , по-друге , Ви виглядаєте гарною і молодою , і якщо у співрозмовника не вистачає не тільки аргументів , а і розуму - це вже не Ваша проблема .	виглядаєте	12	2
— Як візьмеш мене за жінку , то я тобі все зроблю так , як змія казала .	візьмеш	2	2
— Ховайтесь , казала лисичка , бо він як прийде , то розірве нас .	розірве	12	3
— Нема що робити , журбою не поможеш !	поможеш	7	2
Піду світом , щастя пошукаю , бо як удома сидітиму , усі погинемо » .	пошукаю	4	1
Удвох же , кажу тобі .	кажу	3	1
Залюбки цитований в історичній літературі мандрівник ( 20-ті роки XV ст . ) Ланоа докладно оповідає про татарську людність району поміж Дністром та Дніпром , що перебувала тут під зверхністю Витовта , але із своїми тубільними князьками .	оповідає	15	3
Признання мандатів неправними і скасовання виборів та призначення на їх місце нових виборів належить Всенароднім Зборам .	належить	13	3
Після третього ходу Пуня оголосив , що визнає себе переможеним і привітав чемпіона .	визнає	7	3
Якось так склалось , що живу за принципом " де моя сім"я , там мій дім " .	живу	5	1
Загальні вирази про жінку , як « приятеля - друга » , не прецизують погляду на таку важну справу .	прецизують	13	3
Але це не працює , тому що визначення структури ще не приводить до створення об’єкту .	приводить	11	3
Перш давайте добре познайомимось , а то от дідько його знає …	познайомимось	3	1
— Так , ма , — кажу я , — влаштуємо флешмоб .	влаштуємо	10	1
Існує різновид пестощів груді , од якого дістають надзвичайну насолоду обоє закоханих .	дістають	7	3
Вони безповоротно руйнують почуття безпеки у любові і розривають найістотніший зв’язок , що сполучає закоханих .	руйнують	2	3
Або Гнат стриножить свою брикливу жінку , і вона сидітиме дома та працюватиме , або хай собі під ( енергійно ) три чорти вибирається з хати !	працюватиме	12	3
— Їж , дорогий мій , їж ! — і вибирає йому найсмачніше .	їж	6	2
Якщо вони зникнуть в Україні , то автоматично зникнуть і в Європі » , – наголошує Василюк .	зникнуть	2	3
— Дівко , дівко , через поріг пересади !	пересади	7	2
При цьому стискаються губи та щелепи , піднімається м’яке піднебіння , і завдяки скороченням м’язів язика харчова грудка проштовхується у глотку .	стискаються	2	3
вони втратили своє особисте життя і ти відчуваєш за це відповідальність ...	відчуваєш	7	2
Він приходить сюди та й плаче .	плаче	5	3
З 760 лайкарів - в мене в друзях міститься тільки 7 , це - тішить .	міститься	8	3
Мати просто цвіте серед гостей , неприсідає , кожного припрошує , - адже така подія !	неприсідає	6	3
Дайте я його хоч у руках подержу …	Дайте	0	2
Багаті і бідні , власники і наймані працівники повинні були відчути , що вони – одна команда , співробітники однієї « корпорації » , яка конкурує з іншими країнами - « корпораціями » .	конкурує	25	3
Конфліктує з усім під'їздом .	Конфліктує	0	3
— Як хочеш , не раджу .	хочеш	2	2
А перед нею міститься — молоденька сосна рівними рядочками на жовтому піску .	міститься	3	3
Як ви вирішуєте проблему тонких перегородок в хаті , коли чути як скрипить ліжко і всякі інші звуки ...	вирішуєте	2	2
Сьогодні Індія має 850 тис . програмістів , вона стала світовим лідером у створенні програмного забезпечення і експортує його більше ніж на 30 млрд . дол .	експортує	17	3
“ Заповіту ” не вистачає колоритних персонажів .	вистачає	4	3
При цьому для інсталяції Office вам знадобиться ключ продукту .	знадобиться	6	3
Ці фрагменти — вочевидь , усе , що залишилось нам від “ Прометея 2 ” — надто вже виділяються на тлі океану кретинізму , що панує в “ Заповіті ” .	виділяються	18	3
Зареєструйтеся і сплачуйте регулярні рахунки без комісії протягом перших 2-х місяців * разом з нами !	сплачуйте	2	2
Але щойно їжа потрапляє на корінь язика і подразнює його рецептори , нервові імпульси відразу надходять до центру ковтання , розташованого у відповідному відділі головного мозку , і виникає рефлекс ковтання .	подразнює	8	3
Питають - розпитують , пишуть - записують .	записують	6	3
Коли Ви чесні люди , коли Ви демократи - не слухайте большевицької брехливої пропаганди , не слухайте тих , які вихваляють червоний тоталітаризм і кажуть Вам виступати проти українців .	вихваляють	20	3
Барабан крутиться , пір'я за них чіпляється і вилазить .	крутиться	1	3
Коли станеться якась заворушка — казав він — то по Тарасові , якщо він загине офіцером , родина буде отримувати значно більшу пенсію .	загине	14	3
аж смішно , коли пишуть " нічого не робила " , очевидно же , що груди і губи зроблені , тільки дурний не побаче .	побаче	23	3
Щось я ніяк мислю не второпаю .	второпаю	5	1
Бачу по тобі , що не давав !	Бачу	0	1
Він полегшує просування і видалення неперетравлених решток їжі .	полегшує	1	3
Називайте як хочете — але якщо у вас є щось , що таки можна так назвати — напишіть мені , будь ласка .	напишіть	17	2
Хто має і бажає продати / віддати — пишіть у приват )	пишіть	8	2
Серед по-справжньому відданих справі людей , трапляються такі , що я не можу це передати словами .	можу	12	1
Там він дістає із суми конверт і простягає Марфі :	дістає	2	3
Що смачніша їжа , то з більшим апетитом ми її з’їдаємо .	з’їдаємо	10	1
Приношу вибачення видавництву що так часто вклинююсь в коментарі .	Приношу	0	1
Не турбуйтеся Олексій , це нормально , так , там є невелика розбіжність .	турбуйтеся	1	2
Виліз пан Коцький на стіл та почав їсти , аж за ушима лящить .	лящить	12	3
Праця нищить митця , вважав я , і намагався їй якнайменше приносити в жертву свій час , бо найголовніше – творчість .	нищить	1	3
Так от , вони там робили горбик , а я взяв в Тішки біговел , і давай ганяти по тим горбикам .	давай	16	2
Нарешті я отримала свою довгоочікувану книгу , з таким нетерпінням летіла на пошту в дощ , як не знаю що ...	знаю	18	1
Заходи розпочнуться 31 травня 2017 року о 9 . 30 у Сумах на площі Незалежності урочистим відкриттям і закінчаться 2 червня о 16 . 00 церемонією нагородження переможців змагань .	закінчаться	18	3
Одного разу можеш так спіткнутися на дорозі життя , що не тільки виб’єш собі два передні зуби , а й взагалі не здужаєш підвестися .	виб’єш	12	2
Купила товар , а потім вже на роботі подивилась в неті , що сьогодні , у чорну п'ятницю ( як виявляється сьогодні такий день був ) , на мій товар була знижка .	виявляється	20	3
Двоє безпосередніх учасників нападу Гриць Купецький та Григорій Файда , а також провідник дрогобицької боївки УВО — ОУН Михайло Гнатів нелегально покинуть межі Польщі й опиняться на Заході .	опиняться	25	3
А дочка його питається :	питається	3	3
Як чоловік заявляю , вона ідеально виглядає .	заявляю	2	1
А чоловік , гадаєте , сидів ?	гадаєте	3	2
Якщо вони зникнуть в Україні , то автоматично зникнуть і в Європі » , – наголошує Василюк .	наголошує	15	3
Називайте як хочете — але якщо у вас є щось , що таки можна так назвати — напишіть мені , будь ласка .	хочете	2	2
По-перше , Ви тепер точно знаєте що праві , по-друге , Ви виглядаєте гарною і молодою , і якщо у співрозмовника не вистачає не тільки аргументів , а і розуму - це вже не Ваша проблема .	вистачає	22	3
Може це була й випадковість , може некомпетентні продавці трапились , що не пам'ятають весь товар і ціни напам'ять .	пам'ятають	13	3
— Визволь нас , чоловіче , визволь нас , голубчику , випусти нас , соколику .	випусти	11	2
аж смішно , коли пишуть " нічого не робила " , очевидно же , що груди і губи зроблені , тільки дурний не побаче .	пишуть	4	3
Цей причинок ставить собі завдання розглянути деякий матеріял паскової кераміки з Південно - Східньої Европи під оглядом техніки посудини на ніжці , що може кинути світло теж на питання споріднености окремих форм та груп ( подунайського неоліту ) .	ставить	2	3
Пакуй у міхи , що в них тільки влізе , повеземо до твоєї хижі .	повеземо	10	1
— Чого ти плачеш ?	плачеш	3	2
— А от коврижку ніхто вдома не їсть , — скаржиться мама на моїх братів і сестер .	скаржиться	10	3
Коли йдеться про доісторичну добу , головний матеріал дослідникові постачають українські діалекти та факти інших слов’янських мов , що досліджуються за допомогою порівняльного методу , а також аналіз запозичених українською мовою чужомовних слів .	досліджуються	19	3
За 9 км північніше від АЕС проходить залізнична лінія Шепетівка — Здолбунів — Львів , на якій розташована залізнична станція Кривин , до якої примикає під'їзна залізнична колія електростанції .	примикає	24	3
А той ніс із заліза : коли ним ударить , то гуде , як дзвін ...	гуде	11	3
— Тоді тебе визволю від пекла , зроблю щасливим та багатим , якщо візьмеш мене за жону .	візьмеш	13	2
— Дай я тобі , сестричко , починки подержу , поки ти перелізеш !	подержу	8	1
Він сказав — а вдруг станеться крушеніє .	станеться	5	3
Сьогодні Сінгапур займає у рейтингу Transparency International ( 2009 рік ) 4-е місце за чистотою від корупції у світі та посідає 1-е – в Азії .	посідає	20	3
І є відцентрова сила , що врівноважує доцентрову силу .	врівноважує	6	3
Не виступайте , отже , проти Українських Повстанців , не стріляйте до нас , але єднайтесь з нами і допомагайте нам .	виступайте	1	2
Тоді я замислююсь і кажу :	кажу	4	1
Ти завжди з зацікавленням стежиш за оголошеннями театрів — і напевно з жагою чекаєш побачити нову п'єсу автора " 97 " т . Куліша — " Народний Малахій " .	стежиш	4	2
Замовила нову книжку Роальда Дала - сподіваюсь , вона сподобається моїм малим не менше за " Чарлі та шоколадну фабрику " .	сподіваюсь	6	1
Пишуть , що бетон чудовий для малоплавних суден - барж , сховищ , а для швидких і багатоплавних не дуже підходить .	підходить	20	3
БЕЗКОШТОВНО встановимо стенди та заповнимо їх книжками !	встановимо	1	1
Зокрема , три з чотирьох відділень Українського степового заповідника – « Хомутовський степ » , « Кам’яні могили » , « Крейдова флора » – містяться саме в Донецькій області .	містяться	25	3
Мерзенні та дратівливі проблеми , поєднані з сексом , нашаровуються у психіці , і мимоволі відраза та зненависть до життєвих клопотів переноситься на супутні переживання — статеві взаємини .	переноситься	21	3
Село Половинчик згадується у циклі « Русалонька із 7 - В » Марини Павленко .	згадується	2	3
Часто випадає чути , що він чи вона сказали щось таке , чого зась , не можна взяти назад , і ті слова все - все попотрощили поміж ними .	випадає	1	3
Людоньки , хто слухає основи літ . творчості , підкажіть будь ласка дз на понеділок .	підкажіть	9	2
З-посеред них західноволинські , надсянські , наддністрянські , бойківські , західноподільські та покутські говірки ймовірно ведуть свою традицію в тих самих ареалах із доісторичних часів .	ведуть	15	3
Разом з хлопцями вони патрулюють і стали справжніми бойовими вепрами .	патрулюють	4	3
Якщо палета має неправильну геометричну форму ( зокрема , є частини , які виступають ) , то палетна вага вимірюється за крайніми точками габариту палети .	вимірюється	19	3
До 2050 р . населення всіх великих регіонів світу , за винятком Африки , майже на чверть становитимуть люди у віці 60 років або старше .	становитимуть	17	3
Або ти їй віддаєшся повністю , пірнаєш у неї з головою , або бавишся в цюцю - бабки , і тоді вона до тебе повертається задницею , а ти так і зостанешся вічним невдахою .	віддаєшся	3	2
Можливо , зганяємо в Карпати , хочу долучитись до друзів у похід :)	зганяємо	2	1
Наведені вище пестощі мають подвійне значення , бо справляють приємність та збуджують також і жінку , що відчуває , як унаслідок її пестощів підводиться , надимається і готується до акту чоловічий прутень .	збуджують	11	3
Я не представник видавництва , та все ж підкажу вам .	підкажу	8	1
— Я тільки в руках подержу , дядечку , і оддам .	оддам	10	1
Скажімо , четвертий ряд , дев’яте місце у кінотеатрі « Спартак » під час сеансу на чотирнадцяту двадцять .	Скажімо	0	1
Автор проекту « Сімейний екстрім » , котрий ( через відсутність зацікавлення з боку наших телекомпаній ) проводить в екзотичних країнах південно - східної Азії .	проводить	17	3
І щонайгірше , точка неповернення , після якої розумієш , що перейматися долею героїв , вболівати за них і взагалі сприймати фільм серйозно не вийде , настає задовго до появи Чужих .	розумієш	8	2
Перед вами містяться зразки деяких карт і моя обіцянка , що гра обіцяє бути цікавою .	обіцяє	12	3
Синоніми становлять у великій мірі багатство мови , розуміється , коли авторів лінгвістичний смак і чуття мови вміє їх одтінити .	становлять	1	3
А він усміхається й гадає , що сам іде , " сам іде " !	усміхається	2	3
І ось , остаточно змучившись надокучливим пасталяканням , шукаємо солодкої втіхи у забаві вдвох .	шукаємо	8	1
Ото раз на кілька років вирвешся в ті гори , а воно ллє і ллє , ллє і ллє , і туман , і не видно ніякої карпатської краси .	ллє	12	3
А щелепи йому десь аж корчить , і хочеться кинутись , виючи , на їжу й обома руками пхати її в себе , сопучи та здригуючись від насолоди .	хочеться	8	3
Детально про локацію читайте тут http://edustation.in.ua/ і готуйтесь заливати місто цікавим літом !	готуйтесь	7	2
От раз та сучечка бігає коло хати та й дзявкотить :	дзявкотить	9	3
Готують їжу у велетенському казані , з нього ж їдять .	Готують	0	3
У разі придбання планів Office Для дому та навчання , Office Для дому та бізнесу чи Office Професійний , увійдіть до сторінки свого облікового запису Microsoft Store , зв’язаного з вашим замовленням , та встановіть Office .	увійдіть	19	2
Приходить туди , а той і питає :	Приходить	0	3
Діватись було нікуди готель проплачений вирішуємо їхати далі .	вирішуємо	5	1
Нічого , знайду ось вільшечку — переплаче .	знайду	2	1
Підійшовши ближче , я вклоняюся Марфі й кажу через молоденьку сосну ;	вклоняюся	4	1
Влаштовуйтесь , товаришу , як вдома .	Влаштовуйтесь	0	2
— Я одну ногу залишаю , щоб було за що витягати з гарячої води .	залишаю	4	1
Зустріли незнайомця — пусте , спершу ми підемо за ним у якесь дивне місце , де не ловить радіо , а тоді вже будемо ставити йому якісь питання .	підемо	7	1
Якийсь заворушиться , і всі прокидаються зі свого напівсну та вибухають жалібним лементом .	прокидаються	5	3
Одначе розгляд фрагментів цього посуду дозволяє думати , що тут маємо аналогічну техніку , бо не трапляється , щоб ніжка відбивалась від дна посудини в площі здогадного перетину , натомість посудина розбивається все спільно з ніжкою .	трапляється	16	3
Ми переходили з черешні на черешню , трактуючи кожне дерево , як богема трактує — різні каварні і бари .	трактує	13	3
— Тільки Ви тихенько , — поінформував хтось пошепки , — ми сидимо от , як турки , бо не маємо права ані ходити , ані стояти , ані лежати …	сидимо	12	1
Так і в домовину ляжемо , а нікому буде за нами щиро поплакати , нікому буде й душі наші грішнії пом’янути !	ляжемо	4	1
Навіщо в кожну статтю про арахнофобію обов’язково вставляють фото стрьомних великих павуків ?	вставляють	7	3
Якщо хтось не співає і не світить оголеним тілом в кліпі , то , можливо , він рятує чиєсь життя ?	світить	6	3
Нині тут налічують близько 800 мінеральних джерел .	налічують	2	3
Треба ще більш рішуче відгородитися не лише від фемінізму ( амазонства ) , але й від чотирьох К , що відгомоном грають навіть серед тих , які того зрікаються .	зрікаються	28	3
Поки що орієнтовна вартість — 50 грн ( і ми сподіваємось , що вартість остаточна буде дещо нижчою ) .	сподіваємось	10	1
Гнат наскоро робить з комори ( що через сіни ) хату , ставить стола , лави , стільці , чіпляє в куті кілька образів і перебирається з Марією на самостійне господарювання .	чіпляє	19	3
Водою зі шланга зверху поливаю , воно змивається вниз , на лоток , щоб потім піти на викинштейн .	поливаю	4	1
Який руйнівний вплив має на статеві взаємини неприємний запах з рота , бачимо вже в настановах Корану , де є цілий параграф , що дозволяє дружині розвестися зі своїм чоловіком , коли в того повсякчас смердить із рота .	дозволяє	24	3
І так мені руки потім засверблять , що , буває , ложки хлопцям ріжу на дозвіллі .	ріжу	13	1
Половина вас нехай тягне в одну сторону , а половина тягне в другу , то воно й розколеться .	тягне	3	3
Не знаю , можливо , він дуже глибоко .	знаю	1	1
Нищиться тоді дивовижний , досі чудовий та прекрасний о́браз коханої людини .	Нищиться	0	3
Ми покладаємося на ваші внески , щоб виконувати нашу місію зі збереження Інтернету відкритим і вільним .	покладаємося	1	1
Полегшить вам цей шлях пізнання книга , яку ви тримаєте в руках і з якою працюватимете впродовж навчального року .	тримаєте	9	2
Немає Мотрі спокою і в церкві : і там її не спускають з очей .	спускають	11	3
Зареєструйтеся і сплачуйте регулярні рахунки без комісії протягом перших 2-х місяців * разом з нами !	Зареєструйтеся	0	2
Ви , може , не пригадуєте , але я знаю , що колись ви були з ним в дуже близьких відносинах .	знаю	9	1
Завдяки тому , що голівка чоловічого прутня дотикається до клітора і треться об нього , такі зносини доводять до оргазму .	доводять	17	3
Запровадь пільги .	Запровадь	0	2
Вони й почали ховатися : ведмідь лізе на дерево , вовк сідає за кущем , кабан заривається у хмиз , а зайчик лізе в кущ .	заривається	16	3
— Лягай же тепер спати , а завтра рано щоб устав та понесеш змії паляницю .	понесеш	12	2
Ти питаєш , як нас годують , як одягають на зиму .	питаєш	1	2
Умовний рефлекс пускає корені і винищує найкоштовніші якості співжиття — почуття повної розрядки та радісної відпруги .	пускає	2	3
Оскільки літальний апарат під час доставки перебуватиме в русі , технологія передбачає регулювання сили , докладеної до посилки під час спуску , а також систему відслідковування процесу « падіння » замовлення на землю .	перебуватиме	6	3
Ці індустрії формують великі інформаційні « антицивілізації » , які щораз більше викривлюють наш інформаційний простір .	формують	2	3
Не виступайте , отже , проти Українських Повстанців , не стріляйте до нас , але єднайтесь з нами і допомагайте нам .	стріляйте	10	2
Стомлені , роздратовані , зневірені життям — втікаємо , у ліжкові шукаючи забуття , і , подібно як алкоголем , не вгаваючи , напиваємось донезмоги .	напиваємось	23	1
Так чинячи , звертаємо увагу на свою особу , на свої привітність , спостережливість , проникливість .	звертаємо	3	1
— А я меду принесу на закуску .	принесу	4	1
Або ти їй віддаєшся повністю , пірнаєш у неї з головою , або бавишся в цюцю - бабки , і тоді вона до тебе повертається задницею , а ти так і зостанешся вічним невдахою .	бавишся	13	2
Піду світом , щастя пошукаю , бо як удома сидітиму , усі погинемо » .	погинемо	12	1
Потім сів на лавицю і гріється .	гріється	5	3
У ході форматування для спрощення доступу до даних на носіях великої ємності сектори об’єднують у кластери .	об’єднують	13	3
Сьогодні кордони достатньо відкриті , і глушниками інформацію не заблокуєш , бо є інтернет .	заблокуєш	9	2
Привертають увагу « шафка » з глини , чавунні казанки , які розшукав у старших людей по району .	Привертають	0	3
— Мамо , — питаю після того , як куці студентські новини розказано ( сесію здав , костюм ось купив ) , — а чого тітка Марфа Яркова на мене так дивиться ?	питаю	4	1
І чи ви не маєте в планах видати чудові вірші Тамари Коломієць ?	маєте	4	2
Ви також можете надіслати своє резюме на адресу hr@sushiya.ua	можете	2	2
Не бий мене та візьми до себе — я тобі у великій пригоді стану !	візьми	4	2
Поздовжні рухи пальця тоді , як відчується , що твердне клітор , треба змінити на поперечні , під час яких палець перестрибує через його верх або легесенько шарудить уздовж бічних канавок .	перестрибує	21	3
Вирішують здати його в оренду .	Вирішують	0	3
Через подорожчання , зазначають аналітики , знизяться платежі , а кількість людей , яким нічим буде платити , зросте в рази .	знизяться	6	3
— Так , чуєш , далі не можна .	чуєш	3	2
Вийшла , обійшла кругом хати — нема батька .	нема	6	3
Ти питаєш , як нас годують , як одягають на зиму .	годують	5	3
Від солі вони отак зморщуються !	зморщуються	4	3
ні ти , ні синок , мій колосок , чогось давно не снитесь , тільки привиджуєтесь .	привиджуєтесь	15	2
Він , недбало розсівшись , ставить малесенькі ставки , — його не обходить гора .	обходить	12	3
Що видавництво « Книгоспілка » думає робити далі в справі переговорів з Вами — не знаю .	знаю	15	1
Самі страшні бомжихи , сидите в протоптаному дивані і плюєтесь )	сидите	4	2
Це зовсім не трагедія , і шукати в собі надумані причини , чому так відбувається ( « іншим же ок ! » ) – останнє , що треба робити в такій ситуації .	відбувається	14	3
Коли терпляче й наполегливо навчати жінку пестощів , це щедро винагородиться , як стане вона досконалою партнеркою чоловіка у коханні .	стане	13	3
— Та кажи !.. чого ти плачеш ? — аж скрикнула вона .	плачеш	6	2
Коли ти на каруселі крутишся , на тебе типу сили діють .	діють	10	3
Он є комора , роби з неї хату і жий там , як хоч .	жий	9	2
Здається , вола за роги вхопить і об землю кине " .	кине	9	3
Там ви можете побачити що видання " в'язня Азкабану " готується на грудень 2017 року .	можете	2	2
Крейдяна сосна , що росте на виходах крейди довкола Слов’янська , не трапляється більше ніде у світі .	росте	4	3
Гра називалася « на кого Бог пошле » .	пошле	6	3
А він говорив тим своїм усміхненим поглядом : « Не кваптесь , друзі мої !	кваптесь	10	2
Уявляю , якби я був шпигун , та попався з таким папірцем контррозвідці ...	Уявляю	0	1
Забороняється проведення боїв тварин , спортивних , видовищних заходів , що передбачають переслідування , умертвіння , спостереження передсмертної агонії тварин , використання для умертвіння тварин інших тварин .	передбачають	11	3
— Пусти ! — кричить ґазда .	кричить	4	3
— Підеш до пекла !	Підеш	1	2
Вони виконують подвійну роль , пробуджуючи еротичну чутливість жінки та призвичаюючи її до вигляду і дотику прутня у час солодких зазнава́нь .	виконують	1	3
Чує Мотря , та боїться озирнутись : їй чогось соромно , страшно .	Чує	0	3
Кода " : з перших же слів зал ціпеніє , і ти читаєш у гробовій тиші - з відчуттям , ніби ріжеш по живому .	ріжеш	21	2
У період очарування нема жодних сподівань на розсудливе мислення .	нема	3	3
— Одведи - таки та й одведи свою дочку в ліс : нехай її там звіряки з'їдять .	Одведи	1	2
Щоби мама не знала , що він курить , товариш тримав сиґарету не пальцями , а затиснувши її у гребінь з довгим руків’ям .	курить	7	3
Обіймаю тебе і несу на руках колиску з сином , доки й житиму … ”	несу	3	1
Можливо , вам здасться дивним , але в житті я майже не слухаю попсу .	здасться	3	3
Якоїсь миті Вінстон ясно зрозумів що горлає разом із рештою та жорстоко , ба навіть брутально , лупить своєю п’ятою по обідку свого ж таки стільця .	лупить	17	3
— Дай я тобі , сестричко , починки подержу , поки ти перелізеш !	перелізеш	12	2
- Стій !!	Стій	1	2
Та дівка його питається :	питається	3	3
Одначе розгляд фрагментів цього посуду дозволяє думати , що тут маємо аналогічну техніку , бо не трапляється , щоб ніжка відбивалась від дна посудини в площі здогадного перетину , натомість посудина розбивається все спільно з ніжкою .	розбивається	31	3
— А вилазьте , злидні , поїдем у ліс !	поїдем	6	1
Круги ті широкі і значки поставлені зрідка , так що , з берега дивлячись здається , що яхти так собі плутаються без мети і плану .	плутаються	20	3
Його діяльність перебуває під контролем свідомості людини .	перебуває	2	3
Мені щиро жаль - я любила Америку ( зараз поставлю собі New York , NY у виконанні Сестер Тельнюк : попрощатися з тою , яку любила ) .	поставлю	9	1
За своїми функціями виділяють покривний і залозистий епітелій .	виділяють	3	3
Зробите внесок сьогодні ?	Зробите	0	2
От перед весіллям , увечері , кличуть на шишки молодиць .	кличуть	6	3
Ні , я кину тугу в серце наймиліших дітей ворога мого , я розкину над ними смуток чорним покривом , і потьмариться мрія ворога мого » .	розкину	13	1
— Візьми та гляди , — каже , — небагато накладай на віз , щоб ти мені коня не спортив .	накладай	10	2
Наявність такого права для жінки у культовій книзі , яка обґрунтовує радше права чоловіків , ніж жінок , показує , наскільки гидко може тхнути з рота .	обґрунтовує	10	3
— Так , ма , — кажу я , — влаштуємо флешмоб .	кажу	6	1
Щоб дати змогу орієнтуватися в можливих у літературній мові паралельних синонімічних зворотах , я поряд із широко вживаним зворотом наводжу й менш поширений .	наводжу	19	1
Чому ви жіночі циці зневажливо називаєте цицьками .	називаєте	5	2
Фактична вага таких відправлень визначається без урахування обрешетування , висота палети визначається за крайніми точками обрешетування .	визначається	4	3
Їх розчини потрапляють у річки , озера , водосховища , моря , що часто призводить до замору водойм .	призводить	14	3
Стомлені , роздратовані , зневірені життям — втікаємо , у ліжкові шукаючи забуття , і , подібно як алкоголем , не вгаваючи , напиваємось донезмоги .	втікаємо	7	1
Ловить свою цесарку , позбавляє її життя , ошпарює , вкидає в свою машину .	вкидає	10	3
Передбачається , що дрон літатиме на висоті до 120 метрів і нестиме пакунок до 2 , 5 кг .	Передбачається	0	3
Кліп Бадоєв зняв гарно , він майстер своєї справи , справжній художник , але пісня не дотягує до кліпу , хочеться лишити відео і увімкнути на його фоні якусь якісну композицію .	дотягує	16	3
Так , Чернівецька область вирізняється серед інших регіонів найвищою абсолютною висотою рівнинної частини України ( 515 м ) .	вирізняється	4	3
Вона складається з області видимості , в якій знаходиться блок чи визначення функції , доповненої власним простором імен .	складається	1	3
— Пусти ! — кричить ґазда .	Пусти	1	2
Обіймаю тебе і несу на руках колиску з сином , доки й житиму … ”	житиму	12	1
— Не поспішай , газдику , спочиньмо тут на травичці зеленій .	поспішай	2	2
Буває всякого … »	Буває	0	3
У більшості країн і регіонів світу тривалість життя збільшується .	збільшується	8	3
Почнімо з того , що Київ не обмежується туристичними затертостями типу того - таки Хрещатикомайдану і Маріїнського парку .	Почнімо	0	1
Не здивуюсь , якщо Дейнеріс влаштує республіку .	влаштує	5	3
А там , на землі , панує ясний спокій , мрія ворога мого цвіте і витає — і ніщо не бентежить її .	бентежить	20	3
Обличчя негра спливається з ритмом , ніздрі ходять у такт , очі примружено соловіють і розтікаються у солодкій втомі , що знаменує екстаз музичної дії .	соловіють	13	3
Які карні переступства тягнуть позбавлення виборчого права , про те рішають Всенародні Збори звичайним законодатнім порядком .	рішають	10	3
— Визволь нас , чоловіче , визволь нас , голубчику , випусти нас , соколику .	Визволь	1	2
Текст « Живем комуною » , як він видрукуваний у « Шляхах мистецтва » , — це таке свідчення про бідність естетичну , що я й не знаю , як редакція погодилась його собі самій видати .	Живем	2	1
Я підрахував , що витрачаю в середньому до 10 € в день .	витрачаю	4	1
Посилання , яке модифікується під час копіювання формули , називають відносним .	модифікується	3	3
Виділення апетитного соку має виняткове значення , оскільки шлунок готується до перетравлювання їжі ще до її надходження .	готується	9	3
БЕЗКОШТОВНО встановимо стенди та заповнимо їх книжками !	заповнимо	4	1
Тим прислужитесь також своїй батьківщині , яка рівно ж загрожена сьогодні небезпекою большевицького імперіалізму .	прислужитесь	1	2
Також вона згадала , що зелені насадження виконують захисну функцію від автошляху , а знищення дерев та будівництво АЗС чи автомийки ще більше псує екологічний стан міста .	виконують	7	3
Наприклад , за рахунок такої комплексної переробки покладів в Україні виготовляють вапнякові добрива , шляховий і будівельний щебінь , цеглу .	виготовляють	10	3
Після цього самка підгризає квітконіжку , яка надламується і в'яне .	в'яне	9	3
Щодо можливості використання текстів давньоукраїнської доби для реконструкції протоукраїнської мови — див . завваги в 14 . 7 .	див	11	2
Маю мимовільне враження , ніби щось подібне відбувається 25 грудня і 7 січня .	Маю	0	1
— Я не хочу грошей , мені дайте яйце - райце !	дайте	7	2
Бузук у причини звукозмін теж не заглиблюється , але подає найважливіші з них у хронологічній послідовності .	подає	9	3
Перед кожним із них коротко викладено суть матеріалу , що міститься в даному розділі , а наприкінці , у рубриці « Підсумки до розділу … » , узагальнено й систематизовано навчальний матеріал .	міститься	10	3
— А вилазьте , злидні , поїдем у ліс !	вилазьте	2	2
Про те як часто чи згідно якої системи Поліція Думок смикає за будь-який з персональних лялькових дротів можна було лише здогадуватись .	смикає	10	3
Світ видається напрочуд барвистим та свіжим , сповненим збудливих звуків та запахів ( що зв’язано з посиленою гостротою чуттів ) .	видається	1	3
Хотіла написати , що погоджуюся )	погоджуюся	4	1
Змія встає та й дивиться , що все так ізроблено , як вона йому загадала .	встає	1	3
Однак зменшувати шорсткість поверхонь можна лише до певної межі , оскільки , якщо поверхні дуже гладенькі ( наприклад , поліровані ) , то проявляються сили міжмолекулярного притягання , що перешкоджають ковзанню .	проявляються	23	3
Ачей , мене не вб’ють , а як будуть бити , то і я маю сокиру !	вб’ють	4	3
— Принеси мене до своєї хати та годуй мене м'ясом доти , поки в мене крила повідростають .	годуй	7	2
Закриймо очі на те , що поломку “ Заповіта ” списали на безглузду причину типу “ на мою машину посвітило вранішнє сонце , тому в мене пом’явся кузов і фари розбились ” .	Закриймо	0	1
Сидить на поріжку і обриває пелюстки на ромашці , шепочучи : “ Є — нема , є — нема , є … ”	Сидить	0	3
Став коло вогню , сушить плаття .	сушить	4	3
Слів тих уже не забереш назад і ніко́ли вже не відновити довіри коханої людини .	забереш	4	2
Здається , вола за роги вхопить і об землю кине " .	Здається	0	3
Здається , вола за роги вхопить і об землю кине " .	вхопить	5	3
Найперш барикада мала би перегородити затишну вітальню косачівського дому , бо , як дізнаємося з академічних пояснень , Ольга Драгоманова - Косач « стояла на ліберально - буржуазних позиціях » , а її донька стояла – на марксистських .	дізнаємося	13	1
Вивчаючи фізику в 7 класі , ви переконалися , що ця наука відкриває для вас багато таємниць природи , допомагає пояснити явища , з якими ви стикаєтеся на кожному кроці .	стикаєтеся	26	2
Якийсь заворушиться , і всі прокидаються зі свого напівсну та вибухають жалібним лементом .	вибухають	10	3
Її там не впізнали , і як уже вона розказала все , то мачуха аж об поли вдарилась , що , бач , вона думала її з світу зігнати , а тут зовсім не так вийшло ...	бач	21	2
Я буду продовжувати ту політику , яку запропонував , усіма доступними інструментами та методами , які дозволяє демократія та принципи публічної політики .	дозволяє	16	3
Живуть , дійсно , але як живуть , чому живуть , куди живуть ?	живуть	9	3
Які карні переступства тягнуть позбавлення виборчого права , про те рішають Всенародні Збори звичайним законодатнім порядком .	тягнуть	3	3
Коли сьогодні нарікаємо , " чому в нас у владі весь час містяться злочинці й дебіли " , непогано б розуміти - та от саме тому )) .	містяться	12	3
Зубами цокотить .	цокотить	1	3
З 760 лайкарів - в мене в друзях міститься тільки 7 , це - тішить .	тішить	14	3
Марфа ворушить губами і проводжає мене далі , аж доки я не увійду в сосну “ велику ” ( у нас її називають ще : “ та , що твій тато садив ” ) .	проводжає	4	3
Допоможу , якщо вчиниш те , що накажу .	Допоможу	0	1
— Я тільки в руках подержу , дядечку , і оддам .	подержу	5	1
Гляди ж , щоб і друге діло зробив !	Гляди	0	2
Цього року вона здасть останнього екзамена і вийде з школи розумною , правдивою і чесною дівчиною .	здасть	3	3
У програмі заходів також очікується проведення майстер - класів , конференції для керівників центрів екстреної медичної допомоги , Медичного форуму за участю представників сусідніх областей .	очікується	4	3
не знаю , як всі ті ваші мангали , а от big green egg можна назвати замінником грубки .	знаю	1	1
Досить далеко від берега стало зрозуміло , що піроґа пропускає воду .	пропускає	9	3
І не думайте злого .	думайте	2	2
У результаті цих процесів утворюється вуглекислий газ , що виводиться з організму .	виводиться	9	3
Катай , серденько , катай , принесеш діткам гостинчика .	Катай	0	2
Цього року вона здасть останнього екзамена і вийде з школи розумною , правдивою і чесною дівчиною .	вийде	7	3
У мене Анжеліна Джолі відмовляється грати у фільмі .	відмовляється	4	3
Вони могли б правити і за основу , коли доводиться творити нові фразеологічні звороти або перекладати чужі .	доводиться	9	3
Пам'ятайте , що ми , Українські Повстанці , боремося за найвищі і найшляхетніші вселюдські ідеали свободи , братерства і рівноправности всіх народів , ми боремося за національне і соціальне визволення , рівність і справедливість кожнього народу і кожньої людини !	боремося	8	1
Такий досвід поменшує її страх перед першим статевим актом та роздмухує інтерес до дальших пестощів .	роздмухує	10	3
Озброюємо броварських тітушок і направляємо їх захищати інтереси Сапожко та всієї броварської мафії , бо вони - патріоти , а хто проти них - агенти кремля і злочинці	Озброюємо	0	1
– Кого ти граєш у другій картині , в церкві ?	граєш	3	2
Це — отруєний ґрунт , на якому пліснявіє гнила слизота неокласики та росте тощий мох їхнього сонетового виробництва .	росте	12	3
— Ховайтесь , казала лисичка , бо він як прийде , то розірве нас .	Ховайтесь	1	2
Пишуть , що бетон чудовий для малоплавних суден - барж , сховищ , а для швидких і багатоплавних не дуже підходить .	Пишуть	0	3
Не любите гуляти – до ваших послуг затишні столики в сотнях різних класних закладів ( ті ж - таки друзі з гуртожитку стануть вам найповнішим сітігайдом найкращими і при цьому підйомними для студентського бюджету кнайпами ) .	любите	1	2
Існує різновид пестощів груді , од якого дістають надзвичайну насолоду обоє закоханих .	Існує	0	3
Може вона і жалілась , скажімо , на чоловіка - мамі , священику , подругам , - і почула " що поробиш , терпи , то треба терпіти " .	скажімо	5	1
« Єва чи еманципантка — між цими двома типами мусите вибирати » !	мусите	9	2
Такі моделі зберігають систему виборної влади , політичний та економічний плюралізм , але нехтують етичними імперативами .	нехтують	13	3
борюся з цим : наприклад написав пісню ( з посвятою моїй першій викладачці англійської та її дочці ) , яку ми з групою тепер граємо !	граємо	24	1
У такому становищі є один крок до того , щоб закрутити нову́ любов , у якій шукаємо солодкого блаженства у ліжку замість подружнього “ раю ” , котрий вимотує всі жили .	шукаємо	16	1
Питають - розпитують , пишуть - записують .	пишуть	4	3
Раптом ці звуки перериває вступний брязкіт литаври , що , завмираючи , подає голос од натискування ноги .	подає	12	3
Ви нічого йому не зробите .	зробите	4	2
Він сідає рівніше , зачісує обома руками жовту гриву й гупа рукою по столі .	сідає	1	3
Буднього робочого дня Марія одягає святкові одяги .	одягає	4	3
А там , на землі , панує ясний спокій , мрія ворога мого цвіте і витає — і ніщо не бентежить її .	цвіте	13	3
Другого дня , коли зійшлися до театру й почали розповідати одне одному , як кожний влаштувався , виявилося , що всі хазяї годують нас безкоштовно і вважають актора своїм дорогим гостем " .	годують	22	3
Двоє безпосередніх учасників нападу Гриць Купецький та Григорій Файда , а також провідник дрогобицької боївки УВО — ОУН Михайло Гнатів нелегально покинуть межі Польщі й опиняться на Заході .	покинуть	21	3
Джерела CNN повідомляють , що документи , які було вилучено під час обшуку , містили фінансові та податкові звіти та що частину цих даних було передано представникам Сенату .	повідомляють	2	3
Однак зменшувати шорсткість поверхонь можна лише до певної межі , оскільки , якщо поверхні дуже гладенькі ( наприклад , поліровані ) , то проявляються сили міжмолекулярного притягання , що перешкоджають ковзанню .	перешкоджають	29	3
Лучче ми тобі дамо багато грошей .	дамо	3	1
— Візьми та гляди , — каже , — небагато накладай на віз , щоб ти мені коня не спортив .	гляди	3	2
Офіційно сподіваємось випустити гру у вівторок , 18 жовтня , тим часом оформити передзамовлення за собівартістю можна в мене через особисті повідомлення — Вам це вийде дешевше , а ми точно знатимемо розміри першої партії .	знатимемо	31	1
Пакуй у міхи , що в них тільки влізе , повеземо до твоєї хижі .	влізе	8	3
Ця думка й тепер держиться : « Самостійно й оригінально переживані інтуїції збуджують індивідуальну творчість стилістичну , але коли натрапляють на задубілі форми язикової експресії , вони мусять до них нахилитися .	збуджують	12	3
Ми вимикаємо телефони , не дивимося новини , не обговорюємо їх , не сваримося .	вимикаємо	1	1
Тут ви можете знайти корисні поради щодо свідомого життя , реальні інструменти для гарного планування і море натхнення .	можете	2	2
Ці малолітки мусять зрозуміти , що , по-перше , у житті існує принцип бумеранга , по-друге , з деякими людьми краще не зв’язуватися .	мусять	2	3
Всі співають пишаються своїм званням студента найкращого ВНЗ України , а самі не можуть донести сміття до урни …	пишаються	2	3
Через подорожчання , зазначають аналітики , знизяться платежі , а кількість людей , яким нічим буде платити , зросте в рази .	зросте	18	3
А як хто й гавкне , то не біда .	гавкне	4	3
Так само знехтуймо фактом , що не можна так просто взяти і різко змінити курс космічного корабля кількарічного рейсу ( у вже згаданій книжці і цьому є зрозуміле фізичне пояснення ) .	знехтуймо	2	1
Тільки тоді він вам повірить — коли я стоятиму поруч із вами !..	повірить	4	3
Підписана вже давно і з радістю відкриваю кожен пост , багато чого з того публікую у своїй стрічці - хай друзі теж радіють .	відкриваю	6	1
Спочатку я наївно думала , що , якщо побачила назву вулиці , яку знаю , то точно її знайду .	знаю	13	1
Якщо хресним \ ою стала людина яка насправді не була охрещеною і сама являється противником християнства , то наскільки прикольним є цей випадок ?	являється	13	3
Я дякую всім — і це головне .	дякую	1	1
Бувай голод – привіт можливості !	Бувай	0	2
Цей графічний код сприймається спеціальними сканерами та опрацьовується далі з використанням комп’ютера .	опрацьовується	7	3
Я сиджу на кухні , їм сирну запіканку і запиваю колою .	сиджу	1	1
Тож тепер читачі зможуть отримувати книги просто з неба	зможуть	3	3
Будь ласка відгукніться ті , хто переходив в Могилянку з Острозької академії або хоча б підкажіть , де таких можна знайти ?	Будь	0	2
Ти питаєш , як нас годують , як одягають на зиму .	одягають	8	3
Детально про локацію читайте тут http://edustation.in.ua/ і готуйтесь заливати місто цікавим літом !	читайте	3	2
Так , ТЕС , підприємства вугледобувної промисловості забруднюють повітря окисами вуглецю і азоту , сажею , пилом тощо .	забруднюють	7	3
Силує баба чоловіка :	Силує	0	3
У цій сфері нічо́го не зміниться , хіба що людей вирощуватимуть у пробірках і родина перестане існувати .	зміниться	5	3
Сьогодні ми компанією їздили на один з тих пароходів , великий військовий , що зветься « Dandolo » ( по імені одного знаменитого дожа ) .	зветься	14	3
Ми вже два роки б'ємося з такою халтурою і вживаємо всіх сил , щоб дати для цього путящу книжку , де б не пахло ладаном , ні словоблудієм і де б ти міг знайти багато цікавих для себе речей .	б'ємося	4	1
На моє запитання пояснила , що " - ті слимаки , то така зараза , з'їдають на городі чисто все !	з'їдають	15	3
Тепер він гратиме з розумом .	гратиме	2	3
Було зрозуміло , що він блефує .	блефує	5	3
Черкаси поділені на квадрати й відстань від пункту А до пункту Б тут вимірюється кварталами .	вимірюється	13	3
Зволоживши краплиною духів плечі побіля вирізу на сукні , викличемо на тоді , як тіло розігріється , виділення милого запаху з-під того вирізу .	розігріється	15	3
Щодо ремонтів і " облагородження " зйомної квартири , то поміняла їх кілька , але тільки в першій і в цій , що живем зараз робили " облагородження " .	живем	23	1
У столиці Австро - Угорської імперії юнаки перш за все купують путівник і беруться оглядати місто .	беруться	13	3
А там , на землі , панує ясний спокій , мрія ворога мого цвіте і витає — і ніщо не бентежить її .	витає	15	3
Вона пішла за мого тата « на дитину » , як мені було дев'ять років , і прожила з ним до війни рівно місяць , а зі мною оце вже шостий рік мучиться .	мучиться	32	3
Процедури на експериментальних тваринах незалежно від їх цілей , за яких можлива небезпека травмування тварин або заподіяння їм гострих чи тривалих больових подразнень , проводяться в умовах знеболювання .	проводяться	24	3
Годі й казати про те , що міські бюджети традиційно мають дуже багато нагальних статей витрат , через що грошей на аеропорти , які є не надто прибутковими , не вистачає .	мають	10	3
Мама сміється , брат і сестри обурюються і опираються : з якої радості вони будуть жертвами нашого з мамою флешмобу ?	опираються	8	3
Скликає Всенародні Збори і провадить ними Голова їх , вибраний Всенародніми Зборами .	Скликає	0	3
Ми наймаємо розумних і цілеспрямованих людей , але віддаємо перевагу здібностям над досвідом .	наймаємо	1	1
Відправлення , які за розмірами чи вагою перевищують допустимі обмеження , приймаються до перевезення лише за попередньою домовленістю Сторін .	приймаються	11	3
Який руйнівний вплив має на статеві взаємини неприємний запах з рота , бачимо вже в настановах Корану , де є цілий параграф , що дозволяє дружині розвестися зі своїм чоловіком , коли в того повсякчас смердить із рота .	бачимо	12	1
За роялем нижче сидить трамп з червоною краваткою на шиї .	сидить	3	3
Це на нього так впливає , як батіг впливає на рисака .	впливає	4	3
П’ять років над ними сидітиму , а таки зроблю .	зроблю	8	1
Нічого , нарубаю дров , зваримо щось їсти , а далі воно покаже .	зваримо	5	1
Скажіть , а Ви співатимете в храмі , чи просто неба ?	співатимете	4	2
— Братіки , голубчики , поможіть мені це дерево розколоть !	поможіть	5	2
Тоді рекомендуй злачні місця ?!	рекомендуй	1	2
То я їх тут солю , солю ! "	солю	6	1
Одержу — пришлю .	пришлю	2	1
Ось із цим відчуттям тут люди й живуть .	живуть	7	3
Шановному проф . Є . Тимченкові я радо висловлюю тут свою подяку за уваги до цього видання .	висловлюю	8	1
Не шелесне лист , не ворухнеться гілка .	ворухнеться	5	3
Обдеремо його і зі шкури пошиємо бочкори !	пошиємо	5	1
Приходить до неї , а вона йому каже :	Приходить	0	3
Сонячної пори дивуймося , хвалімо , високо цінімо його чесноти , у хмарний час байдужіймо до принадливостей і витягаймо на денне світло негативні риси .	хвалімо	4	1
Наведені завваги стосуються використання давньоукраїнських пам’яток як джерела відомостей про інновації в мові , а також того , як ці пам’ятки використовуватимуться у книзі надалі .	стосуються	2	3
Така найдавніша зміна може бути датована VI - VII ст . ( див . : 3 . 1 ) .	див	12	2
Не слухайте їх , а допомагайте серцем і ділом українському народові в його горю і нещастю і в його героїчній боротьбі !	слухайте	1	2
— Нема , — одказував Левко , блукаючи очима поверх золотого Марфиного волосся , що вибилося з-під чорної хустки .	Нема	1	3
— Я не хочу грошей , мені дайте яйце - райце !	хочу	3	1
Зціпить зуби , і мов пень гнилий .	Зціпить	0	3
( Далі див . передмову до " І знов я влізаю в танк ... " ) )	див	2	2
При повному зведенні клітора стане видно його голівку , що висунулася зі складок крайньої плоті .	стане	4	3
І ти знову сповнений сил і можеш з легкістю розгледіти можливості , які тебе оточують .	оточують	14	3
Вона зара в США живе .	живе	4	3
За кілометри звідси Міністерство Правди , місце його роботи , височіє немов біла й простора вежа посеред замурзаного краєвиду .	височіє	10	3
Тому я зараз створила такий свій світ , у якому зачиняюся зі своєю коханою людиною , і в якому нам затишно .	зачиняюся	10	1
А порівняння абсолютних доходів засвідчує , що український середній клас має дещо нижчий рівень життя , навіть якщо врахувати різну його вартість у двох країнах .	засвідчує	4	3
Шоб не муляло у флуді , і шоб не викинуте було ( флуд же чиститься ) , переніс сюди .	чиститься	14	3
І так мені руки потім засверблять , що , буває , ложки хлопцям ріжу на дозвіллі .	засверблять	5	3
Лише громадяне УНР користуються з усієї повноти громадянських і політичних прав , беруть участь в орудуванню державним і місцевим життям через активну і пасивну участь у виборах до законодатних установ і органів місцевого самоврядування .	користуються	3	3
- Візьми владу над світом .	Візьми	1	2
Там ви можете побачити що видання " в'язня Азкабану " готується на грудень 2017 року .	готується	10	3
— Як візьмеш мене за жінку , то я тобі все зроблю так , як змія казала .	зроблю	11	1
От замовлю собі багато - багато попкорну - і вболіватиму , чесно .	замовлю	1	1
Не виступайте , отже , проти Українських Повстанців , не стріляйте до нас , але єднайтесь з нами і допомагайте нам .	єднайтесь	15	2
День народження ближчає , а книги Гаррі Поттера від ілюстратора Джима Кея все нема :((	ближчає	2	3
Тепер експеримент , коли 50 % понадпланових надходжень митних зборів направляються на ремонт доріг , розповсюджуємо на всю Україну	розповсюджуємо	15	1
Коли ж стріваються двоє статевих ледарів , то обом кортить бути пещеними , а спокушати іншого ліньки .	кортить	9	3
Брудне та запилене волосся зліплюється масними стручками й видає гидкий запах несвіжого лою .	зліплюється	4	3
Все можливо , якщо віриш у себе !	віриш	4	2
Оскільки вони ідіоти , то Чужий не викликає аж такого жаху ; це раніше потвора хитромудро полювала за людиськами і щоразу більше лякала своєю кмітливістю , а тут Чужому вистачає просто відкрити рота і космонавти самі йому туди застрибнуть .	застрибнуть	38	3
Виловлені бродячі домашні тварини протягом п’яти днів з дня їх вилову утримуються на карантинних майданчиках служби або підприємства , що здійснює вилов , і можуть бути передані спеціалізованим організаціям за їх бажанням для передачі їх у спеціалізовані притулки .	здійснює	20	3
До моменту потрапляння їжі на корінь язика цей процес є довільним ( хочу — ковтну , а не хочу — ще пожую ) .	пожую	21	1
Найглибші шахти світу знаходяться в Індії ( шахта « Чемпіон - Риф » ) та в ПАР : « Тау-Тона » , « Вітватерсранд » ( глибина понад 4 , 5 км ) .	знаходяться	3	3
Він захищає тканини , розташовані глибше , а також регулює їхній обмін речовинами із зовнішнім та внутрішнім середовищем ( наприклад , газообмін , видалення продуктів обміну , всмоктування поживних речовин у кишечнику та ін . ) .	захищає	1	3
Розтовчеш у цеброві картоплю і замішаєш з грисом .	Розтовчеш	0	2
Після кожного серцебиття настає момент відпочинку , коли серцевий м’яз стає абсолютно нечутливий і нездатний приймати нервові подразники , що спонукають його до поновного скорочення .	спонукають	20	3
Це — отруєний ґрунт , на якому пліснявіє гнила слизота неокласики та росте тощий мох їхнього сонетового виробництва .	пліснявіє	7	3
Також , група СКМ , кінцевим бенефіціаром якої є бізнесмен Ринат Ахметов , заявляє , що її підприємства на тимчасово неконтрольованих територіях Донецької та Луганської областей будуть продовжувати працювати відповідно до законодавства України .	заявляє	13	3
7 вересня 1919 року вінчаються у Свято - Андріївській церкві .	вінчаються	4	3
Спочатку ви кажете що в Могилянці заборонений плагіат , а потім показуєте на Дні ФПвН сцену з тарганом !	показуєте	11	2
Бачиш , як вона до тебе світиться .	Бачиш	0	2
Але теж не одна з цієї ґенерації знає скільки труду її коштує вирватися зі свого Андромахівського родинного вогнища .	коштує	11	3
Хто має і бажає продати / віддати — пишіть у приват )	бажає	3	3
Половина вас нехай тягне в одну сторону , а половина тягне в другу , то воно й розколеться .	тягне	10	3
Посилання , яке модифікується під час копіювання формули , називають відносним .	називають	9	3
Обдеремо його і зі шкури пошиємо бочкори !	Обдеремо	0	1
Ці викиди завдають великої шкоди екосистемам водойм , виводять з ладу водопроводи , розносять мікроби , завдають значних матеріальних збитків .	завдають	16	3
Не підкажете , будь ласка , як скоро з`являться нові примірники ?	з`являться	8	3
Теперішні жінки , яких надихають дедалі більше урівноправлення з чоловіками , ширші можливості посісти донині неподільно чоловічі місця , в запалі разом з водою вихлюпують і дитину .	вихлюпують	24	3
Добре складається , коли чоловік з неабиякою вразливістю натрапляє на жінку заповзятливу , заводійську у пестощах , адже тоді одне одного доповнюють і статево вдовольняються обоє .	доповнюють	21	3
Ці рубрики повідомлять вам про основні питання , які розглядатимуться в параграфі , а також підкажуть , що потрібно пригадати з раніше вивченого .	повідомлять	2	3
Коли б я не прийшла надвечір , занесеш веприкові .	занесеш	7	2
— Не велика пані — сама перелізеш .	перелізеш	6	2
Так , відомості про товари кодують з використанням штрих - кодів ( мал . 1 . 2 ) .	кодують	5	3
Усі загинуть без вітця , без матері !	загинуть	1	3
Розвідка , кажете ?	кажете	2	2
Той підхід — статичний , або систематичний , — контрастує з динамічним , що застосовуватиметься в дальшому викладі .	застосовуватиметься	14	3
Після цього зануримо обидві руки в посудину з водою кімнатної температури і спробуємо за своїм відчуттям встановити , яка в ній вода — холодна чи гаряча .	спробуємо	12	1
Так , чуєш , не можна .	чуєш	2	2
— Тоді тебе визволю від пекла , зроблю щасливим та багатим , якщо візьмеш мене за жону .	визволю	3	1
Чи не знаходимо ми в наш час той самий прецедент ?	знаходимо	2	1
Як бачимо з попередніх міркувань , флірт — це один з найпотужніших статево - почуттєвих засобів , що підтримує тривкість кохання .	бачимо	1	1
Гнатіву поталанить : під час нелегального переходу кордону його заарештують японці .	заарештують	9	3
Чув він , коли вертається його дружинонька , як роздягається в темноті , розщіпає натягнену корсетку , думає про останній прощальний крадений поцілунок і всміхається до темноти ?	розщіпає	13	3
Через деякий час бутон опадає на землю разом з личинкою .	опадає	4	3
Вона хапає з Левкових пучок листа — сльози рясно котяться їй по щоках — пригортає його до грудей , цілує в зворотну адресу …	котяться	9	3
Ви стаєте цікавішими співрозмовниками для однолітків і дорослих , краще розумієте інших .	стаєте	1	2
Бузук у причини звукозмін теж не заглиблюється , але подає найважливіші з них у хронологічній послідовності .	заглиблюється	6	3
У разі придбання планів Office Для дому та навчання , Office Для дому та бізнесу чи Office Професійний , увійдіть до сторінки свого облікового запису Microsoft Store , зв’язаного з вашим замовленням , та встановіть Office .	встановіть	34	2
А по-третє , Ви тепер точно знаєте з ким маєте справу .	знаєте	6	2
Відкриття архівів і поновлення цензурних вилучень якнайочевидніше показує , що всі маніпуляції з академічним виданням робилися найперш задля поборення чи хоча б завуальовування двох страшних гріхів – буржуазного націоналізму та зловорожого модернізму .	показує	7	3
Коли Сосницький зривається згори й потім понуро сидить , мені стає нудно .	сидить	7	3
На пунктах переробки малину переробляють протягом восьми годин після приймання .	переробляють	4	3
Думають вони : що тут робити ?	Думають	0	3
Як матимемо намір і далі плекати почуття , це потім знадобиться .	матимемо	1	1
Відтоді націоналісти матимуть доступ до японських дипломатів , а за кілька років спробують налагодити ближчий контакт .	спробують	12	3
Можливо навіть що вони слідкують за всіма постійно .	слідкують	4	3
Пор . вище наведену цитату з Ch . Bally .	Пор	0	2
Проте Оксанки ти не зможеш замінити ніким іншим .	зможеш	4	2
На блокпосту « сепарів » спробуй таке ляпни ...	ляпни	7	2
У сусідських наймах не здобудеш тої повноцінної слави , якою винагороджують геніїв ; Антей мусить торкатися таки рідної землі , аби не втратити силу й обдарування .	здобудеш	4	2
Ця книжка , як підкреслює відповідна критика , « повна доброго патріотизму , гордого й чистого » .	підкреслює	4	3
Кодування широко використовується в сучасному житті для подання повідомлень у вигляді , що придатний для опрацювання не лише людиною , а й технічними пристроями .	використовується	2	3
Доречно підкреслити , що , коли подразнюємо ділянку клітора , слід видозмінювати дотикові подразники , бо якщо невпинно й одноманітно повторювати ті самі рухи , то це зменшує піднесення .	подразнюємо	6	1
А за запасами лікувальних мінеральних вод та їхньою різноманітністю цей регіон не поступається всесвітньо відомим курортам .	поступається	12	3
А фінанси , які тратимо на дрібний ремонт квартири це ніщо , в порівнянні з свободою дій ...	тратимо	4	1
І ось вимальовується інший клопіт .	вимальовується	2	3
— Сідай !	Сідай	1	2
Маю диплом біолога , 4 курси провчився на філологічному ...	Маю	0	1
Тому відомий рецепт сінгапурського прем’єра звучав так : « Посадіть трьох своїх найкращих друзів .	Посадіть	9	2
У твердих тілах міжмолекулярні сили проявляють себе як сили пружності при різноманітних деформаціях і зумовлюють міцність тіла .	зумовлюють	14	3
Він сідає рівніше , зачісує обома руками жовту гриву й гупа рукою по столі .	гупа	10	3
Дівчина мордувала кошеня ( дали 2 роки умовно ) - народ злиться бо мало ; Коломойський наєбав країну на 150 млрд - народ мовчить .	злиться	11	3
Він сказав собі : погляну на діло рук моїх !	погляну	4	1
Зберігайте результати роботи в хмарному сховищі OneDrive , щоб до них можна було отримати доступ звідусіль .	Зберігайте	0	2
Ну або уявимо , що мотузка розтягнута , і є сила пружності мотузки - і це доцентрова сила !	уявимо	2	1
Бангладеш та « Укроборонпром » домовляються про модернізацію « АНів »	домовляються	5	3
Така , як вишивають дівчата своїм нареченим , — і трьом мужчинам од того видива на мить заперло дух : сорочка світилася в тьмі як жива , вона хотіла бути вбраною не на смерть , а до шлюбу .	вишивають	3	3
Може , вона покличе свою душу назад , і тоді до мене хоч на хвильку прийде забуття .	покличе	3	3
Я не малюватиму вам щастя матері , коли тріснула перша шкарлупина і звідти почулось жалібне хлипання немовляти .	малюватиму	2	1
Відправлення , яке за своїми розмірами не поміщається до комірки поштомата , доставляється в найближче відділення .	поміщається	7	3
Більш детально питання походження української мови розглядаємо в 14 . 3 .	розглядаємо	6	1
У цих виконавців відчувається талант і харизма .	відчувається	3	3
Приймати з великою кількістю рідини , через 1 - 2 години після прийому їжі ( прийом одразу після їди призводить до подовження часу всмоктування ) .	призводить	19	3
А по-третє , Ви тепер точно знаєте з ким маєте справу .	маєте	9	2
Але Сосницький по камінчику , як Клапан , довбає і з усіх сил тримає себе , щоб не кинутись на неї з криком " ура " !	довбає	8	3
— Та й зоставайся , — каже , — дочко , будемо тут удвох жити .	зоставайся	3	2
борюся з цим : наприклад написав пісню ( з посвятою моїй першій викладачці англійської та її дочці ) , яку ми з групою тепер граємо !	борюся	0	1
А я ж добре знаю , що він закінчив перший курс біофаку заочно , а з другого його вигнали за " хвости " .	знаю	4	1
Після того як людина перехворіла на грип , у неї виробляється несприйнятність до цього різновиду вірусу грипу .	виробляється	10	3
У чоловіка сприйнятливість до збудливих дотиків міститься у ділянках , де пробігають чуттєві нервові волокна , що підходять до геніталій .	міститься	6	3
Теперішні жінки , яких надихають дедалі більше урівноправлення з чоловіками , ширші можливості посісти донині неподільно чоловічі місця , в запалі разом з водою вихлюпують і дитину .	надихають	4	3
Це спрощує виконання операцій з опрацювання повідомлень .	спрощує	1	3
Немає Мотрі спокою і в церкві : і там її не спускають з очей .	Немає	0	3
На блокпосту « сепарів » спробуй таке ляпни ...	спробуй	5	2
Почитавши ці рядки , ти , звичайно , не повіриш нам і скажеш : ви видаєте векселі , а де ваша ґарантія ?	скажеш	12	2
Ти завжди з зацікавленням стежиш за оголошеннями театрів — і напевно з жагою чекаєш побачити нову п'єсу автора " 97 " т . Куліша — " Народний Малахій " .	чекаєш	13	2
Так , так , я запропоную йому роботу .	запропоную	5	1
Жде - жде — батька нема .	нема	5	3
Марін Ле Пен , якій вдається поєднувати патріотичний пафос із московськими грошима , що зобов’язують її фактично працювати в інтересах недружньої до Франції зовнішньої сили , ідеально пасує до окресленої державної формації .	пасує	27	3
До того ж у Львівсько - Волинському вугільному басейні є ще й інші цінні хімічні речовини , які під час видобутку вугілля залишаються в надрах .	залишаються	22	3
Пошкоджує спочатку ранні сорти суниць , потім перелітає на пізніші , а потім перелітає на малину .	перелітає	13	3
в нас досі парусні яхти з бетону будуються тільки не залізо а скло замість арматури	будуються	7	3
Чи не дозволите Ви на той випадок скористатися якимсь із Ваших , присланих в машинковім письмі , оповідань ?	дозволите	2	2
Схопивши , озирається , біжить у куточок і там наминає свій маслачок .	озирається	2	3
— Не було такого ще ніколи , — засмучено розводить руками господар .	розводить	9	3
Оце ж уранці йдуть додому ; дійдуть до перелазу , то бабина дочка й каже дідовій :	йдуть	3	3
Коли повертаються до Києва , тут уже закріпилися радянські війська .	повертаються	1	3
Я промивав його рану і заразився тим ґатунком гепатиту , який подібно до сніду передається лише статево або через кров .	передається	14	3
Також вона згадала , що зелені насадження виконують захисну функцію від автошляху , а знищення дерев та будівництво АЗС чи автомийки ще більше псує екологічний стан міста .	псує	23	3
І , якщо ви вже маєте двох дітей , але не маєте доброї освіти , вам можуть ввечері подзвонити з поліції і нагадати про необхідність користуватися протизаплідними засобами .	маєте	11	2
Я фреш , але вже прочитав , що за одну " двійку " виганяють .	виганяють	13	3
Якщо ти ще там , то передавай привіт Вакулі )	передавай	6	2
Більше , ніж новини про перекриття частини Сагайдачного і 40 метрів ЯрВалу , мене радує тільки взривання пуканів водіїв , які впевнені , що місто існує тільки для їхніх гавнотачок	радує	14	3
« Я б і начхав , але друзі - юристи радять подавати позов , випробовуючи судову систему на захисті прав людини .	радять	10	3
Торкати , гладити чи , не дай Боже , цьомати таку голівоньку — ой як неприємно .	дай	6	2
Більше не хочу .	хочу	2	1
Ми вже два роки б'ємося з такою халтурою і вживаємо всіх сил , щоб дати для цього путящу книжку , де б не пахло ладаном , ні словоблудієм і де б ти міг знайти багато цікавих для себе речей .	вживаємо	9	1
Будь ласка .	Будь	0	2
Іноді для салатів використовую оливкову .	використовую	3	1
Нині ж — абсолютно без будь-якого попередження , анулюють договір на репортажі на УР ( під картинку з Євро ) .	анулюють	8	3
Хай живе воля , братерство і соціяльна справедливість усіх народів і усіх людей !	живе	1	3
Жолудь — це металева куля , яку затискається у кулаці .	затискається	7	3
Далі вона бере кожен з 5-ти елементів , і вставляє їх в дерево кожен в свій вузол .	вставляє	9	3
Я уявляв собі , що переживають померлі , чекаючи на нас .	переживають	5	3
Ще встигнемо наговоритись .	встигнемо	1	1
— Та це я , — каже , — прийшов до тебе просить конячки , нема чим і протопить , поїду в ліс та назбираю хмизу .	протопить	18	3
В цей час в ній знайде собі оборонця взагалі кожне курча , нехай воно навіть убереться вже в колодочки .	убереться	15	3
Усіма згаданими визначеннями аж в очу рябить читачеві багатьох монографій та статей .	рябить	6	3
Це явище , відоме як старіння населення , відбувається в усьому світі .	відбувається	8	3
У товстому кишечнику переважно всмоктуються вода та мінеральні речовини .	всмоктуються	4	3
— Помагай біг !	Помагай	1	2
Взагалі ж пароход гарний , чистий дуже , великий ( з трьома поверхами ) , — я тобі посилаю його портрет , що мені подарували на пароході ті моряки , що нас водили .	посилаю	18	1
— Йой , — відпрошується бідний , — душко , поможи мені .	відпрошується	4	3
Старшою стаєш , починаєш розбиратися у всьому цьому , і потім не знаєш , як дати раду своїм емоціям .	починаєш	3	2
А от в не обертальній інерційній системі відліку камінець матиме прискорення , і зазнаватиме зміни швидкості .	зазнаватиме	13	3
Може вона і жалілась , скажімо , на чоловіка - мамі , священику , подругам , - і почула " що поробиш , терпи , то треба терпіти " .	поробиш	21	2
Справа не лише в тому , що , записавшися в хор римського Мецената , співець зраджує свій край і свою мову .	зраджує	15	3
Якщо тобі набридли нудні пари , які не дають практичних знань , то з нами ти отримуєш купу корисної інформації , яку зможеш застосувати в будь-якій сфері життя !	отримуєш	16	2
Умовний рефлекс пускає корені і винищує найкоштовніші якості співжиття — почуття повної розрядки та радісної відпруги .	винищує	5	3
Ця думка й тепер держиться : « Самостійно й оригінально переживані інтуїції збуджують індивідуальну творчість стилістичну , але коли натрапляють на задубілі форми язикової експресії , вони мусять до них нахилитися .	мусять	27	3
До моменту потрапляння їжі на корінь язика цей процес є довільним ( хочу — ковтну , а не хочу — ще пожую ) .	хочу	12	1
1907 року той разом з її сином Лесем Курбасом їде навчатися у Віденський університет .	їде	9	3
Нема на світі людини , якій би це не подобалось , звісно , коли дивуються нею .	Нема	0	3
— Ви , — каже , — помагайте без сокири .	помагайте	7	2
Спробуємо пояснити його з точки зору молекулярно - кінетичного вчення про будову речовини .	Спробуємо	0	1
Піду світом , щастя пошукаю , бо як удома сидітиму , усі погинемо » .	Піду	0	1
Люблю я його дуже , але думаю , що для Парнасу йому не стає мови , а для масового читача він роблений і « холодний » .	Люблю	0	1
До моменту потрапляння їжі на корінь язика цей процес є довільним ( хочу — ковтну , а не хочу — ще пожую ) .	ковтну	14	1
Самі страшні бомжихи , сидите в протоптаному дивані і плюєтесь )	плюєтесь	9	2
Отже , я розповім вам про півня .	розповім	3	1
Автомобільний транспорт значно забруднює довкілля небезпечними вихлопними газами .	забруднює	3	3
Миритися з таким станом справ нізащо не згоджується : « [ … ] я ніколи не згоджуся вступитися з дороги перед усякими перевертнями і покутними борзописцями з чужої літератури , – dafűr ich bin mir doch zu gut !	згоджується	7	3
Старшою стаєш , починаєш розбиратися у всьому цьому , і потім не знаєш , як дати раду своїм емоціям .	стаєш	1	2
Сонячної пори дивуймося , хвалімо , високо цінімо його чесноти , у хмарний час байдужіймо до принадливостей і витягаймо на денне світло негативні риси .	байдужіймо	14	1
Настільки слабка музика , що стає соромно .	стає	5	3
Йдеться про генерацію на поки що ізольованій від решти країни Луганській ТЕС , яка в режимі енергоострова забезпечує підконтрольні Україні райони .	забезпечує	17	3
Не здивуюсь , якщо Дейнеріс влаштує республіку .	здивуюсь	1	1
Мама працювала в обласній дитячій лікарні і знала , що діти із зони поступають з адреси Івано-Франківськ , 17 , вулиця Авіаційна .	поступають	13	3
Водою зі шланга зверху поливаю , воно змивається вниз , на лоток , щоб потім піти на викинштейн .	змивається	7	3
Коли ведеться йому , може кинутись у воду й , рискуючи життям , рятувати другого .	ведеться	1	3
Скажіть , а Ви співатимете в храмі , чи просто неба ?	Скажіть	0	2
Калові маси періодично виводяться через анальний отвір назовні .	виводяться	3	3
Мама довго мовчить , потім зітхає і каже :	зітхає	5	3
Певна річ , це різновид особливо вишуканих пестощів , які більш годяться для досвідчених коханців .	годяться	11	3
– У її рамках пройдуть змагання бригад екстреної медичної допомоги з міжнародною участю « Сумські медичні ралі - 2017 » .	пройдуть	4	3
Тобто , може якийсь щось й подає , але це якось губиться серед міжпартійного суєтного бруду , що заполонив ефір .	губиться	11	3
Коли йдеться про доісторичну добу , головний матеріал дослідникові постачають українські діалекти та факти інших слов’янських мов , що досліджуються за допомогою порівняльного методу , а також аналіз запозичених українською мовою чужомовних слів .	йдеться	1	3
Хочу звернутися до всіх жителів гуртожитку на Троєщині , а саме на Марини Цвєтаєвої .	Хочу	0	1
Ми чекаємо на зустріч - адже дотик до видавця побачити Вашу радісну посмішку та потонути в чарах продукції - це спомин на багато років та добре щеплення поважати та цінувати свою країну ...	чекаємо	1	1
Візьму та й перекладу назло їм усі « Метаморфози » Овідієві .	Візьму	0	1
Добре складається , коли чоловік з неабиякою вразливістю натрапляє на жінку заповзятливу , заводійську у пестощах , адже тоді одне одного доповнюють і статево вдовольняються обоє .	натрапляє	8	3
А побіч , за столом із закусками , сидить оцей обгризений Нечипоренко .	сидить	8	3
Також в Центрі зберігається особиста бібліотека I . М . Гончара , що нараховує 2_750 книг .	нараховує	13	3
— Ну , Сосницький , давай у кумпанії ?	давай	5	2
Через 1 - 3 тижні після появи вузлів ( горбочків ) некротизована тканина легко відділяється або , підсихаючи , відпадає сама .	відділяється	14	3
Рятувальники просять не спалювати суху траву та чагарники .	просять	1	3
Я сказала , що обійдусь без чека .	обійдусь	4	1
І дописує ще кілька освіт після цього .	дописує	1	3
Розкажіть нам щось .	Розкажіть	0	2
Ще давніше він десь почув , що з бичачих пенісів роблять якісь дорогоцінні ліки .	роблять	10	3
Однак в уряді Лі Куан Ю прекрасно розуміли , що « європейську кашу » зі « східних інгредієнтів » не звариш .	звариш	20	2
Сучасна українська мова в її літературній формі має чимало фонетичних і морфонологічних рис , що виразно відрізняють її від сусідніх слов’янських мов .	відрізняють	16	3
— Принеси мене до своєї хати та годуй мене м'ясом доти , поки в мене крила повідростають .	повідростають	16	3
Ну а коли щось традиційно піде не так , то замість мінімізації збитків і збереження якомога більшої кількості життів від них можна чекати лише істерик і свідомого погіршення ситуації .	піде	5	3
Маю зізнатися , що коли я почула цю фразу вперше ( років в 15 ) , я надавала їй зовсім іншого значення .	Маю	0	1
Ждала вона , ждала , далі дума : « Піду подивлюсь , де він » .	подивлюсь	10	1
тепер сиджу , думаю , як він виглядає , цей паспорт ?	сиджу	1	1
Коли це приходить до кота лисичка та й питає його :	приходить	2	3
Нині Валентин Щербачов часто супроводжує команду ветеранів київського « Динамо » , а не так давно був з ними в зоні АТО .	супроводжує	4	3
— Йой , — відпрошується бідний , — душко , поможи мені .	поможи	10	2
дуже потрібно , дякую	дякую	3	1
Натомість сьогодні брехню породжують і обслуговують потужні індустрії , а відтак брехня чи напівправда стають радше правилом , ніж винятком .	стають	14	3
Коли станеться якась заворушка — казав він — то по Тарасові , якщо він загине офіцером , родина буде отримувати значно більшу пенсію .	станеться	1	3
Якщо вони зникнуть в Україні , то автоматично зникнуть і в Європі » , – наголошує Василюк .	зникнуть	8	3
Ми обов'язково вийдемо з Вами на зв'язок .	вийдемо	2	1
У чоловіка сприйнятливість до збудливих дотиків міститься у ділянках , де пробігають чуттєві нервові волокна , що підходять до геніталій .	підходять	17	3
Цілую міцно твою білу голову , а ти всіх поцілуй .	поцілуй	9	2
З неперетравлених решток їжі формуються калові маси , які містять шкідливі для організму речовини .	містять	9	3
Засоби фізичного впливу не діють , штрафи не діють , кілька діб у буцегарні не подіяли .	діють	4	3
Або Гнат стриножить свою брикливу жінку , і вона сидітиме дома та працюватиме , або хай собі під ( енергійно ) три чорти вибирається з хати !	вибирається	23	3
– Ах , ви не знаєте .	знаєте	5	2
Ритми колишуться , барабан здригається .	здригається	4	3
Ребра з хребцями з'єднуються таким чином : дві пів'ямки сусідніх хребців утворюють ямку , куди заходить головка ребра .	утворюють	11	3
У такому разі годиться і плескати , і скубти .	годиться	3	3
Насамкінець маю сказати , що триптих із босхівської майстерні справді є лише однією із загадкових « копій » в експозиції Музею Ханенків .	маю	1	1
Я просто сама собі заздрю !	заздрю	4	1
Прокинувся злий дух і покликнув : « Лихі сни мучать мене !	мучать	9	3
Спочатку розвага , словесний двобій пори , коли народжуються почуття , далі він поступово обертається на правила гри , які обумовлюють мало не саме́ буття цього кохання .	народжуються	8	3
« Дуже важлива солідарна позиція країн ЄС , вже висловлена лідерами Німеччини , Франції , Великої Британії , що санкції мають тривати до повного виконання Мінських угод , тобто , до повернення Україною контролю над кордоном .	мають	20	3
Якщо хтось не співає і не світить оголеним тілом в кліпі , то , можливо , він рятує чиєсь життя ?	співає	3	3
Ця думка й тепер держиться : « Самостійно й оригінально переживані інтуїції збуджують індивідуальну творчість стилістичну , але коли натрапляють на задубілі форми язикової експресії , вони мусять до них нахилитися .	натрапляють	19	3
І це не вийде списати на затупи і зриви в екстреній ситуації , мовляв , герої фільму також люди .	вийде	3	3
Негр витягає в повітря підборіддя і знов утягає його , як робить це качка в любовному екстазі .	витягає	1	3
Загадай дівчатам зробити ще бант — чорний з червоним , тут , у інституті , такий висить на портреті , дуже красиво .	Загадай	0	2
Цей момент для мене дуже відповідальний , бо в ньому наче сходяться різні лінії мого життя .	сходяться	11	3
На закриття ралі очікується приїзд в . о . Міністра охорони здоров’я України Уляни СУПРУН .	очікується	3	3
Тож деякі сучасні систематики вказують прийнятою назвою цього виду Cyanus segetum Hill , а Centaurea cyanus вказують як синонім , водночас , інші вказують прийнятою назвою Centaurea cyanus , а Cyanus segetum вказують — синонімом .	вказують	23	3
У першому випадку це може призвести до того , що навчальний процес залишиться без викладача , якого замінити ніким .	залишиться	12	3
— А тихо ти там будеш , дурню якийсь !..	будеш	5	2
Вітаємо в команді « Сушия » !	Вітаємо	0	1
Приблизно 50 % всього рекламують Джамала і Олександр Усік .	рекламують	4	3
Точки розповсюдження повідомлю додатково .	повідомлю	2	1
Увіходить чоловік у хату , а вони йому кажуть :	Увіходить	0	3
Їх ні з ким не переплутаєш .	переплутаєш	5	2
Офіційно сподіваємось випустити гру у вівторок , 18 жовтня , тим часом оформити передзамовлення за собівартістю можна в мене через особисті повідомлення — Вам це вийде дешевше , а ми точно знатимемо розміри першої партії .	сподіваємось	1	1
— Ми , — кажуть , — злидні .	кажуть	4	3
— Зроби мені троє діл та й підеш собі додому , а як не зробиш , то я тебе з'їм !	Зроби	1	2
Прибігає зайчик назад та й хвалиться :	хвалиться	5	3
Як він зм’якне , скориться , зробиться дуже люб’язним , тоді знов неждано обертаймося обличчям , вертаючи і ніжність , і захоплення , і сонячні дні .	скориться	4	3
Наклад книжки 240 примірників , і ви навряд чи десь її знайдете .	знайдете	11	2
А новий TUC зі смаком « Копчені ковбаски » додасть пригодам вогню .	додасть	9	3
Насправді , цій державі значно більше підходить визначення « поліцейська » , а не демократична .	підходить	6	3
Днями в одному ( інтернаціональному ) товаристві довелося стати свідком дискусії - а чи знала ж американська розвідка , що Росія готує війну проти України ?	готує	21	3
Загадай дівчатам зробити ще бант — чорний з червоним , тут , у інституті , такий висить на портреті , дуже красиво .	висить	16	3
Усні повідомлення записують на папері , замінюючи звуки людської мови літерами алфавіту .	записують	2	3
І ненавидить .	ненавидить	1	3
Наприклад , зануримо на кілька хвилин одну руку в гарячу воду , іншу зануримо — в холодну .	зануримо	2	1
В цілому я зараз його не уявляю , але окремі описи в ньому люблю і перечитую завжди .	уявляю	6	1
Хай не гнівається ( скажіть йому ) , що я не прислав рецензії на Дорошкевича .	скажіть	4	2
При дресируванні тварин не допускається : нанесення тваринам побоїв , залякування , видалення кликів , кігтів тощо ; примушування тварин до виконання дій , що їх травмують .	травмують	26	3
Мене дуже хвилює , що відбувається назовні .	хвилює	2	3
Ви ж самі розумієте , що робиться з браконьєром , коли він почує " стій ! "	робиться	6	3
До речі , як друкуватиметься « Живем комуною » ?	друкуватиметься	4	3
Як він зм’якне , скориться , зробиться дуже люб’язним , тоді знов неждано обертаймося обличчям , вертаючи і ніжність , і захоплення , і сонячні дні .	обертаймося	13	1
Він ізнов іде до того стовпа та й плаче .	плаче	8	3
Знаєте скількі коштує повія з таким тілом зараз ?	Знаєте	0	2
З усім цим уживаються ноутбук і плазмовий телевізор …	уживаються	3	3
— Я з ним прийду , але ви поховайтесь , бо він вас розірве .	поховайтесь	8	2
Чим відрізняється залік від іспиту ?	відрізняється	1	3
— А скажіть , а чи там аеродромів багато , га ? — миттю запитав хтось жваво , голосно і з надзвичайним інтересом .	скажіть	2	2
Показує позитивну динаміку й експорт з України іншої солодкої продукції .	Показує	0	3
Як же вони стільки курей общипують ?	общипують	5	3
Де головний елемент фразеологічного звороту повторюється в багатьох фразеологічних зворотах , там він може стати за головний елемент і до нових фразеологічних зворотів .	повторюється	5	3
Всі вони однакові , і ті , що УНР будували , і ті , що до УСРР зараз примазуються .	примазуються	18	3
Це засмучує .	засмучує	1	3
Процес згортання проходить через серію послідовних кроків , протягом яких змінюються оптичні властивості білка , весь процес у випадку GFP дикого типу займає біля 30 - 40 хвилин і називається « дозріванням » білка .	змінюються	10	3
Як зазначає Б . Вербер : « Сінгапур – держава демократична , але для того , щоб громадяни не голосували як попало , на виборчому бюлетені пишеться номер картки виборця » .	зазначає	1	3
Не виступайте , отже , проти Українських Повстанців , не стріляйте до нас , але єднайтесь з нами і допомагайте нам .	допомагайте	19	2
Розтовчеш у цеброві картоплю і замішаєш з грисом .	замішаєш	5	2
Ми не допустимо , щоб про нас люди таке говорили …	допустимо	2	1
Але тепер вона , може , дедалі набереться одваги , бо вона ж « гімназист » .	набереться	7	3
Наведені вище пестощі мають подвійне значення , бо справляють приємність та збуджують також і жінку , що відчуває , як унаслідок її пестощів підводиться , надимається і готується до акту чоловічий прутень .	підводиться	23	3
Я могла б тобі допомогти , айбо і так не допоможу !	допоможу	10	1
Нічого , нарубаю дров , зваримо щось їсти , а далі воно покаже .	покаже	12	3
Французи люблять , раптом що не так , виходити на демонстрації .	люблять	1	3
Завдяки скороченням м’язів стінок товстого кишечнику вони просуваються до прямої кишки , де накопичуються .	накопичуються	13	3
Без цих слів я « Живем комуною » не згодився б друкувати .	Живем	5	1
Ваша влада над ритмами росте невпинно , а таких речей , як перша поезія з « Плачу Ярославни » , як « Осінь » , як « Живем комуною » , в « Плузі » нема .	росте	4	3
При збільшенні якості обробки поверхні тертя зменшується .	зменшується	6	3
Коли ж стріваються двоє статевих ледарів , то обом кортить бути пещеними , а спокушати іншого ліньки .	стріваються	2	3
Фінляндія розписує внутрішню позику у сумі 2-ох міліярдів марок під кличем : " Позика для батьківщини " .	розписує	1	3
Дома мене стрічає мама , радіє , плаче і підставляє мені для поцілунку сині губи .	радіє	5	3
Тоді побачите , що чоловіча природа відтоді аніскілечки не помінялась і що у давніх смішних рекомендаціях міститься чимало правди .	міститься	16	3
Для символів , що зустрічаються рідше , буде використано чотири двійкових цифри або 4 біти .	зустрічаються	4	3
— Лисичко - сестричко , прийду я до тебе на досвітки .	прийду	5	1
Як він зм’якне , скориться , зробиться дуже люб’язним , тоді знов неждано обертаймося обличчям , вертаючи і ніжність , і захоплення , і сонячні дні .	зробиться	6	3
Але це не працює , тому що визначення структури ще не приводить до створення об’єкту .	працює	3	3
Нулі та 1 « з поведения » ставлять часто , але й зачеркують хутко , і ніхто того особливо не боїться , хоч не раз « для годиться » плачуть і просять зачеркнути .	зачеркують	12	3
Аби пояснити , що означає цей термін , проведу аналогію зі скорочувальною функцією серця .	означає	4	3
Лише громадяне УНР користуються з усієї повноти громадянських і політичних прав , беруть участь в орудуванню державним і місцевим життям через активну і пасивну участь у виборах до законодатних установ і органів місцевого самоврядування .	беруть	12	3
Відправлення , яке за своїми розмірами не поміщається до комірки поштомата , доставляється в найближче відділення .	доставляється	12	3
Повідомляється , що за даним фактом слідчим відділом Оболонського управління поліції розпочато кримінальне провадження за ч . 1 ст . 119 ( Вбивство через необережність ) Кримінального кодексу України .	Повідомляється	0	3
Утворюється суглоб головки ребра ( плоский ) .	Утворюється	0	3
Більше чекаю на баржу з кавунами , ніж на повідомлення про зарахування на бюджет .	чекаю	1	1
Я як крикну :	крикну	2	1
Ну , я тебе зроблю річкою , а сама зроблюсь рибою - окунем .	зроблюсь	9	1
— Що , волієш по гривеничку зароблять ?	волієш	3	2
Вулиці Відня та тепла погода надихають на гарні думки , прогуляйтесь зі мною ;)	надихають	5	3
Частенько відвідую сайти знайомств , так от 70 % жінок там , з байстрюками .	відвідую	1	1
То я їх тут солю , солю ! "	солю	4	1
Називайте як хочете — але якщо у вас є щось , що таки можна так назвати — напишіть мені , будь ласка .	Називайте	0	2
Ждала вона , ждала , далі дума : « Піду подивлюсь , де він » .	Піду	9	1
Душа моя рветься , нема мені спокою !	нема	4	3
Але вони могли обрати навмання і смикнути саме за твій ляльковий дріт у будь-який час коли вони цього забажають .	забажають	18	3
" Пошуршимо ? " - це територія натхнення , гарного планування та розвитку .	Пошуршимо	1	1
Він усміхається їй , щось тюрлюрлюкає голосом у такт фокстротові і , підкинувши догори палиці , обриває все .	тюрлюрлюкає	5	3
Можливо , зганяємо в Карпати , хочу долучитись до друзів у похід :)	хочу	6	1
Біжи вдруге за ними , та щоб доконче розірвав !	Біжи	0	2
Старіння нації негативно впливає на розвиток господарства , адже частка працездатного населення зменшується , водночас збільшується навантаження на нього через велику кількість людей пенсійного віку , яких треба утримувати .	збільшується	15	3
Про них майже нічого не знаю та і не хочу знати .	знаю	5	1
Як бачимо з попередніх міркувань , флірт — це один з найпотужніших статево - почуттєвих засобів , що підтримує тривкість кохання .	підтримує	18	3
☀ Під гаслом неформальної освіти ми впроваджуємо зміни в українському суспільстві та культивуємо активний відпочинок для молоді .	впроваджуємо	6	1
Спочатку ви кажете що в Могилянці заборонений плагіат , а потім показуєте на Дні ФПвН сцену з тарганом !	кажете	2	2
Аби пояснити , що означає цей термін , проведу аналогію зі скорочувальною функцією серця .	проведу	8	1
— Живемо поряд з фірмою « Гаврилівські курчата » .	Живемо	1	1
Чоловік заглянув у вікно : лампа світить і вогонь горить , аж іскри розлітаються , начеб якась невидима сила гребла грань у пічці .	світить	6	3
І навіть як йду з гостей від батьків , кажу , що йду додому ..	йду	12	1
Спробуй її ще знайти , ту вільшечку !..	Спробуй	0	2
Театр націоналізують .	націоналізують	1	3
Можливо , вам здасться дивним , але в житті я майже не слухаю попсу .	слухаю	12	1
Дівчина виходить із нори та й питається його :	виходить	1	3
— Зробити таку машину прикортіло весною , — тим часом розказує Володя .	розказує	10	3
Цей зелений рай триває майже до листопада .	триває	3	3
Для початку маємо дві колоди — “ Стару ” та “ Нову ” , які потім , якщо все піде добре , будемо доповнювати новими картами , скажімо , до днів факультету .	скажімо	27	1
І , зокрема , показували великим планом пологи - розкинуті ноги , все відкрито , дитинка вискакує з лона ...	вискакує	16	3
Навесні , в кінці квітня — на початку травня , виходять з місць зимівлі і живляться молодими листочками , бутонами , черешками листків .	виходять	10	3
Там до них зараховують 58 % домогосподарств , які мають на члена сім’ї від € 7 , 2 тис . до € 15 , 3 тис . на рік .	зараховують	3	3
Шлункова фаза соковиділення забезпечується не лише за рахунок нервової системи .	забезпечується	3	3
То хоч зробіть їх зручного для користування розміру , шарлатани з пригодованих видавництв !	зробіть	2	2
Шукаю попутника для автостопу з Києва чи Київської області .	Шукаю	0	1
Або рекламуєш .	рекламуєш	1	2
А що ми бачимо насправді ?	бачимо	3	1
Словом , дупа свербить .	свербить	3	3
— Та це я , — каже , — прийшов до тебе просить конячки , нема чим і протопить , поїду в ліс та назбираю хмизу .	поїду	20	1
— Чи чули ?.. — питає молодиця другу , стрівши на улиці .	питає	5	3
Так , наприклад , для кодування у Windows - 1251 попереднього речення , яке містить 114 символів , включаючи пробіли , необхідно використати 1 байт даних на кожен символ , або 114 байтів .	містить	14	3
Добре складається , коли чоловік з неабиякою вразливістю натрапляє на жінку заповзятливу , заводійську у пестощах , адже тоді одне одного доповнюють і статево вдовольняються обоє .	складається	1	3
Ведучи мову про дотикові пестощі геніталій , не оминути чоловіка , у якого саме у цій частині тіла зосереджуються статево чутливі рецептори .	зосереджуються	18	3
легко говорити радійте всі життю , воно таке хороше і прекрасне , коли в тебе все добре і ти здорова і не помираєш ...	помираєш	22	2
І солить слимаків , нападає на лгбт , вірить у світову змову .	вірить	8	3
Фінансова система України залишається чи не найбільш уразливим місцем у державі : попри заяви очільниці НБУ про « очищення » банківської сфери , у нас продовжується « банкопад » , не створено умов для відновлення кредитування реального сектору економіки .	продовжується	25	3
Так , скажуть нам , але ж живуть на світі ще й досі неокласичні форми !	живуть	7	3
Де можна побачити інформацію : які саме дитячі майданчики плануються ?	плануються	9	3
Голова Національного банку не виключає , що може залишити цю посаду .	виключає	4	3
Якщо можете допоможіть і підкажіть , що я маю робити	допоможіть	2	2
Не підкажете , будь ласка , як скоро з`являться нові примірники ?	підкажете	1	2
Дзядзьо тим часом стукав якимось патиком у стелю , бо думав , що тамтешні діти їздять серед ночі на ровері , а мама питалася у брата , нащо він трясе ліжком .	трясе	29	3
Наприклад , зануримо на кілька хвилин одну руку в гарячу воду , іншу зануримо — в холодну .	зануримо	13	1
Я не маю для цього гідних барв .	маю	2	1
І видно всі сузір'я , всі туманності , які падають , падають на тебе	падають	11	3
А він усміхається й гадає , що сам іде , " сам іде " !	гадає	4	3
Сонячної пори дивуймося , хвалімо , високо цінімо його чесноти , у хмарний час байдужіймо до принадливостей і витягаймо на денне світло негативні риси .	цінімо	7	1
Оскільки вони безликі , то їхні смерті не викликають жодного ефекту ( хіба що режисер скрімер поставить ) .	поставить	16	3
У кінці серії « Той , що летить над усім » показано 271-шу поему зі збірки Вітмена « Листя трави » , книги , яка займає важливу нішу у серіалі .	займає	25	3
А баба продовжує :	продовжує	2	3
Правда , коректив був в особі моєї матері та в листах дядька Драгоманова , якого вважаю своїм учителем , бо дуже багато завдячую йому в моїх поглядах на науку , релігію , громадське життя і т . і .	вважаю	15	1
( Далі див . передмову до " І знов я влізаю в танк ... " ) )	влізаю	10	1
Дебата буде , розуміється , при закритих дверях .	розуміється	3	3
От вона вийшла та й гукає :	гукає	5	3
Залозистий епітелій ( мал . 5 , 3 ) входить до складу залоз і виконує секреторну функцію , синтезуючи потрібні організму речовини — секрети .	виконує	14	3
Були би тоді " сили інерції " , адже тоді , ти навіть не зміг би знати , чи ти крутишся .	крутишся	20	2
Прибігаємо в село , помітили в яку хату він ускочив .	Прибігаємо	0	1
Він , недбало розсівшись , ставить малесенькі ставки , — його не обходить гора .	ставить	5	3
А щелепи йому десь аж корчить , і хочеться кинутись , виючи , на їжу й обома руками пхати її в себе , сопучи та здригуючись від насолоди .	корчить	5	3
Відмотуємо , дитинка вертається .	Відмотуємо	0	1
І хочу також подякувати вам за чудову трилогію про джур : мій 10-річний син з минулої осені перечитав її тричі та називає Рутківського своїм улюбленим письменником :)	хочу	1	1
Раптом ці звуки перериває вступний брязкіт литаври , що , завмираючи , подає голос од натискування ноги .	перериває	3	3
Ми вимикаємо телефони , не дивимося новини , не обговорюємо їх , не сваримося .	сваримося	13	1
Допоможу , якщо вчиниш те , що накажу .	накажу	7	1
Звичайно , у піднесенні статевих чарів багато значать штучні , ро́блені запахи , але не забуваймо , що вони не повинні “ забивати ” власних , природних запахів .	значать	7	3
Показово , що групи в соціальних мережах , які поширюють заклики до масових заворушень на річницю Революції Гідності , адмініструються з Москви	адмініструються	19	3
Доводить до столу , а він побачив , що на столі існує м'яса багато , та й каже :	Доводить	0	3
— Зроби мені троє діл та й підеш собі додому , а як не зробиш , то я тебе з'їм !	зробиш	14	2
Барабан крутиться , пір'я за них чіпляється і вилазить .	чіпляється	6	3
Зараз прийде із пекла мій син і візьме тебе в руки .	візьме	7	3
Попри те що більшість британців не приймають поглядів і політики нового президента США , Мей звернулася до колеги з теплими словами .	приймають	6	3
З часом по краях вузлів ( горбочків ) епідерміс відділяється , а в центрі тканина некротизується з утворенням характерної впадини з валиком із грануляційної тканини розміром 1 - 3 мм навколо неї .	відділяється	9	3
Не зроблю я , так і лишається незроблене .	зроблю	1	1
якщо , наприклад , одна дівчина матиме вужчий таз , то чи означатиме це , що бігати вона буде швидше за ту , що матиме ширший таз ?	означатиме	12	3
Ми граємо цілу добу .	граємо	1	1
Маємо , приміром , іще версію « Старого у східному вбранні » .	Маємо	0	1
Дайте я його хоч у руках подержу …	подержу	6	1
Газетний звіт про свій реферат прикладаю .	прикладаю	5	1
І , якщо ви вже маєте двох дітей , але не маєте доброї освіти , вам можуть ввечері подзвонити з поліції і нагадати про необхідність користуватися протизаплідними засобами .	маєте	5	2
— Я не хочу їм здаватися .	хочу	3	1
Пишемо - вискакує .	Пишемо	0	1
Коли голод затьмарює твій погляд , ти просто береш TUC .	береш	8	2
Збирають ягоди вручну і складають у невеликі плетені кошики , в яких і транспортують до місць переробки чи споживання .	транспортують	13	3
Нетішинське водосховище ( Ставок - охолоджувач Хмельницької АЕС ) створене у 1986 році на річці Гнилий Ріг яка впадає в Горинь .	впадає	18	3
Ще тобі колись про їх звичаї напишу , коли цікаво , а тепер вже годі , лист і так довгий .	напишу	6	1
Ви знаєте за що і вони знають за що » .	знаєте	1	2
Господи , — майже крикнула , — та чи ж ви не розумієте , що його ви не вб’єте ?	вб’єте	18	2
Ми не зупиняємося докладно на слідах турецького будівництва або будівництва пізньої татарської доби .	зупиняємося	2	1
Виїмок творять признані законом за безумних або божевільних , котрі находяться під опікою .	находяться	10	3
Ви знаєте , що для того , щоб швидко щось знайти у сховищі даних , потрібно ці дані упорядковано зберігати .	знаєте	1	2
Ці рубрики повідомлять вам про основні питання , які розглядатимуться в параграфі , а також підкажуть , що потрібно пригадати з раніше вивченого .	розглядатимуться	9	3
Приходить той чоловік до брата та й стоїть , бідний .	Приходить	0	3
Коли це приходить до кота лисичка та й питає його :	питає	8	3
Жодна емансипація не здатна вплинути на те , що жінка — мати і народжує дітей , й у своїм материнстві та вихованні дитини потребу́є чоловічого піклування .	потребу́є	23	3
Думаю , дітей потрібно так виховувати , щоб давати їм розуміння , і усвідомлення того , де є погане , а де хороше , бо про великий відсоток самовиховання , саморозвитку теж не можна забувати .	Думаю	0	1
Але щойно їжа потрапляє на корінь язика і подразнює його рецептори , нервові імпульси відразу надходять до центру ковтання , розташованого у відповідному відділі головного мозку , і виникає рефлекс ковтання .	надходять	15	3
Гнат не питає , куди вона йде .	питає	2	3
А тепер то ще й не те зроблю .	зроблю	7	1
— Дай я тобі , сестричко , починки подержу , поки ти перелізеш !	Дай	1	2
Пам'ятайте , що ми , Українські Повстанці , боремося за найвищі і найшляхетніші вселюдські ідеали свободи , братерства і рівноправности всіх народів , ми боремося за національне і соціальне визволення , рівність і справедливість кожнього народу і кожньої людини !	Пам'ятайте	0	2
Ти не дуже сердишся , що я тобі не хутко відповідаю ?	сердишся	3	2
Вони й почали ховатися : ведмідь лізе на дерево , вовк сідає за кущем , кабан заривається у хмиз , а зайчик лізе в кущ .	лізе	22	3
Шановна " А-ба-ба ... " , чи плануєте випустити оновлене видання " Фантастичних звірів " Ролінґ з додатковою інформацією про 6 нових звірят , новою передмовою Ньюта та новими ілюстраціями ?	плануєте	7	2
Як він зм’якне , скориться , зробиться дуже люб’язним , тоді знов неждано обертаймося обличчям , вертаючи і ніжність , і захоплення , і сонячні дні .	зм’якне	2	3
Нині в багатьох розвинутих державах очікувана тривалість життя перевищує 80 років .	перевищує	8	3
— Збирайся ж , дочко , та й ходім , — каже дід .	ходім	8	1
Я веду до того , що так , можливо ширина тазу і впливає , але ми могли б сказати , що це є основним фактором при всіх інших рівних “ дано ” .	веду	1	1
Освітня станція 31В1 шукає ініціативні спільноти : з 15 липня по 15 вересня ви можете провести будь-яку подію та захід на прохолодній терасі в центрі Києва .	можете	14	2
Це , власне , слова - каменюки , що ними , завівшись і не втримавши язика на припоні , силкуються болісно вдарити одне одного .	силкуються	19	3
Неважливо , чоловік чи жінка , чорний чи білий , християнин чи атеїст , сім’янин чи самотній — ці всі характеристики відсуваються на задній план , бо космонавтам слід однаково тверезо мислити і тримати емоції під контролем .	відсуваються	21	3
Саме цей феномен спостерігався в розділених родинах , частина яких живе в Україні , а частина живе – в Росії .	живе	10	3
— Лягай же тепер спати , а завтра рано щоб устав та понесеш змії паляницю .	Лягай	1	2
Скажеш інерція ?	Скажеш	0	2
А на Заході , як відомо , середній клас виокремлюють не так за номінальним доходом , як відносно доходів решти .	виокремлюють	9	3
І видно всі сузір'я , всі туманності , які падають , падають на тебе	падають	9	3
Люблю я його дуже , але думаю , що для Парнасу йому не стає мови , а для масового читача він роблений і « холодний » .	стає	13	3
Нате вам осьо , вип’єте за його здоров’я .	вип’єте	4	2
Далі зазначується , що жінка має дбати про « фізичне збереження раси » .	зазначується	1	3
Особисто я вибираю і п'ю пиво в залежності від настрою , а на певній одній торгівельній марці не зупиняюсь - в кожній є своє улюблене : Львівське світле , Чернігівське біле , Славутич Ice , Оболонь біле ...	п'ю	4	1
Веземо з собою нещипаного півня ( по дорозі заїхали в село Феськівку , купили у господаря .	Веземо	0	1
Та як буде питаться тебе , чи не бачив парубка й дівки , чи не йшли сюди , то ти скажеш , що тоді , як ця пшениця сіялась .	скажеш	20	2
Вона не так додає ваги ударові , як формує найефективнішу структуру самого кулака .	формує	8	3
Втікай до лиха один з другим , бо москалі вас видушать , як рудих мишей .	Втікай	0	2
Юліє , не вигадуйте .	вигадуйте	3	2
— Він врятується , — сказала вона ; в голосі їй дзвеніли істеричні нотки : — Він вислизне , він хитрий .	вислизне	17	3
Якщо там значиться “ pasterizant ” , значить , практично всі дріжджові клітини й бактерії в ньому вбиті .	значиться	2	3
Нулі та 1 « з поведения » ставлять часто , але й зачеркують хутко , і ніхто того особливо не боїться , хоч не раз « для годиться » плачуть і просять зачеркнути .	ставлять	7	3
Чи у вас СВ залежить від точки ?	залежить	4	3
У людей очі дивляться , а баньки в браконьєра - бігають .	бігають	10	3
Проголошуй свою промову до мужиків , як може робити це Жан , мужик , що добре поснідав кашею .	Проголошуй	0	2
" Підтримую військових і дякую українським воїнам за захист нашої свободи , територіальної цілісності та суверенітету ! " - написала Гопко .	дякую	4	1
Гнат наскоро робить з комори ( що через сіни ) хату , ставить стола , лави , стільці , чіпляє в куті кілька образів і перебирається з Марією на самостійне господарювання .	ставить	12	3
смак страв порівнюється лише з тими , що приготовлені у мурованих грубках .	порівнюється	2	3
— Тепер ми вже не біймось !	біймось	5	1
Легесенько надушуємо волосся на потилиці та за вухами , щоб , коли притуляємося та зближуємо голови , випромінювався запах .	зближуємо	14	1
Будь ласка , заповніть анкету або завантажте своє резюме .	заповніть	3	2
І здається , що він сидить тут для того , щоб дочекатись , коли пан увільниться й дасть йому інструкції .	увільниться	15	3
Не любите гуляти – до ваших послуг затишні столики в сотнях різних класних закладів ( ті ж - таки друзі з гуртожитку стануть вам найповнішим сітігайдом найкращими і при цьому підйомними для студентського бюджету кнайпами ) .	стануть	22	3
Ваша влада над ритмами росте невпинно , а таких речей , як перша поезія з « Плачу Ярославни » , як « Осінь » , як « Живем комуною » , в « Плузі » нема .	Живем	27	1
Дівчата - товаришки її люблять і часто дають їй чого їсти — такого , що з дому приносять .	приносять	17	3
Пиши мені про все , може , на Різдво приїду .	Пиши	0	2
Про це повідомляє Український гідрометцентр .	повідомляє	2	3
Вона хапає з Левкових пучок листа — сльози рясно котяться їй по щоках — пригортає його до грудей , цілує в зворотну адресу …	хапає	1	3
Не суди мене гірко .	суди	1	2
Це означає повернення земельних ділянок у той стан , коли їх можна використовувати у сільському господарстві , для лісових насаджень , будівництва , створення штучних ландшафтів , що доповнюють природні .	доповнюють	28	3
Ачей , мене не вб’ють , а як будуть бити , то і я маю сокиру !	маю	14	1
Нагадуємо , Аушвіц - один із найбільших концентраційних таборів нацистської Німеччини , який розташували на території Польщі ( біля м . Освенцим ) впродовж 1940 - 1945 рр .	Нагадуємо	0	1
Каже що це її бентежитиме ...	Каже	0	3
А тепер розказуйте …	розказуйте	2	2
Американські слідчі сподіваються переконати Пола Манафорта , екс-керівника передвиборчої кампанії президента США Дональда Трампа , співпрацювати з ними у розслідуванні можливої змови між штабом Трампа і Росією .	сподіваються	2	3
- Приїздіть , - просить , - та й приїздіть до нас у Дзвонкове пополювати .	приїздіть	9	2
Також в Центрі зберігається особиста бібліотека I . М . Гончара , що нараховує 2_750 книг .	зберігається	3	3
Людоньки , хто слухає основи літ . творчості , підкажіть будь ласка дз на понеділок .	будь	10	2
Проте , окрім порушення природоохоронних норм , протягом восьми років дельфінарій функціонує з порушенням законодавства у сфері містобудівної діяльності .	функціонує	11	3
Він тихо гладив їй волосся , сам погноблений чуттям , що лишає по собі пустиню .	лишає	11	3
Розглядає , ходить чоловік по хаті , але ніде немає живої душі !	Розглядає	0	3
Я налічила 6 великих яхт і 18 менших , а три великі пароходи стоять увесь час напроти нас нерухомо і щовечора наводять світло електричне на Сан-Ремо .	наводять	21	3
Ці рубрики повідомлять вам про основні питання , які розглядатимуться в параграфі , а також підкажуть , що потрібно пригадати з раніше вивченого .	підкажуть	15	3
Люблю старі фільми , романси .	Люблю	0	1
— Ви мусите жити .	мусите	2	2
Ми гордо заявляємо , що ми некомерційна , не корпоративна і не скомпрометована організація .	заявляємо	2	1
— Нема що робити , журбою не поможеш !	Нема	1	3
Припинивши співпрацю з японцями , оунівці інтегруються в українське життя Харбіна .	інтегруються	6	3
Їх цікавлять лише потужні пасажиропотоки , чим Україна наразі похвалитися не може » , — каже авіаційний експерт Богдан Долінце .	цікавлять	1	3
Я думала , що всі яхти стають перше в ряд , а потім переганяються наввипередки , тим часом вони всі роблять круги по морю навколо різних значків , і котра більше кругів зробить в призначений час , та виграє .	зробить	32	3
Отже , в Україні також відбувається старіння населення .	відбувається	5	3
Господи ! і за що ти мене отак караєш на сім світі ? — скрикнула Мотря і знову залилась сльозами .	караєш	8	2
У сусідських наймах не здобудеш тої повноцінної слави , якою винагороджують геніїв ; Антей мусить торкатися таки рідної землі , аби не втратити силу й обдарування .	винагороджують	10	3
Той чоловік стукнув обухом , клини повилітали , обаполки збіглись докупи і держать за руки усіх злиднів .	держать	12	3
Айбо чоловік не стає , а все далі йде .	йде	8	3
Якщо ви не знаєте , як це перевірити , забули пароль або виникли інші питання — зверніться в нашу Службу підтримки .	знаєте	3	2
Задумує він її цікаво , але його писання від голови , а не від безпосереднього внушіння серця , — і синтакса у нього російська .	Задумує	0	3
Гадаючи , що Ваш лист з 27 . 11 . 1925 р . до мене ще не край Вашим зносинам з київською літературною громадою , — шлю Вам найсердечніші вітання од себе і всіх київських прихильників Ваших писань .	шлю	26	1
Тож деякі сучасні систематики вказують прийнятою назвою цього виду Cyanus segetum Hill , а Centaurea cyanus вказують як синонім , водночас , інші вказують прийнятою назвою Centaurea cyanus , а Cyanus segetum вказують — синонімом .	вказують	32	3
Поступово завойовують європейський ринок і українські виробники кондитерської продукції ( див . « Не лише зерном та олією » ) .	див	10	2
Ще більше відкриттів ви зробите , вивчаючи теплові й електричні явища у 8 класі !	зробите	4	2
Перші зв’язки з японцями ОУН налагодить уже на початку 1930-х — у той час доволі гучною акцією , яку розглядала Ліга Націй , була пацифікація , котру поляки проводили на Галичині .	налагодить	5	3
Якщо протягом трьох років колишній власник транспортного засобу не вимагатиме передання йому суми виторгу , ця сума переходить у власність територіальної громади , на території якої було знайдено транспортний засіб .	вимагатиме	9	3
Ураження повітроносних шляхів і легень призводить до порушення процесів дихання .	призводить	5	3
Писатиму тут про свої успіхи в справі імплементування UEFI на кількох mips і arm одноплатних компутерах ( ОПК ) .	Писатиму	0	1
Ми вимикаємо телефони , не дивимося новини , не обговорюємо їх , не сваримося .	обговорюємо	9	1
Дивне прохання , але раптом таки я не марно це сюди запропоную .	запропоную	11	1
Натомість південь Одеської , Миколаївської і Херсонської областей , навпаки , характеризується незначними висотами , що подекуди становлять лише 2 – 10 м .	характеризується	11	3
— Дівко , дівко , влізь мені в праве вухо , а в ліве вилізь !	влізь	5	2
Переможна сила традиції й звичаю у цій царині , як і в обсязі инших формально - язикових уяв , опановує найгеніяльніші особистості .	опановує	19	3
Але що б ми собі не нафантазували , правдою буде одне - відсутність ресурсів забрати з свого життя фактори , які його отруюють .	отруюють	22	3
Цей числовий код призначений для опрацювання людиною та використовується для впорядкованого зберігання даних про товари .	використовується	8	3
Візьмеш мене й побачиш , як добре тобі буде .	Візьмеш	0	2
Що Ви не пускаєте « Сковороди » , це добре : « Сковорода » потребує окремого видання .	пускаєте	3	2
— Чорнила слізьми не розмаж , — каже Левко і одвертається : жде .	одвертається	10	3
Під час проведення практичних робіт у навчальному процесі забороняється вимагати від студентів виконання процедур , що призводять до смерті або травмування тварин , якщо це суперечить їхнім моральним або релігійним принципам .	призводять	16	3
Київський краєвид у ньому божественний , — Ви прекрасно відчуваєте київську своєрідність , стиль Києва .	відчуваєте	9	2
Приїхавши після Чити до Делятина , тато кілька місяців удавав у школі , що не розуміє української .	розуміє	15	3
Вибіжить на вулицю і хіхи - хахи , а дома , як вовк .	Вибіжить	0	3
Вгадайте чи спромігся Кабмін затвердити Положення про Національну раду з питань науки та технологій ?	Вгадайте	0	2
Якщо у вас для кожної точки треба свою СВ , :wink2: а рух залежить від СВ , то не морочте голову , а прямо кажіть , що у вас рух залежить від точки .	залежить	13	3
Я перекинусь пшеницею , а ти перекинешся дідом , та будеш стерегти мене .	перекинешся	6	2
Негр витягає в повітря підборіддя і знов утягає його , як робить це качка в любовному екстазі .	утягає	7	3
Сидить на поріжку і обриває пелюстки на ромашці , шепочучи : “ Є — нема , є — нема , є … ”	обриває	4	3
Коли ти на каруселі крутишся , на тебе типу сили діють .	крутишся	4	2
Для початку маємо дві колоди — “ Стару ” та “ Нову ” , які потім , якщо все піде добре , будемо доповнювати новими картами , скажімо , до днів факультету .	піде	19	3
Таким чином , з точки зору молекулярно - кінетичного вчення , температура тіла характеризує середню кінетичну енергію руху часток речовини , з якої воно складається .	характеризує	13	3
Ви видержите , Гелю .	видержите	1	2
Побачимося в суді .	Побачимося	0	1
На диво , ми це не зможемо зробити , оскільки рука , що була в гарячій воді , відчуватиме холод , і навпаки , рука , що була в холодній воді , відчуватиме тепло .	відчуватиме	18	3
Метелики ці мають строкате і яскраве забарвлення , що часто містить рудий , коричневий і жовтий кольори .	містить	10	3
Подразнюючи цю ділянку пальцями , викликаємо гостре відчуття насолоди і нестримний кровоналив венозних судин прутня .	викликаємо	5	1
От під цією сорочкою він і вийде .	вийде	6	3
Розділи поділено на параграфи , що починаються з коротких рубрик « Ви дізнаєтесь » і « Пригадайте » .	Пригадайте	16	2
Одначе і тут виступає явище , що миски ламаються разом з ніжкою , отже , треба думати , готувалися з одного шматка глини .	виступає	3	3
Левко озирається довкола , зітхає немічно худими грудьми і манить Марфу пальцем за пошту .	озирається	1	3
Пакуй у міхи , що в них тільки влізе , повеземо до твоєї хижі .	Пакуй	0	2
Інших даних про цю спецоперацію наразі немає .	немає	6	3
У разі підписки на Office 365 Домашній , Персональний чи Для студентів перейдіть на сайт www.office.com/myaccount , щоб інсталювати Office .	перейдіть	12	2
Та хіба ж усе розгледиш ?	розгледиш	4	2
Якийсь заворушиться , і всі прокидаються зі свого напівсну та вибухають жалібним лементом .	заворушиться	1	3
Звісно не було жодного способу дізнатись чи спостерігають за вами саме у цей проміжок часу .	спостерігають	7	3
Тоді я замислююсь і кажу :	замислююсь	2	1
Роздіймав він їм руки , роздіймав , нічого не вдіє .	вдіє	9	3
Там наче є один день після оголошення списків рекомендованих до зарахування , щоб написати заяву на ту , на яку все ж більше хочеться , якщо вас рекомендують до зарахування на кілька спеціальностей .	хочеться	23	3
На моєму місці незримо стоять усі , хто , як і мої колеги з Українського католицького університету , творять сьогодні нову натхненну Україну .	творять	18	3
Підписана вже давно і з радістю відкриваю кожен пост , багато чого з того публікую у своїй стрічці - хай друзі теж радіють .	публікую	14	1
Перелік альтернативних методів і об’єктів для використання замість експериментальних тварин розробляється та затверджується центральним органом виконавчої влади , що забезпечує формування державної політики у сфері освіти і науки .	розробляється	10	3
З часом по краях вузлів ( горбочків ) епідерміс відділяється , а в центрі тканина некротизується з утворенням характерної впадини з валиком із грануляційної тканини розміром 1 - 3 мм навколо неї .	некротизується	15	3
До роботи з експериментальними тваринами допускаються особи , які мають вищу медичну , ветеринарну , зоотехнічну , біологічну або фармацевтичну освіту , здобуту у вищих навчальних закладах III – IV рівнів акредитації .	мають	9	3
Якщо можете допоможіть і підкажіть , що я маю робити	маю	8	1
— Аби якісно обскублось , потрібно відрізати голову , ногу , — завершує інструктаж .	завершує	12	3
На останньому поверсі старезної камениці , тої , що прилягає до Успенської церкви , жила наша старенька тітка , вдова першого ректора українського таємного університету .	прилягає	9	3
До податкової декларації або уточнюючих розрахунків ( в разі їх подання ) платником податків додаються розрахунок суми бюджетного відшкодування та оригінали митних декларацій .	додаються	14	3
Цих традицій стараємося дотримуватися і сьогодні .	стараємося	2	1
На другому поверсі існує зачинена шафа , а в ній щось нявчить .	нявчить	11	3
Не знаю , чи цільно стріляв той прилад , але признаюся , що тоді вперше доводилось бачити таке дивовижжа та подивляти стрілецьку вигадливість .	знаю	1	1
Як бачимо загальний обсяг коду речення зменшиться в 10 разів .	бачимо	1	1
Лоскіт , дотик , пестощі всіх статево вразливих зон надзвичайно збуджують будь-якого чоловіка .	збуджують	10	3
Ви знаєте за що і вони знають за що » .	знають	6	3
Серед по-справжньому відданих справі людей , трапляються такі , що я не можу це передати словами .	трапляються	6	3
Постійно щось бухтить противним скрипучим голосом , матюкається сам до себе .	матюкається	7	3
Зовсім загубила спокій Мотря : водять її то в город , то з города ...	водять	5	3
— Як же мені не плакати , коли змія загадала таке , що я ніколи його не зроблю , а вона сказала , щоб за одну ніч зробив .	зроблю	17	1
А то на одні не налазять пластикові обкладинки , для інших ті обкладинки великі .	налазять	5	3
Чорт забирай , це найкращий серіал за всю історію .	забирай	1	2
Картинка , яка йде за текстом , часто ставить крапку ( за певними винятками ) .	ставить	8	3
після твоїх випусків точно довше буду жити у цій чудовій державі , цім казковім царстві тварин які розмовляють і людей які щось людське у тваринах шукають )))	розмовляють	17	3
Цілком можливо , що насправді зросла кількість тих читачів , які з більшою недовірою ставляться до будь-яких матеріалів ЗМІ і які схильні називати « джинсою » все , що викликає в них підозру .	ставляться	14	3
По-перше , Ви тепер точно знаєте що праві , по-друге , Ви виглядаєте гарною і молодою , і якщо у співрозмовника не вистачає не тільки аргументів , а і розуму - це вже не Ваша проблема .	знаєте	5	2
Це історична константа , коли хочете .	хочете	5	2
— Щоб ти оту гору розкопав , і щоб туди Дніпро йшов , а коло того Дніпра побудуй комори : щоб байдаки туди приставали , й щоб ти ту пшеницю продав на байдаки .	побудуй	17	2
фантазія рісує трав*яний чи листяний , екопродукт лісу , де в кожного існує своя тотемна рослина щасливих первісних часів , коли не було кордонів і бюрократії .	рісує	1	3
Хоч , зрештою , у них в гімназії і хлопці часто плачуть , се у них в звичаї .	плачуть	11	3
Це вбиває будь-яку напругу і знецінює увесь екшн .	знецінює	5	3
Перегодом постає знеохота і до похмурої подружньої любові ( на жаль , утішати випадає здебільшого дружині ) .	випадає	13	3
На дорогах , крім півдня , подекуди існуватиме ожеледиця .	існуватиме	7	3
— Красунечко , поможи мені !	поможи	3	2
І той момент , коли в очах , поширених надією й захватом , блискає жах — є найкращий .	блискає	13	3
Старіння нації негативно впливає на розвиток господарства , адже частка працездатного населення зменшується , водночас збільшується навантаження на нього через велику кількість людей пенсійного віку , яких треба утримувати .	зменшується	12	3
Очі мамині сухі , голос ані здригнеться , і я чую за ним : спогади її не щемлять їй і не болять — вони закам’яніли .	чую	10	1
Далі вона бере кожен з 5-ти елементів , і вставляє їх в дерево кожен в свій вузол .	бере	2	3
Забороняється проведення боїв тварин , спортивних , видовищних заходів , що передбачають переслідування , умертвіння , спостереження передсмертної агонії тварин , використання для умертвіння тварин інших тварин .	Забороняється	0	3
Передбачається , що дрон літатиме на висоті до 120 метрів і нестиме пакунок до 2 , 5 кг .	нестиме	11	3
Оце я розумію серіал .	розумію	2	1
На підвищенні сидить міцний , мов із закам’янілої гуми , негр .	сидить	2	3
Гуня виготовляється із своєрідного кошлатого сукна .	виготовляється	1	3
Пізніше він переїде до Шанхая , де очолить українську громаду .	переїде	2	3
До речі , як друкуватиметься « Живем комуною » ?	Живем	6	1
Щось таки добирається , щось іде стежечкою .	добирається	2	3
Тому весь сенс мого існування полягав у тому , аби нізащо не стати серйозним членом суспільства , не бути відмінником , не отримати червоного диплома і не опинитися на дошці пошани : « Ними пишається наше місто » .	пишається	34	3
Ви почитайте , що цей дурень говорить у Івченка другому дурневі , якого автор чомусь називає « Руссо » .	почитайте	1	2
* Нові зареєстровані користувачі протягом перших 2-х місяців сплачують без комісії виставлені електронні рахунки за комунальні послуги , телефон , інтернет та телебачення ( за виключенням оплати рахунків за реквізитами компанії ) .	сплачують	8	3
Таку точно на базарі не куплять .	куплять	5	3
— Зроби мені троє діл та й підеш собі додому , а як не зробиш , то я тебе з'їм !	підеш	7	2
Воно забезпечує автоматичне переобчислення значень формул , де використовуються посилання .	забезпечує	1	3
Пишемо - вискакує .	вискакує	2	3
Ми будуємо нову Україну .	будуємо	1	1
Пам'ятайте , що ми , Українські Повстанці , боремося за найвищі і найшляхетніші вселюдські ідеали свободи , братерства і рівноправности всіх народів , ми боремося за національне і соціальне визволення , рівність і справедливість кожнього народу і кожньої людини !	боремося	24	1
І завела звичку складати графік дня , спілкуватися з людьми в рамках графіку , а потім вимикати телефон і не хвилюватися , що хтось образиться .	образиться	24	3
7 вересня « ТЕЛЬНЮК : Сестри » виступлять на території « Софії Київської » [ Київ , вул . Володимирська , 24 ] за участю Симфонічного оркестру та хору Заслуженого академічного ансамблю пісні і танцю Збройних Сил України	виступлять	7	3
Ми знаємо , що Ви , чехи , і Ви , словаки , - сини культурних , демократичних , політично високорозвинених народів , тому віримо , що Ви станете разом з нами проти большевицько - польського варварства і людоїдства .	станете	28	2
Надійшовши в шлунок , їжа механічно й хімічно подразнює рецептори його слизової оболонки .	подразнює	8	3
Приємно , коли увага застигає , й ти обережно , м’ягко повертаєш його в той бік , який тобі потрібний .	застигає	4	3
Жодна емансипація не здатна вплинути на те , що жінка — мати і народжує дітей , й у своїм материнстві та вихованні дитини потребу́є чоловічого піклування .	народжує	13	3
І скажіть : од такого !!	скажіть	1	2
Високі миски на ніжці румунської мальованої кераміки семигород . та молдавської груп в загальних рисах нагадують старчевські та вінчанські .	нагадують	15	3
Поки я лапаю останні промінчики сонечка і намагаюся зрозуміти , коли я стала рудою - питання , чи не є порушенням Правил адвокатської етики публікація адвокатом своїх знимків у купальнику в соціальних мережах , своєї актуальності не втратило	лапаю	2	1
Від самого початку влада зіткнулася з великою проблемою : кого вважати таким , що працює неналежний термін ?	працює	14	3
Розвиваючись і вивчаючи навколишній світ , ви пізнаєте й самих себе , а пізнаючи себе — пізнаєте світ .	пізнаєте	16	2
Тому пропонуємо , аналізуючи кліматодіаграми , дотримуватися певної послідовності та звертати увагу на конкретні особливості ходу кліматичних показників .	пропонуємо	1	1
Коли це вилазить з нори гадюка та й сичить .	сичить	8	3
— Візьми та гляди , — каже , — небагато накладай на віз , щоб ти мені коня не спортив .	Візьми	1	2
ОК , про інавґурацію самі - знаєте - кого .	знаєте	6	2
Ми вимикаємо телефони , не дивимося новини , не обговорюємо їх , не сваримося .	дивимося	5	1
Перелік можна продовжити , але для початку вистачить .	вистачить	7	3
Божества у релігії Асатру / Одіна розглядаються не як автономні , трансцендентальні істоти , а , скоріше , як зразкові моделі свідомості або архетипи , які слугують патернами для людського розвитку »	слугують	26	3
Недосконалі , часто зношені фізично водопровідно - каналізаційні системи скидають у природні водойми значну кількість забруднювальних речовин : органічних , нафтопродуктів , нітратів , азоту амонійного тощо .	скидають	9	3
Повернені власникам тварини підлягають щепленню проти сказу .	підлягають	3	3
Наприкінці кожного параграфа є рубрика « Підбиваємо підсумки » , яка допоможе вам краще запам’ятати головне .	Підбиваємо	6	1
Уявляєте мій настрій цілий день ?	Уявляєте	0	2
Піду світом , щастя пошукаю , бо як удома сидітиму , усі погинемо » .	сидітиму	9	1
Здебільшого вони містяться довкола губ , очей , шиї , плечей , уздовж боків та на внутрішній поверхні стегон .	містяться	2	3
Біля річки ( південна частина водойми ) глибина складає 1 . 5 метри і поступово переходить на міль .	складає	8	3
Нас не дивує , коли таким могильним запахом з насолодою упиваються Зерови й Могилянські , але нас обурює , коли про цю насолоду шамрикають і деякі пролетарські письменники .	упиваються	10	3
Україна кличе Вас , наші Браття - сусіди , до цього великого діла .	кличе	1	3
А ще благородніша вона тим , що через неї і завдяки їй можна виявити дуже несимпатичну породу роду людського , ту породу , що ганьбить почесне звання охотника - людини , якій є назва браконьєр .	ганьбить	24	3
« Тепер забудовник планує відбити вкладені кошти і мати прибуток , що , зрештою , зрозуміло , – говорить він .	планує	3	3
Несеш як якусь наслідственну хворобу на собі свою національність .	Несеш	0	2
Після цього самка підгризає квітконіжку , яка надламується і в'яне .	підгризає	3	3
Ранні прояви параної : коли я говорю чеською , мені здається , що це вигадана мова і люди навколо мені підігрують .	підігрують	20	3
Мені добре там , звідти не хочеться виходити .	хочеться	6	3
А від точки не залежить ?	залежить	4	3
Ми знаємо , що Ви , чехи , і Ви , словаки , - сини культурних , демократичних , політично високорозвинених народів , тому віримо , що Ви станете разом з нами проти большевицько - польського варварства і людоїдства .	віримо	24	1
Супер сексі - щойно я так ходжу вдома , але без жирафіків , колготів і ведмедиків , і в тапцях .	ходжу	6	1
Вона радіє , як є чим топити .	радіє	1	3
Не згадуватиму і всіх тих переживань , що їх мали нові мокрі громадяни світу , коли ступили на межу свідомого життя .	згадуватиму	1	1
Як зазначає Б . Вербер : « Сінгапур – держава демократична , але для того , щоб громадяни не голосували як попало , на виборчому бюлетені пишеться номер картки виборця » .	пишеться	26	3
Припускаю ( поки не доведено протилежне ) , що автори їх просто " не бачать " - не виокремлюють із дискурсу , яким послуговуються .	Припускаю	0	1
Я дуже чутлива до того , як події , що відбулися в Іспанії в 1936 – 1939-му , позначаються на сьогоденні .	позначаються	18	3
— Дівко , дівко , влізь мені в праве вухо , а в ліве вилізь !	вилізь	14	2
Одкинувши голову , джаз - бандист хапає дві палички , якими піднімає стрекіт , наче гострить одну об одну швидким чорногузовим клекотом .	хапає	6	3
Текст « Живем комуною » , як він видрукуваний у « Шляхах мистецтва » , — це таке свідчення про бідність естетичну , що я й не знаю , як редакція погодилась його собі самій видати .	знаю	27	1
така дурна аж ся світить	світить	4	3
— Іди собі ! — гукнув голова , бачачи , що в неї й річ відтяло .	Іди	1	2
" Нагадай , щоб забрали з повіту ленінський куток , — писав він , — сім карбованців я заплатив , лишається два з половиною .	Нагадай	1	2
Ні , я кину тугу в серце наймиліших дітей ворога мого , я розкину над ними смуток чорним покривом , і потьмариться мрія ворога мого » .	кину	3	1
— А чого ти стоїш , — питає той .	стоїш	4	2
Знаю ще таке : коли дитину вперше купають то воду після купелі слід виливати коли не стемніло і обов"язково під родюче дерево ( щоб продовжувався рід ) .	купають	7	3
Чи маю я носити сам мою тугу огненну , чи маю ховати мій смуток темний ?	маю	1	1
Немов не помічаючи сам , часом бере вилкою то гриб , то шматочок ковбаси , й їсть .	бере	6	3
Обіймаю тебе і несу на руках колиску з сином , доки й житиму … ”	Обіймаю	0	1
Для забезпечення упорядкованого зберігання даних на жорстких магнітних дисках перед використанням диск розбивають на частини — логічні диски .	розбивають	12	3
А потім набив піпу , запалив та й курить , як із комина ...	курить	8	3
За будовою дна воно є платформним : знаходиться на затоплених ділянках Східноєвропейської та Скіфської платформ .	знаходиться	7	3
Перелік альтернативних методів і об’єктів для використання замість експериментальних тварин розробляється та затверджується центральним органом виконавчої влади , що забезпечує формування державної політики у сфері освіти і науки .	затверджується	12	3
— Їж , дорогий мій , їж ! — і вибирає йому найсмачніше .	Їж	1	2
В фізиці Аристотеля нема інерції .	нема	3	3
– Минулорічні змагання вкотре продемонстрували , що Сумщина має високопрофесійних фахівців , які надають якісну медичну допомогу жителям області .	надають	13	3
Нараз позирає , а поряд на лавці сидить паскудна чорна кішка , і на нього очі витріщила .	позирає	1	3
Щоб кожен раз не створювали нових тем пропоную зробити одну і прикріпити її зверху всіх тем .	пропоную	7	1
Нікого я тут ще не знаю .	знаю	5	1
Синоніми становлять у великій мірі багатство мови , розуміється , коли авторів лінгвістичний смак і чуття мови вміє їх одтінити .	вміє	17	3
Чорт таки тягне чоловіка , а той не дається — вчепився за стовпа .	дається	8	3
Роздай усім хліб .	Роздай	0	2
Ви , може , не пригадуєте , але я знаю , що колись ви були з ним в дуже близьких відносинах .	пригадуєте	5	2
— Заждіть ! — волосся їй розкошлалось ; виглядала як безумна .	Заждіть	1	2
Решта посолених , сподіваюсь , заповзли у мокру траву .	сподіваюсь	3	1
І не кажіть потім , що вас не попереджали ...	кажіть	2	2
Пиши мені , Гусінько , а я буду відповідати завжди .	Пиши	0	2
Сосницький гасає в ріжні боки .	гасає	1	3
Лайк , якщо цнотлива , репост , якщо вчишся у Могилянці .	вчишся	8	2
Так пишайтеся !	пишайтеся	1	2
Якщо у вас для кожної точки треба свою СВ , :wink2: а рух залежить від СВ , то не морочте голову , а прямо кажіть , що у вас рух залежить від точки .	морочте	19	2
Для захисту змісту повідомлень від сторонніх осіб проводять шифрування , замінюючи літери в тексті повідомлення іншими літерами , числами або умовними позначеннями .	проводять	7	3
— Ось дивіться ! — прямо заводиться .	заводиться	6	3
Ви ж самі розумієте , що робиться з браконьєром , коли він почує " стій ! "	стій	14	2
За цим фактом поліція розпочала кримінальне провадження за ч . 1 ст . 185 Кримінального кодексу України ( Крадіжка ) , - повідомляє Головне управління Національної поліції у Закарпатській області .	повідомляє	22	3
Одного разу можеш так спіткнутися на дорозі життя , що не тільки виб’єш собі два передні зуби , а й взагалі не здужаєш підвестися .	здужаєш	22	2
Ми наймаємо розумних і цілеспрямованих людей , але віддаємо перевагу здібностям над досвідом .	віддаємо	8	1
Можна було б спробувати проінтерпретувати такий текст , як попереднє замовлення на ініціалізацію , але ж при створенні екземпляру структури діють інші правила неявної ініціалізації , а саме за допомогою замовчуваних значень параметрів .	діють	20	3
Не можу виповісти Вам , який я радий , одержавши від Вас посилку і такого ласкавого листа .	можу	1	1
Під час розмови по телефону звуки перетворюються на електричні сигнали .	перетворюються	6	3
Ходили чутки , що там добувають уран .	добувають	5	3
Зовні ці правила виглядають досить кумедно та старомодно , й усе ж спробуйте , пристосувавши їх до сьогодення .	спробуйте	12	2
І солить слимаків , нападає на лгбт , вірить у світову змову .	солить	1	3
Не підкажете , будь ласка , як скоро з`являться нові примірники ?	будь	3	2
Збирають ягоди вручну і складають у невеликі плетені кошики , в яких і транспортують до місць переробки чи споживання .	Збирають	0	3
У баньках ( у людей ці штуки звуться - очі ) нема ні радості , ні суму , є самі тільки хитрощі .	звуться	7	3
Називайте як хочете — але якщо у вас є щось , що таки можна так назвати — напишіть мені , будь ласка .	будь	20	2
Щиро радію новому перекладу і з нетерпінням чекаю !!!	радію	1	1
Як зазначає видання , Йохай також є фігурантом федерального розслідування в рамках справи про спільні з Манафортом угоди з нерухомістю .	зазначає	1	3
Він усміхається їй , щось тюрлюрлюкає голосом у такт фокстротові і , підкинувши догори палиці , обриває все .	усміхається	1	3
Що ж ми бачимо в церковній метричній книзі ?	бачимо	3	1
Фактична вага й висота піддона ( основи ) враховується у висоту та фактичну вагу палети .	враховується	8	3
— Принеси мене до своєї хати та годуй мене м'ясом доти , поки в мене крила повідростають .	Принеси	1	2
Звичайно Ваші книги роздягають мою пенсійну картку але я це роблю з гордістю за мою Україну .	роздягають	3	3
Знаю ще таке : коли дитину вперше купають то воду після купелі слід виливати коли не стемніло і обов"язково під родюче дерево ( щоб продовжувався рід ) .	Знаю	0	1
Усі міжрегіональні відміни у рельєфі пояснюються місцевими особливостями тектонічної і геологічної будови .	пояснюються	5	3
При дресируванні тварин не допускається : нанесення тваринам побоїв , залякування , видалення кликів , кігтів тощо ; примушування тварин до виконання дій , що їх травмують .	допускається	4	3
– Раніше зими були такі , що снігу випадало по півметра , а то й більше , – розповідає директор Колочавського музею в Міжгірському районі на Закарпатті Василь Дербак , 73 роки .	розповідає	18	3
Його науковий підхід завжди міститиме елементи мистецтва .	міститиме	4	3
Ну , кинь дурниці !	кинь	2	2
А тепер збираймося до тебе , щоб ми до ранку були вже на місці .	збираймося	2	1
— Є також чутка , що до уряду втягають старого віком Льойда Джорджа , який , до речі , у своїх спогадах гостро висмівав Черчіля , як недотепу .	втягають	8	3
Уважатимемо , що текст закодовано з використанням таблиці кодів символів Windows - 1251 , тобто довжина двійкового коду кожного символу складає 1 байт .	Уважатимемо	0	1
Перемінні та урізноманітнені подразники спричиняють те , що швидко зводиться і твердне клітор .	спричиняють	4	3
Як повідомляє Укргідрометцентр , у неділю переважно без опадів , хоча в західних і північних областях вдень місцями існуватимуть невеликі опади .	існуватимуть	18	3
Планую короткотривалі поїздки в різні місця в Україні , 1 - 3 дні .	Планую	0	1
Часто накопичувачами забруднювальних речовин є водосховища , з яких під час підтоплення вони поширюються й на прилеглі ділянки території .	поширюються	13	3
Може вона і жалілась , скажімо , на чоловіка - мамі , священику , подругам , - і почула " що поробиш , терпи , то треба терпіти " .	терпи	23	2
- Приїздіть , - просить , - та й приїздіть до нас у Дзвонкове пополювати .	Приїздіть	1	2
Якоїсь миті Вінстон ясно зрозумів що горлає разом із рештою та жорстоко , ба навіть брутально , лупить своєю п’ятою по обідку свого ж таки стільця .	горлає	6	3
Так вона ж йому задасть .	задасть	4	3
Запам'ятайте собі це курча .	Запам'ятайте	0	2
Обід обходиться в 4 - 5 € у звичайних закладах , або обходиться під 7 € , якщо харчуватись в Lido , місцевій Пузатій Хаті .	обходиться	1	3
У тому ж приміщенні працює танцювальна студія .	працює	4	3
Передбачається , що дрон літатиме на висоті до 120 метрів і нестиме пакунок до 2 , 5 кг .	літатиме	4	3
Дякую за роботу .	Дякую	0	1
— Я на все пристану !	пристану	4	1
Почнімо з волосся .	Почнімо	0	1
Мрію працювати в напрямку характерних вечірок .	Мрію	0	1
Не допустимо , щоб нас викпивали через твою жінку .	допустимо	1	1
Так , стрічка шикарно знята , музика від Джеда Курцеля традиційно чудова , а Фассбендер божить .	божить	15	3
Правила поводження з тваринами , що використовуються у видовищних заходах , у спорті , при організації дозвілля	використовуються	6	3
Він , світ , справді опинився поза звичною дихотомією « правда – брехня » , а тому давній солженіцинський заклик « Жить не по лжи » сьогодні втрачає свій сенс .	втрачає	27	3
Не здурите його своєю виставою , і він урятується , навіть якби ви мали зараз не гранату , а бомбу , й положили півгарнізона ?	здурите	1	2
Алгоритм Д . Хаффмана та алгоритм Шеннона — Фано передбачають перекодування даних .	передбачають	9	3
Иноді він підходить до нас і дивиться на сотняні папірці , які ми пересуваємо один до одного .	пересуваємо	13	1
Чимало першокурсників - некиян ще не мають старших друзів у своєму ВНЗ – але , повірте , потоваришувати зі студентами старших курсів простіше , ніж вам може здаватися .	повірте	15	2
Хоча працівники Google мають спільні цілі та бачення компанії , ми представляємо всі верстви населення , розмовляємо десятками різних мов , уособлюючи всесвітню спільноту наших користувачів .	розмовляємо	16	1
Иноді він підходить до нас і дивиться на сотняні папірці , які ми пересуваємо один до одного .	підходить	2	3
Цитую : « Я вже давно звик до вибриків різних телерадіочинуш , котрі , прогинаючись перед можновладцями , забороняли мені працювати в ефірі , бо я ж — « ображав критикою небожителів » .	Цитую	0	1
Проте ці назви не можна вважати дуже давніми , і до племінних назв доісторичного періоду вони з цілковитою певністю не нав’язують .	нав’язують	20	3
Можна ловити рибу і з човна , але в наявності обов'язково мають бути жилети з особистим номером .	мають	11	3
Ну , ото журяться вони з жінкою , а далі кажуть :	журяться	3	3
Полегшить вам цей шлях пізнання книга , яку ви тримаєте в руках і з якою працюватимете впродовж навчального року .	працюватимете	15	2
При цьому найбільше часу витрачається на пересування решток їжі саме по товстому кишечнику ( приблизно 12 годин ) .	витрачається	4	3
До чого дурний , як валянок , до чого малий і страшний ( тато недоробив , мама недоносила ) , до того ж постійно прагне накликати на себе біду .	прагне	24	3
Але я ніколи нікому не казав неправди і зараз не скажу : я чую щодня , що десь тут коло мене ходить Марфина душа нещасна .	скажу	10	1
У п'єсі Франка ніби для нього написані такі слова Анни : " І боюсь його , і жити без нього не можу .	боюсь	13	1
Поки я лапаю останні промінчики сонечка і намагаюся зрозуміти , коли я стала рудою - питання , чи не є порушенням Правил адвокатської етики публікація адвокатом своїх знимків у купальнику в соціальних мережах , своєї актуальності не втратило	намагаюся	7	1
Наведені вище пестощі мають подвійне значення , бо справляють приємність та збуджують також і жінку , що відчуває , як унаслідок її пестощів підводиться , надимається і готується до акту чоловічий прутень .	відчуває	17	3
Таке волосся не вкладається , стовбурчить , липне до голови і виглядає так , наче його вполовину менше .	стовбурчить	5	3
Йдеться про генерацію на поки що ізольованій від решти країни Луганській ТЕС , яка в режимі енергоострова забезпечує підконтрольні Україні райони .	Йдеться	0	3
А Вінда взагалі пропонувала спочатку " цей диск не форматований , зробімо це ! " .	зробімо	11	1
Усе , було , лає її , сердешну , та знущається над нею , та ще , було , й діда підцьковує , щоб згриз голову своїй дочці .	підцьковує	21	3
Але кожен удар , кожен звук джазу зливається в один музичний , майже математично - точний потік звуків .	зливається	7	3
Правда , коректив був в особі моєї матері та в листах дядька Драгоманова , якого вважаю своїм учителем , бо дуже багато завдячую йому в моїх поглядах на науку , релігію , громадське життя і т . і .	завдячую	22	1
Ці викиди завдають великої шкоди екосистемам водойм , виводять з ладу водопроводи , розносять мікроби , завдають значних матеріальних збитків .	виводять	8	3
— Не йди , — каже , — чоловіче , якби він тебе хотів у куми взять , то б уже давно за тобою прислав .	йди	2	2
Рекламні написи були трьох ґатунків — маргарин дешевий смачний і корисний продукт , користуйтеся послугами держстраху , літайте літаками аерофлоту .	користуйтеся	13	2
Я думала , що всі яхти стають перше в ряд , а потім переганяються наввипередки , тим часом вони всі роблять круги по морю навколо різних значків , і котра більше кругів зробить в призначений час , та виграє .	виграє	38	3
Таке волосся не вкладається , стовбурчить , липне до голови і виглядає так , наче його вполовину менше .	липне	7	3
— Но , буде що буде , я зайду до хижі .	зайду	8	1
Показово , що групи в соціальних мережах , які поширюють заклики до масових заворушень на річницю Революції Гідності , адмініструються з Москви	поширюють	9	3
Летить змій .	Летить	0	3
На відміну від них я дивлюся на ті події з дистанції , не так , як безпосередні учасники , маю зовсім інший досвід їх переживання .	дивлюся	5	1
Наведені завваги стосуються використання давньоукраїнських пам’яток як джерела відомостей про інновації в мові , а також того , як ці пам’ятки використовуватимуться у книзі надалі .	використовуватимуться	21	3
Одкинувши голову , джаз - бандист хапає дві палички , якими піднімає стрекіт , наче гострить одну об одну швидким чорногузовим клекотом .	піднімає	11	3
— Та кажи !.. чого ти плачеш ? — аж скрикнула вона .	кажи	2	2
Під час репетицій Курбас передає своє бачення гри .	передає	4	3
Темне пиво п’ють не разом , а замість їжі .	п’ють	2	3
Однак тепер їхні політичні курси в питаннях Близького Сходу , Росії , зміни клімату та ролі ООН суттєво різняться .	різняться	18	3
— Я старий уже і трохи недобачаю .	недобачаю	6	1
Я починаю з клубної музики , оскільки попит на неї зараз найбільший .	починаю	1	1
Сили тертя між контактуючими поверхнями залежать від матеріалу , з якого виготовлено поверхні , та від якості їх обробки .	залежать	5	3
— Ну , от бачте , нічого я йому і не зробила …	бачте	4	2
При цьому охоче відрізає покупцям по шматочку персика — покуштувати .	відрізає	3	3
— Я з ним прийду , але ви поховайтесь , бо він вас розірве .	прийду	4	1
" За даними джерел , Мінюст домагається співпраці від Йохая у зв'язку з розслідуванням справи Манафорта через можливе відмивання коштів чи податкові порушення під час його співпраці з проросійськими партіями в Україні " , - зазначає видання .	зазначає	35	3
Пропонуємо читачам подивитись у вічі захисникам Києва від московських окупантів .	Пропонуємо	0	1
Також ви знаєте , що під час копіювання формул посилання в них модифікуються .	знаєте	2	2
Припускаю , в наступному сезоні багато хто мимоволі перейде на бік зла , обернувшись на білих блукачів .	Припускаю	0	1
У більшості країн , що розвиваються , і навіть подекуди в більш розвинених країнах , чисельність молодих людей щорічно зростає .	розвиваються	5	3
Утворення і виділення шлункового соку також регулюються нервовою системою і біологічно активними речовинами .	регулюються	6	3
Сходи , моя єдина у світі Соню !	Сходи	0	2
Особисто я вибираю і п'ю пиво в залежності від настрою , а на певній одній торгівельній марці не зупиняюсь - в кожній є своє улюблене : Львівське світле , Чернігівське біле , Славутич Ice , Оболонь біле ...	вибираю	2	1
Кидайте все і ходімо в ліс .	ходімо	3	1
Чоловік заглянув у вікно : лампа світить і вогонь горить , аж іскри розлітаються , начеб якась невидима сила гребла грань у пічці .	розлітаються	13	3
( Щодо марксизму , захоплення яким нібито знівелювало « згубний » вплив Драгоманова , то коментаторам зоставалося тільки сподіватися , ніби читачі обмежаться лише їхніми примітками .	обмежаться	22	3
Катай , серденько , катай , принесеш діткам гостинчика .	катай	4	2
Або ти їй віддаєшся повністю , пірнаєш у неї з головою , або бавишся в цюцю - бабки , і тоді вона до тебе повертається задницею , а ти так і зостанешся вічним невдахою .	пірнаєш	6	2
Ото раз на кілька років вирвешся в ті гори , а воно ллє і ллє , ллє і ллє , і туман , і не видно ніякої карпатської краси .	ллє	16	3
Просто я дуже все близько сприймаю до серця .	сприймаю	5	1
А там , на землі , панує ясний спокій , мрія ворога мого цвіте і витає — і ніщо не бентежить її .	панує	6	3
Точну ціну колоди опублікую через кілька днів , як тільки своє слово скаже типографія .	опублікую	3	1
Ця заввага літературознавця погано корелює зі свідченням самої поетеси у листі до Ольги Кобилянської : « … вчилась тільки того , що мені подобалось , а читала все , що запорву , без жадної заборони .	корелює	4	3
Що кращий апетит , то більше шлункового соку виділяється в « мозкову » фазу .	виділяється	8	3
Запрошуємо до співпраці кав'ярні , квіткові магазини , медичні центри та інші зацікавлені заклади !	Запрошуємо	0	1
І біжить на Хруща дивитись старе й мале .	біжить	1	3
Все пропало , відмовляйтеся від книжок ...	відмовляйтеся	3	2
Салтиков посилав його у недоступні місця і дивився , чим займаються різні звірі .	займаються	10	3
— Просили вовк , ведмідь , дикий кабан , і я прошу , щоб ти прийшла зі своїм паном Коцьким на обід .	прошу	11	1
Тоді він візьме свій клуночок , що лежить десь у кухні , суковату палицю й пішечки почимчикує на вокзал , жаліючи п’ятака на трамвай .	візьме	2	3
Я думала , що всі яхти стають перше в ряд , а потім переганяються наввипередки , тим часом вони всі роблять круги по морю навколо різних значків , і котра більше кругів зробить в призначений час , та виграє .	стають	6	3
Коли ті чують , що летить ізнов , аж земля реве , так дівка каже :	чують	2	3
Другий як стій наложив ленту — і як затріскотить першому над головою !	затріскотить	8	3
Вернулася , а веприк на ціле горло верещить .	верещить	7	3
Втікай до лиха один з другим , бо москалі вас видушать , як рудих мишей .	видушать	10	3
Вага та вартість стандартних палет визначається залежно від площі піддона та фактичної ваги за тарифами на доставку палет , розміщеними на Сайті .	визначається	5	3
Ребра з хребцями з'єднуються таким чином : дві пів'ямки сусідніх хребців утворюють ямку , куди заходить головка ребра .	заходить	15	3
Знаєте скількі коштує повія з таким тілом зараз ?	коштує	2	3
Ніко́ли не годиться перепивати , як і кохатися , аби вбити смуток , бо в обох випадках довго доведеться каратись .	годиться	2	3
Жде - жде — батька нема .	жде	2	3
Тепер я сама побіжу !	побіжу	3	1
Ми кровавились за ці ідеали повних три роки в боротьбі проти німецької окупації - і тепер продовжуємо нашу боротьбу за ті самі ідеали проти окупації большевицької .	продовжуємо	16	1
Не слухайте їх , а допомагайте серцем і ділом українському народові в його горю і нещастю і в його героїчній боротьбі !	допомагайте	5	2
Виловлені бродячі домашні тварини протягом п’яти днів з дня їх вилову утримуються на карантинних майданчиках служби або підприємства , що здійснює вилов , і можуть бути передані спеціалізованим організаціям за їх бажанням для передачі їх у спеціалізовані притулки .	утримуються	11	3
Дізнавшись , що я живу в горах , моряки заздрісно визнали , що це теж дуже - дуже добре .	живу	4	1
Розв’язуючи задачу на уроці математики , слова , що позначають числа , записують цифрами , а математичні операції записують — спеціальними знаками .	записують	18	3
Дражнення жіночих персів — один з найдужчих еротичних подразників , а як посилити ці пестощі цілунками , я опишу докладніше у дальшому розділі .	опишу	18	1
Вітер повіє , то колодочка стук - стук , а бабина дочка в хаті :	повіє	1	3
У разі замовлення Відправником забору в один із часових інтервалів , Відправник забезпечує , щоб відправлення було належним чином запаковане до моменту забору .	забезпечує	12	3
Датується 1200 — 1210 роками та містить 25000 віршованих рядків .	Датується	0	3
Наприклад , тут можна слідкувати за переміщенням кожної автівки , а охоронці в будинках фіксують прізвища відвідувачів .	фіксують	14	3
У любовних книжках натрапляємо на визначення подиху , що пахне фіалкою , материнкою тощо .	натрапляємо	3	1
Звичайно , не вони ведуть перед поетичного поступу .	ведуть	4	3
Тета Міра любила співати нам або сама собі таку пісеньку — я тішуся , як спати йду , і вранці я знова встаю , яка дурненька я , яка дурненька я .	тішуся	12	1
Нас не дивує , коли таким могильним запахом з насолодою упиваються Зерови й Могилянські , але нас обурює , коли про цю насолоду шамрикають і деякі пролетарські письменники .	обурює	17	3
При сортуванні видаляють сторонні домішки і перестиглі та пошкоджені ягоди .	видаляють	2	3
Темне пиво виготовляють без всяких барвників .	виготовляють	2	3
В « Синах » Стефаника бачимо матір , що з німим докором дивиться на синів , які тікають з-під рідної стріхи боронити рідну землю .	бачимо	5	1
Посудини на ніжці відміняються у своїх формах від конічної миски до профільованих баняків .	відміняються	3	3
— Не пущу , най мої діти не будуть голодні .	пущу	2	1
На його синюватих , голодних губах грає запобіглива і в той же час вибачлива посмішка старого ідейного інтеліґента .	грає	6	3
Рекламні написи були трьох ґатунків — маргарин дешевий смачний і корисний продукт , користуйтеся послугами держстраху , літайте літаками аерофлоту .	літайте	17	2
Уважатимемо , що текст закодовано з використанням таблиці кодів символів Windows - 1251 , тобто довжина двійкового коду кожного символу складає 1 байт .	складає	20	3
Коли Ви чесні люди , коли Ви демократи - не слухайте большевицької брехливої пропаганди , не слухайте тих , які вихваляють червоний тоталітаризм і кажуть Вам виступати проти українців .	слухайте	10	2
Може , за такої нагоди деякі і пощастить викорінити .	пощастить	7	3
Офіційно сподіваємось випустити гру у вівторок , 18 жовтня , тим часом оформити передзамовлення за собівартістю можна в мене через особисті повідомлення — Вам це вийде дешевше , а ми точно знатимемо розміри першої партії .	вийде	25	3
Маю вийти я !	Маю	0	1
Та візьме та й оддасть їй починки , а вона мерщій вскочить у хату до матері :	візьме	1	3
Його вирощують у всьому світі на 90 мільйонах гектарів .	вирощують	1	3
Ніко́ли не годиться перепивати , як і кохатися , аби вбити смуток , бо в обох випадках довго доведеться каратись .	доведеться	18	3
Кінець цього шву бачимо у вуздечці крайньої плоті — складці слизової оболонки , яка прикріплює крайню плоть до голівки прутня .	бачимо	3	1
Зміїна дочка зробилась ізнов людиною , а той дід зробився парубком , та давай утікати .	давай	13	2
Зразки друку , формату і паперу посилаю .	посилаю	6	1
Ми захоплено гралися у наших партизанів , за якими полює авіація .	полює	9	3
І ще подумалося , що екранізації ніколи не дадуть того ефекту , що книжки , бо вони все окреслюють , всьому дають форму , чіткий вигляд і звужують простір для фантазії та домислів .	дадуть	8	3
Сильну не тому , що вона долає труднощі , розвивається і приймає важкі рішення .	долає	6	3
Якщо можете допоможіть і підкажіть , що я маю робити	підкажіть	4	2
Зміняє його заступник , вибраний Зборами на випадок смерти або тяжкої хвороби , до вибору нового Голови .	Зміняє	0	3
Коли Сосницький зривається згори й потім понуро сидить , мені стає нудно .	зривається	2	3
легко говорити радійте всі життю , воно таке хороше і прекрасне , коли в тебе все добре і ти здорова і не помираєш ...	радійте	2	2
Певна річ , ще довгими часами матимемо паралелізми , невідтінені сіноніми , — але чи мова взагалі може їх збутися ?	матимемо	6	1
Церемонія нагородження запам’ятається Ріанні не лише особливою нагородою , а й романтичним освідченням .	запам’ятається	2	3
Що впливає на стипендію , на відрахування ?	впливає	1	3
Ну , я тебе зроблю річкою , а сама зроблюсь рибою - окунем .	зроблю	4	1
Потім , стрепенувшись , підкидає їх угору , перебиваючи їхню дерев’яну говірку так , щоб у прорив шелепаво дзвякали мідні тарілки , дзенькав трикутник і наддавала в ритм свою мелодію струнна армія рояля .	підкидає	4	3
— Пусти мене , ніколи не буду більше тобі шкодити .	Пусти	1	2
Дені таке лестить , але вона горда , і на якогось бастарда не хоче дивитися .	лестить	2	3
