V niekoľkých sekundách po prebudení sen i spomienka , ktorá ho podnietila , splynuli v jeho mysli v jedno .	prebudení	4	Neut
Vybudovanie environmentálnej infraštruktúry je nevyhnutnou podmienkou pre vstup do EÚ .	infraštruktúry	2	Fem
Aladin sa zakrádal hore po schodoch s Abuom na pleci .	pleci	9	Neut
Práve došli na okraj malého lesíka .	lesíka	5	Masc
V ich národnom epose Kalevala nájdeme napr . starobylý výklad o pôvode sveta z vajca .	epose	3	Masc
Namiesto neho som objavil dve nečakané veci : svadobné šaty aj s vencom a fotografiu akejsi ženy .	fotografiu	14	Fem
Červený od zlosti vykríkol : “ Ty si ale nemehlo !	zlosti	2	Fem
Bežala za veliteľom mravcov a prosila ho , aby vyhlásil po Flipovi pátranie .	pátranie	12	Neut
Potom Maja s kamarátmi pomáhala stroskotancom z vody na nové plavidlo .	stroskotancom	5	Masc
Tentoraz na televízne obrazovky v podobe 13 - dielneho seriálu .	obrazovky	3	Fem
Spoločne mu ukázali upravené domčeky i podzemné chodby .	domčeky	4	Masc
Práve preto mal spev kohúta aj druhý význam .	spev	3	Masc
V hlbinách zasa mocné morské obludy . “	hlbinách	1	Fem
Neveríme princípom angsocu .	angsocu	2	Masc
Namiesto veľkého podnosu niesla malú tácku , na ktorej bola len jedna šálka s kávou a jeden pohár s rakijou .	podnosu	2	Masc
Vysypte do nej kuskus a vypnite oheň .	kuskus	3	Masc
Vtedy som zdvihol telefón a vytočil číslo 09 .	telefón	3	Masc
A kto tie náročné preteky vyhral .	preteky	4	Masc
Útek sa podaril .	Útek	0	Masc
1 . zázračné vyberanie obilia a rýb spoza ženských pliec .	obilia	4	Neut
Obaja sme začuli mamino zlostné vzdychnutie .	vzdychnutie	5	Neut
Kráľovná Maja a pavúčica Tekla	pavúčica	3	Fem
V nasledujúcej chvíli nastal obrovský rozruch .	rozruch	5	Masc
„ Viera môže dávať človeku životnú istotu “ , mieni profesor Ďurovič .	človeku	4	Masc
Do toho domčeka prichádzal každý večer človek .	domčeka	2	Masc
Napriek tomu sa mi jeho prvá prednáška vryla do pamäti .	prednáška	6	Fem
Vláda bude podporovať politiku multifunkčného poľnohospodárstva a jeho krajinotvorné , enviromentálne a kultúrne funkcie , podporovať rozvoj vidieckej infraštruktúry a vidieckeho turizmu .	poľnohospodárstva	5	Neut
Na inštalovanie sochy podobných rozmerov treba aj súhlas mesta .	inštalovanie	1	Neut
A tu či inde sa v úplnej tajnosti nachádzali riadiace mozgy , ktoré koordinovali toto úsilie a určovali politickú líniu : rozhodovali o tom , že tento fragment minulosti sa zachová , tento sa sfalšuje a ďalší prestane jestvovať .	líniu	19	Fem
A po ďalšej minúte sa opäť rozburácal divoký rev davu .	minúte	3	Fem
PREČ S VEĽKÝM BRATOM !	BRATOM	3	Masc
“ Toto hľadáš ? “ spýtal sa s úsmevom , keď sa po chvíli vynoril aj s kľúčikom .	kľúčikom	17	Masc
O prípadnom sobáši nedebatovali .	sobáši	2	Masc
A vládca sveta mŕtvych sa mi zjavil v čiernej peleríne .	peleríne	9	Fem
V ten večer sa v paláci zhromaždili všetci dvorania , keď princezná Zornička tancovala s princom Filipom .	princom	15	Masc
Teraz mal kopu peňazí .	kopu	2	Fem
Cieľom reformy poistenia v nezamestnanosti bude posilnenie princípu zásluhovosti ( poistného princípu ) a princípu osobnej zodpovednosti občana za vlastnú pracovnú a sociálnu situáciu .	zásluhovosti	8	Fem
“ Tu je diera , “ zašepkala som a vybrala trs trávy , ktorý zakrýval vyčnievajúci stupienok z palmového dreva .	trs	10	Masc
Lev IX . a jeho nástupcovia sa teda snažili cirkev už skutočne riadiť .	nástupcovia	5	Masc
Poskladali sme vlhkú deku , napchali ju do koša , ktorý sme pomaly uväzovali o korman .	korman	15	Masc
Všetci vedeli , že na papieri sa každý kvartál vyrobili astronomické počty topánok , kým vari polovica obyvateľov Oceánie chodila bosá .	kvartál	8	Masc
Zrazu si Aladin uvedomil , že naňho so záujmom hľadí vysoký , vážny a trochu zavalitý mladík .	mladík	16	Masc
Keď víly nechali princeznú na chvíľočku v paláci osamote , zjavilo sa pred ňou jagavé svetlo .	chvíľočku	5	Fem
JEDNÉHO DŇA SA PYŠNÁ KRÁĽOVNÁ SPÝTALA svojho zázračného zrkadla : “ Povedzže mi , ktože je najkrajší v našej zemi ? “	zemi	19	Fem
Máme jej celé kilo , " povedala .	kilo	3	Neut
Pri cieli sa skrýval osiak Boris a zrkadielkom oslňoval ostatných pretekárov , len aby pomohol svojmu zmrzačenému kamarátovi zvíťaziť .	zrkadielkom	7	Neut
S očividným uspokojením dokázal rozprávať o náletoch vrtuľníkov na nepriateľské dediny , o procesoch s ideozločincami , o ich priznaniach a o popravách v katakombách Ministerstva lásky .	dediny	10	Fem
Jedlo zásadne mení človeka po každej stránke .	človeka	3	Masc
Na dverách od profesorovej izby bola vosková pečať , zo stareninej izby sa neozývali nijaké zvuky .	izby	4	Fem
Marga odchádzala , strácala sa v dave , autobus ju viezol do ktorejsi dediny v nížine .	autobus	8	Masc
Drobná žena s pieskovými vlasmi zakvičala a v jej hlase sa miešala hrôza s odporom .	hrôza	12	Fem
" Je to káva Vnútornej strany .	káva	3	Fem
Veď je to cesta plná rôznych prekážok , zvodov a pokušení .	prekážok	6	Fem
Na jednom z programov Českej televízie sa momentálne dá vidieť skvelá séria ľahkých , avšak nebulvárnych reportáží zo života s názvom Ta naše povaha česká .	reportáží	16	Fem
/ Vypitie čaše vína na schodisku chrámu pripomína obrady pohanských kolektívnych hostín , tzv . „ bratčín “ .	vína	3	Neut
Druhou činnosťou , ktorú v Ostrihome klerikom zakázali , bolo úžerníctvo .	činnosťou	1	Fem
Miatla ho vôňa povetria i zeleň lístia .	vôňa	2	Fem
Kým odletím do nebeského pekla , musím si odčiniť nejaké hriechy tu , v pozemskom pekle .	pekle	15	Neut
Nespýtal som sa ho , či sa pamätá na obdobie , keď som s ním každú nedeľu chodieval do bábkového divadla .	divadla	20	Neut
Dotyčný sa zaceril .	Dotyčný	0	Masc
Nervózny mladý slon Tantor ho zbadal .	slon	2	Masc
Decentralizáciou kompetencií sa presunula podstatná časť zodpovednosti za rozvoj bývania na obce .	zodpovednosti	6	Fem
Zmeravela som , keď na druhý deň Chris meškal celých desať minút na hodinu astronómie .	hodinu	13	Fem
Videl , ako Júlia zodvihla pohár a privoňala k nemu s úprimnou zvedavosťou .	zvedavosťou	12	Fem
Mamina silueta stála vo dverách a obaja sme vycítili , že sa hnevá .	dverách	4	Fem
So zlovestným úškľabkom na tvári Uršuľa chrlila na Arielu hromy ‐ blesky .	hromy	9	Masc
V jednom rohu podložky je ventil , po jeho otvorení pena nasáva vzduch , nafukuje sa .	otvorení	9	Neut
Domčeky vyzdobili girladnami a Vilko s Emilom urobili na jednom krtinci kĺzačku , kde šantili deti .	kĺzačku	11	Fem
Chorvátsko sa totiž od Zvonimirovej komendácie považovalo za pápežské léno .	léno	9	Neut
Pred dvermi sa objavovali košíky s prekrásnymi plodmi od výmyslu sveta .	plodmi	7	Masc
Zaletela k nim , sadla na kvet a počúvala tiché zurčanie potoka .	potoka	11	Masc
Na lúke postávali skupinky rozčúlených obyvateľov .	skupinky	3	Fem
Neviditeľní jazdci na koňoch sú vyjadrením predstavy o zlých duchoch , schopných ubližovať človeku odnesením jeho duše do podsvetia .	odnesením	14	Neut
Poviedka nie je pekne napísaná .	Poviedka	0	Fem
Priplávala som ku kovovým schodíkom a s námahou som vystupovala von , keď ma striaslo .	schodíkom	4	Masc
Okolo preletela penica .	penica	2	Fem
Deti sa budú matkám odnímať už pri pôrode , ako vajce sliepke .	sliepke	11	Fem
Centrom vladimírskych mohýl bolo Pleščejevské jazero , osídlené zmiešaným slovansko ‐ ugrofínskym obyvateľstvom .	jazero	5	Neut
Rozprávanie Ľubomíra Ďuroviča PRIPRAVILA Kveta Škvarková .	Rozprávanie	0	Neut
Podľa viery ugrofínskych Čuvašov výšivka konskej hlavy na ženskej hrudi chráni pred nebezpečím pôrodu .	pôrodu	13	Masc
Na chrbte cítil , ako ich zraky priťahuje jeho belasá uniforma .	zraky	6	Masc
Napriek tomu sa mi jeho prvá prednáška vryla do pamäti .	pamäti	9	Fem
Foto je len ilustračné .	Foto	0	Neut
Takéto obavy som rázne zavrhol .	obavy	1	Fem
Na stoloch stáli všelijaké fľaštičky a v bankách bublali záhadné tekutiny .	tekutiny	10	Fem
Všetci obyvatelia Makovej lúky sa zišli na čistine , kde Rudko poriadal letecké preteky .	čistine	7	Fem
Niekoľko dvojíc tancovalo , iní sa bavili pri stoloch a bolo tam veselo i príjemne .	dvojíc	1	Fem
Koniec rebríka preťal okno a prelomil rám .	okno	3	Neut
Po známej zrážke s okrajom bazéna ma boleli päty a prestala som si veriť .	bazéna	5	Masc
Vláda pripraví program zameraný na ekonomický rozvoj , v rámci tohto programu vypracuje podprogramy pre jednotlivé sektory .	program	2	Masc
Na rozdiel od iných nedieľ ma vtedy nečakala vo foyeri .	foyeri	9	Masc
V posledných mesiacoch žiletky patrili medzi nedostatkový tovar .	mesiacoch	2	Masc
Vláda v každom prípade prijme kroky na zvýšenie motivácie rodičov a ich detí študovať , respektíve skutočne plniť povinnú školskú dochádzku .	motivácie	8	Fem
Dnes tu však mali návštevu , sedeli na terase a jedli lahodne rozvoniavajúci ovocný koláč .	koláč	14	Masc
Sloníča sa usmialo .	Sloníča	0	Neut
Cieľom reformy je zastaviť demograficky podmienené zvyšovanie vnútorného dlhu priebežne financovaného dôchodkového systému a zvýšiť zaangažovanosť občanov na svojej životnej úrovni v dôchodkovom veku .	úrovni	20	Fem
Žaba nemohla kričať a had ju prehltol v tichosti .	Žaba	0	Fem
Možnože dievča je jeho členkou !	dievča	1	Neut
Ocitla sa v spleti úzkych uličiek , ktoré sa ponášali ako vajce vajcu .	vajcu	12	Neut
Zjavila sa vo dverách , mala na sebe čierno ‐ bielu uniformu .	uniformu	11	Fem
Posledný szabolcsský kánon , ktorý sa venuje kláštornému životu nariaďuje opátom a mníchom , aby sa nezúčastňovali na kalendových sedeniach , ale aby prijímali oblácie ich účastníkov v kláštoroch .	mníchom	12	Masc
Cieľom reformy je zastaviť demograficky podmienené zvyšovanie vnútorného dlhu priebežne financovaného dôchodkového systému a zvýšiť zaangažovanosť občanov na svojej životnej úrovni v dôchodkovom veku .	zvyšovanie	6	Neut
Toto stieranie hraníc je veľmi príjemné , pokiaľ ide o poriadneho občana , ktorý cestuje za svojím obchodom alebo za svojou dovolenkou .	stieranie	1	Neut
Padol som na kolená .	kolená	3	Neut
Vláda bude naďalej podporovať účasť Ozbrojených síl SR v mierových misiách a operáciách na podporu mieru a na boji proti terorizmu , s dôrazom na operácie pod vedením NATO .	dôrazom	23	Masc
“ Tuším vidím princa Omara , ocko . “	ocko	6	Masc
Takéto oduševnenie stačilo na to , aby som sa zmenil .	oduševnenie	1	Neut
A tak sa pavúčikovia pustili priasť ľan .	pavúčikovia	3	Masc
Keď sme dojedli a mama upratala stôl , rodičia hrávali karty .	rodičia	8	Masc
“ Kamže sa ponáhľate , “ prehovoril pavúk .	pavúk	7	Masc
Než však stačili vzlietnuť , obkolesila ich horda zelených mužíčkov .	mužíčkov	9	Masc
Úzky ružový pás na oblohe ohlasoval príchod nového dňa .	príchod	6	Masc
V niekoľkých sekundách po prebudení sen i spomienka , ktorá ho podnietila , splynuli v jeho mysli v jedno .	spomienka	7	Fem
A prišli naraz , mama do izby a prudký lejak do obloka .	obloka	11	Masc
Čoskoro som však zapochybovala o svojom odhodlaní , lebo pred školou ma dobehol Chris a chytil za ruku .	ruku	17	Fem
Najspokojnejšie však boli pestúnky , lebo im vrátia ukradnuté vajíčka .	vajíčka	9	Neut
Raz to boli gombičky , potom vlnené handry na záplaty a raz šnúrky od topánok ; a teraz to boli žiletky .	žiletky	20	Fem
“ Som včela , pane ! “ zvolala výhražne .	včela	2	Fem
Nie je to môj odbor .	odbor	4	Masc
Nateraz sa uzavrel pred vzdialenejšími zvukmi a počúval len kvákanie , ktoré sa valilo z obrazovky .	obrazovky	15	Fem
Teória „ protorepubliikánskej decentralizácie “ .	decentralizácie	3	Fem
“ Zatváram , “ odvetilo lekno .	lekno	5	Neut
Zber uskutočňoval pomocou siete platených agentov .	siete	3	Fem
Medzi tieto nedovolené zamestnania patrilo i krčmárstvo , ktorého vykonávanie zakázali aj ostrihomskí synodálni otcovia .	vykonávanie	9	Neut
Mauglí rýchlo zaspal na lôžku z lístia , ale Baghíra poúčal Balúa .	lístia	6	Neut
Po vypnutí obrazovky nastalo v miestnosti hrobové ticho .	obrazovky	2	Fem
Jeho nádej opäť zhasínala .	nádej	1	Fem
Prítomnosť nálezov kačacích príveskov sa vysvetľuje tiež importom zo Škandinávie , prostredníctvom nápodoby laponských a karelských kovolejárov .	kovolejárov	16	Masc
Zrejme mala akúsi praktickú ostrieľanosť , ktorá Winstonovi chýbala a podľa všetkého vďaka nespočítateľným spoločenským výletom výborne poznala okolie Londýna .	ostrieľanosť	4	Fem
Svojím typickým gestom si O ' Brien upravil na nose okuliare .	gestom	2	Neut
Všimnime si audiotextové reklamy .	reklamy	3	Fem
Toto spoločenstvo nám poskytlo hlboké zážitky , mnoho podnetov na zamyslenie , mnoho motivácie k modlitbám a pocit Božej prítomnosti .	zážitky	5	Masc
Snažil sa vyliezť po steble trávy hore , ale steblo sa pod jeho váhou nebezpečne naklonilo nabok .	trávy	5	Fem
Z ich tiel nikdy nijaké dieťa nepovstane .	tiel	2	Neut
Dôverujem tomu zasľúbeniu , ktoré som prijala vierou .	zasľúbeniu	2	Neut
Keď vošiel , hluk hlasov zoslabol na polovicu .	hluk	3	Masc
Pred odchodom upchám dieru kusmi vrecoviny .	kusmi	4	Masc
“ Podľa mňa by mal mať šofér právo veta , “ navrhol Rýchlik .	šofér	6	Masc
Bol v tom kus pravdy .	kus	3	Masc
V prípade , ak si poslanci odsúhlasia platených sekretárov , môže sa stať , že " Ringom Čechom " budú poslanci a efekt bude mať sekretár .	poslanci	20	Masc
Chris ma chytil za ruku a kľúčik sme zvierali medzi dlaňami .	ruku	4	Fem
Cez Bibliu sa ako červená niť tiahne hodnota človeka .	hodnota	7	Fem
Ústrednou postavou poviedky aj filmu bola Delina , dedinská učiteľka .	filmu	4	Masc
“ Tento víkend ostanem doma .	víkend	2	Masc
Aktom spojenia sa s takouto bytosťou sa šaman vlastne dostáva na úroveň božských tvorcov .	spojenia	1	Neut
“ Prisahám na svoj včelí život , že môj kamarát stratil pri nehode vedomie a prebral sa iba zázrakom ! “	vedomie	13	Neut
“ Ale to som predsa nechcela ! “ zvolala Lienka , keď predseda súdu vyhlásil rozsudok .	rozsudok	15	Masc
Pred okienkom do pivnice ležal lesklý tvor s červenými očami a nahlas funel .	okienkom	1	Neut
Dieťa rodičov Vnútornej strany sa nenarodilo do Vnútornej strany .	Dieťa	0	Neut
Za jeho stiahnutými mihalnicami sa pohyboval celý les prstov v akomsi tanci , vykrúcal sa a skrúcal , strácal sa jeden za druhým a znova sa objavoval .	les	7	Masc
Súviselo to jednak s už spomenutým rozvinutým fungovaním systému vlastníckych kostolov a kláštorov a jednak s existenciou otónsko - sálskeho ríšskeho cirkevného systému v Nemecku .	fungovaním	7	Neut
Je to kúsok histórie , ktorú zabudli zmeniť .	kúsok	2	Masc
Chvíľu leteli , až pristáli v spustnutej záhrade , kde bola pod obrovskou smutnou vŕbou hlbočizná studňa .	Chvíľu	0	Fem
Ale ani pre myšiaka sa všetko neskončilo .	myšiaka	3	Masc
Marketing je súborom disciplín , ktoré sa zaoberajú trhom a v trhovej ekonomike človek má cenu , ktorá sa vyjadruje len peniazmi .	Marketing	0	Masc
Vtedy mi utkveli v pamäti dátumy , mená i dôležité udalosti z minulosti , medzi ktoré bolo neskôr ľahšie dokladať nové dátumy , mená i vzťahy .	mená	23	Neut
Keď sa však hlasuje v parlamente o zmluve s Vatikánom , zriadení katolíckej univerzity , SNS to podporila . "	parlamente	5	Masc
Triedenie kvalitatívne , podľa druhu nálezu .	nálezu	5	Masc
Koniec rebríka preťal okno a prelomil rám .	rebríka	1	Masc
“ Daj pokoj môjmu mláďaťu ! “ zreval .	pokoj	2	Masc
Tvár mala bledú .	Tvár	0	Fem
Lesné a vodné hospodárstvo	hospodárstvo	3	Neut
Lori popíjala pomarančový džús .	džús	3	Masc
V tej chvíli tréner Augustus zapískal , čím dal znamenie , že dráhy treba uvoľniť na tréning .	tréning	16	Masc
Našla osí roj , ktorý mal včelí palác zničiť .	roj	2	Masc
Tieto kulty a božstvá sú dedičstvom ich rasy , sú dôležitou súčasťou ich každodenného života na vidieku .	dedičstvom	5	Neut
Strana vyzýva jedinca , aby poprel svedectvo vlastných očí a uší .	uší	10	Neut
Na Námestí víťazstva bol Winston ešte pred stanoveným časom .	Námestí	1	Neut
Aj keď vo chvíli , keď sa to stalo , ležal na chrbte , mal čudný pocit , že ho do tejto polohy niečo zrazilo .	pocit	16	Masc
Zaujal výberom tém aj ich spracovaním .	výberom	1	Masc
Okolo pohrebnej jamy boli nájdené stopy stĺpov .	stĺpov	6	Masc
Fil sa svedomito pustil do Herkulovej prípravy .	prípravy	6	Fem
Majine jemné krídelká sa jagali ako perly a zlatisté telíčko na slnku len tak žiarilo .	slnku	11	Neut
Tá správa ma zastihla na dovolenke .	dovolenke	5	Fem
Čiapky a iné prikrývky hlavy	prikrývky	3	Fem
Naučil sa spať s prudkým svetlom na tvári .	svetlom	5	Neut
Takto nevyzerá ani autorka článku , ani kamarátova babka .	autorka	3	Fem
Zrazu Jazmína zastala s otvorenými ústami .	ústami	5	Neut
I keď som mala na sebe jeho bundu , naskočila mi husia koža , ale neuhla som sa .	bundu	7	Fem
Vilko a mravce	mravce	2	Masc
Uvedomuješ si , aká osamotenosť nás potom čaká ?	osamotenosť	4	Fem
Zbehom a pútnikom vo filmoch a knihách trvá návrat do rodnej obce neraz celé desaťročia .	Zbehom	0	Masc
Trendy regionálneho rozvoja vo vyspelých štátoch sú založené na využití vnútorných zdrojov regiónu .	Trendy	0	Masc
Však vieš , že sa tá zbierka robí od domu k domu .	domu	9	Masc
Legislatíva a legislatívny proces	Legislatíva	0	Fem
Áno , jej zmiznutie sa dá vysvetliť jednoducho a logicky .	zmiznutie	3	Neut
ZOO pre mláďatká	mláďatká	2	Neut
Väčšie zlá sústavne unikali ich pozornosti .	zlá	1	Neut
Majino mužstvo zvíťazilo .	mužstvo	1	Neut
Nikde nedajú pokoj .	pokoj	2	Masc
Keď však Winston opravoval pôvodný plán , znížil číslo na 57 miliónov , aby vyhovel bežným požiadavkám na prekročenie kvóty .	kvóty	19	Fem
Vzápätí však na votrelcov zaútočili svietniky , vešiaky , skrine , hodiny a riad .	skrine	9	Fem
Jej tvár vo mne vzbudzovala dôveru : bola to pokojná , vľúdna tvár .	tvár	1	Fem
Ak muža s tvárou umrlca odviedli o polnoci , bolo ráno , ak ráno , bolo popoludnie .	tvárou	3	Fem
Rovnako pri dodaní či vyzdvihnutí fotografií ste ušetrení od úmorného vyčkávania v rade .	dodaní	2	Neut
“ Ty podlý zradca ! “	zradca	3	Masc
O malú chvíľočku si na Mauglího miesto sadla iná opica .	opica	9	Fem
A opäť som zamieril kameru na Lorinu tvár .	tvár	7	Fem
Bol to neuveriteľný pohľad a pripomínal skôr fatamorgánu .	fatamorgánu	7	Fem
Prečo by vlastne tí mimozemšťania mali byť naši priatelia alebo nepriatelia , keď sa vyvíjali s úplne iným backgroundom , v inom kontexte , majú totálne iný spôsob dorozumievania , ich ciele a motivácie nechápeme ?	backgroundom	18	Masc
Vtedy mi pripadalo prirodzené vyhľadať v tme jej ruku .	ruku	8	Fem
Spočiatku som mala nepríjemný pocit , že sa na mňa všetci dívajú , ale trvalo to len moment .	pocit	4	Masc
“ No moment , “ skočila mi do reči Blythe .	reči	8	Fem
Vzápätí však včielka Maja začula iný hlas , oveľa tichší a jemnejší .	včielka	2	Fem
Odvahy a zbabelosti sa to netýka .	Odvahy	0	Fem
Každý zo stupňov svätenia od ordinanda vyžadoval , aby spĺňal príslušné predpoklady na jeho získanie .	ordinanda	5	Masc
Tentoraz to však nebolo hlásenie o vojenskom víťazstve , ale iba oznámenie Ministerstva hojnosti .	Ministerstva	12	Neut
Ráno našla Kasandra chrápajúceho strážcu a prázdnu komoru .	strážcu	4	Masc
Naučil sa spať s prudkým svetlom na tvári .	tvári	7	Fem
Slovenská republika prekonala obdobie spochybňovania demokratických inštitúcií a ohrozovania demokratických slobôd .	ohrozovania	8	Neut
Spal som v taxíku cestou z hotela na letisko .	cestou	4	Fem
Keď profesor Tayerle zahlásil : “ Koniec ! “ odložila som ceruzku .	Koniec	6	Masc
Jeho reliéf bol v mojom vnútri .	reliéf	1	Masc
Pri rešpektovaní špecifík poľnohospodárskej výroby vláda bude podporovať rozvoj voľného trhu s agropotravinovými výrobkami a slobodnú konkurenciu v poľnohospodárskom podnikaní .	rešpektovaní	1	Neut
Miznú tak i zvyšky existencie predkresťanskej náhrady za škodu , nahradzujúce prechodne krvnú pomstu .	náhrady	6	Fem
Trvalo to tri týždne .	týždne	3	Masc
Ak má môj rod zomrieť , tak chcem zomrieť i ja , pomyslela si .	rod	3	Masc
“ Množstvo , “ odvetila mucha .	mucha	5	Fem
Kým komáre krúžili koldokola na kraji lesa , na krajinu pomaličky sadala tma .	lesa	6	Masc
Šer Chán ich počúval zo svojho úkrytu z kroví .	kroví	8	Neut
Obsiahly vlastivedný úvod ( Praefatio ) k Doležalovej gramatike napísal o generáciu starší Matej Bel .	úvod	2	Masc
“ Ticho !	Ticho	1	Neut
Keď preberal znova volant , prikryl mi ruky , ktoré ostali naspodu .	volant	3	Masc
Vypáči z pamäte pána Charringtona zvyšok tej riekanky .	pamäte	2	Fem
Mal deravú pamäť a musel sa pýtať Maji .	pamäť	2	Fem
Zajac mohol byť vykladaný v systéme predkresťanských názorov jednak ako symbol plodnosti / dodnes spájame na veľkú noc vyobrazenia zajacov s vajíčkami , Nemci počas tohto sviatku hľadajú v záhrade vajíčka ukryté veľkonočným zajacom / .	Zajac	0	Masc
Nateraz sa uzavrel pred vzdialenejšími zvukmi a počúval len kvákanie , ktoré sa valilo z obrazovky .	obrazovky	15	Fem
V nedeľu 18 . apríla sa konalo zasadnutie zborového presbyterstva .	zasadnutie	7	Neut
A tak sa na Rusi v tomto období stretávame s uctievaním pohanských bohov v novom rúchu .	rúchu	15	Neut
O chvíľu sa pri nej s hlasným bzučaním usadil komár .	komár	9	Masc
Najväčším bohatstvom SR je jej biologická a krajinná diverzita .	diverzita	8	Fem
S údivom pozeráme na hospodskú .	údivom	1	Masc
Vtom si v prachu na cestičke všimol drobné šľapaje .	šľapaje	8	Fem
Bol ním koncert kresťanskej country skupiny z Batizoviec a okolia .	koncert	2	Masc
“ Chyť volant , “ povedal a otočil sa k zadnému sedadlu , kde mal športový vak .	volant	2	Masc
Spoznal vajíčka na prvý pohľad .	vajíčka	1	Neut
Kráčal chodbou s bielymi kachličkami a mal pocit , že sa prechádza na slnku , v pätách mu kráčal ozbrojený dozorca .	pätách	16	Fem
Samonafukovačky sa pýšia výbornými izolačnými schopnosťami , vysokým komfortom pri ležaní a neprepúšťaním vlhkosti .	neprepúšťaním	12	Neut
Začnem podľa poradia , od fascikla s číslom 1 .	číslom	7	Neut
Tým bola narušená klasická štruktúra ruského mesta s oddeleným posadom a hradiskom .	štruktúra	4	Fem
“ Neskáč ! “ kričali naňho ženy a deti a muži zatiaľ uzatvárali stávky .	muži	10	Masc
A strechu Džahijovej chatrče strhla púštna búrka .	chatrče	3	Fem
“ Správne , “ povzbudzovali ich akrobati .	akrobati	6	Masc
Rodina sa tak v skutočnosti stala predĺženou rukou Ideopolície .	Ideopolície	8	Fem
Profesor Eugen Jóna , ktorý sa dejinami spisovnej slovenčiny dlhé roky zaoberal , si uvedomil potrebu dať do rúk slovenskej i medzinárodnej vedeckej verejnosti dostatočne prístupný skutočný text tohto základného diela .	potrebu	15	Fem
Opantal ho pocit absolútnej bezmocnosti .	bezmocnosti	4	Fem
Iba na bodliaku sa jagali veľké kvapky rosy , lebo sa báli skotúľať do trávy .	bodliaku	2	Masc
“ Spím , “ odvetilo lekno .	lekno	5	Neut
NEVEDOMOSŤ JE SILA .	SILA	2	Fem
Európska únia , čiže rozmieňanie veľkých bankoviek na drobné mince .	bankoviek	6	Fem
Keď som v dráhe zastala a šliapala vodu , zabrzdila som ostatných plavcov .	plavcov	12	Masc
Zdivočenci sa zarazili .	Zdivočenci	0	Masc
Po desiatich dňoch lekárske konzílium posilnili českí lekári .	konzílium	4	Neut
Pre novodobú vedu bola pamiatka objavená v roku 1773 v Archangeľsku V . V . Krestininom v zborníku z prvej polovice 16 storočia .	zborníku	17	Masc
Rovnakú spoluprácu so svetským sudcom predpokladajú v citovaných ustanoveniach aj sledované súdobé cirkevnoprávne príručky .	sudcom	4	Masc
Sadol som si do podniku pri kine a čakal , kým príde určená hodina .	hodina	13	Fem
Až na komára Bzuča .	komára	2	Masc
V tom sne najsilnejší bol pocit sebaklamu , lebo v skutočnosti vedel , čo je za tým temným múrom .	pocit	5	Masc
Napriek svojej rozrušenosti som vytušil , že šéf hrá akúsi hru .	rozrušenosti	2	Fem
Alias svietilňa alebo dokonca valcový vreckový elektrický lampáš .	svietilňa	1	Fem
Poďakovanie na záver konventu :	Poďakovanie	0	Neut
“ Možno by sme to veštenie mohli odložiť , “ navrhol Kalif napokon .	veštenie	5	Neut
“ Určite je to lepšie ako tu , “ vravel Aladin zahĺbený do vlastných myšlienok .	myšlienok	14	Fem
Maja s Vilkom poprisili o kúsok smrčka a statočne ho prežúvali , len aby sa zavďačili hostiteľovi .	smrčka	6	Masc
Spomenul som si na dve veci : na hysterickú eufóriu učiteľov po incidente , pri ktorom sa spomenulo meno mytologického božstva záhrobného sveta .	božstva	20	Neut
Cez kombinézu cítil jej prsníky , zrelé , ale pevné .	prsníky	4	Masc
“ Takto vonia more ? “	more	3	Neut
Dvojtvárnosť trickstera súvisí s celkovým dualizmom , prítomným v systéme prírodného polyteizmu .	polyteizmu	11	Masc
V ľudských obydliach je veľa okien .	obydliach	2	Neut
Chodbu , po ktorej ich viedol , pokrýval jemný koberec , na stenách boli krémové tapety , biele drevené obloženie , všetko neskutočne čisté .	obloženie	19	Neut
Títo Sosolci tiahnú proti Rusom , plienia ruský oporný bod Jurjev a útočia na Pskov .	bod	9	Masc
Vlak bol plný proletov so sviatočnou náladou , ktorú v každom vyvolávalo letné počasie .	náladou	6	Fem
V reformnom hnutí v 10 . a 11 . storočí musíme zreteľne odlíšiť dve základné línie – staršiu reformu monastickú a mladšiu reformu rímsku , resp . pápežskú .	hnutí	2	Neut
“ A teraz mi zaplať ! “ zhúkol na Jazmínu predavač .	predavač	10	Masc
„ Poznajú iba hlad a smäd , lásku a lopotu , sebectvo a skúposť .	hlad	3	Masc
“ Kto je tvoj ocino ? “ spýtal sa Mauglí .	ocino	4	Masc
Naše hlasy sa donekonečna odrážali od orosených skál .	hlasy	1	Masc
Tá myšlienka mu v skutočnosti v mysli skrsla v podobe vidiny , skleného ťažidla , ktoré sa zrkadlilo na povrchu sklápacieho stola .	ťažidla	13	Neut
Moji rodičia sa báli .	rodičia	1	Masc
Literárne činný od roku 1898 , jeho prvá kniha poviedok vyvolala roku 1903 senzáciu — bezpochyby spôsobom stvárnenia i výberom tém .	stvárnenia	17	Neut
1 . zázračné vyberanie obilia a rýb spoza ženských pliec .	vyberanie	3	Neut
Keď som vychádzal z izby , že za ním zájdem a poprosím ho o nejakú radu , opäť som pocítil svrbenie .	izby	4	Fem
Jeho základnými zložkami budú školy odborného výcviku , poddôstojnícka akadémia a akadémia obrany .	školy	4	Fem
Okolo nás pulzovala noc a ozývali sa známe zvuky okolia : tlmený hukot čerpadiel v okolitých bazénoch .	hukot	12	Masc
More postupne zmizlo a ona sa otočila ku mne .	More	0	Neut
Zároveň dochádza k postupnému vyprázdňovaniu symboliky pohanských obyčajov .	symboliky	5	Fem
Mauglí so supmi sa smiali , keď im tiger zmizol z dohľadu .	tiger	8	Masc
Vybudovanie environmentálnej infraštruktúry je nevyhnutnou podmienkou pre vstup do EÚ .	Vybudovanie	0	Neut
Profesor Eugen Jóna , ktorý sa dejinami spisovnej slovenčiny dlhé roky zaoberal , si uvedomil potrebu dať do rúk slovenskej i medzinárodnej vedeckej verejnosti dostatočne prístupný skutočný text tohto základného diela .	dejinami	6	Fem
Flip zvolal obyvateľov lúčky , aby sa prišli s kamarátom rozlúčiť .	kamarátom	9	Masc
V tom sne najsilnejší bol pocit sebaklamu , lebo v skutočnosti vedel , čo je za tým temným múrom .	sebaklamu	6	Masc
V izbe boli tri skupiny kondolujúcich .	izbe	1	Fem
Rovnakého problému sa týka i posledný z ostrihomských kánonov , ktorý sa venuje vlastnému ordinačnému právu .	právu	15	Neut
Sopky vreli , vyčíňali búrky a zemetrasenia , svet bol plný zmätku a veľkého zdesenia .	zemetrasenia	6	Neut
“ Za krásavicou Veronikou . “	krásavicou	2	Fem
V tom sne najsilnejší bol pocit sebaklamu , lebo v skutočnosti vedel , čo je za tým temným múrom .	múrom	18	Masc
Do chrobákovho obydlia dopadalo tlmené červené svetlo a sladká vôňa bola oveľa prenikavejšia .	obydlia	2	Neut
Práve sa chystala roztiahnuť krídla a vzlietnuť , keď v tieni steny zbadala strážcu .	strážcu	13	Masc
Už dávno sa s nimi nehrám , ale ani vo sne by mi nenapadlo , aby som ich vyhodila .	sne	10	Masc
Vzhľadom na vytrvalosť , akú prejavoval , som očakával , že takto zaboduje .	Vzhľadom	0	Masc
“ Stavím sa , že je to bytosť z inej planéty , “ zašepkala Maja a zatiaľ čo sakamaráti skrývali za jej chrbtom , podišla bližšie a navrhla neznámemu prehliadku Makovej lúky .	prehliadku	29	Fem
Čo sa týka vzťahov Novgorodcov a podmanených ugro ‐ fínskych plemien , formálne podriadené kmene si zachovávali značnú dávku nezávislosti .	plemien	10	Neut
Chodili jej normálnou poštou do školy , kde učila .	školy	5	Fem
Asi verili svojim po zuby ozbrojeným bojovníkom , pred ktorými sa všetci trasú .	zuby	4	Masc
Pocítil som jemný dotyk jej prstov .	prstov	5	Masc
Otvorila som okno a zazrela na Chrisa .	okno	2	Neut
Nová však bola energia , s akou tieto požiadavky nastoľovali a nová bola aj prísnosť trestov za nerešpektovanie týchto požiadaviek .	nerešpektovanie	17	Neut
“ Spomínaš na tú rozprávku , čo ti mama rozprávala , keď si nemohla zaspať ? “	rozprávku	4	Fem
Miatla ho vôňa povetria i zeleň lístia .	lístia	6	Neut
Vytvorí mechanizmy na získavanie a vyhodnocovanie informácií a odhaľovanie týchto prípadov .	informácií	6	Fem
Zrazu však vyšľahli obrovské plamene a vyrazili princovi štít z ruky .	princovi	7	Masc
Napokon vstal , tackavo a hojdavo prešiel celou , hlboko ponoril ruku do vrecka na kombinéze a s rozpačitým výrazom podal mužovi s umrlčou tvárou ufúľaný kúsok chleba .	výrazom	19	Masc
Činnosť nášho združenia zatisli do pozadia iné potreby .	združenia	2	Neut
Ochrana kultúrneho dedičstva a duševného vlastníctva	dedičstva	2	Neut
Pohltili ich autá .	autá	2	Neut
“ Džungľa preňho nie je vhodným miestom . “	Džungľa	1	Fem
Vytrhol sa z pavúčej priadze takou silou , že nič netušiaceho pavúka s ôsmimi nohami prevrátilo horeznačky .	priadze	4	Fem
Keď vystúpila z pásma žltkastého svitu a na chvíľu zastala na rozhraní medzi svetlom a temnotou , nemyslel som na to , že ide priamo ku mne , aby napravila chybnú interpretáciu vecí , ktorú vyprodukoval môj mozog .	svitu	5	Masc
Nemala inú možnosť , keď jej Roger odmietol šteniatka predať .	šteniatka	8	Neut
Osobitnú pozornosť bude vláda venovať vytváraniu podmienok pre činnosť Hasičského a záchranného zboru ako základnej zložky integrovaného záchranného systému .	zložky	15	Fem
Náš dnešný spisovný jazyk je skutočným kompromisom medzi radikálnou normou štúrovcov a požiadavkami bernolákovcov i tradíciou českou či československou .	kompromisom	6	Masc
Prijatie novely zákona o štátnej službe umožní okrem iného zamestnanie špičkových odborníkov v ústredných štátnych orgánoch za adekvátneho mzdového ohodnotenia a odstráni nepružnosť zamestnávania v štátnej službe .	Prijatie	0	Neut
Ako teda vysvetliť , že žobráci touto zónou opovrhujú ?	žobráci	5	Masc
Porota však ocenila práce slimákov Šuchtáka a Plazivca , ktorý si prekrásne vymaľovali domčeky .	Porota	0	Fem
Večer už boli unavení a z meravého sedenia ich bolel vzadu krk .	sedenia	7	Neut
Isteže , už dnes nejestvuje dôvod či opodstatnenie na páchanie ideozločinov .	opodstatnenie	7	Neut
S cieľom zefektívnenia správy rozpočtových prostriedkov a správy finančných prostriedkov štátu vláda uskutoční kroky na urýchlené dobudovanie systému štátnej pokladnice .	pokladnice	19	Fem
Biblia nie je v rozpore s vedeckými objavmi .	rozpore	4	Masc
A tak sa na Rusi v tomto období stretávame s uctievaním pohanských bohov v novom rúchu .	uctievaním	10	Neut
To vie len múdra rosnička .	rosnička	4	Fem
Vzápätí sa vynoril Zlatoň a držal si hrču na čele .	čele	9	Neut
Dosadzovanie duchovných do úradov laikmi bolo bežnou praxou raného stredoveku .	duchovných	1	Masc
Telo by malo mať šiju Jenny Elfman , ramená Courtney Love , zadok Jennifer Lopez , pupok Sandry Bullock a nohy Miry Sorvino .	zadok	12	Masc
Som spokojný so značkou " spoľahlivý , rovnocenný , monogamný vzťah " .	značkou	3	Fem
Znak potom môžme vykladať ako zobrazenie vtáka s roztiahnutými krídlami a hlavou vysunutou dopredu .	hlavou	11	Fem
Mohutná posteľ pri okne bola zastlaná dotrhanými prikrývkami a na poduške chýbala obliečka .	obliečka	12	Fem
Lístok do kina ?	kina	2	Neut
“ Pero alebo mostík cez palubu ? “	mostík	3	Masc
Bolo by hanba predstúpiť pred žiakov v takom stave .	žiakov	5	Masc
Maja zaletela na breh , aby si na chvíľu odpočinula .	breh	3	Masc
Sme nepriatelia Strany .	Strany	2	Fem
K tomu sa podávalo trnkové víno a deťom ponúkli fialovú malinovku .	deťom	7	Neut
Pri štvrtej obrátke sa mi stužka s kľúčikom z krku vyvliekla .	kľúčikom	7	Masc
Jeho kult sa spájal s kultom Poseidóna .	kultom	5	Masc
Pre Lulu prišla po hre najobľúbenejšia časť dňa . . . obed !	hre	4	Fem
Nôž by mal minimálne obsahovať : veľkú a malú čepeľ , otvárač na fľaše a konzervy , rydlo , výhodné je , ak obsahuje dierovač , pílku na drevo , vývrtku , pinzetu .	drevo	28	Neut
Namiesto veľkého podnosu niesla malú tácku , na ktorej bola len jedna šálka s kávou a jeden pohár s rakijou .	kávou	14	Fem
Z týchto vzájomných kontaktov totiž vyplývajú isté indície o tom , do akej miery mohli byť myšlienky rímskych reformátorov recipované uhorskou cirkvou a jej zákonodarstvom .	kontaktov	3	Masc
Predavač zdrapil Aladina .	Predavač	0	Masc
Mamu som zbadala na rovine , keď sa na nebi zablyslo a rozľahol sa mocný hrom .	nebi	9	Neut
Gaston od úžasu onemel , keď uvidel , ako Bela cvála na koni cez kamenný most .	most	15	Masc
Usadili sme sa na pohovke a z kuchyne sme počuli tikanie hodín na rúre .	rúre	13	Fem
A najpevnejšou niťou bude niektorá televízna stanica .	niťou	2	Fem
Vo svojej džungli nijaké ľudské mláďa nestrpím ! “	džungli	2	Fem
Keď som mala bundu na sebe , zistila som , že ju nepotrebujem .	bundu	3	Fem
Dostal novú spodnú bielizeň a čistú súpravu kombinézy .	súpravu	6	Fem
Od tých čias bola mojím najvzácnejším pokladom , i keď miestami zodratým , ale na okrajoch som cítila šampónovú vôňu jeho vlasov .	vlasov	21	Masc
Nilus bol skôr predstaviteľom východného typu mnícha , v osobe ktorého sa spájala vysoká miera asketizmu s rovnako vysokou úrovňou vzdelanosti a kvality duchovného života .	kvality	22	Fem
Nálezy pečatí umožňujú určiť autorstvo , pravosť a čas vzniku dokumentu , dopĺňajú tak informácie o ňom .	dokumentu	10	Masc
Nenadarmo platí " Sýty hladnému neverí " a zároveň neexistuje žiadne porekadlo typu " Ukojený nadržanému neverí " .	porekadlo	11	Neut
Vláda predloží zákon o zdravotníckych povolaniach a zariadeniach definujúci úlohy poskytovateľov a zdravotníckych pracovníkov .	povolaniach	5	Neut
Blízka existencia dvoch stredísk rozdielnych národov svedčí o možnosti ich vzájomného ovplyvňovania , o etnickej nerovnorodosti základu , z ktorého vznikol Rostov .	nerovnorodosti	15	Fem
Prerušilo ju ohlušujúce chrčanie .	chrčanie	3	Neut
Keď som jej zapaľoval cigaretu , prebehla mnou vlna zlosti .	vlna	8	Fem
Zato na perách mal akýsi poprašok .	poprašok	5	Masc
Moje chorľavé srdce ! “ zvolala .	srdce	2	Neut
“ Ty chceš ísť na túru ? “ spýtala som sa a pozrela na hodinky .	túru	5	Fem
Zobudilo ma zvonenie telefónu .	zvonenie	2	Neut
Bolo sivé popoludnie s oblohou veštiacou sneh , keď sa človeka zmocňuje ubíjajúca otupnosť a uvoľnenie prináša len alkohol .	človeka	10	Masc
Celkové dojmy z výletu ?	dojmy	1	Masc
Vlak bol plný proletov so sviatočnou náladou , ktorú v každom vyvolávalo letné počasie .	Vlak	0	Masc
Tohto pocitu som sa nezbavil ani v triede .	triede	7	Fem
Spytovaní náhodní chodci i sociológovia a ďalší odborníci sa vzácne zhodli .	chodci	2	Masc
Regula metského biskupa podrobne ustanovuje i podmienky prijatia do spoločenstva kanonikov a v rámci nich predpisuje pre kandidáta povinnosť odovzdať všetok majetok kostolu , pri ktorom mieni pôsobiť .	prijatia	7	Neut
Priplietol sa tam iný blázon : Plné gate .	blázon	4	Masc
Potom zlezie zo stromu a uteká domov . . .	stromu	3	Masc
Mravce roztiahli plachtu a razom všetko stíchlo .	plachtu	2	Fem
Ten sa mu bude hodiť do bábkového divadla !	divadla	7	Neut
Tú reláciu som zbožňovala .	reláciu	1	Fem
Hlas trúbky rozpútal mohutný huriavk .	trúbky	1	Fem
Prehľadal som vrecká na všetkých sakách a vo vnútornom vrecku jedného z kabátov som našiel fotografiu ženy .	fotografiu	15	Fem
Kačka bola u ugrofínskeho národa Mordovcov posvätným zvieraťom .	zvieraťom	7	Neut
Keď zbadal , že mám poloprázdny pohár , hneď mi dolial .	pohár	6	Masc
Zastupiteľstvo súhlasilo s umiestnením vo vojenskom kostole .	umiestnením	3	Neut
Máme celé popoludnie .	popoludnie	2	Neut
Ale pozor bez povrázkov !	povrázkov	3	Masc
S hrôzou som otvoril oči : zvonil telefón .	telefón	7	Masc
Hmotným blahobytom ( chlebom ) , mocou a pýchou .	pýchou	8	Fem
Rozoberané nepokoje sa odohrávajú v Beloozere , Novgorode , Suzdali , roku 1091 sa objavuje volchv i v Rostove .	volchv	15	Masc
Bola jeho životom , jeho smrťou , jeho zmŕtvychvstaním .	zmŕtvychvstaním	8	Neut
“ Vy máte šťastie ! “ povedala mora Maji , lebo vedela , čo znamená stretnutie so škriatkom kvetov .	šťastie	3	Neut
Predovšetkým doktorovo správanie .	správanie	2	Neut
Keďže sa prvýkrát vyskytuje počas Jaroslavovho námestníctva v Novgorode , nie je vylúčená možnosť nápodoby všemocného novgorodského vodného jaštera .	námestníctva	6	Neut
Slnečný svit , ktorý prenikal nespočetným lístím , ich ešte stále pálil na tvárach .	lístím	6	Neut
Už jej vzhľad mu naháňal hrôzu , a nielen vedomie , že je to on .	vzhľad	2	Masc
Čakal som , kým zaparkuje auto , a potom sme išli do kaviarne pri ceste .	kaviarne	12	Fem
Vybrala najligotavejšie jabĺčko a podala ho chlapcovi .	jabĺčko	2	Neut
Chuchlík v maštali a na cvičisku	maštali	2	Fem
Vyvoláva pokušenie .	pokušenie	1	Neut
Tento letopis bol paralelou cyklu bylín o Vladimírovi .	bylín	5	Fem
Zovrel ju v náručí a vtedy zistil , že bozkáva živú , teplú tvár .	náručí	3	Neut
Terapia nezabrala .	Terapia	0	Fem
Presne takúto podobu , teda jednoduché príkazy či predpisy , majú i príslušné nariadenia v sledovaných kánonickoprávnych zbierkach .	predpisy	8	Masc
Dnes stojí súsošie bez podstavca provizórne na dvore evanjelickej fary medzi detskými preliezačkami .	súsošie	2	Neut
Hľadala som v zásuvke nejaký papier na poznámky , keď som zbadala formulár na udelenie finančnej podpory počas štúdia na vysokej , ktorý mi dal ešte pred niekoľkými týždňami výchovný poradca pán Hatch .	zásuvke	3	Fem
Skupina kánonov I . ostrihomskej synody sa venuje stanoveniu obsahu bohoslužieb a príbuzným kultovým predpisom .	stanoveniu	8	Neut
“ Nijaké záhady sa nekonajú , “ odvetil Chris .	záhady	2	Fem
Po drevenom schodišti som zišiel do salóna na prízemí .	prízemí	8	Neut
Otrokársky generál sa spamätal až po hodnej chvíli .	generál	1	Masc
Podala Aladinovi mincu .	mincu	2	Fem
O týždeň sme sa dozvedeli , že ju na rok vylúčili z fakulty .	týždeň	1	Masc
Stala si na kameň a začala vrzúkať .	kameň	3	Masc
Toto pápežské privilégium bolo vlastne uznaním , že Cluny sú centrom okolo neho vytvorenej skupiny kláštorov , teda právnym podkladom existencie takéhoto spoločenstva rehoľných domov .	uznaním	5	Neut
Vládol tam smiech , spev a veselie .	veselie	6	Neut
Ťarbavo sa pohyboval po javisku a nevedel sa naučiť úlohu .	javisku	4	Neut
Pôvodný scenár : Zamilovaný Shakespeare	scenár	1	Masc
Odvliekla princa na svoj zámok a uvrhla ho do temnice .	temnice	9	Fem
Ide o unikátny nález brezovej listiny v karelčine , s využitím ruskej abecedy .	využitím	10	Neut
Prikázali mi , aby som bol na druhý deň okolo poludnia v hotelovej hale , odkiaľ pôjdeme do kostola na svadobný obrad .	poludnia	10	Neut
S pocitom prihlúpleho vidiečana som prešiel po asfaltovej ceste , ktorá viedla k zhluku novopostavených budov .	budov	15	Fem
Vzájomné porovnanie takto vytvorených jednotiek umožní plastickejší pohľad na danú problematiku a odhalí nové súvislosti dávno známych faktov .	faktov	17	Masc
Zavedie štátnu maturitnú skúšku na stredných školách .	skúšku	3	Fem
Otvorila okienko , akože naňho zakričí , ale vzápätí si to rozmyslela .	okienko	1	Neut
Vytvoríme kapitálotvornú vrstvu , ktorá bude zárukou blaha ľudu , presvedčivo hlásal tvorca blaha svojich prívržencov .	zárukou	6	Fem
Drobná žena s pieskovými vlasmi zružovela a ústa otvárala a zatvárala ako ryba na suchu .	vlasmi	4	Masc
Bez jediného uhra .	uhra	2	Masc
Vláda bude klásť dôraz na racionalizáciu nákladov spojených s realizáciou výkonov vo verejnom záujme v železničnej osobnej doprave a verejnej autobusovej doprave .	výkonov	10	Masc
Zmeny budú navrhnuté v súlade s európskou legislatívou tak , aby tieto zákony neboli prekážkou zvyšovania zamestnanosti a ekonomického rastu a zvýšili flexibilitu trhu práce .	legislatívou	7	Fem
Nakoniec som jej povedal , že má pravdu , náš nový pokus bol bláznovstvom .	bláznovstvom	13	Neut
O ' Brien mu položil ruku na rameno takmer priateľsky .	rameno	7	Neut
Zaštebotal dobrý deň a cmukol mužovi na líce veľký uslintaný bozk .	líce	7	Neut
Bolo tu pododdelenie televíznych programov s inžiniermi , producentmi a s celými tímami špeciálne vybraných hercov , lebo dokázali imitovať hlasy .	producentmi	8	Masc
Celá sa triasla , sotva vládala stáť na nohách .	nohách	8	Fem
Na lúke postávali skupinky rozčúlených obyvateľov .	lúke	1	Fem
Pokým nás kryjú tieto konáre , sme v bezpečí . "	bezpečí	8	Neut
Človek očakával , že ho zabijú .	Človek	0	Masc
Na hlave mal klobúk a na krídlach vzácny vzor .	vzor	8	Masc
Winston i Syme postrčili svoje podnosy k okienku .	okienku	7	Neut
Tekla sedela prikrčená v kúte a zlomyseľne pozorovala jej márne úsilie .	kúte	4	Masc
Vláda zabezpečí prepojenie národného obranného plánovania s obranným plánovaním NATO .	plánovania	5	Neut
Pod ním bola na fotografii Cruellina priateľka Anita , jej manžel Roger a ich kuchárka .	manžel	10	Masc
To je krása !	krása	2	Fem
“ Môžem byť vaším kapitánom ? “ spýtala sa .	kapitánom	4	Masc
Ľudská postava vcelku s kniežacou čiapkou , alebo korunou držiacou atribúty moci .	korunou	8	Fem
Ja to viem , prehovoril som po dlhom váhaní .	váhaní	8	Neut
Súčasné ľudské poznanie je na veľmi vysokej úrovni , stojí na prahu klonovania nového života .	úrovni	7	Fem
Na chvíľu som sa započúval do ticha na schodišti .	schodišti	8	Neut
Na príjazdovej ceste pred Taco Villa stál dlhočizný rad áut , v ktorých sedeli decká z našej školy .	školy	17	Fem
Na bielizníku mi nechala odkaz : “ Dúfam , že si sa dobre bavila , srdiečko . “	bielizníku	1	Masc
Ilúzia takejto taktiky netrvala dlho .	taktiky	2	Fem
Za týchto okolností bola akási tenká strieborná retiazka na jej krku celkom bezvýznamná .	krku	10	Masc
Nespomínali moje ruské dobrodružstvo .	dobrodružstvo	3	Neut
Formálne dodržiavaným zvykom je aj skrývanie moslimských žien .	skrývanie	5	Neut
Vláda podporí doriešenie vlastníckych vzťahov k pôde a rozvoj trhu s pôdou .	doriešenie	2	Neut
Spory spoločenstva a okolia .	spoločenstva	1	Neut
Nemal najmenšie pokušenie jej klamať .	pokušenie	2	Neut
V Studiofilme sa povrávalo , že šéfa čochvíľa odvolajú ; označovali ho za liberálneho modernistu a bolo iróniou osudu , že najostrejšie na neho útočil týždenník Október .	týždenník	25	Masc
V skutočnosti to nebola nijaká vila .	vila	5	Fem
Keďže ide o individuálnu záležitosť , škola v tomto dieťaťu veľmi nepomôže .	dieťaťu	9	Neut
Jeho ruka potajomky vkĺzla do čižmy .	ruka	1	Fem
Ako mala vo zvyku v takýchto prípadoch , povedala mi , aby som išiel do svojej izby .	izby	16	Fem
Čašník priniesol druhú whisky .	whisky	3	Fem
Brána sa opäť zachvela pod úderom baranidla .	baranidla	6	Neut
Chris sa obrátil a zbadal , že naňho pozerám , akoby mi čítal myšlienky .	myšlienky	13	Fem
Vtom sa z opačného smeru objavil Plné gate .	smeru	4	Masc
Bucka ( Petronila ) zalomila krídlami .	krídlami	5	Neut
Vláda prehodnotí doterajší spôsob podpory malého a stredného podnikania s akcentom na územnú samosprávu a prihraničnú spoluprácu .	podnikania	8	Neut
Mám ženu a tri deti .	ženu	1	Fem
“ Amy , “ povedal a jemne ma chytil za lakeť .	lakeť	10	Masc
Ostalo aj pre mamičku .	mamičku	3	Fem
Po putovaní rôznymi bratislavskými krčmami sa slovenské večery vrátili do Véčka .	večery	7	Masc
Na príjazdovej ceste pred Taco Villa stál dlhočizný rad áut , v ktorých sedeli decká z našej školy .	áut	9	Neut
Poviedky typu Sexuálny nenásytník ani eseje ako Esej o vši nemali budúcnosť .	budúcnosť	11	Fem
“ Narušujú morálku našich detí , “ kričal do mikrofónu .	mikrofónu	9	Masc
“ Kino ? “ navrhla som nepresvedčivo a uprene som sa dívala na sedadlo pred sebou .	sedadlo	13	Neut
Raňajky sa podávajú na prízemí , do deviatej .	prízemí	4	Neut
Od toho času neznášam zvonenie budíka .	zvonenie	4	Neut
Pred domom kuny Chytráčky viali pestré slepačie perá , Alfonz vystavoval lesklú kukuricu a kliešťak Drakula voňavé krvavé klobásky .	kuny	2	Fem
Pozrela som pod seba a zacítila v žalúdku šteklivé vzrušenie .	vzrušenie	9	Neut
Iba na bodliaku sa jagali veľké kvapky rosy , lebo sa báli skotúľať do trávy .	rosy	7	Fem
Rutherford mal mohutnú postavu , hrivu mastných , sivých vlasov , zjazvenú tvár s vačkami pod očami a hrubé negroidné pery .	tvár	12	Fem
Winston ihneď vyplatil štyri doláre a zasunul si vysnívanú vecičku do vrecka .	vecičku	9	Fem
V tej chvíli tréner Augustus zapískal , čím dal znamenie , že dráhy treba uvoľniť na tréning .	znamenie	9	Neut
Položil mi poslednú otázku .	otázku	3	Fem
Hook sa otočil k pirátovi Smíovi a posmešne napodobnil dievčatko .	dievčatko	9	Neut
Potom začul ďalší zvuk — ľudské hlasy !	hlasy	6	Masc
Zrazu sa nad ňou ktosi tichučko zasmial a akýsi hlások sa jej spýtal : “ Prečo sa bavíte so bzdochou ? “	hlások	9	Masc
Vláda vytvorí legislatívne a ekonomické podmienky pre ochranu a sprístupnenie audiovizuálneho dedičstva v súlade s príslušnými medzinárodnými dohovormi .	sprístupnenie	9	Neut
Pred voľbami bolo – v neposlednom rade v Mostoch – mnoho krásnych vzletných výkladov , prečo treba voliť Martina Bútoru .	voľbami	1	Fem
Niekedy sú moje znamenia klamné . “	znamenia	3	Neut
Pocítil som na hrudi tlak jej pevných okrúhlych pŕs .	pŕs	8	Neut
“ Dnes určite stretnem človeka ! “ volala naradostene .	človeka	4	Masc
Náš dnešný spisovný jazyk je skutočným kompromisom medzi radikálnou normou štúrovcov a požiadavkami bernolákovcov i tradíciou českou či československou .	požiadavkami	12	Fem
Zostal som sedieť v kresle , aj keď sa dvere otvorili a do miestnosti vošli dvaja muži , nové tváre .	kresle	4	Neut
Vtedy nás poslali na brigádu do Jonufëru pri Vlore , kde sme mesiac budovali terasové polia .	polia	15	Neut
Kvôli nutnosti ich lepšieho uchopenia je potrebné vopred určiť , z akého hľadiska budeme pramene skúmať .	uchopenia	4	Neut
V ušiach mi zostala len ozvena jeho hlasu a v diaľke , na úpätí podstavca bez sochy , som uvidel Háda .	diaľke	10	Fem
Potom oko zasa zatvorilo .	oko	1	Neut
Najťažší trest postihuje opäť kňazov , ktorí sa dopustili bigamie .	bigamie	9	Neut
o Herkulovu slávu sa s vami podelíme .	slávu	2	Fem
Moje oči márne hľadali pri okne so železnými prútmi nejaký rám s oficiálnym portrétom .	okne	5	Neut
Chodia vôbec do školy ?	školy	3	Fem
Avšak rodine malého paviána sa nepáčilo , ako sa Jane správa k ich mláďaťu a nazlostení začali dievčinu prenasledovať .	paviána	3	Masc
Vypil som už polovicu fľaše s koňakom , keď sa objavila vo dverách .	dverách	12	Fem
Blythe plesla rukou po sedadle a otočila sa ku mne .	sedadle	4	Neut
Namiesto toho sa predo mnou opäť zjavila Lorina tvár .	tvár	8	Fem
Na letisko nás prišiel čakať Sergejov priateľ .	priateľ	6	Masc
Pri každom kine , divadle , klube je aj jeho adresa a telefón .	divadle	4	Neut
“ Bude tam titulok : Slávna rekordérka fotografuje reportérov , “ povedala Blythe .	reportérov	8	Masc
Jedného dňa povysávala všetky kancelárie s vypnutým vysávačom .	kancelárie	4	Fem
Táto imunita ( nenarušiteľnosť ) sa potom vzťahovala aj na všetkých ľudí , ktorí sa v objekte zdržiavali .	nenarušiteľnosť	3	Fem
Slovenská republika sa nachádza v tomto globálnom bezpečnostnom prostredí .	prostredí	8	Neut
Vytvoríme kapitálotvornú vrstvu , ktorá bude zárukou blaha ľudu , presvedčivo hlásal tvorca blaha svojich prívržencov .	ľudu	8	Masc
Právo na prístup ku kultúrnym hodnotám je jedným z dôležitých práv všetkých občanov .	práv	10	Neut
Mladá žena sa usmiala a na lícach sa jej urobili jamky .	lícach	6	Neut
Bolo to beznádejné , nedokázal sa zdvihnúť ani o centimeter .	centimeter	9	Masc
Niektorí sa nazdávali , že drevorubač konal správne .	drevorubač	5	Masc
Aladin však strčil nohu do dverí .	nohu	3	Fem
Z čiernej nočnej oblohy sa spustil lejak .	oblohy	3	Fem
O týždeň sme sa dozvedeli , že ju na rok vylúčili z fakulty .	fakulty	12	Fem
Z maku vyšlo ako z lesa drobučké dievčatko .	lesa	5	Masc
Spokojne som sedela na trávniku pred domom , vdychovala eukalyptovú vôňu a chladnejší vzduch i sledovala som , ako nado mnou vetrík povieva palmovými listami .	trávniku	4	Masc
Vytrhol som mu ho a opäť som ho vypil až do dna .	dna	11	Neut
Začali sme na kolotočoch , kde sme vyliezli na koňa .	kolotočoch	3	Masc
“ Neskáč ! “ kričali naňho ženy a deti a muži zatiaľ uzatvárali stávky .	stávky	13	Fem
Komár unudene pozrel do trávy .	trávy	4	Fem
Poľsko bude reprezentovať Wojciech J . Has , Českú republiku Jan Švankmajer a Slovensko Štefan Uher .	republiku	9	Fem
Okolo hučal a bzučal najrôznejší hmyz a v stromoch na plné hrdlo vyspevovali vtáci .	hrdlo	11	Neut
Moja mama sa mi naozaj snaží vyjsť v ústrety .	mama	1	Fem
ZLÁ VÍLA NETRPEZLIVO ČAKALA NA ZÁPAD SLNKA vo vlhkých tmavých rozvalinách kamenného hradu , ktorý stál na vysokom brale .	SLNKA	6	Neut
Shannon s Waynom sa hrabali vo vreckách , aby dali dokopy drobáky na prvú pizzu .	drobáky	11	Masc
S očividným uspokojením dokázal rozprávať o náletoch vrtuľníkov na nepriateľské dediny , o procesoch s ideozločincami , o ich priznaniach a o popravách v katakombách Ministerstva lásky .	priznaniach	19	Neut
Toto pápežské privilégium bolo vlastne uznaním , že Cluny sú centrom okolo neho vytvorenej skupiny kláštorov , teda právnym podkladom existencie takéhoto spoločenstva rehoľných domov .	privilégium	2	Neut
„ Poznajú iba hlad a smäd , lásku a lopotu , sebectvo a skúposť .	sebectvo	11	Neut
Vonku zaznel dupot ťažkých čižiem .	čižiem	4	Fem
Do horúcich pekiel , pomyslel si .	pekiel	2	Neut
Vláda bude využívať štátne záruky iba v nevyhnutných prípadoch na prefinancovanie splatných úverov so štátnymi zárukami , ak to umožní zákon o štátnej pomoci a ak hrozí realizácia záruk z prostriedkov verejných financií .	zárukami	15	Fem
Žije šťastne , nemá povinnosti a nič jej nechýba .	povinnosti	4	Fem
Opustená strecha , kde bývali , bola na severe od trhoviska .	severe	8	Masc
V súlade s európskym trendom budeme podporovať rozširovanie výmery ekologického poľnohospodárstva a výroby biopotravín .	poľnohospodárstva	10	Neut
Pelikánia slečna Polly má veľký zobák a veľmi sa jej nepáči .	zobák	5	Masc
Sudcovi sa jej smelosť páčila , a tak súhlasil .	Sudcovi	0	Masc
Lietajúca lavica ?	lavica	1	Fem
SLOBODA JE OTROCTVO	OTROCTVO	2	Neut
Dom bol v predstave vtedajších ľudí akýmsi mikrokozmom , svetom samým osebe s prepracovaným systémom magickej obrany pred zlými silami vonku .	systémom	14	Masc
Myslím však , že vysoká škola má dve významné úlohy , ktoré so spomínanou rovnicou priamo nesúvisia .	rovnicou	14	Fem
V oblasti nemocenského poistenia prijme vláda opatrenia zamedzujúce zneužívaniu systému .	zneužívaniu	8	Neut
Nevidieť tú reláciu , povedal by som spolu s Freudom , že za všetkým je sexuálne pudenie , ale tých dvadsať minút mi otvorilo oči .	pudenie	16	Neut
Človeka to bohvieako nezaujímalo , popíjal z pohára a škriabal na papier tie svoje znaky .	pohára	7	Masc
Kúsok chleba ešte stále ležal tam , kam ho odhodil muž bez brady .	brady	12	Fem
K tejto problematike patria podľa nášho názoru i právne normy , ktoré upravujú niektoré procesné záležitosti .	názoru	6	Masc
Maja vedela , že blízko úľa je veľké mravenisko .	mravenisko	8	Neut
Výučbu tancov povedie Jano Blaho , dôstojný nástupca Štefana Nosáľa na poste choreografa Lúčnice .	choreografa	12	Masc
Princ Filip prebehol bránou do paláca .	bránou	3	Fem
v prioritných oblastiach verejného záujmu musí byť verejný sektor schopný konkurovať súkromnému sektoru pri získavaní a udržaní kvalitných ľudských zdrojov	získavaní	14	Neut
Vláda vypracuje a realizuje projekt transformácie štátnych podnikov lesného hospodárstva v pôsobnosti Ministerstva pôdohospodárstva SR na štátnu akciovú spoločnosť založenú podľa osobitného zákona .	pôdohospodárstva	13	Neut
Začali sme na kolotočoch , kde sme vyliezli na koňa .	koňa	9	Masc
Bez vyzvania im čašník priniesol ďalšie poháriky s džinom .	vyzvania	1	Neut
Najprv sme sa pomaly a opatrne zakrádali k ich domu , ale potom sme prebiehali od lampy k lampe .	lampe	18	Fem
“ Prv ako som dopovedala , zmocnili sa ma výčitky , že som mala byť inde a venovať sa učeniu .	učeniu	19	Neut
Nechala dole pred domom auto .	domom	3	Masc
Ich obvinenia ma trápili .	obvinenia	1	Neut
Zbadala ho na steble trávy , práve z orlíčka popíjal sladký nektár .	steble	3	Neut
Halogénové žiarovky sú výhodou .	výhodou	3	Fem
Winston si zopäl ruky nad hlavou .	ruky	3	Fem
Pokľakol pred ňou a vzal jej ruky do svojich .	ruky	6	Fem
Stotožňovaná s Mokošou ako s bohyňou viacerých funkcií nadobúdala i viacero podôb .	bohyňou	5	Fem
Nijaký cit nie je čistý , pretože všetko je zmiešané so strachom a nenávisťou .	cit	1	Masc
Nachádzala sa tam kancelária šéfa televízie Sírius .	kancelária	3	Fem
" Nechápeš , že jediným cieľom newspeaku je zúžiť rozsah myslenia ?	rozsah	9	Masc
Ohlasy tohto splývania sa zachovali v neoficiálnom podaní legiend a príbehov , tradovaných z generácie na generáciu a neskôr zachytených v Pateriku .	splývania	2	Neut
Zišlo mu na um , že až doteraz ho zrejme nevidela na voľnom priestranstve v plnom dennom svetle .	priestranstve	13	Neut
Plávanie je môj najobľúbenejší šport .	Plávanie	0	Neut
V ústach cítil lepkavú a odpornú pachuť .	ústach	1	Neut
Medzi Ladislavovými zákonmi máme cirkevnú sankciu doloženú v prípade zabitia nevernej ženy a znásilnenia .	znásilnenia	13	Neut
Winston usúdil , že nepostačí iba zmeniť zmysel prejavu Veľkého brata .	prejavu	8	Masc
Ďalšiu polovicu som odhodil do kontajnera pri sedačke .	sedačke	7	Fem
“ Hromy a blesky privej !	blesky	3	Masc
Smutným hlasom im Kasandra oznámila , že v noci navšítvili komoru s medom zlodeji a spôsobili im veľkú škodu .	komoru	10	Fem
Jej priebeh je možné zrekonštruovať zhruba takto — Pred obradom samotným bolo postavené obetisko s pôdorysom štvoruholníka so štyrmi stĺpmi v rohoch .	rohoch	21	Masc
Z maku vyšlo ako z lesa drobučké dievčatko .	maku	1	Masc
Po dlhom období dažďov vykúklo opäť slniečko .	slniečko	6	Neut
Vlčia rodinka prijala ľudské mláďa .	rodinka	1	Fem
Vzápätí však na votrelcov zaútočili svietniky , vešiaky , skrine , hodiny a riad .	hodiny	11	Fem
Tu ide vlastne len o zhutnené zopakovanie už citovaného Kolomanovho zákona , teda opäť o určenie prvostupňového odvolacieho súdu .	určenie	15	Neut
Prekrásny pestrodfarebný motýľ !	motýľ	2	Masc
Jej telo akoby doňho prelievalo časť svojej mladosti a elánu .	elánu	9	Masc
Ruská cirkev pozemkový majetok od panovníka nezískala .	majetok	3	Masc
Na šiesty deň ráno príval zvitkov ustal .	príval	4	Masc
Svätoštefanská legislácia predpokladá , že veriaci budú v nedeľu chodiť do kostola .	legislácia	1	Fem
Cvrček pokračoval v hre na svojom krídle .	krídle	6	Neut
Súžitie etník tu teda fungovalo na princípe spoločenstiev v ktorých jednotlivé zložky popri sebe slobodne existovali a zároveň sa ovplyvňovali , miešali a splývali .	spoločenstiev	7	Neut
Abu zoskočil z Aladinovho pleca .	pleca	4	Neut
Zavedenie inštitútu manažéra súdu zníži počet funkcionárov súdov , ktorí obmedzene vykonávajú súdnictvo .	súdov	7	Masc
Pod gaštanom stálo niekoľko stolov a stoličiek a za živým plotom presvitala tehlová budova hostinca .	plotom	10	Masc
Za oknom sa brieždilo .	oknom	1	Neut
Podporením priestupnosti školského systému v oblasti prechodu žiakov na vyšší stupeň školy bez prijímacích skúšok , vláda minimalizuje podmienky na korupciu v školstve .	skúšok	14	Fem
Vzápätí pribehli mandelinčatá s boľavými bruchami , takže musela ošetriť aj ich .	bruchami	5	Neut
Vláda podporí dosiahnutie kritérií európskej úrovne stavania , kvalifikácie firiem , úspor energie a energetickej certifikácie budov .	úspor	11	Fem
Je tu Amaris so Šatarou , máme pre teba prekvapenie ! “	Šatarou	4	Fem
Srdce ťa ešte stále ťahá k oldspeaku s celou jeho neurčitosťou a zbytočnými významovými odtieňmi .	Srdce	0	Neut
Vláda zabezpečí harmonizáciu a štandardizáciu informačných technológií a dátových štruktúr s cieľom vytvorenia podmienok pre prepojenie informačných systémov dopravy , pôšt a telekomunikácií s EÚ	prepojenie	15	Neut
Určite bol nervózny , lebo hlas mu v tej krátkej vete preskočil do fistuly ako rozladené rádio .	fistuly	13	Fem
Menšie rozmery potešia pri balení .	balení	4	Neut
Sklamanie po vojne	Sklamanie	0	Neut
Pred odchodom mi nastavila líce .	odchodom	1	Masc
Chvíľami mu na náprsenku kombinézy kvapol pramienok krvi .	kombinézy	4	Fem
Nie je jasné , či ide o hračky , alebo o idolčeky .	hračky	7	Fem
Prichádzali sme zozadu , a tak sme sa vyhli autobusom , autám a nápisom nad vstupom .	vstupom	15	Masc
Keď však Winston opravoval pôvodný plán , znížil číslo na 57 miliónov , aby vyhovel bežným požiadavkám na prekročenie kvóty .	prekročenie	18	Neut
Symbolickú úlohu má i výzdoba koníka — krúžky s bodkou uprostred sú ďalšou z mnohých modifikácií solárnych znakov .	výzdoba	4	Fem
Keď bol ľan poriadne mokrý , krtko ho zaniesol na breh .	breh	10	Masc
Vendelín sa chvíľu zdráhal , lebo mal kopu práce , no napokon sa predsa dal prehovoriť .	chvíľu	2	Fem
Vtáky spievajú , proleti spievajú , Strana nespieva .	Vtáky	0	Masc
V tejto časti práce podávam prehľad zmienok o prvkoch pohanstva v skúmanej oblasti .	prehľad	5	Masc
Rudko mal hlavu na prasknutie .	prasknutie	4	Neut
Priviezol ho džíp , za ktorým išlo kryté nákladné auto , naložené naplno .	auto	9	Neut
V tejto súvislosti použila výraz „ špicľovanie “ .	špicľovanie	6	Neut
Zbierka uvádza pravé i nepravé dekretály viacerých pápežov , ako aj početné dokumenty pojednávajúce o výnimočných právach rímskeho biskupa .	právach	16	Neut
Vtom však zamračenú tvár vystriedal náznak budúceho úsmevu .	náznak	5	Masc
Zrazu sa zachvela zem a dievčatko skoro spadlo .	dievčatko	5	Neut
Došlo mi , že po celý čas nad nami visel oveľa výraznejší dôkaz božskosti Mira Šatana .	božskosti	13	Fem
Bonus : vodovzdorné zápalky	Bonus	0	Masc
Zajac mohol byť vykladaný v systéme predkresťanských názorov jednak ako symbol plodnosti / dodnes spájame na veľkú noc vyobrazenia zajacov s vajíčkami , Nemci počas tohto sviatku hľadajú v záhrade vajíčka ukryté veľkonočným zajacom / .	zajacov	19	Masc
Na rube sa nachádza ľudská postava v korune s insígniami v rukách .	insígniami	9	Fem
Okolo nej , nad ňou i pod ňou boli ďalšie davy pracovníkov s nepredstaviteľným množstvom úloh .	davy	10	Masc
Na chrbtici mu vystúpili kropaje potu .	kropaje	4	Fem
Každá od neho však utiekla , pretože len čo otvoril ústa , ovalil ich zápach cesnaku a syra .	ústa	10	Neut
Osobitne by sme si chceli povšimnúť právne normy , v ktorých ide o odvádzanie desiatku klérom .	odvádzanie	13	Neut
Vraj pri takých veľkonočných oblievačkách chlapci najviac a najčastejšie oblievali najkrajšie dievčatá z dediny .	dievčatá	11	Neut
Zrazu som začula klopkanie na okno , no neposkočilo mi srdce ako inokedy .	srdce	10	Neut
Aladin však strčil nohu do dverí .	dverí	5	Fem
Rovnakú spoluprácu so svetským sudcom predpokladajú v citovaných ustanoveniach aj sledované súdobé cirkevnoprávne príručky .	ustanoveniach	8	Neut
Dal priniesť koše kvetov , podnosy so sladkými včelími špicmi a jazmínové koláčiky .	špicmi	9	Masc
Brúsil si na nás zubiská a najradšej by nás zhltol ako malinu .	malinu	11	Fem
Tá budova sa volala Domov dôstojníkov .	budova	1	Fem
Nakoniec si urobila z nosidiel trampolínu , začala skákať kotrmelce a nosidlá tak rozhojdala , že ich včielky sotva udržali .	nosidiel	4	Neut
“ Pero alebo mostík cez palubu ? “	palubu	5	Fem
Mnohí z nás s nimi nadviazali hlboké priateľstvá , spoznali sme ich krehučké duše prahnúce po láske , priateľstve a uznaní .	láske	16	Fem
Vyšiel na chodbu .	chodbu	2	Fem
Chlapci sa smiali , keď mocný pirát napol svaly na ruke , až sa mu na ramene zachvel vytetovaný pirátsky znak ‐ lebka so skríženými hnátmi .	ramene	16	Neut
Na dverách od profesorovej izby bola vosková pečať , zo stareninej izby sa neozývali nijaké zvuky .	dverách	1	Fem
Dúfam , že majú pravdu . “	pravdu	4	Fem
Cvrček pokračoval v hre na svojom krídle .	hre	3	Fem
Ale mňa to okno vôbec nezaujímalo .	okno	3	Neut
Zasadanie otvoril a viedol predsedajúci zborový farár brat Bakalár .	Zasadanie	0	Neut
Nestoja totiž v opozícií voči sebe na rovine ideí a ideológie , ale voči zástupcom orgánov svetských .	opozícií	3	Fem
Vtom začula výkrik .	výkrik	2	Masc
Trávniky sa premenia na oceány bahna a autá uviaznu pred domami .	bahna	5	Neut
Objavil sa pri dverách obchodu , zdvihol ruky a povystieral sa .	dverách	3	Fem
Mama pila doma , nikdy sa nestalo , že by sa vrátila z kravínov a razila alkoholom .	alkoholom	16	Masc
Súžitie etník tu teda fungovalo na princípe spoločenstiev v ktorých jednotlivé zložky popri sebe slobodne existovali a zároveň sa ovplyvňovali , miešali a splývali .	etník	1	Neut
Winston dojedol chlieb so syrom .	chlieb	2	Masc
Na tej stránke bolo moje meno .	stránke	2	Fem
Na obzore zbadala piesočný vír ako malé tornádo .	vír	4	Masc
Vo všeobecnosti to boli dôchodcovia s plstenými klobúkmi alebo čiapkami , ktoré ich chránili pred slnkom .	dôchodcovia	4	Masc
Opice skákali z konára na konár a preskakovali koruny stromov , čo rástli pozdĺž brehu rieky .	konára	3	Masc
Prišli pokušenia , zvody a ony podľahli .	zvody	3	Masc
Lenže Jasper chcel peniaze , ktoré mu sľúbila za krádež šteniat .	šteniat	10	Neut
Pochopil som to , keď som prišiel na koniec schodišťa a stretol som suseda z prízemia .	prízemia	15	Neut
Vo Zvedoch som robila vedúcu oddielu .	vedúcu	4	Fem
Po celý čas som sa díval smerom k osvetlenému pásmu , kde sa zástup žien tlačil pred skleným priečelím obchodu .	žien	14	Fem
Už sme spomenuli , že pápežský úrad bol v desaťročiach pred reformou v hlbokej kríze .	reformou	11	Fem
Realita života na vidieku zatláča náboženské rozdiely do úzadia .	Realita	0	Fem
SLOBODA JE OTROCTVO	OTROCTVO	2	Neut
Mimoriadne škaredú , s mimoriadne škaredým a nepriateľským pohľadom .	pohľadom	8	Masc
Toto spoločenstvo nám poskytlo hlboké zážitky , mnoho podnetov na zamyslenie , mnoho motivácie k modlitbám a pocit Božej prítomnosti .	zamyslenie	10	Neut
Ležala som v posteli a po tvári mi stekali slzy .	tvári	6	Fem
Zvláštnym , odzbrojujúco priateľským gestom , ktoré len on dokázal vyčarovať , si na nose upravil okuliare a pokračoval :	gestom	4	Neut
Bláznovstvo , bláznovstvo , bláznovstvo , pomyslel si znovu .	bláznovstvo	4	Neut
Vláda pripraví transformáciu štátnych zdravotných ústavov na inštitúcie verejného zdravotníctva so zvýraznením opatrení zameraných na zníženie , resp . vylúčenie rizika poškodenia zdravia .	vylúčenie	19	Neut
Ostávala po ňom mokrá stopa .	stopa	4	Fem
Na lúke pred stromom sa ozývalo funenie a nejasné hlasy .	funenie	6	Neut
Zámerom je dostať všetkých záujemcov do blízkosti rómskej lokality .	záujemcov	4	Masc
Keď som prišla domov a ocitla sa v izbe , toto všetko mi uviazlo v hrdle .	hrdle	15	Neut
Na rozdiel od svojej matky bol vysokej postavy .	postavy	7	Fem
Mama sedela na stoličke pri stole .	stole	5	Masc
Do toho , do toho , do toho , povzbudzovala som sa v duchu , cítiac , ako mi pulzuje celé telo .	duchu	13	Masc
VEĽMI KOMPLIKOVANOU ZHODOU OKOLNOSTÍ HO PO ROKU dostal a odišiel NA ROK do Nórska .	ROK	11	Masc
Starec ihneď pookrial .	Starec	0	Masc
Pomaly vstala a po niekoľkých knísavých krokoch zasa našla rovnováhu .	rovnováhu	9	Fem
Nárast služobných činností sa zabezpečí najmä prehodnotením existujúcich funkčných miest zo zabezpečovacích služieb .	prehodnotením	6	Neut
Nastolíme po voľbách zmenu - odhalením zbohatlíkov , mafiánov , delikventov , korupčníkov a lobistov pri stálom sledovaní blaha občana .	občana	19	Masc
Prehltol posledný dúšok čaju .	dúšok	2	Masc
Priateľky a príbuzní ju ponechali svojmu osudu .	Priateľky	0	Fem
Newspeak bol oficiálnym jazykom Oceánie , vytvorený kvôli ideologickým potrebám angsocu , teda anglického socializmu .	Newspeak	0	Masc
“ Počkajte , chvíľu .	chvíľu	3	Fem
Flora Plum je ľúbostný príbeh , odohrávajúci sa počas tridsiatych rokov v prostredí cirkusu .	prostredí	12	Neut
Vláda urýchli a finančne posilní zákonom regulovaný proces vysporiadania vlastníctva pôdy a pripraví komasáciu a proces definitívneho doriešenia vydávania náhradných pozemkov .	doriešenia	17	Neut
Cieľom reformy je zastaviť demograficky podmienené zvyšovanie vnútorného dlhu priebežne financovaného dôchodkového systému a zvýšiť zaangažovanosť občanov na svojej životnej úrovni v dôchodkovom veku .	zaangažovanosť	15	Fem
“ A teraz idem pohľadať to malé bezmocné úbožiatko . “	úbožiatko	8	Neut
Aj Maja so škriatkom opustili topoľ a leteli , kým nedoleteli k domu , kde sa v oknách ešte svietilo .	oknách	17	Neut
Usadili sme sa na pohovke a z kuchyne sme počuli tikanie hodín na rúre .	tikanie	10	Neut
Niet pochýb , že mi ju poslala do cesty prozreteľnosť .	prozreteľnosť	9	Fem
“ Kino ? “ navrhla som nepresvedčivo a uprene som sa dívala na sedadlo pred sebou .	Kino	1	Neut
Deti sa budú matkám odnímať už pri pôrode , ako vajce sliepke .	Deti	0	Neut
Vláda urýchli liberalizáciu trhu a vytvorí konkurenčné prostredie v energetike .	trhu	3	Masc
Miestne vymedzenie .	vymedzenie	1	Neut
Toto pápežské privilégium bolo vlastne uznaním , že Cluny sú centrom okolo neho vytvorenej skupiny kláštorov , teda právnym podkladom existencie takéhoto spoločenstva rehoľných domov .	spoločenstva	22	Neut
Pojem slavico - bohemicus zo začiatku XVIII . storočia je začiatok pojmu česko ( - ) slovenský .	pojmu	11	Masc
“ Čo sa s tebou deje , Amy ? “ vypytoval sa ma po pretekoch tréner August a odviedol ma nabok , kým ostatní nastupovali do autobusu .	tréner	15	Masc
Prehľadal som vrecká na všetkých sakách a vo vnútornom vrecku jedného z kabátov som našiel fotografiu ženy .	vrecká	2	Neut
Dom bol v predstave vtedajších ľudí akýmsi mikrokozmom , svetom samým osebe s prepracovaným systémom magickej obrany pred zlými silami vonku .	mikrokozmom	7	Masc
Drobná žena s pieskovými vlasmi zakvičala a v jej hlase sa miešala hrôza s odporom .	vlasmi	4	Masc
Ak si želáte dievča , povedala , zariadime to .	dievča	3	Neut
Poprosil som čašníka , aby mi priniesol koňak , dvojitý .	čašníka	2	Masc
Herkules prišiel do podsvetia vo chvíli , keď Megina duša vošla do Hádesovej jaskyne smrti .	duša	9	Fem
Marga odchádzala , strácala sa v dave , autobus ju viezol do ktorejsi dediny v nížine .	dediny	13	Fem
Strata slobody na platnosť uzavretého manželstva podľa všetkého vplyv nemala a manželstvo zostalo právoplatné .	Strata	0	Fem
Medzi tieto nedovolené zamestnania patrilo i krčmárstvo , ktorého vykonávanie zakázali aj ostrihomskí synodálni otcovia .	zamestnania	3	Neut
Títo reformne naladení klerici sa stali najbližšími pápežovými spolupracovníkmi a poradcami .	spolupracovníkmi	8	Masc
I v našom rozprávaní ide o tvorenie — o tvorenie človeka .	tvorenie	6	Neut
Winstonovi sa zovrel žalúdok .	žalúdok	3	Masc
“ Máte pekné tykadlá , “ povedala .	tykadlá	3	Neut
Nakoniec som jej povedal , že má pravdu , náš nový pokus bol bláznovstvom .	pravdu	7	Fem
Mami , toto je Chris Shepherd . “	Mami	0	Fem
Gregor VII . , aby toto presvedčenie ešte zdôraznil a aby mohol vyžadovať poslušnosť od uhorských kráľov , vytvoril konštrukciu o Štefanovom komendovaní krajiny sv . Petrovi .	komendovaní	22	Neut
Keďže mu nechceli odpovedať na otázku , Hádes sa uchýlil k lichôtkam .	lichôtkam	11	Fem
To dievča do kuchyne !	dievča	1	Neut
Tak či onak ho dostane Ideopolícia .	Ideopolícia	5	Fem
Zlatoňov dom v ruži	ruži	3	Fem
Správy z afrického frontu boli mimoriadne znepokojujúce .	Správy	0	Fem
Nákladné autá ešte stále prechádzali okolo a ľudia ešte stále na ne hladovo civeli .	autá	1	Neut
V prípade , že z manželstva nevzišli deti , Strana nepovoľovala rozvod , zato podporovala odlúčenie .	Strana	9	Fem
Obaja sme na okamih upreli zrak na pohybujúce sa svetlo .	zrak	5	Masc
Keď zástup Japoncov odišiel , v uchu sa mi opäť rozozvučal smútočný motív trúby .	trúby	13	Fem
Ide vlastne o stanovenie uhorského cirkevného kalendára .	stanovenie	3	Neut
Obyčajne majú väčší objem ako klasické karimatky .	karimatky	6	Fem
Vtom sa z opačného smeru objavil Plné gate .	gate	7	Fem
Našla som svojho osobného Spasiteľa , Ježiša Krista vo svetle Ježišovho evanjelia , v ňom som poznala posolstvo pokoja , lásky , radosti a šťastia .	šťastia	24	Neut
“ Fajn , “ povedal so sileným smiechom .	smiechom	7	Masc
Na chvíľu zavládlo ticho .	ticho	3	Neut
Rozbúrila more a na rozčerenej , spenenej hladine sa ako atrament černela tekutina , ktorú vypúšťajú iba chobotnice .	more	1	Neut
On – Kristus je novou možnosťou orientácie , cestou znovuzrodenia , novej nádeje a lásky , ktorá hľadá tých , ktorí sú na ceste rezignácie , ubití ľudským egoizmom a hriechom .	cestou	8	Fem
Na schodišti som mal opäť zvláštny pocit , že ma niekto sleduje , a znova som rýchlym pohybom otočil hlavu , akoby som ho chcel nečakane prekvapiť .	pohybom	17	Masc
Na preklenutie rozdielov vo vzdelanostnej úrovni a štruktúre sa vláda zaväzuje v prvom roku volebného obdobia k vytvoreniu univerzity pre vysokoškolskú prípravu občanov maďarskej národnosti .	preklenutie	1	Neut
Pred priateľovou ordináciou čakalo zo dvadsať ľudí , lavice pri stene boli obsadené .	ordináciou	2	Fem
Roku 1095 bol obliehaný svojim bratom Olegom , V . Monomachom a Svjatopolkom Izjaslavičom .	bratom	5	Masc
Občas sa niekto chabo a dosť bezvýsledne pokúsil sfúknuť dvadsaťcentimetrové plamene .	plamene	10	Masc
Mám osem nôh , osem očí a sedem chutí .	chutí	8	Fem
Mohlo byť len zo stromu , do ktorého sa zaťalo sekerou so zatvorenými očami .	očami	13	Neut
Ochrannú funkciu mal krížik , zakončujúci ihlicu z mosadze .	mosadze	8	Fem
Slávnostne , s nádejou v lepšiu budúcnosť .	budúcnosť	6	Fem
V obvodnom kine , vzdialenom od centra , obyčajne premietali staré filmy .	kine	2	Neut
Krtko prečesával ľan až z neho vyčesal jemné vlákna .	vlákna	8	Neut
Zlá víla sa princovi Filipovi posmievala , no prezradila mu , že iba on môže zrušiť Zorničkinu kliatbu , ak ju pobozká .	princovi	3	Masc
Poviedka mala názov Prípad z praxe .	Poviedka	0	Fem
Vajíčka z jeho mraveniska !	Vajíčka	0	Neut
CENY ČASOPISU MOVIELINE	ČASOPISU	1	Masc
Viac ich je , pochopiteľne , v zbierkach z reformného obdobia .	zbierkach	7	Fem
Abdullah pokrčil plecami .	plecami	2	Neut
Na chvíľu zavládlo trápne ticho , ale potom mu mama podala ruku .	ticho	4	Neut
Drobné žieňa s pieskovými vlasmi sa vrhlo na operadlo stoličky pred ňou .	žieňa	1	Neut
Vláda predloží zákon o zdravotníckych povolaniach a zariadeniach definujúci úlohy poskytovateľov a zdravotníckych pracovníkov .	zariadeniach	7	Neut
Mal som veľké potešenie z knižky Antona Dinku Skalica – moja láska , osud a poťešeňí .	láska	11	Fem
Deti sú v prevažnej miere rímokatolíci .	Deti	0	Neut
Zrazu začul akýsi zachrípnutý hlas .	hlas	4	Masc
Dupot za Ferdom neutíchal a chodba pred ním sa akoby z ničoho nič končila .	Dupot	0	Masc
Herkules skočil do jaskyne smrti , aby zachránil Meginu dušu , a z mládenca sa razom stal starec na pokraji smrti .	starec	17	Masc
“ S trochou cukru a citrónu je to jedna báseň .	citrónu	5	Masc
Tesnejšie sa pritisol k malinčiu a oko zavrel .	malinčiu	4	Neut
Lietal po poli a vyhrýzal zrniečka .	zrniečka	5	Neut
/ vedie k pochybnosti o pevnosti náboženského presvedčenia Nikolu .	pochybnosti	3	Fem
Sadli si na rímsu a Maja zreteľne videla , čo sa dnu deje .	rímsu	3	Fem
Tak tomu hovorím názorný príklad fungovania zóny najbližšieho vývinu , o ktorej som písala minule !	vývinu	8	Masc
A uvedomovať si , že som na tomto svete jediným Loriným zástupcom .	zástupcom	11	Masc
Toto dielo vznikalo postupne od konca 10 storočia do počiatku storočia 12 .	počiatku	9	Masc
Kritérium je dosť kontroverzné .	Kritérium	0	Neut
Smolenské kniežatstvo .	kniežatstvo	1	Neut
Tá myšlienka mu v skutočnosti v mysli skrsla v podobe vidiny , skleného ťažidla , ktoré sa zrkadlilo na povrchu sklápacieho stola .	podobe	9	Fem
ZLÁ VÍLA NETRPEZLIVO ČAKALA NA ZÁPAD SLNKA vo vlhkých tmavých rozvalinách kamenného hradu , ktorý stál na vysokom brale .	brale	18	Neut
Súčasnému vedúcemu katery doc . M . Danišovi patrí okrem toho aj moje srdečné poďakovanie za vytrvalú a všestrannú podporu pri vydaní tejto knihy .	vydaní	21	Neut
Účinok exkomunikácie bol nevídaný .	exkomunikácie	1	Fem
Aj reformný kánonista Anselm uvádza vo svojej zbierke viacero nariadení o konaní synod .	nariadení	9	Neut
Roztvorila dlaň a ukázala jeden medenák .	medenák	5	Masc
JEDNÉHO DŇA SA PYŠNÁ KRÁĽOVNÁ SPÝTALA svojho zázračného zrkadla : “ Povedzže mi , ktože je najkrajší v našej zemi ? “	zrkadla	8	Neut
“ Často som brával Mauglího na potulky džungľou .	džungľou	7	Fem
Prvý štvorec čokolády sa Winstonovi rozpustil na jazyku .	jazyku	7	Masc
Potom vyšla do chodby aj Lori .	chodby	3	Fem
Ešte mu v ušiach znel smiech a potlesk divákov .	potlesk	7	Masc
V jednom rohu podložky je ventil , po jeho otvorení pena nasáva vzduch , nafukuje sa .	pena	10	Fem
Keď som ju začal ťahať k posteli , vymanila sa mi .	posteli	6	Fem
Medzi pretekármi pravdaže nchýbal ani Flip , ktorý mal v hľadisku spústu fanúšikov .	pretekármi	1	Masc
Sú vhodné do teplého letného počasia , od jesene do jari ich použitie neodporúčam .	počasia	5	Neut
So žiarivým trojzubcom v mohutnej ruke sa nad nimi týčila ako predzvesť smrteľných bleskov .	predzvesť	11	Fem
Máš však nebezpečnú zbraň — žihadlo .	žihadlo	5	Neut
Bol to nádherný okamih : sedeli sme vedľa seba v prítmí autobusu a žlté pouličné osvetlenie ožiarilo Chrisovi tvár .	prítmí	10	Neut
A tak sa stalo , že nakoniec som sa na jednej hodine roztriasla , keď som si predstavila niečo strašné : v budúcnosti ma čaká to isté , čo stihlo moju mamu .	mamu	31	Fem
Raz som chytil muchu a vlastnoručne som ju hodil do pavučiny , ale nevidel som , že by sa objavil nejaký pavúk , ktorý by ju zožral .	pavúk	21	Masc
Posledný szabolcsský kánon , ktorý sa venuje kláštornému životu nariaďuje opátom a mníchom , aby sa nezúčastňovali na kalendových sedeniach , ale aby prijímali oblácie ich účastníkov v kláštoroch .	sedeniach	19	Neut
Prichádzali a záhadne odchádzali ďalší väzni .	väzni	5	Masc
Okno bolo len zámienkou a ona to svojou ženskou intuíciou vytušila .	zámienkou	3	Fem
Vláda pripraví transformáciu štátnych zdravotných ústavov na inštitúcie verejného zdravotníctva so zvýraznením opatrení zameraných na zníženie , resp . vylúčenie rizika poškodenia zdravia .	zdravotníctva	9	Neut
Zem sa ustavične triasla a kopček z hliny rástol a rástol .	kopček	5	Masc
Na polceste Aladin zastal .	polceste	1	Fem
Baghíra ho ťahal , ale Mauglí sa pevne držal stromčeka .	stromčeka	9	Masc
Vláda bude venovať pozornosť aj ďalším súčastiam slovenskej zahraničnej politiky , medzi ktoré patria viaceré oblasti dvojstrannej a mnohostrannej diplomacie , otázky ľudskej dimenzie , ekonomický rozmer diplomacie , optimalizácia zahraničnej služby .	dimenzie	23	Fem
Požiadavka primeraného vzdelania klerika nepotrebuje obšírnejší komentár .	komentár	6	Masc
Mama mi naznačila , že nemám otvárať .	Mama	0	Fem
Kukla mu padla na tvár .	Kukla	0	Fem
Vtom dostal Aladin vynikajúci nápad .	nápad	4	Masc
Napokon vstal , tackavo a hojdavo prešiel celou , hlboko ponoril ruku do vrecka na kombinéze a s rozpačitým výrazom podal mužovi s umrlčou tvárou ufúľaný kúsok chleba .	mužovi	21	Masc
Lulu , ošetrovateľka v ZOO pre mláďatká , zvieratká ľúbila .	zvieratká	8	Neut
Mama nastúpila do práce už na druhý deň .	Mama	0	Fem
Srdce mi bilo ako zvon , no odľahlo mi , len čo za sebou zavrela .	zvon	4	Masc
Netrvalo dlho a vedľa nej sa pod veľkým černicovým kríkom zjavil tučný svetlohnedý pavúk .	pavúk	13	Masc
Začal ma trápiť komplex impotentnosti .	impotentnosti	4	Fem
Šľahali okolo nej , no zakaždým ju o vlások minuli .	vlások	8	Masc
Chudáčik nešťastný Pinocchio si v klietke bezmocne sadol .	Chudáčik	0	Masc
Neváhal a rozhádzal všetky kamene , zničil všetky znamenia .	znamenia	8	Neut
Vtedy však Winston spozoroval výhonky vrbiny , ktoré vyrastali z prasklín brala pod nimi .	výhonky	4	Masc
V procese obstarávania bude vláda dbať na transparentný systém nakladania s majetkom štátu .	obstarávania	2	Neut
Urobia z neho človeka . “	človeka	3	Masc
Redakčný kruh : J . Bakalár , V . Ferenc , K . Furdík , V . Furdíková , J . Plačko , Ľ . Liptáková .	kruh	1	Masc
Iba sa trochu sklonila , odkryla deku a ja som uvidel tvár spiaceho človiečika , ktorý nemal takmer nijaké vlasy .	vlasy	19	Masc
Slovensko má dôvod na sebavedomie .	sebavedomie	4	Neut
Profesor rozprával historku o anglickej vojenskej misii , ktorú cez vojnu zhodili na padákoch .	historku	2	Fem
Bolo významným strediskom na ceste do rostovsko ‐ suzdaľskej oblasti .	strediskom	2	Neut
Mal pocit , že ho v žalúdku páli oheň .	žalúdku	6	Masc
“ Tu býva jeden môj známy a veľmi rád prijíma návštevy . “	návštevy	10	Fem
Splývali pred mojím duševným zrakom v podobe Lori , ktorá bola ich poslednou metamorfózou .	zrakom	4	Masc
“ Ty to dievča poznáš ? “	dievča	3	Neut
Sankcia teda obsahuje v sebe ako hľadisko trestné , tak aj hľadisko náhrady škody pozostalým .	hľadisko	11	Neut
Chvíľu stála a pozerala sa naňho , potom nahmatala zips na jeho kombinéze .	zips	9	Masc
Súčasné ľudské poznanie je na veľmi vysokej úrovni , stojí na prahu klonovania nového života .	klonovania	12	Neut
Je to veľmi jednoduché , vysvetlil mi doktor .	doktor	7	Masc
Americká premiéra bola plánovaná na júl a v slovenských kinách by sa mal objaviť 21 . 10 . 1999 pod názvom Spaľujúca túžba .	túžba	22	Fem
Podľa viery ugrofínskych Čuvašov výšivka konskej hlavy na ženskej hrudi chráni pred nebezpečím pôrodu .	nebezpečím	12	Neut
Svoje životy zasvätili dobytiu sveta , ale vedia aj to , že vojna má sa viesť do nekonečna a nemá ju korunovať víťazstvo .	dobytiu	3	Neut
Unaveným krokom som vyšiel po schodoch nášho domu .	krokom	1	Masc
Podporí v rámci krajín EÚ kompatibilnosť v oblasti vzájomného uznávania dokladov o dosiahnutí určitého stupňa vzdelania .	dokladov	10	Masc
/ Vypitie čaše vína na schodisku chrámu pripomína obrady pohanských kolektívnych hostín , tzv . „ bratčín “ .	Vypitie	1	Neut
Musíte byť tolerantní , musíte pochopiť , že som nemal iné východisko .	východisko	11	Neut
Mal som pred sebou prízraky .	prízraky	4	Masc
“ Asi mám , “ odvetil Chris a pokračoval v kreslení .	kreslení	10	Neut
Mnohí z nás s nimi nadviazali hlboké priateľstvá , spoznali sme ich krehučké duše prahnúce po láske , priateľstve a uznaní .	priateľstve	18	Neut
Okrem toho bol ochrancom šamanov .	šamanov	4	Masc
Vážka , čo krúžila vysoko nad čistinou , ponúkala vyhliadkový let .	Vážka	0	Fem
Stĺpy boli spojené prútím , alebo žrďovinou .	prútím	3	Neut
Štyridsať dva takýchto odliatkov bolo poslaných do Moskvy , kde ich skúmal I . A . Ščepkin , autor prvej práce o nich .	odliatkov	3	Masc
Na nič spred začiatku šesťdesiatych rokov sa nepamätala a ( zo všetkých známych ) jediný človek , ktorý často rozprával o rokoch pred Revolúciou , bol jej starý otec .	Revolúciou	23	Fem
Pri vchode do školy sa objavila Liza .	školy	3	Fem
Potom začali preteky so zaujímavými prekážkami , ktoré vymyslel Rudko .	prekážkami	5	Fem
To bol dôvod , prečo ešte nemal ženu .	ženu	7	Fem
Služobníctvo by ťa tu našlo .	Služobníctvo	0	Neut
Vláda vytvorí podmienky pre uskutočnenie úspešného referenda o vstupe do EÚ , ktoré bude dokumentovať udržanie širokej podpory verejnosti tomuto historickému kroku .	uskutočnenie	4	Neut
Nastavil dlaň .	dlaň	1	Fem
Pred domom kuny Chytráčky viali pestré slepačie perá , Alfonz vystavoval lesklú kukuricu a kliešťak Drakula voňavé krvavé klobásky .	kliešťak	14	Masc
Odpočívala na kraji bazéna a hompáľala nohami .	bazéna	3	Masc
Právo na prístup ku kultúrnym hodnotám je jedným z dôležitých práv všetkých občanov .	občanov	12	Masc
A veselili sa , kým nezapadlo slnko .	slnko	6	Neut
Vláda prijme strednodobý komplexný programový dokument rozvoja regiónov , zabezpečí prípravu , prerokovanie a schválenie plánovacích a programových dokumentov v oblasti regionálnej politiky s dôrazom na zlepšenie ekonomickej a sociálnej súdržnosti a prehĺbi uplatňovanie princípu partnerstva .	rozvoja	6	Masc
Začiatkom týždňa sme písali ďalší test a profesor Tayerle nám ho dnes priniesol opravený .	týždňa	1	Masc
S cieľom zefektívnenia správy rozpočtových prostriedkov a správy finančných prostriedkov štátu vláda uskutoční kroky na urýchlené dobudovanie systému štátnej pokladnice .	dobudovanie	16	Neut
Niekto z mojich niekdajších šéfov , vedúcich kádrového oddelenia alebo veliteľov na vojenských cvičeniach .	oddelenia	8	Neut
Pritom je známe , že remeslo kováčske bolo spájané s magickými šamanskými praktikami u mnohých národov — kováč a šaman sú z jedného rodu hovorí jakutské príslovie .	remeslo	5	Neut
Podľa nich klerici sa nielenže nesmeli opíjať , ale mali aj povinnosť brániť veriacim v prehnanom požívaní opojných nápojov .	nápojov	18	Masc
Vytieňoval lícne kosti a tmavé obočie .	obočie	5	Neut
Vtom medzi nich skočil zo stromov Tarzan .	stromov	5	Masc
Publikum burácalo .	Publikum	0	Neut
V skutočnosti sa vyplácali iba malé sumy a výhercovia veľkých výhier neexistovali .	sumy	6	Fem
Svet víťazstva za víťazstvom , triumfu za triumfom : nekonečný nátlak , nátlak , nátlak na nervy moci .	Svet	0	Masc
Ale Lori pochopila zmysel mojich slov po svojom .	slov	5	Neut
Dej románu sa odohráva na nej alebo pri nej .	Dej	0	Masc
Najprv Maja spoznala dobrého kamaráta , ktorý jej pripadal veľmi zvláštny .	kamaráta	4	Masc
Vojnu sme viedli s Euroáziou .	Vojnu	0	Fem
Zdravotníkovi som dal meno Vehap a črty ošetrovateľa .	Zdravotníkovi	0	Masc
Okolo výhonkov stromu sa nachádza mriežka s kosoštvorcov .	mriežka	5	Fem
Zlý stav pečate znemožňuje podrobnejšiu analýzu .	pečate	2	Fem
Mala na sebe len podprsenku a nohavičky .	nohavičky	6	Fem
Obrátila som sa v očakávaní , že to bol prelud .	očakávaní	4	Neut
Z dverí vyšla Faika .	dverí	1	Fem
Po kráľovskej hostine , na ktorú mravce priniesli obrie porcie špagiet s voškovou omáčkou , si všetci políhali na slniečko , aby si oddýchli .	slniečko	19	Neut
Vláda bude zvyšovať prostriedky na vzdelávanie , aby sa postupne priblížili priemernej hodnote podielu z HDP v krajinách EÚ .	vzdelávanie	5	Neut
Dal som jej aj nejaké ruble a povedal som , aby za ne nakúpila pivo a ešte niečo iné .	ruble	5	Masc
“ Zachovajte pokoj a rozvahu , “ zavelila im .	rozvahu	4	Fem
Vláda pripraví návrh zákona o menšinách , vrátane financovania menšinových kultúr .	financovania	8	Neut
Zrejme poznala ten sladiak naspamäť .	sladiak	3	Masc
Pocítil , že na znak nesúhlasu pokrčila ramená .	znak	4	Masc
Delina by ma zaradila medzi šarlatánov .	šarlatánov	5	Masc
Švihák Pedro sa v letku obrátil a zmizol kdesi v diaľke .	Švihák	0	Masc
V krátkom čase v rokoch 1989 – 1990 bol členom Generálneho presbyterstva .	presbyterstva	11	Neut
Mohutná posteľ pri okne bola zastlaná dotrhanými prikrývkami a na poduške chýbala obliečka .	prikrývkami	7	Fem
Neďaleko jazdil na koni mladý princ .	princ	5	Masc
Miznem v temnej priepasti , v roztvorených ústach pohlcujúcich rieku času .	ústach	7	Neut
Nevznikla sama od seba , jej náväznosť na vierouku z desiateho storočia / i keď došlo k zrejmým posunom / svedčí o kontinuite jej vývoja .	náväznosť	6	Fem
Cítil som vôňu jeho tela , ktorá bola premiešaná so zápachom tabaku a alkoholu .	zápachom	10	Masc
Rusi prenasledovali kacírstvo ešte krutejšie , než inkvizícia .	Rusi	0	Masc
Nestoja totiž v opozícií voči sebe na rovine ideí a ideológie , ale voči zástupcom orgánov svetských .	zástupcom	14	Masc
Mravčie gazdinky boli rozhorčené .	gazdinky	1	Fem
Sadli si na konár medzi šuštiace lístie topoľa .	lístie	6	Neut
Súčasťou reformy verejných financií bude aj zásadné sprísnenie poskytovania štátnych záruk .	sprísnenie	7	Neut
“ Daj im pokoj ! “ skríkol Aladin .	pokoj	3	Masc
Pochopil som to , keď som prišiel na koniec schodišťa a stretol som suseda z prízemia .	schodišťa	9	Neut
Niekde blízko pri vás sa určite potuluje bezprizorná neter , synovec , sused či kolegyňa .	neter	8	Fem
Keď búrka ustala , zistili , že pristáli na púšti .	búrka	1	Fem
Ako kráčal k dverám , mince v mešci príjemne zacinkali .	dverám	3	Fem
Triedenie kvalitatívne , podľa druhu nálezu .	Triedenie	0	Neut
Už jej vzhľad mu naháňal hrôzu , a nielen vedomie , že je to on .	vedomie	9	Neut
Oči jej vystúpili z jamiek a z vyškerených úst vypadali všetky zuby okrem jedného .	Oči	0	Neut
Spomenul si , že sedí s drevenou bábkou , na ktorej zarobí milióny .	bábkou	7	Fem
Na druhom bola tvár Lizy .	tvár	3	Fem
Táto kralická norma je dodnes základom spisovnej češtiny .	češtiny	7	Fem
Vláda je pritom presvedčená o nevyhnutnosti zavádzať do rezortu pôdohospodárstva , pri rešpektovaní niektorých špecifík , trhové podmienky a slobodnú konkurenciu .	konkurenciu	20	Fem
Možno to bola tlmená ozvena nevedomia .	nevedomia	5	Neut
Bol to pochmúrny deň , oblaky viseli nízko , smerom k močiaru udierali blesky .	močiaru	11	Masc
Zakryte nádobu pokrievkou a nechajte vychladnúť na izbovú teplotu .	pokrievkou	2	Fem
“ Čo by si chcela robiť v sobotu ? “ spýtal sa Chris a ja som na uchu zacítila jeho dych .	uchu	17	Neut
Pôjde najmä o precíznejšiu personálnu prácu , efektívnejšie využitie ich vlastných kontrolných a inšpekčných mechanizmov , ale tiež o uplatňovanie nových špecifických protikorupčných postupov .	uplatňovanie	19	Neut
Podišiel som k oknu , že sa spýtam svojich postáv , čo si o tom myslia .	oknu	3	Neut
Chlapec mu prebehol prstom po hrdle .	hrdle	5	Neut
Omar ležal chvíľu roztiahnutý na zemi .	chvíľu	2	Fem
Patrili do minulosti , do predrevolučných časov .	časov	6	Masc
A ustúpil som nabok , aby mohla prejsť cez tesnú chodbičku .	chodbičku	10	Fem
Herkulovi sa na tvári zračilo záhadné odhodlanie .	tvári	3	Fem
Keď som vychádzal z izby , že za ním zájdem a poprosím ho o nejakú radu , opäť som pocítil svrbenie .	svrbenie	20	Neut
Za opáta Odona , Bernonovho nástupcu , sa potom vytvorili predpoklady , aby sa Cluny stalo strediskom skupiny kláštorov .	kláštorov	18	Masc
“ Som advokátka , vyhlásila pohotovo Maja , “ a pána Rudka budem zastupovať ! “	advokátka	2	Fem
Na záver tohto pamätného dňa dala princezná otcovi pusu na dobrú noc a mravčie vojsko vymenovalo kráľa za svojho čestného člena .	pusu	8	Fem
Opustená strecha , kde bývali , bola na severe od trhoviska .	trhoviska	10	Neut
Obe upierali naňho zrak .	zrak	3	Masc
Keďže mu nechceli odpovedať na otázku , Hádes sa uchýlil k lichôtkam .	otázku	5	Fem
Parsons to s hlúposťou zvieraťa zhltol ľahko .	hlúposťou	3	Fem
S prekvapujúcou dôvernosťou .	dôvernosťou	2	Fem
Buchta láskyplne sledovala siláka Fridolína .	siláka	3	Masc
Tak sa učili variť , robiť jednoduché kuchynské práce ako umývanie riadu , škrabanie zemiakov , krájanie chleba .	riadu	11	Masc
Keď Jazmína vošla na chodbu , čo viedla do prijímacej siene , zjavil sa nesmierne rozrušený sultán .	chodbu	4	Fem
Mykla plecami .	plecami	1	Neut
Za finančnú podporu sa chcem poďakovať Ekumenickej rade cirkví , nášmu drahému zboru a „ staršej “ mládeži ECAV v Prešove , modlitebnému spoločenstvu , kamarátom z tréningu Rovesník a jednotlivcom .	tréningu	27	Masc
Naším zámerom je odstrániť najmä deformácie , ktoré zakladajú neopodstatnené nerovnosti medzi občanmi alebo zavádzajú do sociálneho systému cudzorodé prvky , akým je napríklad nesystémové včlenenie kúpeľnej starostlivosti do sociálneho poistenia .	poistenia	30	Neut
O kulte jaštera svedčia už spomenuté rúčky čiaš .	čiaš	7	Fem
Záujemcov o šport poteší futbalový turnaj pre dospelých a jazda na koni pre deti .	Záujemcov	0	Masc
V jeho mysli sa vôňa spájala neoddeliteľne so smilstvom .	smilstvom	8	Neut
Pozostáva z krátkych pasáží o jednotlivých mníchoch , v ktorých sa neopakovateľným spôsobom preplieta fantastika s reálnym videním sveta .	videním	17	Neut
Ak nepočítam učebnice , až donedávna jediné knihy , ktoré držala v ruke , boli detské rozprávky .	ruke	12	Fem
Mauglího myšlienky prerušil Baghírov prísny hlas .	myšlienky	1	Fem
Ani nad záhadnými delegáciami , ktoré ma prišli navštíviť .	delegáciami	3	Fem
“ Bude tam titulok : Slávna rekordérka fotografuje reportérov , “ povedala Blythe .	rekordérka	6	Fem
Pri štvrtej obrátke sa mi stužka s kľúčikom z krku vyvliekla .	obrátke	2	Fem
Zostal som so slúchadlom v ruke a pozoroval som deti .	slúchadlom	3	Neut
“ Dúfam , že získam štipendium na niektorú vysokú školu , “ vyhlásila som , ale nespomenula som , že by som chcela ísť na menšiu , no o to prestížnejšiu univerzitu .	univerzitu	31	Fem
Víťazne sme vybojovali zápas o zvýšenie výroby .	zápas	3	Masc
To vie Boh sám , človek je na ceste do večnosti alebo do zahynutia .	zahynutia	13	Neut
Zaplietla sa do niečoho neznámeho , ako keby ju lapila neviditeľná nitka .	nitka	11	Fem
Nastal bod obratu .	bod	1	Masc
Potom som stlačil kľučku na dverách vedúcich do Profesorovej izby .	dverách	5	Fem
Potom sa otvorili dvere a vošla mamička .	mamička	6	Fem
Schmatol jeden z Winstonových zostávajúcich predných zubov palcom a ukazovákom .	ukazovákom	9	Masc
No keď sa stane na brehu jazera nehoda , Polly zachraňuje !	jazera	6	Neut
Vždy hulákaj s davom , to je moja zásada .	zásada	8	Fem
Aby anonym urobil svoje obvinenie dôveryhodným , uvádzal iniciálky tej ‐ ktorej ženy a z tohto hľadiska mala Marga dôvod podozrievať ma .	obvinenie	4	Neut
Nazlostený Flip sa jediným obrovským skokom preniesol k pavučine .	pavučine	8	Fem
“ Veru mohla , “ odvetila makovica .	makovica	6	Fem
Bronzová čaša , zdobená rúčkou s vtáčikom pripomína uctievanie vtákov u ugrofínskych národov — ak karelský poľovník zabil vtáka čakalo ho nešťastie .	vtáka	18	Masc
Jej priebeh je možné zrekonštruovať zhruba takto — Pred obradom samotným bolo postavené obetisko s pôdorysom štvoruholníka so štyrmi stĺpmi v rohoch .	obetisko	13	Neut
Zmätená som horúčkovito preletela zvyšok testu .	testu	5	Masc
Kaviareň preťal akýsi elektrický náboj .	náboj	4	Masc
Potom som stlačil kľučku na dverách vedúcich do Profesorovej izby .	izby	9	Fem
Bol to nádherný okamih : sedeli sme vedľa seba v prítmí autobusu a žlté pouličné osvetlenie ožiarilo Chrisovi tvár .	autobusu	11	Masc
Našli cestu do tajnej vežičky a v nej Kráľovnú zla .	zla	9	Neut
Recepčné sa podujali objednať taxík a zobudiť ma , kedy uznám za vhodné .	taxík	4	Masc
Mauglí natešene vykríkol , vyskočil medveďovi na brucho a pritúlil sa k nemu .	medveďovi	5	Masc
Niekto zo susedov si mohol všimnúť , že som bol preč , mohol by sa ma zvedavo vypytovať , kde som bol , a to by stačilo , aby sa som sa rozčúlil .	susedov	2	Masc
Proleti si zachovali ľudskosť .	Proleti	0	Masc
Svätojánske mušky , lienky a niekoľko včiel sedelo alebo ležalo na dlážke a smutne vyčkávalo na svoj osud .	včiel	6	Fem
Mala som pocit bezpečia a veľmi sa mi to páčilo .	bezpečia	3	Neut
Veľavravným svedectvom sú nálezy belozerskej lepenej keramiky .	svedectvom	1	Neut
Srdce mi bilo ako zvon , no odľahlo mi , len čo za sebou zavrela .	Srdce	0	Neut
Práve poletovala medzi bielymi jazmínovými kvetmi a nevšimla si jemnulinké a tenulinké vlákna napnuté medzi konárikmi .	vlákna	12	Neut
Neodpustiteľným hriechom však bola promiskuita medzi straníkmi .	straníkmi	6	Masc
Keď konečne zaspala , bola tma .	tma	5	Fem
“ Vieš , minulé leto som mal fantastický džob .	leto	4	Neut
Usnul šepkajúc : " Zdravý rozum sa nedá zaznamenať štatisticky " a s pocitom , že táto jeho poznámka obsahuje hlbokú múdrosť .	pocitom	13	Masc
Ako som počúval otcove husle , pred očami sa mi zjavil portrét ženy z medailónu .	očami	7	Neut
Usadili sme sa pripravení sledovať oblohu .	oblohu	5	Fem
Na oslavu prišli všetci olympskí bohovia a priniesli množstvo nádherných darov .	bohovia	5	Masc
U nás jeme to , čo sa objedná cez donášku alebo mrazené jedlá , “ povedal Chris .	donášku	9	Fem
Chcela mu ukázať strom , z ktorého viseli liany .	strom	3	Masc
“ Často som brával Mauglího na potulky džungľou .	potulky	6	Fem
V nemocnici sa naňho vrhlo desať mravcov .	nemocnici	1	Fem
Pod bielym strniskom starcova tvár očervenala .	strniskom	2	Neut
Vláda uskutoční revíziu úradov , pripraví zmeny v pracovno - právnej legislatíve a uskutoční reorganizáciu štátnej správy .	legislatíve	11	Fem
Neprestal zvončeky trhať .	zvončeky	1	Masc
Podľa iných to bol hadži Qamil .	hadži	4	Masc
Ani bratanci sa sem už neodvážia prísť , priatelia k nám prestali chodiť na návštevu už dávno .	bratanci	1	Masc
Môj otec po jeho rozpade niekoľko týždňov nespal . . .	rozpade	4	Masc
Winston študoval štyri vyrovnané zvitky papiera .	papiera	5	Masc
Tomuto cieľu bola podriadená aj metóda ich spracovania .	metóda	5	Fem
Večer vhupli všetky včielky do postieľok a vytiahli si deky až pod nos .	postieľok	5	Fem
Všetky tieto ich snahy mali aj svoju právnu dimenziu , vďaka čomu sa v okolí reformných pápežov vytvorilo „ nové “ reformné kánonické právo .	okolí	14	Neut
O chvíľu som späť . “	chvíľu	1	Fem
Zišlo mu na um , že ešte stále nepozná jej priezvisko , ani jej adresu .	adresu	14	Fem
Vzdelanie sa stáva kľúčom k životnému úspechu , najlepšou investíciou do budúcnosti , účinnou prevenciou pred nezamestnanosťou , zločinnosťou , drogami .	drogami	20	Fem
Keď sme sa v pološere prechádzali na korze , všimol som si akúsi ženu .	pološere	4	Neut
Celý týždeň som bol náchylný uveriť , že to všetko bol iba sen .	sen	12	Masc
To malo obrovský národnozáchovný význam v druhej polovici XIX . storočia , keď maďarizácia reálne ohrozovala samotnú existenciu slovenského národa .	existenciu	17	Fem
Trh určuje našu cenu .	Trh	0	Masc
Nie je toto skvelá skrýša ?	skrýša	4	Fem
Šmátrala som okolo seba a hľadala môj poklad .	poklad	7	Masc
Zároveň sa pred mojím duševným zrakom naraz objavilo dievčatko .	dievčatko	8	Neut
Aj ona sa mi zahľadela do očí .	očí	6	Neut
Už dávno som stratil kontakt so svetom kina a v nových televíziách ma nikto nepoznal .	kina	7	Neut
Pri stene bola posteľ , na stole lampa s hlboko stiahnutým tienidlom .	lampa	7	Fem
Škole chýbali priestory , a tak žiaci prvého stupňa , čiže aj my prváčikovia , mávali vyučovanie popoludní .	vyučovanie	16	Neut
Ocitlo sa osamote s Lori a zo svojej skrýše všetko pozorne vnímalo : tvary Lorinho tela , jej dych , vôňu jej mäsa .	dych	18	Masc
Svätoštefanský zákon pripúšťa , aby sa žena , ktorú manžel za istých okolností opustí , znovu vydala .	manžel	9	Masc
Vietor im prilepil tenké kombinézy na telo .	Vietor	0	Masc
Oba tieto kánony zodpovedajú dávnej praxi latinskej cirkvi .	kánony	2	Masc
Otvorila som balkónové dvere , po mačke ani stopy .	dvere	3	Fem
Vtom mi Chris stisol ruku .	ruku	4	Fem
Regula metského biskupa podrobne ustanovuje i podmienky prijatia do spoločenstva kanonikov a v rámci nich predpisuje pre kandidáta povinnosť odovzdať všetok majetok kostolu , pri ktorom mieni pôsobiť .	spoločenstva	9	Neut
Dnes stojí súsošie bez podstavca provizórne na dvore evanjelickej fary medzi detskými preliezačkami .	podstavca	4	Masc
Vláda bude preto v tomto volebnom období osobitne dbať na schopnosť komunikácie , výcvik , vyzbrojenie , zabezpečenie strategickej prepravy a udržateľnosť špeciálnych jednotiek rýchlej reakcie .	výcvik	13	Masc
Potom sa obrátila k bratom .	bratom	4	Masc
Jeho ruka potajomky vkĺzla do čižmy .	čižmy	5	Fem
Vzal list bieleho papiera a pustil sa do písania .	písania	8	Neut
Tigríča jej nešikovne skočilo do náručia a princezná zacítila mäkulinkú teplú guľku s hodvábnou srsťou .	Tigríča	0	Neut
Na moje prekvapenie sa mama zasmiala .	prekvapenie	2	Neut
Očakával náš príchod .	príchod	2	Masc
V dobrej kondícii .	kondícii	2	Fem
“ Konečne ! “ zvolal so smiechom .	smiechom	6	Masc
Taniere obložte hlávkovým šalátom , na ktorý servírujte kuskus a zeleninovú zmes .	Taniere	0	Masc
Najvýraznejšie sa prvky predkresťanských systémov prejavil v severoruských oblastich .	prvky	2	Masc
Neraz som videla , ako sa máča ľan .	ľan	7	Masc
Duchovné osoby boli ideálnymi parlamenármi , lebo podľa dobových predstáv majú osobitnú ochranu boha pred nebezpečím .	nebezpečím	15	Neut
Dôležitejším znakom oboch kategórií šamanov je , že úspech ich činov nezávisí od toho , akú obetu bohu prinesú , ale od toho v akom vzťahu sú oni sami s bohmi — tj . od ich schopností .	obetu	16	Fem
Nastolíme po voľbách zmenu - odhalením zbohatlíkov , mafiánov , delikventov , korupčníkov a lobistov pri stálom sledovaní blaha občana .	zbohatlíkov	6	Masc
Keď zástup Japoncov odišiel , v uchu sa mi opäť rozozvučal smútočný motív trúby .	uchu	6	Neut
Krk by som ti zlomil ako mrkvu .	Krk	0	Masc
Dosadzovanie duchovných do úradov laikmi bolo bežnou praxou raného stredoveku .	Dosadzovanie	0	Neut
Pečate so vzývajúcou formulou v staroruštine	staroruštine	5	Fem
Mladým som vyrozumel z tváre , že ani oni sa dobre nevyspali .	tváre	4	Fem
Nastal bod obratu .	obratu	2	Masc
Vytvorí legislatívne podmienky pre pristúpenie SR k Dohovoru EHK OSN o prístupe k informáciám .	pristúpenie	4	Neut
Prúd mojej energie sa jej vylial na prsia .	prsia	7	Neut
Zároveň sa pred mojím duševným zrakom naraz objavilo dievčatko .	zrakom	5	Masc
Vytvorí mechanizmy na získavanie a vyhodnocovanie informácií a odhaľovanie týchto prípadov .	získavanie	3	Neut
Osobitnú pozornosť bude vláda venovať vytváraniu podmienok pre činnosť Hasičského a záchranného zboru ako základnej zložky integrovaného záchranného systému .	vytváraniu	5	Neut
V svetle lampy som uvidel agresívnu formu jej pŕs .	formu	6	Fem
Chrisova mama zabalila chlebíčky po štyroch do plastovej fólie a ešte do alobalu .	chlebíčky	3	Masc
Winston i dievča vytrvalo jedli .	dievča	2	Neut
Ak ťažké kvapky zasiahnu jej jemné krídelká , môžu ju poraniť .	kvapky	2	Fem
Vzdialené tóny .	tóny	1	Masc
Slovo „ drúk “ malo tentoraz ničivý účinok .	drúk	2	Masc
Vtedy bol ôsmak a ja štvrtáčka .	ôsmak	2	Masc
Uma Thurman a jej priateľ Ethan Hawke očakávajú v júni narodenie dieťaťa .	priateľ	4	Masc
Záhadný zlodej syra	zlodej	1	Masc
Brat kantor pre vážne osobné dôvody nemohol prísť , preto brat farár sprevádzal nábožný spev na gitare spolu s mládežníkmi , ktorí poslúžili programom a vystúpili aj s osobným vyznaním .	mládežníkmi	19	Masc
List bol adresovaný mojej mame .	mame	4	Fem
Bol som v jeho pracovni , mal som v sebe nerozumnú dávku alkoholu a čakal som , že všetko sa definitívne vyjasní a ja odídem .	pracovni	4	Fem
V piaty deň každého mesiaca išla Irma na poštu s príslušným kódom a priniesla domov sto dolárov .	poštu	8	Fem
“ Ale keď kapitán Hook na tom trvá ! “ vysvetľoval John , starší z Wendiných bratov .	kapitán	3	Masc
Už na začiatku nás zblížila šťastná okolnosť .	okolnosť	6	Fem
To je MOŽNO tá pozitívna stránka ROZDELENIA REPUBLIKY .	ROZDELENIA	6	Neut
Vedel dôvod . Šírila okolo seba atmosféru hokejového ihriska , studených kúpeľov , spoločného stopovania a akejsi všeobecnej čistoty mysle .	stopovania	14	Neut
V tomto podniku si nemôžem dovoliť luxus v podobe ďalšej whisky , ani keby som išiel dušu vypustiť .	whisky	10	Fem
Kým sa malý Herkules hral s Pegasom , zjavil sa Hádes , boh podsvetia .	podsvetia	13	Neut
Zaujímavý je v tejto súvislosti nález z vykopávok z roku 1960 z Iľjinej ulice .	ulice	13	Fem
Avšak hoci som sa strácal v tieni režisérov a hviezd filmového plátna , netrápil som sa .	plátna	11	Neut
Rodičia zhasli svetlo a vyšli z izby .	izby	6	Fem
Hlas na druhom konci linky patril Lori .	linky	4	Fem
" Dom je naozaj obkľúčený , " povedal ten hlas .	hlas	9	Masc
A Winstona najviac deprimovalo vedomie jeho vlastnej intelektuálnej menejcennosti .	menejcennosti	8	Fem
Pozvala na ňu Blythe a Ricka a podávala moje obľúbené jedlá : zemiakovú kašu , pizzu , celozrnný chlieb , španielske chimichangas , makaróny so syrom a orechový koláč .	chlieb	18	Masc
Smutným hlasom im Kasandra oznámila , že v noci navšítvili komoru s medom zlodeji a spôsobili im veľkú škodu .	medom	12	Masc
SLOBODA JE OTROCTVO	OTROCTVO	2	Neut
Nová však bola energia , s akou tieto požiadavky nastoľovali a nová bola aj prísnosť trestov za nerešpektovanie týchto požiadaviek .	trestov	15	Masc
Zavedenie inštitútu manažéra súdu zníži počet funkcionárov súdov , ktorí obmedzene vykonávajú súdnictvo .	Zavedenie	0	Neut
Toto každodenné falšovanie minulosti , ktoré robí Ministerstvo pravdy , je pre stabilitu režimu rovnako nevyhnutné ako represálie a špicľovanie , ktoré robí Ministerstvo lásky .	falšovanie	2	Neut
Globalizácia nevznikla sama od seba a nevznikla ani náhodou .	Globalizácia	0	Fem
Odhrnula som mokré plavky , prázdne kokakolové plechovice , ceruzky , listy vytrhnuté z notesa a knižku Kto chytá v žite so somárskymi ušami .	notesa	14	Masc
V stredoveku jestvovala inkvizícia .	inkvizícia	3	Fem
Vtom ju niečo zozadu potiahlo za krídlo .	krídlo	6	Neut
Mama rázne podišla k oknu .	oknu	4	Neut
A položil som slúchadlo .	slúchadlo	3	Neut
Je tu Amaris so Šatarou , máme pre teba prekvapenie ! “	prekvapenie	9	Neut
Cieľom reformy poistenia v nezamestnanosti bude posilnenie princípu zásluhovosti ( poistného princípu ) a princípu osobnej zodpovednosti občana za vlastnú pracovnú a sociálnu situáciu .	posilnenie	6	Neut
Mal ohromnú prax zo školských novín Hrom .	prax	2	Fem
“ Khalid mi dal morské riasy ! “	riasy	5	Fem
Radikálnou inováciou je hláskoslovie a tvaroslovie .	tvaroslovie	5	Neut
Mala som pocit , že potrebujem vypadnúť na čerstvý vzduch .	pocit	2	Masc
Jeho kláštor musel mať dobrú povesť , lebo ako lotrinský vojvoda , tak aj flámsky markgróf mu odovzdali viaceré kláštory , aby v nich obnovil rehoľný život podľa reformných princípov .	markgróf	15	Masc
“ Tak aké je rande , princezná ?	rande	4	Neut
Vláda bude podporovať vývoj a šírenie výrobkov i služieb šetriacich životné prostredie a v rámci legitímnych trhových nástrojov hľadať možnosti podpory malým a stredným podnikateľom zvyšovať investície do „ čistej “ výroby a environmentálnych podnikateľských aktivít .	šírenie	5	Neut
Vtom si spomenula na poštového poslíčka Pavla , ktorý okrem správ roznášal po lúke dobrú náladu .	lúke	13	Fem
Prirodzeným krokom v napĺňaní integračných ambícií Slovenska je vstup krajiny do Európskej menovej únie .	krokom	1	Masc
Vláda bude klásť dôraz na prehľadnosť , výkonnosť , spoľahlivosť a efektívnosť monitorovacieho a hodnotiaceho systému .	spoľahlivosť	9	Fem
Telo má zdravé a silné .	Telo	0	Neut
Hook sa otočil k pirátovi Smíovi a posmešne napodobnil dievčatko .	pirátovi	4	Masc
Na jeho ľavom konci bola stará studňa bez vody , pred studňou rástla marhuľa .	studňou	11	Fem
Potom knihu zavrela a dievčatko pobozkala .	dievčatko	4	Neut
Potlačila som zívnutie .	zívnutie	2	Neut
Smrti sa , samozrejme , bojím .	Smrti	0	Fem
Ale pri pochodovaní sa nerozpráva .	pochodovaní	2	Neut
Systematicky podrýva súdržnosť rodiny , zato svojho vodcu označuje pomenovaním , ktoré priamo vyvoláva pocity rodinnej vernosti .	vodcu	7	Masc
Vošla som do tichého bytu .	bytu	4	Masc
Na prvý pohľad je tu zrejmá podobnosť so znením kánonov , ktoré sa týkajú rehoľníkov .	kánonov	9	Masc
Zváži motivačné pravidlá pre využívanie domácich primárnych energetických zdrojov , vrátane využívania obnoviteľných zdrojov energie .	využívania	11	Neut
Všetko prebehlo v tichosti , vedenie fakulty nevydalo nijaké oficiálne vyhlásenie .	fakulty	6	Fem
Na takomto mieste prelínania sa dvoch kultúr sa ľahšie uchovávajú archaické prežitky .	kultúr	6	Fem
Ja som zaujímal svoj výklenok , ona prichádzala po mne .	výklenok	4	Masc
A možno mi zatemnila zrak dažďová clona .	zrak	4	Masc
Má osem riadkov .	riadkov	2	Masc
S letenkou v ruke som vyšiel z izby a zamieril k stolu , kde sedeli recepčné z môjho poschodia .	letenkou	1	Fem
Zasa sa ukáže slniečko .	slniečko	3	Neut
Pravovernosť je nevedomosť .	nevedomosť	2	Fem
V poslednom čase ju Ministerstvo hojnosti veľmi obľubovalo .	Ministerstvo	4	Neut
Urobíme nejaké rozbory , určíme liečbu . . .	rozbory	2	Masc
Domčeky vyzdobili girladnami a Vilko s Emilom urobili na jednom krtinci kĺzačku , kde šantili deti .	krtinci	10	Masc
V ušiach mi zostala len ozvena jeho hlasu a v diaľke , na úpätí podstavca bez sochy , som uvidel Háda .	úpätí	13	Neut
Hlavným motívom výletu bola rozprávka .	výletu	2	Masc
Slová mi uviazli v hrdle .	hrdle	4	Neut
Pani Shepherdová sa zasmiala , no mala som nepríjemný pocit , že mi neverí .	pocit	9	Masc
/ Vypitie čaše vína na schodisku chrámu pripomína obrady pohanských kolektívnych hostín , tzv . „ bratčín “ .	schodisku	5	Neut
Cvrčica sa rozžiarila .	Cvrčica	0	Fem
Oči jej vystúpili z jamiek a z vyškerených úst vypadali všetky zuby okrem jedného .	úst	8	Neut
Na preklenutie rozdielov vo vzdelanostnej úrovni a štruktúre sa vláda zaväzuje v prvom roku volebného obdobia k vytvoreniu univerzity pre vysokoškolskú prípravu občanov maďarskej národnosti .	úrovni	5	Fem
Bola tu celá reťaz zvláštnych oddelení , ktoré sa zaoberali proletárskou literatúrou , hudbou , dramatickým umením a vôbec zábavou .	umením	16	Neut
Začervenala som sa , ale s úsmevom som pokrčila plecami .	plecami	9	Neut
Ako ju veverička Barka odniesla do hniezda	veverička	2	Fem
Podľa nich u nás hrdo postavili Stalinovu sochu .	sochu	7	Fem
Čertovské dievčisko ?	dievčisko	1	Neut
Chvíľu sme stáli vo dverách , pretože nás ovalil svieži závan klimatizovaného vzduchu .	dverách	4	Fem
Veľa včiel opustilo mesto s novou kráľovnou , aby niekde vo veľkom šírom svete založili nové včelstvo .	včiel	1	Fem
Vláda bude analyzovať možnosti zavedenia rovnej dane .	zavedenia	4	Neut
Popoludní o tretej sa začínali Majstrovstvá Makovej lúky v skákaní .	skákaní	9	Neut
“ Dávajte pozor ! “	pozor	2	Masc
Prezradiť ťa môže jediný záblesk v očiach .	záblesk	4	Masc
Znak potom môžme vykladať ako zobrazenie vtáka s roztiahnutými krídlami a hlavou vysunutou dopredu .	krídlami	9	Neut
Prinesie na oltár lásky obeť tým , že odpoveď začne najhorším .	lásky	3	Fem
Veľkú tašku hodil do kúta a mľaskavo ho pobozkal .	tašku	1	Fem
Formulácia „ Volumus , ut episcopi habeant potestatem . . . “ implikuje interpretáciu , že biskupi , vykonávali svoj úrad z vôle panovníka , že on im udeľoval mandát na reálne pôsobenie v ich úrade .	panovníka	23	Masc
Na nebi ani mráčka a z blankytného neba hrialo slnko .	slnko	9	Neut
Sklo je prirodzene náchylné rozbiť sa a plech nezaručuje odolnosť voči vlhkosti .	odolnosť	9	Fem
Vláda zjednotí sadzby DPH pred vstupom do EÚ .	vstupom	5	Masc
Hook nevedel zakryť obrovskú radosť .	radosť	4	Fem
Keď zazneli prvé tóny pomalej skladby , rozhodla som sa , že za ním pôjdem .	skladby	5	Fem
Vtedy som vyriekol jediné slová , o ktorých som si myslel , že vystihujú moje rozpoloženie .	rozpoloženie	15	Neut
Bez problémov našiel moje pery , akoby dôverne poznal moju tvár .	pery	4	Fem
“ Tak ti teda prezradím , aká budúcnosť ťa čaká , “ odvetil Abdullah .	budúcnosť	7	Fem
Mäso je neuveriteľne vynikajúco ochutené , mäkké , obloha čerstvá , hranolky " křupavé " .	hranolky	11	Fem
Vtedy vyšla moja KNIHA Paradigmatika spisovnej ruštiny , ktorá sa stala celoštátnou univerzitnou učebnicou ruskej TEORETICKEJ morfológie .	Paradigmatika	4	Fem
Maja s Vilkom sedeli na lesnej čistine a vymýšľali si o nich príbehy .	čistine	6	Fem
Vtom mu na nose zabzučala mucha .	mucha	5	Fem
Voš žijúca v lone vystúpi nahor , na krk , voš z vlasov sa spustí dolu , na líce .	krk	8	Masc
Podstrčil mu ho redaktor z televízie , ktorá všetko nakrúcala .	redaktor	3	Masc
Rozbúchalo sa mi srdce .	srdce	3	Neut
Hlúpa tvár pod svetlými vlasmi ho vítala s rozžiareným úsmevom .	úsmevom	9	Masc
Maja zakrátko znovu nabrala odvahu .	odvahu	4	Fem
Porozprával mu o svojom sne , v ktorom sa mal stať hrdinom , a požiadal učiteľa , nech mu pomôže .	sne	4	Masc
Tá relácia , i keď varovala pred známymi dôsledkami zbožšťovania jedla , ma definitívne presvedčia o tom , čo som už dávnejšie tušil .	relácia	1	Fem
Komárno nechce Cyrila a Metoda na verejnom priestranstve	priestranstve	7	Neut
Ruky ma zúfalo boleli a na krátky , ale nepríjemný okamih som nadobudla dojem , že spadnem na nesprávnu stranu .	Ruky	0	Fem
Na okraje slohového zošita mi písal ľúbostné odkazy , alebo ma chcel bozkávať , kým som čítala .	zošita	3	Masc
Princezná Jazmína pozerala z okna do hlbokej púštnej noci .	Princezná	0	Fem
Na vrchole koleso chvíľu postálo a náš vozík sa knísal zboka nabok .	vrchole	1	Masc
Ako kráčal k dverám , mince v mešci príjemne zacinkali .	mince	5	Fem
Uvedomila som si , že som nevhodne zareagovala , lenže ten bozk ma naozaj vyviedol z miery .	bozk	11	Masc
Celý ďalší týždeň jeho život pripomínal nepokojný sen .	sen	7	Masc
Jeho kláštor musel mať dobrú povesť , lebo ako lotrinský vojvoda , tak aj flámsky markgróf mu odovzdali viaceré kláštory , aby v nich obnovil rehoľný život podľa reformných princípov .	povesť	5	Fem
Ak Tichomirov vidí v povstaniach iba element sociálny , Frojanov na jeho úkor vyzdvihuje moment politický .	element	6	Masc
Potom sa vrhol do vody a rozpleštil sa na člne , až ma od smiechu rozbolelo brucho .	smiechu	14	Masc
Dieťa vie čítať až vtedy , keď text pochopí .	Dieťa	0	Neut
Ďakujem , “ odvetila som a vymanila si studené prsty spod jeho rúk .	prsty	9	Masc
Dievčatko išlo do kúpeľne .	kúpeľne	3	Fem
Pinta je predsa polovica štvrtky a štyri štvrtky idú do galóna .	Pinta	0	Fem
Cieľom Diskusného klubu je budovanie občianskej spoločnosti na kresťanskom morálnom základe .	klubu	2	Masc
* Niektorým poslancom padlo zaťažko zverejniť svoje majetkové priznanie .	priznanie	8	Neut
Nárast služobných činností sa zabezpečí najmä prehodnotením existujúcich funkčných miest zo zabezpečovacích služieb .	Nárast	0	Masc
Chcem poďakovať aj sestrám , ktoré sa podieľajú na upratovaní nášho chrámu .	sestrám	3	Fem
Vedľa v sieni sa zatiaľ zhromaždenie skončilo a v sršňom meste zavládol pokoj .	zhromaždenie	5	Neut
V nedeľu 18 . apríla sa konalo zasadnutie zborového presbyterstva .	presbyterstva	9	Neut
Štefan bol prinajmenšom od kanonizácie roku 1083 uctievaný ako apoštol svojho ľudu .	ľudu	11	Masc
“ Chŕŕŕŕŕ ! “ zachrčal netvor , keď sa mu šíp zaryl do chrbta .	chrbta	13	Masc
Vláda bude presadzovať zrušenie systému maximálnych cien a zmenu kategorizácie úhrady liekov tak , aby obsahom solidárneho balíka bola v každej anatomicko - terapeutickej skupine aspoň jedna účinná látka .	kategorizácie	9	Fem
Cítil som vôňu jeho tela , ktorá bola premiešaná so zápachom tabaku a alkoholu .	vôňu	2	Fem
Usadili sme sa na pohovke a z kuchyne sme počuli tikanie hodín na rúre .	pohovke	4	Fem
Chúďa Maja ronila trpké slzy .	Chúďa	0	Neut
Cítila som , aké má teplé dlane .	dlane	6	Fem
V zápale hry Maja prihrala Vilkovi , ten prudko kopol do lopty a lopta zmizla v kroví .	lopty	11	Fem
Princezná vzala tigríča do svojej postele .	tigríča	2	Neut
Blízka existencia dvoch stredísk rozdielnych národov svedčí o možnosti ich vzájomného ovplyvňovania , o etnickej nerovnorodosti základu , z ktorého vznikol Rostov .	ovplyvňovania	11	Neut
Flauta hrala zložitú melódiu .	melódiu	3	Fem
Jednostaj prichádzali a odchádzali všakovakí väzni : distribútori drog , zlodeji , banditi , šmelinári , opilci , prostitútky .	väzni	5	Masc
Zrazu ma hnev pominul a nahradil ho smútok .	hnev	2	Masc
Regula metského biskupa podrobne ustanovuje i podmienky prijatia do spoločenstva kanonikov a v rámci nich predpisuje pre kandidáta povinnosť odovzdať všetok majetok kostolu , pri ktorom mieni pôsobiť .	kanonikov	10	Masc
Namiesto toho urobila večeru , ako na zmierenie , a celú večnosť čakala , že sa vrátim .	zmierenie	7	Neut
Keď sme asi hodinu kráčali po ceste pre vozy , mama odbočovala ku kravínom a ja som išla ďalej do školy .	hodinu	3	Fem
Vilka vyučovanie celkom vyčepalo .	vyučovanie	1	Neut
Opantal ho pocit únavy .	únavy	3	Fem
Mäso je neuveriteľne vynikajúco ochutené , mäkké , obloha čerstvá , hranolky " křupavé " .	Mäso	0	Neut
O ' Brienov sluha ich však oboch vpustil dnu bez jediného protestu .	protestu	11	Masc
Keďže kníh , ktoré mi zostali , nebolo ktovieako veľa , vrece bude ťažšie , ak pridám rukopisy svojich scenárov .	rukopisy	17	Masc
Zrazu od úžasu onemela .	úžasu	2	Masc
Zostupujúc do hĺbok duševných priepastí , ( seba ) obnažuje , bičuje ( sa ) .	hĺbok	2	Fem
Dobrovoľníci z rôznych organizácií pripravili bohatý program : divadelné , umelecké a hudobné dielne aj súťaže .	program	6	Masc
Pochybovačne zdvihla obočie , pozrela na mňa a ďalej vykladala nákup .	obočie	2	Neut
Ochrana kultúrneho dedičstva a duševného vlastníctva	Ochrana	0	Fem
Aj keď v noci ešte nelietala , rozprestrela krídla a opustila svoju bezpečnú dutinku v strome .	strome	15	Masc
Podporením priestupnosti školského systému v oblasti prechodu žiakov na vyšší stupeň školy bez prijímacích skúšok , vláda minimalizuje podmienky na korupciu v školstve .	korupciu	20	Fem
Mravce dovliekli celý kôš dobrôt , včielky priniesli ovocný medovník a Kasandra jazmínové želé .	dobrôt	4	Fem
Súčasťou 10 . ročníka bude vyhlásenie ankety o najlepší film všetkých desiatich ročníkov .	ročníka	3	Masc
Vzala handru a neznámeho ňou poutierala .	handru	1	Fem
Vláda zabezpečí harmonizáciu a štandardizáciu informačných technológií a dátových štruktúr s cieľom vytvorenia podmienok pre prepojenie informačných systémov dopravy , pôšt a telekomunikácií s EÚ	telekomunikácií	22	Fem
Bola to vysoká plavovláska s rozpustenými vlasmi a modrými očami , pery mala trochu hrubé a namaľované na tmavočerveno .	vlasmi	6	Masc
Cieľom fiškálnej politiky vlády bude zníženie podielu verejného dlhu na hrubom domácom produkte počas volebného obdobia .	dlhu	8	Masc
Neveril som vlastným ušiam .	ušiam	3	Neut
I Hanibal si to všimol , a preto vzal pred ňou nohy na plecia .	plecia	13	Neut
Zavedieme stanovenie základných štandardov na financovanie a kvalitu sociálnych služieb , systém udeľovania licencií a kontroly , zrovnoprávnenie pre všetky inštitúcie poskytujúce sociálne služby .	udeľovania	12	Neut
Kým sa obliekala , v chodbe zazvonil telefón .	telefón	7	Masc
Je isté , že v Ríme reformných pápežov žilo presvedčenie o podriadenosti Uhorska Rímu .	presvedčenie	9	Neut
Priznanie nie je zrada .	Priznanie	0	Neut
Legislatívnym základom bude vládou vypracovaný návrh moderného zákona o výchove a vzdelávaní .	výchove	9	Fem
Na zlepšenie komunikácie s verejnosťou sa zavedú pravidelné stretnutia funkcionárov polície s občanmi .	stretnutia	8	Neut
Chuchlík v maštali a na cvičisku	cvičisku	5	Neut
Poslúchol som ju a podišiel k oknu .	oknu	6	Neut
Nazlostený Džafar vyskočil z trónu , ktorý pripomínal kobru .	kobru	8	Fem
Jillina mama s otcom tam zamračení meravo sedeli , ako keby chceli silou vôle dotlačiť dcéru na stupienok víťazov .	víťazov	18	Masc
Mama sa pobrala do kuchyne , no na polceste zastala .	kuchyne	4	Fem
Podporí v rámci krajín EÚ kompatibilnosť v oblasti vzájomného uznávania dokladov o dosiahnutí určitého stupňa vzdelania .	vzdelania	15	Neut
Vláda zabezpečí kontinuálne transponovanie legislatívy EÚ pre bezpečnosť potravín a legislatívy politiky kvality a implementácie na podmienky potravinového dozoru v celom reťazci výroby potravín .	kvality	12	Fem
“ Odkedy máš v hlave piliny ?	hlave	4	Fem
V Policajnom zbore sa zmení systém hodnotenia práce , ktorý bude akcentovať mieru spokojnosti občanov s činnosťou polície .	hodnotenia	6	Neut
Ja som si nemohla dovoliť také neprístojnosti .	neprístojnosti	6	Fem
Tak u mnohých národov existujú tzv . bieli šamani , spájaní s nebeskými silami a svetom hore a šamani čierni , zviazaní s podsvetím .	šamani	8	Masc
Vláda prehodnotí systém výkonu správy súdov , ktorý príliš zaťažuje sudcov administratívnymi činnosťami , osobitne pri štátnej správe jednotlivých súdov .	súdov	5	Masc
Takéto zistenie zaujímavo dopĺňa a modifikuje pohľad na najvyspelejšie mesto stredovekej Rusi , mesto majúce bohaté styky s civilizačným okruhom západnej Európy .	okruhom	19	Masc
Pre novodobú vedu bola pamiatka objavená v roku 1773 v Archangeľsku V . V . Krestininom v zborníku z prvej polovice 16 storočia .	pamiatka	4	Fem
Odkiaľ berú títo ľudia presvedčenie , že pre Bratislavčanov reformy neznamenajú záťaž ?	presvedčenie	4	Neut
Kráľovná sa premenila na starú škaredú bosorku .	Kráľovná	0	Fem
Nález železného kľúča od visiaceho zámku mohol súvisieť s už spomenutou ochrannou funkciou .	funkciou	12	Fem
Chvíľu tam ležal akoby omráčený , pričom mu z úst a z nosa stekal pruh tmavej krvi .	Chvíľu	0	Fem
A obchody , ktoré chcú predávať zaručene čerstvý , v noci upečený a nezabalený chlieb , musia ho držať v osobitných zasklených policiach , takže skôr nebalenie chlieb zdražuje .	obchody	1	Masc
Vláda pripraví transformáciu štátnych zdravotných ústavov na inštitúcie verejného zdravotníctva so zvýraznením opatrení zameraných na zníženie , resp . vylúčenie rizika poškodenia zdravia .	zdravia	22	Neut
Táto kralická norma je dodnes základom spisovnej češtiny .	norma	2	Fem
Štát tú časť pôdy , ktorá nebude potrebná ma výstavbu objektov a infraštruktúry celospoločenského významu , prevedie do vlastníctva obce .	vlastníctva	18	Neut
Tigríča jej nešikovne skočilo do náručia a princezná zacítila mäkulinkú teplú guľku s hodvábnou srsťou .	náručia	5	Neut
Potom sa jedného dňa prízemie vyprázdnilo .	prízemie	4	Neut
Na obzore sa objavil čierny bod a ja som si pomyslela , že je to nejaký chrobák .	obzore	1	Masc
Ako predpokladal , pán Charrington nerobil s prenájmom izby nijaké drahoty .	izby	8	Fem
Najprv zavládlo neprirodzené ticho .	ticho	3	Neut
Cieľom reformy poistenia v nezamestnanosti bude posilnenie princípu zásluhovosti ( poistného princípu ) a princípu osobnej zodpovednosti občana za vlastnú pracovnú a sociálnu situáciu .	poistenia	2	Neut
Vtedy začali hasnúť svetlá .	svetlá	3	Neut
Vzniknutý kódex sa stáva základom tzv . Krátkej redakcie pravdy / kým kódex , vzniknutý roku 1037 v Kyjeve sa stáva základom pravdy priestrannej / .	pravdy	22	Fem
Ochrannú funkciu mal krížik , zakončujúci ihlicu z mosadze .	krížik	3	Masc
Okrem zajatcov priemerný občan Oceánie nikdy nezočí občana Euroázie alebo Východoázie a zakazuje sa ovládať cudzie jazyky .	občana	7	Masc
Ohlasy tohto splývania sa zachovali v neoficiálnom podaní legiend a príbehov , tradovaných z generácie na generáciu a neskôr zachytených v Pateriku .	podaní	7	Neut
Vláda v spolupráci s predstaviteľmi územnej samosprávy vytvorí transparentný inštitucionálny a finančný návrh na kofinancovanie regionálneho rozvoja z prostriedkov štátneho rozpočtu a z fondov EÚ .	samosprávy	6	Fem
Práve som ležala na pohovke .	pohovke	4	Fem
Steny mojej lebky zaduneli .	Steny	0	Fem
Okrem rekodifikácie trestného práva vláda dopracuje legislatívny zámer rekodifikácie súkromného práva a na jeho základe vypracuje dlhodobý plán postupného vypracovania nových právnych predpisov .	vypracovania	19	Neut
Kúsok chleba ešte stále ležal tam , kam ho odhodil muž bez brady .	Kúsok	0	Masc
O nich , ako aj o charakteristike ranoarpádovských zákonníkov a synodálnych uznesení hovoríme konkrétnejšie v samostatných kapitolách .	uznesení	11	Neut
Nová Koncepcia ochrany prírody a krajiny bude obsahovať racionálny systém manažmentu chránených území , prehodnotí ich cieľový stav a navrhne opatrenia a programy starostlivosti tak , aby chránené územia slúžili aj verejnosti .	ochrany	2	Fem
Tentoraz to však nebolo hlásenie o vojenskom víťazstve , ale iba oznámenie Ministerstva hojnosti .	Ministerstva	12	Neut
A obchody , ktoré chcú predávať zaručene čerstvý , v noci upečený a nezabalený chlieb , musia ho držať v osobitných zasklených policiach , takže skôr nebalenie chlieb zdražuje .	chlieb	14	Masc
Jedna ruka jej ovisla nabok , telo sa jej uvoľnilo .	ruka	1	Fem
Zlatoňov dom v ruži	dom	1	Masc
Po skončení vlády prvého stredovekého západného cisára totiž v krajine ochabli štátne garancie dodržiavania zákonnosti .	garancie	12	Fem
Roztrhajte jej tvár , roztrhajte jej ju až na kosť .	tvár	2	Fem
Aj tlač bola akási rozhádzaná .	tlač	1	Fem
Vláda pripraví legislatívny rámec inštitucionálneho vzdelávania zdravotníckych pracovníkov prostredníctvom rezortu školstva s možnosťou postgraduálnej prípravy pracovníkov v zdravotníctve v školách a inštitúciách , ktoré získajú akreditáciu pre príslušný typ vzdelávania .	pracovníkov	15	Masc
Rozrývalo mi to dušu a ničilo nervy .	nervy	6	Masc
Chris ma chytil za ruku a kľúčik sme zvierali medzi dlaňami .	kľúčik	6	Masc
Ordinácia je akt , ktorým kandidát svätenia ( ordinand ) získava istý stupeň svätenia .	Ordinácia	0	Fem
Naposledy požiadalo o povolenie na postavenie súsošia na svojom pozemku Gymnázium Ľudovíta Jaroslava Šuleka .	súsošia	6	Neut
Musí osloviť Amplefortha aj za cenu okríknutia z televíznej obrazovky .	okríknutia	6	Neut
Predkladaná publikácia je doplneným a čiastočne prepracovaným textom dizertačnej práce , ktorú som v odbore Všeobecné dejiny obhájil na jar roku 2000 na pôde Filozofickej fakulty Univerzity Komenského v Bratislave .	publikácia	1	Fem
Človek by si myslel , že som mu ponúkla sviatočný obed .	obed	10	Masc
Otesávame jazyk až na kosť .	kosť	4	Fem
Steblo sa zlomilo a on skončil na chrbte .	Steblo	0	Neut
Požiadavka primeraného vzdelania klerika nepotrebuje obšírnejší komentár .	vzdelania	2	Neut
Tarzan podrástol a veľmi rád si matku doberal .	matku	6	Fem
Zažiješ neuveriteľné dobrodružstvá .	dobrodružstvá	2	Neut
Základným východiskom pre elimináciu environmentálnych rizík je kontrola chemickej , biologickej a jadrovej bezpečnosti .	rizík	5	Neut
V tom prípade však ide o veľmi zaujímavý príklad prenosu archaických právnych zvyklostí do uhorského práva a ich pretrvania aj v podmienkach reforiem .	zvyklostí	12	Fem
Počul , ako sľubuje klamať , kradnúť , falšovať , vraždiť , rozširovať drogy , prostitúciu , a pohlavné choroby , liať deťom vitriol do tváre .	vitriol	23	Masc
Jej román Vášeň je však skvelý .	Vášeň	2	Fem
Na chrbte cítil , ako ich zraky priťahuje jeho belasá uniforma .	chrbte	1	Masc
Scenár - adaptácia : Tenká červená čiara	čiara	6	Fem
Kerchak bránil rodinu proti zákernej mačke , zatiaľ čo ostatní členovia ho pozorovali zo stromov .	mačke	5	Fem
Profesor Eugen Jóna , ktorý sa dejinami spisovnej slovenčiny dlhé roky zaoberal , si uvedomil potrebu dať do rúk slovenskej i medzinárodnej vedeckej verejnosti dostatočne prístupný skutočný text tohto základného diela .	slovenčiny	8	Fem
Keď Ferdovi muži zajali celé nepriateľské vojsko , aj hlavný veliteľ otrokárov vyšiel z podzemnej chodby .	chodby	15	Fem
“ Vezmi ju na preteky chrtov , “ navrhol Wayne Dean .	chrtov	5	Masc
A lial som do seba whisky .	whisky	5	Fem
O chvíľu prišiel za mnou Rick .	chvíľu	1	Fem
Z nálezov na Gorodišti sú zaujímavé predovšetkým miniatúrne toporčeky — amulety , známe zo Suzdaľa .	toporčeky	8	Masc
Oznam Ministerstva hojnosti zakončilo ďalšie sólo na trúbku , ktoré potom vystriedala dychovka .	sólo	5	Neut
Pri každom kine , divadle , klube je aj jeho adresa a telefón .	adresa	10	Fem
Vypil ďalší dúšok džinu , vzal bieleho jazdca a pokusne ním tiahol . Šach !	dúšok	2	Masc
Makulienka a motýľ Emanuel sklopili zrak .	zrak	5	Masc
Nakoniec si urobila z nosidiel trampolínu , začala skákať kotrmelce a nosidlá tak rozhojdala , že ich včielky sotva udržali .	včielky	17	Fem
Niečo mi zvieralo hrdlo .	hrdlo	3	Neut
Správu aktív bude v tomto systéme zabezpečovať súkromný sektor , výber správcu bude v plnej kompetencii občana .	aktív	1	Neut
Možno o vaše poučovanie nebude vôbec stáť .	poučovanie	3	Neut
Zlý sultán bol od šťastia ako omámený .	šťastia	4	Neut
Ľudská naivnosť i hrubosť majú určité hranice .	naivnosť	1	Fem
Zostal som sedieť v kresle , aj keď sa dvere otvorili a do miestnosti vošli dvaja muži , nové tváre .	dvere	9	Fem
SLOBODA JE OTROCTVO	OTROCTVO	2	Neut
Cieľom Strany nebolo len to , aby medzi mužmi a ženami nevznikali vzťahy vernosti , nad ktorými nemala moc .	Strany	1	Fem
Potom som stlačil kľučku na dverách vedúcich do Profesorovej izby .	kľučku	3	Fem
Keď sme sa v pološere prechádzali na korze , všimol som si akúsi ženu .	korze	7	Neut
Bláznovstvo , bláznovstvo , bláznovstvo , pomyslel si znovu .	bláznovstvo	2	Neut
Jeho zrak padol na úlomky skleného ťažidla .	ťažidla	6	Neut
Kým sa malý Herkules hral s Pegasom , zjavil sa Hádes , boh podsvetia .	boh	12	Masc
Zrazu začuli vystrašený krik .	krik	3	Masc
Snehulienka pozrela na ligotavé červené jabĺčko .	jabĺčko	5	Neut
To všetko mi jedného dňa porozprával Sergej , pri močiari .	močiari	9	Masc
Avšak rodine malého paviána sa nepáčilo , ako sa Jane správa k ich mláďaťu a nazlostení začali dievčinu prenasledovať .	mláďaťu	13	Neut
Napokon preletel cez domček slimáka Oskara a skončil na baze .	domček	3	Masc
Na druhej strane slovo Kominterna vnuká predstavu prísne štruktúrovanej organizácie a dobre zoštylizovanej ideologickej doktríny .	doktríny	14	Fem
Stále mala na sebe služobnú uniformu , čiernu sukňu a letnú bielu blúzku s krátkymi rukávmi .	sukňu	8	Fem
Maja zaviedla hostí na slávnostne vyzdobenú lúku a ponúkla im vyhliadkový let s vážkou , medové guľôčky , cukrovú vatu a mnoho iných dobrôt .	let	11	Masc
Snažila som sa potlačiť vzrušenie .	vzrušenie	4	Neut
Prúd áut sa zastavil .	Prúd	0	Masc
Ordinácia je akt , ktorým kandidát svätenia ( ordinand ) získava istý stupeň svätenia .	svätenia	6	Neut
Nejedno dieťa už vytklo s bolesťou svojim rodičom : Vy ste na vine , že som sa dostal na zlú cestu , lebo vy sami ste nebrali Ježiša vážne a neviedli ste ma k Nemu .	vine	12	Fem
Keď Maja začula žalostný nárek muchy , zabudla na strach pred žabami .	muchy	5	Fem
" To hádam nie , Ideopolícia ? !	Ideopolícia	5	Fem
Ak vojde dnu , bude pred nimi v bezpečí .	bezpečí	8	Neut
Na dne oceána sa otriasali vraky lodí a potopené poklady .	lodí	6	Fem
Vláda pripraví legislatívny rámec inštitucionálneho vzdelávania zdravotníckych pracovníkov prostredníctvom rezortu školstva s možnosťou postgraduálnej prípravy pracovníkov v zdravotníctve v školách a inštitúciách , ktoré získajú akreditáciu pre príslušný typ vzdelávania .	zdravotníctve	17	Neut
Ďalšou decentralizáciou verejných financií vláda vytvorí na úrovni obcí lepšie podmienky pre napĺňanie miestnej bytovej politiky .	napĺňanie	12	Neut
Svojho času som ich spomínal pri popisovaní nosenia fotografickej tašky na ruksaku .	tašky	9	Fem
A s týmito neskutočnými útrapami v duši . . .	útrapami	4	Fem
Navyše sú nepoužiteľné vzhľadom na tlačiarenskú farbu , ktorá môže nepríjemne poškodiť istú chúlostivú časť tela .	vzhľadom	3	Masc
Najmenšia drobnosť vás mohla prezradiť .	drobnosť	1	Fem
Ministerstvo mieru sa zaoberá vojnou , Ministerstvo pravdy lžami , Ministerstvo lásky mučením a Ministerstvo hojnosti hladomorom .	lásky	11	Fem
Keďže som neprišiel na nič lepšie , sedel som celý deň vo svojej izbe a v duchu som si predstavoval , že som ušiel z domu .	izbe	13	Fem
Vláda v každom prípade prijme kroky na zvýšenie motivácie rodičov a ich detí študovať , respektíve skutočne plniť povinnú školskú dochádzku .	rodičov	9	Masc
Modlime sa a pomáhajme im na ich ceste , aby sa aj ich srdce zapálilo víťazstvom lásky , pravdy , nádeje a života .	lásky	16	Fem
Ako predpokladal , pán Charrington nerobil s prenájmom izby nijaké drahoty .	pán	3	Masc
Si drúk , povedal som tomu ksichtovi v zrkadle .	zrkadle	8	Neut
Biele lístočky kvetu sa jemne odhrnuli a zjavila sa malá rúčka .	kvetu	2	Masc
Kráčal chodbou s bielymi kachličkami a mal pocit , že sa prechádza na slnku , v pätách mu kráčal ozbrojený dozorca .	slnku	13	Neut
V bruchu cítil tupú bolesť .	bruchu	1	Neut
Winston zdvihol šálku džinu , chvíľku naberal odvahu a potom obrátil do seba to tekuté svinstvo , ktoré malo pachuť oleja .	svinstvo	15	Neut
Nakoniec sme priniesli z kuchyne taniere , šalát a fašírku .	fašírku	9	Fem
Vypil som už polovicu fľaše s koňakom , keď sa objavila vo dverách .	koňakom	6	Masc
Podporením priestupnosti školského systému v oblasti prechodu žiakov na vyšší stupeň školy bez prijímacích skúšok , vláda minimalizuje podmienky na korupciu v školstve .	stupeň	10	Masc
Sviečky som vložila do mosadzných svietnikov a postavila ich na stôl .	stôl	10	Masc
Keď vystúpila z pásma žltkastého svitu a na chvíľu zastala na rozhraní medzi svetlom a temnotou , nemyslel som na to , že ide priamo ku mne , aby napravila chybnú interpretáciu vecí , ktorú vyprodukoval môj mozog .	chvíľu	8	Fem
Typickým príkladom sú lúčové náušnice — symboly slnka a svetla .	náušnice	4	Fem
Na chrbtici mu vystúpili kropaje potu .	chrbtici	1	Fem
Doktor zostal v rozpakoch .	rozpakoch	3	Masc
To chlapča asi žartuje !	chlapča	1	Neut
Vláda podporí dosiahnutie kritérií európskej úrovne stavania , kvalifikácie firiem , úspor energie a energetickej certifikácie budov .	kritérií	3	Neut
Nakukol pomedzi húštinu a uvidel troch tvorov v šatách namiesto kožušiny .	šatách	8	Fem
Naši žiaci a rodičia sú pobúrení .	rodičia	3	Masc
A s pohľadom Loriných očí vo svojom vnútri .	očí	4	Neut
Dievčatko išlo do kúpeľne .	Dievčatko	0	Neut
Budúcnosť patrí proletom .	proletom	2	Masc
Mama sa poteší , pomyslel som si .	Mama	0	Fem
Vláda pripraví transformáciu štátnych zdravotných ústavov na inštitúcie verejného zdravotníctva so zvýraznením opatrení zameraných na zníženie , resp . vylúčenie rizika poškodenia zdravia .	transformáciu	2	Fem
Mauglímu vystúpili do očí slzy .	očí	3	Neut
Tým bola narušená klasická štruktúra ruského mesta s oddeleným posadom a hradiskom .	hradiskom	11	Neut
Ja som mal tajne odložené niektoré naše intímnosti .	intímnosti	7	Fem
Páči sa mi tvoja myseľ .	myseľ	4	Fem
" Vybudovať civilizáciu na strachu , nenávisti a krutosti nemožno .	civilizáciu	2	Fem
Roztočil som laso a chytil stonožku do slučky .	laso	2	Neut
Škriatok sa zasmial .	Škriatok	0	Masc
Kántrové pôstne dni sa spomínajú aj v Ladislavových a Kolomanových zákonoch .	zákonoch	10	Masc
Môžeme ich pripraviť o existenciu .	existenciu	4	Fem
Rád by som v tomto poďakovaní spomenul všetkých , ktorí akoukoľvek radou či pomocou prispeli ku zrodu predkladanej publikácie .	zrodu	16	Masc
Jeho najstaršou časťou je hradisko Krom .	hradisko	4	Neut
Vláda zvýši mieru informovania verejnosti v oblasti regionálnej politiky .	informovania	3	Neut
Za týchto okolností sa mi v diaľke zjavilo mytologické božstvo záhrobného sveta .	božstvo	9	Neut
Obaja sme na okamih upreli zrak na pohybujúce sa svetlo .	okamih	3	Masc
Zavedieme stanovenie základných štandardov na financovanie a kvalitu sociálnych služieb , systém udeľovania licencií a kontroly , zrovnoprávnenie pre všetky inštitúcie poskytujúce sociálne služby .	zrovnoprávnenie	17	Neut
Vláda pripraví aktualizáciu národnej stratégie prevencie kriminality a vytvorí legislatívne podmienky na jej realizáciu .	kriminality	6	Fem
Viem o vašej veľkej finančnej štedrosti .	štedrosti	5	Fem
Ministerstvo lásky nemalo okná .	Ministerstvo	0	Neut
Minule sa môj kolega Rado Ondřejíček fejtónovým perom pustil do problému hlupákov medzi nami .	perom	7	Neut
Nebola to namáhavá robota , dážďovku o chvíľu našli .	robota	3	Fem
To bolo šťastie !	šťastie	2	Neut
Najprv vybojovali pri brehu víťaznú vodnú bitvu .	bitvu	6	Fem
Potom som oči otvorila a ponorená v tme som smerovala k odrazu mesiaca .	odrazu	11	Masc
Po chvíli však medzi nami zavládlo napäté ticho a obaja sme sa otočili k oknu .	oknu	14	Neut
Myseľ mi zaletela k Marge .	Myseľ	0	Fem
Napriek mojej nezrozumiteľnej ruštine opäť pochopila .	ruštine	3	Fem
“ To je zbytočné , “ odvetila , prišla za mnou a objala ma okolo pliec .	pliec	15	Neut
Aladina raz z Rahimovho obchodu vyhnali , keď sa Abu usiloval chvostom potiahnuť trs banánov .	banánov	14	Masc
Spôsoboval mi najväčšie utrpenie .	utrpenie	3	Neut
Počula som tikanie nástenných hodín a vlastný dych .	tikanie	2	Neut
Vláda podporí dosiahnutie kritérií európskej úrovne stavania , kvalifikácie firiem , úspor energie a energetickej certifikácie budov .	dosiahnutie	2	Neut
Spočiatku som svoje utrpenie dusila v sebe .	utrpenie	3	Neut
Ferdo si napravil šatku a vyšli z brány mraveniska .	mraveniska	8	Neut
Stiahol páku a pokračoval :	páku	1	Fem
Všetko prebehlo v tichosti , vedenie fakulty nevydalo nijaké oficiálne vyhlásenie .	vedenie	5	Neut
Dostal som strašnú chuť na makový koláčik . “	koláčik	6	Masc
Nebudete poznať kamarátstvo , nebude mať čo vás povzbudiť .	kamarátstvo	2	Neut
Povedal som im , že to nepovažujem za zlý nápad .	nápad	9	Masc
Nikdy nebudú svoji .	svoji	2	Masc
Ako sa hovorilo , túto škandalóznu informáciu potvrdila sama herečka , ktorá sa nervovo zrútila .	herečka	9	Fem
Boli to moji kolegovia a kolegyne .	kolegovia	3	Masc
Stromboli neveril vlastným ušiam .	ušiam	3	Neut
Napriek tomu Syme odhalil uňho niečo ako nedostatok nadšenia .	nadšenia	8	Neut
V druhej ruke držala zelené jabĺčko .	jabĺčko	5	Neut
Bol na slnku , oni v tieni .	slnku	2	Neut
“ Si náš hrdina , Aladin . “	hrdina	3	Masc
Ide o ustanovenie o používaní latinčiny v kapitule .	ustanovenie	2	Neut
Je to na druhom poschodí .	poschodí	4	Neut
Vlastne patril do početného týmu odborníkov , ktorý pripravoval jedenáste vydanie Slovníka newspeaku .	newspeaku	12	Masc
Telefón zrazu prestal vyzváňať .	Telefón	0	Masc
Príslušníka vojenskej polície , poľovníka a manželský pár v stredných rokoch .	poľovníka	4	Masc
Irma neuverí rozprávkam , vyľaká sa .	rozprávkam	2	Fem
Dobre som poznal mená všetkých dobových talianskych spevákov aj všetkých futbalistov .	mená	3	Neut
Ide v nich napospol o reglementovanie podmienok azylu pre zlodejov , ktorí utečú do kostolov .	azylu	7	Masc
Ručička ciferníka vystrelila na päťdesiatpäť .	Ručička	0	Fem
Vláda vytvorí systémové legislatívne a inštitucionálne predpoklady pre riešenie medzipodnikovej zadlženosti a s ňou súvisiacich pohľadávok štátu a verejných inštitúcií .	pohľadávok	15	Fem
Strata slobody na platnosť uzavretého manželstva podľa všetkého vplyv nemala a manželstvo zostalo právoplatné .	manželstvo	11	Neut
Môj potôčik vyrazil von , rozlial sa a ja som zostal zahalený v horúcej pare sauny .	potôčik	1	Masc
Iná obsahová náplň priláka nový typ čitateľov , to je jasné .	náplň	2	Fem
So zatajeným dychom sledovala , ako Snehulienka zahryzla do jabĺčka .	jabĺčka	9	Neut
Vláda bude naďalej podporovať účasť Ozbrojených síl SR v mierových misiách a operáciách na podporu mieru a na boji proti terorizmu , s dôrazom na operácie pod vedením NATO .	operáciách	12	Fem
Titan Ľadovec dokončil jeho dielo a zmrazil lávu dychom .	lávu	7	Fem
Keď Maja začula žalostný nárek muchy , zabudla na strach pred žabami .	nárek	4	Masc
Napokon chytil vak a hodil mi ho na kolená .	kolená	8	Neut
Vláda podporí doriešenie vlastníckych vzťahov k pôde a rozvoj trhu s pôdou .	trhu	9	Masc
Uvedené komplexy sa vyznačujú zmiešaným osídlením Slovanov s inými etnikami a tvrdošijným zachovávaním archaických prežitkov rodového zriadenia , kým mestá sú čisto slovanskými sídlami , určenými na pacifikáciu a christianizáciu kolonizovaných oblastí .	osídlením	5	Neut
Tri uvedené stupne výskumu nás vedú ku konštatovaniu , potvrdzujúcemu úvodnú tézu o tesnej prepletenosti oboch systémov , obohatenému však poznaním vnútornej dynamiky jej vývoja .	výskumu	3	Masc
N . T . bol za stenou , vyšetroval Margu .	stenou	6	Fem
Spomínaní clunyjskí opáti boli osobnosťami s mimoriadnymi osobnostnými kvalitami a veľkou morálnou autoritou .	opáti	2	Masc
Vláda bude podporovať programy v horších pôdnych a klimatických podmienkach a orientovať sa na mimoprodukčné funkcie poľnohospodárstva a agroturistiky .	poľnohospodárstva	16	Neut
Človeka to bohvieako nezaujímalo , popíjal z pohára a škriabal na papier tie svoje znaky .	Človeka	0	Masc
To je tretia brutalita marketingu .	marketingu	4	Masc
A keď som ho počúval , pri akejsi zmene v zafarbení jeho hlasu sa mi na chvíľu zazdalo , že ho poznám .	zafarbení	10	Neut
Aladin pokrčil plecami .	plecami	2	Neut
A po ďalšej minúte sa opäť rozburácal divoký rev davu .	davu	9	Masc
U ugrofínskych národov fungoval orol ako predok a ochranca šamanov .	ochranca	8	Masc
Tentoraz na televízne obrazovky v podobe 13 - dielneho seriálu .	seriálu	9	Masc
“ Ešte by som si niečo dal , “ povedal Chris , keď pozrel na jedálny lístok .	lístok	16	Masc
Alebo spoločne spáchajú samovraždu .	samovraždu	3	Fem
Mal na sebe krátke nohavice farby kaki a športovú košeľu .	nohavice	4	Fem
Zajac mohol byť vykladaný v systéme predkresťanských názorov jednak ako symbol plodnosti / dodnes spájame na veľkú noc vyobrazenia zajacov s vajíčkami , Nemci počas tohto sviatku hľadajú v záhrade vajíčka ukryté veľkonočným zajacom / .	vyobrazenia	18	Neut
Ženy a deti sledovali z úkrytu , ako sa muži skrývajú za Jumbom .	Ženy	0	Fem
Aj keď v noci ešte nelietala , rozprestrela krídla a opustila svoju bezpečnú dutinku v strome .	krídla	8	Neut
Mohutná posteľ pri okne bola zastlaná dotrhanými prikrývkami a na poduške chýbala obliečka .	okne	3	Neut
Posledný krok urobí na Ministerstve lásky .	Ministerstve	4	Neut
Prvýkrát počas celého výsluchu som sa mu pozrel do očí .	očí	9	Neut
Vláda bude pokračovať v transformácii železníc .	železníc	5	Fem
Opatrne ju položil na zelené súkno .	súkno	5	Neut
Neďaleko jazdil na koni mladý princ .	koni	3	Masc
Pravdepodobne to teda bol cudzinec .	cudzinec	4	Masc
Naším zámerom je odstrániť najmä deformácie , ktoré zakladajú neopodstatnené nerovnosti medzi občanmi alebo zavádzajú do sociálneho systému cudzorodé prvky , akým je napríklad nesystémové včlenenie kúpeľnej starostlivosti do sociálneho poistenia .	občanmi	12	Masc
Duchovia sa však v tomto prípade nechcú objaviť — boja sa kríža , ktorý má Novgorodec pri sebe .	Duchovia	0	Masc
Vláda sa bude usilovať o postupné zapájanie kapacít nášho obranného priemyslu do štruktúr európskeho obranného priemyslu .	priemyslu	10	Masc
Podporíme urýchlenie legislatívneho , inštitucionálneho a administratívneho dobudovania štruktúr potrebných na výkon Spoločnej poľnohospodárskej politiky .	urýchlenie	1	Neut
Vilkova radosť z Majinej chvály sa topila ako ľad na slnku .	ľad	8	Masc
Tí vo väčšine prípadov velebili filmy nakrútené podľa mojich scenárov .	väčšine	2	Fem
Jednoznačne ide o účelovú mystifikáciu s cieľom zmanipulovať konanie bežného občana a obrať ho o posledné základné životné istoty .	istoty	18	Fem
Žuk meškal , a hoci som sa všemožne pokúšal opäť zaspať , nedarilo sa mi to .	Žuk	0	Masc
Tradičnú retrospektívnu sekciu programovo každý rok napĺňajú filmy zástupcov jednotlivých krajín všetkých troch zúčastnených kinematografií .	sekciu	2	Fem
Lavdima Lavdoshaja zaraďovali k príslušníkom konzervatívneho krídla .	krídla	6	Neut
Požiadavka primeraného vzdelania klerika nepotrebuje obšírnejší komentár .	Požiadavka	0	Fem
Na niektorých uliciach metropoly sa matky ani na chvíľku neodvážia nechať svoje bábätká samotné .	metropoly	3	Fem
Skvelé prekvapenie .	prekvapenie	1	Neut
S tým však moja okamžitá strata optimizmu nesúvisí , a nesúvisí ani so skutočnosťou , že predstava takého scenára bola nezmyselná .	scenára	18	Masc
Priateľky a príbuzní ju ponechali svojmu osudu .	príbuzní	2	Masc
Tentoraz mu ju však pripomenula najmä dusná horúčava toho popoludnia , keď mu na čele vyrazili kropaje potu .	popoludnia	9	Neut
Svorka sa usadí okolo kmeňa stromu .	Svorka	0	Fem
Vláda bude pri všetkých reformách venovať osobitnú pozornosť tomu , do akej miery navrhované zmeny prispievajú k zníženiu nezamestnanosti a finančnej náročnosti pre daňovníkov a k posilňovaniu motivácie hľadať prácu .	motivácie	27	Fem
Na slnku jej telo žiarilo .	slnku	1	Neut
Jeho pani bola na počudovanie osa a mala veľmi útly driek .	útly	9	Masc
Stretla ho v tieni čiernej bazy , keď počúvala spev červienky .	spev	9	Masc
Na Makovej lúke panovalo ticho .	ticho	4	Neut
“ PÄŤ TELEFONÁTOV ! “ zvolala som , keď som zbadala , že doma v chodbe bliká svetielko na odkazovači .	odkazovači	19	Masc
Možnože dievča je jeho členkou !	členkou	4	Fem
Prirodzeným dôsledkom takéhoto stretu je rozbíjanie vervi a úsilie o znevoľnenie smerdov .	vervi	6	Fem
Keď sme asi hodinu kráčali po ceste pre vozy , mama odbočovala ku kravínom a ja som išla ďalej do školy .	kravínom	13	Masc
Bol pri dievčati .	dievčati	2	Neut
Ležal v bezvedomí na zemi .	zemi	4	Fem
Aj reformný kánonista Anselm uvádza vo svojej zbierke viacero nariadení o konaní synod .	kánonista	2	Masc
Na úplný záver dlžím ešte jedno poďakovanie .	poďakovanie	6	Neut
Nôž by mal minimálne obsahovať : veľkú a malú čepeľ , otvárač na fľaše a konzervy , rydlo , výhodné je , ak obsahuje dierovač , pílku na drevo , vývrtku , pinzetu .	rydlo	17	Neut
Zem sa ustavične triasla a kopček z hliny rástol a rástol .	hliny	7	Fem
Z nálezov nefigurálneho charakteru je zaujímavý nález troch hlinených kraslíc .	nález	6	Masc
Zavedenie inštitútu manažéra súdu zníži počet funkcionárov súdov , ktorí obmedzene vykonávajú súdnictvo .	súdnictvo	12	Neut
Hore budeš v bezpečí . “	bezpečí	3	Neut
Prstom zalovil v hrnci a nabral si porciu kaše .	kaše	8	Fem
Vysoko na oblohe uprostred jasných hviezd žiaril guľatý mesiac .	oblohe	2	Fem
Nešiel som na letisko .	letisko	3	Neut
Vznik a charakter štatútu .	Vznik	0	Masc
Proces optimalizácie a scivilňovania štruktúr rezortu ministerstva bude pokračovať .	scivilňovania	3	Neut
Pod ním bola na fotografii Cruellina priateľka Anita , jej manžel Roger a ich kuchárka .	priateľka	6	Fem
Teraz sa chvíľu bavme o tebe . “	chvíľu	2	Fem
Nuž som sa rozhodol , prirodzene , že ten rubín zmizne z jeho vrecka a zjaví sa v mojom . “	rubín	9	Masc
Meg trápili starosti .	starosti	2	Fem
Možno ju poslali do tábora nútených prác .	tábora	4	Masc
Prísny , spravodlivý a efektívny výber daní a odvodov bude jedným zo základných predpokladov znižovania ich sadzieb .	znižovania	14	Neut
Navyše technológia našich tlačiarní sa ani dnes veľmi neodlišuje od technológie z čias Gutenberga .	technológia	1	Fem
V súlade s európskym trendom budeme podporovať rozširovanie výmery ekologického poľnohospodárstva a výroby biopotravín .	biopotravín	13	Fem
Nebolo tajomstvom , že odoslané listy sa bežne otvárajú .	tajomstvom	1	Neut
Listina je o šesťsto rokov staršia než iné zo známych písomných pamiatok v karelčine .	karelčine	13	Fem
Pred odchodom upchám dieru kusmi vrecoviny .	vrecoviny	5	Fem
Starec po ňom hodil bochník starej pity .	pity	6	Fem
Nijaké šteklenie .	šteklenie	1	Neut
Príčiny ochorenia úzko súvisia s nezdravým životným štýlom , svoju významnú úlohu zohrávajú alkohol , fajčenie , nedostatok pohybu , nadváha a obezita , stres , poprípade nedostatok zdravých potravín .	fajčenie	15	Neut
Odložil som pohár a očami som opäť zablúdil k protiľahlým stolom , pri ktorých sedeli spomínaní ľudia .	očami	4	Neut
Rozzúreného Šuchtáka vystrieda slimák Plazivec a hra pokračuje .	slimák	3	Masc
Grifony zapriahnuté v nebeských záprahoch božstiev fungovali ako zjednotitelia neba a zeme .	neba	9	Neut
Ak ste sa na ňu pozreli zblízka , okolo očí mala zopár vrások .	vrások	12	Fem
Prvý deň sa deťom v škole veľmi páčilo !	deťom	3	Neut
Zostal som pri telefóne so zatajeným dychom .	dychom	6	Masc
Na dvore som hadicou napustila slnkom zohriatu vodu a začala som šampónovať auto .	slnkom	5	Neut
Presne takúto podobu , teda jednoduché príkazy či predpisy , majú i príslušné nariadenia v sledovaných kánonickoprávnych zbierkach .	zbierkach	17	Fem
Konfirmáciou sa začína skutočný boj s hriechom , diablom a vlastným telom .	boj	4	Masc
Podišiel som k oknu , že sa spýtam svojich postáv , čo si o tom myslia .	postáv	9	Fem
Ferdo z toho usúdil , že bývalí otrokári nevedia ani písať .	otrokári	7	Masc
Voda špliechala o okraje a zamočila ležadlá pri bazéne .	okraje	3	Masc
Vtom sa mladík zháčil .	mladík	2	Masc
Postupne mu však ten príval hudby vyhnal z mysle všetky špekulácie .	príval	4	Masc
Ako na zavolanie sa zjavila Meg .	zavolanie	2	Neut
Vláda v spolupráci s predstaviteľmi územnej samosprávy vytvorí transparentný inštitucionálny a finančný návrh na kofinancovanie regionálneho rozvoja z prostriedkov štátneho rozpočtu a z fondov EÚ .	kofinancovanie	14	Neut
Zasadalo zborové presbyterstvo	presbyterstvo	2	Neut
Toto ministerstvo však nemuselo uspokojovať mnohoraké potreby straníkov , ale opakovať celú operáciu na nižšej úrovni pre blaho proletariátu .	proletariátu	18	Masc
Zrazu som začula klopkanie na okno , no neposkočilo mi srdce ako inokedy .	okno	5	Neut
Zmĺkla som , lebo som si spomenula , ako sa moja mama pustila do pečenia aj po dvoch šichtách .	pečenia	14	Neut
Akékoľvek doklady o Fulbertovom ideovom vplyve na Boniperta však chýbajú .	vplyve	5	Masc
Vláda bude zabezpečovať realizáciu Stratégie rozvoja slovenského knihovníctva .	knihovníctva	7	Neut
Oslík zahol do jednej z ulíc .	Oslík	0	Masc
Presne , “ odvetila som a pokrčila plecami .	plecami	7	Neut
Moja extáza nastala vo chvíli jej delíria .	extáza	1	Fem
Ako ospanlivé nočné strašidlá .	strašidlá	3	Neut
Mozog sa mi tentoraz dal do pohybu .	Mozog	0	Masc
Nilus bol skôr predstaviteľom východného typu mnícha , v osobe ktorého sa spájala vysoká miera asketizmu s rovnako vysokou úrovňou vzdelanosti a kvality duchovného života .	asketizmu	15	Masc
Jedného dňa sochu odtiaľ strhol dav , ktorý rozzúrilo jej namyslené povýšenectvo .	povýšenectvo	11	Neut
Opantal ho pocit absolútnej bezmocnosti .	pocit	2	Masc
Základom väčšiny dnes známych letopisov je tzv . Rozprávanie o dávnych časoch .	letopisov	4	Masc
Majú nás ako na dlani .	dlani	4	Fem
Nebude jestvovať zvedavosť , radosť zo života .	zvedavosť	2	Fem
Jedného dňa sa Gim objavil pri vchode do školy .	školy	8	Fem
Horace a Jasper sedeli na starej pohovke obklopení tuctami šteniatok a pozerali televíziu .	pohovke	6	Fem
Na stenách viseli zaprášené police s prastarými knihami zaklínadiel a čarov .	knihami	7	Fem
Ale ja nemôžem žiť bez tohto priznania .	priznania	6	Neut
Dôvodom bol práve nevyriešený problém umiestnenia štyri metre vysokého súsošia sv . Cyrila a Metoda v Komárne .	umiestnenia	5	Neut
Na perách sa mu zjavil potuteľný úsmev .	perách	1	Fem
Zároveň dochádza k postupnému vyprázdňovaniu symboliky pohanských obyčajov .	vyprázdňovaniu	4	Neut
V dome zavládlo hrobové ticho .	ticho	4	Neut
Hrobové ticho .	ticho	1	Neut
Vláda bude hľadať spôsoby legislatívnej úpravy , aby v Národnej rade SR neboli prijímané zákony s nekrytými rozpočtovými dôsledkami .	spôsoby	3	Masc
Za opáta Odona , Bernonovho nástupcu , sa potom vytvorili predpoklady , aby sa Cluny stalo strediskom skupiny kláštorov .	predpoklady	10	Masc
Ako vlak , ktorý zišiel z koľají .	vlak	1	Masc
Namiesto neho som objavil dve nečakané veci : svadobné šaty aj s vencom a fotografiu akejsi ženy .	ženy	16	Fem
Mal dlhý kabát , zdvihnutý golier , okuliare so strieborným rámom , červenastú tvár a husté šedivé vlasy .	tvár	13	Fem
Preto samotné pozvanie nebude dôvodom pre sebauspokojenie .	sebauspokojenie	6	Neut
Podporí v rámci krajín EÚ kompatibilnosť v oblasti vzájomného uznávania dokladov o dosiahnutí určitého stupňa vzdelania .	stupňa	14	Masc
V rohu na sklápacom stole v pološere sa jasne lesklo sklené ťažidlo , ktoré tam kúpil na poslednej návšteve .	ťažidlo	11	Neut
Do cely vošiel mladý dôstojník s chladnou tvárou .	tvárou	7	Fem
Ona by mala policajtom všetko vysvetliť .	policajtom	3	Masc
Podľa mojich predstáv sa vracali do pekných domov s vyhrievanými bazénmi .	bazénmi	10	Masc
Maja sa rozhodla , že zasa zaletí do ľudského obydlia .	obydlia	9	Neut
Prichádzali sme zozadu , a tak sme sa vyhli autobusom , autám a nápisom nad vstupom .	autám	11	Neut
" Niekedy , " poznamenala , " pohrozia človeku niečím -- niečím , čomu nedokáže vzdorovať , na čo nedokáže ani pomyslieť .	človeku	8	Masc
Pani Parsonsová priniesla kľúč na matice .	Pani	0	Fem
Jej centrom bol vŕšok , na ktorom sa zrejme nachádzalo hradisko .	vŕšok	3	Masc
Zakrátko zhotovil pekné a pevné nosidlá .	nosidlá	5	Neut
“ Mami ! “ zvolala som .	Mami	1	Fem
Mestské zastupiteľstvo schválilo umiestnenie menších sôch šiestich patrónov Európy na Nádvorie Európy , ktoré je vo výstavbe .	patrónov	7	Masc
V niekoľkých sekundách po prebudení sen i spomienka , ktorá ho podnietila , splynuli v jeho mysli v jedno .	sekundách	2	Fem
Na chodbe zadupotali ťažké čižmy .	chodbe	1	Fem
Z Odilonovho listu Štefanovi I . sa dozvedáme , že clunyjský opát a prvý uhorský kráľ boli vo vzájomnom styku už pred odoslaním tohto listu vzniknuvšieho medzi rokmi 1031 – 1038 .	odoslaním	22	Neut
Vtedy začula Meg z neďalekej stajne známe erdžanie .	erdžanie	7	Neut
Zmeny budú navrhnuté v súlade s európskou legislatívou tak , aby tieto zákony neboli prekážkou zvyšovania zamestnanosti a ekonomického rastu a zvýšili flexibilitu trhu práce .	zamestnanosti	16	Fem
A už miešala v kotli vriacu tekutinu .	tekutinu	6	Fem
V lete 1948 v Prahe zažiadal o zahraničné štipendium .	lete	1	Neut
Na hrebeni sa otočil a zaparkoval autom celkom pri okraji cesty .	autom	6	Neut
V jednom kuse táral o Týždni nenávisti .	kuse	2	Masc
Zvláštnym , odzbrojujúco priateľským gestom , ktoré len on dokázal vyčarovať , si na nose upravil okuliare a pokračoval :	nose	14	Masc
Winston donariekal , aj keď slzy mu ešte stále stekali z očí .	očí	11	Neut
Prinajmenšom ohľadom zlata v peňaženke sa mýlila , obavy som však určite nemal .	zlata	2	Neut
Klopanie sa opakovalo .	Klopanie	0	Neut
Od zatknutia nemal v ústach nič .	zatknutia	1	Neut
Hrebene / okrem svojej prvotnej funkcie slúžili ako amulety na ochranu od zlých síl .	amulety	8	Masc
Abuov citlivý noštek vykrúcalo od najodpornejších pachov a jeho jemné ušká urážalo nedôstojné pokrikovanie .	pokrikovanie	13	Neut
Prešiel som s ňou vchodom a cez dvor do suterénnej kuchyne .	kuchyne	10	Fem
Do izby vstúpil pán Charrington .	pán	3	Masc
Raz to boli gombičky , potom vlnené handry na záplaty a raz šnúrky od topánok ; a teraz to boli žiletky .	topánok	14	Fem
Aladin sa zatiaľ usadil so skríženými nohami pred krištáľovou guľou .	nohami	6	Fem
Vláda bude pokračovať v znižovaní miery prerozdeľovania prostredníctvom verejných financií .	prerozdeľovania	6	Neut
Vtom sa vrátil chrobák Truhlík aj so svojím filmovým časopsom .	časopsom	9	Masc
Z kuchyne som vzala dva vínové poháre a veľkú fľašu malinovky .	malinovky	10	Fem
Kým komáre krúžili koldokola na kraji lesa , na krajinu pomaličky sadala tma .	kraji	5	Masc
Z toho človeka nevravel mozog , ale hrtan .	mozog	4	Masc
Tentoraz mu ju však pripomenula najmä dusná horúčava toho popoludnia , keď mu na čele vyrazili kropaje potu .	horúčava	7	Fem
Zaujal výberom tém aj ich spracovaním .	tém	2	Fem
Celou cestou domov som sa dívala z okna do tmavej prázdnoty .	prázdnoty	10	Fem
Jeho prítomnosť vnáša do útvaru už spomenuté prvky hrdinskej epiky — mýtický boj za odstránenie chaosu sa mení na ochranu štátu a viery proti cudzím pohanom .	ochranu	19	Fem
Za jej chrbtom mi zostala v zábere Talianova tvár .	tvár	8	Fem
Všetky slony rýchlo zdvihli choboty .	slony	1	Masc
Telo by malo mať šiju Jenny Elfman , ramená Courtney Love , zadok Jennifer Lopez , pupok Sandry Bullock a nohy Miry Sorvino .	ramená	8	Neut
Vláda pripraví aktualizáciu národnej stratégie prevencie kriminality a vytvorí legislatívne podmienky na jej realizáciu .	prevencie	5	Fem
Isteže , už dnes nejestvuje dôvod či opodstatnenie na páchanie ideozločinov .	ideozločinov	10	Masc
Koleso sa krútilo a náš vozík pomaly stúpal na vrchol .	Koleso	0	Neut
Pelikánia slečna Polly a jej veľký zobák	zobák	6	Masc
Vo dverách sa objavila plavovláska , pripomínajúca plavovlasé dievčatá z výťahu .	dievčatá	8	Neut
Na jeho základe sa bude financovať tzv . solidárny balík , ktorého súčasťou bude aj financovanie siete rýchlej zdravotnej pomoci .	siete	16	Fem
Na okraji studne sedel zelený žabiak s kockovaným klobúkom na hlave .	žabiak	5	Masc
Len čo to dopovedala , zniesol sa nad ňou modrý tieň , v ktorom stála ako v jazierku .	jazierku	17	Neut
Okolo pohrebnej jamy boli nájdené stopy stĺpov .	jamy	2	Fem
Oči jej vystúpili z jamiek a z vyškerených úst vypadali všetky zuby okrem jedného .	jamiek	4	Fem
M . N . Tichomirov fakt jednostranné vykladá len ako príčinu „ hladových vzbúr “ , Frojanov si všíma dôležitú okolnosť — volchovia sa zjavujú , aby zabezpečili blahobyt , hojnosť , úrodu .	okolnosť	20	Fem
Vyzeráš ako príšera . “	príšera	2	Fem
Skupina kánonov I . ostrihomskej synody sa venuje stanoveniu obsahu bohoslužieb a príbuzným kultovým predpisom .	kánonov	1	Masc
Jej centrom bol vŕšok , na ktorom sa zrejme nachádzalo hradisko .	hradisko	10	Neut
Vystrelil vychudnutú ruku .	ruku	2	Fem
Mohlo byť len zo stromu , do ktorého sa zaťalo sekerou so zatvorenými očami .	sekerou	10	Fem
Jedlo zásadne mení človeka po každej stránke .	Jedlo	0	Neut
Zbadala ho na steble trávy , práve z orlíčka popíjal sladký nektár .	nektár	11	Masc
Mama mi oznámila , že chceš ísť na vysokú a samozrejme , chcem ti podľa svojich možností pomôcť .	Mama	0	Fem
Tarzanova najlepšia priateľka Terk ho prišla zachrániť .	priateľka	2	Fem
Pri analýze skúmaného javu v práci sme použili viac vrstiev v úvode spomenutých prvkov .	vrstiev	9	Fem
Rovnako pri dodaní či vyzdvihnutí fotografií ste ušetrení od úmorného vyčkávania v rade .	vyzdvihnutí	4	Neut
Vytvorí mechanizmy na získavanie a vyhodnocovanie informácií a odhaľovanie týchto prípadov .	vyhodnocovanie	5	Neut
V tejto časti práce podávam prehľad zmienok o prvkoch pohanstva v skúmanej oblasti .	zmienok	6	Fem
Bol plochý a hranatý , na chrbte mal pekný vzor a zdalo sa , že spí .	chrbte	6	Masc
Švihák Pedro sa v letku obrátil a zmizol kdesi v diaľke .	diaľke	10	Fem
Pred dvermi sa objavovali košíky s prekrásnymi plodmi od výmyslu sveta .	výmyslu	9	Masc
Čakal som v obývačke , mal som na sebe oblek s kravatou .	kravatou	11	Fem
Zebríčaťu sa nesmierne páčilo , keď mu prečesávala hrivu .	Zebríčaťu	0	Neut
Na pomoc nám prišiel Brucháč s niekoľkými chrobákmi a onedlho sme mali obydlie pre Chuchlíka pod strechou .	obydlie	12	Neut
Winston sa začal obliekať pomalými , strnulými pohybmi .	pohybmi	7	Masc
Svojím typickým gestom si O ' Brien upravil na nose okuliare .	okuliare	10	Masc
Nešporné služby Božie sa u nás konajú pravidelne každú prvú nedeľu v mesiaci v modlitebni .	mesiaci	12	Masc
Pritom je známe , že remeslo kováčske bolo spájané s magickými šamanskými praktikami u mnohých národov — kováč a šaman sú z jedného rodu hovorí jakutské príslovie .	praktikami	12	Fem
Tieto hliadky neboli dôležité .	hliadky	1	Fem
Začínam byť vážne neznesiteľný snob .	snob	4	Masc
Keď sa však hlasuje v parlamente o zmluve s Vatikánom , zriadení katolíckej univerzity , SNS to podporila . "	zriadení	11	Neut
Priestor — krajný severovýchod oblastí vplyvu Kyjevskej Rusi , obývaný ugrofínskym plemenom Samojedov .	Priestor	0	Masc
Tigríča sledovalo , ako sa rozkotúľali , a skočilo medzi ne !	Tigríča	0	Neut
Zopár minút preskakovali z témy na tému , keď vtom ich rev z televíznej obrazovky vyzval , aby držali jazyk za zubami .	rev	11	Masc
Vedel , že to tak nie je , jej vzrušenie , keď mu podávala odkaz , bolo príliš skutočné .	vzrušenie	9	Neut
Sú nápadné , vyzývavé a slušné dievča sa v nich môže odviazať a vyvádzať ako divoška .	divoška	15	Fem
Keď sa však priblížila , uvidela v tráve svetlovlasé spiace dievčatko v červených šatôčkach .	dievčatko	10	Neut
Bol to ľúbostný maratón od sobotného večera až do pondelňajšieho rána .	rána	10	Neut
Chcel by som s tebou prebrať istú myšlienku , ktorá ma znepokojila len pred chvíľou , keď Irma odišla na letisko .	chvíľou	14	Fem
Jeho obyvatelia odišli a ich odchod sledoval veľký zástup zvedavcov , obyvateľov našej štvrte .	zástup	8	Masc
Navrhli im , že ak chcú prežiť v nových podmienkach trhového hospodárstva , môžu predávať po tiranských chodníkoch cigarety alebo banány .	banány	20	Masc
Odhrnula som mokré plavky , prázdne kokakolové plechovice , ceruzky , listy vytrhnuté z notesa a knižku Kto chytá v žite so somárskymi ušami .	plechovice	7	Fem
Keď si Lori sadla do auta , sklonila sa nad volant , plecia sa jej roztriasli a ja som si zarazene uvedomil , že vzlyká .	plecia	12	Neut
Jeho hlas opäť sprísnel .	hlas	1	Masc
Bojoval proti vykorisťovaniu v indickej spoločnosti , proti krviprelievaniu medzi hinduistami a moslimami , proti vojne , za politickú nezávislosť svojej krajiny .	vykorisťovaniu	2	Neut
Stranu nezaujímajú konkrétne činy : my si potrpíme len na myšlienky .	činy	3	Masc
Možno si až teraz uvedomila , kam to jej klamstvo viedlo .	klamstvo	9	Neut
Počas jazdy sa Rýchlik a Jill hádali , ktorú stanicu naladia .	stanicu	9	Fem
V spánku . Áno , taká je pravda .	spánku	1	Masc
Rovnako prirodzené bolo , že zablúdila očami k fľaši s vodkou značky Smirnoff na stole .	očami	6	Neut
V okne na prvom poschodí zbadala uväznenú cvrčicu .	poschodí	4	Neut
Onedlho začul dupot čižiem niekde mimo cely .	čižiem	3	Fem
V lete 1948 v Prahe zažiadal o zahraničné štipendium .	štipendium	8	Neut
Lori naštartovala auto .	auto	2	Neut
“ Kedykoľvek , “ odvetil Chris s úsmevom , zvrtol sa a plával k trénerovi .	trénerovi	14	Masc
Netrvalo dlho a obaja lavínu skyprili , takže sa párik cvrčkov ľahko dostal von .	párik	9	Masc
Začal som chodiť po izbe s telefónom v ruke .	izbe	4	Fem
V procese obstarávania bude vláda dbať na transparentný systém nakladania s majetkom štátu .	nakladania	9	Neut
“ A správaj sa slušne , srdiečko , “ zašepkala .	srdiečko	6	Neut
Celú noc som sa prevaľoval na posteli v hotelovej izbe a nemohol som sa zmieriť s realitou .	izbe	9	Fem
Abu položil na zem pred mladého muža vankúš .	vankúš	7	Masc
Nočným ovzduším sa nieslo vzrušenie .	vzrušenie	4	Neut
Miznú tak i zvyšky existencie predkresťanskej náhrady za škodu , nahradzujúce prechodne krvnú pomstu .	pomstu	13	Fem
Vláda prehodnotí platné znenie zákona o sociálnom poistení ešte pred nadobudnutím jeho účinnosti .	poistení	7	Neut
Druhou činnosťou , ktorú v Ostrihome klerikom zakázali , bolo úžerníctvo .	úžerníctvo	10	Neut
Aladin si vzdychol , odľahlo mu , že mal tentoraz šťastie .	šťastie	10	Neut
Ak Tichomirov vidí v povstaniach iba element sociálny , Frojanov na jeho úkor vyzdvihuje moment politický .	povstaniach	4	Neut
Samozrejmosťou sú profily fotoaparátov .	Samozrejmosťou	0	Fem
Prijatie novely zákona o štátnej službe umožní okrem iného zamestnanie špičkových odborníkov v ústredných štátnych orgánoch za adekvátneho mzdového ohodnotenia a odstráni nepružnosť zamestnávania v štátnej službe .	orgánoch	15	Masc
Pri štvrtej obrátke sa mi stužka s kľúčikom z krku vyvliekla .	stužka	5	Fem
Petrovi Tvorjata / list dvoch spolupracovníkov /	spolupracovníkov	5	Masc
Dieťa prikývlo , akoby mu rozumelo .	Dieťa	0	Neut
Zúril , až mu vlasy dupkom stáli .	vlasy	4	Masc
NEVEDOMOSŤ JE SILA .	NEVEDOMOSŤ	0	Fem
Ako sprievodcovia do podsvetia Samojedov slúžia napr . hranostaj a myš .	podsvetia	3	Neut
ODCHODY A návraty ĽUBOMÍRA Ďuroviča ( I . )	návraty	2	Masc
Strážca prižmúril oči a poobzeral sa dookola .	Strážca	0	Masc
Smutná dážďovka Vendelín	dážďovka	1	Fem
Určený čas a meno kina mi utkveli v mozgu .	kina	4	Neut
Nechýbali vrúcne kontakty , dlhé lúčenie a pozvanie na ďalšie stretnutie .	kontakty	2	Masc
Nemal topánky , veľké špinavé prsty mu vyčnievali z dier na ponožkách .	topánky	1	Fem
Dnes by ste našu záhradu nepoznali .	záhradu	4	Fem
Srdce mu poskočilo .	Srdce	0	Neut
Na čistinke neostal ani jedinký .	čistinke	1	Fem
Niečo v jej posunku mu naznačilo , že sestrička umiera .	sestrička	8	Fem
Bolo tu pododdelenie televíznych programov s inžiniermi , producentmi a s celými tímami špeciálne vybraných hercov , lebo dokázali imitovať hlasy .	programov	4	Masc
Za jeho stiahnutými mihalnicami sa pohyboval celý les prstov v akomsi tanci , vykrúcal sa a skrúcal , strácal sa jeden za druhým a znova sa objavoval .	prstov	8	Masc
Steblo sa zlomilo a on skončil na chrbte .	chrbte	7	Masc
Od ľaku urobil Vilko kotrmelec .	kotrmelec	4	Masc
Modlime sa a pomáhajme im na ich ceste , aby sa aj ich srdce zapálilo víťazstvom lásky , pravdy , nádeje a života .	nádeje	20	Fem
Sedela na pohovke len v kombiné a čítala jednu z mojich poviedok .	pohovke	2	Fem
Okamžite súhlasil s mojím návrhom a meno prijal bez mihnutia oka .	mihnutia	9	Neut
Bolo tu pododdelenie televíznych programov s inžiniermi , producentmi a s celými tímami špeciálne vybraných hercov , lebo dokázali imitovať hlasy .	pododdelenie	2	Neut
Ešteže to spozorvali mravce a zavolali hasičov !	hasičov	6	Masc
“ Kto to tu plače ? “ spýtala sa tá krehká drobučká bytosť a zvedavo sa poobzerala okolo seba .	bytosť	12	Fem
Medzitým prišlo na plaváreň zopár deciek z oddielu a ich hlasy sa ozývali po vykachličkovanom priestore .	deciek	5	Neut
Vtom k nim pribehol muž z nosidiel .	nosidiel	6	Neut
Na letisko nás prišiel čakať Sergejov priateľ .	letisko	1	Neut
Plukovníkovi Hatímu sa zježil chobot .	chobot	4	Masc
“ Pozri , ocko ! “ zvolala Jane .	ocko	3	Masc
Prečo by vlastne tí mimozemšťania mali byť naši priatelia alebo nepriatelia , keď sa vyvíjali s úplne iným backgroundom , v inom kontexte , majú totálne iný spôsob dorozumievania , ich ciele a motivácie nechápeme ?	dorozumievania	28	Neut
Začiatkom 11 storočia bolo pomerne málo významným sídlom — nespomína sa napr . pri delení údelov Vladimírovým synom .	sídlom	7	Neut
Postupne sa zdvíhanie a klesanie ich hrudí spomalilo a prešlo do normálneho rytmu a s príjemným pocitom bezmocnosti sa od seba oddelili .	klesanie	4	Neut
Vtedy mi utkveli v pamäti dátumy , mená i dôležité udalosti z minulosti , medzi ktoré bolo neskôr ľahšie dokladať nové dátumy , mená i vzťahy .	dátumy	5	Masc
Že Mečiar , suverénny víťaz prvého kola , v druhom kole bol spektakulárne odmietnutý , je spravodlivý trest za roky jeho vládnutia .	vládnutia	21	Neut
Vláda bude presadzovať zrušenie systému maximálnych cien a zmenu kategorizácie úhrady liekov tak , aby obsahom solidárneho balíka bola v každej anatomicko - terapeutickej skupine aspoň jedna účinná látka .	zrušenie	3	Neut
Vietor im prilepil tenké kombinézy na telo .	kombinézy	4	Fem
Aby som sa dostal k vencu , musel som si vziať stoličku .	stoličku	11	Fem
Jazz , blues , rock , funk .	blues	2	Neut
Medzitým zavládol v úli pokoj .	pokoj	4	Masc
Neviditeľní jazdci na koňoch sú vyjadrením predstavy o zlých duchoch , schopných ubližovať človeku odnesením jeho duše do podsvetia .	duchoch	9	Masc
Mala namaľovanú tvár .	tvár	2	Fem
Naším zámerom je odstrániť najmä deformácie , ktoré zakladajú neopodstatnené nerovnosti medzi občanmi alebo zavádzajú do sociálneho systému cudzorodé prvky , akým je napríklad nesystémové včlenenie kúpeľnej starostlivosti do sociálneho poistenia .	starostlivosti	27	Fem
Bála som sa , že keby som naznačila , po čom túžim , mama by si našla aj tretie zamestnanie .	zamestnanie	19	Neut
Nôž by mal minimálne obsahovať : veľkú a malú čepeľ , otvárač na fľaše a konzervy , rydlo , výhodné je , ak obsahuje dierovač , pílku na drevo , vývrtku , pinzetu .	pinzetu	32	Fem
Sultán spustil plecia .	plecia	2	Neut
Maja začala zostavovať mužstvo .	mužstvo	3	Neut
Srdce mu divoko bilo .	Srdce	0	Neut
Nechal som televízor zapnutý a privliekol som sa k dverám bytu .	bytu	10	Masc
Zároveň sa ale postupne menilo aj ponímanie zločinu a trestu .	ponímanie	6	Neut
Tri uvedené stupne výskumu nás vedú ku konštatovaniu , potvrdzujúcemu úvodnú tézu o tesnej prepletenosti oboch systémov , obohatenému však poznaním vnútornej dynamiky jej vývoja .	stupne	2	Masc
Tieto kulty a božstvá sú dedičstvom ich rasy , sú dôležitou súčasťou ich každodenného života na vidieku .	vidieku	16	Masc
Potom Maju nežne pohladila po hlávke a vraví : “ Spoznáš krásny veľký svet , Maja , hrejivé slniečko a nádherné lúky plné kvetov .	slniečko	18	Neut
Uhorskí zákonodarcovia vytvárali zákony a kánony v prvom rade s ohľadom na konkrétne domáce podmienky a snaženia reformátorov boli pre nich druhoradé .	snaženia	16	Neut
Guľôčka , kliniec , gombík i zrkadielko .	zrkadielko	6	Neut
Meg márne odmietala , lebo podľa starej dohody s Hádesom vymenila svoju slobodu za život bývalého priateľa .	priateľa	16	Masc
Vládol tu čulý ruch , no Chrisa nevyrušil zo sústredenia .	sústredenia	9	Neut
V oblasti prepravných povolení v cestnej doprave sa realizuje nový transparentný systém založený na princípe nárokovosti pri splnení požadovaných kritérií a podmienok	povolení	3	Neut
Tá relácia , i keď varovala pred známymi dôsledkami zbožšťovania jedla , ma definitívne presvedčia o tom , čo som už dávnejšie tušil .	dôsledkami	8	Masc
Pokrútil hlavou .	hlavou	1	Fem
Vláda zabezpečí uvedenie nového registra obyvateľov do prevádzky .	uvedenie	2	Neut
“ Chodí spať ako slniečko , “ povzdychol si motýľ Emanuel .	slniečko	4	Neut
Moja lavica však bola rýchlejšia .	lavica	1	Fem
Vo vzduchu sa vznášali farebné balóniky , v pestrých stánkoch bolo množstvo všakovakých dobrôt .	dobrôt	13	Fem
Deti sa veľmi tešili , keď Lulu kŕmila mláďatká .	Deti	0	Neut
Maja sa rozhodla , že zaletí do chladného lesa , kde je ticho a tieň , aby mohla pokojne popremýšľať o všetkom , čo v noci zažila .	ticho	12	Neut
V piaty deň každého mesiaca išla Irma na poštu s príslušným kódom a priniesla domov sto dolárov .	mesiaca	4	Masc
Jachtala som , rýchlo som zavrela notes a strčila ho späť do vaku .	notes	6	Masc
Drôtené dvierka delila od jeho tváre len šírka niekoľkých dlaní .	dlaní	9	Fem
Chytila Petronilu pod krk a niekoľkokrát ňou zatriasla .	krk	3	Masc
Na bielizníku mi nechala odkaz : “ Dúfam , že si sa dobre bavila , srdiečko . “	srdiečko	15	Neut
Celý ďalší týždeň jeho život pripomínal nepokojný sen .	sen	7	Masc
Vláda pripraví legislatívny rámec inštitucionálneho vzdelávania zdravotníckych pracovníkov prostredníctvom rezortu školstva s možnosťou postgraduálnej prípravy pracovníkov v zdravotníctve v školách a inštitúciách , ktoré získajú akreditáciu pre príslušný typ vzdelávania .	vzdelávania	29	Neut
Okrem toho som mala zo seba hrozný pocit , pretože Rick sa len mierne knísal zboka nabok a meravo mi držal prsty .	prsty	21	Masc
Miesto — čudská oblasť , obývaná plemenom baltskej proveniencie , predkami dnešných Estóncov .	plemenom	6	Neut
“ Vy ten červík zjete ? “	červík	3	Masc
Súboj s Netvorom	Súboj	0	Masc
Ešte mal zalepené hlasivky a nemohol rozprávať .	hlasivky	3	Fem
Po tejto dohode prichádza aj koniec historky .	dohode	2	Fem
Na chvíľu som sa započúval do ticha na schodišti .	chvíľu	1	Fem
Vláda si uvedomuje , že súčasťou problémov v rezorte zdravotníctva a dôvodom nespokojnosti obyvateľstva je vysoká miera korupcie .	zdravotníctva	9	Neut
Zbadala ho na steble trávy , práve z orlíčka popíjal sladký nektár .	orlíčka	8	Masc
Proroctvo otcovho priateľa , že bude zo mňa básnik , sa nesplnilo .	Proroctvo	0	Neut
V úvode pasáže volchvi symbolizujú bielych šamanov , vysporiadávajúcich sa s čiernymi šamanmi .	pasáže	2	Fem
Moja myseľ opäť postrehla akúsi súvislosť medzi autom a týmito dvoma mužmi .	autom	7	Neut
Istým spôsobom sa mi tam oddávala , v sále bábkového divadla .	divadla	10	Neut
Mauglí nevinne pokrútil hlavou .	hlavou	3	Fem
Je síce pravda , že nijaký súdruh Ogilvy nikdy neexistoval , ale zopár riadkov v tlači a niekoľko vyfabrikovaných fotografií čoskoro splodia jeho existenciu .	tlači	15	Fem
“ Ale , počkaj chvíľu , “ odvetil Mauglí .	chvíľu	4	Fem
Vláda pripraví podmienky pre sústredenie kompetencií v oblasti regulácie a koordinácie elektronickej komunikácie a rozvoja informačnej spoločnosti z rôznych orgánov na jeden regulačný orgán .	sústredenie	4	Neut
Straníčky sa nikdy nefarbili .	Straníčky	0	Fem
Do izby vstúpil pán Charrington .	izby	1	Fem
Vlastne patril do početného týmu odborníkov , ktorý pripravoval jedenáste vydanie Slovníka newspeaku .	odborníkov	5	Masc
Vystúpenie veľkého množstva jeho bojových oddielov sa dalo chápať i ako pohanský nepokoj — prežitky predkresťanskej viery sa u Estóncov udržali neobvykle dlho .	nepokoj	12	Masc
Sandra hľadala Koru po dome a Barbie po záhrade .	záhrade	8	Fem
Podľa N . M . Tichomirova ide len o označenie ich sociálneho postavenia , my však vyslovujeme domnienku , že ide o pozostatok matriarchátu , zvlášť silného u ugrofínskych plemien .	matriarchátu	23	Masc
Tentoraz to však nebolo hlásenie o vojenskom víťazstve , ale iba oznámenie Ministerstva hojnosti .	hlásenie	4	Neut
Nakoniec obrazovka môjho mozgu zhasla a uprostred nej zostal jeden žiariaci bod .	bod	11	Masc
“ Možno by sa princeznej páčili nové šaty , “ navrhol Nassir .	šaty	7	Fem
Tu dnu , to vedel inštinktívne , sa svetlá nikdy nevypínajú .	svetlá	8	Neut
Šéf sa zo všetkých síl pokúšal , aby som odišiel z jeho pracovne spokojný , aj keď mi tú poviedku neuverejní .	Šéf	0	Masc
Blythe mi požičala prekrásne hodvábne modré šaty a v trojici sme sa zjavili v piatok večer na plese .	plese	17	Masc
Vláda pripraví koncepciu legislatívnych opatrení a ekonomickú stratégiu pre digitalizáciu televízneho a rozhlasového vysielania .	opatrení	4	Neut
Práve poletovala medzi bielymi jazmínovými kvetmi a nevšimla si jemnulinké a tenulinké vlákna napnuté medzi konárikmi .	kvetmi	5	Masc
V každom prípade aj text jeho úvodu dal Doležalovej gramatike punc najautoritatívnejšieho zdroja poznania vtedajšieho spisovného jazyka Čechov i Slovákov .	úvodu	6	Masc
Bratovi farárovi prajeme v tejto funkcii múdrosť , vytrvalosť a Božie vedenie .	vedenie	11	Neut
Preskúmal jej dlhé prsty , pekne vytvarované nechty , dlaň zatvrdnutú ťažkou prácou s množstvom mozoľov , hladkú pokožku pod zápästím .	množstvom	14	Neut
Vyvesili na tabuľu text , ale ani to nepomohlo , lebo Vilko sa z lenivosti nenaučil dobre čítať .	text	3	Masc
“ Kvak , “ zvolala na krtka žaba , “ počkaj , pomôžem ti .	krtka	6	Masc
Ukazuje sa teda , že tým stredoslovenským nárečím , ktorÉ Štúrovci povýšili na spisovný JAZYK , bol prestížny liptovský mestský jazyk .	JAZYK	14	Masc
A z opičky sa razom stala detská hračka s činelami .	opičky	2	Fem
Deti sa veľmi tešili , keď Lulu kŕmila mláďatká .	mláďatká	8	Neut
Potom sa rozhostilo ticho .	ticho	3	Neut
Tamojší zdravotník i Delina prišli do tej dediny z mesta .	dediny	7	Fem
Niekedy sa objavovali obyvatelia Čarodejníckej vily , všetkých som poznala a vedela som , aký bol osud každého z nich .	vily	5	Fem
Trvalo to , až kým výťah nezastal na siedmom poschodí .	poschodí	9	Neut
Cez Bibliu sa ako červená niť tiahne hodnota človeka .	človeka	8	Masc
" To robí táto pliaga , " povedala , strhla si šarlátovú šerpu Antisexuálnej ligy mládeže a odhodila ju na konár .	ligy	14	Fem
Chcel by som s tebou prebrať istú myšlienku , ktorá ma znepokojila len pred chvíľou , keď Irma odišla na letisko .	letisko	20	Neut
Chcela som zaplniť ticho , čo medzi nami zavládlo , a tresla som parádnu hlúposť .	ticho	3	Neut
Našťastie za prvým bukom stretli Truhlíka a zistili , že aj on má na otrokárov ťažké srdce .	bukom	3	Masc
Slniečko hrialo , ľan schol a krtko zaspal .	krtko	6	Masc
Vnútri jedného z nich som uvidel fotografiu ženy .	fotografiu	6	Fem
Chvíľu leteli , až pristáli v spustnutej záhrade , kde bola pod obrovskou smutnou vŕbou hlbočizná studňa .	vŕbou	14	Fem
Pri raňajkách som mame vyrozprávala ten sen .	sen	6	Masc
Tá žena patrí niekomu inému a ja som strašidlo .	strašidlo	8	Neut
Musím rešpektovať Marginu požiadavku , aby som deťom nič nepovedal , a zároveň musím nájsť pre Irmu nejaké presvedčivé vysvetlenie .	vysvetlenie	19	Neut
“ Ocko ! “ zvolala Jazmína , keď sultán zmizol .	Ocko	1	Masc
Sprevádzali ho ďalší štyria strážcovia s vytasenými mečmi .	strážcovia	4	Masc
Rýchlo som upratala zo stola a ponáhľala sa do svojej izby .	stola	4	Masc
Ako predpokladal , pán Charrington nerobil s prenájmom izby nijaké drahoty .	drahoty	10	Fem
Mozog mi pracoval na plné obrátky , keď som zvažovala , ktorá z možností je správna a meravou rukou som úhľadne zakrúžkovávala odpovede ceruzkou , úplne vlhkou od potu .	rukou	18	Fem
Zúfalo po tebe túžim , slečna , a to je jedno z mojich bláznovstiev .	bláznovstiev	13	Neut
A bodliak Makulienku i motýľa Emanuela radšej pustil .	bodliak	1	Masc
Vseslav — vodca kyjevského povstania je z Polocka a nepokoje sú i v Novgorode .	povstania	4	Neut
Keď ju vyvreskúvali stovky hrdiel za dupania pochodujúcich nôh , zmocňovala sa človeka hrôza .	hrdiel	4	Neut
Od rána do večera som pil čaj s citrónom , aby som sa čo najskôr uzdravil a mohol Lienke splniť jej sen .	rána	1	Neut
A , prosím ťa , nalej mi ešte raz do tohto pohára !	pohára	11	Masc
Proces optimalizácie a scivilňovania štruktúr rezortu ministerstva bude pokračovať .	rezortu	5	Masc
Aj to je argument pre zastupiteľstvo . "	zastupiteľstvo	5	Neut
Stĺpy boli spojené prútím , alebo žrďovinou .	žrďovinou	6	Fem
Zišlo mu na um , že až doteraz ho zrejme nevidela na voľnom priestranstve v plnom dennom svetle .	um	3	Masc
Winstona bolestne bodlo pri srdci .	srdci	4	Neut
Chvíľu ho nechali metať sa vo vode , no potom prilákali k studni muža , čo okopával záhradku .	studni	12	Fem
Uprostred salóna bol jedálenský stôl .	salóna	1	Masc
Na líci sa nachádza ruža so štyrmi lupienkami , obkolesená zložitou dekoratívnou obrubou .	líci	1	Neut
V oblasti aktívnej politiky trhu práce bude vláda presadzovať princíp návratnosti a projektového financovania .	financovania	13	Neut
Mravce dovliekli celý kôš dobrôt , včielky priniesli ovocný medovník a Kasandra jazmínové želé .	včielky	6	Fem
Nikita sám , ako je v texte uvádzané , sa neskôr stáva novgorodským biskupom .	biskupom	13	Masc
Doma Alfonz bratovi vyčítal , že mu svojím správaním urobil hanbu a vyhodil ho .	správaním	8	Neut
“ Vy ste jasnovidec ? “	jasnovidec	3	Masc
Pri realizácii zahraničnej politiky bude vláda SR venovať stálu pozornosť otázkam ľudskej dimenzie .	dimenzie	12	Fem
“ Chcem ostať v džungli , “ hundral nahlas .	džungli	4	Fem
Mama sa každú chvíľu vráti z práce .	chvíľu	3	Fem
“ Tak tu si , poklad môj .	poklad	5	Masc
Vráť sestričke jej čokoládu ! "	sestričke	1	Fem
U nás jeme to , čo sa objedná cez donášku alebo mrazené jedlá , “ povedal Chris .	jedlá	12	Neut
To námestie bolo akousi stanicou .	námestie	1	Neut
Koordináciu európskej politiky štátu ako súčasti zahraničnej politiky bude zabezpečovať MZV SR v úzkej spolupráci s ostatnými ústrednými orgánmi štátnej správy .	Koordináciu	0	Fem
Tak znie neodvolateľné proroctvo o osude jeho umenia .	umenia	7	Neut
Postav ho na okrúhly stôl .	stôl	4	Masc
Počul , ako Júlia zaťala zuby . " Asi by sme sa mali rozlúčiť , " poznamenal .	zuby	5	Masc
“ Klobáska , “ povedala Shannon .	Klobáska	1	Fem
Zväčša to boli obyčajní zločinci , ale našla sa tam aj hŕstka politických väzňov .	zločinci	4	Masc
Začal písať o značkách aj seriál , pretože patria neodmysliteľne k našej civilizácii .	značkách	3	Fem
Na druhej strane slovo Kominterna vnuká predstavu prísne štruktúrovanej organizácie a dobre zoštylizovanej ideologickej doktríny .	Kominterna	4	Fem
Niekedy s chabou nádejou myslel na O ' Briena a žiletku .	žiletku	10	Fem
Zips sa mu už dávnejšie odtrhol .	Zips	0	Masc
Hlas mi znel neprirodzene .	Hlas	0	Masc
Dodržiaval som toto pravidlo , odkedy som napísal prvú hlúposť z toho cyklu , krátku esej s dlhým názvom Orgazmus alebo Hrôza zo sexuálneho vyčerpania .	pravidlo	3	Neut
Gaston od úžasu onemel , keď uvidel , ako Bela cvála na koni cez kamenný most .	koni	12	Masc
Poviedky typu Sexuálny nenásytník ani eseje ako Esej o vši nemali budúcnosť .	nenásytník	3	Masc
Ten chlapec si doň predtým vopchal žabu .	žabu	6	Fem
Zaleteli k lesu , kde Svetlanka ukázala na uzučkú škárku v zemi .	škárku	9	Fem
Po analýze a vyhodnotení doterajších skúseností s pilotnými prevádzkami vláda vytvorí podmienky na jeho rozšírenie na všetky súdy .	vyhodnotení	3	Neut
Strana vyhlásila , že Oceánia nikdy nebola spojencom Euroázie .	Strana	0	Fem
Zobudilo ma zvonenie telefónu .	telefónu	3	Masc
V súlade s európskym trendom budeme podporovať rozširovanie výmery ekologického poľnohospodárstva a výroby biopotravín .	rozširovanie	7	Neut
Do cely vošiel Parsons .	cely	1	Fem
Vláda prehodnotí doterajší spôsob podpory malého a stredného podnikania s akcentom na územnú samosprávu a prihraničnú spoluprácu .	akcentom	10	Masc
“ Chyť volant , “ povedal a otočil sa k zadnému sedadlu , kde mal športový vak .	vak	16	Masc
Opatrne vyzrela z komôrky .	komôrky	3	Fem
Podľa zoznamu posadnikov , uvedených v novgorodskom prvom letopise mladšieho vydania sa nazýval Zavid .	posadnikov	2	Masc
“ Dotkni sa vretena .	vretena	3	Neut
Situáciu umožňujú skompletizovať archeologické vykopávky v Timerevskom hradisku .	Situáciu	0	Fem
Majine jemné krídelká sa jagali ako perly a zlatisté telíčko na slnku len tak žiarilo .	telíčko	9	Neut
A po rozlúčke s ním som mal zvláštny pocit .	rozlúčke	2	Fem
Individualista , vzbúrenec , latentný terorista .	terorista	5	Masc
V lese som krok za krôčikom snoril pod krami a pod kameňmi .	krôčikom	5	Masc
Dieťa rodičov Vnútornej strany sa nenarodilo do Vnútornej strany .	rodičov	1	Masc
Vláda bude pri všetkých reformách venovať osobitnú pozornosť tomu , do akej miery navrhované zmeny prispievajú k zníženiu nezamestnanosti a finančnej náročnosti pre daňovníkov a k posilňovaniu motivácie hľadať prácu .	posilňovaniu	26	Neut
Ešte mu v ušiach znel smiech a potlesk divákov .	ušiach	3	Neut
Pred okienkom do pivnice ležal lesklý tvor s červenými očami a nahlas funel .	očami	9	Neut
Na druhej strane je zaujímavé , že v sledovaných cirkevnoprávnych zbierkach sme nenašli žiadne ustanovenia o podmienkach využívania azylu .	využívania	17	Neut
Natiahla sa k zásuvke na mojej strane a prehŕňala sa v nej , až kým nenašla škatuľku cigariet .	škatuľku	16	Fem
Premenlivosť minulosti je podstatou angsocu .	Premenlivosť	0	Fem
Odhrnula som mokré plavky , prázdne kokakolové plechovice , ceruzky , listy vytrhnuté z notesa a knižku Kto chytá v žite so somárskymi ušami .	notesa	14	Masc
V hlbinách zasa mocné morské obludy . “	obludy	5	Fem
Winstona bolestne bodlo pri srdci .	srdci	4	Neut
Uplatní transparentný postup pri schvaľovaní podpôr .	schvaľovaní	4	Neut
Robili tak skôr mocní šľachtici , usilujúci sa o odtrhnutie časti krajiny / najpríhodnejším príkladom je tu uhorské povstanie Vathu roku 1046 v Bekeszi / .	šľachtici	4	Masc
Vláda považuje štíhlejší , funkčnejší a menej náročný verejný sektor za nevyhnutnú podmienku úspešnej správy vecí verejných .	podmienku	12	Fem
Winston sedel na svojom mieste a civel do prázdneho pohára .	pohára	9	Masc
Nedávno som odovzdal do skalického Záhorského múzea otcove denníky .	denníky	8	Masc
Po obidvoch stranách chodby boli dvere vedúce do izieb so štvorcifernými číslami .	stranách	2	Fem
A prišli naraz , mama do izby a prudký lejak do obloka .	lejak	9	Masc
Nahol sa ku mne a odhrnul mi z tváre mokré vlasy .	vlasy	10	Masc
Euroáziu chráni jej obrovská rozloha .	rozloha	4	Fem
Guľôčka , kliniec , gombík i zrkadielko .	kliniec	2	Masc
Leopard Sabor sa chystal zaútočiť .	Leopard	0	Masc
Niekedy jej rozprával o Oddelení záznamov a o nehanebných falzifikátoch , ktoré v ňom fabrikuje .	Oddelení	4	Neut
Opice skákali z konára na konár a preskakovali koruny stromov , čo rástli pozdĺž brehu rieky .	stromov	9	Masc
Autografy — nápisy obsahujúce predovšetkým meno píšuceho .	Autografy	0	Masc
Pevnejšie pritlačila veko košíka a odháňala Syreetinu zvedavú opičku .	opičku	8	Fem
Do minúty zhorí na popol .	popol	4	Masc
S námahou som pochopil , že má na mysli moju chlpatú hruď .	hruď	11	Fem
Drsný koniec srbského " partizána "	partizána	4	Masc
Dôvod je jednoduchý .	Dôvod	0	Masc
Po chvíli prišli na svet štyri drobnučké šteniatka .	šteniatka	7	Neut
Jaskyne ma vždy lákali .	Jaskyne	0	Fem
Alfonz prijal s úľavou od kamarátov ponuku , že mu pomôžu pripraviť oslavu .	oslavu	12	Fem
Usmiala sa na Kalifa , až sa jej na lícach zjavili jamky .	lícach	9	Neut
Bolo to v jeden januárový deň , z popolavej oblohy padal jemný dážď .	oblohy	9	Fem
Našiel prastarý turban a knihu .	turban	2	Masc
Vysoko na nebi vyšiel mesiac .	nebi	2	Neut
Raz sa podobali na rybu , potom na obra alebo na obriu včelu .	obra	8	Masc
Vlci sa zhromaždili na Veľkej skale .	Vlci	0	Masc
Gule na žonglovanie .	Gule	0	Fem
Pri Džafarovi sedela Jazmína so spútanými rukami .	rukami	6	Fem
Pozvala na ňu Blythe a Ricka a podávala moje obľúbené jedlá : zemiakovú kašu , pizzu , celozrnný chlieb , španielske chimichangas , makaróny so syrom a orechový koláč .	pizzu	15	Fem
Okolo nej , nad ňou i pod ňou boli ďalšie davy pracovníkov s nepredstaviteľným množstvom úloh .	množstvom	14	Neut
Poradil jej : “ Zajtra ráno na telocviku sa postav do posledného radu a potom zmizni . “	telocviku	7	Masc
Ide opäť o prívesky — amulety .	prívesky	3	Masc
Chlapče , tvoje básne páchnu potuchlinou , povedal mi .	potuchlinou	5	Fem
A slabých bytostí , ako bola mama .	bytostí	2	Fem
Minule sa môj kolega Rado Ondřejíček fejtónovým perom pustil do problému hlupákov medzi nami .	hlupákov	11	Masc
“ Myslela som , že robíš v El Rancho , “ vyhŕkla som bez rozmyslu .	rozmyslu	14	Masc
Akoby na chvíľu stratil reč .	reč	4	Fem
Na jeho základe sa bude financovať tzv . solidárny balík , ktorého súčasťou bude aj financovanie siete rýchlej zdravotnej pomoci .	základe	2	Masc
Za finančnú podporu sa chcem poďakovať Ekumenickej rade cirkví , nášmu drahému zboru a „ staršej “ mládeži ECAV v Prešove , modlitebnému spoločenstvu , kamarátom z tréningu Rovesník a jednotlivcom .	kamarátom	25	Masc
Posledný kánon II . kolomanovskej synody o celibáte sa svojím obsahom vymyká prísnejšiemu tónu uznesení tohto cirkevného snemu .	celibáte	7	Masc
Za veľkými stolmi sedeli princovia a šľachtici .	šľachtici	6	Masc
Modlime sa a pomáhajme im na ich ceste , aby sa aj ich srdce zapálilo víťazstvom lásky , pravdy , nádeje a života .	srdce	13	Neut
“ Je v šoku , nehýbe sa , “ zistili mravce .	mravce	10	Masc
Objala ho okolo krku , nazývala ho miláčikom , zlatkom , láskou .	zlatkom	9	Neut
Odborná porota vyberie najlepší film z kategórie režisérskych debutov a v tejto kategórii svojho favorita vyberie aj publikum .	kategórii	12	Fem
Pozrela som na hodinky a zmocnili sa ma obavy .	obavy	8	Fem
Inštitút zahladenia odsúdenia by nemal mať účinok opätovného nadobudnutia " bezúhonnosti " .	nadobudnutia	8	Neut
Kolega mi porozprával o tejto epizóde práve v čase , keď moja mama dostala ten slávny list .	Kolega	0	Masc
Každý pokus o systematizáciu tejto otázky totiž nevyhnutne naráža na kolíziu metódy vedeckého prístupu s rozumovo nedefinovateľným fenoménom náboženstva a viery .	systematizáciu	3	Fem
Makovica zatriasla hlavou .	Makovica	0	Fem
Nadlho som zanechal hlúposti zo zásuvky .	zásuvky	5	Fem
Pani Parsonsová priniesla kľúč na matice .	kľúč	3	Masc
“ Hromy a blesky privej !	Hromy	1	Masc
“ Počkaj , až ochutnáš Safiyinu špecialitu , “ nadšene vravel , keď sluhovia kládli na stôl ťažký strieborný podnos s polguľovitým vrchnákom .	špecialitu	6	Fem
Mladí tancovali takmer v objatí a ja som musel chvíľu čakať .	Mladí	0	Masc
Balú sa od smiechu zvíjal .	smiechu	3	Masc
Uvedené komplexy sa vyznačujú zmiešaným osídlením Slovanov s inými etnikami a tvrdošijným zachovávaním archaických prežitkov rodového zriadenia , kým mestá sú čisto slovanskými sídlami , určenými na pacifikáciu a christianizáciu kolonizovaných oblastí .	etnikami	9	Neut
On – Kristus je novou možnosťou orientácie , cestou znovuzrodenia , novej nádeje a lásky , ktorá hľadá tých , ktorí sú na ceste rezignácie , ubití ľudským egoizmom a hriechom .	znovuzrodenia	9	Neut
Poletíš ponad strieborné jazerá a zurčiace potoky , pod jasným nebom a vysokými zelenými stromami .	jazerá	3	Neut
“ Chcete povedať , že som herec ? “ pýtal sa Pinocchio .	herec	6	Masc
“ Akú širokú perspektívu máš na mysli ? “ spýtala som sa .	perspektívu	3	Fem
Vnútri jedného z nich som uvidel fotografiu ženy .	ženy	7	Fem
Bohatstvo a privilégiá sa najľahšie ochraňujú , keď majú spoločného vlastníka .	privilégiá	2	Neut
Biely vždy dáva mat .	mat	3	Masc
“ Prosím vás pekne ! “ zvolal lúčny koník Flip .	koník	8	Masc
Jedného dňa povysávala všetky kancelárie s vypnutým vysávačom .	vysávačom	7	Masc
Väčšie zlá sústavne unikali ich pozornosti .	zlá	1	Neut
Spory spoločenstva a okolia .	Spory	0	Masc
Bojoval proti vykorisťovaniu v indickej spoločnosti , proti krviprelievaniu medzi hinduistami a moslimami , proti vojne , za politickú nezávislosť svojej krajiny .	krviprelievaniu	8	Neut
Prišli pokušenia , zvody a ony podľahli .	pokušenia	1	Neut
Po známej zrážke s okrajom bazéna ma boleli päty a prestala som si veriť .	päty	8	Fem
Milí konfirmandi , dnes sa stanete dospelými členmi nášho cirkevného zboru .	konfirmandi	1	Masc
Pokračovala v nezmenenom tempe stále bližšie k jeho stolu .	stolu	8	Masc
Podstrčil mu ho redaktor z televízie , ktorá všetko nakrúcala .	televízie	5	Fem
Prešiel som s ňou vchodom a cez dvor do suterénnej kuchyne .	vchodom	4	Masc
S pocitom prihlúpleho vidiečana som prešiel po asfaltovej ceste , ktorá viedla k zhluku novopostavených budov .	zhluku	13	Masc
Grazie all ' America , ' ' kričal z pódia nadšený Benigni .	pódia	9	Neut
" Nemám na mysli priznanie .	priznanie	4	Neut
Takéto zistenie zaujímavo dopĺňa a modifikuje pohľad na najvyspelejšie mesto stredovekej Rusi , mesto majúce bohaté styky s civilizačným okruhom západnej Európy .	zistenie	1	Neut
Po kráľovskej hostine , na ktorú mravce priniesli obrie porcie špagiet s voškovou omáčkou , si všetci políhali na slniečko , aby si oddýchli .	špagiet	10	Fem
Vláda bude využívať štátne záruky iba v nevyhnutných prípadoch na prefinancovanie splatných úverov so štátnymi zárukami , ak to umožní zákon o štátnej pomoci a ak hrozí realizácia záruk z prostriedkov verejných financií .	realizácia	27	Fem
Amulet teda posilňuje určité črty jeho charakteru do neobvyklých až nadprirodzených polôh , Vseslav sa stáva vyvolencom — podľa kresťanského kronikára — temných síl .	charakteru	6	Masc
V zrkadle sa znovu zjavila akási nejasná tajomná tvár .	tvár	8	Fem
V živote každého človeka sú okamihy a udalosti , ktoré majú zvláštnu moc .	udalosti	7	Fem
Objal ju okolo pása .	pása	3	Masc
“ Pozrite na toho zbabelca ! “ zakričal nejaký nezbedník .	zbabelca	4	Masc
Roku 1966 pri vykopávkach v Iľjinskom rajóne bol nájdený stredný trám s tlamou draka .	draka	13	Masc
Do slovenských častí Uhorska sa vtedy utiahla jedna časť českých emigrovaných protestantov a tu našli v používaní svoj vlastný spisovný jazyk presne tak , ako vo svojej českej vlasti .	používaní	16	Neut
Na druhej strane je zaujímavé , že v sledovaných cirkevnoprávnych zbierkach sme nenašli žiadne ustanovenia o podmienkach využívania azylu .	zbierkach	10	Fem
Chvíľu tam ležal akoby omráčený , pričom mu z úst a z nosa stekal pruh tmavej krvi .	úst	9	Neut
Júlia tíško zapišťala , v jej hlase sa ozvalo prekvapenie .	prekvapenie	9	Neut
Zaburácal silný výbuch , ktorý akoby zodvihol vydláždený chodník ; na chrbát mu dopadla spŕška ľahkých predmetov .	spŕška	14	Fem
Jabĺčko vypadlo dievčine z ruky .	Jabĺčko	0	Neut
Pocítil som akúsi vnútornú horúčosť , úzkosť .	horúčosť	4	Fem
Autobusy sú pohodlím na európskej úrovni .	pohodlím	2	Neut
Čas — 1071 .	Čas	0	Masc
Teraz už neboli v znehybnených pózach .	pózach	5	Fem
Aj oni mali pred sebou lepšiu a krajšiu budúcnosť a máme ju aj my .	budúcnosť	8	Fem
Žena sa postavila na stupienok s katedrou , otvorila triednu knihu a začala čítať naše mená .	mená	15	Neut
Začudovane zlietla nižšie a zistila , že je to veľké tiché lesné jazierko , v ktorom sa zrkadlí obloha .	jazierko	12	Neut
Zrazu Tayerle stratil prehľad , kde je , ale v triede bolo ticho .	ticho	12	Neut
Pokračovala v nezmenenom tempe stále bližšie k jeho stolu .	tempe	3	Neut
Abu pokrčil plecami , tváril sa trochu pochybovačne .	plecami	2	Neut
Vyznajme Bohu svoje hriechy , potom nám Boh daruje tento pokoj skrze vieru v Ježiša Krista .	hriechy	3	Masc
Sama zájdem do chalúpky k siedmim trpaslíkom .	trpaslíkom	6	Masc
Uvedené komplexy sa vyznačujú zmiešaným osídlením Slovanov s inými etnikami a tvrdošijným zachovávaním archaických prežitkov rodového zriadenia , kým mestá sú čisto slovanskými sídlami , určenými na pacifikáciu a christianizáciu kolonizovaných oblastí .	zachovávaním	12	Neut
Vzápätí sa zjavila svetlovlasá hlávka a nakoniec sa z kvetu vynorilo drobučké stvorenie .	hlávka	4	Fem
Okno na izbe bolo otvorené , a bol tam zápach .	zápach	9	Masc
Biele lístočky kvetu sa jemne odhrnuli a zjavila sa malá rúčka .	lístočky	1	Masc
Teraz sa v noci budievam zo spánku a hrdlo mi zviera úzkosť : trápi ma nočná mora , že aj ja som v dave , ktorý ženie mamu v ústrety smrti .	hrdlo	8	Neut
Vietor silnel a v ďatelinových hlavičkách nebezpečne zašumelo .	Vietor	0	Masc
Pozrela som na ňu a napravila som si zelenú košeľu , ktorú som si dala na rande .	košeľu	9	Fem
Na okraji makového poľa sedel motýľ s malým oranžovým cylindrom na hlave .	hlave	11	Fem
Na utierke ostala svetielkujúca zelená farba a na všeobecné prekvapenie stál pred nimi pavúk Karol .	farba	5	Fem
Z hľadiska reformátorov bol tento fakt jednou z najvážnejších prekážok na ceste k dosiahnutiu slobody cirkvi .	dosiahnutiu	13	Neut
Ak nepočítam učebnice , až donedávna jediné knihy , ktoré držala v ruke , boli detské rozprávky .	učebnice	2	Fem
Tým bola narušená klasická štruktúra ruského mesta s oddeleným posadom a hradiskom .	posadom	9	Masc
Horace a Jasper sedeli na starej pohovke obklopení tuctami šteniatok a pozerali televíziu .	šteniatok	9	Neut
“ Anita a ten jej nepodarený Beethoven s fajkou v ústach !	ústach	10	Neut
Zakrátko si Makulienka obliekala novú sukničku s volánikmi a motýľ Emanuel frak s dlhými krídlami .	sukničku	5	Fem
Kvalifikovanú odpoveď na tuto otázku však budeme môcť priniesť až po dôkladnej komparácii s dobovými východnými právnymi pamiatkami .	komparácii	12	Fem
Nebola to moja myšlienka .	myšlienka	3	Fem
Nová Koncepcia ochrany prírody a krajiny bude obsahovať racionálny systém manažmentu chránených území , prehodnotí ich cieľový stav a navrhne opatrenia a programy starostlivosti tak , aby chránené územia slúžili aj verejnosti .	prírody	3	Fem
Sprievod vyšiel z uličky za domom , čo znamená , že musel zomrieť niekto , kto býva v dome .	Sprievod	0	Masc
Podporením priestupnosti školského systému v oblasti prechodu žiakov na vyšší stupeň školy bez prijímacích skúšok , vláda minimalizuje podmienky na korupciu v školstve .	školstve	22	Neut
Iba na začiatku textu zbierky je akýsi tematický zoznam , pri jednotlivých častiach ktorého sú uvedené čísla „ kánonov ” , vzťahujúcich sa k tomu - ktorému tematickému okruhu .	okruhu	28	Masc
Odkiaľ berú títo ľudia presvedčenie , že pre Bratislavčanov reformy neznamenajú záťaž ?	záťaž	11	Fem
Teraz sa v noci budievam zo spánku a hrdlo mi zviera úzkosť : trápi ma nočná mora , že aj ja som v dave , ktorý ženie mamu v ústrety smrti .	úzkosť	11	Fem
Wilsher , blondiak s nasprostastým výrazom na tvári , ktorého takmer nepoznal , ho s úsmevom pozýval na voľné miesto pri svojom stole .	výrazom	5	Masc
Vtom sa odraz mesiaca rozbil na črepy , no zakrátko sa zasa zjavil na hladine .	mesiaca	3	Masc
Syreeta vyvesila oznam o Abuovom úteku a kto ho nájde , dostane odmenu .	oznam	2	Masc
Šéf sa zo všetkých síl pokúšal , aby som odišiel z jeho pracovne spokojný , aj keď mi tú poviedku neuverejní .	poviedku	19	Fem
Keď Shannon otvorila dvere , sprisahanecky ma objal okolo pliec a vliezol na zadné sedadlo .	sedadlo	14	Neut
