Tuho som ich zavrela a čakala .	čakala	5	Pos
Možno ich nevidel .	nevidel	2	Neg
Raisa na stretnutie neprišla .	neprišla	3	Neg
Nepretrvá . "	Nepretrvá	0	Neg
Napokon chytil vak a hodil mi ho na kolená .	chytil	1	Pos
Snažili sa zachytiť každučké jeho slovo .	Snažili	0	Pos
Tentoraz sa ma nepýtala , či som v poriadku .	nepýtala	3	Neg
Za ich zvukov som zaspal .	zaspal	4	Pos
Boli stále so mnou , boli vo mne .	Boli	0	Pos
Nehodilo sa mi do " krámu " .	Nehodilo	0	Neg
Nezazrel na nej nijaké jazvy .	Nezazrel	0	Neg
Znamenalo to , že mama ma nepustí do školy .	nepustí	6	Neg
Na Makovej lúke panovalo ticho .	panovalo	3	Pos
Na rozdiel od iných stretnutí v ten večer nepila .	nepila	8	Neg
Vláda bude využívať štátne záruky iba v nevyhnutných prípadoch na prefinancovanie splatných úverov so štátnymi zárukami , ak to umožní zákon o štátnej pomoci a ak hrozí realizácia záruk z prostriedkov verejných financií .	využívať	2	Pos
“ Nemôžeme čakať .	Nemôžeme	1	Neg
Chutila výborne .	Chutila	0	Pos
Na dverách od profesorovej izby bola vosková pečať , zo stareninej izby sa neozývali nijaké zvuky .	neozývali	13	Neg
“ Poznám tvojho otca veľmi dobre a viem , že sa nikdy nezmení .	nezmení	12	Neg
“ Ako môžete také niečo povedať ! “ vyhŕkla Maja .	povedať	5	Pos
Zastav to , zastav !	Zastav	0	Pos
Ja som ich ani nepočúval , ani som si nič nemyslel .	nepočúval	4	Neg
Nevieš napodobniť nejaké tichšie zviera ? “ spýtala sa Kala .	napodobniť	1	Pos
Z kuchyne som vzala dva vínové poháre a veľkú fľašu malinovky .	vzala	3	Pos
Nenadarmo platí " Sýty hladnému neverí " a zároveň neexistuje žiadne porekadlo typu " Ukojený nadržanému neverí " .	neverí	5	Neg
Balú zatiaľ chlapcovi nepovedal , že ho vedie do osady .	nepovedal	3	Neg
Spi sladko . “	Spi	0	Pos
Podľa Irminých pokynov – samotná Irma vybavovala všelijaké formality – ma poprosili , aby som odišiel z domu a vrátil sa podľa možnosti až večer .	odišiel	15	Pos
Cítila som zvláštny pokoj .	Cítila	0	Pos
Šéf vypustil dušu vo chvíli , keď dosiahol orgazmus , a ona sa nemohla zbaviť prežitej hrôzy .	vypustil	1	Pos
Nedokázal premôcť nápor paniky .	Nedokázal	0	Neg
Zostupujúc do hĺbok duševných priepastí , ( seba ) obnažuje , bičuje ( sa ) .	Zostupujúc	0	Pos
Neviem , čo mama urobila , že jej dali pokoj .	Neviem	0	Neg
Chris roztrhol jedno balenie , ale veľmi sa s ním nemaznal .	nemaznal	10	Neg
Vláda pripraví a realizuje systém ochrany slovenského spotrebiteľa a prostredníctvom legislatívy ho prispôsobí stavu , ktorý bude zodpovedať legislatíve EÚ .	pripraví	1	Pos
Škoda , že Tayerle je taký nezáživný profesor , pretože astronómia , ktorú sme tento týždeň preberali , mi pripadala nesmierne zaujímavá .	pripadala	19	Pos
Nemieni sa vzdať bez boja , tak lacno svoju kožu nepredá .	nepredá	10	Neg
Neodpovedali mi .	Neodpovedali	0	Neg
Zrazu však vyšľahli obrovské plamene a vyrazili princovi štít z ruky .	vyšľahli	2	Pos
“ Neviem , otec .	Neviem	1	Neg
Čo sa však nestalo !	nestalo	3	Neg
Džafar sa naňho opäť zahnal čarodejnou palicou .	zahnal	4	Pos
Keď sa mi posmievala , zmocňovala sa ma trpká zlosť , napriek tomu medzi nami nedochádzalo k scénam .	zmocňovala	5	Pos
Zaľúbil som sa do nej akousi zvláštnou láskou , ktorá ma nepobádala písať verše , ako som ich písal pre Teutu .	nepobádala	11	Neg
Maja sa vzchopila .	vzchopila	2	Pos
Teraz ťa pozývam ja , povedal som , ale Lori odvetila , že nič nechce .	nechce	14	Neg
V každom prípade musím otvoriť oči a nesmiem veriť legendám .	musím	3	Pos
Nezdalo sa mi , že veštia nejaké zásadné zmeny .	Nezdalo	0	Neg
Veľmi som chcela , aby ostali spolu , no cítila som sa pri nich trochu navyše .	ostali	5	Pos
Vtom som pozrela hore a zbadala pri bazéne Chrisa .	pozrela	2	Pos
Pristúpil k zrkadlu bližšie .	Pristúpil	0	Pos
Nezáleží na tom , čo povieš či urobíš ; záleží jedine na tom , čo cítiš .	Nezáleží	0	Neg
Netušili , čo to znamená a čoskoro sa dostali do úzkych .	Netušili	0	Neg
Vari dnešní otcovia národa často nevravievajú , že naša milovaná vlasť je banánová republika ?	nevravievajú	5	Neg
" Pivo bolo lepšie , " poznamenal napokon .	poznamenal	6	Pos
Omar pustil vankúš a skočil na zem .	pustil	1	Pos
Američania by nemuseli bombardovať Irak .	nemuseli	2	Neg
Paradoxne som si želal , aby neprišiel .	neprišiel	6	Neg
Nečakal na myšiakove ďalšie požiadavky a dvaapolmetrovým skokom sa vzdialil .	Nečakal	0	Neg
Mladým včielkam pripadal dážď spočiatku zábavný .	pripadal	2	Pos
Mamu som zbadala na rovine , keď sa na nebi zablyslo a rozľahol sa mocný hrom .	zbadala	2	Pos
Jednu z tých , aké nevyvolajú reakciu v podobe telefonátov zhora .	nevyvolajú	5	Neg
Nikde nedajú pokoj .	nedajú	1	Neg
Keďže som neprišiel na nič lepšie , sedel som celý deň vo svojej izbe a v duchu som si predstavoval , že som ušiel z domu .	neprišiel	2	Neg
Ťarbavo sa pohyboval po javisku a nevedel sa naučiť úlohu .	nevedel	6	Neg
A ja som jej neprezradil niečo , čo ma ťažilo veľmi dlho po jej odchode .	neprezradil	4	Neg
Kto zažil sparné pražské popoludnie , vie veľmi dobre , čo znamená spojenie " správně vychlazená dvanáctka " .	vie	6	Pos
“ Nepoznám nikoho , kto dosiahol taký vysoký počet bodov .	Nepoznám	1	Neg
Dolorina tvár , ktorá bývala obyčajne bledá , zbledla ešte viac .	zbledla	8	Pos
Predo mnou sa týčila iná socha , socha Vladimíra Iľjiča Lenina .	týčila	3	Pos
Nemohla som pochopiť , ako to zo mňa vyletelo .	Nemohla	0	Neg
Oči jej vystúpili z jamiek a z vyškerených úst vypadali všetky zuby okrem jedného .	vystúpili	2	Pos
“ Neviete , že vám piraňa za pár sekúd obžerie všetko mäso ? “	Neviete	1	Neg
Zasmiala sa .	Zasmiala	0	Pos
Zaburácal silný výbuch , ktorý akoby zodvihol vydláždený chodník ; na chrbát mu dopadla spŕška ľahkých predmetov .	zodvihol	6	Pos
Spýtal som sa ho , ako sa volá , ale ono mi nechcelo povedať svoje meno .	nechcelo	12	Neg
Sú tam psi ? “ spýtal sa ma , kým sa vyšvihol na múr .	Sú	0	Pos
Lori bola vedľa mňa , aby mi potvrdila , že Irma , ktorú pohltilo nebo , teraz letí do iného sveta .	letí	17	Pos
Nepovedal som jej nič .	Nepovedal	0	Neg
Naozaj stenám , ale ty si to , preboha , poriadne zveličil .	stenám	1	Pos
A kým je môj pas v rukách toho muža , veci vonkoncom nevyzerajú dobre .	nevyzerajú	12	Neg
Hroby majú vedľa seba a mama ma kedysi brávala každú nedeľu so sebou zapáliť im sviečky .	brávala	8	Pos
Moja trpezlivosť sa vyčerpala , keď ručičky na hodinkách stihli ukázať pol dvanástej a mne sa nikto nevenoval .	nevenoval	17	Neg
Irma nevedela , kde je Marga .	nevedela	1	Neg
Odtiahol som kameru .	Odtiahol	0	Pos
Dnes by ste našu záhradu nepoznali .	nepoznali	5	Neg
Uplatní transparentný postup pri schvaľovaní podpôr .	Uplatní	0	Pos
Smiali sme sa , až sme lapali dych , a držali sa za ruky .	Smiali	0	Pos
Podporí v rámci krajín EÚ kompatibilnosť v oblasti vzájomného uznávania dokladov o dosiahnutí určitého stupňa vzdelania .	Podporí	0	Pos
Máme tu teda ďalší argument pre to , aby sme kánony o celibáte z druhej kolomanovskej synody nepovažovali za prejav úplného príklonu k normám reformného pápežstva .	nepovažovali	17	Neg
“ Nepotrebujem nikoho ! “	Nepotrebujem	1	Neg
Nastala chvíľa , aby princeznú vrátili kráľovi a kráľovnej .	Nastala	0	Pos
Šľahali okolo nej , no zakaždým ju o vlások minuli .	Šľahali	0	Pos
“ Porozprávame sa inokedy , “ zavolala Blythe a veselo mi zakývala , keď odchádzali .	zavolala	6	Pos
Za celé tie roky som ani raz neodovzdala prácu po termíne .	neodovzdala	7	Neg
Posledný szabolcsský kánon , ktorý sa venuje kláštornému životu nariaďuje opátom a mníchom , aby sa nezúčastňovali na kalendových sedeniach , ale aby prijímali oblácie ich účastníkov v kláštoroch .	nezúčastňovali	16	Neg
Smrti sa , samozrejme , bojím .	bojím	5	Pos
Musím rešpektovať Marginu požiadavku , aby som deťom nič nepovedal , a zároveň musím nájsť pre Irmu nejaké presvedčivé vysvetlenie .	rešpektovať	1	Pos
Faika si nič nevšimla a nevmietla mi do tváre nijaký prívlastok .	nevšimla	3	Neg
Obyčajne sedávala v poslednom rade , kam som si sadal i ja .	sedávala	1	Pos
Priadli , priadli až upriadli .	Priadli	0	Pos
Dobre vedel , že dal Džahijovi na opravu strechy raz toľko , ako potreboval .	potreboval	13	Pos
Syme zdvihol zrak . " Tam prichádza Parsons , " poznamenal .	prichádza	6	Pos
Nič som však nepovedal .	nepovedal	3	Neg
Jej bledosť a mlčanie stačili , aby som okamžite pochopil , že som urobil hlúposť .	stačili	4	Pos
Nechcela som Chrisa znepokojiť , ale čím dlhšie tu ostaneme , tým skôr nás zbadajú .	Nechcela	0	Neg
Šaty , ktoré šila Flóra , sa nevydarili .	nevydarili	7	Neg
Podľa N . M . Tichomirova ide len o označenie ich sociálneho postavenia , my však vyslovujeme domnienku , že ide o pozostatok matriarchátu , zvlášť silného u ugrofínskych plemien .	vyslovujeme	16	Pos
A bodliak Makulienku i motýľa Emanuela radšej pustil .	pustil	7	Pos
Jej oddychovanie prezrádzalo , že opäť usína .	usína	6	Pos
Bude mať názov Shanghai Noon a režisérom bude debutujúci Tom Dey .	mať	1	Pos
Neobjal ma , nepriblížil sa ku mne , ani nezavrel oči .	nezavrel	9	Neg
Nemám pravdu ?	Nemám	0	Neg
Pre nesúhlas samosprávy blokovalo KDH vstup SMK do Európskej demokratickej únie .	blokovalo	3	Pos
Má pokojný , rozvážny hlas , dbá na každé slovo a tvári sa vážne .	dbá	6	Pos
“ Fíha ! “ zvolala prekvapene Maja .	zvolala	4	Pos
Maja rozhorčene vyskočila .	vyskočila	2	Pos
Ale mňa to okno vôbec nezaujímalo .	nezaujímalo	5	Neg
Najprv som sa rozprávala s ostatnými dievčatami , tváriac sa , že si ju nevšímam .	nevšímam	14	Neg
Pokúšal sa jej to vysvetliť tak , aby pochopila . " Toto bol výnimočný prípad .	pochopila	8	Pos
“ Narušujú morálku našich detí , “ kričal do mikrofónu .	kričal	7	Pos
Z obilia sa robila múka a z nej sa piekol chlieb .	robila	3	Pos
Globalizácia nevznikla sama od seba a nevznikla ani náhodou .	nevznikla	6	Neg
Vlastne som Chrisa pred mamou ešte nikdy nespomenula .	nespomenula	7	Neg
Alia sa tvárila zamyslene .	tvárila	2	Pos
Na zvončeku za sebou uvidel Maju .	uvidel	4	Pos
“ Naozaj chceš poznať svoju budúcnosť , Aladin ? “ spýtal sa .	spýtal	10	Pos
Tom nevrieskal .	nevrieskal	1	Neg
V nemocnici sa naňho vrhlo desať mravcov .	vrhlo	4	Pos
Pohladkal som ho a veru ani sa nehol .	Pohladkal	0	Pos
Začala som s kapitolou o zatmení a snažila sa spomenúť na to , čo som videla .	Začala	0	Pos
Marga odchádzala , strácala sa v dave , autobus ju viezol do ktorejsi dediny v nížine .	odchádzala	1	Pos
V tomto ohľade sme sa všetci mýlili .	mýlili	6	Pos
Nastal čas , aby niečo podnikol .	podnikol	5	Pos
Dlho som sedel pred tým plným pohárom .	sedel	2	Pos
Neviem , čo som si vymyslel .	Neviem	0	Neg
A zobudilo lekno .	zobudilo	1	Pos
Netrpel som dlho .	Netrpel	0	Neg
Pre chlad som za stolom nikdy nezaspal .	nezaspal	6	Neg
Prešla hodina , a mama nechodila .	nechodila	5	Neg
“ Som včela , pane ! “ zvolala výhražne .	zvolala	7	Pos
“ Dnes určite stretnem človeka ! “ volala naradostene .	stretnem	3	Pos
Ja jeden mám .	mám	2	Pos
Opatrne som vstala , aby som ju nezobudila a išla som vypnúť televízor .	nezobudila	7	Neg
Sadol si na zem a povedal : “ Tak čo mám teda robiť ? “	Sadol	0	Pos
Pomyslel som si , že plače .	Pomyslel	0	Pos
Navyše sú nepoužiteľné vzhľadom na tlačiarenskú farbu , ktorá môže nepríjemne poškodiť istú chúlostivú časť tela .	poškodiť	11	Pos
Ale ja som si nič nevšimol .	nevšimol	5	Neg
Nechápeš , že smrť jednotlivca nie je vôbec smrť .	Nechápeš	0	Neg
Začína odznova .	Začína	0	Pos
Ja som ju napriek tomu nehanebne vyzliekal očami .	vyzliekal	6	Pos
Vrátili sme sa dovnútra a zaujali svoje miesta .	zaujali	5	Pos
Tá nehoda celkom zmenila náš život . “	zmenila	3	Pos
Pokrčil plecami a podal mi Colu .	podal	3	Pos
Neodvážila sa otvoriť oči a ja som pochopil , že očakáva niečo strašné .	pochopil	7	Pos
Maja si zatiaľ hladkala boľavé plece .	hladkala	3	Pos
Nepobozkala ma .	Nepobozkala	0	Neg
Avšak rodine malého paviána sa nepáčilo , ako sa Jane správa k ich mláďaťu a nazlostení začali dievčinu prenasledovať .	nepáčilo	5	Neg
Mauglí chcel Káaovi veriť .	veriť	3	Pos
Kŕčovito sa pridržiaval kôry , aby ho neodfúkol vietor .	neodfúkol	7	Neg
Ty mi neveríš ? “	neveríš	2	Neg
Winston bol ženatý a pravdepodobne ešte stále je ženatý , lebo pokiaľ vie , jeho žena nezomrela .	nezomrela	16	Neg
Odolné proti drsnému zaobchádzaniu a nejaká tá diera neuberie z ich dobrých vlastností .	neuberie	8	Neg
Na takú dokonalú odpoveď som sa vtedy nezmohla , napadla mi až na druhý deň .	nezmohla	7	Neg
Otec veľa rozprával o svojom literárnovednom výskume , ale nevyhýbali sme sa , samozrejme , ani súčasným problémom .	nevyhýbali	9	Neg
Svoju neforemnú topánku presunula o pár centimetrov a naschvál dodrúzgala konárik .	dodrúzgala	9	Pos
Musím niečo urobiť , inak hrozí , že sa nezúčastním na Lorinom svadobnom obrade .	urobiť	2	Pos
“ Najprv si prečítam celú astronómiu od začiatku do konca , “ hovorila som Chrisovi , keď sme v Saabe jeho matky uháňali do verejnej knižnice .	prečítam	3	Pos
Ale otec ma nepočúval . “	nepočúval	3	Neg
Vypil ďalší dúšok džinu , vzal bieleho jazdca a pokusne ním tiahol . Šach !	tiahol	11	Pos
Polovicu zo všetkého , čo vo mne je , mám z domu , z toho , čo sa doma povedalo , napríklad pri stole .	povedalo	19	Pos
Stromboli neveril vlastným ušiam .	neveril	1	Neg
“ To všetko je veľmi pekné , ale to som nechcel počuť .	počuť	11	Pos
O ' Briena vyparia .	vyparia	3	Pos
Čo som neurobil ja , urobili medzitým iní .	neurobil	2	Neg
Očakávala som niečo iné , ona však nevyslovila jedinú výčitku .	nevyslovila	7	Neg
Položil mi poslednú otázku .	Položil	0	Pos
Strana vyzýva jedinca , aby poprel svedectvo vlastných očí a uší .	poprel	5	Pos
Duchovia sa však v tomto prípade nechcú objaviť — boja sa kríža , ktorý má Novgorodec pri sebe .	nechcú	6	Neg
“ Neviem , “ vraví myška , “ ale možno ti poradia tamtie modré kvietky . “	Neviem	1	Neg
Pôvodný text sa však nezachoval .	nezachoval	4	Neg
Na jeho tvári viseli matkine ustráchané oči .	viseli	3	Pos
Maja sa zatiaľ obzerala .	obzerala	3	Pos
To sú jediné výsledky , ktoré dosiahnete .	dosiahnete	6	Pos
Nakoniec , takisto môže aj Čech čítať slovenské , keby chcel , oni však tú potrebu V ROVNAKEJ MIERE nemajú . “	nemajú	19	Neg
Nedokážeme uspokojivo vysvetliť , prečo uhorský kráľ takto postupoval .	Nedokážeme	0	Neg
Nikdy som sa nezaoberal otázkami vlastnej tvorby jazyka . "	nezaoberal	3	Neg
Dozvedel som sa a stále tomu neviem uveriť .	neviem	6	Neg
Bežali do domu , aby zistili , či niečo nezmizlo .	nezmizlo	9	Neg
Srdce mu poskočilo .	poskočilo	2	Pos
Pelikánia slečna Polly má veľký zobák a veľmi sa jej nepáči .	nepáči	10	Neg
Netrvalo dlho a obaja lavínu skyprili , takže sa párik cvrčkov ľahko dostal von .	Netrvalo	0	Neg
Moja trpezlivosť sa vyčerpala , keď ručičky na hodinkách stihli ukázať pol dvanástej a mne sa nikto nevenoval .	ukázať	10	Pos
Nič mi nepovedal .	nepovedal	2	Neg
Ale vlasy mu vstanú dupkom , keď si všimne niečo iné : trochu ďalej na konári , kam sa vyštveral , sedí medveď , ktorý tam vyliezol .	vyliezol	26	Pos
V džungli by ste nenašli šťastnejšieho tvora .	nenašli	4	Neg
“ To bude nuda ! “ uštipačne prehodila Maja .	prehodila	7	Pos
“ Pravdaže , poklad môj , “ odvetila mamička .	odvetila	7	Pos
Neviem vysvetliť , prečo sme nechodili na rande ako iní .	Neviem	0	Neg
“ Prepáč .	Prepáč	1	Pos
Jej vládcov nespájajú pokrvné zväzky , ale príslušnosť k spoločnému učeniu .	nespájajú	2	Neg
Nemal som zvlášť dobrý dojem .	Nemal	0	Neg
Podporíme intenzívnu ekonomickú poľnohospodársku výrobu .	Podporíme	0	Pos
Odteraz sme jej rodičia , tak ju musíme niesť , “ povedala potom Vilkovi .	niesť	8	Pos
STROMBOLI NEVERIL VLASTNÝM OČIAM , keď pred sebou zbadal dreveného panáčika .	NEVERIL	1	Neg
Politicky sa Rus rozdrobuje , cirkev , naďalej sa upevňujúca , slúži ako kladný protipól úpadku .	rozdrobuje	3	Pos
Takú bledosť som v jej tvári ešte nevidela .	nevidela	7	Neg
Keď Herkules počul tie slová , vrátila sa mu odvaha .	vrátila	6	Pos
Trojzubec sa odchýlil iným smerom .	odchýlil	2	Pos
“ Chceš povedať , že s tým nemôžeš niečo urobiť ? “ pýtal sa zúfalý Herkules .	nemôžeš	7	Neg
A síce , že vôbec nejde o odkaz od Ideopolície , ale od nejakej ilegálnej organizácie .	nejde	5	Neg
Asi hnedú , lenže tmavovlasí ľudia mávajú aj belasé oči .	mávajú	6	Pos
Neveríme princípom angsocu .	Neveríme	0	Neg
“ Neboj sa , Ferdo .	Neboj	1	Neg
Nikoho , kto raz vybočil , neušetríme .	neušetríme	6	Neg
Chcem , aby si mi splnil druhé želanie , džin .	Chcem	0	Pos
Musím rozmýšľať . “	rozmýšľať	1	Pos
Do minúty zhorí na popol .	zhorí	2	Pos
Keď vošiel , hluk hlasov zoslabol na polovicu .	vošiel	1	Pos
Chris sa držal vľavo , šiel v pruhu , ktorý rozhodne neviedol ku knižnici .	držal	2	Pos
Nazlostený Džafar vyskočil z trónu , ktorý pripomínal kobru .	pripomínal	7	Pos
Zároveň som sa dozvedela niečo , čo som nevedela .	nevedela	8	Neg
Mamu som zbadala na rovine , keď sa na nebi zablyslo a rozľahol sa mocný hrom .	rozľahol	12	Pos
Ostražito sa zakrádala k neznámemu miestu , keď začula plač .	začula	8	Pos
Toto ministerstvo však nemuselo uspokojovať mnohoraké potreby straníkov , ale opakovať celú operáciu na nižšej úrovni pre blaho proletariátu .	nemuselo	3	Neg
Jedna ruka jej ovisla nabok , telo sa jej uvoľnilo .	uvoľnilo	9	Pos
Iba my s Chrisom sme tak zúrivo nepísali a nehrbili sa nad lavicami .	nepísali	7	Neg
Urazený som sa ho pokúšal presvedčiť , že neklamem .	neklamem	8	Neg
Vytopilo nás ?	Vytopilo	0	Pos
Najprv si myslel , že to vybaví podobrotky .	vybaví	6	Pos
Dokážem dobre vytipovať nezaradených ľudí .	vytipovať	2	Pos
“ Tak poď , “ zašepkal Chris .	zašepkal	5	Pos
Stáli pred obrazovkou .	Stáli	0	Pos
Ak nedostanem z fyziky jednotku , nemôžem so štipendiom rátať .	nedostanem	1	Neg
“ Keby som nevedela , že máte bezpečnostný systém , “ doberala som si Chrisa , “ preliezla by som plot a skočila dnu . “	máte	6	Pos
Ale ani pre myšiaka sa všetko neskončilo .	neskončilo	6	Neg
“ Nič , “ odvetila som a pozrela na Chrisa .	pozrela	7	Pos
Stalo sa to len včera večer a Rick sa určite pred chalanmi nevyťahoval , ako vlažne som ho odbila .	nevyťahoval	12	Neg
Ten nežiadal , aby som mu podal pomocnú ruku .	nežiadal	1	Neg
Nepovažovalo sa za žiaduce , aby proleti mali silné politické cítenie .	Nepovažovalo	0	Neg
Sú v ňom i Greta Garbo , Betty Grable , Lucille Ball , Hedy Lamar , Mary Pickford , Ruth Gordon a Dinah Shore .	Sú	0	Pos
“ To nemyslíš vážne ?	nemyslíš	2	Neg
A keď sa Dolora na znak pochopenia spýtala Toma na jeho meno , neodpovedal jej ani on .	neodpovedal	13	Neg
Sedela som vedľa neho na vrchole Squaw Peaku a zmocnil sa ma pocit šťastia .	Sedela	0	Pos
“ Si ten najstatočnejší a najbystrejší mladý muž , akého poznám , “ povedal vďačne .	povedal	13	Pos
Ale ona nezdvihla zrak .	nezdvihla	2	Neg
V škole sme sa už nemilovali .	nemilovali	5	Neg
Hru , ktorú hráme , nemôžeme vyhrať .	nemôžeme	5	Neg
Pocítil som na hrudi tlak jej pevných okrúhlych pŕs .	Pocítil	0	Pos
Makovej lúky sa totiž chceli zmocniť lúpežné mravce .	chceli	4	Pos
“ Páčil som sa im , “ nadšene odvetil Pinocchio .	Páčil	1	Pos
Napriek všetkému Delina nevenuje tomuto človeku pozornosť .	nevenuje	3	Neg
Lori to trvalo dlho , ale neplakala .	neplakala	6	Neg
“ Hádam mi nechceš tvrdiť , že nezáleží na výsledkoch .	nechceš	3	Neg
Neďaleko jazdil na koni mladý princ .	jazdil	1	Pos
Ale ich vodca ma rázne prerušil .	prerušil	5	Pos
Pohladkal som ho a veru ani sa nehol .	nehol	7	Neg
Mauglí nezašiel ďaleko , keď sa zrazu ocitol na rozľahlej čistinke .	nezašiel	1	Neg
Nepripisoval som mu význam .	Nepripisoval	0	Neg
Rodičia zaujímali miesta naproti sebe , ja som sedával medzi nimi .	sedával	8	Pos
Maja ju však nechala , nech rozpráva .	nechala	3	Neg
“ No ak to nezistí , nezabije nás , “ navrhol Bôľ .	nezistí	4	Neg
Niekto zo susedov si mohol všimnúť , že som bol preč , mohol by sa ma zvedavo vypytovať , kde som bol , a to by stačilo , aby sa som sa rozčúlil .	vypytovať	17	Pos
Zúrivo odrážal nápory paniky .	odrážal	1	Pos
“ Hraj ako ja , “ zašepkal .	zašepkal	6	Pos
Na chvíľu zavládlo ticho .	zavládlo	2	Pos
“ Verím ti . “	Verím	1	Pos
Na chvíľu Winston ignoroval ciferník .	ignoroval	3	Pos
Vytvorí legislatívne podmienky pre pristúpenie SR k Dohovoru EHK OSN o prístupe k informáciám .	Vytvorí	0	Pos
Samonafukovačky sa pýšia výbornými izolačnými schopnosťami , vysokým komfortom pri ležaní a neprepúšťaním vlhkosti .	pýšia	2	Pos
Raz vylepil svojej dcére Katke mľaskavé zaucho len preto , že sa nahlas smiala .	vylepil	1	Pos
Povedal som jej , že sa podobá na niekoho , koho poznám .	podobá	6	Pos
Každý deň som chodievala do školy spolu s mamou .	chodievala	3	Pos
Vyliezla spod listu a obzerala sa okolo seba .	obzerala	4	Pos
Nedávno som odovzdal do skalického Záhorského múzea otcove denníky .	odovzdal	2	Pos
Bál sa , že konal unáhlene .	Bál	0	Pos
Navrhneme zmeny , ktoré sú nevyhnutné pre vybudovanie moderného sociálneho systému .	Navrhneme	0	Pos
Vo Zvedoch som robila vedúcu oddielu .	robila	3	Pos
Tuho som ich zavrela a čakala .	zavrela	3	Pos
“ Nesklamem ťa , otec , “ zvolal Herkules , keď s Pegasom leteli na ostrov Idra .	Nesklamem	1	Neg
Nezískala ho ani Matica , ani občianske združenie Komorra a nedarí sa to ani gymnáziu .	nedarí	10	Neg
Zámerom je dostať všetkých záujemcov do blízkosti rómskej lokality .	dostať	2	Pos
V prípade , že z manželstva nevzišli deti , Strana nepovoľovala rozvod , zato podporovala odlúčenie .	nevzišli	6	Neg
Zatiaľ nič nevidel .	nevidel	2	Neg
Čo robíte , keď napadne čerstvý sneh ?	robíte	1	Pos
Nemal topánky , veľké špinavé prsty mu vyčnievali z dier na ponožkách .	vyčnievali	7	Pos
Chris na mňa pozrel , či mi nešibe .	nešibe	7	Neg
Pocítil som úprimnú potrebu plakať .	plakať	4	Pos
Stala si na kameň a začala vrzúkať .	vrzúkať	6	Pos
Zničíme ho ! “ kričali .	Zničíme	0	Pos
Iných stopárov som tu zatiaľ ešte nevidel .	nevidel	6	Neg
Dôverujem tomu zasľúbeniu , ktoré som prijala vierou .	Dôverujem	0	Pos
Zapojte sa aktívne do zborového života , príjmite pozvanie mládeže , navštevujte tento chrám , prichádzajte k Večeri Pánovej .	navštevujte	11	Pos
“ Aša mi povedala , že to nevyjde .	nevyjde	7	Neg
Pochopila , čo som povedal .	Pochopila	0	Pos
Neuspokojme sa s tým , že sme poslali svojím blízkym veľkonočný pozdrav , ale ukážme im ako vyzerá život v nádeji vzkriesenia a víťazstva v Kristu .	ukážme	14	Pos
Iba na bodliaku sa jagali veľké kvapky rosy , lebo sa báli skotúľať do trávy .	skotúľať	12	Pos
Nestalo sa to prvý raz .	Nestalo	0	Neg
Zišlo mu na um , že až doteraz ho zrejme nevidela na voľnom priestranstve v plnom dennom svetle .	Zišlo	0	Pos
Ako sa princ blížil k palácu , Kráľovná zla mu postavila do cesty múr z tŕňových krov .	postavila	10	Pos
“ Barbie , nevidela si Koru ? “ zakričala .	nevidela	3	Neg
Nemôžeš poprieť , že si plakala .	plakala	5	Pos
Ak mu nepomôžeš , zomrie ! “	nepomôžeš	2	Neg
“ Ihneď ma pustite , “ zvolala Maja .	pustite	3	Neg
Medzi tieto nedovolené zamestnania patrilo i krčmárstvo , ktorého vykonávanie zakázali aj ostrihomskí synodálni otcovia .	zakázali	10	Pos
Pomyslel som si , že sa nebojí môjho semena .	nebojí	6	Neg
Vtáky spievajú , proleti spievajú , Strana nespieva .	nespieva	7	Neg
Ale ja som nepoznal šéfa televízie Sírius .	nepoznal	3	Neg
Mama pila doma , nikdy sa nestalo , že by sa vrátila z kravínov a razila alkoholom .	nestalo	6	Neg
Neskôr mi Dolora povedala , že na túto epizódu sa nepamätá .	nepamätá	10	Neg
Nemohla sa dočkať , kedy preberieme moje citové záležitosti , a tak prišla k nám .	Nemohla	0	Neg
Chvíľu čakal , ale mnoho ľudí mu netlieskalo .	netlieskalo	7	Neg
Nevedel som , čo ich čaká .	Nevedel	0	Neg
“ Prečo nie , “ odvetil Chris , keď chvíľu snoril v knižnici a prezeral si farebné obaly kníh .	prezeral	14	Pos
Pomyslel som si , že keď ju tam zvalili a vláčili po uliciach , podarilo sa jej nejako utiecť , ako utekajú sochy , a prišla sa postaviť sem .	vláčili	10	Pos
Alebo príde čoskoro o hlavu , ako mu predpovedal Ňufko ?	príde	1	Pos
Nesmie zobudiť mamu .	Nesmie	0	Neg
Irma nevedela , že Marga leží v nemocnici .	nevedela	1	Neg
Vďaka týmto skúsenostiam pre mňa teoreticky neexistovalo nijaké tajomstvo súvisiace s túžbami , ktoré nútia muža pokúšať sa o zblíženie so ženou .	neexistovalo	6	Neg
Jedného dňa z neho vystúpila .	vystúpila	4	Pos
Pozrela som pod seba a zacítila v žalúdku šteklivé vzrušenie .	Pozrela	0	Pos
Mal na sebe dlhý čierny kabát .	Mal	0	Pos
Našej susedke - záhradkárke sa naše mičurinčenie ale veľmi nepáčilo .	nepáčilo	9	Neg
A veselili sa , kým nezapadlo slnko .	veselili	1	Pos
Hral v tom filme hlavného hrdinu .	Hral	0	Pos
“ Niet za čo , to je predsa samozrejmé , “ skromne odvetil Chrabroš .	Niet	1	Neg
A obchody , ktoré chcú predávať zaručene čerstvý , v noci upečený a nezabalený chlieb , musia ho držať v osobitných zasklených policiach , takže skôr nebalenie chlieb zdražuje .	musia	16	Pos
Niektoré z nich , vydané vo francúzštine , občas dávala aj mne , pričom mi nezabudla prikázať , aby som to nikomu neprezradil .	nezabudla	15	Neg
Komár unudene pozrel do trávy .	pozrel	2	Pos
Zúfalo po tebe túžim , slečna , a to je jedno z mojich bláznovstiev .	túžim	3	Pos
“ Neskáč ! “ kričali naňho ženy a deti a muži zatiaľ uzatvárali stávky .	Neskáč	1	Neg
“ Nejdem ! “ odvrkol Mauglí .	Nejdem	1	Neg
Ale ja som Marge nič nepovedal ani v to ráno , ani neskôr .	nepovedal	5	Neg
Netočka sa nesmiala .	nesmiala	2	Neg
Podľa mňa Talianom nejde štúdium cudzích jazykov .	nejde	3	Neg
Všimol som si , že aj ona sa začervenala .	začervenala	8	Pos
" Niekedy , " poznamenala , " pohrozia človeku niečím -- niečím , čomu nedokáže vzdorovať , na čo nedokáže ani pomyslieť .	nedokáže	14	Neg
Dnes a zajtra spím u nej .	spím	3	Pos
“ Ranná čata pôjde chlapca hľadať . “	hľadať	5	Pos
“ Mali by ste sa obaja hneď vydať na cestu . “	vydať	7	Pos
Dnes meškáš , povedala , bála som sa , že neprídeš .	neprídeš	10	Neg
“ Nejdeme domov , “ odvetil Baghíra .	Nejdeme	1	Neg
Od smiechu som takmer nevládala chodiť .	nevládala	4	Neg
Nejedno dieťa už vytklo s bolesťou svojim rodičom : Vy ste na vine , že som sa dostal na zlú cestu , lebo vy sami ste nebrali Ježiša vážne a neviedli ste ma k Nemu .	neviedli	30	Neg
A stalo sa .	stalo	1	Pos
“ Odmlčala som sa .	Odmlčala	1	Pos
Keď sa chrobák zjavil znovu , vyzeral namrzene a hodil na zem kúsok medu .	zjavil	3	Pos
Netúžil som prekladať Danteho Peklo .	Netúžil	0	Neg
Zasmiala sa .	Zasmiala	0	Pos
Potrebujem finančnú podporu , ak chcem študovať .	chcem	5	Pos
Večer ma začala znepokojovať pohrebná trúba .	znepokojovať	3	Pos
Ručička ciferníka vystrelila na päťdesiatpäť .	vystrelila	2	Pos
Ide o unikátny nález brezovej listiny v karelčine , s využitím ruskej abecedy .	Ide	0	Pos
“ Takže týmto ťa odmietam . “	odmietam	4	Pos
Sadli si na konár medzi šuštiace lístie topoľa .	Sadli	0	Pos
“ Mhm , “ povedal Aladin , kým čítal .	povedal	4	Pos
Nevyšiel som ku dverám .	Nevyšiel	0	Neg
Voláte sa . . .	Voláte	0	Pos
Nevyháňala som ho .	Nevyháňala	0	Neg
Svedčia o tom výsledky viacerých súťaží .	Svedčia	0	Pos
V oblasti vodovodov a kanalizácií sa vytvoria podmienky pre podporu rozvojových aktivít v regiónoch s nedostatkom prirodzených zdrojov pitnej vody .	vytvoria	6	Pos
Neznášala som tieto slová .	Neznášala	0	Neg
Bol to neuveriteľný pohľad a pripomínal skôr fatamorgánu .	pripomínal	5	Pos
Nechcem nič konkrétne .	Nechcem	0	Neg
Ako predpokladal , pán Charrington nerobil s prenájmom izby nijaké drahoty .	nerobil	5	Neg
Všetci by lavínu najradšej čo najrýchlejšie odstránili , no nevedeli ako .	odstránili	6	Pos
“ Mhm , “ zamrmlal .	zamrmlal	4	Pos
Tí prašiví tuláci nedajú pokoj ! “	nedajú	3	Neg
Sklo je prirodzene náchylné rozbiť sa a plech nezaručuje odolnosť voči vlhkosti .	nezaručuje	8	Neg
Obaja súhlasili , no nič im nenapadalo .	nenapadalo	6	Neg
Nemôžu sa .	Nemôžu	0	Neg
Naďalej som tam stál so spustenými rukami a na Lorino objatie som neodpovedal .	neodpovedal	12	Neg
Nik neprehovoril .	neprehovoril	1	Neg
Chris pokrútil hlavou , akoby si to rozmyslel .	rozmyslel	7	Pos
Lori po rusky nerozumela , ja som občas zachytil nejaké slovo .	nerozumela	3	Neg
“ Prehľadaj ma , “ odvetil Káa .	Prehľadaj	1	Pos
“ To my poznáme , “ povedal Flaps .	poznáme	3	Pos
Prvý , druhý , tretí aj štvrý odkaz mi nechala Blythe a zneli čoraz rozčúlenejšie .	zneli	12	Pos
" Nenávidím mravnú čistotu , nenávidím dobrotu !	nenávidím	5	Pos
Veštkyňa uprene hľadela do sklenej gule .	hľadela	2	Pos
“ Prestaň zúriť , Blythe , “ šepkala som do slúchadla , aby ma mama nepočula .	šepkala	7	Pos
Biele lístočky kvetu sa jemne odhrnuli a zjavila sa malá rúčka .	zjavila	7	Pos
Nimi vysvätení kňazi teda nie sú právoplatne vysvätenými a nemôžu teda veriacim sprostredkovať dary Ducha Svätého .	nemôžu	9	Neg
Odišla som preč .	Odišla	0	Pos
Na rozdiel od iných nedieľ ma vtedy nečakala vo foyeri .	nečakala	7	Neg
Vtedy zdvihla hlavu .	zdvihla	1	Pos
Nezjavil sa mi tam Hádes .	Nezjavil	0	Neg
“ Nevidela si Makulienku ? “ spýtal sa jej .	Nevidela	1	Neg
Takého odporného tvora ešte nevidela .	nevidela	4	Neg
Celú noc som sa prevaľoval na posteli v hotelovej izbe a nemohol som sa zmieriť s realitou .	nemohol	11	Neg
Neurobil som ani jedno , ani druhé .	Neurobil	0	Neg
Tú ženu som nepoznal , nikdy som ju nestretol .	nestretol	8	Neg
Voš žijúca v lone vystúpi nahor , na krk , voš z vlasov sa spustí dolu , na líce .	vystúpi	4	Pos
Straník žije od narodenia po smrť pod dozorom Ideopolície .	žije	1	Pos
Túto fantastickú predstavu rázne rozbila Lorina prítomnosť .	rozbila	4	Pos
Uvažovala som , akú časť pretekov teraz v duchu pláva .	pláva	9	Pos
Nezáleží na tom , kto si .	Nezáleží	0	Neg
Maličkosť , ktorá poteší .	poteší	3	Pos
Naši neurológovia pracujú na tom už teraz .	pracujú	2	Pos
Jedného letného popoludnia sa na Makovej lúke zjavila obluda , akú ešte nikto nevidel .	nevidel	13	Neg
Ešte nikto nikdy Veľkého brata nevidel .	nevidel	5	Neg
Ani sa to nechcem dozvedieť .	dozvedieť	4	Pos
Pramenné materiály , ktoré zachytávajú 11 . storočie sa zmieňujú o prudkom nástupe novej ideológie do všetkých oblastí života .	zachytávajú	4	Pos
“ Prestaň zúriť , Blythe , “ šepkala som do slúchadla , aby ma mama nepočula .	nepočula	15	Neg
Ľúbim ťa .	Ľúbim	0	Pos
Čím dlhšie som tam šliapala vodu , tým väčšia zlosť ma chytala .	chytala	11	Pos
Už dávno som stratil kontakt so svetom kina a v nových televíziách ma nikto nepoznal .	nepoznal	14	Neg
Potom si ukryla tvár do dlaní .	ukryla	2	Pos
Veril som mu .	Veril	0	Pos
Alan Smithee je meno , ktoré sa používa v titulkoch , keď ražisér z rôznych príčin nesúhlasí s uvedením vlastného mena .	nesúhlasí	16	Neg
“ Neopustím ťa ! “ zakričal princ .	Neopustím	1	Neg
Ukrutne ma to potešilo .	potešilo	3	Pos
Nechal som u nej kľúč .	Nechal	0	Pos
Keď ju vyvreskúvali stovky hrdiel za dupania pochodujúcich nôh , zmocňovala sa človeka hrôza .	vyvreskúvali	2	Pos
“ Kto to tu plače ? “ spýtala sa tá krehká drobučká bytosť a zvedavo sa poobzerala okolo seba .	spýtala	7	Pos
Už štrnásť mesiacov nijaké číslo so sedmičkou na konci nevyhralo .	nevyhralo	9	Neg
Vláda bude klásť dôraz na prehľadnosť , výkonnosť , spoľahlivosť a efektívnosť monitorovacieho a hodnotiaceho systému .	klásť	2	Pos
Práve sa chystala roztiahnuť krídla a vzlietnuť , keď v tieni steny zbadala strážcu .	zbadala	12	Pos
Zvykneš si .	Zvykneš	0	Pos
To si nemyslel vážne . "	nemyslel	2	Neg
Blythe nesúhlasila .	nesúhlasila	1	Neg
Netrvalo dlho a vedľa nej sa pod veľkým černicovým kríkom zjavil tučný svetlohnedý pavúk .	Netrvalo	0	Neg
Neotvoril oči ihneď .	Neotvoril	0	Neg
Neskôrnateli vnútorne .	Neskôrnateli	0	Neg
Začnem podľa poradia , od fascikla s číslom 1 .	Začnem	0	Pos
Keď máme čo jesť , máme všetko ostatné , čo potrebujeme .	potrebujeme	10	Pos
Maja tomu nechcela veriť .	nechcela	2	Neg
Zo strachu o seba , pre svoju povýšenú zbabelosť zaprel svojho Majstra a Pána .	zaprel	9	Pos
Delina predo mnou nikdy nevyriekla toto slovo .	nevyriekla	4	Neg
Vysvetľovala to takto :	Vysvetľovala	0	Pos
Išli sme až k nášmu vchodu na zadnej strane domu a celou cestou sme mlčali .	mlčali	14	Pos
“ Nebolelo ! “	Nebolelo	1	Neg
Publikum burácalo .	burácalo	1	Pos
Mohol sa volať akokoľvek , nebol však Vehap .	volať	2	Pos
Abu pokrčil plecami , tváril sa trochu pochybovačne .	pokrčil	1	Pos
Ešte chvíľu na mňa skúmavo s úsmevom hľadel .	hľadel	7	Pos
Nemám náhodou vo vlasoch nejakú vetvičku ?	Nemám	0	Neg
Ich najnovší projekt sa volá Tanečný dom .	volá	4	Pos
“ Pán Shepherd , “ povedal profesor Tayerle a kývol rukou , “ nemyslite si , že som nevidel lístok , ktorý ste dali pred chvíľou slečne Wyseovej .	nevidel	18	Neg
Keď je tak , nebudem nič oznamovať . “	oznamovať	6	Pos
Strata slobody na platnosť uzavretého manželstva podľa všetkého vplyv nemala a manželstvo zostalo právoplatné .	zostalo	12	Pos
Účastníci jedného letu stratili smer .	stratili	3	Pos
Keď zaznela hymna , po lícach vyčerpaných hráčov sa kotúľali slzy .	zaznela	1	Pos
A pomyslel som si , že ju už neuvidím .	neuvidím	8	Neg
Neodvážila sa otvoriť oči a ja som pochopil , že očakáva niečo strašné .	Neodvážila	0	Neg
“ Chcela by som , aby ste mi vyveštili budúcnosť , ale nemám veľa peňazí . “	vyveštili	8	Pos
Odmietla , povedala , že nepije alkohol .	nepije	5	Neg
Balú sa od smiechu zvíjal .	zvíjal	4	Pos
Nevieš napodobniť nejaké tichšie zviera ? “ spýtala sa Kala .	Nevieš	0	Neg
Potom sa pohodlne oprel a napil sa z fľaše .	napil	5	Pos
Najprv si myslel , že to vybaví podobrotky .	myslel	2	Pos
Neotáľa a vylezie na strom .	vylezie	2	Pos
Máme celé popoludnie .	Máme	0	Pos
Vždy som mával zvláštny pocit , že ten človek ma neznáša .	neznáša	10	Neg
Gregorove nádeje sa za Gejzovho panovania nesplnili .	nesplnili	6	Neg
Niečo vás porazí . Život vás porazí . "	porazí	6	Pos
“ Môžem si to ešte rozmyslieť ? “ spýtala sa .	spýtala	8	Pos
Hlas mi znel neprirodzene .	znel	2	Pos
A predsa ma Faika už nevolala do školy .	nevolala	5	Neg
Kým som takto uvažoval , zdalo sa mi , že som na niečo prišiel .	zdalo	5	Pos
Vliekol som sa po Nevskom prospekte a stále som nedokázal sformulovať nijakú myšlienku .	nedokázal	9	Neg
A lial som do seba whisky .	lial	1	Pos
A Trúbeľko sa zasa radoval , že sa Ferdovi nič zlé nestalo .	nestalo	11	Neg
Mohli si nás všimnúť a vyjavene sa na nás dívať .	Mohli	0	Pos
Ale ona mi nepripomínala nijakú herečku .	nepripomínala	3	Neg
“ A nezabudnite na vrecká , kam zabalíte psom zvyšky . “	nezabudnite	2	Neg
Raz som chytil muchu a vlastnoručne som ju hodil do pavučiny , ale nevidel som , že by sa objavil nejaký pavúk , ktorý by ju zožral .	hodil	8	Pos
“ Obávam sa , že ten chlapec sa nikdy neožení .	neožení	9	Neg
Zrejme nepostrehol Winstonovu belasú kombinézu .	nepostrehol	1	Neg
V každom prípade musím otvoriť oči a nesmiem veriť legendám .	nesmiem	7	Neg
Ak nedostanem z fyziky jednotku , nemôžem so štipendiom rátať .	nemôžem	6	Neg
Tentoraz nebola sama .	nebola	1	Neg
Nechcela som sa s Chrisom rozísť .	Nechcela	0	Neg
Keď Maja začula žalostný nárek muchy , zabudla na strach pred žabami .	začula	2	Pos
Druhý a tretí riadok spolu dávajú meno Sežir .	dávajú	5	Pos
Môj mozog by na to asi nestačil .	nestačil	6	Neg
Večer už boli unavení a z meravého sedenia ich bolel vzadu krk .	bolel	9	Pos
Zatvorím oči a narátam do desať .	narátam	3	Pos
Nová Koncepcia ochrany prírody a krajiny bude obsahovať racionálny systém manažmentu chránených území , prehodnotí ich cieľový stav a navrhne opatrenia a programy starostlivosti tak , aby chránené územia slúžili aj verejnosti .	slúžili	29	Pos
Pred okienkom do pivnice ležal lesklý tvor s červenými očami a nahlas funel .	ležal	4	Pos
Vysypte do nej kuskus a vypnite oheň .	Vysypte	0	Pos
Nezdalo sa mi však , že som ho presvedčila .	Nezdalo	0	Neg
Vláda upraví rámcové podmienky regionálneho rozvoja decentralizáciou verejných financií a zavedie nový , efektívnejší systém finančného vyrovnávania sociálno - ekonomických rozdielov vyšších územných celkov .	zavedie	10	Pos
“ Super , “ povedala som , keď sme kráčali ku kabrioletu .	kráčali	9	Pos
Nemyslite si , že nepôjdu .	Nemyslite	0	Neg
Neobjal ma , nepriblížil sa ku mne , ani nezavrel oči .	Neobjal	0	Neg
“ Ranná čata pôjde chlapca hľadať . “	pôjde	3	Pos
Potomstvo sa o tebe nikdy nedozvie .	nedozvie	5	Neg
Je tvrdohlavý , neodíde , ani keby som to ohlásila na polícii .	neodíde	3	Neg
Že sa utopím ?	utopím	2	Pos
Ako sme už spomenuli , clunyjská reforma sa dostala aj do Lotrinska .	spomenuli	3	Pos
“ Nič sa nestalo , “ odpovedala som hanblivo .	odpovedala	6	Pos
Nemala jediný zub .	Nemala	0	Neg
“ Padajme , kým nás tu zbadá správca , “ zašepkala som .	zašepkala	10	Pos
Tekla vychrlila niekoľko oplzlých pavúčich nadávok , ale na silného Chrabroša si netrúfla , a tak kľajúc zaliezla pod vädnúci list .	netrúfla	12	Neg
Pohľad , ktorý sa mi naskytol , ma vydesil .	vydesil	8	Pos
Vypil ďalší dúšok džinu , vzal bieleho jazdca a pokusne ním tiahol . Šach !	vzal	5	Pos
Svetové ríše , silné krajiny , politické systémy vznikajú a zanikajú , nič netrvá večne .	netrvá	13	Neg
Všetci by lavínu najradšej čo najrýchlejšie odstránili , no nevedeli ako .	nevedeli	9	Neg
V Petrohrade som prvýkrát , nemám tu nijaké kontakty .	nemám	5	Neg
" Neviem .	Neviem	1	Neg
Maja , Vilko a Flip sa mu ani nečudovali .	nečudovali	8	Neg
Najprv sa Radžu ukrutne bojíš a len čo odídem , ste najlepší priatelia .	odídem	8	Pos
Profesor Eugen Jóna , ktorý sa dejinami spisovnej slovenčiny dlhé roky zaoberal , si uvedomil potrebu dať do rúk slovenskej i medzinárodnej vedeckej verejnosti dostatočne prístupný skutočný text tohto základného diela .	zaoberal	11	Pos
Aj ja som prišiel kvôli tomu , hoci som sa nemohol zbaviť stŕpnutosti .	nemohol	10	Neg
Náš vzťah trval rok .	trval	2	Pos
“ Nepridátete sa ku mne , Alia ?	Nepridátete	1	Neg
S čím som mala súhlasiť ? “ nechápala som .	súhlasiť	4	Pos
Neviem , či som na ne pripravená .	Neviem	0	Neg
Muselo sa mu to stať v noci , “ odvetila Bibi .	Muselo	0	Pos
Mohutná posteľ pri okne bola zastlaná dotrhanými prikrývkami a na poduške chýbala obliečka .	chýbala	11	Pos
Malá Maja sa začervenala .	začervenala	3	Pos
Vláda Strany potrvá navždy .	potrvá	2	Pos
" Mám tridsaťdeväť rokov .	Mám	1	Pos
“ Nepiekla to , “ odvetil .	Nepiekla	1	Neg
Zabočila za roh a pridala plyn .	Zabočila	0	Pos
Možno to vyzerá nezmyselne , ale mne to pomáha .	vyzerá	2	Pos
Tú báseň som napísal v štvrtej triede základnej školy , chcel som napodobniť jedného básnika , ktorý bol otcovým priateľom .	napodobniť	12	Pos
Kolektívne postupovať nemôžeme .	nemôžeme	2	Neg
Želám vám príjemný zvyšok týždňa .	Želám	0	Pos
Balú sa napokon predsa len so špľachotom vynoril .	vynoril	7	Pos
Ochráni Jazmínu , nech by jej hrozilo čokoľvek .	hrozilo	6	Pos
Pozoroval som každý štvorcový milimeter jej tváre .	Pozoroval	0	Pos
Preto neskrývame obavy , či sa nechytí aj nás táto nemoc .	nechytí	6	Neg
A všetky naraz začali vylučovať energiu .	vylučovať	4	Pos
Už jej vzhľad mu naháňal hrôzu , a nielen vedomie , že je to on .	naháňal	4	Pos
Pila som , lebo som sa bála , povedala mi .	bála	6	Pos
“ Kto ma volá ? “ ozvalo sa .	ozvalo	6	Pos
Zostal som sedieť v kresle , aj keď sa dvere otvorili a do miestnosti vošli dvaja muži , nové tváre .	Zostal	0	Pos
Dôležitejším znakom oboch kategórií šamanov je , že úspech ich činov nezávisí od toho , akú obetu bohu prinesú , ale od toho v akom vzťahu sú oni sami s bohmi — tj . od ich schopností .	nezávisí	11	Neg
Pripomínali mi najdaromnejšie obdobie môjho života .	Pripomínali	0	Pos
V období vzniku uhorskej cirkevnej organizácie problém , či si uhorský kráľ uzurpoval práva prináležiace Apoštolskému stolcu , ešte nehral rozhodujúcu úlohu .	nehral	19	Neg
" Asi by som to vydržal , nebyť jednej veci , " povedal .	nebyť	7	Neg
Už som nič necítila .	necítila	3	Neg
Prišla tam pred niekoľkými hodinami a niekoľko hodín sa zdráhala zatelefonovať mi .	Prišla	0	Pos
Táto odpoveď mi stačila .	stačila	3	Pos
Máš poškodenú pamäť .	Máš	0	Pos
V tú noc som po mnohých rokoch pocítil potrebu písať poéziu .	písať	9	Pos
Veď čo už zvýšilo z toho , čo z neho mučením nevypáčili ?	nevypáčili	11	Neg
Do chrobákovho obydlia dopadalo tlmené červené svetlo a sladká vôňa bola oveľa prenikavejšia .	dopadalo	3	Pos
Široký nôž sa pri používaní zle drží v ruke .	drží	6	Pos
Ako sme vychádzali z miestnosti , nastal v triede všeobecný ruch .	vychádzali	2	Pos
V mojej mladosti sme litre nepoznali .	nepoznali	5	Neg
Mama postupne napísala otcovi niekoľko listov , ale on jej neodpovedal .	neodpovedal	10	Neg
Trúbeľko preto rýchlo dodal , že bez Ňufka by veru mravenisko neubránili .	neubránili	11	Neg
Neviem , kedy som si tam prvýkrát všimol Doloru .	Neviem	0	Neg
Kolos , ktorý celkom ovládol svet !	ovládol	4	Pos
Maja si pospomínala na všetky nebezpečenstvá , o ktorých im vykladala slečna Kasandra .	pospomínala	2	Pos
Na nič spred začiatku šesťdesiatych rokov sa nepamätala a ( zo všetkých známych ) jediný človek , ktorý často rozprával o rokoch pred Revolúciou , bol jej starý otec .	nepamätala	7	Neg
Každý jeden šedý Reebok vás presvedčí , že tak skoro sa nič nezmení .	nezmení	12	Neg
Natiahla sa k zásuvke na mojej strane a prehŕňala sa v nej , až kým nenašla škatuľku cigariet .	nenašla	15	Neg
Ktosi vystúpil , aby splnil rozkaz .	vystúpil	1	Pos
Ak vojde dnu , bude pred nimi v bezpečí .	vojde	1	Pos
Niet pochýb , že nikdy nemohlo jestvovať obdobie , keď to bolo celkom bežné .	Niet	0	Neg
Zváži motivačné pravidlá pre využívanie domácich primárnych energetických zdrojov , vrátane využívania obnoviteľných zdrojov energie .	Zváži	0	Pos
Neviem vysvetliť , prečo sme nechodili na rande ako iní .	nechodili	5	Neg
Nechcela som , aby niekde zablúdil .	Nechcela	0	Neg
Moje postavy ma prenasledovali .	prenasledovali	3	Pos
Odhrnula som mokré plavky , prázdne kokakolové plechovice , ceruzky , listy vytrhnuté z notesa a knižku Kto chytá v žite so somárskymi ušami .	chytá	18	Pos
Proroctvo otcovho priateľa , že bude zo mňa básnik , sa nesplnilo .	nesplnilo	11	Neg
Myslela som na jeho hlboké hnedé oči .	Myslela	0	Pos
Ďalej sa nestalo nič zvláštne .	nestalo	2	Neg
" Už dlho som to slovo nepočul .	nepočul	6	Neg
“ Nejedz od nej nič , “ zašepkal .	Nejedz	1	Neg
Znovu ho objala .	objala	2	Pos
Pacientov stav sa veľmi zlepšil .	zlepšil	4	Pos
Keby bola , nezdržiaval by ma , keď som sa zúfalo snažila vrátiť do izby .	nezdržiaval	3	Neg
Ani v ten deň , ani neskôr som nemal možnosť pozrieť sa mu zblízka do tváre .	pozrieť	10	Pos
Pri tejto príležitosti som zistil , že o tom , čo sa deje už tri mesiace , sa dozvedám ako posledný .	dozvedám	18	Pos
Poprosil som Lori , aby sme odišli .	Poprosil	0	Pos
Nedovolím to ani jednému , ani druhému .	Nedovolím	0	Neg
A mne sa zdá , že aj mamu prehltol akýsi had .	prehltol	8	Pos
“ No povedzte , nebola som krásna ? “ ubezpečovala sa vážka Kráska .	povedzte	2	Pos
Nahol sa ku mne a odhrnul mi z tváre mokré vlasy .	odhrnul	5	Pos
Nezabudnite si ju vypočuť .	Nezabudnite	0	Neg
“ Nemôžem to počúvať ! “ zamrmlala som a pohodlne sa oprela .	Nemôžem	1	Neg
Veď hrdinu by nemalo nič rozptyľovať .	nemalo	3	Neg
Nikdy nič podobné nevidel .	nevidel	3	Neg
Potom vložila ten lístok do zásuvky , vytiahla z nej kľúč s ťažkým bronzovým štítkom , na ktorom bolo číslo izby , a strčila mi ho do ruky .	vytiahla	7	Pos
Nepovedal som jej nič .	Nepovedal	0	Neg
Ja pred jej príchodom neprežívam nič čarokrásne .	neprežívam	4	Neg
Pri stanovení termínu veľkého pôstu siahli uhorskí zákonodarcovia k jeho starej východnej podobe ešte spred 7 . storočia , ktorá sa v 11 . storočí nepoužívala už ani na kresťanskom východe ani na západe .	nepoužívala	25	Neg
Vyvesili na tabuľu text , ale ani to nepomohlo , lebo Vilko sa z lenivosti nenaučil dobre čítať .	nenaučil	15	Neg
Je ťažké nenávidieť niekoho , kto si natoľko neverí , že sa opičí po druhých .	neverí	8	Neg
Veď sa dozviete .	dozviete	2	Pos
“ Tú šóru v žiadnom prípade nezvládneme , “ povedal Rýchlik a začal cúvať .	nezvládneme	6	Neg
Winstonovi sa zapichla do ruky ihla .	zapichla	2	Pos
Bola to budova , ktorú som hľadal .	hľadal	6	Pos
Jeho monotónny hlas mi pripadal znesiteľný až dovčera , keď Chris povedal , že mu chýba iskra .	chýba	15	Pos
“ Nemá čas .	Nemá	1	Neg
“ Musím rozmýšľať . “	Musím	1	Pos
A predsa to nefungovalo .	nefungovalo	3	Neg
Nilus bol skôr predstaviteľom východného typu mnícha , v osobe ktorého sa spájala vysoká miera asketizmu s rovnako vysokou úrovňou vzdelanosti a kvality duchovného života .	spájala	12	Pos
Vláda vypracuje a realizuje projekt transformácie štátnych podnikov lesného hospodárstva v pôsobnosti Ministerstva pôdohospodárstva SR na štátnu akciovú spoločnosť založenú podľa osobitného zákona .	vypracuje	1	Pos
Po záhrade poletovali mištičky , servítky ba aj stoličky .	poletovali	2	Pos
Kuber to vie , no neodváži sa odporovať .	neodváži	5	Neg
Stromboli zúril .	zúril	1	Pos
Nevládal by bežať , nevládal by uderiť .	nevládal	4	Neg
Profesor Eugen Jóna , ktorý sa dejinami spisovnej slovenčiny dlhé roky zaoberal , si uvedomil potrebu dať do rúk slovenskej i medzinárodnej vedeckej verejnosti dostatočne prístupný skutočný text tohto základného diela .	dať	16	Pos
“ A teraz zavri oči , “ prikázal .	prikázal	7	Pos
Zostávali mi teda poviedky .	Zostávali	0	Pos
Už neuvažoval o tom , že by mu mohla nastavovať pascu .	neuvažoval	1	Neg
Zamestnanci Oddelenia záznamov nerozprávali o svojej práci radi .	nerozprávali	3	Neg
V mysli mu naskočila O ' Brienova tvár , aj keď ju nevyvolala nijaká konkrétna asociácia .	nevyvolala	12	Neg
Zničená som si prisahala , že si cez obedňajšiu prestávku zaplávam a budem trénovať obrátky dovtedy , kým ich nezvládnem .	nezvládnem	19	Neg
Teší ma , “ jachtala som .	Teší	0	Pos
S tým však moja okamžitá strata optimizmu nesúvisí , a nesúvisí ani so skutočnosťou , že predstava takého scenára bola nezmyselná .	nesúvisí	7	Neg
Na vrchole koleso chvíľu postálo a náš vozík sa knísal zboka nabok .	knísal	9	Pos
“ Ostane so mnou celú noc , aby som sa nebála tmy . “	nebála	10	Neg
Prečo by vlastne tí mimozemšťania mali byť naši priatelia alebo nepriatelia , keď sa vyvíjali s úplne iným backgroundom , v inom kontexte , majú totálne iný spôsob dorozumievania , ich ciele a motivácie nechápeme ?	vyvíjali	14	Pos
Na rozdiel od svätoštefanskej legislácie sú tí , ktorí v nedeľu neprídu do kostola , potrestaní prísnejšie – telesným trestom .	neprídu	11	Neg
Z obrazovky sa ďalej valila riava vymyslenej štatistiky .	valila	4	Pos
Bolo by to v poriadku , keby si sa v duchu nestiahla , len čo sa dotkneš steny .	nestiahla	11	Neg
Nemá inú možnosť , musí to skúsiť .	Nemá	0	Neg
“ Nebojím sa ťa . “	Nebojím	1	Neg
Ďakujeme vám , bratia a sestry , za vaše modlitby , pomoc s potravinami , za vaše rady a inú praktickú pomoc !	Ďakujeme	0	Pos
Otočil sa ku mne a nedopovedal .	nedopovedal	5	Neg
Na moje kaktusové obdobie som si spomenula celkom nedávno .	spomenula	6	Pos
Povzdychol si .	Povzdychol	0	Pos
Moja mama to vedela .	vedela	3	Pos
Tentoraz mu ju však pripomenula najmä dusná horúčava toho popoludnia , keď mu na čele vyrazili kropaje potu .	pripomenula	4	Pos
Nespýtal som sa ho , či sa pamätá na obdobie , keď som s ním každú nedeľu chodieval do bábkového divadla .	Nespýtal	0	Neg
“ Vidím , že nič neviete o našom žartíku .	Vidím	1	Pos
Ak odpovedala záporne , nenáhlil som sa .	nenáhlil	4	Neg
Neodvážila sa otvoriť oči a ja som pochopil , že očakáva niečo strašné .	očakáva	10	Pos
Po poslednej hodine , ktorá sa skončila o tretej , som bežala na plaváreň .	bežala	11	Pos
Odvtedy kríva .	kríva	1	Pos
Preto neskrývame obavy , či sa nechytí aj nás táto nemoc .	neskrývame	1	Neg
Maja volala o pomoc , čo jej hrdlo stačilo .	stačilo	8	Pos
Okamžite vzlietla nad miesto nešťastia , kde topiace sa mravce zúfalo kričali o pomoc .	kričali	11	Pos
Ani ja som si to neželal .	neželal	5	Neg
Netrvalo dlho , a policajti prišli do kaviarne zatknúť zlodeja .	Netrvalo	0	Neg
Keby ste ho nenašli , leťte za slnečným svitom .	leťte	5	Pos
Hook nevedel zakryť obrovskú radosť .	nevedel	1	Neg
Zakrátko zhotovil pekné a pevné nosidlá .	zhotovil	1	Pos
Tá relácia , i keď varovala pred známymi dôsledkami zbožšťovania jedla , ma definitívne presvedčia o tom , čo som už dávnejšie tušil .	varovala	5	Pos
Ak muža s tvárou umrlca odviedli o polnoci , bolo ráno , ak ráno , bolo popoludnie .	odviedli	5	Pos
Položil to na vzdialenejší stôl .	Položil	0	Pos
“ Čo tu robíš ?	robíš	3	Pos
Položil som pohár na stôl a išiel som otvoriť .	išiel	6	Pos
Považovala to za skvost vtipnosti a s potešením ho vzala do náručia .	Považovala	0	Pos
“ Kam ideme ? “ vypytoval sa .	vypytoval	5	Pos
“ Nevrť sa toľko ! “ hnevala sa Kasandra .	Nevrť	1	Neg
Prichádzali a záhadne odchádzali ďalší väzni .	odchádzali	3	Pos
“ Dúfam , že mi nechalo aspoň zákusok . “	nechalo	5	Pos
Bol som šťastný ako blška , že sa jej nič nestalo .	nestalo	10	Neg
Odvahy a zbabelosti sa to netýka .	netýka	5	Neg
Drž ! “ povedal .	Drž	0	Pos
Kŕč povolil .	povolil	1	Pos
Títo Sosolci tiahnú proti Rusom , plienia ruský oporný bod Jurjev a útočia na Pskov .	tiahnú	2	Pos
Myslíte si , že sa strana dostatočne nevenovala ekonomike ?	nevenovala	7	Neg
“ Máš právo sa na mňa hnevať .	hnevať	6	Pos
Soni ma prosila , aby som nerobil hlúposti .	nerobil	6	Neg
Z balkóna utiekla , až keď som k odháňacím pohybom pridala aj hlasité zvukové efekty .	utiekla	2	Pos
Človek nikdy nevie , na čo natrafí .	nevie	2	Neg
Neodolala som .	Neodolala	0	Neg
Najprv zamierila za Flipom .	zamierila	1	Pos
Dôsledky učenia Strany ju ani trochu nezaujímali .	nezaujímali	6	Neg
“ Chceš povedať , že s tým nemôžeš niečo urobiť ? “ pýtal sa zúfalý Herkules .	povedať	2	Pos
Spal som v taxíku cestou z hotela na letisko .	Spal	0	Pos
Náhlivo vošla dnu .	vošla	1	Pos
Nebola som schopná plakať .	plakať	3	Pos
“ Slušne , “ zopakovala .	zopakovala	4	Pos
Marga nechcela , aby sme zobudili Irmu .	nechcela	1	Neg
Dodržiaval som toto pravidlo , odkedy som napísal prvú hlúposť z toho cyklu , krátku esej s dlhým názvom Orgazmus alebo Hrôza zo sexuálneho vyčerpania .	napísal	7	Pos
Ak nevyjde , nemáme dôvod stretnúť sa .	nevyjde	1	Neg
Vyšiel som z obchodu .	Vyšiel	0	Pos
Verila , že neurobím to čo ona .	neurobím	3	Neg
“ Nenávidí ľudí , “ odvetil Baghíra .	Nenávidí	1	Neg
Nepovedal som jej nič .	Nepovedal	0	Neg
“ Si v poriadku , Amy ? “ spýtal sa potichu chlapčenský hlas , keď som sa kašlúc vynorila .	kašlúc	17	Pos
* Niektorým poslancom padlo zaťažko zverejniť svoje majetkové priznanie .	padlo	3	Pos
A nehľaď na mňa .	nehľaď	1	Neg
Kým svetlo stihlo zmiznúť , upozornil som naň taxikára .	upozornil	5	Pos
Ty ich neznášaš .	neznášaš	2	Neg
Iba sa trochu sklonila , odkryla deku a ja som uvidel tvár spiaceho človiečika , ktorý nemal takmer nijaké vlasy .	odkryla	5	Pos
Nechal som ju vzlykať .	vzlykať	3	Pos
“ Kam ideme ? “ vypytoval sa .	ideme	2	Pos
Môj mozog zatiaľ začínal špekulovať .	špekulovať	4	Pos
Zmiluj sa nad nimi a veď a ochraňuj ich aj v ďalšie dni života .	Zmiluj	0	Pos
Rozhodol sa letieť za nimi a za trest , že naňho zabudli , vzal so sebou všetkých susedov .	letieť	2	Pos
Táto úvaha ma neuspokojila .	neuspokojila	3	Neg
“ Nechce zastaviť ! “	Nechce	1	Neg
Ak nenájde dievča samo , nebude to mať zmysel .	mať	7	Pos
Zachytil ma , aby som sa neudrela .	Zachytil	0	Pos
Myslím však , že vysoká škola má dve významné úlohy , ktoré so spomínanou rovnicou priamo nesúvisia .	Myslím	0	Pos
Marga sa posadila na posteli .	posadila	2	Pos
Ľubomír Ďurovič do komunistickej strany nevstúpil .	nevstúpil	5	Neg
Musím rešpektovať Marginu požiadavku , aby som deťom nič nepovedal , a zároveň musím nájsť pre Irmu nejaké presvedčivé vysvetlenie .	nepovedal	9	Neg
Išli pomaly a váhavo .	Išli	0	Pos
Raz vylepil svojej dcére Katke mľaskavé zaucho len preto , že sa nahlas smiala .	smiala	13	Pos
Myslím však , že vysoká škola má dve významné úlohy , ktoré so spomínanou rovnicou priamo nesúvisia .	nesúvisia	16	Neg
Tohto pocitu som sa nezbavil ani v triede .	nezbavil	4	Neg
“ Je v šoku , nehýbe sa , “ zistili mravce .	nehýbe	5	Neg
Nevytrvali ísť za Pánom Ježišom .	Nevytrvali	0	Neg
Tekla sedela prikrčená v kúte a zlomyseľne pozorovala jej márne úsilie .	pozorovala	7	Pos
“ Vravela , že pozná sultána . “	Vravela	1	Pos
Berte to tak , že ich píšu Marťania , s ktorými sa nikdy nedorozumiete .	nedorozumiete	13	Neg
Dupot za Ferdom neutíchal a chodba pred ním sa akoby z ničoho nič končila .	neutíchal	3	Neg
O ' Brien nič nepoznamenal .	nepoznamenal	4	Neg
Polovica z nej nikdy nespoznala topánky .	nespoznala	4	Neg
Tyranizuje nás ťaživou krásou obrazov .	Tyranizuje	0	Pos
Nevlastní rodičia sa o Herkula dobre starali a vyrástol z neho milujúci syn a mladík .	vyrástol	8	Pos
Nevedel som dešifrovať jej pohľad , neprečítal som v ňom nič .	Nevedel	0	Neg
Kala pozrela do domu a zbadala stopy po zápase .	zbadala	5	Pos
Samozrejme , že som mu nepovedala , že mám domáce väzenie .	nepovedala	5	Neg
Jumbo si dupol nohou a vystrčil hrozivé tykadlá .	dupol	2	Pos
Len čo stačil dobehnúť do úkrytu , z jaskyne vytrielila svorka vĺčat .	stačil	2	Pos
Nakoniec si urobila z nosidiel trampolínu , začala skákať kotrmelce a nosidlá tak rozhojdala , že ich včielky sotva udržali .	rozhojdala	13	Pos
“ Nemôžem žiť tvoj život , mami , “ šepkala som .	Nemôžem	1	Neg
“ To je legálne ? “ vykríkol ktosi a všetci sa pustili do rehotu .	vykríkol	6	Pos
Marga nebola doma .	nebola	1	Neg
“ To sa zle skončí , “ kuvikal dážďovka Vendelín , ale nikto ho nepočúval .	nepočúval	14	Neg
Preštudoval šachovú úlohu a rozostavil figúrky .	Preštudoval	0	Pos
Umožniť jazykovedcovi rozhovoriť sa o systéme v jazyku , prináša zdanlivo nebezpečenstvo , že sa vstúpi do nezaujímavého a nudného sveta .	rozhovoriť	2	Pos
Ale šéf na nič neprišiel .	neprišiel	4	Neg
Spočiatku som ničomu nerozumel .	nerozumel	3	Neg
Keď sa začal semester , pustil som sa pod vedením profesora SommerfelTa do čítania textov .	pustil	5	Pos
“ Nechceme pomstu , “ povedal zmierlivo Ferdo .	Nechceme	1	Neg
Pozrite sa na mňa ešte raz .	Pozrite	0	Pos
Maja si z celého srdca vydýchla a náhlila sa k potoku , aby tú radostnú novinu oznámila ostatným .	vydýchla	5	Pos
„ Ypsilon ako hláska nie je funkčný a v slovenskom jazyku takej hlásky niet .	niet	13	Neg
Tá správa bola jasná : jej telo túži po mojom tele .	túži	7	Pos
Neostanú však verní fanúšikovia skrátka .	Neostanú	0	Neg
Vytrhol sa z pavúčej priadze takou silou , že nič netušiaceho pavúka s ôsmimi nohami prevrátilo horeznačky .	Vytrhol	0	Pos
Nemohla som si spomenúť , odkiaľ ju poznám .	Nemohla	0	Neg
Keď sa mi posmievala , zmocňovala sa ma trpká zlosť , napriek tomu medzi nami nedochádzalo k scénam .	nedochádzalo	15	Neg
Otočila sa a odletela .	Otočila	0	Pos
Maja znervóznela .	znervóznela	1	Pos
Tak tomu hovorím názorný príklad fungovania zóny najbližšieho vývinu , o ktorej som písala minule !	písala	13	Pos
N . T . sa usmial .	usmial	5	Pos
Nikto mi neodpovedal .	neodpovedal	2	Neg
Márne sa prezliekala , v našej izbe sa vždy našlo niečo , čo smrdelo kravínom .	smrdelo	13	Pos
A už miešala v kotli vriacu tekutinu .	miešala	2	Pos
Ani sa to nechcem dozvedieť .	nechcem	3	Neg
Môže mu veriť ?	veriť	2	Pos
Nestalo sa nič mimoriadne .	Nestalo	0	Neg
Zostal som stáť , ani som sa nepohol .	nepohol	7	Neg
Zabezpečia to baterky s pogumovaným povrchom .	Zabezpečia	0	Pos
Ak si želáte dievča , povedala , zariadime to .	želáte	2	Pos
Spočiatku nevidel nič .	nevidel	1	Neg
Z druhej strany neprišla nijaká odpoveď .	neprišla	3	Neg
Boris svieti zrkadielkom do očí , končím , “ hlásil vysielačkou Vilko .	svieti	1	Pos
Nebežal tadiaľto kôň ? “ kričal som na motýle .	kričal	5	Pos
Dúfam , že to nezbabrem .	nezbabrem	4	Neg
“ Zastavte svet , nech sa prestane krútiť ! “ zvolal .	prestane	6	Pos
Prečo nechodím na rande ?	nechodím	1	Neg
Neničíme kacíra preto , že nám odporuje ; pokým nám odporuje , neničíme ho .	neničíme	12	Neg
Irme sa to nepáčilo .	nepáčilo	3	Neg
Vláda vypracuje a realizuje projekt transformácie štátnych podnikov lesného hospodárstva v pôsobnosti Ministerstva pôdohospodárstva SR na štátnu akciovú spoločnosť založenú podľa osobitného zákona .	realizuje	3	Pos
Už sme spomenuli , že za Ladislavovej vlády prichádza k postupnej konsolidácii pomerov v krajine .	spomenuli	2	Pos
Soni mi to obyčajne nedovoľovala bez prezervatívu .	nedovoľovala	4	Neg
Keď chcel , úplne vypol a okolie preňho neexistovalo .	neexistovalo	8	Neg
“ Ona si to o sebe myslí , “ zasmial sa Truhlík .	zasmial	9	Pos
“ Nemôžem mať samé jednotky !	Nemôžem	1	Neg
Nevládala som naňho pozrieť .	Nevládala	0	Neg
Nešiel som na letisko .	Nešiel	0	Neg
Mama by sa nepotešila , keby som sa správala podľa vlastných predstáv .	nepotešila	3	Neg
Nemala názov .	Nemala	0	Neg
“ Blahoželám , zázračný silák , “ povedala Meg so slzami v očiach .	Blahoželám	1	Pos
Na tvári som jej videla , že ju to vzalo , a keď vstala zo stoličky , bála som sa , že odíde z kuchyne .	vstala	13	Pos
Pripadala mi veľmi známa a bola príjemná .	Pripadala	0	Pos
Prvý sa zobudil Winston .	zobudil	2	Pos
Musíte byť tolerantní , musíte pochopiť , že som nemal iné východisko .	pochopiť	5	Pos
Pri ďalšej skúške vymenila slák za golfovú palicu , takže Klotilda musela kričať a prišla o hlas .	vymenila	3	Pos
Ľudia sa však neukázali .	neukázali	3	Neg
Po celý čas som sa díval smerom k osvetlenému pásmu , kde sa zástup žien tlačil pred skleným priečelím obchodu .	tlačil	15	Pos
“ Nijakú kobylku nepoznám , ukážeš mi ju , Vilko ? “	nepoznám	3	Neg
A nemýlil som sa .	nemýlil	1	Neg
Wilsher , blondiak s nasprostastým výrazom na tvári , ktorého takmer nepoznal , ho s úsmevom pozýval na voľné miesto pri svojom stole .	nepoznal	11	Neg
Tešila som sa , ale zároveň mi chýbali tie chvíle , keď sme po večierkoch spolu posedeli a rozoberali každý detail .	chýbali	7	Pos
Bojoval proti vykorisťovaniu v indickej spoločnosti , proti krviprelievaniu medzi hinduistami a moslimami , proti vojne , za politickú nezávislosť svojej krajiny .	Bojoval	0	Pos
Nemyslite si , že nepôjdu .	nepôjdu	4	Neg
Nejestvoval ; nikdy nejestvoval .	Nejestvoval	0	Neg
Nepoznám nič horšie ako utáraných kamarátov .	Nepoznám	0	Neg
Ten telnatý muž sa ma nič nevypytoval .	nevypytoval	6	Neg
“ Nemôžem , “ čo znamenalo , že ho nemôžem pozvať dnu , a nie bozkávať sa .	Nemôžem	1	Neg
“ Vysvetlíme mu , že ja také niečo nikdy neurobím ! “	neurobím	9	Neg
Faika si nič nevšimla a nevmietla mi do tváre nijaký prívlastok .	nevmietla	5	Neg
“ Myslím na dnešné preteky , “ zaklamala som .	Myslím	1	Pos
Od chvíle , keď ho uväznili , nepoznal , čo je tma a čo denné svetlo .	nepoznal	7	Neg
Baghíra ho ťahal , ale Mauglí sa pevne držal stromčeka .	ťahal	2	Pos
Nepodarilo sa mi to .	Nepodarilo	0	Neg
Zastavil sa pri lieskach a zbadal tam veveričku Barku .	Zastavil	0	Pos
“ Ja si počkám , “ odmietla .	odmietla	6	Pos
Nikto nevie , kam ho pochovali .	nevie	1	Neg
No kým si Aladin stačil odhryznúť , čosi ho zaujalo .	odhryznúť	5	Pos
Ja sa na Vianoce teším .	teším	4	Pos
Moja myseľ opäť postrehla akúsi súvislosť medzi autom a týmito dvoma mužmi .	postrehla	3	Pos
Netrvalo dlho a predsedov príklad nasledovali súčasne Sabri aj veterinárny technik .	Netrvalo	0	Neg
Vtom sa v temnici zjavili dobré víly .	zjavili	4	Pos
Priviezol ho džíp , za ktorým išlo kryté nákladné auto , naložené naplno .	Priviezol	0	Pos
Ani tieto základné zručnosti neovláda každé dieťa !	neovláda	4	Neg
Alia mu ukázala dve ligotavé medené mince .	ukázala	2	Pos
“ Ja som to bol , “ priznal sa Baghíra .	priznal	7	Pos
Šetrí aj pani ministerka financií , ktorá stále nevylučuje ďalšie zvyšovania cien a zodpovednosť za to prenechala na vedúcich úsekov ?	Šetrí	0	Pos
Vilko najprv reptal , ale potom ho Maja nespoznávala .	nespoznávala	8	Neg
“ Ale mne veriť môžeš . “	môžeš	4	Pos
Na druhý deň neprišla na vyučovanie .	neprišla	3	Neg
“ Prisahám na svoj včelí život , že môj kamarát stratil pri nehode vedomie a prebral sa iba zázrakom ! “	Prisahám	1	Pos
Ja neviem .	neviem	1	Neg
Porozprával Júlii , ako mu matka zmizla .	zmizla	6	Pos
Dúfala som , že sa nápadne zablyští na slnku , ale , žiaľ , v ten deň bolo zatiahnuté .	zablyští	6	Pos
Kým Mauglí triasol Baghírom , aby sa prebudil , zjavilo sa obďaleč stádo slonov .	zjavilo	9	Pos
Porota však ocenila práce slimákov Šuchtáka a Plazivca , ktorý si prekrásne vymaľovali domčeky .	vymaľovali	12	Pos
Ich sústredený pohľad nemohol neupútať moju pozornosť .	neupútať	4	Neg
Obe upierali naňho zrak .	upierali	1	Pos
Podaktorí si to nemysleli .	nemysleli	3	Neg
Odložil som pohár a očami som opäť zablúdil k protiľahlým stolom , pri ktorých sedeli spomínaní ľudia .	zablúdil	7	Pos
Navyše technológia našich tlačiarní sa ani dnes veľmi neodlišuje od technológie z čias Gutenberga .	neodlišuje	8	Neg
Pochybovačne zdvihla obočie , pozrela na mňa a ďalej vykladala nákup .	pozrela	4	Pos
Keď však videl tých zamyslených zubáčov , nedalo mu to .	nedalo	7	Neg
Uvedomuješ si , aká osamotenosť nás potom čaká ?	čaká	7	Pos
Keď to navrhol Júlii , súhlasila neočakávane horlivo .	súhlasila	5	Pos
Ja som však neznášal huriavk , ktorý robili ľudia čakajúci v radoch .	neznášal	3	Neg
Nedýchala som , lebo skúmavo na mňa pozeral .	Nedýchala	0	Neg
Musí ma dostať z mŕtvolného stavu .	Musí	0	Pos
Zhrozený Herkules si uvedomil , že Hádes má na mysli Meg .	uvedomil	3	Pos
Ony , samozrejme , vyzváňali ďalej .	vyzváňali	4	Pos
Herkules si ho však nevšímal .	nevšímal	4	Neg
Počul , ako Júlia zaťala zuby . " Asi by sme sa mali rozlúčiť , " poznamenal .	zaťala	4	Pos
Jeho vyduté biele bruško pripomínalo huňatý kopček .	pripomínalo	4	Pos
Neuspokojme sa s tým , že sme poslali svojím blízkym veľkonočný pozdrav , ale ukážme im ako vyzerá život v nádeji vzkriesenia a víťazstva v Kristu .	Neuspokojme	0	Neg
Nevládal odtrhnúť oči od ciferníka .	Nevládal	0	Neg
“ Preber sa , Baghíra , preber sa ! “ kričal Mauglí .	kričal	10	Pos
Chcem vedieť , či niekedy nájdem pravú lásku . “	Chcem	0	Pos
Mlčky sme sedeli a dívali sa , ako medená žiara pomaly bledne .	dívali	4	Pos
Ale tým sa táto záležitosť neskončila .	neskončila	5	Neg
Lori ma nežiadala o schôdzku na konci sveta .	nežiadala	2	Neg
Nič som nevidel .	nevidel	2	Neg
Tigríča sledovalo , ako sa rozkotúľali , a skočilo medzi ne !	sledovalo	1	Pos
Zároveň však Cluny urobilo veľký krok na ceste k libertas , lebo vytvorilo spoločenstvo ( zväčša ) úplne slobodných kláštorov , ktoré nepodliehali laikom .	urobilo	3	Pos
A predovšetkým , nedovoľujeme mŕtvym , aby povstali proti nám .	nedovoľujeme	3	Neg
Mauglí veselo poskakoval vedľa medveďa .	poskakoval	2	Pos
Neotočil hlavu .	Neotočil	0	Neg
Nespýtal som sa jej na to .	Nespýtal	0	Neg
Mešťania sa nazlostili a upozornili Herkulovho otca , nech ho viac do mesta nepúšťa .	upozornili	4	Pos
Sviečky som vložila do mosadzných svietnikov a postavila ich na stôl .	vložila	2	Pos
Publikum nevie , či sa má smiať alebo plakať , ale napokon sa rozosmeje .	nevie	1	Neg
Ak nepočítam učebnice , až donedávna jediné knihy , ktoré držala v ruke , boli detské rozprávky .	nepočítam	1	Neg
Pred domom kuny Chytráčky viali pestré slepačie perá , Alfonz vystavoval lesklú kukuricu a kliešťak Drakula voňavé krvavé klobásky .	vystavoval	10	Pos
Preto szabolcsská synoda schválila niekoľko kánonov , ktoré ich mali brániť pred takouto ujmou .	brániť	10	Pos
Chris sa zasmial a pomrvil sa na tvrdých hranatých škridlách .	pomrvil	4	Pos
“ Nechceš ochutnať ? “ spýtala sa bosorka .	Nechceš	1	Neg
Neprezradila som jej , o čom sme sa rozprávali s Rickom , bála som sa , že sa nazúri , ak zistí , že som sa ich snažila dať dokopy .	Neprezradila	0	Neg
Chcel by som s tebou prebrať istú myšlienku , ktorá ma znepokojila len pred chvíľou , keď Irma odišla na letisko .	Chcel	0	Pos
“ Mohla by som doplniť aj najhulvátskejší ? “ dodala Aziza .	doplniť	4	Pos
Parsons sa opäť rozrečnil .	rozrečnil	3	Pos
Musí sa veľa učiť a Kasandrinou úlohou bolo vychovať ju a pripraviť na život včely .	vychovať	8	Pos
Zovrel ju v náručí a vtedy zistil , že bozkáva živú , teplú tvár .	Zovrel	0	Pos
Zaburácal silný výbuch , ktorý akoby zodvihol vydláždený chodník ; na chrbát mu dopadla spŕška ľahkých predmetov .	Zaburácal	0	Pos
Samozrejme , ja som o tom nič nevedel .	nevedel	7	Neg
Zmocnil sa ma nevysvetliteľný strach , mal som pocit , že ju už neuvidím .	neuvidím	13	Neg
Nemal topánky , veľké špinavé prsty mu vyčnievali z dier na ponožkách .	Nemal	0	Neg
Doteraz sa ešte nikto o ňu tak veľmi nebál .	nebál	8	Neg
“ Erik ! “ zvolala Ariela .	zvolala	4	Pos
Nenašiel som slová , aby som mohol odpovedať .	Nenašiel	0	Neg
Hodila . . .	Hodila	0	Pos
Prestala som na to myslieť .	myslieť	4	Pos
“ Nehovor , “ zahlásila Jill .	Nehovor	1	Neg
Zrazu od úžasu onemela .	onemela	3	Pos
“ Prečo ste neoslavovali aj vy ? “ vypytoval sa Vilko .	neoslavovali	3	Neg
Vilko s Majou doleteli na lúku s koňmi .	doleteli	3	Pos
My sme mravce smelé , my sa nezľakneme .	nezľakneme	7	Neg
Na dobrú náladu im veselo vyhrávali muzikanti .	vyhrávali	5	Pos
Obrazovka načas zmĺkla .	zmĺkla	2	Pos
Ja tomu len verím . Viem , že raz padnete .	padnete	9	Pos
Chcela ho odohnať , ale Tarzan jej chytil ruku .	Chcela	0	Pos
Zastupiteľstvo súhlasilo s umiestnením vo vojenskom kostole .	súhlasilo	1	Pos
I keď som mala na sebe jeho bundu , naskočila mi husia koža , ale neuhla som sa .	neuhla	15	Neg
“ Pán Shepherd , “ povedal profesor Tayerle a kývol rukou , “ nemyslite si , že som nevidel lístok , ktorý ste dali pred chvíľou slečne Wyseovej .	nemyslite	13	Neg
Zdvihol som ho .	Zdvihol	0	Pos
Neuľahčuje mi to .	Neuľahčuje	0	Neg
Usadili sme sa pripravení sledovať oblohu .	sledovať	4	Pos
Medzi seba a potkany musí postaviť inú ľudskú bytosť , telo inej ľudskej bytosti .	postaviť	5	Pos
Už nebežal , ani nejasal .	nejasal	4	Neg
Neodvážil som sa jej nič povedať .	Neodvážil	0	Neg
Keď som mal vši , nikam som necestoval , nechodieval som domov .	nechodieval	9	Neg
Čo sa týka vzťahov Novgorodcov a podmanených ugro ‐ fínskych plemien , formálne podriadené kmene si zachovávali značnú dávku nezávislosti .	zachovávali	16	Pos
Nepamätal som sa , či sme s Raisou vypili včerajšiu fľašu alebo nie .	vypili	8	Pos
Nenamietam ani teraz .	Nenamietam	0	Neg
Od tvojho príchodu na svet , od vzniku Strany , od začiatku dejín trvá stále tá istá vojna bez prestávky .	trvá	13	Pos
Keď som čítala posledné riadky , myslela som na mamu , ktorá robila zázraky , aby sme dajako vyšli .	robila	12	Pos
Prepáčila by mi to , aj keby vedela , že som to odkladala kvôli nočnému astronomickému klubu s Chrisom ?	vedela	7	Pos
“ Radža naozaj nikomu neublíži , “ ubezpečovala ho Jazmína .	neublíži	4	Neg
Medzi pretekármi pravdaže nchýbal ani Flip , ktorý mal v hľadisku spústu fanúšikov .	nchýbal	3	Neg
Nemala jediný zub .	Nemala	0	Neg
Bála som sa , že keby som naznačila , po čom túžim , mama by si našla aj tretie zamestnanie .	našla	16	Pos
Neverím , že by sme mohli niečo zmeniť za nášho života .	Neverím	0	Neg
Vyšiel som na kopec , ale nestretol som nijakého psa .	nestretol	6	Neg
V okne na prvom poschodí zbadala uväznenú cvrčicu .	zbadala	5	Pos
A zasmial som sa .	zasmial	1	Pos
Nemala som chuť rozlúčiť sa .	Nemala	0	Neg
“ A nikto ma nechce . “	nechce	4	Neg
Kedy sa zmenili Rickove city ku mne a prečo som si to nevšimla ?	nevšimla	12	Neg
Neobjal ma , nepriblížil sa ku mne , ani nezavrel oči .	nepriblížil	3	Neg
S tým však moja okamžitá strata optimizmu nesúvisí , a nesúvisí ani so skutočnosťou , že predstava takého scenára bola nezmyselná .	nesúvisí	10	Neg
Stoly a stoličky boli prevrhnuté , vázy rozbité a obrazy viseli nakrivo .	viseli	10	Pos
“ Počkaj , “ povedal , vyzul si tenisku a vylial z nej vodu na trávnik .	vyzul	6	Pos
Neotáľa a vylezie na strom .	Neotáľa	0	Neg
Nikto neprotestoval , že sa predbiehame .	neprotestoval	1	Neg
Chris sa držal vľavo , šiel v pruhu , ktorý rozhodne neviedol ku knižnici .	neviedol	11	Neg
Nezdalo sa mi však , že som ho presvedčila .	presvedčila	8	Pos
Je síce pravda , že nijaký súdruh Ogilvy nikdy neexistoval , ale zopár riadkov v tlači a niekoľko vyfabrikovaných fotografií čoskoro splodia jeho existenciu .	neexistoval	9	Neg
V prípade , ak si poslanci odsúhlasia platených sekretárov , môže sa stať , že " Ringom Čechom " budú poslanci a efekt bude mať sekretár .	mať	24	Pos
“ Džafar , rozkazujem ti , aby si prestal ! “ zlostne skríkol sultán .	prestal	8	Pos
Nesmieme strácať ani chvíľočku . “	Nesmieme	0	Neg
Nerozumel som , prečo mi to hovorí .	Nerozumel	0	Neg
Nejestvoval ; nikdy nejestvoval .	nejestvoval	3	Neg
V Oceánii právo nejestvuje .	nejestvuje	3	Neg
Musím niečo urobiť , inak hrozí , že sa nezúčastním na Lorinom svadobnom obrade .	nezúčastním	9	Neg
Netrvalo dlho a opäť sa ozvalo zvonenie .	Netrvalo	0	Neg
Nik iný ho neoslovil .	neoslovil	3	Neg
Mauglí sa zamračil .	zamračil	2	Pos
Volá sa Maja .	Volá	0	Pos
Nenávidím tie hodiny .	Nenávidím	0	Pos
“ Ty nemôžeš žiť !	nemôžeš	2	Neg
Okrem zajatcov priemerný občan Oceánie nikdy nezočí občana Euroázie alebo Východoázie a zakazuje sa ovládať cudzie jazyky .	nezočí	6	Neg
Ani nemukla a bez pohnutia sa dívala na spiace dieťa .	nemukla	1	Neg
Nahradilo ich niekoľko všeobecných slov , čím sa zlikvidovali .	Nahradilo	0	Pos
Skúsil som sa rozpomenúť na jej tvár .	Skúsil	0	Pos
“ Nesmieš sa udrieť , nesmieš sa udrieť , nesmieš sa udrieť .	nesmieš	9	Neg
" Nemám na mysli priznanie .	Nemám	1	Neg
Bola to rovnaká vôňa , lenže tentoraz mu akosi neprekážala .	neprekážala	9	Neg
Ráno sa Alfonz za bratovo správanie všetkým ospravedlňoval .	ospravedlňoval	7	Pos
Vysvetli mi to . “	Vysvetli	0	Pos
" Nechápeš , že jediným cieľom newspeaku je zúžiť rozsah myslenia ?	Nechápeš	1	Neg
“ Ale to som predsa nechcela ! “ zvolala Lienka , keď predseda súdu vyhlásil rozsudok .	nechcela	5	Neg
Chceš vidieť , ako urobím leoparada ? “ spýtal sa .	Chceš	0	Pos
Nemôžem pritom nespomenúť ešte jednu vec .	Nemôžem	0	Neg
Tu nejde o solipsizmus .	nejde	1	Neg
Súžitie etník tu teda fungovalo na princípe spoločenstiev v ktorých jednotlivé zložky popri sebe slobodne existovali a zároveň sa ovplyvňovali , miešali a splývali .	existovali	15	Pos
Na Makovej lúke sa nič nedialo , a tak zamierila do lesa .	nedialo	5	Neg
Odtiahla som sa .	Odtiahla	0	Pos
Najskôr som začul psí brechot .	začul	2	Pos
Marga neverila jej klamstvám , ja som ich prijímal .	neverila	1	Neg
Keď odišla , vstal som a zamkol dvere znútra .	zamkol	6	Pos
Uvedomila som si , že ma nepočúval .	nepočúval	6	Neg
Neotvoril oči ihneď .	Neotvoril	0	Neg
Po kráľovskej hostine , na ktorú mravce priniesli obrie porcie špagiet s voškovou omáčkou , si všetci políhali na slniečko , aby si oddýchli .	priniesli	7	Pos
Vo svojom blaženom sne Winston nevenoval nijakú pozornosť tomu , že mu nalieva pohár .	nevenoval	5	Neg
Aladin zle spal .	spal	2	Pos
Preletela na list toho neznámeho tvora a sadla si vedľa neho .	sadla	7	Pos
Pani Shepherdová sa zasmiala , no mala som nepríjemný pocit , že mi neverí .	neverí	13	Neg
Mama mi o ňom nikdy predtým nerozprávala .	nerozprávala	6	Neg
Mauglí skĺzol po liane dolu .	skĺzol	1	Pos
Dofajčí ju po smene , ak ju dokáže nevytrúsiť .	nevytrúsiť	8	Neg
Nevládal by bežať , nevládal by uderiť .	Nevládal	0	Neg
" A kto ťa udal ? " opýtal sa Winston .	opýtal	7	Pos
Najmiernejším prívlastkom , ktorý by mi vmietla do tváre , by bolo slovo „ gauner “ .	vmietla	6	Pos
“ Nemôžem , “ čo znamenalo , že ho nemôžem pozvať dnu , a nie bozkávať sa .	nemôžem	9	Neg
" Nechoď na voľné priestranstvo !	Nechoď	1	Neg
Máte kvalitnú vodku , poznamenala , čo som vôbec nečakal .	nečakal	9	Neg
Človeka to bohvieako nezaujímalo , popíjal z pohára a škriabal na papier tie svoje znaky .	nezaujímalo	3	Neg
Odporná extáza strachu a pomstychtivosti , túžba zabíjať , mučiť , drúzgať tváre kováčskym mlátom akoby preskočila sťa elektrický prúd na všetkých a premenila každého aj proti jeho vôli na vrieskajúceho pomätenca s pokrivenou tvárou .	premenila	23	Pos
Keď ich spustil na zem , zazrel na vzdialenom konci miestnosti trojstranné zrkadlo .	zazrel	6	Pos
“ Chyť volant , “ povedal a otočil sa k zadnému sedadlu , kde mal športový vak .	Chyť	1	Pos
Reklama nás každý deň bombarduje rôznymi výzvami , sľubuje bohatstvo , zdravie a úspech .	sľubuje	8	Pos
Zlá víla sa princovi Filipovi posmievala , no prezradila mu , že iba on môže zrušiť Zorničkinu kliatbu , ak ju pobozká .	pobozká	21	Pos
“ Mala som pocit , že sa vznášam ! “ vravela som mame , keď za mnou pribehla a objala ma .	vznášam	7	Pos
Vyrába umelé potreby , ktoré nás aktivujú , vyprázdňujú , ničia a zotročujú .	Vyrába	0	Pos
Pripadalo by mi znesiteľnejšie , keby kvôli nemu nespal ani Chris .	nespal	8	Neg
“ Z nás sa nikdy nestanú piráti , “ hrdo vyhlásila Wendy .	nestanú	5	Neg
Pre svoju krátkosť a úryvkovitosť sa nedajú podrobiť podrobnejšej analýze .	nedajú	6	Neg
Nakoniec ma chcela privítať .	privítať	3	Pos
Chvíľu tam ležal akoby omráčený , pričom mu z úst a z nosa stekal pruh tmavej krvi .	stekal	13	Pos
Potom knihu zavrela a dievčatko pobozkala .	zavrela	2	Pos
“ Ty pokúšaš moju trpezlivosť ? “ zreval .	pokúšaš	2	Pos
Makové zrniečka v nej zašušťali , ako keď sa presýpajú myšlienky .	presýpajú	9	Pos
Všetkým sa zdal veľmi zaujímavý , najmä pavúčici Hedvige .	zdal	2	Pos
Síce sme nevyhrali , ale verím , že aj to príde .	nevyhrali	2	Neg
Na druhej strane jeho činy neupravuje nijaký zákon , ani nijaký jasne sformulovaný kódex správania .	neupravuje	5	Neg
Začal som pochybovať , či som v izbe sám .	pochybovať	2	Pos
Povedala , že by sme mali odísť bez rozlúčky , nechcela , aby sme nechali Irme odkaz , kam ideme , a ja som pozbieral odvahu .	nechcela	10	Neg
“ Daj im pokoj ! “ skríkol Aladin .	skríkol	6	Pos
Ale Kerchak to nevidí ! “	nevidí	3	Neg
“ Viete čo ? “ povedal Ferdo kamarátom .	Viete	1	Pos
V hoteli ubytovali len mňa .	ubytovali	2	Pos
Ale tomu neuniklo nič .	neuniklo	2	Neg
Až doteraz vlastne nepostrehol , aký je chudý a slabý .	nepostrehol	3	Neg
Tú ženu som nepoznal , nikdy som ju nestretol .	nepoznal	3	Neg
“ To sa nemalo stať ! “ kričal nešťastný Herkules .	nemalo	3	Neg
“ Veľmi ma teší . “	teší	3	Pos
Otvoril som ju .	Otvoril	0	Pos
“ Podľa teba nemám právo na vlastný život !	nemám	3	Neg
“ To je moja mama , “ povedalo .	povedalo	7	Pos
Opatrne si sadol vedľa na stoličku a uprene sledoval Radžu .	sadol	2	Pos
“ Chŕŕŕŕŕ ! “ zachrčal netvor , keď sa mu šíp zaryl do chrbta .	zachrčal	4	Pos
Ale to sa nedalo spoľahlivo určiť .	nedalo	3	Neg
A nakoniec , nevolám sa Trapi .	nevolám	3	Neg
Čakal som celé dve hodiny , ale šéf nechodil .	nechodil	8	Neg
Začali sme na kolotočoch , kde sme vyliezli na koňa .	vyliezli	7	Pos
Neviem , čo mi to napadlo .	Neviem	0	Neg
Bez problémov našiel moje pery , akoby dôverne poznal moju tvár .	poznal	8	Pos
Nepostupoval by bezpečne , keby odmietol .	Nepostupoval	0	Neg
Nevidieť tú reláciu , povedal by som spolu s Freudom , že za všetkým je sexuálne pudenie , ale tých dvadsať minút mi otvorilo oči .	Nevidieť	0	Neg
Vilko visel na Maji ako ťažké bremeno .	visel	1	Pos
Nevedel som dešifrovať jej pohľad , neprečítal som v ňom nič .	neprečítal	6	Neg
Vybral som peniaze a podal som mu ich .	Vybral	0	Pos
Urobíme nejaké rozbory , určíme liečbu . . .	Urobíme	0	Pos
Ak prirátam hodinu na pečenie , bude trištvrte na jedenásť .	prirátam	1	Pos
Teplé letné dni sa skončili a mladé včielky prvý raz zažili jeseň .	zažili	10	Pos
Ocitlo sa osamote s Lori a zo svojej skrýše všetko pozorne vnímalo : tvary Lorinho tela , jej dych , vôňu jej mäsa .	Ocitlo	0	Pos
Abdullah povedal , že raz budem bohatý . “	povedal	1	Pos
Bežné prachovky naňho nestačia ” .	nestačia	3	Neg
Vtedy som nemohol tušiť , že to mesto mi vybrala prozreteľnosť .	nemohol	2	Neg
“ Keď napríklad zavrem oči , vidím teba , Amy . “	zavrem	3	Pos
Ustráchaní sedeli na akejsi lúke a nevedeli , kadiaľ sa ide domov .	nevedeli	6	Neg
Urobila som adventný veniec a zavesila na dvere .	Urobila	0	Pos
" Hráš , vyhráš , hráš , prehráš .	hráš	5	Pos
Zmeravela som , keď na druhý deň Chris meškal celých desať minút na hodinu astronómie .	Zmeravela	0	Pos
Paradoxne som si želal , aby neprišiel .	želal	3	Pos
Navrhli im , že ak chcú prežiť v nových podmienkach trhového hospodárstva , môžu predávať po tiranských chodníkoch cigarety alebo banány .	chcú	5	Pos
“ Čo sa s tebou deje , Amy ? “ vypytoval sa ma po pretekoch tréner August a odviedol ma nabok , kým ostatní nastupovali do autobusu .	nastupovali	24	Pos
Dal som jej aj nejaké ruble a povedal som , aby za ne nakúpila pivo a ešte niečo iné .	nakúpila	13	Pos
Práve poletovala medzi bielymi jazmínovými kvetmi a nevšimla si jemnulinké a tenulinké vlákna napnuté medzi konárikmi .	nevšimla	7	Neg
Duchovní v tejto funkcii sa netešia veľkej úcte , sú ohováraní svojimi nevoľníkmi , mučení a zabíjaní .	netešia	5	Neg
Aby ma Chris nepovažoval za decko pretože , nemám mamin súhlas , nič som mu nevravela .	nevravela	15	Neg
V učebniciach dejepisu stojí , že život pred Revolúciou bol celkom iný , ako je dnes .	stojí	3	Pos
To je fantastická novina ! “ zvolala som a objala ju .	objala	9	Pos
Neopustila ma celý týždeň ani celé leto .	Neopustila	0	Neg
Netrvalo dlho a nad jaskynkou sa zachvel list , spod ktorého vyliezol prečudesný chrobák .	Netrvalo	0	Neg
" Nezabil som ju .	Nezabil	1	Neg
Maja zo zvedavosti priletela bližšie a sadla si na vedľajší list .	sadla	6	Pos
Takáto vyhliadka na nadchádzajúci večer sa mi nepáčila .	nepáčila	7	Neg
Deti boli v kostole veľmi tichučko a správali sa vzorne .	správali	7	Pos
Zachvátila ma panika , nevládal som utekať .	nevládal	4	Neg
Teší ma , “ jachtala som .	jachtala	4	Pos
Napriek tomu nerob unáhlené závery .	nerob	2	Neg
Po putovaní rôznymi bratislavskými krčmami sa slovenské večery vrátili do Véčka .	vrátili	8	Pos
Mama pila doma , nikdy sa nestalo , že by sa vrátila z kravínov a razila alkoholom .	razila	15	Pos
Mladým som vyrozumel z tváre , že ani oni sa dobre nevyspali .	nevyspali	11	Neg
Nezhromaždilo sa tam veľa ľudí .	Nezhromaždilo	0	Neg
Keď preberal znova volant , prikryl mi ruky , ktoré ostali naspodu .	preberal	1	Pos
Nemala som nijaký dôvod namietať .	namietať	4	Pos
Takáto túžba robiť hlúposti ma neopustila po celý deň .	neopustila	5	Neg
Nadvihol som jej tvár .	Nadvihol	0	Pos
Pravovernosť znamená nemyslieť -- nepotrebovať myslieť .	nepotrebovať	4	Neg
Za to , že som neprehltol spomenutú návnadu , nevďačím nijakej inteligencii .	neprehltol	5	Neg
Požiadavka primeraného vzdelania klerika nepotrebuje obšírnejší komentár .	nepotrebuje	4	Neg
Ak jej dovolím odísť , už ju neuvidím .	dovolím	2	Pos
Neodvážil som sa spýtať sa jej na to .	Neodvážil	0	Neg
“ Ani ja nič nedostanem zadarmo , a teraz si tú háveď pekne odveď ! “	nedostanem	4	Neg
" Niekedy , " poznamenala , " pohrozia človeku niečím -- niečím , čomu nedokáže vzdorovať , na čo nedokáže ani pomyslieť .	nedokáže	19	Neg
“ Pustíš ? “ spýtal sa Ferdinand .	spýtal	4	Pos
Robili sme to v mori a ja som necítil váhu Soninho tela .	necítil	8	Neg
Sú tu správy !	Sú	0	Pos
Rovnako prekvapujúco dobre vedela rozprávať bez pohybovania perami .	rozprávať	4	Pos
Keď som mal vši , nikam som necestoval , nechodieval som domov .	necestoval	7	Neg
“ Nezáleží ? “	Nezáleží	1	Neg
“ Amy , “ zašepkal Chris , objal ma okolo krku a hladkal ma po vlasoch .	zašepkal	4	Pos
Neodvážili sa ho dráždiť ani decká , ani psy .	Neodvážili	0	Neg
Len čo sa jej dotkol , myklo ňou a akoby zmeravela .	zmeravela	10	Pos
“ Prv ako som dopovedala , zmocnili sa ma výčitky , že som mala byť inde a venovať sa učeniu .	dopovedala	4	Pos
Chvalabohu , nič sa mu nestalo .	nestalo	5	Neg
Zrazu sa ma zmocnilo presvedčenie , že som to zbabrala , ani kytička sedmokrások ma nemohla utešiť .	zbabrala	9	Pos
Vtedy som uvidel , že nie som sám .	uvidel	2	Pos
“ Ty mi neveríš , však ? “	neveríš	3	Neg
Po špičkách som zišiel do salóna na prízemí , kde som na chvíľu zastal so zatajeným dychom .	zastal	13	Pos
Natoľko ma zaskočil , že som ho skoro ostriekala .	ostriekala	8	Pos
V ten deň som zaplávala osobný rekord .	zaplávala	4	Pos
Prečo by vlastne tí mimozemšťania mali byť naši priatelia alebo nepriatelia , keď sa vyvíjali s úplne iným backgroundom , v inom kontexte , majú totálne iný spôsob dorozumievania , ich ciele a motivácie nechápeme ?	nechápeme	34	Neg
Igelitku s pivom položila na stôl .	položila	3	Pos
Terapia nezabrala .	nezabrala	1	Neg
“ Ani sa nečudujem , že pre ňu nemôžete nič vymyslieť .	nemôžete	8	Neg
Ešte mal zalepené hlasivky a nemohol rozprávať .	nemohol	5	Neg
" Dom je naozaj obkľúčený , " povedal ten hlas .	povedal	7	Pos
Sedeli sme pri stole oproti sebe .	Sedeli	0	Pos
" Vlastne by to na veci nič nezmenilo , " poznamenal .	nezmenilo	7	Neg
Aj tak sa vybrala pod harmanček , či náhodou pod lístkom neostala nejaká kvapôčka .	neostala	11	Neg
“ Môjmu kráľovskému uchu sa donieslo , že chceš ostať v džungli . “	ostať	9	Pos
" Môže to trvať dlho , " odvetil O ' Brien . " Ty si ťažký prípad .	Môže	1	Pos
Zachytil ma , aby som sa neudrela .	neudrela	6	Neg
Pohrebná trúba stále vyhrávala v ktoromsi kúte prázdneho priestoru môjho mozgu .	vyhrávala	3	Pos
Pripomínal jej trochu Teklu a chcela rýchlo odletieť .	chcela	5	Pos
U dovážaných produktov zabezpečí elimináciu tých , ktoré nespĺňajú kritériá kvality a ktoré neprešli colným a daňovým vysporiadaním .	nespĺňajú	8	Neg
Nezavelil však na ústup , ale poslal dopredu ďalších zubáčov .	Nezavelil	0	Neg
“ Neďakujte .	Neďakujte	1	Neg
Pod rokom 1092 sa nachádza zmienka o „ polockom zázraku “ .	nachádza	4	Pos
Nepýtam sa , či len so mnou .	Nepýtam	0	Neg
Máme spoločnú príležitosť napísať vynikajúcu kapitolu slovenských dejín .	napísať	3	Pos
“ Mhm , nehovorte tak , “ namietal lúčny koník Flip .	nehovorte	3	Neg
Globalizácia nevznikla sama od seba a nevznikla ani náhodou .	nevznikla	1	Neg
Netušili však , akí je múdry !	Netušili	0	Neg
Publikáciu napísal známy český novinár a publicista Miloš Čermák .	napísal	1	Pos
V ten deň som sa ho nedozvedel , lebo dievčatko ku mne opäť zaujalo nepriateľský postoj drobnej šelmy .	nedozvedel	6	Neg
Nemám z toho dobrý pocit .	Nemám	0	Neg
Jediný , kto mohol niečo také urobiť , bol Tom .	urobiť	6	Pos
Veronika sa najprv urazila , ale keď jej Ferdo vysvetlil , že rehotanie je taká zvláštna psia choroba , trochu sa upokojila .	upokojila	21	Pos
Hoci sme to nechceli !	nechceli	3	Neg
Rodičom sa však taký vývoj udalostí nepáčil a zišli sa na porade .	nepáčil	6	Neg
Neprestal zvončeky trhať .	Neprestal	0	Neg
Neveril som vlastným ušiam .	Neveril	0	Neg
Vrátila sa za svitania a hneď si ľahla .	Vrátila	0	Pos
“ Nemôžem sa správať , ako ty chceš ! “ kričala som zachrípnuto .	Nemôžem	1	Neg
Strážca prižmúril oči a poobzeral sa dookola .	poobzeral	4	Pos
Vedela som , že obaja túžime , aby táto čarovná noc trvala večne .	Vedela	0	Pos
Ale mama na mňa vôbec nemyslela .	nemyslela	5	Neg
Neodpovedala mi .	Neodpovedala	0	Neg
No kým si Aladin stačil odhryznúť , čosi ho zaujalo .	stačil	4	Pos
Toto dielo vznikalo postupne od konca 10 storočia do počiatku storočia 12 .	vznikalo	2	Pos
Gaston od úžasu onemel , keď uvidel , ako Bela cvála na koni cez kamenný most .	onemel	3	Pos
Pripomínala mi nejakú literárnu hrdinku .	Pripomínala	0	Pos
Ak sa neponáhľate , počkajte chvíľu . “	neponáhľate	2	Neg
“ Ubezpečujem vás , že nič nehrozí , “ kričal žene sultánov hlavný vezír Džafar .	nehrozí	6	Neg
“ Veď ti vravím , “ odvetil Balú .	odvetil	6	Pos
Ja som zaujímal svoj výklenok , ona prichádzala po mne .	zaujímal	2	Pos
Jedného dňa sochu odtiaľ strhol dav , ktorý rozzúrilo jej namyslené povýšenectvo .	strhol	4	Pos
Drobné štuchnutie však Balúa netrápilo .	netrápilo	4	Neg
Im všetkým však patrí moja srdečná vďaka .	patrí	3	Pos
Porozprával mu o svojom sne , v ktorom sa mal stať hrdinom , a požiadal učiteľa , nech mu pomôže .	pomôže	19	Pos
Mamka o tom nechcela ani počuť .	nechcela	3	Neg
Krist , nenamáhaj sa , nepoučuj ma o tom , o čom ma stará mama poučila už dávno ‐ pradávno .	nenamáhaj	2	Neg
S hrdinským úsmevom povedala , že uvíta každú kritickú pripomienku , lebo doteraz jej nikto nič konkrétne nepovedal .	nepovedal	17	Neg
V podstate som nedúfala , že príde , no keď som ho zbadala na opačnom konci preplnenej a zadymenej telocvične , myslela som si , že sa mi marí .	nedúfala	3	Neg
Možno moje postavy vedia hrať šach .	vedia	3	Pos
Ako možno komunikovať s budúcnosťou ?	komunikovať	2	Pos
" Neviem .	Neviem	1	Neg
Nevidel som nič , nikto ma nesledoval .	Nevidel	0	Neg
Ja som nehľadal Istanbul ani bývalé hlavné mesto nejakej inej ríše .	nehľadal	2	Neg
Nečakal som nijaké telefonáty .	Nečakal	0	Neg
Chris je najrýchlejší plavec v Delfíne , ale rekord v prsiach doteraz neprekonal .	neprekonal	12	Neg
“ Ja teraz veľmi rada lietam , “ povedala Maja .	lietam	5	Pos
Okamžite som súhlasil .	súhlasil	2	Pos
Trápilo ma niečo iné : musím zvíťaziť nad zvieraťom , ktoré sa vo mne prebudilo .	Trápilo	0	Pos
Ani v ten deň , ani neskôr si neželala , aby som použil prezervatív .	neželala	8	Neg
Vyzerajú ako šťastná dvojica ! “ zvolala prekvapená Sandra .	zvolala	6	Pos
Vrátil som sa a znovu som si sadol k stolu .	sadol	7	Pos
Pomyslel na obrazovku s uchom , ktorá nikdy neusne .	neusne	8	Neg
Je to celá svorka , oči im žiaria v tme .	žiaria	7	Pos
Hmotný svet existuje , jeho zákony sa nemenia .	nemenia	7	Neg
“ To bude naše tajomstvo , nikomu ho neprezradíme . “	neprezradíme	8	Neg
Siahol do mešca a vybral z neho za hrsť zlatých mincí .	Siahol	0	Pos
“ Dúfam , že získam štipendium na niektorú vysokú školu , “ vyhlásila som , ale nespomenula som , že by som chcela ísť na menšiu , no o to prestížnejšiu univerzitu .	nespomenula	16	Neg
Vietor hvízdal v konároch a trápil sporadické , ufúľané krókusy .	hvízdal	1	Pos
Nedbal na to , že sa ocitol v nebezpečnej blízkosti kravského chvosta .	Nedbal	0	Neg
“ Počkajte .	Počkajte	1	Pos
Usmiala som sa na Chrisa .	Usmiala	0	Pos
Bol som v jeho pracovni , mal som v sebe nerozumnú dávku alkoholu a čakal som , že všetko sa definitívne vyjasní a ja odídem .	vyjasní	21	Pos
Niekoľkokrát ho už videla z bezpečnej vzdialenosti , ale nikdy sa neodvážila k nemu priblížiť .	neodvážila	11	Neg
Abu síce nevedel čítať , no páčili sa mu obrázky .	nevedel	2	Neg
Ale oni nič nerobili ani nehovorili .	nerobili	3	Neg
Nemôžete ho minúť . “	Nemôžete	0	Neg
Abuov citlivý noštek vykrúcalo od najodpornejších pachov a jeho jemné ušká urážalo nedôstojné pokrikovanie .	urážalo	11	Pos
Mama sa zrejme nemohla utešiť tým , že jej otcovi zostalo meno .	zostalo	10	Pos
Niet pochýb , že mi ju poslala do cesty prozreteľnosť .	Niet	0	Neg
Irma neuverí rozprávkam , vyľaká sa .	vyľaká	4	Pos
“ To nič , “ odvetila som , ale pripúšťam , že som bola sklamaná .	pripúšťam	9	Pos
Neobjavil sa nijaký strážnik .	Neobjavil	0	Neg
Videla som ju zopár ráz na plaveckých pretekoch , lenže nikdy nás nikto nepredstavil .	nepredstavil	13	Neg
Môžem ti hovoriť Jaz ? “	hovoriť	2	Pos
A hneď volala motýľa Emanuela , aby ju tam v noci nenechával .	nenechával	11	Neg
Hrali sa s Efrou a Ahmadom .	Hrali	0	Pos
V tej izbe bývalo predo mnou niekoľko brigádnikov z mesta , predstaviteľov robotníckej triedy .	bývalo	3	Pos
Nemohla som tú otázku zodpovedať ani pánu Tayerlemu , ani sebe .	Nemohla	0	Neg
Gaston bol presvedčený , že tentoraz nevyviazne so zdravou kožou .	nevyviazne	6	Neg
Kov ma príjemne chladil .	chladil	3	Pos
Nik neprehovoril .	neprehovoril	1	Neg
Nedal sa zastaviť , vraj si ju hneď musí vyskúšať .	Nedal	0	Neg
Nerúhajme sa Bohu a nereptajme na všetko a všetkých .	Nerúhajme	0	Neg
Radšej zmiznem .	zmiznem	1	Pos
“ Daj im pokoj ! “ skríkol Aladin .	Daj	1	Pos
Nevznikla sama od seba , jej náväznosť na vierouku z desiateho storočia / i keď došlo k zrejmým posunom / svedčí o kontinuite jej vývoja .	Nevznikla	0	Neg
Keď sa raz rozhodla piecť v takú nezvyčajnú hodinu , nikto jej v tom nezabráni .	nezabráni	14	Neg
Pomaly vstala a po niekoľkých knísavých krokoch zasa našla rovnováhu .	našla	8	Pos
Nemala inú možnosť , keď jej Roger odmietol šteniatka predať .	Nemala	0	Neg
“ Presne , “ povedala a zadívala sa na mňa .	zadívala	6	Pos
Potom zostával na noc aj inokedy .	zostával	1	Pos
Maja sa však nedala odradiť .	odradiť	4	Pos
Maja sa rozletela po rýchlu zdravotnú pomoc .	rozletela	2	Pos
Ani jeden návrh ma nechytil za srdce .	nechytil	4	Neg
Rovnakého problému sa týka i posledný z ostrihomských kánonov , ktorý sa venuje vlastnému ordinačnému právu .	venuje	12	Pos
Ich bojový pokrik prilákal spústu divákov .	prilákal	3	Pos
Nechýbali vrúcne kontakty , dlhé lúčenie a pozvanie na ďalšie stretnutie .	Nechýbali	0	Neg
Ak nevyjde , nemáme dôvod stretnúť sa .	nemáme	3	Neg
Povedal som mu , že v tú noc som neodišiel z zürišského letiska .	neodišiel	9	Neg
Chris šliapal vodu a ako psík krúžil okolo mňa .	šliapal	1	Pos
Nevieme , kde v tú noc odišiel .	Nevieme	0	Neg
Niečo , čo by nevydesilo Lavdima Lavdoshaja .	nevydesilo	4	Neg
Bála som sa , že mi povie , že ich chytil , keď sa milovali .	milovali	14	Pos
“ Nemal si ho vyhnať , “ povedal Flip .	Nemal	1	Neg
Na chodbe som nepočul nijaké zvuky .	nepočul	3	Neg
Nahlas vykríkla od bolesti .	vykríkla	1	Pos
Keď vystúpila z pásma žltkastého svitu a na chvíľu zastala na rozhraní medzi svetlom a temnotou , nemyslel som na to , že ide priamo ku mne , aby napravila chybnú interpretáciu vecí , ktorú vyprodukoval môj mozog .	nemyslel	17	Neg
Úľ sa vzďaľoval a jej sa zdalo , akoby pod ňou utekala zem .	utekala	11	Pos
Ale nevieš si predstaviť , kde som .	nevieš	1	Neg
A neutekala som otvoriť .	neutekala	1	Neg
Ministerstvo lásky nemalo okná .	nemalo	2	Neg
Zhíkla som a uhla sa , takže namiesto môjho líca Rick druhý raz pobozkal vzduch .	pobozkal	13	Pos
V podstate som nedúfala , že príde , no keď som ho zbadala na opačnom konci preplnenej a zadymenej telocvične , myslela som si , že sa mi marí .	zbadala	12	Pos
S takým nátreskom nerátal .	nerátal	3	Neg
Vďaka týmto skúsenostiam pre mňa teoreticky neexistovalo nijaké tajomstvo súvisiace s túžbami , ktoré nútia muža pokúšať sa o zblíženie so ženou .	pokúšať	16	Pos
V izbe podo mnou spával Profesor , oddeľovala nás iba tenká dosková podlaha .	spával	4	Pos
Nepovedal som jej to .	Nepovedal	0	Neg
Mama zdvihla hlavu a ja som uvidela jej vystrašenú tvár .	uvidela	6	Pos
" Možno som sa nevyjadril celkom presne , " poznamenal .	poznamenal	9	Pos
Už dávno sa s nimi nehrám , ale ani vo sne by mi nenapadlo , aby som ich vyhodila .	nehrám	5	Neg
Takých ľudí Strana neobľubuje .	neobľubuje	3	Neg
Zrazu Jazmína zastala s otvorenými ústami .	zastala	2	Pos
Nevidieť tú reláciu , povedal by som spolu s Freudom , že za všetkým je sexuálne pudenie , ale tých dvadsať minút mi otvorilo oči .	otvorilo	23	Pos
Keďže mu nechceli odpovedať na otázku , Hádes sa uchýlil k lichôtkam .	nechceli	2	Neg
“ Nechodím s Rickom .	Nechodím	1	Neg
Maja si už netrúfla nič navrhnúť .	netrúfla	3	Neg
Ručička vyskočila na šesťdesiat .	vyskočila	1	Pos
A veselili sa , kým nezapadlo slnko .	nezapadlo	5	Neg
Ja som očakával , že tú poviedku neuverejnia .	neuverejnia	7	Neg
Chcel vzlietnuť do vzduchu , ale zamotal sa do krídel fraku .	vzlietnuť	1	Pos
“ Nič sa nestalo , “ odpovedala som hanblivo .	nestalo	3	Neg
Menšie rozmery potešia pri balení .	potešia	2	Pos
Hádes nemohol pokojne spávať , kým sa nepresvedčil , že tvoj otec je mŕtvy .	nemohol	1	Neg
Neodvážil som sa pohnúť , zdvihnúť ruky , odpovedať na Lorino objatie .	Neodvážil	0	Neg
Pravovernosť znamená nemyslieť -- nepotrebovať myslieť .	nemyslieť	2	Neg
Prebehli sme okolo nich a prešmykli sa dozadu k dvojmetrovému múru .	Prebehli	0	Pos
“ Zaklopal som Amy na okno .	Zaklopal	1	Pos
Nevyhýbali sme sa ani politike .	Nevyhýbali	0	Neg
Chvíľu sme stáli vo dverách , pretože nás ovalil svieži závan klimatizovaného vzduchu .	stáli	2	Pos
Si škvrna , ktorú treba zotrieť .	zotrieť	5	Pos
Uteč ! “ kričal .	kričal	3	Pos
Nerob to ! “ zvolal Aladin .	Nerob	0	Neg
Iba my s Chrisom sme tak zúrivo nepísali a nehrbili sa nad lavicami .	nehrbili	9	Neg
Jeho ruka potajomky vkĺzla do čižmy .	vkĺzla	3	Pos
Na čistinke neostal ani jedinký .	neostal	2	Neg
“ Keby som nevedela , že máte bezpečnostný systém , “ doberala som si Chrisa , “ preliezla by som plot a skočila dnu . “	nevedela	3	Neg
Vlak bol plný proletov so sviatočnou náladou , ktorú v každom vyvolávalo letné počasie .	vyvolávalo	11	Pos
Jedno však bolo isté : smrť nikdy nepríde v očakávanú chvíľu .	nepríde	7	Neg
Ilúzia takejto taktiky netrvala dlho .	netrvala	3	Neg
Tie ostatné názvy mi príliš " nerežú " , ale videl som ich používať .	nerežú	6	Neg
Z toho človeka nevravel mozog , ale hrtan .	nevravel	3	Neg
Postrehla , že má akési čudné topánky , vraj ešte nikdy predtým také topánky nevidela .	nevidela	14	Neg
“ Chcela by som , aby ste mi vyveštili budúcnosť , ale nemám veľa peňazí . “	nemám	12	Neg
Nestrácal som čas a priložil som oko k škáre v podlahovej doske .	Nestrácal	0	Neg
Všetky formality vytrvalo vybavila naša kurátorka Justína Petrová , ktorá v tomto smere nepozná prekážky .	nepozná	13	Neg
Pokračovali sme v pití mlčky , sediac proti sebe .	sediac	6	Pos
Za to , že som neprehltol spomenutú návnadu , nevďačím nijakej inteligencii .	nevďačím	9	Neg
Napokon usúdil , že najbezpečnejším miestom je kantína .	usúdil	1	Pos
Ako som vychádzala zo školy , zbadala so , že sedí na trávniku pri zastávke môjho autobusu .	zbadala	6	Pos
Čarodejnica odhrnula vejúci plášť a dobré víly onemeli od hrôzy , keď zbadali Zorničku .	zbadali	12	Pos
“ Nemôžem !	Nemôžem	1	Neg
Netešíš sa , že žiješ ?	Netešíš	0	Neg
I keď sa Maja ukrutne bála , nesmierne sa rozčúlila .	bála	5	Pos
Často sa pokúšam nájsť nejaké vysvetlenie , prečo som ju vtedy nenávidela .	pokúšam	2	Pos
“ Ďakujem , “ povedala som , lebo nič lepšie mi nenapadlo .	nenapadlo	11	Neg
Čierna tma ustupovala pred sivastým svetlom .	ustupovala	2	Pos
" Nechoď na voľné priestranstvo !	Nechoď	1	Neg
Nikto mu nevenoval pozornosť .	nevenoval	2	Neg
Podľa jej interpretácie sa otočila chrbtom kvôli mne .	otočila	4	Pos
Žiadne z nich nevykazujú nejaké reformné vplyvy .	nevykazujú	3	Neg
Práve som ležala na pohovke .	ležala	2	Pos
Zrejme mala akúsi praktickú ostrieľanosť , ktorá Winstonovi chýbala a podľa všetkého vďaka nespočítateľným spoločenským výletom výborne poznala okolie Londýna .	poznala	17	Pos
Nenatrafili na nikoho , koho by sa mohli opýtať na cestu .	Nenatrafili	0	Neg
Isteže , už dnes nejestvuje dôvod či opodstatnenie na páchanie ideozločinov .	nejestvuje	4	Neg
Na plece mu zľahka doľahla čiasi ruka .	doľahla	4	Pos
Našťastie sa nemusím veľmi rozpisovať , lebo Hysteria Pub má svoju webovú stránku .	rozpisovať	4	Pos
Winston neodvetil .	neodvetil	1	Neg
Bolo to beznádejné , nedokázal sa zdvihnúť ani o centimeter .	nedokázal	4	Neg
Sexuálne puritánstvo Strany im nikto nevnútil .	nevnútil	5	Neg
Krútili hlavou .	Krútili	0	Pos
Odporná extáza strachu a pomstychtivosti , túžba zabíjať , mučiť , drúzgať tváre kováčskym mlátom akoby preskočila sťa elektrický prúd na všetkých a premenila každého aj proti jeho vôli na vrieskajúceho pomätenca s pokrivenou tvárou .	preskočila	16	Pos
“ A ty si mu to veľmi neuľahčil . “	neuľahčil	7	Neg
Soni ma prosila , aby som nerobil hlúposti .	prosila	2	Pos
Vláda sa zároveň zaväzuje presadiť v zdravotníctve tvrdé rozpočtové obmedzenie tak , aby od roku 2004 nedochádzalo k tvorbe nového dlhu .	nedochádzalo	16	Neg
“ Tak , čo mi na to povieš ? “ spustil na Vilka .	spustil	10	Pos
Vietor silnel a v ďatelinových hlavičkách nebezpečne zašumelo .	zašumelo	7	Pos
Beztak tie pracovité mravce nemohol ani cítiť .	nemohol	4	Neg
Chcel som poprosiť aj redaktorku , aby už nevyužívala repliky mojich postáv .	nevyužívala	8	Neg
Nesklamte Ho .	Nesklamte	0	Neg
Chrisova mama zabalila chlebíčky po štyroch do plastovej fólie a ešte do alobalu .	zabalila	2	Pos
Hmotný svet existuje , jeho zákony sa nemenia .	existuje	2	Pos
“ Ja som vedel , že som niečo zabudol ! “ zvolal a neodolateľne sa usmial .	zvolal	11	Pos
Dieťa rodičov Vnútornej strany sa nenarodilo do Vnútornej strany .	nenarodilo	5	Neg
Tarzan nechápal .	nechápal	1	Neg
Niet pochýb , v hlave mám zmätok .	Niet	0	Neg
“ Hádam mi nechceš tvrdiť , že nezáleží na výsledkoch .	nezáleží	7	Neg
“ Nehnevám sa , “ odvetila Makulienka .	Nehnevám	1	Neg
“ Môjmu kráľovskému uchu sa donieslo , že chceš ostať v džungli . “	chceš	8	Pos
Marga nechcela , aby sme zobudili Irmu .	zobudili	5	Pos
Vždy môže niektorá z tých sviní identifikovať tvoj hlas .	identifikovať	6	Pos
Soni nedodržala našu dohodu , nenapísala nič .	nenapísala	5	Neg
Ferdo z toho usúdil , že bývalí otrokári nevedia ani písať .	nevedia	8	Neg
Anita jej to sľúbila a zložila .	sľúbila	3	Pos
V popoludňajšej tíši prekvapovala hlasitosť jeho zvuku .	prekvapovala	3	Pos
Winston nevedel , prečo Withers upadol do nemilosti .	nevedel	1	Neg
Vtom sa dieťa rozkričalo a prekvapený Baghíra uskočil .	uskočil	7	Pos
Mešťania sa nazlostili a upozornili Herkulovho otca , nech ho viac do mesta nepúšťa .	nepúšťa	13	Neg
Hubert však nechodil .	nechodil	2	Neg
Napokon zvíťazila láska .	zvíťazila	1	Pos
Nová však bola energia , s akou tieto požiadavky nastoľovali a nová bola aj prísnosť trestov za nerešpektovanie týchto požiadaviek .	nastoľovali	9	Pos
Nezvoň , mama bude spať .	Nezvoň	0	Neg
Ale ja som bol zmätený a nedokázal som reagovať .	nedokázal	6	Neg
Preto predpokladáme , že žili pomerne izolovane od ostatného uhorského mníšstva .	predpokladáme	1	Pos
Ale oni nič nerobili ani nehovorili .	nehovorili	5	Neg
Terk neverila vlastným očiam .	neverila	1	Neg
Keďže kníh , ktoré mi zostali , nebolo ktovieako veľa , vrece bude ťažšie , ak pridám rukopisy svojich scenárov .	nebolo	7	Neg
Skúsil som sa rozpomenúť na jej tvár .	rozpomenúť	3	Pos
Ale nikto sa neodhodlal spustiť posmešky .	neodhodlal	3	Neg
Nemalo zelené oči .	Nemalo	0	Neg
“ Takto to vyzerá na Mesiaci , “ povedala som Cheryl Wagnerovej , maturantke , čo sedela vedľa mňa .	sedela	16	Pos
Nebežal tadiaľto kôň ? “ kričal som na motýle .	Nebežal	0	Neg
Pomyslel som si , že žartuje .	Pomyslel	0	Pos
Nečakal som , že ju moje slová až tak rozosmejú .	Nečakal	0	Neg
Na druhý deň som zistil , že ležím celkom oblečený na skladacej posteli .	ležím	7	Pos
Nič lepšie robiť nemohol .	nemohol	3	Neg
Vláda prehodnotí platné znenie zákona o sociálnom poistení ešte pred nadobudnutím jeho účinnosti .	prehodnotí	1	Pos
V Gregorovom ponímaní by to znamenalo komendovanie Uhorska sv . Petrovi , ktorého nástupca by vládcovi krajiny udelil kráľovskú korunu .	znamenalo	5	Pos
“ Ty žartuješ , “ zvolala som a prekvapene vyvalila oči .	vyvalila	9	Pos
Bál som sa , že moji rodičia sa namiesto toho , aby ma bránili , postavia na stranu útočníka .	Bál	0	Pos
Zaspíš , kým sa dopečie , “ vyhlásila som neisto .	Zaspíš	0	Pos
I Hanibal si to všimol , a preto vzal pred ňou nohy na plecia .	vzal	8	Pos
“ Dobre , “ súhlasil .	súhlasil	4	Pos
“ A to hovoríš ty ! “ zvolala som .	hovoríš	3	Pos
Videli ste už také nohavičky ?	Videli	0	Pos
Rozbúchalo sa mi srdce .	Rozbúchalo	0	Pos
“ Ďakujem , pani Hutchinsonová , “ odvetila som naradostene .	odvetila	7	Pos
A musel som niečo vymyslieť , aby mi nezalietala k Lori .	nezalietala	8	Neg
Chcel som tej rieke zabrániť , aby vyrazila von , bolo to však nemožné .	vyrazila	7	Pos
“ Vidím , že nič neviete o našom žartíku .	neviete	5	Neg
Veľa čítal , niekedy aj písal .	čítal	1	Pos
Raz som chytil muchu a vlastnoručne som ju hodil do pavučiny , ale nevidel som , že by sa objavil nejaký pavúk , ktorý by ju zožral .	nevidel	13	Neg
Stále padal hustý sneh s veľkými vločkami .	padal	1	Pos
Lenže oni neznesú , aby sa človek cítil takto .	neznesú	2	Neg
Marga nereagovala , takže to bol iba sluchový klam .	nereagovala	1	Neg
“ Vstávaj ! “	Vstávaj	1	Pos
Chcel som jej povedať , že to mesto poznám .	poznám	8	Pos
Neboj sa . “	Neboj	0	Neg
Začiatkom 11 storočia bolo pomerne málo významným sídlom — nespomína sa napr . pri delení údelov Vladimírovým synom .	nespomína	9	Neg
“ Toľko peňazí neminiem na oblečenie za celý rok . “	neminiem	3	Neg
Strhla sa búrka	Strhla	0	Pos
Od ľaku som nevládal vyriecť slova .	nevládal	3	Neg
V oblasti prepravných povolení v cestnej doprave sa realizuje nový transparentný systém založený na princípe nárokovosti pri splnení požadovaných kritérií a podmienok	realizuje	8	Pos
V niekoľkých sekundách po prebudení sen i spomienka , ktorá ho podnietila , splynuli v jeho mysli v jedno .	podnietila	11	Pos
Variant , že pôjdem po žobraní , sa mi nepáčil .	nepáčil	9	Neg
Nikto ma nepočúval .	nepočúval	2	Neg
Toľko peňazí som ešte nevidel . “	nevidel	4	Neg
Len čo sa jej dotkol , myklo ňou a akoby zmeravela .	dotkol	4	Pos
Zaslané médium vám vrátime spolu s vyvolanými fotkami .	vrátime	3	Pos
Ohrozené boli mestá Brazzaville a Leopoldville . Človek sa nepotreboval pozrieť na mapu , aby vedel , čo to znamená .	nepotreboval	9	Neg
Stiahol ju nadol , takže kľačali tvárou v tvár .	kľačali	5	Pos
Vtedy víly pochopili , že je načase , aby dievčine povedali pravdu .	povedali	10	Pos
Pretože bolo kakarátky , nepohádali sa , ale išli spolu na zmrzlinu .	nepohádali	4	Neg
Hrozne mi chýbal a pocítila som priam fyzickú bolesť .	pocítila	4	Pos
Do nášho podvedomia pomaly a nenápadne ukladá hrdzu , ktorá ukradomky rozožiera našu psychiku .	rozožiera	11	Pos
Irma neuverí rozprávkam , vyľaká sa .	neuverí	1	Neg
Cítila som , ako sa mi do hlavy hrnie krv .	Cítila	0	Pos
Blythe sa však nesmiala .	nesmiala	3	Neg
V tých miestach sa nikdy neobjavili divé kačice .	neobjavili	5	Neg
Už tretíkrát sme sa mohli stretnúť na neformálnej úrovni a prebrať pálčivé problémy , s ktorými sa stretávame na chodbách našej školy .	stretnúť	5	Pos
Nerob zo seba hlupáka , povedali mi .	Nerob	0	Neg
Nespýtala som sa ho to .	Nespýtala	0	Neg
Zarazil som sa .	Zarazil	0	Pos
Východ na Bielej hore mal však splniť iný cieľ , ale nepredbiehajme .	nepredbiehajme	11	Neg
Straníčky sa nikdy nefarbili .	nefarbili	3	Neg
“ Máš žalúdočné problémy , Amy ? “ spýtala sa Jill s predstieraným záujmom .	Máš	1	Pos
Keď prišla k vile , vyhodila som tranzistor z obloka .	vyhodila	5	Pos
Nikto ma nikam nepredvolal .	nepredvolal	3	Neg
“ Viem , “ povedala som a vystúpila z auta , “ ale ak budem myslieť len na zábavu , môžem ísť zametať chodníky . “	môžem	20	Pos
Smutným hlasom im Kasandra oznámila , že v noci navšítvili komoru s medom zlodeji a spôsobili im veľkú škodu .	spôsobili	15	Pos
Odborným prekladom z nemeckého jazyka nám poslúžil Mikuláš Lipták .	poslúžil	6	Pos
Nehovoriac o tom , že popoludní mávala stále program , chodila na súkromné hodiny angličtiny .	Nehovoriac	0	Neg
Vôbec som im neprotirečil , postupoval som podľa inej taktiky .	neprotirečil	3	Neg
Nie , táto zvláštna myšlienka nikdy Winstonovi na um nezišla .	nezišla	9	Neg
" Niekedy to , samozrejme , neplatí .	neplatí	6	Neg
Nevidel som nič , nikto ma nesledoval .	nesledoval	6	Neg
Vtedy som sa naposledy ocitol tak blízko neho .	ocitol	4	Pos
“ Choď domov ! “ zašepkala som zúfalo .	zašepkala	5	Pos
Nikdy nepočula o Bratstve a odmietala veriť v jeho existenciu .	nepočula	1	Neg
Prešlo niekoľko dní a princezná ani len nepomyslela na návrat domov .	nepomyslela	7	Neg
Určite bol nervózny , lebo hlas mu v tej krátkej vete preskočil do fistuly ako rozladené rádio .	preskočil	11	Pos
“ Herkules nám dal niečo , čo sme obaja stratili .	stratili	9	Pos
Usadila sa na leknovom liste a začala sa umývať .	Usadila	0	Pos
Do cely vošiel Parsons .	vošiel	2	Pos
Uprostred noci sa zobudila , čo sa jej nikdy nestalo .	nestalo	9	Neg
Nebojme sa klásť otázky , pýtať sa a odpovede hľadať v Písme .	Nebojme	0	Neg
Nechýbal nik .	Nechýbal	0	Neg
Veruže neostala .	neostala	1	Neg
“ Nezistia to , “ odvetila Flóra .	Nezistia	1	Neg
“ Nie ! “ ozval sa odkiaľsi zdola vzdialený hlas .	ozval	4	Pos
Ako šesťročného ( o rok skôr , než bolo zvykom ) ho na základe zvláštnej výnimky prijali medzi Zvedov a ako deväťročný sa stal vedúcim skupiny .	prijali	16	Pos
Nikto z nich nevie nič o mojom ruskom dobrodružstve .	nevie	3	Neg
Nijaká dvojica nevstávala , že pôjde tancovať , plač toho dievčaťa pokazil atmosféru .	nevstávala	2	Neg
Aj Maja so škriatkom opustili topoľ a leteli , kým nedoleteli k domu , kde sa v oknách ešte svietilo .	nedoleteli	10	Neg
Pokiaľ ide o vši , veľmi sa netráp .	netráp	7	Neg
Ak nenájde dievča samo , nebude to mať zmysel .	nenájde	1	Neg
Maja sa zamyslela .	zamyslela	2	Pos
Pomôžu vám vyniesť nahor veci , povedal Cerberus a podal ten kľúč mame .	Pomôžu	0	Pos
Naozaj stenám , ale ty si to , preboha , poriadne zveličil .	zveličil	11	Pos
Vstal som a vyšiel von .	Vstal	0	Pos
Neviem , či na mňa viac zapôsobila skutočnosť , že môjho starého otca zabili , alebo meno Hádes , ktoré náš hosť ticho precedil cez zuby .	Neviem	0	Neg
Flip zívol .	zívol	1	Pos
Na otca sa nepamätám .	nepamätám	3	Neg
Delina nebola v Tirane , už dostala umiestenku do profesionálneho divadla v meste Fier .	nebola	1	Neg
Nemohli sme k nej chodievať , ani ona nemohla chodievať k nám .	Nemohli	0	Neg
Nepatrí teda k spomenutému typu „ poľnohospodárskych miest “ .	Nepatrí	0	Neg
Tarzan skočil vrčiac ako leopard a vyrušil rodinu .	vrčiac	2	Pos
V uplynulých rokoch ukázalo silný vzťah k demokratickým hodnotám a silu riešiť mnohé problémy .	ukázalo	3	Pos
Počul , ako sľubuje klamať , kradnúť , falšovať , vraždiť , rozširovať drogy , prostitúciu , a pohlavné choroby , liať deťom vitriol do tváre .	Počul	0	Pos
“ Nemaj strachy .	Nemaj	1	Neg
Otvorila som okno a zazrela na Chrisa .	Otvorila	0	Pos
“ Tak predsa ste sa bozkávali ! “ zvolala .	bozkávali	5	Pos
Vystrela som sa a poďakovala mu .	Vystrela	0	Pos
“ Čo tu tak príšerne smrdí ? “ čudovala sa Maja .	čudovala	8	Pos
Abu naňho pozrel .	pozrel	2	Pos
“ Nejdeme domov , “ odvetil Baghíra .	odvetil	5	Pos
Neskôrnateli vnútorne .	Neskôrnateli	0	Neg
Hrozne ma bolia kĺby a nestihla som spojenie . “	nestihla	5	Neg
Zavedieme stanovenie základných štandardov na financovanie a kvalitu sociálnych služieb , systém udeľovania licencií a kontroly , zrovnoprávnenie pre všetky inštitúcie poskytujúce sociálne služby .	Zavedieme	0	Pos
Išli sme za školu , kde – trochu vyššie – vyvieral prameň , ktorý tam vymlel priehlbinu .	Išli	0	Pos
Nadýchol sa a písal ďalej .	Nadýchol	0	Pos
Ona ustúpila dozadu , otočila sa mu chrbtom , ale ten chlap zostal pri zástupe žien .	otočila	4	Pos
Utekala som , čo mi nohy stačili .	stačili	6	Pos
Kora tam nebola .	nebola	2	Neg
Nemala som najmenšiu chuť rozoberať pred ním svoje zmätené pocity a zbabraný test .	Nemala	0	Neg
Ak jej dovolím odísť , už ju neuvidím .	neuvidím	7	Neg
“ Ty nerozumieš , “ zašepkala Jazmína .	nerozumieš	2	Neg
Grazie all ' America , ' ' kričal z pódia nadšený Benigni .	kričal	7	Pos
Všetky ďalšie uhorské právne normy , ktoré reglementujú život kláštorných spoločenstiev nachádzame potom až medzi kánonmi I . ostrihomskej synody .	nachádzame	11	Pos
Nijaký taký papier neexistoval .	neexistoval	3	Neg
V prvých troch kapitolách sa teda pokúsime o prieskum problematiky v celoruskom rámci , odhliadnuc od jemnejších miestnych odlišností .	odhliadnuc	14	Pos
Trochu sa zľakla , no pozrela hore .	zľakla	2	Pos
Ponúka nám niečo , čo nepotrebujeme .	nepotrebujeme	5	Neg
Nedávalo to zmysel .	Nedávalo	0	Neg
Nebudete poznať kamarátstvo , nebude mať čo vás povzbudiť .	poznať	1	Pos
“ Daj pokoj môjmu mláďaťu ! “ zreval .	Daj	1	Pos
Chvíľu sme stáli vo dverách , pretože nás ovalil svieži závan klimatizovaného vzduchu .	ovalil	8	Pos
Výsledkom bude , že v nijakej oblasti sa nespotrebuje viac zdrojov , ako na ňu bude vyčlenených v rozpočtoch , ktoré schváli NR SR , resp . jednotlivé samosprávne orgány .	nespotrebuje	8	Neg
Napriek tomu som neodišla .	neodišla	3	Neg
" Ste pripravení obetovať svoje životy ? "	obetovať	3	Pos
Žije šťastne , nemá povinnosti a nič jej nechýba .	nechýba	8	Neg
Oči ma neklamali .	neklamali	2	Neg
Nikdy by jej nezišlo na um , že bezvýsledný čin nemá význam .	nezišlo	3	Neg
Napokon vstal , tackavo a hojdavo prešiel celou , hlboko ponoril ruku do vrecka na kombinéze a s rozpačitým výrazom podal mužovi s umrlčou tvárou ufúľaný kúsok chleba .	prešiel	6	Pos
Publikum nevie , či sa má smiať alebo plakať , ale napokon sa rozosmeje .	rozosmeje	13	Pos
Netušila som , že počúvajú , ale zrazu všetci hýrili nápadmi .	Netušila	0	Neg
Potom sa otvorili dvere a vošla mamička .	vošla	5	Pos
S čím som mala súhlasiť ? “ nechápala som .	nechápala	7	Neg
Namáhavo som preglgla .	preglgla	2	Pos
Lulu tigra najprv prekvapene sledovala , ale po chvíli sa rozosmiala .	rozosmiala	10	Pos
No človek sa nevzdáva .	nevzdáva	3	Neg
Nesmieme strácať čas . “	Nesmieme	0	Neg
“ Nuž čo , na tom nezáleží .	nezáleží	6	Neg
Nechcela , aby sme jej nechali odkaz .	Nechcela	0	Neg
Môj otec po jeho rozpade niekoľko týždňov nespal . . .	nespal	7	Neg
Poskladali sme vlhkú deku , napchali ju do koša , ktorý sme pomaly uväzovali o korman .	napchali	5	Pos
Mal som pocit , že za známymi črtami tváre , ktorých som sa vo sne neraz dotýkal , sa skrýva akési tajomstvo .	Mal	0	Pos
Srdce mu v prsiach búchalo hrôzostrašne hlasito .	búchalo	4	Pos
Nedokázala som urobiť jedinú slušnú obrátku .	Nedokázala	0	Neg
Zlej víle ostávala posledná nádej — havran .	ostávala	2	Pos
Pravdepodobne sa napokon nevyrobili vôbec nijaké topánky .	nevyrobili	3	Neg
Nešlo to .	Nešlo	0	Neg
O chvíľu sa pri nej s hlasným bzučaním usadil komár .	usadil	8	Pos
“ Človek nikdy nevie , čo ako vypáli . “	nevie	3	Neg
Pozrela som na ňu a napravila som si zelenú košeľu , ktorú som si dala na rande .	Pozrela	0	Pos
Na jednom z programov Českej televízie sa momentálne dá vidieť skvelá séria ľahkých , avšak nebulvárnych reportáží zo života s názvom Ta naše povaha česká .	vidieť	9	Pos
Zároveň však Cluny urobilo veľký krok na ceste k libertas , lebo vytvorilo spoločenstvo ( zväčša ) úplne slobodných kláštorov , ktoré nepodliehali laikom .	nepodliehali	22	Neg
Šéf sa zo všetkých síl pokúšal , aby som odišiel z jeho pracovne spokojný , aj keď mi tú poviedku neuverejní .	neuverejní	20	Neg
Fajčila cigaretu a čítala noviny .	Fajčila	0	Pos
“ Ty žartuješ ? “ zvolal Balú .	zvolal	5	Pos
Svojim členom nikdy nepomáhame .	nepomáhame	3	Neg
Zasa sa ukáže slniečko .	ukáže	2	Pos
Oduševnenie nestačí .	nestačí	1	Neg
Snažila som sa potlačiť vzrušenie .	potlačiť	3	Pos
Formulácia „ Volumus , ut episcopi habeant potestatem . . . “ implikuje interpretáciu , že biskupi , vykonávali svoj úrad z vôle panovníka , že on im udeľoval mandát na reálne pôsobenie v ich úrade .	implikuje	12	Pos
“ Neviem si ťa v uniforme predstaviť , “ povedala som .	Neviem	1	Neg
Na stole ležala strieborná tabatierka .	ležala	2	Pos
“ Neviem , “ pripustila Jazmína .	Neviem	1	Neg
Zakrátko nevidela na cestu .	nevidela	1	Neg
“ Chceš si to vyskúšať ?	vyskúšať	4	Pos
Už dávno dostal prezývku podľa starovekého filozofa a už dávno si nikto nepamätal , ako sa skutočne volá .	nepamätal	12	Neg
Hefaistos kul rýchlo blesky , ktoré bohom slúžili ako zbrane .	slúžili	7	Pos
Pokým nevyprázdnili misky , ani jeden z nich už neprehovoril .	nevyprázdnili	1	Neg
Nikto sa mu nečuduje .	nečuduje	3	Neg
“ Vyzeráš , akoby si tu mysľou ani nebola . “	nebola	8	Neg
Svätojánska muška mala tenulinký hlások a Maja ju takmer nepočula .	nepočula	9	Neg
Na druhom konci linky som začul jej hlas .	začul	5	Pos
Spočiatku ich nepoužil .	nepoužil	2	Neg
V takých chvíľach to nemalo zmysel .	nemalo	4	Neg
Preto szabolcsská synoda schválila niekoľko kánonov , ktoré ich mali brániť pred takouto ujmou .	schválila	3	Pos
Nemám čas , “ odvrkla som .	Nemám	0	Neg
Nikdy predtým som nevidela živú korytnačku .	nevidela	3	Neg
Zdvihol pohár a obrátil ho do seba .	Zdvihol	0	Pos
Aby nás neobvinili z farizejstva .	neobvinili	2	Neg
Zámok sa zatriasol , keď dedinčania vrazili baranidlom do brány .	vrazili	6	Pos
Avšak hoci som sa strácal v tieni režisérov a hviezd filmového plátna , netrápil som sa .	netrápil	13	Neg
Ak Tichomirov vidí v povstaniach iba element sociálny , Frojanov na jeho úkor vyzdvihuje moment politický .	vidí	2	Pos
Vcelku ľutujem , že som to neurobil . "	neurobil	6	Neg
“ Roku 1543 , “ odvetil Chris a opäť sa venoval kresbe .	odvetil	5	Pos
Nič sme o sebe nevedeli .	nevedeli	4	Neg
Vláda bude klásť dôraz na racionalizáciu nákladov spojených s realizáciou výkonov vo verejnom záujme v železničnej osobnej doprave a verejnej autobusovej doprave .	klásť	2	Pos
Sporenie prostredníctvom individuálnych účtov vytvorí priestor , aby v budúcnosti o čase svojho odchodu do dôchodku mohol rozhodovať sám občan .	rozhodovať	17	Pos
Ale dlho ho potrebovať nebudeš , “ vraví pavúk Karkoško .	potrebovať	3	Pos
Vláda bude venovať pozornosť aj ďalším súčastiam slovenskej zahraničnej politiky , medzi ktoré patria viaceré oblasti dvojstrannej a mnohostrannej diplomacie , otázky ľudskej dimenzie , ekonomický rozmer diplomacie , optimalizácia zahraničnej služby .	venovať	2	Pos
Mal deravú pamäť a musel sa pýtať Maji .	pýtať	6	Pos
“ Chceš povedať , že s tým nemôžeš niečo urobiť ? “ pýtal sa zúfalý Herkules .	Chceš	1	Pos
Vedel dôvod . Šírila okolo seba atmosféru hokejového ihriska , studených kúpeľov , spoločného stopovania a akejsi všeobecnej čistoty mysle .	Vedel	0	Pos
Podarilo sa mu vyšklbnúť mu niekoľko pierok .	Podarilo	0	Pos
Ostatní sú mimo -- nezáleží na nich . "	nezáleží	4	Neg
Cítila som , že sa pohybujú , ako keby mi chceli prezradiť nejaké tajomstvo .	prezradiť	11	Pos
Tekla vychrlila niekoľko oplzlých pavúčich nadávok , ale na silného Chrabroša si netrúfla , a tak kľajúc zaliezla pod vädnúci list .	zaliezla	17	Pos
Pozná ju každý .	Pozná	0	Pos
Syreeta vyvesila oznam o Abuovom úteku a kto ho nájde , dostane odmenu .	nájde	9	Pos
Vtedy sa prítomným naskytol pohľad na Gimov obrovský penis .	naskytol	3	Pos
Keby som bol prehltol tú návnadu , moje postavy by ma boli priviedli do hrobu .	prehltol	3	Pos
“ To nemyslíte vážne ! “ rozhorčene zvolal Hanibal .	nemyslíte	2	Neg
u Martina nemám čo do zvonca .	nemám	2	Neg
Skláňal sa nad Winstonom .	Skláňal	0	Pos
Máme pre vás slávnu správu .	Máme	0	Pos
Možno som vôbec nič nepovedal .	nepovedal	4	Neg
Na lúke pred stromom sa ozývalo funenie a nejasné hlasy .	ozývalo	5	Pos
Steblo sa zlomilo a on skončil na chrbte .	skončil	5	Pos
Bláznovstvo , bláznovstvo , bláznovstvo , pomyslel si znovu .	pomyslel	6	Pos
Správal sa , akoby sa nič nestalo .	nestalo	6	Neg
A takisto dúfam , že neskôr nevidel ani film Hmla .	nevidel	6	Neg
Vtedy mohol klopať ktokoľvek , my sme neotvárali .	neotvárali	7	Neg
V prípade , že klerik žaluje laika , má sa spor prerokovať pred svetským sudcom .	prerokovať	11	Pos
Od tej chvíle som sa myšlienky , že tá mačka mi vidí do duše , nevedela zbaviť .	nevedela	15	Neg
“ Chcete povedať , že som herec ? “ pýtal sa Pinocchio .	pýtal	9	Pos
Winston sa zľahka poškrabal na nose sponkou na spisy .	poškrabal	3	Pos
Takto ten projekt naozaj nikdy nedokončím .	nedokončím	5	Neg
Syma vyparia .	vyparia	1	Pos
Nasledovali ďalšie veci , ktoré boli podľa Sergeja podpichovaním na Cerberovu adresu , hoci jeho meno sa tam nespomínalo .	nespomínalo	18	Neg
Túto zmenu nepredvídal ani anonym , ani ja sám .	nepredvídal	2	Neg
Gaston od úžasu onemel , keď uvidel , ako Bela cvála na koni cez kamenný most .	cvála	10	Pos
Podľa nich klerici sa nielenže nesmeli opíjať , ale mali aj povinnosť brániť veriacim v prehnanom požívaní opojných nápojov .	nesmeli	5	Neg
Nemohol som sa na nič sústrediť , nevládal som zniesť nikoho pri sebe : ani Margu , ani mamu , ani Toma .	nevládal	7	Neg
" Možno som sa nevyjadril celkom presne , " poznamenal .	nevyjadril	4	Neg
Z ich tiel nikdy nijaké dieťa nepovstane .	nepovstane	6	Neg
“ Čakám na teba , “ odvetil .	Čakám	1	Pos
“ Kam ideš ? “ spýtal sa Chris .	ideš	2	Pos
Najprv so mnou nechcela hovoriť .	nechcela	3	Neg
“ Prosím , ja uznávam , že Ferdo je jednotka .	uznávam	4	Pos
“ Ak ti na mne naozaj záleží , tak mi nerob zle !	nerob	10	Neg
Dieťa spokojne ležalo a nič nenaznačovalo , že sa vlci chystajú vyjsť z jaskyne .	nenaznačovalo	5	Neg
Iste chápete , že najprv vám musím položiť zopár otázok .	položiť	7	Pos
Ani v ten deň , ani neskôr som nepovedal kamarátom o návšteve , ktorá k nám prišla .	nepovedal	8	Neg
Každý hrob na cintoríne potvrdzuje istotu našej smrti a Božieho súdu .	potvrdzuje	4	Pos
V zásade príslušnosť k týmto trom skupinám sa nededí .	nededí	8	Neg
NASLEDUJÚCI TÝŽDEŇ som sa Chrisovi v škole vyhýbala .	vyhýbala	7	Pos
Bolo prirodzené , že roztiahla pery do úsmevu .	roztiahla	4	Pos
" Ľutuješ , že si to neurobil ? "	neurobil	6	Neg
Chichúňali sme sa ako pojašení , prebehli sme cez trávnik a smerovali k múru .	smerovali	11	Pos
“ Mohla by som doplniť aj najhulvátskejší ? “ dodala Aziza .	dodala	9	Pos
Jazmína zdvihla hlavu a uvidela , že princ Omar tuho spí .	uvidela	4	Pos
Rozumiem AKO , nechápem PREČO .	nechápem	3	Neg
Winston i Syme postrčili svoje podnosy k okienku .	postrčili	3	Pos
Nesmiem sa báť , hovorila si .	Nesmiem	0	Neg
“ Myslíš , že nás spoznal ? “ spýtal sa Chris , keď sme sa prestali triasť .	prestali	15	Pos
Neveriacky som sa na ňu dívala , cítiac , ako ma zadúša od hnevu .	zadúša	11	Pos
Oznámime to slečne Kasandre a budeme žiadať náhradu škody .	žiadať	6	Pos
Rozochvel som sa a pomyslel som si , že rovnako rozochvieť sa musela aj ona .	musela	12	Pos
Len čo stačil dobehnúť do úkrytu , z jaskyne vytrielila svorka vĺčat .	dobehnúť	3	Pos
Nezničil som ich , iba som ich ukryl .	Nezničil	0	Neg
Chris už dva dni neprišiel do školy .	neprišiel	4	Neg
“ Som najslávnejší človek v Grécku ! “ namietal Herkules .	namietal	8	Pos
Pred odchodom upchám dieru kusmi vrecoviny .	upchám	2	Pos
Nezískala ho ani Matica , ani občianske združenie Komorra a nedarí sa to ani gymnáziu .	Nezískala	0	Neg
Bol plochý a hranatý , na chrbte mal pekný vzor a zdalo sa , že spí .	spí	15	Pos
„ Nebyť toho , Slovensko by dnes neexistovalo , “ hovorí Ľubomír Ďurovič .	Nebyť	1	Neg
Nejedno dieťa už vytklo s bolesťou svojim rodičom : Vy ste na vine , že som sa dostal na zlú cestu , lebo vy sami ste nebrali Ježiša vážne a neviedli ste ma k Nemu .	nebrali	26	Neg
“ Kým neodíde , nevylieziem na žiaden strom . “	nevylieziem	4	Neg
Chcela by som sa na nej odviezť , “ povedala Makulienka .	odviezť	6	Pos
Nečudujem sa , že výborne urobil záverečné ročníkové testy .	Nečudujem	0	Neg
Bola horúca júlová noc a vládla dusivá spara .	vládla	5	Pos
Pani učiteľka sa usmievala a pousádzala ich okolo stola .	usmievala	3	Pos
Veď si sa v škole ani raz neprihlásil !	neprihlásil	7	Neg
A teraz pomôžem ja tebe .	pomôžem	2	Neg
“ Nedopustíme predsa , aby utiekli a varovali netvora , “ povedal ľuďom .	Nedopustíme	1	Neg
Nevládala som naňho pozrieť .	Nevládala	0	Neg
Dúfal som , že ju nečítal .	nečítal	5	Neg
To dievčisko nič nevie !	nevie	3	Neg
Chcel vzlietnuť do vzduchu , ale zamotal sa do krídel fraku .	zamotal	6	Pos
Moja trpezlivosť sa vyčerpala , keď ručičky na hodinkách stihli ukázať pol dvanástej a mne sa nikto nevenoval .	stihli	9	Pos
Svojim členom nikdy nepomáhame .	nepomáhame	3	Neg
Nevidel som nijakú uniformu .	Nevidel	0	Neg
Myslím , že o sebe urobili veľmi pekný obraz , že aj Rómovia a deti z detského domova sa vedia správať na úrovni .	správať	20	Pos
Nerúhajme sa Bohu a nereptajme na všetko a všetkých .	nereptajme	4	Neg
Čarodejnica odhrnula vejúci plášť a dobré víly onemeli od hrôzy , keď zbadali Zorničku .	odhrnula	1	Pos
Zrazu zažmurkal a prekvapene na oboch pozrel .	pozrel	6	Pos
V prípade , že z manželstva nevzišli deti , Strana nepovoľovala rozvod , zato podporovala odlúčenie .	nepovoľovala	10	Neg
Klesol som na stoličku .	Klesol	0	Pos
Neskrývame však ani obavy a pochybnosti .	Neskrývame	0	Neg
Neprihovorím sa mu po taliansky .	Neprihovorím	0	Neg
Na druhej strane je zaujímavé , že v sledovaných cirkevnoprávnych zbierkach sme nenašli žiadne ustanovenia o podmienkach využívania azylu .	nenašli	12	Neg
Za jasotu spoluobčanov prevzali cenu a Dr . Slimák slzil od dojatia , pretože v tejto súťaži doteraz nijaký slimák nevyhral .	nevyhral	20	Neg
V našich chlievoch niet jedinej kravy .	niet	3	Neg
“ Asi nikam nepôjdem .	nepôjdem	3	Neg
Straníčky sa nikdy nefarbili .	nefarbili	3	Neg
Ich sústredený pohľad nemohol neupútať moju pozornosť .	nemohol	3	Neg
Nenadarmo platí " Sýty hladnému neverí " a zároveň neexistuje žiadne porekadlo typu " Ukojený nadržanému neverí " .	neverí	16	Neg
“ Ani sa nečudujem , že pre ňu nemôžete nič vymyslieť .	nečudujem	3	Neg
Soni nedodržala našu dohodu , nenapísala nič .	nedodržala	1	Neg
U dovážaných produktov zabezpečí elimináciu tých , ktoré nespĺňajú kritériá kvality a ktoré neprešli colným a daňovým vysporiadaním .	neprešli	13	Neg
Lori som nevidel .	nevidel	2	Neg
Faika ma presvedčila o opaku .	presvedčila	2	Pos
“ A ďakujem , že ste tu zdržali to ľudské mláďa . “	ďakujem	2	Pos
Vláda bude požadovať zvýšenie finančnej disciplíny a tvrdé rozpočtové obmedzenie .	požadovať	2	Pos
Jachtala som , rýchlo som zavrela notes a strčila ho späť do vaku .	zavrela	5	Pos
Potrebujeme ľudí , ktorí budú ochotní počúvať svojho partnera , budú dostatočne vzdelaní na to , aby dokázali zaujať jasné stanovisko k mnohým problémom súčasnosti .	zaujať	18	Pos
Raz ju navštívila pavúčica Tekla , ktorá bola taká škaredá , až sa kráľovná zľakla .	zľakla	14	Pos
Nehryzie , však ? “	Nehryzie	0	Neg
“ A reči o tvojom starkom neber vážne .	neber	6	Neg
Hádes nemohol pokojne spávať , kým sa nepresvedčil , že tvoj otec je mŕtvy .	nepresvedčil	7	Neg
Nakoniec to nevydržal a snažil sa upratovačku na problém upozorniť .	nevydržal	2	Neg
" Nezabil som ju .	Nezabil	1	Neg
Nič sa nedalo robiť .	nedalo	2	Neg
Na rozdiel od rodičov som sa Profesora nebál .	nebál	7	Neg
Ale to vedia všetci .	vedia	2	Pos
Zostal som sám na prvopočiatku sveta .	Zostal	0	Pos
Namiesto toho urobila večeru , ako na zmierenie , a celú večnosť čakala , že sa vrátim .	urobila	2	Pos
Nemal najmenšie pokušenie jej klamať .	Nemal	0	Neg
Naučil ju i zopár tónov a zakrátko už Jazmína zabávala hostí jednoduchou melódiou .	zabávala	9	Pos
Lenže svedomie mi nedalo , a musela som jej niečo povedať .	nedalo	3	Neg
Za nič na svete však nechcela opustiť svoju rodinku , a tak sa Rudko a Flip rozhodli , že jej občas pomôžu .	nechcela	5	Neg
Na tretí deň ráno spratal päť porcií raňajok a spokojne sa ponaťahoval .	ponaťahoval	11	Pos
V zápale hry Maja prihrala Vilkovi , ten prudko kopol do lopty a lopta zmizla v kroví .	prihrala	4	Pos
Kolektívne postupovať nemôžeme .	nemôžeme	2	Neg
Vari nám nikdy nedáte pokoj !	nedáte	3	Neg
Nikto neprotestoval , že sa predbiehame .	predbiehame	5	Pos
Ako si usúdila , že neprídem ?	neprídem	5	Neg
Maja vyskočila a urobila zopár drepov .	vyskočila	1	Pos
Stranu nezaujímajú konkrétne činy : my si potrpíme len na myšlienky .	nezaujímajú	1	Neg
I ja mám občas dojem , že môj život riadia mamine nesplnené sny .	riadia	9	Pos
Náhlila som sa do kabínky pri bazéne , napchala som mokré veci do vaku , obula si mokré tenisky a vybehla von .	obula	15	Pos
Horšie však bolo , že ten divý kôň zmizol .	zmizol	8	Pos
Roztiahni krídla a leť .	Roztiahni	0	Pos
Vláda v každom prípade prijme kroky na zvýšenie motivácie rodičov a ich detí študovať , respektíve skutočne plniť povinnú školskú dochádzku .	plniť	17	Pos
Nedokáže sám vychovávať Jazmínu , dcéru , ktorá má toľko energie a predstavivosti .	Nedokáže	0	Neg
Môj mozog zatiaľ začínal špekulovať .	začínal	3	Pos
Tých , ktorí ma poznajú , takéto vyhlásenie neprekvapí .	neprekvapí	8	Neg
Usmiala sa naňho a potom odišla .	Usmiala	0	Pos
Nikto ho zatiaľ neuderil .	neuderil	3	Neg
“ Nijaké záhady sa nekonajú , “ odvetil Chris .	odvetil	7	Pos
Nemajú čas ani myseľ na spory , ktoré by mohli vyplynúť z ich odlišných vyznaní .	Nemajú	0	Neg
Nemalo by to zmysel .	Nemalo	0	Neg
Mám kŕčové žily a päť umelých zubov . "	Mám	0	Pos
Toto stieranie hraníc je veľmi príjemné , pokiaľ ide o poriadneho občana , ktorý cestuje za svojím obchodom alebo za svojou dovolenkou .	cestuje	14	Pos
Trvalo to len chvíľu .	Trvalo	0	Pos
Opäť ho pochytila temná panika .	pochytila	2	Pos
“ No ak to nezistí , nezabije nás , “ navrhol Bôľ .	nezabije	6	Neg
Winston usúdil , že nepostačí iba zmeniť zmysel prejavu Veľkého brata .	nepostačí	4	Neg
Ihneď ho ohúrila jej zmena k horšiemu .	ohúrila	2	Pos
V čase , keď sme s nimi skoncovali , boli to už len ľudské škrupiny .	skoncovali	7	Pos
Neúnavný hlas ďalej vyspevoval :	vyspevoval	3	Pos
V ten večer sa v paláci zhromaždili všetci dvorania , keď princezná Zornička tancovala s princom Filipom .	tancovala	13	Pos
Tento chlapík sa nikdy autorke nepáčil .	nepáčil	5	Neg
Zaletela k nim , sadla na kvet a počúvala tiché zurčanie potoka .	počúvala	8	Pos
Zaujal výberom tém aj ich spracovaním .	Zaujal	0	Pos
Ale mozog mi nefungoval .	nefungoval	3	Neg
Maja vážne pozrela na svoju učiteľku .	pozrela	2	Pos
Žuk meškal , a hoci som sa všemožne pokúšal opäť zaspať , nedarilo sa mi to .	nedarilo	12	Neg
Komárno nechce Cyrila a Metoda na verejnom priestranstve	nechce	1	Neg
“ Takto to už ďalej nejde , “ povedala Maja Rudkovi a Flipovi .	nejde	5	Neg
“ Nesmieš sa udrieť , nesmieš sa udrieť , nesmieš sa udrieť .	Nesmieš	1	Neg
Do horúcich pekiel , pomyslel si .	pomyslel	4	Pos
Nevládal by bežať , nevládal by uderiť .	uderiť	6	Pos
O dva dni ma v škole čakali samé dobré správy .	čakali	6	Pos
Tu boli zvyknutí vyberané spôsoby a správali sa podľa spoločenských pravidiel .	správali	6	Pos
Keby ste si mohli vybrať , žili by ste radšej vtedy či teraz ?	vybrať	4	Pos
Nemôžeš spať ? “	Nemôžeš	0	Neg
Ale ja nemôžem žiť bez tohto priznania .	nemôžem	2	Neg
“ Nijaké záhady sa nekonajú , “ odvetil Chris .	nekonajú	4	Neg
Vo svojej džungli nijaké ľudské mláďa nestrpím ! “	nestrpím	6	Neg
Táto správa ma omráčila a doktor ma odprevadil až dolu , k východu z budovy .	odprevadil	7	Pos
Keby som tade išiel ako dieťa , určite by som mal chuť zavolať kamarátov z dvora a ísť sa tam hrať „ dole - dole “ .	zavolať	12	Pos
Šetrí aj pani ministerka financií , ktorá stále nevylučuje ďalšie zvyšovania cien a zodpovednosť za to prenechala na vedúcich úsekov ?	nevylučuje	8	Neg
Prehltol posledný dúšok čaju .	Prehltol	0	Pos
Rozprávala , akoby jej vynechávalo srdce .	Rozprávala	0	Pos
Vôbec som neveril tomu , čo sa hovorí .	neveril	2	Neg
Marga sa ponáhľala odísť bezo mňa .	ponáhľala	2	Pos
Tu dávam povely ja ! “	dávam	1	Pos
Urobte to Júlii !	Urobte	0	Pos
Vyklonila som sa a pobozkala ho na ucho .	pobozkala	4	Pos
Vybrala najligotavejšie jabĺčko a podala ho chlapcovi .	podala	4	Pos
“ Nemôžeš mi nič zakazovať !	Nemôžeš	1	Neg
Človek očakával , že ho zabijú .	očakával	1	Pos
Ale pri pochodovaní sa nerozpráva .	nerozpráva	4	Neg
Nechodieval k nemu nikto okrem stareny v širokých nohaviciach .	Nechodieval	0	Neg
Veľkého brata nepočul nikto .	nepočul	2	Neg
Na perách sa mu zjavil potuteľný úsmev .	zjavil	4	Pos
Nespomínali moje ruské dobrodružstvo .	Nespomínali	0	Neg
“ Nevydeli ste tu nejakého koňa ? “ vypytoval som sa chrobákov .	Nevydeli	1	Neg
Nemôže vziať späť ani bozk .	Nemôže	0	Neg
V dome im Bibi vysvetlila , čo dáva psíkom jesť a kde majú svoje misky .	jesť	9	Pos
“ Držím ti palce , Amy , “ povedal s úsmevom , ktorý by roztopil i ľad .	povedal	8	Pos
Často sa pokúšam nájsť nejaké vysvetlenie , prečo som ju vtedy nenávidela .	nenávidela	11	Neg
Nevyzerám v plavkách smiešne ?	Nevyzerám	0	Neg
“ Z očí mi vyhŕkli slzy .	vyhŕkli	4	Pos
Ja sa nebojím možnosti , že na seba vrhnem zlé svetlo .	nebojím	2	Neg
Baghíra nestrácal ani chvíľu , zdvihol košík a odniesol ho k jaskyni .	odniesol	8	Pos
Po desiatich dňoch lekárske konzílium posilnili českí lekári .	posilnili	5	Pos
Čo spraví s dievčaťom , to rozhodne neskôr .	spraví	1	Pos
Klotilda pochopila .	pochopila	1	Pos
Nič som nevidel .	nevidel	2	Neg
Večer sa zakutral pod perinu a sníval o akrobatoch .	zakutral	2	Pos
Neváhal a rozhádzal všetky kamene , zničil všetky znamenia .	Neváhal	0	Neg
Kolektívne postupovať nemôžeme .	postupovať	1	Pos
" Neviem -- mne už je to fuk .	Neviem	1	Neg
Nič sa ma nepýtal .	nepýtal	3	Neg
Maja s Vilkom sedeli na lesnej čistine a vymýšľali si o nich príbehy .	vymýšľali	8	Pos
Musí odpútať ich pozornosť .	odpútať	1	Pos
Primátor Komárna Štefan Pásztor po svojej sekretárke odkázal SME , že sa k problému nevyjadrí .	nevyjadrí	14	Neg
Ja by som si dovolil tvrdiť , že nefungujú .	nefungujú	8	Neg
Žiaden z pápežov pred Gregorom VII . nešiel do priamej konfrontácie s najvyšším reprezentantom svetskej moci .	nešiel	7	Neg
Domčeky vyzdobili girladnami a Vilko s Emilom urobili na jednom krtinci kĺzačku , kde šantili deti .	šantili	14	Pos
Maja od ľaku vykríkla .	vykríkla	3	Pos
“ Nechcú nám ublížiť , Kerchak ! “ povedal .	Nechcú	1	Neg
V tomto podniku si nemôžem dovoliť luxus v podobe ďalšej whisky , ani keby som išiel dušu vypustiť .	nemôžem	4	Neg
“ Tak poďme privítať môjho nápadníka . “	poďme	2	Pos
Nemieni sa vzdať bez boja , tak lacno svoju kožu nepredá .	Nemieni	0	Neg
Trošku sa pritom začervenal .	začervenal	3	Pos
Pri tom seriáli by som dnes nevydržala .	nevydržala	6	Neg
“ Nestrachuj sa o mňa , “ odvetil Mauglí .	Nestrachuj	1	Neg
Cítila som ľútosť a hrôzu .	Cítila	0	Pos
Radža zazíval .	zazíval	1	Pos
Tkali od rána do večera .	Tkali	0	Pos
Nostradamus nič také nepredpovedal . . .	nepredpovedal	3	Neg
Naozaj tu niečo nesedí ?	nesedí	3	Neg
Srdce mu poskočilo .	poskočilo	2	Pos
Musí byť pohodlný , viem , aby sa v ňom Lienke dobre sedelo a dobre pérovaný , aby nedostala kočovú chorobu .	nedostala	18	Neg
“ Letím náhodou okolo , “ zašveholila , “ a takmer som o vás zakopla . “	Letím	1	Pos
“ Ale sú veci , ktoré nemôžeš zmeniť ani ty ! “	nemôžeš	6	Neg
Pred domom kuny Chytráčky viali pestré slepačie perá , Alfonz vystavoval lesklú kukuricu a kliešťak Drakula voňavé krvavé klobásky .	viali	4	Pos
“ Žobrákov nekŕmime , “ povedal sluha .	nekŕmime	2	Neg
Ak nemôže dostať Belu on , nedostane ju nikto , ani človek ani zviera .	nedostane	6	Neg
„ Nebyť toho , Slovensko by dnes neexistovalo , “ hovorí Ľubomír Ďurovič .	neexistovalo	7	Neg
“ Skoro všetky sú mamine , “ opravila som ho rýchlo .	opravila	7	Pos
Poslušnosť nestačí .	nestačí	1	Neg
To je tajomstvo , povedalo , neprezradím ho každému .	neprezradím	6	Neg
Nik sa však nezastavil .	nezastavil	3	Neg
Hladko som vkĺzla pod vodu a vynorila sa na hladine .	vkĺzla	2	Pos
Nevedel som to .	Nevedel	0	Neg
Neničíme kacíra preto , že nám odporuje ; pokým nám odporuje , neničíme ho .	Neničíme	0	Neg
Tu dnu , to vedel inštinktívne , sa svetlá nikdy nevypínajú .	nevypínajú	10	Neg
Ak im dovolíme , aby na nás zaútočili zo všetkých strán , nikdy sa neubránime .	neubránime	14	Neg
“ Ty nevieš , kto som ? “	nevieš	2	Neg
Videla som , že Chrisovi síce odľahlo , no po chvíli sa zasa tváril vážne .	Videla	0	Pos
Nikto si nevšimol , že som bol preč .	nevšimol	2	Neg
Odraz sa , povedala som si na konci dráhy po prvej dĺžke a hladko som to zvládla .	Odraz	0	Pos
Keď som mala bundu na sebe , zistila som , že ju nepotrebujem .	nepotrebujem	12	Neg
“ Môžeš si dať za mňa , “ povedala som .	Môžeš	1	Pos
“ Tu som ! “ zvolal krtko .	zvolal	5	Pos
To malo obrovský národnozáchovný význam v druhej polovici XIX . storočia , keď maďarizácia reálne ohrozovala samotnú existenciu slovenského národa .	ohrozovala	15	Pos
Honoráre oboch hviezd vzrástli .	vzrástli	3	Pos
Všetky tieto ich snahy mali aj svoju právnu dimenziu , vďaka čomu sa v okolí reformných pápežov vytvorilo „ nové “ reformné kánonické právo .	vytvorilo	17	Pos
Nemôžeš nikomu veriť . “	Nemôžeš	0	Neg
Keby ste ho nenašli , leťte za slnečným svitom .	nenašli	3	Neg
Noviny ste zabudli v kaviarni , letáky neznášate .	neznášate	7	Neg
Zhodil ma na trávu a veľmi dlho sme sa bozkávali .	Zhodil	0	Pos
Nemala som nijaký dôvod namietať .	Nemala	0	Neg
Neodpovedal som .	Neodpovedal	0	Neg
Nemôžeme sa skrývať za masu ani za tradíciu cirkvi , keď nás Kristus oslovuje na ceste nášho života .	Nemôžeme	0	Neg
Už nebežal , ani nejasal .	nebežal	1	Neg
A hoci tú knihu ešte nedočítal , vedel , že práve toto je konečné Goldsteinovo posolstvo .	nedočítal	5	Neg
V druhej polovici tohto storočia prvé nebezpečenstvo vlastne pominulo .	pominulo	8	Pos
Ostatné včely pobijeme .	pobijeme	2	Pos
“ Nech ti nelepí , vyhnem sa ti , ak sa vyhneš ty mne !	vyhnem	5	Pos
Postav ho na okrúhly stôl .	Postav	0	Pos
Bol to riskantný nápad , lebo nemusel vyjsť .	nemusel	6	Neg
" Ale Júliu som nezradil , " poznamenal .	nezradil	4	Neg
To však malá Maja ešte nevedela .	nevedela	5	Neg
“ Neviem , “ povedala som váhavo .	Neviem	1	Neg
Napriek tomu to však neplatilo bezvýhradne .	neplatilo	4	Neg
Chris zaprotestoval , ale zavrela som okno .	zaprotestoval	1	Pos
Ale ja som nevedel , že by zomrel niekto z domu .	nevedel	3	Neg
Chvíľu ho nechali metať sa vo vode , no potom prilákali k studni muža , čo okopával záhradku .	metať	3	Pos
Netušil som , že na druhý deň moju formu , ktorú som opäť nadobudol vďaka Raise , zničí tá najabsurdnejšia udalosť v mojom živote .	Netušil	0	Neg
Ten leták na mňa nezapôsobil .	nezapôsobil	4	Neg
“ Zjedol celú moju špecialitu ! “	Zjedol	1	Pos
Poď so mnou do Petrohradu namiesto mojich rodičov .	Poď	0	Pos
Vyrába umelé potreby , ktoré nás aktivujú , vyprázdňujú , ničia a zotročujú .	vyprázdňujú	8	Pos
Raňajky sa podávajú na prízemí , do deviatej .	podávajú	2	Pos
“ Obviňujeme vás , že ste nám odcudzili drahocennú potravu , “ povedal prísne veliteľ a dal pokyn , aby ich zajali a postavili pred sudcu .	odcudzili	7	Pos
Ja som nepostrehol nijaký náznak , že by mala strach .	nepostrehol	2	Neg
Cieľom Strany nebolo len to , aby medzi mužmi a ženami nevznikali vzťahy vernosti , nad ktorými nemala moc .	nevznikali	11	Neg
“ Vážne som chcela ísť po tréningu za tebou , ale vyfučalo mi to z hlavy .	chcela	3	Pos
Polly sa začervenala a hanblivo klapla zobákom .	klapla	5	Pos
Od ich svadby ubehli tri či štyri mesiace .	ubehli	3	Pos
Keďže ide o individuálnu záležitosť , škola v tomto dieťaťu veľmi nepomôže .	nepomôže	11	Neg
u Martina nemám čo do zvonca .	nemám	2	Neg
Nikto vlastne nevedel , kam ide .	nevedel	2	Neg
Sú vhodné do teplého letného počasia , od jesene do jari ich použitie neodporúčam .	neodporúčam	13	Neg
Nepamätal som sa , či sme s Raisou vypili včerajšiu fľašu alebo nie .	Nepamätal	0	Neg
Niečo tu nesedí .	nesedí	2	Pos
Nereagoval som .	Nereagoval	0	Neg
Našiel som vašu opičku ! “	Našiel	0	Pos
Nemohla som chápať súvislosti tejto zmeny .	Nemohla	0	Neg
Neboli sme tam už dosť dlho .	Neboli	0	Neg
Pripomínal jej trochu Teklu a chcela rýchlo odletieť .	Pripomínal	0	Pos
Aj Maja so škriatkom opustili topoľ a leteli , kým nedoleteli k domu , kde sa v oknách ešte svietilo .	svietilo	19	Pos
V sledovaných cirkevnoprávnych zbierkach sme pendanty k uhorským úpravám nenašli .	nenašli	9	Neg
Napokon preletel cez domček slimáka Oskara a skončil na baze .	preletel	1	Pos
Sexuálne puritánstvo Strany im nikto nevnútil .	nevnútil	5	Neg
Teraz som cítil , že nemám silu pokračovať pred Lori .	nemám	5	Neg
Svoje fotografie odteraz nájdete vždy na adrese www . fotoindex . sk vo svojom súkromnom fotoalbume .	nájdete	3	Pos
Nemohol som sa na nič sústrediť , nevládal som zniesť nikoho pri sebe : ani Margu , ani mamu , ani Toma .	Nemohol	0	Neg
Celú noc som ani oko nezažmúril , spal som iba chvíľu nadránom .	nezažmúril	5	Neg
Prichádzali a záhadne odchádzali ďalší väzni .	Prichádzali	0	Pos
Nič sa nedalo robiť .	nedalo	2	Neg
V 11 storočí však tieto vrstvy , stelesňujúce štátnu moc zastávali postoj výrazne odlišný — čoho najpregnantnejším prejavom bol kódex svetského práva — Ruská Pravda .	zastávali	10	Pos
Lienka sa držala nad vodou z posledných síl .	držala	2	Pos
Keď mama v ten deň dočítala list , neplakala .	neplakala	8	Neg
“ Nemyslím , “ odvetila som .	Nemyslím	1	Neg
O nej a o koníkovi nikto nič nevedel .	nevedel	7	Neg
Nekúpila som ho , povedala , priniesla som ti ho .	Nekúpila	0	Neg
Žiadne údaje o prípadných ďalších tunajších aktivitách Leva IX . , napríklad o snahách presadzovť refory , k dispozícii nemáme .	nemáme	19	Neg
Chcela som jej povedať o Chrisovi , ale nedokázala som sa zdôveriť so všetkým , čo cítim .	nedokázala	8	Neg
Zrazu som začula klopkanie na okno , no neposkočilo mi srdce ako inokedy .	neposkočilo	8	Neg
V tom polosvite som mal všetky dôvody myslieť si , že tam trčím zbytočne , aj keď človek , na ktorého som čakal , sa nevolal Godot .	nevolal	25	Neg
Všetko prebehlo v tichosti , vedenie fakulty nevydalo nijaké oficiálne vyhlásenie .	nevydalo	7	Neg
Vláda prijme strednodobý komplexný programový dokument rozvoja regiónov , zabezpečí prípravu , prerokovanie a schválenie plánovacích a programových dokumentov v oblasti regionálnej politiky s dôrazom na zlepšenie ekonomickej a sociálnej súdržnosti a prehĺbi uplatňovanie princípu partnerstva .	prijme	1	Pos
Stiahol kombinézu nabok a prezeral si jej hladký , biely bok .	prezeral	4	Pos
Chcem byť tvojím kňazom , povedal som jej .	Chcem	0	Pos
Ale neotvoril ho ihneď .	neotvoril	1	Neg
Takto nevyzerá ani autorka článku , ani kamarátova babka .	nevyzerá	1	Neg
Zničená som si prisahala , že si cez obedňajšiu prestávku zaplávam a budem trénovať obrátky dovtedy , kým ich nezvládnem .	zaplávam	10	Pos
Trvalo to , až kým výťah nezastal na siedmom poschodí .	nezastal	6	Neg
A Trúbeľko sa zasa radoval , že sa Ferdovi nič zlé nestalo .	radoval	4	Pos
Po vypnutí obrazovky nastalo v miestnosti hrobové ticho .	nastalo	3	Pos
Ani bratanci sa sem už neodvážia prísť , priatelia k nám prestali chodiť na návštevu už dávno .	neodvážia	5	Neg
Akýsi neomylný inštinkt mi signalizoval , že aj ona myslí na mňa .	signalizoval	4	Pos
“ Celý deň som ho nevidela , “ zahučala ozvena zo skaly .	nevidela	5	Neg
Lenže Alfonza nezastavil .	nezastavil	2	Neg
Mama mi naznačila , že nemám otvárať .	nemám	5	Neg
Čo bolo v listoch posielaných nahor , nikdy som sa nedozvedel .	nedozvedel	10	Neg
Baghíra ich sledoval , kým mu nezmizli z dohľadu .	nezmizli	6	Neg
Sledoval som ju pohľadom , až kým sa nestratila v dave .	nestratila	8	Neg
“ Nezmysel , to by Radža neurobil . “	neurobil	6	Neg
Dodnes s určitosťou nevedel , či je matka mŕtva .	nevedel	3	Neg
Nemalo nijaké okná .	Nemalo	0	Neg
Nikto ju neprenasledoval .	neprenasledoval	2	Neg
Aby ma Chris nepovažoval za decko pretože , nemám mamin súhlas , nič som mu nevravela .	nemám	8	Neg
Verila , že neurobím to čo ona .	Verila	0	Pos
Vychrlila tie otázky tak rýchlo , že som nestačila reagovať .	nestačila	8	Neg
Veď čo už zvýšilo z toho , čo z neho mučením nevypáčili ?	zvýšilo	3	Pos
Našťastie sa nemusím veľmi rozpisovať , lebo Hysteria Pub má svoju webovú stránku .	nemusím	2	Neg
Jediný kanál s jasným obrazom vysielal pornografické scény .	vysielal	5	Pos
Pokým nevyprázdnili misky , ani jeden z nich už neprehovoril .	neprehovoril	9	Neg
Ona ustúpila dozadu , otočila sa mu chrbtom , ale ten chlap zostal pri zástupe žien .	ustúpila	1	Pos
Oficiálne sa partneri nikdy nezmenili .	nezmenili	4	Neg
Rád by som v tomto poďakovaní spomenul všetkých , ktorí akoukoľvek radou či pomocou prispeli ku zrodu predkladanej publikácie .	prispeli	14	Pos
" Neviem .	Neviem	1	Neg
Celý svet vyvalí oči , keď Belu a Gastona zbadá taký pár málokde zočí , krásavci jedna balada .	zbadá	9	Pos
Vodné vtáky teda i kačky sú späté s kultom slnca , keďže svojim jarným príletom zvestujú vzrast jeho moci .	zvestujú	15	Pos
Ale ani to som neurobila .	neurobila	4	Neg
Abu pokrčil plecami , tváril sa trochu pochybovačne .	tváril	4	Pos
Jediná nádej , že ju uvidím , bola virtuálna , závisela od toho , či sa rozhodne trápiť ma vo sne .	rozhodne	16	Pos
Mne to môžeš povedať . “	môžeš	2	Pos
“ Môže tu ostať do desiatej . “	Môže	1	Pos
Nemôžeš poprieť , že si plakala .	Nemôžeš	0	Neg
Pod bielym strniskom starcova tvár očervenala .	očervenala	5	Pos
Vybral z nej dlhú striebornú dýku .	Vybral	0	Pos
Preto je väčšinou lepšie neplytvať energiou a vziať na vedomie cudziu paradigmu .	neplytvať	4	Neg
Slnečný svit , ktorý prenikal nespočetným lístím , ich ešte stále pálil na tvárach .	pálil	11	Pos
“ Nehovor mi , že si mierumilovný netvor !	Nehovor	1	Neg
Maja sa však nedala odradiť .	nedala	3	Neg
Zišlo mu na um , že až doteraz ho zrejme nevidela na voľnom priestranstve v plnom dennom svetle .	nevidela	10	Neg
Škriatok , ktorý opustí kvet , má zázračnú moc .	opustí	3	Pos
“ Kým nebude jeho hlava visieť na múre môjho domu , dovtedy nebudeme v bezpečí . “	nebudeme	12	Neg
Kúsok chleba ešte stále ležal tam , kam ho odhodil muž bez brady .	ležal	4	Pos
V Čarodejníckej vile sa nikto netešil takému privilégiu .	netešil	5	Neg
“ Len sa tak netvárte , “ namietala vážka Kráska .	netvárte	4	Neg
My takéto chyby nerobíme .	nerobíme	3	Neg
Skry sa ! “ zvolala som a zatiahla Chrisa pod oleander .	zvolala	4	Pos
“ Nesmieš sa udrieť , nesmieš sa udrieť , nesmieš sa udrieť .	nesmieš	5	Neg
Ani družka , ani sok ho nesledujú . Čo ho núti vysedávať na konári osamoteného stromu a vyludzovať hudbu do prázdna ?	núti	10	Pos
Vláda bude podporovať programy v horších pôdnych a klimatických podmienkach a orientovať sa na mimoprodukčné funkcie poľnohospodárstva a agroturistiky .	orientovať	11	Pos
Keď leteli okolo sladko rozvoniavajúceho jazmínového kra , neodolali a sadli si naň .	neodolali	8	Neg
Zmocnil sa ma závrat .	Zmocnil	0	Pos
Oznamuje východ slnka a prebúdza zo spánku . .	prebúdza	4	Pos
Takto som kedysi čakával na Doloru .	čakával	3	Pos
Povedala , že už neznesie život v takomto špicľovaní .	neznesie	4	Neg
Štát tú časť pôdy , ktorá nebude potrebná ma výstavbu objektov a infraštruktúry celospoločenského významu , prevedie do vlastníctva obce .	prevedie	16	Pos
Vládol tu čulý ruch , no Chrisa nevyrušil zo sústredenia .	nevyrušil	7	Neg
Vedela , že Erik s Arielou sa zachytili o cípy jej obrovitej koruny .	zachytili	7	Pos
Keď ho vypije , majú ho zabiť .	zabiť	6	Pos
Euroáziu chráni jej obrovská rozloha .	chráni	1	Pos
“ Rick ! “ skríkla som a vyjavene naňho pozrela .	skríkla	4	Pos
Kvalifikovanú odpoveď na tuto otázku však budeme môcť priniesť až po dôkladnej komparácii s dobovými východnými právnymi pamiatkami .	môcť	7	Pos
Nadovšetko túžil po krajci chleba .	túžil	1	Pos
Skúste siahnuť po nejakej knižnej novinke , zoznam nájdete v Knižnom katalógu .	Skúste	0	Pos
“ Nebyť mňa , nebol by si tu ! “	Nebyť	1	Neg
O chvíľu zaspalo .	zaspalo	2	Pos
Jazmína pokrútila hlavou .	pokrútila	1	Pos
Myslela som si , že neprídeš , povedala .	neprídeš	5	Neg
“ Hľa ! “ zvolala bosorka .	zvolala	4	Pos
Všetka moc , všetky zbrane , ktoré Ho chceli zlikvidovať , sú nanič .	zlikvidovať	9	Pos
Potichučky som vyliezla hore a prešmykla sa dnu .	prešmykla	5	Pos
O prípadnom sobáši nedebatovali .	nedebatovali	3	Neg
Postávali v tieni lieštiny .	Postávali	0	Pos
Na hrebeni sa otočil a zaparkoval autom celkom pri okraji cesty .	zaparkoval	5	Pos
“ Ty nemáš otca alebo mamu ? “ spýtal sa Dizzy .	nemáš	2	Neg
Nemal najmenšie pokušenie jej klamať .	Nemal	0	Neg
Tentoraz mu ju však pripomenula najmä dusná horúčava toho popoludnia , keď mu na čele vyrazili kropaje potu .	pripomenula	4	Pos
Veď nás Duchom Svätým a pomáhaj nám prekonávať všetko , čo v EÚ a našom svete bude slúžiť smrti a zániku .	pomáhaj	5	Pos
Na môj zarazený pohľad odpovedala pozvaním : Ak túto sobotu nepôjdeš domov do Tirany , príď sem .	nepôjdeš	10	Neg
Prejav ma neprekvapil .	neprekvapil	2	Neg
Obávam sa , že ocko nedovolí , aby sa mu po paláci potuloval tiger .	nedovolí	5	Neg
Niektorí sa nazdávali , že drevorubač konal správne .	nazdávali	2	Pos
Každý pohlavný styk , ktorému nič nechýbalo , bol vzburou .	nechýbalo	6	Neg
Ani družka , ani sok ho nesledujú . Čo ho núti vysedávať na konári osamoteného stromu a vyludzovať hudbu do prázdna ?	nesledujú	6	Neg
Už mnoho generácií múch obývalo kráľovský palác v stajni .	obývalo	4	Pos
“ Nepleť sa do toho , Atlas , “ odvrkla Meg , keď jej chcel Herkules pomôcť .	Nepleť	1	Neg
Nedbal na to , že sa ocitol v nebezpečnej blízkosti kravského chvosta .	ocitol	6	Pos
Krist , nenamáhaj sa , nepoučuj ma o tom , o čom ma stará mama poučila už dávno ‐ pradávno .	nepoučuj	5	Neg
Prekvapená videla , ako zvonka preniká do spálne jemné modravé svetlo .	preniká	5	Pos
Niektoré z nich , vydané vo francúzštine , občas dávala aj mne , pričom mi nezabudla prikázať , aby som to nikomu neprezradil .	neprezradil	22	Neg
Poskakoval okolo mňa a od samej radosti sa jašil .	jašil	8	Pos
“ Toto je tvoja detská izba , neskôr dostaneš večeru , “ vysvetľovala mu Maja .	dostaneš	8	Pos
Vtedy mi utkveli v pamäti dátumy , mená i dôležité udalosti z minulosti , medzi ktoré bolo neskôr ľahšie dokladať nové dátumy , mená i vzťahy .	dokladať	19	Pos
Táto povinnosť sa však nevzťahovala na produkty , ktoré sa jednak priamo a jednak symbolicky týkali základných prejavov kresťanského kultu .	nevzťahovala	4	Neg
Ten nový tlmočil .	tlmočil	2	Pos
Keď zástup Japoncov odišiel , v uchu sa mi opäť rozozvučal smútočný motív trúby .	rozozvučal	10	Pos
Herkules hodil povinnosti s radosťou za hlavu .	hodil	1	Pos
Odkiaľ berú títo ľudia presvedčenie , že pre Bratislavčanov reformy neznamenajú záťaž ?	neznamenajú	10	Neg
Nenapísal som nič .	Nenapísal	0	Neg
Ospravedlnil som sa jej .	Ospravedlnil	0	Pos
Zišlo mu na um , že ešte stále nepozná jej priezvisko , ani jej adresu .	nepozná	8	Neg
Veľký panter pozorne nastražil uši .	nastražil	3	Pos
Kráčal ďalej .	Kráčal	0	Pos
Po záležitosti so Soni som nezažil nijaké ľúbostné dobrodružstvo .	nezažil	5	Neg
Nemala som veľmi na výber , a tak som ostala vo vode .	Nemala	0	Neg
Nech ma Tom netrápi , chcel som jej povedať .	netrápi	3	Neg
Našla osí roj , ktorý mal včelí palác zničiť .	Našla	0	Pos
“ Nechcela som ťa nahnevať , “ vravela som rozpačito .	Nechcela	1	Neg
Nemohla som tomu uveriť .	Nemohla	0	Neg
“ Blahoželám ! “ zvolal .	Blahoželám	1	Pos
Winston si tu nemusel objednávať nič .	nemusel	3	Neg
Keď Herkules vynášal Meg z jaskyne smrti , Hádes sa usiloval zľahčiť svoju chybu .	vynášal	2	Pos
Už dávno sa s nimi nehrám , ale ani vo sne by mi nenapadlo , aby som ich vyhodila .	nenapadlo	13	Neg
Srdce mu od radosti poskočilo , keď Wendy urobila posledný krôčik a zmizla .	zmizla	12	Pos
“ Nech ti nelepí , vyhnem sa ti , ak sa vyhneš ty mne !	nelepí	3	Neg
Kráčal som za ním po tichej chodbe nemocničného pavilónu a ani som si nevšimol , že Irma nie je s nami .	nevšimol	13	Neg
Prestal premýšľať a iba vnímal .	vnímal	4	Pos
Možno ich nevidel .	nevidel	2	Neg
O dvadsať minút nastalo úplné zatmenie .	nastalo	3	Pos
Tú ženu som vôbec nepoznal .	nepoznal	4	Neg
Kráčal po chodbe a očakával guľku .	Kráčal	0	Pos
“ Môžem si to ešte rozmyslieť ? “ spýtala sa .	rozmyslieť	5	Pos
“ To sa zle skončí , “ kuvikal dážďovka Vendelín , ale nikto ho nepočúval .	skončí	4	Pos
Aj keď vo chvíli , keď sa to stalo , ležal na chrbte , mal čudný pocit , že ho do tejto polohy niečo zrazilo .	zrazilo	24	Pos
Už sa nemôžem vrátiť .	nemôžem	2	Neg
Nemal som dôvod zapierať .	Nemal	0	Neg
Vyšiel som von a chvíľu som nerozhodne postával : mám celkom odísť , alebo mám poslúchnuť chlapcovu radu a ísť do toho podniku ?	postával	7	Pos
( Cirkevnú sankciu teda zákon neobsahuje . )	neobsahuje	5	Neg
Abu sledoval , kam pozerá , a zbadal dievča .	zbadal	7	Pos
Najvyšší čas prebehnúť sa po čerstvom vzduchu !	prebehnúť	2	Pos
Pritisol som ich k sebe .	Pritisol	0	Pos
Každý teraz prosil o žiletky .	prosil	2	Pos
Ale sukničku s volánikmi horko ‐ ťažko uniesla .	uniesla	7	Pos
Nechcem nič konkrétne .	Nechcem	0	Neg
“ Urobil si veľkú a hlúpu chybu , priateľko . “	Urobil	1	Pos
Ani som sa nepohla .	nepohla	3	Neg
“ Veľmi ste mi neporadili . “	neporadili	4	Neg
Aj keď v noci ešte nelietala , rozprestrela krídla a opustila svoju bezpečnú dutinku v strome .	nelietala	5	Neg
Chcela som sa spýtať , kde tie chrústy našiel .	Chcela	0	Pos
Ťažkopádne sa mu pohla hlava .	pohla	3	Pos
Nesmiem sa báť , hovorila si .	báť	2	Pos
“ V Aquitare jedia červíky , otec !	jedia	3	Pos
“ Nikdy nevystúpim na Olymp , “ vravel Filovi .	nevystúpim	2	Neg
Nebojte sa , “ zakričala Polly .	Nebojte	0	Neg
Tá rozprávka ma priviedla na inú stanicu .	priviedla	3	Pos
Nič také som neurobil .	neurobil	3	Neg
Na niektorých uliciach metropoly sa matky ani na chvíľku neodvážia nechať svoje bábätká samotné .	neodvážia	9	Neg
“ To nikam nevedie . “	nevedie	3	Neg
“ Áno , chápem . “	chápem	3	Pos
Vtom sa vo dverách zjavila aj neforemná Buchta .	zjavila	4	Pos
A ja som si myslel , že si ma nikto nevšimol .	nevšimol	10	Neg
Skúsil to ešte raz , ale nezdvihol ju .	nezdvihol	6	Neg
Nemôžem pritom nespomenúť ešte jednu vec .	nespomenúť	2	Neg
Povedal som im , že to nepovažujem za zlý nápad .	nepovažujem	6	Neg
Z televíznej obrazovky ho nik neokríkol .	neokríkol	5	Neg
Od toho času neznášam zvonenie budíka .	neznášam	3	Neg
Potom prišli texty , ktoré som Deline nikdy neukázal .	neukázal	8	Neg
Však vieš , že sa tá zbierka robí od domu k domu .	vieš	1	Pos
Takého neposedného spoločníka ešte nestretla .	nestretla	4	Neg
/ vedie k pochybnosti o pevnosti náboženského presvedčenia Nikolu .	vedie	1	Pos
Bála som sa , že ho tak ľahko znovu nezavriem .	nezavriem	9	Neg
No keď Lulu kefovala tigriu srsť , diali sa čudné veci .	diali	7	Pos
“ A prečo palác nepresťahujete inde ? “	nepresťahujete	4	Neg
Pretože Jumbo bol mierumilovný , nikto nenamietal .	nenamietal	6	Neg
Rástol , zrel až dozrel .	Rástol	0	Pos
V oblasti aktívnej politiky trhu práce bude vláda presadzovať princíp návratnosti a projektového financovania .	presadzovať	8	Pos
Terapia nezabrala .	nezabrala	1	Neg
Trochu sa zľakla , no pozrela hore .	pozrela	5	Pos
Chcel vzlietnuť do vzduchu , ale zamotal sa do krídel fraku .	Chcel	0	Pos
Niečo ma však na tom znepokojuje .	znepokojuje	5	Pos
“ Fajn ! “ odvetil .	odvetil	4	Pos
“ Kým neodíde , nevylieziem na žiaden strom . “	neodíde	2	Neg
Je tvrdohlavý , neodíde , ani keby som to ohlásila na polícii .	ohlásila	9	Pos
“ S vami sa už nemienim baviť ! “ kričal rozhorčene .	nemienim	5	Neg
Maja sa strhla .	strhla	2	Pos
Nevdojak som sa poobzeral , či neuvidím Háda .	neuvidím	6	Neg
Slovná zásoba A sa vôbec nedala použiť na literárne účely a na politické a filozofické dišputy .	nedala	5	Neg
Odhrnula som mokré plavky , prázdne kokakolové plechovice , ceruzky , listy vytrhnuté z notesa a knižku Kto chytá v žite so somárskymi ušami .	Odhrnula	0	Pos
“ Ďakujem , “ povedala Makulienka , “ ibaže neviem , čo mám robiť , aby drozd vrátil Emanuelovi cylinder . “	neviem	9	Neg
Niekto zo susedov si mohol všimnúť , že som bol preč , mohol by sa ma zvedavo vypytovať , kde som bol , a to by stačilo , aby sa som sa rozčúlil .	rozčúlil	32	Pos
Ja som ich ani nepočúval , ani som si nič nemyslel .	nemyslel	10	Neg
Niekedy plakala .	plakala	1	Pos
Samozrejme , že Maja s Vilkom zablúdili v jesennej hmle ako prví .	zablúdili	6	Pos
Mohla by sa ma pýtať na Lorinu svadbu a ja by som nevedel , čo jej povedať .	nevedel	12	Neg
Brat kantor pre vážne osobné dôvody nemohol prísť , preto brat farár sprevádzal nábožný spev na gitare spolu s mládežníkmi , ktorí poslúžili programom a vystúpili aj s osobným vyznaním .	nemohol	6	Neg
“ Musíme ho rozveseliť , “ pošepla Maja Vilkovi .	Musíme	1	Pos
