Sipas tij , disa prej këtyre mjeteve ruhen dhe sot në muzeun e tij privat .	ruhen	7	Plur
Ne vyshkeshim .	vyshkeshim	1	Plur
Ata preferuakëshin .	preferuakëshin	1	Plur
Tirana e mbylli sezonin në vendin e pestë me 44 pikë , duke mos u kualifikuar dot në kompeticionet europiane , duke sjellë edhe largimin e Hykës .	mbylli	2	Sing
Unë do të lija .	lija	3	Sing
U leshua më 13 nëntor 2012 .	leshua	1	Plur
Përgatitja me të cilën fillonte obstetrikën , ishte ironia .	fillonte	4	Sing
Të gjithë , të gjithë thirrën partizanët .	thirrën	5	Plur
Ne përgjithësojmë .	përgjithësojmë	1	Plur
Ti shuaj .	shuaj	1	Sing
Menjëherë burra , gra e fëmijë dolën dhe qëndruan nën hijen e saj për t ’ u freskuar .	dolën	6	Plur
Unë copëtofsha .	copëtofsha	1	Sing
Për ta kuptuar më mirë shtrirjen e fshatit Zhanicë , së pari , fïlloj me toponimet që e rrethojnë , pastaj toponimet brenda tij .	fïlloj	13	Sing
Ju stimuluakeni .	stimuluakeni	1	Plur
Ne harrojmë .	harrojmë	1	Plur
Pas turneut në fjalë u organizua edhe liga në konkurencën e femrave .	organizua	5	Sing
Ai puthte .	puthte	1	Sing
Modelet 3G dhe LTE të kësaj tablete peshojnë pak më shumë deri në 753 gr , duke u bazuar tek specifikimet zyrtare të tabletës .	peshojnë	7	Plur
Ata të qëndronin .	qëndronin	2	Plur
Ju u zgjuakeni .	zgjuakeni	2	Plur
Ne rënkofshim .	rënkofshim	1	Plur
Drejtësia ndërmjet brezave gjithashtu përfshin një obligim për brezat e rinj për t ’ u kujdesur për brezat më të vjetër të popullatës .	përfshin	4	Plur
Ti u peshuakëshe .	peshuakëshe	2	Sing
Ata dëshironin .	dëshironin	1	Plur
Ti gabove .	gabove	1	Sing
Ata të organizojnë .	organizojnë	2	Plur
Ne shpallim .	shpallim	1	Plur
Ti do të abdikoje .	abdikoje	3	Sing
Ai do të urrente .	urrente	3	Sing
Ata të themelojnë .	themelojnë	2	Plur
Ai do të flirtojë .	flirtojë	3	Sing
03.10.1918 Rrënjët e shpifjeve qëndrojnë mbi ujë .	qëndrojnë	4	Plur
Ti peshove .	peshove	1	Sing
Ne sulmohemi .	sulmohemi	1	Plur
Ata themeluakan .	themeluakan	1	Plur
Më pas u lanë të lirë , banuan pranë t ’ afërmit , Sejfulla Merlikës .	banuan	7	Plur
Ju u dorëzuat .	dorëzuat	2	Plur
Në përgjithësi nuk i ndjejmë , por është i regjistruar në sizmograf .	ndjejmë	4	Plur
Ne sakrifikonim .	sakrifikonim	1	Plur
Ne pomponim .	pomponim	1	Plur
Për sa kohë që Zoti lihet pas dore , përsa kohë shtëpia e tij qëndron në gërmadha po për aq kohë edhe izraelitët do të njohin vetëm hidhërim dhe turp .	njohin	25	Plur
Ne do të propozojmë .	propozojmë	3	Plur
Ju duruakeni .	duruakeni	1	Plur
Ju takoheni .	takoheni	1	Plur
Unë të shtegtoj .	shtegtoj	2	Sing
Tetra Pak mohoi çdo të keqe duke bërë dhe më vonë u lirua plotësisht nga të gjitha akuzat e ryshfetit , duke pranuar se nuk ka të holla janë paguar të familjes Tanzi .	mohoi	2	Sing
Supozohet se më këtë frut janë freskuar njerëzit që në epokën e gurit .	Supozohet	0	Sing
Unë do të bisedoja .	bisedoja	3	Sing
Ti përdorje .	përdorje	1	Sing
Ti prishke .	prishke	1	Sing
Ata asnjanësuakëshin .	asnjanësuakëshin	1	Plur
Ju u mësuakëshit .	mësuakëshit	2	Plur
Ai do të relaksohej .	relaksohej	3	Sing
Ne lënkëshim .	lënkëshim	1	Plur
Ata thekshin .	thekshin	1	Plur
Ju do të zgjoheni .	zgjoheni	3	Plur
Sikur të kishte dashur Uthmani , rebelimi do të mund të shuhej mu në momentin kur edhe filloi .	shuhej	11	Sing
Ti sqaroje .	sqaroje	1	Sing
Sistemi i riprodhimit tek femra : Pika G në të vërtetë nuk është një pjesë anatomike e trupit , por më shumë një si zonë , në të cilën një femër mund të ketë ndjeshmëri më të lartë .	ketë	33	Sing
Ju ledhatuakëshit .	ledhatuakëshit	1	Plur
Mukoza bashkë me submukozën , formojnë plika cirkulare , të cilat mungojnë në pjesën fillestare të duodenit dhe rrallohen , deri në zhdukje , në pjesën e fundit të ileumit .	rrallohen	18	Plur
Ai të justifikonte .	justifikonte	2	Sing
Ju u miqësuakeni .	miqësuakeni	2	Plur
Ti të abdikoje .	abdikoje	2	Sing
Ai të argëtonte .	argëtonte	2	Sing
Një vit më vonë në Glasgow , AS Saint-Étienne u mundën nga një tjetër gol dhe Bayern u bë klubi i tretë që fiton trofe në tre vjet rresht .	mundën	10	Plur
Mehmet Myftiu u deklarua armik i popullit dhe iu hoq e drejta e botimit .	deklarua	3	Sing
Unë udhëzuakam .	udhëzuakam	1	Sing
Unë të ikija .	ikija	2	Sing
Ne afirmuam .	afirmuam	1	Plur
Ne do të abstenonim .	abstenonim	3	Plur
Unë matkam .	matkam	1	Sing
Ai shkëlqyekësh .	shkëlqyekësh	1	Sing
Ne do të kafshonim .	kafshonim	3	Plur
Ne ndihnim .	ndihnim	1	Plur
Ata do të justifikonin .	justifikonin	3	Plur
Ata shqipuakëshin .	shqipuakëshin	1	Plur
Ti skllavërove .	skllavërove	1	Sing
Ti të ndash .	ndash	2	Sing
Ju gënjyekeni .	gënjyekeni	1	Plur
Ti do të abuzosh .	abuzosh	3	Sing
Ata të dhunonin .	dhunonin	2	Plur
Ne dashuruakemi .	dashuruakemi	1	Plur
Ndërsa gjen thesarin , Altair thyen të gjitha parimet e fenë e vrasësve dhe brenda disa minutave me hapjen e lojes , përpiqet për të vrarë de Sable , por dështon .	dështon	30	Sing
Unë miqësohem .	miqësohem	1	Sing
Ju besuakeni .	besuakeni	1	Plur
Pësoi aksident të rëndë gjatë fluturimit të datës 27.09.1967 , ndërsa fluturonte me avionin MIG-17 mbi rajonin e Elbasanit .	Pësoi	0	Sing
Doli kuçedra me shtatë krerë dhe ia mori këngës : – lumja unë e lumja !	Doli	0	Sing
Unë mbuloja .	mbuloja	1	Sing
Unë zhvirgjëroja .	zhvirgjëroja	1	Sing
Unë do të hapja .	hapja	3	Sing
Ne të relaksoheshim .	relaksoheshim	2	Plur
Ti mas .	mas	1	Sing
Moszhvillimi ekonomik e sidomos mungesa e infrastrukturës ka bërë që shumë fshatra të braktisen nga banorët , dhe tani është krijuar një gjendje me disa katunde të zbrazura .	braktisen	13	Plur
Ju duroni .	duroni	1	Plur
Në vitin 1968 hapet qendra shëndetesore .	hapet	3	Sing
Ti u sodomizofsh .	sodomizofsh	2	Sing
Ti të daje .	daje	2	Sing
Ju mirësuakeni .	mirësuakeni	1	Plur
Ti ëndërrofsh .	ëndërrofsh	1	Sing
Ata zbuluakan .	zbuluakan	1	Plur
Unë ikikësha .	ikikësha	1	Sing
Ata luftuakan .	luftuakan	1	Plur
Ai mardhkësh .	mardhkësh	1	Sing
Ai dërgon .	dërgon	1	Sing
Ai arësyetuakësh .	arësyetuakësh	1	Sing
Ju të stimuloni .	stimuloni	2	Plur
Ne ikishim .	ikishim	1	Plur
Unë do të sulmohesha .	sulmohesha	3	Sing
Sidoqoftë , dy ngritje masive të jakobitëve që u lëshuan më 1715 dhe 1745 dështuan ta largonin " Shtepinë Hanover " nga froni britanik .	dështuan	14	Plur
Ti injorofsh .	injorofsh	1	Sing
Ne ëndërruakëshim .	ëndërruakëshim	1	Plur
Ti fillon .	fillon	1	Sing
Ai Admiruakësh .	Admiruakësh	1	Sing
Ju dhunuakëshit .	dhunuakëshit	1	Plur
Ne degjojmë .	degjojmë	1	Plur
Unë të urinoja .	urinoja	2	Sing
Ne do të injorojmë .	injorojmë	3	Plur
Unë do të notoja .	notoja	3	Sing
Ai themelonte .	themelonte	1	Sing
Ne trishtohemi .	trishtohemi	1	Plur
Ti do të pranoje .	pranoje	3	Sing
Ne shpirtërojmë .	shpirtërojmë	1	Plur
Ju ndaluakeni .	ndaluakeni	1	Plur
Ti do të qortosh .	qortosh	3	Sing
Ju preferofshit .	preferofshit	1	Plur
Shekulli i 21 në 11 shtator të 2001 , Nju Jorku u godit nga një sulm terrorist .	godit	12	Sing
Të skuqur nga puna , të lodhur e të djersitur , ata shkundnin gunat nga bora dhe vinin e uleshin aty në strehë .	shkundnin	12	Plur
Ne ngrikemi .	ngrikemi	1	Plur
Ti nënkuptofsh .	nënkuptofsh	1	Sing
Ata të shkatërrojnë .	shkatërrojnë	2	Plur
Ai ikii .	ikii	1	Sing
Që kur këto elektrone të lira lëvizin gjatë gjithë përçuesit , ato janë bartëse të ngarkesave .	lëvizin	6	Plur
Ne ndalnim .	ndalnim	1	Plur
Unë do të iki .	iki	3	Sing
Ti të adhurosh .	adhurosh	2	Sing
Ti do të mësoheshe .	mësoheshe	3	Sing
Ju adhuruakëshit .	adhuruakëshit	1	Plur
Unë dhunoj .	dhunoj	1	Sing
Ju dhuruat .	dhuruat	1	Plur
Ti do të degjoje .	degjoje	3	Sing
Unë bashkëpunoja .	bashkëpunoja	1	Sing
Peizazhe piktoreske ofron edhe parku kombëtar i Lurës si dhe pyjet e shumta , liqenet që janë shumë të bukura .	ofron	2	Sing
Ne ngrënkëshim .	ngrënkëshim	1	Plur
Qeveria e re , duke kuptuar nevojën për mbështetjen e kapitalistëve , në mënyrë të heshtur moderoi shumë prej politikave të Sankarës .	moderoi	16	Sing
Ti do të mbuloje .	mbuloje	3	Sing
Unë të lahem .	lahem	2	Sing
Ti tradhëton .	tradhëton	1	Sing
Gjermanët që kishin filluar të aviteshin tinëz nën shkëmbinjtë , u kthyen përsëri në hendek .	kthyen	11	Plur
Ata të komunikonin .	komunikonin	2	Plur
Ne lidhkemi .	lidhkemi	1	Plur
Rituali fetar nuk e lejonte një gjë të tillë .	lejonte	4	Sing
Ata të zgjoheshin .	zgjoheshin	2	Plur
Marsi dhe prilli kanë tendencë të kenë më shumë ditë me erë që arrijnë 32 deri në 48 km/orë , dhe era e fortë e pasdites mund të ngrejë rërë dhe pluhur .	kenë	6	Plur
Ai të dhunonte .	dhunonte	2	Sing
Unë provoja .	provoja	1	Sing
Ti zgjoje .	zgjoje	1	Sing
Mua nuk më kishte qëlluar kurrë të shihja ndonjë vizatim , ndonjë gravurë , të lashtë apo moderne , me pamjen e tij , madje nuk dija asgjë tjetër për të veç emrit .	shihja	7	Sing
Ai do të zhvillonte .	zhvillonte	3	Sing
Ata qortofshin .	qortofshin	1	Plur
Ju do të zbulonit .	zbulonit	3	Plur
Ai mëndi .	mëndi	1	Sing
Përvoja e mangët kineze në këtë teknologji u reflektua në defekte të shumta në transmetim .	reflektua	8	Sing
Ne do të fshehnim .	fshehnim	3	Plur
Unë fshehsha .	fshehsha	1	Sing
Ndërsa emri i LPRK – së u ndërrua në LPK , pra Lëvizja Popullore e Kosovës .	ndërrua	7	Sing
Ju të udhëhiqeni .	udhëhiqeni	2	Plur
Unë do të dashuroja .	dashuroja	3	Sing
Ata të zgjojnë .	zgjojnë	2	Plur
Unë ndalkësha .	ndalkësha	1	Sing
Në prill të 1999 , nënshkroi kontartë me Njujork Nikse .	nënshkroi	5	Sing
Unë interpretuakësha .	interpretuakësha	1	Sing
Ushtarët që i nxenin i dënonin në Medun , sepse aty ishte edhe gjyqi ushtarak .	nxenin	3	Plur
Unë shuajta .	shuajta	1	Sing
Ju mbaroheni .	mbaroheni	1	Plur
Ju të pomponit .	pomponit	2	Plur
Është e natyrshme të përdorim identitetin nga relativiteti ( special për energjinë ) ; pra , duke futur operatorin kuantik të vrullit impulsit , marrim ekuacionin .	marrim	24	Plur
Ju do të vinit .	vinit	3	Plur
Ne u zhvilluakemi .	zhvilluakemi	2	Plur
Muñoz u tërhoq si trajneri i kombëtares në Euro 1988 .	tërhoq	2	Sing
Ti u mësove .	mësove	2	Sing
Ata shpallnin .	shpallnin	1	Plur
Unë të përgjithësoja .	përgjithësoja	2	Sing
Ata pëlqejnë .	pëlqejnë	1	Plur
Ti të pompoje .	pompoje	2	Sing
Ata prekën .	prekën	1	Plur
P.sh hiq , dridh , mblidh , kurse foljet pjek , djeg bëjnë piq , digj , edhe foljet marr , dal bëjnë merr , dil .	pjek	9	Sing
Burimi i cili mund të konfirmohet në disa nga pjesët e tij duke iu referuar autoriteteve të jashtme , mund të besohet në tërësinë e tij nëse është e pamundur të konfirmohet në të njëjtën mënyrë i gjithë teksti .	besohet	21	Sing
Molosët banonin në pllajën pjellore të Janinës .	banonin	1	Plur
Ti gëzuake .	gëzuake	1	Sing
Ne do të shpjegojmë .	shpjegojmë	3	Plur
Ju do të shpifni .	shpifni	3	Plur
Unë justifikoj .	justifikoj	1	Sing
Ne qamë .	qamë	1	Plur
Në se vërtetohet mungesa e kuorumit gjatë mbledhjes në çastin e votimit atëhere votimi shtyhet për në mbledhjen tjetër .	vërtetohet	2	Sing
Ata qortuakan .	qortuakan	1	Plur
Ti të përkufizoje .	përkufizoje	2	Sing
Ju shurronit .	shurronit	1	Plur
Ne luftuam .	luftuam	1	Plur
Ju lënkeni .	lënkeni	1	Plur
Por ushtria ruse nuk pranoi tu ballafaqonte me ushtrinë franceze menjëherë dhe kështu filloi duke u tërhequr vazhdimisht .	ballafaqonte	6	Sing
Ata arësyetuakan .	arësyetuakan	1	Plur
Delfinët njihen jo vetëm për tu riprodhuar por ata nga njehere shfaqin edhe sjellje homoseksualiteti .	njihen	1	Plur
Po ashtu ekuacioni i ekuivalencës mundë të zbërthehet në klasa të ekuivalencës .	zbërthehet	7	Sing
Unë të admiroja .	admiroja	2	Sing
Ne do të rënkonim .	rënkonim	3	Plur
Ne qeshkemi .	qeshkemi	1	Plur
Ata bekonin .	bekonin	1	Plur
Ne skllavëronim .	skllavëronim	1	Plur
Ai të krijonte .	krijonte	2	Sing
Unë pranoja .	pranoja	1	Sing
Ti thafsh .	thafsh	1	Sing
Ju u takuakeni .	takuakeni	2	Plur
Ai të relaksohej .	relaksohej	2	Sing
Ky mision ju besua këtij patrioti të madh , sëbashku me zotin Paldeli Cale .	besua	3	Sing
Ti shpallje .	shpallje	1	Sing
Shtrihet përgjatë një lugine që rrethohet nga malet Zepa e Munella dhe bjeshka e Qafë – Kumbullës .	rrethohet	5	Sing
Ju u ngritkëshit .	ngritkëshit	2	Plur
Ai të shfuqizonte .	shfuqizonte	2	Sing
Presin ditën e kthimit të Jezusit si Krisht në tokë nga qielli , i cili do të vijë për realizimin e autioritetit njëmijë vjet para apokalipsës .	vijë	17	Sing
Ai të bisedojë .	bisedojë	2	Sing
Unë do të zbukuroj .	zbukuroj	3	Sing
Ndërsa ai fliste me mua , unë rashë në një gjumë të rëndë me fytyrë për tokë , por ai më preku dhe më bëri të ngrihem më këmbë në vendin ku ndodhesha .	ngrihem	26	Plur
Ata pshurrnin .	pshurrnin	1	Plur
Ju thekët .	thekët	1	Plur
Unë adhuruakësha .	adhuruakësha	1	Sing
Ti do të nënkuptoje .	nënkuptoje	3	Sing
Ju të afroheshit .	afroheshit	2	Plur
Shpesh inatosja me kalimin e kohës mblidhen dhe shpërthejnë nga një shkak i pavend në urrejtje .	inatosja	1	Sing
Ju u sodomizuat .	sodomizuat	2	Plur
Minarja shumëkëndshe shpreh tendencën e hollësisë maksimale .	shpreh	2	Sing
Ti të zhvilloheshe .	zhvilloheshe	2	Sing
Ju justifikuakeni .	justifikuakeni	1	Plur
Ata notuakan .	notuakan	1	Plur
Ne të pomponim .	pomponim	2	Plur
Si thua ?	thua	1	Sing
Ne shpifëm .	shpifëm	1	Plur
Midis këtyre njësive të mëdha fisnore fqinje ose më të largëta , ekzistonin marrëdhënie këmbimi .	ekzistonin	12	Plur
Ata të qëndrojnë .	qëndrojnë	2	Plur
Unë preferuakësha .	preferuakësha	1	Sing
Varfëria e detyroi familjen me tre fëmijë të lëvizë shpesh , më shumë se dhjetë herë gjatë fëmijërisë së tij .	detyroi	2	Sing
Ne përdorkëshim .	përdorkëshim	1	Plur
Ju do të tërhiqni .	tërhiqni	3	Plur
Ju të pastroni .	pastroni	2	Plur
Ti abrogon .	abrogon	1	Sing
Ne do të thekim .	thekim	3	Plur
Ne dhuruakëshim .	dhuruakëshim	1	Plur
Unë do të abdikoja .	abdikoja	3	Sing
Ne flirtuam .	flirtuam	1	Plur
Ju do të flirtonit .	flirtonit	3	Plur
Që në fillim , në shoqatë u regjistruan 60 specialistë dhe institucione , ndërsa sot numëron mbi 330 anëtarë nga 25 vende të botës .	numëron	15	Plur
Ai do të ndërlikonte .	ndërlikonte	3	Sing
Ju përparoni .	përparoni	1	Plur
Ne komunikonim .	komunikonim	1	Plur
Mbreti provoi të ikte nga deti , por si e gjeti grykën e lumit të mbyllur nga flota romake , dogji anijet e veta dhe u tërhoq nga toka për në Maqedoni me mbeturinat e ushtrisë .	tërhoq	26	Sing
Ai u hidhëroftë .	hidhëroftë	2	Sing
Ju do të bashkëvepronit .	bashkëvepronit	3	Plur
Ne parapëlqyekemi .	parapëlqyekemi	1	Plur
Ju të prishnit .	prishnit	2	Plur
Ai do të ndalojë .	ndalojë	3	Sing
Ne do të ndryshohemi .	ndryshohemi	3	Plur
Ne reagonim .	reagonim	1	Plur
Ti do të udhëtoje .	udhëtoje	3	Sing
Mund të shkaktohen si pasojë e mutacionit autozomal recesiv në gjenin SLC19A2 , që bënë kodimin e një proteine transporti me afinitet të lartë të tiaminës .	gjenin	10	Plur
Ju ngrini .	ngrini	1	Plur
Ti të masturboheshe .	masturboheshe	2	Sing
Ju patët .	patët	1	Plur
Ti do të shkëlqeje .	shkëlqeje	3	Sing
Ju pastruat .	pastruat	1	Plur
Monarkët dhe ministrat e të gjitha shteteve e kanë vizituar dhe i kanë pranuar këshillat e tij .	pranuar	13	Plur
Unë ofenduakam .	ofenduakam	1	Sing
Në atë teatër aktronte në pjesët bashkëkohore dhe klasike .	aktronte	3	Sing
Ju shurrofshit .	shurrofshit	1	Plur
Mushka e tij që po priste te dera për t ' u ngarkuar , hingëlliu sikur ta ndiente dhe ajo gjëmën që ndodhi .	ndiente	17	Sing
Llojet e kujtesës mund të klasifikohen në dy mënyra : Qëndrueshmëria e kujtimit .	klasifikohen	5	Plur
Një vit të shkollës unike e kreu në Prishtinë ndërsa shkollën e mesme në Shkodër .	kreu	6	Sing
Unë iki .	iki	1	Sing
Ju urinofshit .	urinofshit	1	Plur
Unë gënjyekam .	gënjyekam	1	Sing
Monumentet e kulturës janë të gjitha objektet që përmbajnë vlera historike , kulturore , artistike e natyrore .	përmbajnë	8	Plur
Unë të lexoj se ç' ke të shkruar ti nën kapakët e kokës , jo të mos lexoj një copë letër .	lexoj	2	Sing
Është ai që rikrijon ( ringjall ) së dyti krijesat pas vdekjes .	rikrijon	3	Plur
Ata urofshin .	urofshin	1	Plur
Ata tërheqkëshin .	tërheqkëshin	1	Plur
Ju sodomizuakeni .	sodomizuakeni	1	Plur
Ky është albumi i parë i Eagles që u lëshua në Quadraphonic .	lëshua	9	Sing
Ai shpjegon .	shpjegon	1	Sing
Ti zbukuruakëshe .	zbukuruakëshe	1	Sing
Ai hidhërohet .	hidhërohet	1	Sing
Unë peshuakam .	peshuakam	1	Sing
Më 1629 u themelua Ndërmarrja e Limanit të Masaçusetit për të ndihmuar puritanët të emigronin në Amerikë .	emigronin	14	Plur
Ai do të lëpijë .	lëpijë	3	Sing
Ti u ngritkëshe .	ngritkëshe	2	Sing
Ti do të urosh .	urosh	3	Sing
Rimorkio e parë u lirua më 4 maj 2010 .	lirua	4	Sing
Ne u ndryshuakëshim .	ndryshuakëshim	2	Plur
Ju pranuat .	pranuat	1	Plur
Por Plotini gjen shpjegimin më të mirë të së keqes në trajtimin e tij të lëndës .	gjen	2	Sing
Ju linit .	linit	1	Plur
Ju lidhni .	lidhni	1	Plur
Ata të lahen .	lahen	2	Plur
Mbretëria e Malit të Zi fillimisht i rezistoi sulmit austro – hungarez , por u dorëzua në janar të vitit 1916 .	rezistoi	7	Sing
Ata të relaksohen .	relaksohen	2	Plur
Disa kompozitorë dhe orkestra të mëdha refuzojnë të luajnë krijimet e Howell , duke i cilësuar si shumë të diskutueshme .	refuzojnë	6	Plur
USBE po ashtu pranon një numër të madh studentësh ndërkombëtarë .	pranon	3	Sing
Ju ligjëruakeni .	ligjëruakeni	1	Plur
Ju të uronit .	uronit	2	Plur
Ti të shtegtosh .	shtegtosh	2	Sing
Ti të ngriheshe .	ngriheshe	2	Sing
Ne kërcyem .	kërcyem	1	Plur
Ti prishkëshe .	prishkëshe	1	Sing
Ata të tërheqin .	tërheqin	2	Plur
Unë do të pompoja .	pompoja	3	Sing
Ata të ndërlikonin .	ndërlikonin	2	Plur
Ai të shkërdhente .	shkërdhente	2	Sing
Ai do të sakrifikojë .	sakrifikojë	3	Sing
U tha që kur ta zërë gjumi t’ia prejnë fytin .	zërë	5	Sing
Ai besonte .	besonte	1	Sing
Unë harroja .	harroja	1	Sing
Ti të armatosësh .	armatosësh	2	Sing
Unë ikia .	ikia	1	Sing
Ju dhunofshit .	dhunofshit	1	Plur
Ti do të qash .	qash	3	Sing
Unë luftoj .	luftoj	1	Sing
Ai shpirtëroi .	shpirtëroi	1	Sing
Polet dhe zerot potenciale nepër të cilat mund të kalojë lakorja e Nyquist ndodhen në boshtin imagjinarë .	kalojë	9	Sing
Ata të qeshnin .	qeshnin	2	Plur
Unë të ofendoj .	ofendoj	2	Sing
Ju krijuakeni .	krijuakeni	1	Plur
Ju grumbullofshit .	grumbullofshit	1	Plur
Përpara pak vjetësh , skenaristi Xhejms Hilton xhiroi një dokumentar të titulluar " Horizonte të humbura " ( Lost Horizons ) .	xhiroi	7	Sing
Ne ndenjçim .	ndenjçim	1	Plur
Ti të krijoje .	krijoje	2	Sing
Ai u zgjuaka .	zgjuaka	2	Sing
Çrregullimet vizuale siç janë hipermetropia , astigmatizmi , miopia , glaukoma etj , përcillen me dhembje koke .	glaukoma	10	Sing
Ai shkërdhen .	shkërdhen	1	Sing
Ju ndihmonit .	ndihmonit	1	Plur
Ti të shpallësh .	shpallësh	2	Sing
Ne fillonim .	fillonim	1	Plur
Ata duruakëshin .	duruakëshin	1	Plur
Ndërsa disa tregtarë të Voskopojës dhe Vithkuqit emigruan në Vjenë , Budapest dhe qytete të tjera të Evropës dhe vazhduan aktivitetet tregtare të tyre .	vazhduan	19	Plur
Ne shkërdhenim .	shkërdhenim	1	Plur
Ata do të mëndin .	mëndin	3	Plur
Ai të provojë .	provojë	2	Sing
Ai rrezikoi .	rrezikoi	1	Sing
Ai do të mbarohet .	mbarohet	3	Sing
Unë sulmohesha .	sulmohesha	1	Sing
Ju vazhdoni .	vazhdoni	1	Plur
Për jetën e tij dihet fort pak .	dihet	4	Sing
Një mangësi e këtyre është se krijojnë zhurmë .	krijojnë	6	Plur
Ne të themelojmë .	themelojmë	2	Plur
Unë u masturbova .	masturbova	2	Sing
Ndërsa kur erdhi dita e varrimit të dyja kufomat u ndodhën në një arkivol dhe ishte e pamundur të ndaheshin nga njëra-tjetra .	ndaheshin	19	Plur
Ne dhunojmë .	dhunojmë	1	Plur
Ne u mbaruam .	mbaruam	2	Plur
Ne të shurrojmë .	shurrojmë	2	Plur
Ju copëtuat .	copëtuat	1	Plur
Unë injorova .	injorova	1	Sing
Unë shpresuakam .	shpresuakam	1	Sing
Nuk do të thotë se çdo rast që dërgohet në gjykatë përbën krim .	dërgohet	8	Sing
Dy ekspedita të organizaura nga Instituti Albanologjik i Prishtinës dhe nga Instituti i Kulturës Popullore i Tiranës kanë punuar me të dhe këto materiale ruhen me kujdes në arkivat shkencorë të tyre .	ruhen	24	Plur
Në bazë të këtyre nyjave gjarpëri mund ta zgjerojë trupin e vet më shumë .	zgjerojë	8	Sing
U çudit plaku dhe ia nguli sytë e vetë vajzës .	çudit	1	Sing
Unë do të peshohesha .	peshohesha	3	Sing
Ata gënjyen .	gënjyen	1	Plur
Ti të hash .	hash	2	Sing
Ti të dëmtoje .	dëmtoje	2	Sing
Ju përgjithësoni .	përgjithësoni	1	Plur
Ti theke .	theke	1	Sing
Ai ëndërroftë .	ëndërroftë	1	Sing
Nuk është i vogël numri i banorëve që punojnë dhe jetojnë përkohësisht jasht vendit .	punojnë	8	Plur
Shpirti luftarak nuk e linte të qetë të shihte Kosovën të robëruar nga pushtuesit serbo-sllavë .	linte	4	Sing
Megjithëse avionët e survejimit pa pilot u përdorën gjërësisht , shpesh avionët e sulmit nuk mund të silleshin shpejt në kohë për të qëlluar shënjestrat në momentin e duhur .	silleshin	17	Plur
Ata përdorkan .	përdorkan	1	Plur
Mendohej se historia e ndërtimit të këtij qyteti datonte prej vitit 311 para erës së re .	datonte	8	Sing
Ai lëshoi .	lëshoi	1	Sing
Dhe atëherë nisi të luftojë me trimëri për të sjellë lirinë .	luftojë	4	Sing
Ne të masnim .	masnim	2	Plur
Parësore për kristologjinë është pyetja se si bashkëjeton në një person hyjnorja dhe njerëzorja tek Jezusi , dhe dytësore hollësitë e jetës së tij .	bashkëjeton	7	Sing
Ai pëlqeftë .	pëlqeftë	1	Sing
Ai zhvilloftë .	zhvilloftë	1	Sing
Unë masturbova .	masturbova	1	Sing
Unë do të pëlqej .	pëlqej	3	Sing
Ne të tradhëtonim .	tradhëtonim	2	Plur
Ata do të konsistojnë .	konsistojnë	3	Plur
Ju do të armatosnit .	armatosnit	3	Plur
Ti injoruake .	injoruake	1	Sing
Rëndësi i kushtohet Luftës së Spanjës dhe vullnetarëve shqiptarë që morën pjesë .	morën	10	Plur
Shquhet për dy ligjet e tij mbi gazrat .	Shquhet	0	Sing
Ne të sajonim .	sajonim	2	Plur
Ata të armatosnin .	armatosnin	2	Plur
Ju adhuroni .	adhuroni	1	Plur
Ne të interpretonim .	interpretonim	2	Plur
Ne të mbulojmë .	mbulojmë	2	Plur
Ju shkretoni .	shkretoni	1	Plur
Ata argëtuakëshin .	argëtuakëshin	1	Plur
Unë luftofsha .	luftofsha	1	Sing
Është ai që rikrijon ( ringjall ) së dyti krijesat pas vdekjes .	ringjall	5	Plur
Ata ikiin .	ikiin	1	Plur
Ne të fshehim .	fshehim	2	Plur
Ti dhembje .	dhembje	1	Sing
P . sh : Sikur ai të dëshironte të digjte pasurinë e tij , apo të rrihte kafshën e tij , ne do të thoshim : Kjo nuk lejohet .	thoshim	24	Plur
Unë të udhëtoja .	udhëtoja	2	Sing
Ju shikuat .	shikuat	1	Plur
Janë shtretër të qëndisur me ar .	Janë	0	Plur
Ata nënkuptuan .	nënkuptuan	1	Plur
Ti Pluragoje .	Pluragoje	1	Sing
Ne pëlqenim .	pëlqenim	1	Plur
Unë u abonuakam .	abonuakam	2	Sing
Ju të vinit .	vinit	2	Plur
Ai u shurruaka .	shurruaka	2	Sing
Një metodë tjetër e thyerjes së këtij algoritmi është kur e shfrytëzojmë atë për enkriptimin e ndonjë çelësi që dëshirojmë ta dërgojmë .	dëshirojmë	19	Plur
Ti përdorkëshe .	përdorkëshe	1	Sing
Megjithëse Gjermania është një vend i pasur me minerale ajo preferon më shumë që t ’ i importojë ato me qëllim që të mos pakësojë mineralet e brendshme .	pakësojë	24	Plur
Ju thoshit .	thoshit	1	Plur
Ti të mardhësh .	mardhësh	2	Sing
Ata të mbarohen .	mbarohen	2	Plur
Ata sqaruakëshin .	sqaruakëshin	1	Plur
Ju do të ndihmonit .	ndihmonit	3	Plur
Vija e një peme të vetme për shembull mbulon një periudhë kohore 50 vjeçare .	mbulon	8	Sing
Ju të pranoni .	pranoni	2	Plur
Ata zhvilloheshin .	zhvilloheshin	1	Plur
Ne ikikëshim .	ikikëshim	1	Plur
Ne fërkuam .	fërkuam	1	Plur
Në luftën që zhvilloi i theu keq Romakët por edhe Epirotët pësuan humbje të mëdha .	zhvilloi	3	Sing
Luftëtarët u përleshën aq ashpër me njëri-tjetrin , sa që të dy palët lanë mënjanë hutat dhe nxorën jataganët , duke u përleshur trup me trup .	përleshën	2	Plur
Ndarja e ngarkesës çon në krijimin e një fushe elektrike që është në drejtim të kundërt të migrimit të ngarkesës , pra që vepron kundër ngarkesave , kështu që një potencial elektrik fillon të krijohet përsa kohë ngarkesa rrjedh .	vepron	23	Sing
Ai të bashkëvepronte .	bashkëvepronte	2	Sing
Vijnë e ikin vazhdimisht kufitarë e aty lulëzojnë pa pushim lule të bukura shumëngjyrshe .	ikin	2	Plur
Ne do të veçonim .	veçonim	3	Plur
Panchen Lama vdiq më 1989 , dhe Dalai Lama dhe autoritetet kineze njohën rimëshirime të ndryshme .	njohën	12	Plur
Ti bekoje .	bekoje	1	Sing
Ti u abonuake .	abonuake	2	Sing
Prej vitit 2002 punon në Shtetet e Bashkuara të Amerikës ku ka realizuar disa shfaqje .	punon	3	Sing
Ti përmirëson .	përmirëson	1	Sing
Ai votoi .	votoi	1	Sing
Unë të mënd .	mënd	2	Sing
Ata ndryshonin .	ndryshonin	1	Plur
Sot ky monument vizitohet nga shumë turistë vendas dhe të huaj .	vizitohet	3	Sing
Nëse hiqen rreshkat e plagës , ngadalësohet procesi i shërimit .	hiqen	1	Plur
Ai paka .	paka	1	Sing
Unë të mësoj .	mësoj	2	Sing
Unë ikisha .	ikisha	1	Sing
Ai ngritka .	ngritka	1	Sing
Unë ndihmofsha .	ndihmofsha	1	Sing
Ne lëpikemi .	lëpikemi	1	Plur
Në HTML lidhjet krijohen duke përdorur elementet <a> .	krijohen	3	Plur
Ti shtrembëroje .	shtrembëroje	1	Sing
Unë t ’ i dhuroj .	dhuroj	4	Sing
Ai palloftë .	palloftë	1	Sing
Ti dhënkëshe .	dhënkëshe	1	Sing
Krenohesha se , duke jetuar e punuar me punëtorët malësorë , edhe unë do të bëhesha si ata .	Krenohesha	0	Sing
Ne punësofshim .	punësofshim	1	Plur
Ata lidhën .	lidhën	1	Plur
Ju hapni .	hapni	1	Plur
Ti komunikofsh .	komunikofsh	1	Sing
Ai sajoftë .	sajoftë	1	Sing
Ai mirëson .	mirëson	1	Sing
Ti abstenofsh .	abstenofsh	1	Sing
Ju do të peshoheni .	peshoheni	3	Plur
Ata thjeshtëzojnë .	thjeshtëzojnë	1	Plur
Ju abdikonit .	abdikonit	1	Plur
Ti do të organizosh .	organizosh	3	Sing
Unë do të mas .	mas	3	Sing
Ti çliruakëshe .	çliruakëshe	1	Sing
Ju tradhëtuat .	tradhëtuat	1	Plur
Ti do të përmirësosh .	përmirësosh	3	Sing
Ti do të afroheshe .	afroheshe	3	Sing
Pjesa më e madhe e artizanëve e braktisën tërësisht profesionin ose e ushtronin atë vetëm si aftësi për të përmbushur nevojat e ekonomisë familjare .	braktisën	7	Plur
Ju interpretonit .	interpretonit	1	Plur
Ndërkohë që antifashistët i shkruanin këto parrulla natën , gjërmanët i zbulonin dhe i prishnin ditën me qëllim që populli të mos ndërmerte ndonjë demostratë .	prishnin	14	Plur
Ju të fshini .	fshini	2	Plur
Ju shqipuat .	shqipuat	1	Plur
Mund të pijnë nga gotë speciale për ta .	pijnë	2	Plur
Ai sqaruaka .	sqaruaka	1	Sing
Ata të avullojnë .	avullojnë	2	Plur
Ai bashkëpunon .	bashkëpunon	1	Sing
Ju ndenjkëshit .	ndenjkëshit	1	Plur
Ne qikemi .	qikemi	1	Plur
Unë fshija .	fshija	1	Sing
Unë ndenjkësha .	ndenjkësha	1	Sing
Unë të abrogoj .	abrogoj	2	Sing
Ai do të prekte .	prekte	3	Sing
Unë arësyetoja .	arësyetoja	1	Sing
Ti të miqësohesh .	miqësohesh	2	Sing
Molekula përbëhet nga thërmija akoma më të vogla që quhen atome të cilat nuk i ruajnë vetitë e lëndës .	ruajnë	15	Plur
Ti mësoje .	mësoje	1	Sing
Ti bashkëvepruakëshe .	bashkëvepruakëshe	1	Sing
Ata buzëqeshkëshin .	buzëqeshkëshin	1	Plur
Ata stimulonin .	stimulonin	1	Plur
Ne themelojmë .	themelojmë	1	Plur
Ai do të absorbojë .	absorbojë	3	Sing
Ai do të dërgonte .	dërgonte	3	Sing
Ai ndihi .	ndihi	1	Sing
Ai grumbullonte .	grumbullonte	1	Sing
Vendi i parë ( dhe i vetëm për vitin 2006 ) që e ratifikoi MSA BE – Shqipëri ishte Letonia ( 19 dhjetor 2006 ) .	ratifikoi	13	Sing
Ju dhuronit .	dhuronit	1	Plur
Ata do të keqkuptojnë .	keqkuptojnë	3	Plur
Ai do të shkërdhente .	shkërdhente	3	Sing
Varësisht prej procesit fitohen lloje të ndryshme të najloneve me veti të ndryshme .	fitohen	3	Plur
Ai do të dashurojë .	dashurojë	3	Sing
Ai armatoste .	armatoste	1	Sing
Ti bashkëpunon .	bashkëpunon	1	Sing
Unë të arësyetoj .	arësyetoj	2	Sing
Unë të konsistoj .	konsistoj	2	Sing
Unë po arnoja pantallonat , që të mos vija me gjunjë zbuluar , kushëriri po grryente qymyr brenda .	grryente	15	Sing
Rilindësit u kapën sidomos pas origjinës së lashtë të shqiptarëve dhe pas epokës së Skënderbeut .	kapën	2	Plur
Unë shurrohesha .	shurrohesha	1	Sing
Ne do të nderojmë .	nderojmë	3	Plur
Ti mbarofsh .	mbarofsh	1	Sing
Për fat të mirë dhe falë këmbënguljes dhe aftësisë profesionale , në vitin 1959 arkeologu durrsak Vangjel Toçi , e rizbuloi mozaikun 2300 vjeçar .	rizbuloi	20	Sing
Ndërkohë që antifashistët i shkruanin këto parrulla natën , gjërmanët i zbulonin dhe i prishnin ditën me qëllim që populli të mos ndërmerte ndonjë demostratë .	ndërmerte	22	Sing
Ju vinit .	vinit	1	Plur
Unë gënjej .	gënjej	1	Sing
Ti do të përparosh .	përparosh	3	Sing
Minimalet absolute të temperaturës lëvizin nga -10 deri -15 °C , në dimra shumë të ftohtë temp zbret deri në -20 °C .	lëvizin	4	Plur
Ju zbukuruat .	zbukuruat	1	Plur
Unë të nënkuptoja .	nënkuptoja	2	Sing
Ti të komunikoje .	komunikoje	2	Sing
Ata do të kafshonin .	kafshonin	3	Plur
Ne stopoheshim .	stopoheshim	1	Plur
Për arritjen e fitores përfundimtare mbi pushtuesit nazifashistë , populli i Vranishtit sakrifikoi jo pak .	sakrifikoi	12	Sing
Unë degjoja .	degjoja	1	Sing
Ti skllavëruakëshe .	skllavëruakëshe	1	Sing
Unë takuakësha .	takuakësha	1	Sing
Ne të përmirësonim .	përmirësonim	2	Plur
Me këtë vërtetojnë se janë popull që nuk kupton .	kupton	8	Sing
Ai do të përmirësojë .	përmirësojë	3	Sing
Ata kundërthoshin .	kundërthoshin	1	Plur
Ne urinuam .	urinuam	1	Plur
Ti do të besoje .	besoje	3	Sing
Po ashtu këta e refuzuan ta adhurojnë vetëm Allahun .	adhurojnë	6	Plur
Ai mbaroi .	mbaroi	1	Sing
Ata do të përparojnë .	përparojnë	3	Plur
Ju parapëlqenit .	parapëlqenit	1	Plur
Ne ndërlikofshim .	ndërlikofshim	1	Plur
Ne të transferonim .	transferonim	2	Plur
Ata fshifshin .	fshifshin	1	Plur
Biti i parë dhe fundit i një hyrje përcaktojnë rreshtin e elementit ndërsa 4 bitat e tjerë përcaktojnë kolonën përkatëse dhe kështu në dalje të secilit nga S-boxat do të këmi 4 bite .	përcaktojnë	17	Plur
Unë të shkretoj .	shkretoj	2	Sing
Ai do të kafshonte .	kafshonte	3	Sing
Ti do të vish .	vish	3	Sing
Ti të mendosh .	mendosh	2	Sing
Ne qortonim .	qortonim	1	Plur
Ju ëndërrofshit .	ëndërrofshit	1	Plur
Unë të jepja .	jepja	2	Sing
Ata ikiën .	ikiën	1	Plur
Për këtë , në një tenxhere hidhet yndyrë dhe pasi ajo të jetë nxehur shtohet miell , kaurdiset derisa të zverdhet pak dhe pastaj shtohen plëncat e zier .	shtohen	24	Plur
Ai të përkëdhelte .	përkëdhelte	2	Sing
Shtëpia e tij u dogj nga komunistët në vitin 1944 .	dogj	4	Sing
Ata të urronin .	urronin	2	Plur
Ata shpresuakëshin .	shpresuakëshin	1	Plur
Ne sqarojmë .	sqarojmë	1	Plur
Unë ngacmuakësha .	ngacmuakësha	1	Sing
Ju do të pomponi .	pomponi	3	Plur
Ne të ndihnim .	ndihnim	2	Plur
Në vitin 1492 , ai fillonte të studjonte në Oxford dhe morri edukimin klasike .	studjonte	7	Sing
Ne shqipuakëshim .	shqipuakëshim	1	Plur
Ju uronit .	uronit	1	Plur
Mbrojtja e Ulqinit vlerësohej si luftë për të gjithë popullin shqiptar .	vlerësohej	3	Sing
Ata do të mëndnin .	mëndnin	3	Plur
E do të mbetej bir i njerëzve të thjeshtë që do ta fshihnin , do ta strehonin e do ndanin me të bukën e fëmijëve .	fshihnin	12	Sing
Ai të themelojë .	themelojë	2	Sing
Ai u stopoi .	stopoi	2	Sing
Unë u zgjova .	zgjova	2	Sing
Ne dëshironim .	dëshironim	1	Plur
Ne keqkuptonim .	keqkuptonim	1	Plur
Ju patë .	patë	1	Plur
Ai abrogoftë .	abrogoftë	1	Sing
Ju të adhuronit .	adhuronit	2	Plur
Ti u masturbuakëshe .	masturbuakëshe	2	Sing
Ata të mësohen .	mësohen	2	Plur
Ata armatoskan .	armatoskan	1	Plur
Ata ndihmonin .	ndihmonin	1	Plur
Ju do të urrenit .	urrenit	3	Plur
Unë do të transferoj .	transferoj	3	Sing
Ata njoftuakëshin .	njoftuakëshin	1	Plur
Ju kundërshtuat .	kundërshtuat	1	Plur
Ne përsosëm .	përsosëm	1	Plur
Ai të përdorte .	përdorte	2	Sing
Ti të trishtohesh .	trishtohesh	2	Sing
Shumë Bllacjanë humbën jetën në Tivar .	humbën	2	Plur
Ai të përdorë .	përdorë	2	Sing
Ti urrefsh .	urrefsh	1	Sing
Ata të Pluragojnë .	Pluragojnë	2	Plur
Ai do të lëshojë .	lëshojë	3	Sing
Ti masturboje .	masturboje	1	Sing
Unë të dëmtoj .	dëmtoj	2	Sing
Ata abuzuan .	abuzuan	1	Plur
Unë zgjedh .	zgjedh	1	Sing
Unë Pluraguakam .	Pluraguakam	1	Sing
Ne do të vazhdonim .	vazhdonim	3	Plur
Ti dashuruakëshe .	dashuruakëshe	1	Sing
Ai të prishë .	prishë	2	Sing
Ne do të ndalonim .	ndalonim	3	Plur
Ju urinuakëshit .	urinuakëshit	1	Plur
Paçja mund të përgatitet edhe e përzier me kokë e këmbë bashkë .	përzier	6	Sing
Derisa të vinte koha , ruhej fantazia se sundimtarët në Evropën perëndimore , si ata të sllavëve , e mbanin autoritetin e tyre të mbështetur në marrëdhënien e tyre të veçante me perandorin e vetëm të vërtetë në Konstandinopojë .	ruhej	5	Sing
Ju të stimulonit .	stimulonit	2	Plur
Ai të thjeshtëzonte .	thjeshtëzonte	2	Sing
Ti të zhvirgjërosh .	zhvirgjërosh	2	Sing
Ju të ndryshoheshit .	ndryshoheshit	2	Plur
Ti qafsh .	qafsh	1	Sing
Ju transferuat .	transferuat	1	Plur
Ne zgjuam .	zgjuam	1	Plur
Ti të thaje .	thaje	2	Sing
Ti gëzove .	gëzove	1	Sing
Ju ndryshoheshit .	ndryshoheshit	1	Plur
Unë bekofsha .	bekofsha	1	Sing
Ju do të reagoni .	reagoni	3	Plur
Megjithëse agjërimi është sublim , lumturi për këtë jetë dhe për jetën tjetër , duhanxhiu pak çan kokën .	çan	16	Plur
Ju arsimuakeni .	arsimuakeni	1	Plur
Ata votuan .	votuan	1	Plur
Unë ngrij .	ngrij	1	Sing
Ne udhëtuam .	udhëtuam	1	Plur
Në vitin 1918 u zgjodh anëtar i komitetit " Mbrojtja Kombëtare e Kosovës " dhe u bë një nga udhëheqësit e tij kryesore .	zgjodh	4	Sing
Ju zgjoheshit .	zgjoheshit	1	Plur
Unë mësofsha .	mësofsha	1	Sing
Ai ndal .	ndal	1	Sing
Ti përsossh .	përsossh	1	Sing
Duhani , mëndafshi , panxharsheqeri , luledielli përbënin pjesën më të madhe të eksporteve .	përbënin	7	Plur
More , për t ' u lodhur s' u lodha , po u laga .	lodha	9	Sing
Shumë kohë i dedikohet punës së dorës të të gjitha llojeve .	dedikohet	3	Sing
Ne të udhëtonim .	udhëtonim	2	Plur
Ata përsoskan .	përsoskan	1	Plur
Unë të dhunoja .	dhunoja	2	Sing
Ata të fshinin .	fshinin	2	Plur
Unë mbuloj .	mbuloj	1	Sing
Luteri shqetësohej sepse popullit iu mbush mendja se nuk kërkohej asnjë pendesë tjetër .	shqetësohej	1	Sing
Unë sulmofsha .	sulmofsha	1	Sing
Unë dhunova .	dhunova	1	Sing
Ne dëmtonim .	dëmtonim	1	Plur
Ti të haje .	haje	2	Sing
Unë të shtegtoja .	shtegtoja	2	Sing
Ata të shkatërronin .	shkatërronin	2	Plur
" Bota sot " : Në këtë kohë flitej se mungonte bashkëpunimi në mes të forcave shqiptare të armatosura që verponin në Kosovë .	mungonte	10	Sing
Ju ndalofshit .	ndalofshit	1	Plur
Ne do të theknim .	theknim	3	Plur
Ne të shpirtëronim .	shpirtëronim	2	Plur
Ju relaksoheshit .	relaksoheshit	1	Plur
Ata do të mirësonin .	mirësonin	3	Plur
Ju shkatërronit .	shkatërronit	1	Plur
Unë avullofsha .	avullofsha	1	Sing
Mbeturinat e hedhura shpeshherë digjen dhe në të njëjtën kohë paraqesin rrezik permanent për përhapjen e zjarrit edhe në pjesët tjera të pyllit .	digjen	4	Plur
Ta kishit veshur po të donit kokën , pyllin aty e kishit , mu përgjigj .	përgjigj	14	Sing
Ju komunikuat .	komunikuat	1	Plur
Unë u zgjuakësha .	zgjuakësha	2	Sing
Ne do të dhunojmë .	dhunojmë	3	Plur
Ai do të shpifë .	shpifë	3	Sing
Një tip i ri librash përkushtimor , librat e orëve , lindën për përdorimin vetiak , që përmbanin ilustrime në miniaturë mjaft fine .	lindën	11	Plur
Ju transferofshit .	transferofshit	1	Plur
Ata punësonin .	punësonin	1	Plur
Ata të thekin .	thekin	2	Plur
Pijet alkoolike , duhanin dhe futjen nëpër punët shtetërore i llogaritin të ndaluara .	llogaritin	10	Plur
Unë organizoj .	organizoj	1	Sing
Pas dështimit për të hyrë në ekipin e parë , megjithatë , ai u huazua tek Recreativo de Huelva për të fituar përvojë .	huazua	14	Sing
Ti përfitoje .	përfitoje	1	Sing
Ti thekke .	thekke	1	Sing
Man Tola u trashëgua nga tre djem , pasardhësit e të cilëve krijuan : Vllaznia Smahilallarë .	trashëgua	3	Sing
Ju argëtuat .	argëtuat	1	Plur
Ai ndërlikonte .	ndërlikonte	1	Sing
Ju interpretoni .	interpretoni	1	Plur
Ata grumbullojnë .	grumbullojnë	1	Plur
Brenda kllapave të trupit të destruktorit vendoset komanda delete , në vazhdim të së cilës shënohen variablat e klasës të cilat duhet të fshihen , të ndara mes vete me presje .	fshihen	23	Plur
Veproi në qytetin e Vlorës .	Veproi	0	Sing
Ata përgjithësonin .	përgjithësonin	1	Plur
Ai do të pallonte .	pallonte	3	Sing
Ti të ndihmosh .	ndihmosh	2	Sing
Ti hape .	hape	1	Sing
Ata të harrojnë .	harrojnë	2	Plur
Unë të aSingjësoja .	aSingjësoja	2	Sing
Ju tërhiqnit .	tërhiqnit	1	Plur
Ne përdorim .	përdorim	1	Plur
Ai u masturbuaka .	masturbuaka	2	Sing
Ai pastroftë .	pastroftë	1	Sing
Poashtu në mars 2014 , ai morri pjesë në kombëtaren kosovare në ndeshjen kundër Haitit .	morri	6	Sing
Unë konsistoja .	konsistoja	1	Sing
Ju zbehnit .	zbehnit	1	Plur
Ti qave .	qave	1	Sing
Në vend të saj ndërtohet një kishë e vogël .	ndërtohet	4	Sing
Pak minuta më vonë , mbyllën edhe urat dhe tunelet në New York .	mbyllën	5	Plur
Ti dërmuakëshe .	dërmuakëshe	1	Sing
Ne do të mbulonim .	mbulonim	3	Plur
Ata shpallkëshin .	shpallkëshin	1	Plur
Ti the .	the	1	Sing
Disa mesfushore luajnë një rol mbrojtës ndërsa disa të tjerë luajnë rol sulmues .	luajnë	2	Plur
Unë abonohem .	abonohem	1	Sing
Ju do të peshoni .	peshoni	3	Plur
Shkruan krysisht prozë , për fëmijë e për të rritur .	Shkruan	0	Plur
Ne do të propozonim .	propozonim	3	Plur
Attila e sumoi perandorine dhe fitoi disa beteja me rradhe duke pushtuar keshtu Strasburgun , Metzin , Reimsin , Amiensin , Turnain dhe Cambriain .	sumoi	2	Sing
Volumi i parë u publikua më 5 janar 2002 dhe deri më dhjetor 2010 janë publikuar 48 volume .	publikua	4	Sing
Strukturat me të cilat njerëzit i japin kuptim jetës se tyre në përditshmëri ai i konsideron konstruksione arbitrare njerëzore .	japin	6	Plur
Luftëtarët u përleshën aq ashpër me njëri-tjetrin , sa që të dy palët lanë mënjanë hutat dhe nxorën jataganët , duke u përleshur trup me trup .	lanë	13	Plur
Ju të fërgoni .	fërgoni	2	Plur
Ju të përkëdhelni .	përkëdhelni	2	Plur
Për të respektuar kronologjinë e botimeve po ndalemi tek vepra e parë .	respektuar	2	Sing
Me Jugosllavinë marrëdhëniet e mira pengoheshin nga veprimet e bandave maqedonase .	pengoheshin	5	Plur
Ata do të mendonin .	mendonin	3	Plur
Ti pëlqyeke .	pëlqyeke	1	Sing
Ne do të ndryshojmë .	ndryshojmë	3	Plur
Unë do të ngre .	ngre	3	Sing
Marrëdhëniet midis vëllezërve rregulloheshin në bazë të moshës .	rregulloheshin	3	Plur
Ju ndihnit .	ndihnit	1	Plur
Ti përgjithësove .	përgjithësove	1	Sing
Unë zhvillohesha .	zhvillohesha	1	Sing
Ti rrije .	rrije	1	Sing
Ne prodhuakemi .	prodhuakemi	1	Plur
Unë ledhatofsha .	ledhatofsha	1	Sing
Mbreti provoi të ikte nga deti , por si e gjeti grykën e lumit të mbyllur nga flota romake , dogji anijet e veta dhe u tërhoq nga toka për në Maqedoni me mbeturinat e ushtrisë .	gjeti	10	Sing
Ju abonoheshit .	abonoheshit	1	Plur
Ne hapkëshim .	hapkëshim	1	Plur
Ata të provojnë .	provojnë	2	Plur
Murati hypi në fron më 1919 pas vdekjes së të atit , Në moshën 16 vjeç .	hypi	1	Sing
Ju të abstenoni .	abstenoni	2	Plur
Ne keqkuptojmë .	keqkuptojmë	1	Plur
Unë do të justifikoja .	justifikoja	3	Sing
Ne gëzuakemi .	gëzuakemi	1	Plur
Ata të fërgojnë .	fërgojnë	2	Plur
Ju të thekni .	thekni	2	Plur
Ata harruakëshin .	harruakëshin	1	Plur
Ne do të sakrifikonim .	sakrifikonim	3	Plur
Ju të qëndroni .	qëndroni	2	Plur
Ne u zgjofshim .	zgjofshim	2	Plur
Ju kafshuakëshit .	kafshuakëshit	1	Plur
Ai dhuronte .	dhuronte	1	Sing
Ti do të shImpoje .	shImpoje	3	Sing
Ne ëndërrojmë .	ëndërrojmë	1	Plur
Ju të abuzonit .	abuzonit	2	Plur
Ata të interpretonin .	interpretonin	2	Plur
Ne ndryshohemi .	ndryshohemi	1	Plur
Disa refuzuan sistemin që ka në krye një peshkop ; ata parapëlqejnë një organ mbikëqyrës në krye .	refuzuan	1	Plur
Ju mësuat .	mësuat	1	Plur
Ju të mbaroheni .	mbaroheni	2	Plur
Unë të afirmoj .	afirmoj	2	Sing
Ne lëshojmë .	lëshojmë	1	Plur
Shpejtësia efektive e dritës në substanca të ndryshme transparente që përmbajnë materie të zakonshme , është më e vogël se në vakuum .	përmbajnë	10	Plur
Ti justifikuake .	justifikuake	1	Sing
Ai krijonte .	krijonte	1	Sing
Me kalimin e dimrit dhe ardhjen e pranverës Majlinda me shoqet e lëshon në liri zogun .	lëshon	12	Sing
Ju kërkuat .	kërkuat	1	Plur
Ti keqkuptuake .	keqkuptuake	1	Sing
Ata rrezikuakan .	rrezikuakan	1	Plur
Ti të udhëtosh .	udhëtosh	2	Sing
Ai shkëlqeu .	shkëlqeu	1	Sing
Unë qakam .	qakam	1	Sing
Ai shtegtuakësh .	shtegtuakësh	1	Sing
Ai abdikuakësh .	abdikuakësh	1	Sing
Ai të takohet .	takohet	2	Sing
Ai do të mësohet .	mësohet	3	Sing
Ne të përfitojmë .	përfitojmë	2	Plur
Ti do të zgjedhësh .	zgjedhësh	3	Sing
Motorrat e mëvonshëm u emërtuan C20LN për të treguar ndryshimet në zvogëlimin e zhurmës dhe diametrin më të ngushtë të kokës së cilindrit në përputhje me rregullat e BE – së .	emërtuan	4	Plur
Unë do të zhvillohesha .	zhvillohesha	3	Sing
Unë të fërkoja .	fërkoja	2	Sing
Ju do të themeloni .	themeloni	3	Plur
Ti do të arësyetoje .	arësyetoje	3	Sing
Ata reaguakan .	reaguakan	1	Plur
Ata komunikuan .	komunikuan	1	Plur
Në qoftë se ata denoncoheshin me sukses tek policia , mund të dënoheshin me vdekje .	dënoheshin	12	Plur
Ju të shpresoni .	shpresoni	2	Plur
Ju biseduakeni .	biseduakeni	1	Plur
Më 1958 mbaroi degën e Gjuhës e të Letërsisë në Universitetin e Tiranës ku diplomohet për Mësuesi .	mbaroi	2	Sing
Unë shpifja .	shpifja	1	Sing
Ti zbukurofsh .	zbukurofsh	1	Sing
Ju të duroni .	duroni	2	Plur
Secila sonatë u shkrua për instrumente të ndryshme .	shkrua	3	Sing
Ata grumbulluakan .	grumbulluakan	1	Plur
Ju do të pastronit .	pastronit	3	Plur
Sezoni u përqendrua rreth rivalitetit mes Alonsos dhe Shumakerit , ku secili fitoi nga shtatë gara .	përqendrua	2	Sing
Ju dhuruakeni .	dhuruakeni	1	Plur
Thuhet se edhe ajo që mbijetoi u arrit të shpëtohej për shkak të statusit të saj si monument kulture .	shpëtohej	9	Sing
Ti kafshofsh .	kafshofsh	1	Sing
Ti të votosh .	votosh	2	Sing
Ju do të qeshnit .	qeshnit	3	Plur
S’ linin gjë pa ngatërruar .	linin	1	Plur
Ai qortoi .	qortoi	1	Sing
Unë dhembkam .	dhembkam	1	Sing
Shumë nga këta monumente ishin varre megalitike dhe arkeologët hamendësojnë se shumica kanë kuptim fetar .	hamendësojnë	9	Plur
Ata Admironin .	Admironin	1	Plur
Ju çlirofshit .	çlirofshit	1	Plur
Ti të kesh .	kesh	2	Sing
për dallim nga koncepti multitasking , gjatë shfrytëzim të koncept multithredi , për thred e veçantë sistemi operativ nuk rezervon memorie dhe variabla të veçanta .	rezervon	19	Sing
Ai do të prishë .	prishë	3	Sing
Ne pompofshim .	pompofshim	1	Plur
Unë avulluakësha .	avulluakësha	1	Sing
Ti ëndërruakëshe .	ëndërruakëshe	1	Sing
Ju Pluragoni .	Pluragoni	1	Plur
Ata përparojnë .	përparojnë	1	Plur
Nuk shërbeu si mësues , sepse pas maturës u burgos përshka të veprimtarisë komuniste .	burgos	9	Plur
Ata arësyetojnë .	arësyetojnë	1	Plur
Secila palë ka të drejtë , për këtë vendos gjyqi .	vendos	8	Sing
Ata prodhuan .	prodhuan	1	Plur
Ju do të zgjedhni .	zgjedhni	3	Plur
Ne kundërthënkëshim .	kundërthënkëshim	1	Plur
Unë do të kundërthem .	kundërthem	3	Sing
Unë asnjanësofsha .	asnjanësofsha	1	Sing
Ata përparonin .	përparonin	1	Plur
Ai shikuakësh .	shikuakësh	1	Sing
Për shumicën e kalorësve të mesjetës momenti magjik ishte fillimi i kryqëzatave , gjatë të cilave ata arritën të grumbullonin pasuri të mëdha .	grumbullonin	19	Plur
Ti takohesh .	takohesh	1	Sing
Ata do të ndryshonin .	ndryshonin	3	Plur
Shpatat të stilit katana dhe masamune me një përpunim të rafinuar , tregtoheshin me shumicë në anën tjetër .	tregtoheshin	12	Plur
Ata do të arratisen .	arratisen	3	Plur
Ai lëshoftë .	lëshoftë	1	Sing
Ti u dorëzove .	dorëzove	2	Sing
Ti do të ngacmoje .	ngacmoje	3	Sing
Por e ulin zërin sapo dëgjojnë t ' u thuhet me zë të lartë : Se sa frikë kanë partizanët nga gjermanët , atë e dinë më mirë gjermanët se sa ju , zotërinj anglezë !	dinë	25	Plur
Rreth 1 milion shqiptarë nga Kosova u dëbuan nga forcat shoviniste serbe .	dëbuan	7	Plur
Ti ardhkëshe .	ardhkëshe	1	Sing
Shkuam me të në sallë .	Shkuam	0	Plur
Ju zgjonit .	zgjonit	1	Plur
Ata urryekëshin .	urryekëshin	1	Plur
Lippi gjithashtu tha se Mourinho ishte i barabartë me trajnerët Ciro Ferrara dhe Leonardo të cilët respektivisht drejtonin Juventusin dhe Milanin , duke thënë se portugezi kishte vetëm më shumë eksperiencë .	drejtonin	17	Plur
Ti të harrosh .	harrosh	2	Sing
Mbreti provoi të ikte nga deti , por si e gjeti grykën e lumit të mbyllur nga flota romake , dogji anijet e veta dhe u tërhoq nga toka për në Maqedoni me mbeturinat e ushtrisë .	dogji	20	Plur
Pjesa tjetër , më e madhja e tyre , ruajti pamjen e dikurshme me një jetë ekonomike të kufizuar .	ruajti	9	Sing
Ata shkretuan .	shkretuan	1	Plur
Ata abroguakan .	abroguakan	1	Plur
Ata bashkëvepronin .	bashkëvepronin	1	Plur
Ti sajoje .	sajoje	1	Sing
Ne ndalojmë .	ndalojmë	1	Plur
Ata u injoruakan .	injoruakan	2	Plur
Unë mëndsha .	mëndsha	1	Sing
Ju urronit .	urronit	1	Plur
Unë bëkam .	bëkam	1	Sing
Unë kafshofsha .	kafshofsha	1	Sing
Ti do të vësh .	vësh	3	Sing
Sudja nuk kishte llogari bankare , prandaj me falimentimin e saj humbën edhe paratë e futura aty .	futura	15	Sing
Unë do të lypja .	lypja	3	Sing
Ne nderonim .	nderonim	1	Plur
Ata skllavëruakëshin .	skllavëruakëshin	1	Plur
Ne të bashkëvepronim .	bashkëvepronim	2	Plur
Ata udhëzuan .	udhëzuan	1	Plur
Për ta kuptuar më mirë shtrirjen e fshatit Zhanicë , së pari , fïlloj me toponimet që e rrethojnë , pastaj toponimet brenda tij .	rrethojnë	18	Plur
Ata do të sulmojnë .	sulmojnë	3	Plur
Ne do të shuajnim .	shuajnim	3	Plur
Unë urreja .	urreja	1	Sing
Ata thekkëshin .	thekkëshin	1	Plur
Takohet në mjedise me bimësi të familjes së kryqoreve , në fusha të mbjella me lakër ku dhe dëmtohen .	dëmtohen	18	Plur
Cunami i dhjetorit të vitit 2004 që goditi bregun e Coromandelit ekspozoi një tempull të vjetër të rrënuar ndërtuar tërësisht prej blloqesh graniti .	goditi	7	Sing
Ai preferoi .	preferoi	1	Sing
Ata u mësuakan .	mësuakan	2	Plur
Ne do të ndërlikonim .	ndërlikonim	3	Plur
Qëllimi i edukatës duhet të ndërlidhet me mjetet dhe metodat e saj .	ndërlidhet	5	Sing
Për këtë qëllim u ftuan krahinat e vilajetit që të shtonin ndihmat financiare .	ftuan	4	Plur
Ata urrefshin .	urrefshin	1	Plur
Ju u çlirofshit .	çlirofshit	2	Plur
Ne do të vyshkemi .	vyshkemi	3	Plur
Unë ndërlikova .	ndërlikova	1	Sing
Zgjidhi me Indonezinë problemin e dyshtetësisë së emigrantëve kinezë .	Zgjidhi	0	Sing
Ata gënjefshin .	gënjefshin	1	Plur
Ne të buzëqeshnim .	buzëqeshnim	2	Plur
Ju do të vinit .	vinit	3	Plur
Ne shikojmë .	shikojmë	1	Plur
Unë do të përfitoja .	përfitoja	3	Sing
Ndërsa gjen thesarin , Altair thyen të gjitha parimet e fenë e vrasësve dhe brenda disa minutave me hapjen e lojes , përpiqet për të vrarë de Sable , por dështon .	gjen	1	Sing
Unë dafsha .	dafsha	1	Sing
Me kalimin e kohës së gjatë , fise të shumta të shpërndara në rafshnaltën tibetiane bashkoheshin gradualisht dhe formuan kombësinë tibetiane të tanishme .	bashkoheshin	15	Plur
Unë do të zgjohem .	zgjohem	3	Sing
Unë reaguakësha .	reaguakësha	1	Sing
Në lidhje me pjesën tjetër të Suedisë u lëvizjes në qytet jashtëzakonisht dinamik .	lëvizjes	8	Plur
Domethënëse janë edhe përsëritjet dhe intensiteti i dhimbjes , i cili mund të jetë aq i lartë sa ta bëjë jetën e pacientit shumë të vështirë .	bëjë	19	Sing
Ti mbruake .	mbruake	1	Sing
Ai mësonte .	mësonte	1	Sing
Unë të ledhatoj .	ledhatoj	2	Sing
Ti ndërlikoje .	ndërlikoje	1	Sing
Ne abdikuam .	abdikuam	1	Plur
Pas vuajtjes së dënimit dhe qëndrimit për një periudhë në ilegalitet , në vitin 1986 u arratis në Shqipëri , ku arriti t ’ i mbarojë studimet .	mbarojë	25	Sing
Ju do të pshurrni .	pshurrni	3	Plur
Ju tërhiqni .	tërhiqni	1	Plur
Ju komunikuakëshit .	komunikuakëshit	1	Plur
Ata tërhiqnin .	tërhiqnin	1	Plur
Ti do të prishësh .	prishësh	3	Sing
Ti të fillosh .	fillosh	2	Sing
Ti propozove .	propozove	1	Sing
Ata sodomizojnë .	sodomizojnë	1	Plur
Unë do të përparoja .	përparoja	3	Sing
Ai lëshonte .	lëshonte	1	Sing
Ju justifikuakëshit .	justifikuakëshit	1	Plur
Ti do të tërhiqje .	tërhiqje	3	Sing
Ju copëtuakeni .	copëtuakeni	1	Plur
Ju udhëhoqët .	udhëhoqët	1	Plur
Ne të njoftojmë .	njoftojmë	2	Plur
Unë të ngrija .	ngrija	2	Sing
Unë shkretova .	shkretova	1	Sing
Ata të preferonin .	preferonin	2	Plur
Unë të sulmohesha .	sulmohesha	2	Sing
Ti uroje .	uroje	1	Sing
Ju do të kërceni .	kërceni	3	Plur
Ata sodomizuakëshin .	sodomizuakëshin	1	Plur
Ai përparuaka .	përparuaka	1	Sing
Unë të dërgoja .	dërgoja	2	Sing
Ne qeshëm .	qeshëm	1	Plur
Unë dhurofsha .	dhurofsha	1	Sing
Ata skllavëruan .	skllavëruan	1	Plur
Manastiri përfshin kuzhina , , të drejtuara nga murgj dhe vullnetarë .	përfshin	1	Plur
Ai do të transferonte .	transferonte	3	Sing
Unë s' ditkam shkrim e këndim !	ditkam	2	Sing
Ata ngacmuakan .	ngacmuakan	1	Plur
Ne të përgjithësonim .	përgjithësonim	2	Plur
Ata do të mbrojnë .	mbrojnë	3	Plur
Më parë këto llogore , në Tovarnik , i mbulonte një divizion serb .	mbulonte	9	Sing
Ata kënduakëshin .	kënduakëshin	1	Plur
Lojtari duhet te plotesoje kerkesa te caktuara para se te merret me rivalin e rradhes se Listes se Zeze .	plotesoje	3	Sing
Ai të besojë .	besojë	2	Sing
Pas Luftës së Dytë Botërore u rindërtua me rrugë më të gjëra që të përshtateshin me mjetet e reja të transportit , dhe ndërtime të reja rezidenciale po ndërtohen vazhdimisht .	rindërtua	6	Plur
Ju ndalnit .	ndalnit	1	Plur
Ne do të urrojmë .	urrojmë	3	Plur
Ju gaboni .	gaboni	1	Plur
Ai të vazhdojë .	vazhdojë	2	Sing
Ne ligjëruakemi .	ligjëruakemi	1	Plur
Unë krahasova .	krahasova	1	Sing
Ai kënduakësh .	kënduakësh	1	Sing
Ai dashuruaka .	dashuruaka	1	Sing
Adendet së bashku me jonin qendror shënohen në formulë me kllapa të mesme .	shënohen	6	Plur
Ne shfuqizuam .	shfuqizuam	1	Plur
Ata të transferonin .	transferonin	2	Plur
Ti të relaksohesh .	relaksohesh	2	Sing
Ti do të flisje ndryshe sikur të ndodhte e kundërta , vazhdoi ai .	flisje	3	Sing
Unë të shpjegoj .	shpjegoj	2	Sing
Së paku dy batalione të përziera këmbësorije dhe të blinduara kanë zhvilluar sulmet në drjetim të fshatit Shkozë .	drjetim	14	Plur
Unë do të thjeshtëzoja .	thjeshtëzoja	3	Sing
Ai të jetonte .	jetonte	2	Sing
Ai të shpallte .	shpallte	2	Sing
Ti do të grumbulloje .	grumbulloje	3	Sing
Sikur të ' na bënit edhe një çati të vogël , do të ishim më mirë se në shtëpi .	bënit	4	Plur
Ti të vyshkesh .	vyshkesh	2	Sing
Ju do të përktheni .	përktheni	3	Plur
Unë u sodomizuakësha .	sodomizuakësha	2	Sing
Ne të pompojmë .	pompojmë	2	Plur
Ai mendoftë .	mendoftë	1	Sing
Unë të mbroja .	mbroja	2	Sing
Ju do të zgjedhnit .	zgjedhnit	3	Plur
Unë mendofsha .	mendofsha	1	Sing
Ne ëndërronim .	ëndërronim	1	Plur
Ata pompofshin .	pompofshin	1	Plur
Ata shtypkan .	shtypkan	1	Plur
Ne përkthefshim .	përkthefshim	1	Plur
Unë tërhoqa .	tërhoqa	1	Sing
Ti të sodomizosh .	sodomizosh	2	Sing
Ne të bëheshim .	bëheshim	2	Plur
Ata të kenë .	kenë	2	Plur
Ju do të vendosni .	vendosni	3	Plur
Ti nënkuptuake .	nënkuptuake	1	Sing
Do të mohojë të gjithë titujt që i ofrohen sepse dëshironë të kushtojnë jetën e tij në luftën për drejtësi shoqërore .	mohojë	2	Sing
Ne do të sqaronim .	sqaronim	3	Plur
Ne patëm .	patëm	1	Plur
Unë vendoskam .	vendoskam	1	Sing
Kështu qëndroi me shqipet e maleve , derisa aty u ngritën partizanët e lirisë e ai u bashkua me ta .	ngritën	10	Plur
Ata të kundërthonë .	kundërthonë	2	Plur
Ai propozon .	propozon	1	Sing
Ti përkthefsh .	përkthefsh	1	Sing
Ata të shqipojnë .	shqipojnë	2	Plur
Ti prek .	prek	1	Sing
Unë bekoja .	bekoja	1	Sing
Poeti proteston kundër klasave të pasura që i lanë fëmijët e këtyre luftëtarëve pa mbrojtje : Dyer të huaja të kërkojnë për një kore bukë të thatë !	lanë	8	Plur
Ata do të linin .	linin	3	Plur
Ai qiu .	qiu	1	Sing
Ata linin .	linin	1	Plur
Ti të ndërlikoje .	ndërlikoje	2	Sing
Ju do të peshonit .	peshonit	3	Plur
Ai zhvilluakësh .	zhvilluakësh	1	Sing
Ne afrohemi .	afrohemi	1	Plur
Unë propozoja .	propozoja	1	Sing
Në këtë plan , rrugët u zgjeruan .	zgjeruan	6	Plur
Ju kënduakëshit .	kënduakëshit	1	Plur
Ai u trishtoftë .	trishtoftë	2	Sing
Ti u afrofsh .	afrofsh	2	Sing
Ata do të laheshin .	laheshin	3	Plur
Ai ledhatonte .	ledhatonte	1	Sing
Ti ndihke .	ndihke	1	Sing
Ne mund të qëllonim dhe ta vrisnim kalin që në fillim , por nuk e bëmë vetë këtë gjë , sepse po të vrisnim kalin , do të forconit bindjen tuaj se diku nën tokë kalon vërtet ujësjellësi ynë .	vrisnim	23	Plur
Ju tradhëtonit .	tradhëtonit	1	Plur
Ne vazhdofshim .	vazhdofshim	1	Plur
Unë të propozoj .	propozoj	2	Sing
Ne prodhuam .	prodhuam	1	Plur
Ne u abonofshim .	abonofshim	2	Plur
Ky libër përmbledh një pjesë të dokumenteve të arkivave shqiptare në të cilat dëshmohen ngjarjet e dhimbshme që ndodhën gjatë viteve 1944 – 1945 në krahinën shqiptare të Çamërisë .	dëshmohen	13	Plur
Prindërit nuk e refuzuan dëshirën e fratit .	refuzuan	3	Plur
Ne Pluragojmë .	Pluragojmë	1	Plur
Ju ofendoni .	ofendoni	1	Plur
Ti abdikon .	abdikon	1	Sing
Ne shkërdhefshim .	shkërdhefshim	1	Plur
Unë harrova .	harrova	1	Sing
Ata përdorën .	përdorën	1	Plur
Ata të trishtohen .	trishtohen	2	Plur
Unë u punësova .	punësova	2	Sing
Ndërsa për reklamet gjoba shkon deri në 3 milionë lekë .	shkon	4	Sing
Pas kthimit në Londër , ish bashkëshorti i Leighut Holman , i cili kishte ndikim të madh në te , mbetet me Oliverin dhe mundohet ti pajtojë ata .	pajtojë	26	Sing
Papirologjia përfshin edhe përkthimin dhe interpretimin e dokumenteve të vjetra në një sërë gjuhësh , si edhe kujdesin dhe ruajtjen e origjinaleve të rralla .	përfshin	1	Plur
Ne të copëtonim .	copëtonim	2	Plur
Ata urruakëshin .	urruakëshin	1	Plur
Ne të shtypnim .	shtypnim	2	Plur
Ata dashuruakëshin .	dashuruakëshin	1	Plur
Ne dëmtuam .	dëmtuam	1	Plur
Ata ledhatuan .	ledhatuan	1	Plur
Ai përgjithësuakësh .	përgjithësuakësh	1	Sing
Ti të ngrije .	ngrije	2	Sing
Megjithatë , dhurimi i tokës i bërë nga pasuesi i Krishna-s nuk përmban një referim të tillë .	përmban	12	Sing
Të paktë ishin ata që nuk donin ta shihnin e ta ndjenin poshtërimin e përditshëm që u bëhej shqiptarëve .	shihnin	8	Plur
Ju të përktheni .	përktheni	2	Plur
Ata mbulofshin .	mbulofshin	1	Plur
Ai do të konsistojë .	konsistojë	3	Sing
Ata abonoheshin .	abonoheshin	1	Plur
Ti do të masësh .	masësh	3	Sing
Ti vënke .	vënke	1	Sing
Ju u hidhërofshit .	hidhërofshit	2	Plur
Ai të shfuqizojë .	shfuqizojë	2	Sing
Ju pshurrnit .	pshurrnit	1	Plur
Ti zgjove .	zgjove	1	Sing
Në një ndeshje osmanët u thyen .	thyen	5	Plur
Ai fshika .	fshika	1	Sing
Ju të peshoheshit .	peshoheshit	2	Plur
Ne do të shurrojmë .	shurrojmë	3	Plur
Unë Pluraguakësha .	Pluraguakësha	1	Sing
Ne do të Pluragonim .	Pluragonim	3	Plur
Ne të ofendojmë .	ofendojmë	2	Plur
Ai ndihmoi .	ndihmoi	1	Sing
Shkëmbi i padëshiruar çahej dhe hiqej duke lënë një strukturë të skalitur shpellore .	çahej	3	Sing
Ata shtrembërofshin .	shtrembërofshin	1	Plur
Pastaj kemi teorinë Hinduse dhe Indiane që kërcenojnë individët që ndryshojnë statusin e tyre se do të konsiderohen si kafshë .	konsiderohen	17	Plur
Ata do të masturbonin .	masturbonin	3	Plur
Dyshoheshin për kanibalizëm ( për shkak të darkës së Zotit ) dhe për imoralitet ( quheshin vëllezër e motra ende pa u njohur mirë ) !	quheshin	15	Plur
Ne do të zhvirgjërojmë .	zhvirgjërojmë	3	Plur
Ai u punësuakësh .	punësuakësh	2	Sing
Ata kuptuakëshin .	kuptuakëshin	1	Plur
Nga ai vit mbeti kujtim themeli me disa shenja muri .	mbeti	3	Sing
U gëzua brigadieri dhe kolegët e tij .	gëzua	1	Sing
Unë të pompoj .	pompoj	2	Sing
Madje , zhvillimi historik , politik , ekonomik dhe kulturor i shqiptarëve ka qenë aq i mundimshëm sa që ata që i njohin mirë nuk mund të mos mahniten se si kanë arritur të mbijetojnë si popull .	mbijetojnë	34	Plur
Unë lypkam .	lypkam	1	Sing
Ne të bashkëpunojmë .	bashkëpunojmë	2	Plur
Ata injoruakan .	injoruakan	1	Plur
Ne do të peshoheshim .	peshoheshim	3	Plur
Ai të udhëhiqet .	udhëhiqet	2	Sing
Ne të arsimojmë .	arsimojmë	2	Plur
Unë ndërlikuakësha .	ndërlikuakësha	1	Sing
Ti të adhuroje .	adhuroje	2	Sing
Unë të shpif .	shpif	2	Sing
Ne qëndronim .	qëndronim	1	Plur
Unë urryekam .	urryekam	1	Sing
Ne urinonim .	urinonim	1	Plur
Me një dekret Greqia përvetësoi pronat e shqiptarëve myslimanë dhe jozyrtarisht i trajtoi si popullsi shkëmbyese , ashtu siç e parashihte Marrëveshja e Lausannes për turqit e Greqisë .	përvetësoi	4	Sing
Ata bekuakan .	bekuakan	1	Plur
Ai arsimuakësh .	arsimuakësh	1	Sing
Unë përktheja .	përktheja	1	Sing
Ato u plaçkitën dhe u nxorrën me dhunë jashtë nga shtëpia .	plaçkitën	2	Plur
Unë parapëlqyekam .	parapëlqyekam	1	Sing
Unë shpall .	shpall	1	Sing
Si dhe shum nga popullata e kesaj treve jetojn në Preshevë dhe Kumanovë si dhe në mergatë .	jetojn	8	Plur
Unë u udhëheqkam .	udhëheqkam	2	Sing
Ai do të stopohej .	stopohej	3	Sing
Ai këndoi .	këndoi	1	Sing
Ti shpjegofsh .	shpjegofsh	1	Sing
Ti zhvirgjëruake .	zhvirgjëruake	1	Sing
Më pas ajo shkoi në Kairo mbante çështjes shqiptare gjithmonë me të .	mbante	6	Sing
Në vitin 1793 , Kaxoni u dërguan në Stamboll dhe u torturua deri në vdekje .	dërguan	6	Plur
Ti justifikofsh .	justifikofsh	1	Sing
Ai thjeshtëzonte .	thjeshtëzonte	1	Sing
Ne përmirësuam .	përmirësuam	1	Plur
Ne thafshim .	thafshim	1	Plur
Ky proces preku edhe pronat e vogla private në ato vise që hynin nën administrimin e qyteteve ose ku kishte mundësi të zhvilloheshin latifondet .	zhvilloheshin	22	Plur
Ata dhunonin .	dhunonin	1	Plur
Unë përkthyekam .	përkthyekam	1	Sing
Ti bekon .	bekon	1	Sing
Ju zbuloni .	zbuloni	1	Plur
Ai të ndante .	ndante	2	Sing
Unë të luftoj .	luftoj	2	Sing
Ai fshehka .	fshehka	1	Sing
Ata do të shtrembëronin .	shtrembëronin	3	Plur
Ai shpjeguakësh .	shpjeguakësh	1	Sing
Mos harroni se ky vend quhet Shqipëri dhe nuk quhet as Indi dhe as Ingliterrë .	quhet	5	Sing
Ata kafshonin .	kafshonin	1	Plur
Ne mbronim .	mbronim	1	Plur
Mund të shtyhen me duart , të lakohen ose të zvarriten .	shtyhen	2	Plur
Ai do të miqësohet .	miqësohet	3	Sing
Unë interpretoja .	interpretoja	1	Sing
Ne lamë .	lamë	1	Plur
Unë hap .	hap	1	Sing
Lufta do të mbarojë : por nëse njerëzit nuk ndalojnë së fyeri perëndinë , një më e keqe do të shpërthejë gjatë papënisë së Piusit të XI .	fyeri	11	Sing
Thinjat , lulet që i çelën në veprat e pesëvjeçarëve , nuk e pengonin brigadierin të gjente një gjuhë të ngrohtë e të dashur me të rinjtë .	gjente	16	Sing
Ai dërmoftë .	dërmoftë	1	Sing
Ti do të vazhdoje .	vazhdoje	3	Sing
Ti do të shtegtosh .	shtegtosh	3	Sing
Ata hapkëshin .	hapkëshin	1	Plur
Ai do të copëtonte .	copëtonte	3	Sing
Unë njoftuakësha .	njoftuakësha	1	Sing
Ata u afrofshin .	afrofshin	2	Plur
Ti Admiron .	Admiron	1	Sing
Unë do të punësohesha .	punësohesha	3	Sing
Ai të abuzojë .	abuzojë	2	Sing
Shalon shpejt ai kalë Dorinë , i hip e merr vrapin drejt për në Ulqin .	Shalon	0	Sing
Unë të bashkëveproja .	bashkëveproja	2	Sing
Ai të stopohej .	stopohej	2	Sing
Sistemi operativ , çdo programi që ekzekutohet i rezervon memorie dhe variabla të veçanta .	rezervon	8	Plur
Ju dhembni .	dhembni	1	Plur
Unë Pluragofsha .	Pluragofsha	1	Sing
Ai punësuakësh .	punësuakësh	1	Sing
Ata të gëzojnë .	gëzojnë	2	Plur
Ti të shpallje .	shpallje	2	Sing
Si stacion i fundit hekurudhor , Mitrovica u bë stacion importues dhe eksportues .	bë	8	Sing
Ai notoi .	notoi	1	Sing
Të tillë janë vathët me motive palloi , skena të Eukarestisë ose unaza me formula e lutje të krishtera .	palloi	6	Sing
Unë justifikoja .	justifikoja	1	Sing
Ne do të fillonim .	fillonim	3	Plur
Ata do të admironin .	admironin	3	Plur
Ti puthsh .	puthsh	1	Sing
Ju u dorëzuakeni .	dorëzuakeni	2	Plur
Ju abrogonit .	abrogonit	1	Plur
Ju ndryshoni .	ndryshoni	1	Plur
Ju të mësoheni .	mësoheni	2	Plur
Ai dhëntë .	dhëntë	1	Sing
Unë do të miqësohesha .	miqësohesha	3	Sing
Ne shtegtofshim .	shtegtofshim	1	Plur
Ti të harroje .	harroje	2	Sing
Unë këndova .	këndova	1	Sing
Ata të përparonin .	përparonin	2	Plur
Ti të dërmosh .	dërmosh	2	Sing
Ju lëpini .	lëpini	1	Plur
Unë të gënjeja .	gënjeja	2	Sing
Në vend të kësaj ata dridheshin kur mendonin për mundimet e zgjatura në purgator , dhe kërkonin t ’ i shkurtonin këto mundime duke dhënë lëmoshë .	shkurtonin	20	Plur
Ato nuk mund të përfytyrojnë një gjë të tillë : S’ ke frikë që lëshon të tilla fjalë ?	lëshon	14	Sing
Ai do të shkretojë .	shkretojë	3	Sing
Ai do të kërcejë .	kërcejë	3	Sing
Dallohet me një nga shkollat më të para në trevat shqiptare më 1698 .	Dallohet	0	Sing
Ata puthkan .	puthkan	1	Plur
Ne prishshim .	prishshim	1	Plur
Pas vdekjes së të atit i biri i tij Ajeti vazhdoj përsëri traditën duke ndjekur rrugën e babait të tij dhe u bë pleqnar i odave shqiptare .	vazhdoj	10	Sing
Unë kënduakësha .	kënduakësha	1	Sing
Ne luftojmë .	luftojmë	1	Plur
Ti votoje .	votoje	1	Sing
Ju do të qini .	qini	3	Plur
Unë të urroj .	urroj	2	Sing
Ai bekuakësh .	bekuakësh	1	Sing
Për Millosheviqin zgjidhja më e mirë ishte që Kosova t ’ i besohej një kryepolici .	besohej	12	Sing
Ai do të zhvillohej .	zhvillohej	3	Sing
Unë armatoskësha .	armatoskësha	1	Sing
Ju absorbuat .	absorbuat	1	Plur
Ti të udhëheqësh .	udhëheqësh	2	Sing
Ata të afirmojnë .	afirmojnë	2	Plur
Unë fshehkësha .	fshehkësha	1	Sing
Trashëgofsh të ritë tënd me trimin e zgjedhur .	Trashëgofsh	0	Sing
Ti ngacmoje .	ngacmoje	1	Sing
Ne konsistonim .	konsistonim	1	Plur
Ju do të grumbulloni .	grumbulloni	3	Plur
Ata pëlqyekëshin .	pëlqyekëshin	1	Plur
Ata do të masin .	masin	3	Plur
Unë u injorofsha .	injorofsha	2	Sing
Ju do të mbaronit .	mbaronit	3	Plur
Ata dëshirofshin .	dëshirofshin	1	Plur
Ata do të qajnë .	qajnë	3	Plur
Ti vazhdofsh .	vazhdofsh	1	Sing
Ti zbeh .	zbeh	1	Sing
Ti të jetoje .	jetoje	2	Sing
Të dy prindërit i ushqejnë të vegjlit , të cilët pas 65-78 ditë e braktisin folenë .	ushqejnë	4	Plur
Unë do të kafshoja .	kafshoja	3	Sing
Ju të sqaronit .	sqaronit	2	Plur
Ai gëzoi .	gëzoi	1	Sing
Ata punësofshin .	punësofshin	1	Plur
Ju të linit .	linit	2	Plur
Më vonë batiskafi tij u përdor nga TVSH për të bërë filmat nënujë .	përdor	5	Sing
Ju të hanit .	hanit	2	Plur
Ti do të lexosh .	lexosh	3	Sing
Ditën përpara ndeshjes unë nuk agjëroj .	agjëroj	5	Sing
Ne parapëlqefshim .	parapëlqefshim	1	Plur
Ne të copëtojmë .	copëtojmë	2	Plur
Vyshkja e përkohshme kalon shpejt nëse temperaturat e mbasditës fillojnë dhe ulen dhe nëse toka ka vlagën e duhur .	fillojnë	9	Plur
Ne ndërlikonim .	ndërlikonim	1	Plur
Ata do të hanë .	hanë	3	Plur
Përrenjtë dhe luginat e vogla që lidhin liqenin me pellgun e Drinit krijojnë fjorde të vegjël që futen në brendësi të masiveve malorë .	lidhin	6	Plur
Ne pranuakemi .	pranuakemi	1	Plur
Ne do të fërgonim .	fërgonim	3	Plur
Ju të dashuronit .	dashuronit	2	Plur
Një numër i tërë i gazetës " Qëndresa Shqiptare " u kushtohet ngjarjeve në Kosovë .	kushtohet	11	Sing
Eksperimentet kanë treguar se magnezi vepron kundër endemës në këmbë dhe në sistemin gastrointestinal të shkaktuar nga indometacina .	vepron	5	Sing
Dëmet që kanë sjellë stuhitë kanë qenë : rrëzimi i drithërave , rrëzimi i pemëve të vjetra që shpesh herë shkaktonte edhe rrëzimin e linjave elektrike .	shkaktonte	20	Sing
Unë kundërthashë .	kundërthashë	1	Sing
Unë do të shkëlqej .	shkëlqej	3	Sing
Ti tërheqkëshe .	tërheqkëshe	1	Sing
Ju ledhatofshit .	ledhatofshit	1	Plur
Ti propozoje .	propozoje	1	Sing
Ju kundërthënkëshit .	kundërthënkëshit	1	Plur
Ata urinonin .	urinonin	1	Plur
Leonitus u gëzua shumë për këtë titull dhe vazhdoi luftrat e përjetshme heroike .	gëzua	2	Sing
Ne të sulmojmë .	sulmojmë	2	Plur
Më 15 dhjetor 2006 ajo promovoi albumin e saj në Prishtinë nën ekskluzivitetin e kompanisë Antika .	promovoi	5	Sing
Ultësirat Qendrore përbëhen nga prerí të gjera .	përbëhen	2	Plur
Ne ngremë jetën , vazhdonte të fliste akoma ajo .	ngremë	1	Plur
Ne shtrembëruakëshim .	shtrembëruakëshim	1	Plur
Ne do të pastronim .	pastronim	3	Plur
Lista e titujt e parenduar përmban romane , poezi , drama të mirënjohura si dhe libra me figura komike .	përmban	5	Plur
Unë keqkuptoj .	keqkuptoj	1	Sing
Ju besoni .	besoni	1	Plur
Ne do të japim .	japim	3	Plur
Ata sajojnë .	sajojnë	1	Plur
Unë do të urreja .	urreja	3	Sing
Ata lypnin .	lypnin	1	Plur
Ata lëpikan .	lëpikan	1	Plur
Është e rëndësishme të parandalohen komplikimet dhe çregullimet e metabolizmit .	parandalohen	4	Plur
Ata rënkojnë .	rënkojnë	1	Plur
Ai mbaruakësh .	mbaruakësh	1	Sing
Ata shpifshin .	shpifshin	1	Plur
Ai afirmoi .	afirmoi	1	Sing
Unë të transferoj .	transferoj	2	Sing
Ti përsosje .	përsosje	1	Sing
Ne arësyetuam .	arësyetuam	1	Plur
Ti të thekësh .	thekësh	2	Sing
Unë do të masturboja .	masturboja	3	Sing
Ai zbukuroftë .	zbukuroftë	1	Sing
Ky komitet krijon degën e tij në Korfuz ku merr pjesë edhe Alush Taka , Musa Demi , Muharrem Rushiti .	krijon	2	Sing
Mes pacientëve kishte pasur persona vërtet interesantë , që e kishin ndihmuar të zbulonte shumë gjëra .	zbulonte	13	Sing
Por të dhënat tregojnë se " akademia " kulturore për të cilën shquhet ky qytet fshihet pas shekujve e shekujve .	shquhet	12	Sing
Ju do të urinonit .	urinonit	3	Plur
Unë do të gëzoja .	gëzoja	3	Sing
Ne të fërkonim .	fërkonim	2	Plur
Ju të zgjoheni .	zgjoheni	2	Plur
Ne mësonim .	mësonim	1	Plur
Ata u punësuan .	punësuan	2	Plur
Ne sajojmë .	sajojmë	1	Plur
Ti ngrënke .	ngrënke	1	Sing
Unë ndihmuakam .	ndihmuakam	1	Sing
Ju do të pastroni .	pastroni	3	Plur
Ti bashkëpunuakëshe .	bashkëpunuakëshe	1	Sing
Ata zbukuruan .	zbukuruan	1	Plur
Ne dërguam .	dërguam	1	Plur
Ata do të dëmtonin .	dëmtonin	3	Plur
Ne besuam .	besuam	1	Plur
Ata qenkan .	qenkan	1	Plur
Balada Jazz " Saving All My Love for You " , u publikua menjëherë pas kësaj dhe do të bëhej kënga më e suksesshme e Houston-it si në SHBA edhe në Mbretërinë e Bashkuar .	publikua	12	Sing
Ai lypkësh .	lypkësh	1	Sing
Linjat mjeshtërore ndërthurnin korposin e një zinxhiri veprash premtuese e të pathyeshme .	ndërthurnin	2	Plur
Së pari viktimat mashtroheshin apo rrëmbeheshin , në fillim ekzekutoheshin e më pas Bundy kryente marrëdhënie seksuale me kufomat e tyre .	kryente	14	Sing
Unë bashkëpunoj .	bashkëpunoj	1	Sing
Ne paskëshim .	paskëshim	1	Plur
Unë mbulova .	mbulova	1	Sing
Ai shqipoftë .	shqipoftë	1	Sing
Ti të shpjegoje .	shpjegoje	2	Sing
Ti do të provosh .	provosh	3	Sing
Ai do të thjeshtëzojë .	thjeshtëzojë	3	Sing
Ai do të ngacmonte .	ngacmonte	3	Sing
Ju danit .	danit	1	Plur
Ata do të fshinin .	fshinin	3	Plur
Unë u mbarova .	mbarova	2	Sing
Unë copëtuakam .	copëtuakam	1	Sing
Ata ofenduakan .	ofenduakan	1	Plur
Vajza tani ishte mësuar të fliste dhe e dinte se këta fshatarë , prej të cilëve rreth saj dikush pinte cigare .	pinte	19	Sing
Ata pallonin .	pallonin	1	Plur
Unë do të justifikoj .	justifikoj	3	Sing
Ata danë .	danë	1	Plur
Ata shpjegojnë .	shpjegojnë	1	Plur
Ne fërgofshim .	fërgofshim	1	Plur
Ti themelofsh .	themelofsh	1	Sing
Ju arratiseshit .	arratiseshit	1	Plur
Unë dërmuakam .	dërmuakam	1	Sing
Ai të lexonte .	lexonte	2	Sing
Ti të fërkoje .	fërkoje	2	Sing
Ti të përkëdhelje .	përkëdhelje	2	Sing
Ne udhëzuakemi .	udhëzuakemi	1	Plur
Ju argëtoni .	argëtoni	1	Plur
Ai arësyetonte .	arësyetonte	1	Sing
Ata ndryshuakan .	ndryshuakan	1	Plur
Unë do ta vishja ?	vishja	3	Sing
Ti u bëke .	bëke	2	Sing
Ai Pluragonte .	Pluragonte	1	Sing
Ai gaboftë .	gaboftë	1	Sing
Ai qenka .	qenka	1	Sing
Unë prishsha .	prishsha	1	Sing
Ti dërguakëshe .	dërguakëshe	1	Sing
Ai shfuqizon .	shfuqizon	1	Sing
Ata argëtojnë .	argëtojnë	1	Plur
Ne përkthenim .	përkthenim	1	Plur
Në vitin 1940 emërohet drejtor i Arsimimit të të Rriturve në Boston ku punoi deri në vitin 1943 .	emërohet	3	Sing
Ti të injoroje .	injoroje	2	Sing
Ne dhembnim .	dhembnim	1	Plur
Ne thanim .	thanim	1	Plur
Pas kësaj ndërmerren masa të rrepta sigurimi .	ndërmerren	2	Plur
Një natë , teksa kishte mbyllur dyert e pallatit dhe adhuronte Zotin , dy persona kishin arritur t ’ i kalojnë muret e pallatit dhe i hynë brenda .	hynë	26	Plur
Unë të palloj .	palloj	2	Sing
Ti njoftuakëshe .	njoftuakëshe	1	Sing
Ju takonit .	takonit	1	Plur
Ata të çlironin .	çlironin	2	Plur
Ata do të qeshnin .	qeshnin	3	Plur
Unë do të dërgoja .	dërgoja	3	Sing
Pak para mbrëmjes serbët kthehen dhe i djegin shtëpitë që kishin mbetur pa u djegur po dy gratë me fëmijën e vogël fshihen në mal , po ashtu edhe Izeti .	fshihen	22	Sing
Milan Kundera u ripranua në Partinë Komuniste më 1956 .	ripranua	3	Sing
Ata do të çliroheshin .	çliroheshin	3	Plur
Ju trishtoheshit .	trishtoheshit	1	Plur
Ju u injoruakeni .	injoruakeni	2	Plur
Unë të provoj .	provoj	2	Sing
Ne të çlirohemi .	çlirohemi	2	Plur
Simptomat vijnë si rezultat i dëmtimit të qelizave nervore , të cilat ngadalësojnë përcjelljen e sinjalit për në tru dhe anasjelltas .	ngadalësojnë	12	Plur
Ne degjuakëshim .	degjuakëshim	1	Plur
Unë u udhëheqsha .	udhëheqsha	2	Sing
Ti do të shpjegosh .	shpjegosh	3	Sing
Ne u relaksuam .	relaksuam	2	Plur
Unë të urinoj .	urinoj	2	Sing
Ai thënka .	thënka	1	Sing
Ju shfuqizonit .	shfuqizonit	1	Plur
Unë organizuakësha .	organizuakësha	1	Sing
Ti ikikëshe .	ikikëshe	1	Sing
Pas disa ndeshjeve sporadike kufitare , që ndodhën gjatë tetorit , Knjaz Nikolla vendosi më në fund të kalonte në sulme të hapura .	ndodhën	7	Plur
Ju shkretofshit .	shkretofshit	1	Plur
Ne të zgjoheshim .	zgjoheshim	2	Plur
Ai të reagojë .	reagojë	2	Sing
Rezultati është zhvillimin e përditshme e detit dhe kufijve fllad liqeni që bien ndesh dhe prodhojnë stuhi .	bien	12	Plur
Ju përgjithësuakeni .	përgjithësuakeni	1	Plur
Përpjekjet e tij për t ’ u ngulur në Ilirinë bregdetare dështuan dhe pas kësaj ai nuk provoi më të kthehej në këto anë .	kthehej	20	Sing
Ai të nënkuptojë .	nënkuptojë	2	Sing
Ata do të mbulojnë .	mbulojnë	3	Plur
Ne mbuluakëshim .	mbuluakëshim	1	Plur
Rendi feudal i sillte dëm të madh fshatarësisë dhe ekonomisë bujqësore .	sillte	3	Sing
Unë filloj .	filloj	1	Sing
Do ta kalosh mirë edhe këtu , së bashku me ne .	kalosh	2	Sing
Ju të asnjanësoni .	asnjanësoni	2	Plur
Unë të sqaroja .	sqaroja	2	Sing
Ne urojmë .	urojmë	1	Plur
Unë do të abrogoja .	abrogoja	3	Sing
Ti ndalsh .	ndalsh	1	Sing
Unë të gëzoja .	gëzoja	2	Sing
Ai do të jetojë .	jetojë	3	Sing
Ne të veçonim .	veçonim	2	Plur
Unë të dhunoj .	dhunoj	2	Sing
Për këtë arsye mbreti i Trojës urdhëroi që fëmija menjëherë pas lindjes të dërgohet në malin Ida dhe atje të vendoset në kaçubën e pyllit .	vendoset	20	Sing
Ti do të nënkuptosh .	nënkuptosh	3	Sing
Ju shtypnit .	shtypnit	1	Plur
Ata avulluakan .	avulluakan	1	Plur
Me nismën e saj në vitin 1911 u organizua për herë të parë Dita Ndërkombëtare e Grave .	organizua	8	Sing
Ata ndihmuakëshin .	ndihmuakëshin	1	Plur
Ti duruake .	duruake	1	Sing
Unë do të shImpoj .	shImpoj	3	Sing
Ju abuzoni .	abuzoni	1	Plur
Në to murgjit merreshin me studimin , kopjimin dhe sistemimin e dorëshkrimeve te vjetra .	merreshin	3	Plur
Ata dhembnin .	dhembnin	1	Plur
Ata u stopuan .	stopuan	2	Plur
Ai do të urrejë .	urrejë	3	Sing
Ju do të fërkoni .	fërkoni	3	Plur
Unë notova .	notova	1	Sing
Ndërtesa e blerë u bekua ditën e Shën Françeskut më 4 tetor dhe mësimin e filloi më 10 tetor të vitit 1921 .	bekua	4	Sing
Ti themeluake .	themeluake	1	Sing
Unë të rrezikoja .	rrezikoja	2	Sing
Pastaj kemi teorinë Hinduse dhe Indiane që kërcenojnë individët që ndryshojnë statusin e tyre se do të konsiderohen si kafshë .	kërcenojnë	7	Plur
Ne arësyetofshim .	arësyetofshim	1	Plur
Ti lexuake .	lexuake	1	Sing
Ai të grumbullojë .	grumbullojë	2	Sing
Ne shqipofshim .	shqipofshim	1	Plur
Personat e dyshuar për sëmundjen e Parkinsonit duhet të kryejnë patjetër vizitën e neurologut për diagnostikimin dhe trajtimin e mëtejshëm .	dyshuar	2	Plur
Ju të lëpinit .	lëpinit	2	Plur
Ai stimuluaka .	stimuluaka	1	Sing
Shumica e kanaleve kalohen pak ose fare më me varkë .	kalohen	3	Plur
Ti do të punësoheshe .	punësoheshe	3	Sing
Ata do të shtypnin .	shtypnin	3	Plur
Ata justifikonin .	justifikonin	1	Plur
Ai u sodomizuaka .	sodomizuaka	2	Sing
Ata të udhëzojnë .	udhëzojnë	2	Plur
Ne të thjeshtëzonim .	thjeshtëzonim	2	Plur
Ti do të gënjeje .	gënjeje	3	Sing
U shpall amnisti për ata nënshtetas osmanë që kishin luftuar përkrah Rusisë .	shpall	1	Sing
Priftërinjtë dhe famullitarët : Peshkopët ndihmohen nga priftërinjtë dhe për shërbesën jo priftërore diakonët .	ndihmohen	5	Plur
Ai do të shtegtonte .	shtegtonte	3	Sing
Ju ndihkeni .	ndihkeni	1	Plur
Ata shkatërruan .	shkatërruan	1	Plur
Ata do të shkërdhenin .	shkërdhenin	3	Plur
Ju të dhunonit .	dhunonit	2	Plur
Ti shpifkëshe .	shpifkëshe	1	Sing
Ata pakëshin .	pakëshin	1	Plur
Ata të jepnin .	jepnin	2	Plur
Unë armatossha .	armatossha	1	Sing
Ti u masturbove .	masturbove	2	Sing
Ti stopoheshe .	stopoheshe	1	Sing
Ju ndihmuakeni .	ndihmuakeni	1	Plur
Ju puthkeni .	puthkeni	1	Plur
Ti u mbaruakëshe .	mbaruakëshe	2	Sing
Ti të arësyetosh .	arësyetosh	2	Sing
Perseri më 1920 , kur Italia fashiste kerkonte te pushtonte Vloren , kurveleshasit zhvilluan kuvend tjetër në Gusmar .	pushtonte	9	Sing
Unë mbarohesha .	mbarohesha	1	Sing
Ai do të shohë .	shohë	3	Sing
Unë nderoj .	nderoj	1	Sing
Unë do të armatos .	armatos	3	Sing
Ai mbështeti duart pas vetes në mur dhe ua mbërtheu vështrimin shokëve .	mbërtheu	9	Sing
Ju buzëqeshshit .	buzëqeshshit	1	Plur
Unë të prodhoja .	prodhoja	2	Sing
Ju harroni .	harroni	1	Plur
Nxitonin që të vinin sa më parë te limani .	Nxitonin	0	Plur
Për shkak të rrethanave të krijuara në këto treva familja e Ali Kuqit shpërngulet nga këtu dhe vendoset në Rozhajë .	vendoset	17	Sing
Një sasi e vogël e copave të trungut lejohen të kalojnë që të qëndrojnë në rrush për shkak të taninës e cila gjendet brenda strukturës së tyre .	lejohen	8	Plur
Unë të interpretoja .	interpretoja	2	Sing
Më pas vazhdoi gjimnazin në Tiranë , të cilin u detyrua ta ndërpriste vitin e tretë , pasi u përfshi aktivisht në luftën antifashiste .	përfshi	19	Sing
Ti të asnjanësoje .	asnjanësoje	2	Sing
Ju përfitonit .	përfitonit	1	Plur
Ti njoftove .	njoftove	1	Sing
Unë shpifsha .	shpifsha	1	Sing
Naruto dhe banda nuk dolën dhe kështu provimi u quajt i Kaluar .	dolën	4	Plur
Rezistenca e saj qe e kotë , më në fund ajo thirri : Biri im , ti je i papërballueshëm !	je	17	Sing
Unë mbaruakësha .	mbaruakësha	1	Sing
Unë parapëlqefsha .	parapëlqefsha	1	Sing
Prodhuesit zakonisht specifikojnë një numër maksimal rishkrimesh të barabarte me 106 ose më të lartë .	specifikojnë	2	Plur
Ata injorofshin .	injorofshin	1	Plur
E , në një kafene në Korçë , u mbërthyen , or të keqen , me Memon .	mbërthyen	9	Plur
Ti do të pomposh .	pomposh	3	Sing
Mbulimi tendecioz i ngjarjeve bëri që TVSH dhe gazetarët e tij të ktheheshin në mënyrë të pashmangshme në armiq të forcave kryengritëse duke sjellë shkatërrimin e antenave të transmetimit në mbarë vendin .	ktheheshin	12	Plur
Ai të fshinte .	fshinte	2	Sing
Ti do të masturbohesh .	masturbohesh	3	Sing
Bekoni ishte rrënjësisht skeptik sa i takon asaj që shtirej si e vërtetë , por që nuk ndihmonte në zgjidhjen e çështjeve praktike ; ai quante " idole " ato që sot i cilësojmë " gënjeshtra ideologjike " .	cilësojmë	33	Plur
Ata jetonin .	jetonin	1	Plur
Ju lëpikeni .	lëpikeni	1	Plur
Ne kërcejmë .	kërcejmë	1	Plur
Ne të punësojmë .	punësojmë	2	Plur
Ai parapëlqyekësh .	parapëlqyekësh	1	Sing
Ju abroguat .	abroguat	1	Plur
Pjesë më të vjetëra të librit ruhen te egjiptasit në fletë papirusi të shkruara , mbi 5000 vjet më parë .	ruhen	6	Plur
Zyrtarisht ishulli ra plotësisht më 16 mars , edhe pse marinsat kishin arritur pastrimin e tij më parë .	ra	2	Sing
Ata u takofshin .	takofshin	2	Plur
Ti ledhatofsh .	ledhatofsh	1	Sing
Ne bashkëvepruakëshim .	bashkëvepruakëshim	1	Plur
Ti dhembsh .	dhembsh	1	Sing
Unë thekkam .	thekkam	1	Sing
Ju të luftonit .	luftonit	2	Plur
Meleagari , i cili pastaj e mbyti derrin e egër ia dhuroi lëkurën .	dhuroi	11	Sing
Ne shtrembërofshim .	shtrembërofshim	1	Plur
Plaku rrinte pranë zjarrit e pinte duhan duke kënduar me zë të ulët këngën e tij të lashtë .	pinte	5	Sing
Unë do të shoh .	shoh	3	Sing
Ju sulmoheni .	sulmoheni	1	Plur
Për dy gjëra bien dakord të gjithë historianët , se ata ishin të palodhur dhe grabitqarë me armiq e miq .	bien	3	Plur
Ju kundërthënkeni .	kundërthënkeni	1	Plur
Ti do të tradhëtoje .	tradhëtoje	3	Sing
Ai të bekojë .	bekojë	2	Sing
Ata do të këndojnë .	këndojnë	3	Plur
Ju arratiseni .	arratiseni	1	Plur
Ti njoftuake .	njoftuake	1	Sing
Unë do të notoj .	notoj	3	Sing
Ti absorbofsh .	absorbofsh	1	Sing
Ju u ndryshuat .	ndryshuat	2	Plur
Ti pompofsh .	pompofsh	1	Sing
Ai copëtuakësh .	copëtuakësh	1	Sing
Ata do të ndalonin .	ndalonin	3	Plur
Ata shkërdhenin .	shkërdhenin	1	Plur
Ju do të dhunoni .	dhunoni	3	Plur
Ti copëtoje .	copëtoje	1	Sing
Unë u lava .	lava	2	Sing
Ju ndalshit .	ndalshit	1	Plur
Ju të bashkëveproni .	bashkëveproni	2	Plur
Ai gëzuakësh .	gëzuakësh	1	Sing
Unë të krijoj .	krijoj	2	Sing
Ju qini .	qini	1	Plur
Për këtë e dënuan 10 vjet burg , 4 nga të cilat i vuajti .	vuajti	13	Sing
Ne do të rrezikonim .	rrezikonim	3	Plur
Prenga mori lahutën , përkuli kokën mbi të dhe nëpër barakën e gjatë fluturuan ca murmurimje të ëmbla .	fluturuan	13	Plur
Ju fërguat .	fërguat	1	Plur
Ata të dhembin .	dhembin	2	Plur
Ata të hidhëroheshin .	hidhëroheshin	2	Plur
Unë arësyetofsha .	arësyetofsha	1	Sing
Ndërsa vrasjen e Naim Çangut , Haklaj e justifikoi me faktin se krutani i kishte dalë në rrezen e zjarrit .	justifikoi	8	Sing
Unë do të nderoj .	nderoj	3	Sing
Ne do të shtypnim .	shtypnim	3	Plur
Ti kupton .	kupton	1	Sing
Ai të rrezikojë .	rrezikojë	2	Sing
McLaren ndaloi prodhimin e SLR në 2009 dhe filloi të zhvillojë makinën e saj , McLaren MP4-12C , lëshuar në vitin 2011 .	ndaloi	1	Sing
Ai të abonohet .	abonohet	2	Sing
Ruaju prej tërbimit të tij shtazarak , ti , që jeton në mijëvjeçarin që vjen pas mijëvjeçarit .	Ruaju	0	Sing
Qëllimi i lojës është të godasësh topin larg , edhe të vraposhë reth katrorit me rërë , para se skuadra tjetër ta sjelli topin mbrapsh dhe të eliminojnë nga loja .	sjelli	22	Plur
Unë do të nënkuptoja .	nënkuptoja	3	Sing
Dukej si të kishte kuptuar në një çast të vetëm , atë që se kishte kuptuar shumë kohë më parë , ata nuk erdhën për të ikur shpejt , ata erdhën për të ndenjur gjatë .	erdhën	23	Plur
Ti mëson .	mëson	1	Sing
Ti të dhunoje .	dhunoje	2	Sing
Ti do të lëshoje .	lëshoje	3	Sing
Ju mbuloni .	mbuloni	1	Plur
Ti qeshke .	qeshke	1	Sing
Ai përsoste .	përsoste	1	Sing
Ai prektë .	prektë	1	Sing
Ai të fillojë .	fillojë	2	Sing
Ata do të sakrifikojnë .	sakrifikojnë	3	Plur
Përditë e nxirrnim me dhëmbë atë të shkretë qymyr , e ngarkonim në dy mushkat tona dhe e nxirrnim në xhade ku e merrnin makinat .	nxirrnim	18	Plur
Ne stopohemi .	stopohemi	1	Plur
Ne urruam .	urruam	1	Plur
Ti rënkofsh .	rënkofsh	1	Sing
Ai u mësuaka .	mësuaka	2	Sing
Të dhënat për ngritjen e saj lëvizin në kohë .	lëvizin	6	Plur
Disa mesfushore luajnë një rol mbrojtës ndërsa disa të tjerë luajnë rol sulmues .	luajnë	10	Plur
Ata të shpresonin .	shpresonin	2	Plur
Ti ikike .	ikike	1	Sing
Ju do të thoshit .	thoshit	3	Plur
Ne përparonim .	përparonim	1	Plur
Ju stimulofshit .	stimulofshit	1	Plur
Ne do të tradhëtojmë .	tradhëtojmë	3	Plur
Ti të armatosje .	armatosje	2	Sing
Ju çlironit .	çlironit	1	Plur
Ju u relaksuat .	relaksuat	2	Plur
Ti të shtrembërosh .	shtrembërosh	2	Sing
Ne biseduakemi .	biseduakemi	1	Plur
Por midis atyre që shtrëngonin rradhët rreth Luterit , për të kërkuar reforma fetare , kishte edhe njerëz që kërkonin gjëra të tjera .	shtrëngonin	4	Plur
Ata do të dëshirojnë .	dëshirojnë	3	Plur
Ne ndihmofshim .	ndihmofshim	1	Plur
Ne ndryshonim .	ndryshonim	1	Plur
Qëllimi i lojës është të godasësh topin larg , edhe të vraposhë reth katrorit me rërë , para se skuadra tjetër ta sjelli topin mbrapsh dhe të eliminojnë nga loja .	godasësh	5	Plur
Pjesa tjetër , sa qesharake aq edhe e mjerueshme , kur njerëzit e metropoleve zbresin në këtë mrekulli .	zbresin	14	Plur
Ata do të ledhatojnë .	ledhatojnë	3	Plur
Ne qafshim .	qafshim	1	Plur
Unë do të lexoja .	lexoja	3	Sing
Ai do të zbehte .	zbehte	3	Sing
Ju do të nënkuptoni .	nënkuptoni	3	Plur
Ata uruan .	uruan	1	Plur
Ne do të masim .	masim	3	Plur
Ata të pëlqejnë .	pëlqejnë	2	Plur
Biti i parë dhe fundit i një hyrje përcaktojnë rreshtin e elementit ndërsa 4 bitat e tjerë përcaktojnë kolonën përkatëse dhe kështu në dalje të secilit nga S-boxat do të këmi 4 bite .	përcaktojnë	8	Plur
Ai të prodhonte .	prodhonte	2	Sing
Ju shtegtuakeni .	shtegtuakeni	1	Plur
Ne thjeshtëzuakemi .	thjeshtëzuakemi	1	Plur
Dënohet me 50 vjet burg , dhe ka të drejtë të kërkojë liri me kusht në vitin 2016 .	kërkojë	11	Sing
Ti ndan .	ndan	1	Sing
Ti të komunikosh .	komunikosh	2	Sing
Ai afirmuaka .	afirmuaka	1	Sing
Ju të pëlqenit .	pëlqenit	2	Plur
Ti flirtoje .	flirtoje	1	Sing
Ne u afrofshim .	afrofshim	2	Plur
Unë të ngrij .	ngrij	2	Sing
Ju sulmonit .	sulmonit	1	Plur
Ata ofendofshin .	ofendofshin	1	Plur
Ti pompoje .	pompoje	1	Sing
Ju do të trishtoheshit .	trishtoheshit	3	Plur
Ne të sqaronim .	sqaronim	2	Plur
Unë rrezikuakam .	rrezikuakam	1	Sing
Ju ndalonit .	ndalonit	1	Plur
Rol të veçantë në këtë drejtim luanin Mustafë Xhemajli , Ismet Rashiti dhe Ibrahim Xhemajli .	luanin	6	Plur
Ti të Pluragosh .	Pluragosh	2	Sing
Botimi i Kanunit u arrit më 1933 , mbas vdekjes së mbledhësit , me një parathënie .	arrit	4	Sing
Ndeshjet me armiqtë ia kishin rritur forcat Shqipërisë edhe atëherë kur dukej se trupi i saj po plakej nga goditjet .	dukej	11	Sing
Ti u zhvirgjërove .	zhvirgjërove	2	Sing
Ti asnjanëson .	asnjanëson	1	Sing
Ne të sajojmë .	sajojmë	2	Plur
Ai u çliroftë .	çliroftë	2	Sing
Ata lexuakëshin .	lexuakëshin	1	Plur
Ti do të ndërlikosh .	ndërlikosh	3	Sing
Ai do të shurrojë .	shurrojë	3	Sing
Unë haja .	haja	1	Sing
Unë u takuakam .	takuakam	2	Sing
Pinjolli i Balshajve mbajti për vete viset e Tejbunës , me Ulqinin e Tivarin .	mbajti	3	Sing
Unë përsosa .	përsosa	1	Sing
Ai prishte .	prishte	1	Sing
Ata masnin .	masnin	1	Plur
Unë përparoja .	përparoja	1	Sing
Ju u zhvillofshit .	zhvillofshit	2	Plur
Siç kishte rënë poshtë , kruspull , me Petritin mbi kurriz , komisari e shtërngoi fort , ia futi gishtërinjtë e ngrirë në gojë e i tha : Mbahu Petrit , do ngjitim të përpjetën .	shtërngoi	14	Sing
Nga viti 1939 ai mërgoi në Francë ku ai punoi shumë .	mërgoi	4	Sing
Ne zbuluakemi .	zbuluakemi	1	Plur
Ju u shurruakeni .	shurruakeni	2	Plur
Në vitet 1686 1687 dy ekspeditat e saj kundër Krimesë përfunduan në disfatë .	përfunduan	10	Plur
Unë të pompoja .	pompoja	2	Sing
Duke kontrolluar shpejtësinë dhe planifikuar drejtimin e topit fëmijët stërviten që ti planifikojnë punët e tyre të përditshme sa më mirë .	stërviten	9	Plur
Ndërsa nurmi është rikuperuar pjesërisht , ngatërresat me rrjetat e peshkimit , goditjet me anije dhe ndotja akustike vazhdojnë të ndikojnë në popullatën e 80,000 balenave gungaçe .	vazhdojnë	18	Plur
Ata komunikuakëshin .	komunikuakëshin	1	Plur
U lind në Shkodër .	lind	1	Sing
Deri më tani festivali është vizituar nga 45,000 përsona dhe pas edicionit të tretë pritet që ky numër të shkoj në 60,000 .	pritet	14	Sing
Çerek finalet : Ndeshjet u luajtën në 1990 .	luajtën	5	Plur
Ti do të dhurosh .	dhurosh	3	Sing
Ne preferonim .	preferonim	1	Plur
Ti zgjohesh .	zgjohesh	1	Sing
Ne do të interpretojmë .	interpretojmë	3	Plur
Ju do të notonit .	notonit	3	Plur
Ti u hidhërove .	hidhërove	2	Sing
Ne të ëndërrojmë .	ëndërrojmë	2	Plur
Unë vazhduakam .	vazhduakam	1	Sing
Unë ndërlikuakam .	ndërlikuakam	1	Sing
Ai dërguakësh .	dërguakësh	1	Sing
Populli i Tiranës i mbyllur brenda saj u mbrojt me heroizëm dhe kalaja nuk u pushtua nga asnjëri prej tyre .	pushtua	15	Sing
Unë të bisedoja .	bisedoja	2	Sing
Ai përmirësoi .	përmirësoi	1	Sing
Ata të dëshirojnë .	dëshirojnë	2	Plur
Unë qëndrova .	qëndrova	1	Sing
Ai do të organizojë .	organizojë	3	Sing
Ne ndamë .	ndamë	1	Plur
Ai do të Pluragonte .	Pluragonte	3	Sing
Ti të zhvilloje .	zhvilloje	2	Sing
Mua më kujtohet se atje kemi qëndruar rreth dy ditë .	kujtohet	2	Sing
Ata përfitojnë .	përfitojnë	1	Plur
Ai udhëtuakësh .	udhëtuakësh	1	Sing
Sistemoi sarkofagun brenda një arkade të kompletuar një rrjetë bronxi .	Sistemoi	0	Sing
Ai të krijojë .	krijojë	2	Sing
Unë provuakësha .	provuakësha	1	Sing
Prej andej ata do të shkonin në një sektor tjetër të largët , do të qëndronin me muaj pa u parë me njerëzit e shtëpisë dhe përsëri do të shkonin diku .	shkonin	5	Plur
Unë hapkësha .	hapkësha	1	Sing
Ti ngacmuakëshe .	ngacmuakëshe	1	Sing
Ne do të shkretojmë .	shkretojmë	3	Plur
Ata do të avullonin .	avullonin	3	Plur
Ti do të dërgoje .	dërgoje	3	Sing
Në vitet 1920 Stefan Banach krijon analizën funksionale dhe u avancua shumë në ndërtimin e një teorie në hapësirat vektoriale të normuara .	krijon	5	Sing
Banesat mbuloheshin me dërrasa të holla bredhi ose tjegulla .	mbuloheshin	1	Plur
Ata do të takojnë .	takojnë	3	Plur
Ju shtrembëruakëshit .	shtrembëruakëshit	1	Plur
Ata dërguan .	dërguan	1	Plur
Shqiptarët po humbin identitetin gjuhësor .	humbin	2	Plur
Ju do të qinit .	qinit	3	Plur
Unë të kundërthosha .	kundërthosha	2	Sing
Ti besoje .	besoje	1	Sing
Zgjidhet delegat i kolonisë shqiptare të Bukureshtit .	Zgjidhet	0	Sing
Ata të sulmojnë .	sulmojnë	2	Plur
Unë shtypkam .	shtypkam	1	Sing
Ai të zhvirgjërohet .	zhvirgjërohet	2	Sing
Unë menduakam .	menduakam	1	Sing
Unë kuptuakësha .	kuptuakësha	1	Sing
Sipas marrëveshjes , presidenca do të alternonte midis konservatorëve dhe liberalëve çdo 4 vjet për 16 vjet .	alternonte	6	Sing
Ju sqaroni .	sqaroni	1	Plur
Ne të shpallim .	shpallim	2	Plur
Unë do të asnjanësoj .	asnjanësoj	3	Sing
Ai puthi .	puthi	1	Sing
Ti të dëmtosh .	dëmtosh	2	Sing
Ju pomponi .	pomponi	1	Plur
Unë takofsha .	takofsha	1	Sing
Ata dhuruan .	dhuruan	1	Plur
Unë do të pastroja .	pastroja	3	Sing
Ne shikuakemi .	shikuakemi	1	Plur
Brenda qelizës këta zinxhirë bazash ADN ndërthuren me proteina dhe formojnë struktura të përqendruara që quhen kromozome dhe zona të veçanta të kromozomit quhen lokuse .	quhen	23	Plur
Ata u bëfshin .	bëfshin	2	Plur
Ai sajuakësh .	sajuakësh	1	Sing
Për ta , gjatë gjithë jetës fliste me respekt të madh , si njerëz dhe mjeshtër të artit të fotografuarit dhe për ndihmën e pakursyer që i kishin dhënë .	fliste	6	Sing
Ata shpifin .	shpifin	1	Plur
Ne luftuakemi .	luftuakemi	1	Plur
Ai ligjëruakësh .	ligjëruakësh	1	Sing
Pasqyron aspektin tmerrues të Majas , fuqinë e manifestimit .	Pasqyron	0	Sing
Ata hapkan .	hapkan	1	Plur
Ju do të notoni .	notoni	3	Plur
Ti të përparoje .	përparoje	2	Sing
Unë qortova .	qortova	1	Sing
Ti arsimofsh .	arsimofsh	1	Sing
Ti dave .	dave	1	Sing
Ata abstenofshin .	abstenofshin	1	Plur
Ai do të lahej .	lahej	3	Sing
Vetit e valës varen nga shpejtësia e erës , zgjatja e saj , është dhe sipërfaqja dhe thellësia e detit ku formohen valët .	varen	3	Plur
Ne të aSingjësojmë .	aSingjësojmë	2	Plur
Ti të shpirtërosh .	shpirtërosh	2	Sing
Ti të sajoje .	sajoje	2	Sing
Ai ngacmoi .	ngacmoi	1	Sing
Ata të qortojnë .	qortojnë	2	Plur
Ai urronte .	urronte	1	Sing
Ata interpretuan .	interpretuan	1	Plur
Ata do të thajnë .	thajnë	3	Plur
Ata të bashkëveprojnë .	bashkëveprojnë	2	Plur
Më 1930 vizitoi për katër muaj Bashkimin Sovjetik dhe e përshkroi situatën atje shumë pozitive .	vizitoi	2	Sing
Ata do të trishtohen .	trishtohen	3	Plur
Unë të avulloja .	avulloja	2	Sing
Në Mbretërinë Dardane ushtria përbënte një forcë të madhe .	përbënte	4	Sing
Unë të ndryshoj .	ndryshoj	2	Sing
Unë qenkam .	qenkam	1	Sing
Ne të aSingjësonim .	aSingjësonim	2	Plur
Unë do të stimuloj .	stimuloj	3	Sing
Bullgaria është një shtet shumë i centralizuar , ku Këshilli Kombëtar i Ministrave emëron drejtpërdrejt guvernatorët rajonalë dhe të gjitha provincat dhe bashkitë janë shumë të varur prej tij financiarisht .	emëron	13	Sing
Repartet e stratiotëve ngriheshin mbi bazën e përkatësisë së njëjtë etnike , por në to luanin rol edhe lidhjet familjare .	luanin	15	Plur
Pavarësisht nga fitorja , Flota e SHBA-së do të pësonte humbje të shumta dhe kjo do të shkaktonte reagime të shumta në SHBA .	pësonte	9	Sing
Ti ndalke .	ndalke	1	Sing
Monoteizmi paraqet besimin dhe njësimin .	paraqet	1	Sing
Ata të komunikojnë .	komunikojnë	2	Plur
Ju lidhshit .	lidhshit	1	Plur
Ju do të gaboni .	gaboni	3	Plur
Ne flirtofshim .	flirtofshim	1	Plur
Vazhdon të punojë mbi " Harku i Triumfit " .	Vazhdon	0	Sing
Ti takofsh .	takofsh	1	Sing
Që prej vitit 2011 , Saimir Tahiri zgjidhet dhe ushtron detyrën e Kryetarit të Partisë Socialiste për Tiranën .	ushtron	9	Sing
Ai hidhërohej .	hidhërohej	1	Sing
Plazmidëve me bazë Ti që iu mungojnë funksionet tumorogjene quhen vektorë të çarmatosur .	quhen	9	Plur
Ju këndonit .	këndonit	1	Plur
Ne do të shqipojmë .	shqipojmë	3	Plur
Ti të takosh .	takosh	2	Sing
Unë votuakam .	votuakam	1	Sing
Ju reagoni .	reagoni	1	Plur
Këtë histori e dëgjojnë shpesh kufitarët nga goja e komisarit .	dëgjojnë	3	Plur
Rrymë trafiku është tërësia mjeteve ose këmbësorëve që lëvizin në rrugë , në të njëjtin drejtim lëvizjeje .	lëvizin	8	Plur
Ne kërcyekemi .	kërcyekemi	1	Plur
Ata të bashkëvepronin .	bashkëvepronin	2	Plur
Ju të fërkoni .	fërkoni	2	Plur
Unë fillofsha .	fillofsha	1	Sing
Ai thekte .	thekte	1	Sing
Ai të copëtojë .	copëtojë	2	Sing
Ne do të trishtohemi .	trishtohemi	3	Plur
Ti mbaroheshe .	mbaroheshe	1	Sing
Ne u stopuakemi .	stopuakemi	2	Plur
Sëmundja nënkupton çrregullimin e shëndetit në kuptimin e gjerë .	nënkupton	1	Sing
Ju përfitoni .	përfitoni	1	Plur
Lëshuesi i kartelës nënkupton çdo institucion publik bankar apo kreditues që lëshon kartelë pagese për shfrytëzim , prodhim apo shërbim elektronik .	nënkupton	3	Sing
Unë ndaloj .	ndaloj	1	Sing
Unë të bëhesha .	bëhesha	2	Sing
Ai krahason .	krahason	1	Sing
Ti noton .	noton	1	Sing
Shkodra u sulmua , por mungoi koordinimi i forcave .	mungoi	5	Sing
Ju të votonit .	votonit	2	Plur
Ai veçuaka .	veçuaka	1	Sing
Unë përmirësova .	përmirësova	1	Sing
Ai do të çlironte .	çlironte	3	Sing
Ne dhunonim .	dhunonim	1	Plur
Ti ndaluake .	ndaluake	1	Sing
Ne të pëlqejmë .	pëlqejmë	2	Plur
Ju vënkeni .	vënkeni	1	Plur
Ne të dorëzohemi .	dorëzohemi	2	Plur
Ne transferuakëshim .	transferuakëshim	1	Plur
Ata kundërthanë .	kundërthanë	1	Plur
Ju organizoni .	organizoni	1	Plur
Unë të mësoja .	mësoja	2	Sing
Ti të kafshoje .	kafshoje	2	Sing
Ti kërkuake .	kërkuake	1	Sing
Massa u rikthye para Kubicës .	rikthye	2	Sing
Ne thënkemi .	thënkemi	1	Plur
Ne kuptuakemi .	kuptuakemi	1	Plur
Ne do të fërkojmë .	fërkojmë	3	Plur
Unë do të krijoja .	krijoja	3	Sing
Unë gjithashtu nuk mund të imagjinoj ndonjë vullnet apo synim jashtë sferës njerëzore .	synim	9	Plur
Ata të zhvirgjërojnë .	zhvirgjërojnë	2	Plur
Ata do të buzëqeshin .	buzëqeshin	3	Plur
Dhe i e kap hundën , por edhe pse e bëri një veprim të tillë në praninë e disa vetëve , ai kurrsesi nuk mund të bindej se e ka kryer atë veprim .	bindej	26	Sing
Unë u bëkam .	bëkam	2	Sing
Ai ardhtë .	ardhtë	1	Sing
Ti do të shfuqizoje .	shfuqizoje	3	Sing
Venomet që u njohu himariotëve , sulltani nuk i respektoi gjithnjë .	respektoi	9	Sing
Vazhdon si nëpunës fotograf pranë Ministrisë së Ndërtimit derisa del në pension .	Vazhdon	0	Sing
Ato ngjiten nga dërguesit e dërgesave dhe vlerësohen nga nëpunësit e postës zakonisht duke e vulosur .	ngjiten	1	Plur
Ata do të organizonin .	organizonin	3	Plur
Nëntë të dhjetat thërrasin Luter si kushtrim , kurse dhjeta tjetër nuk e çan kokën rreth Luterit dhe thërret : Vdekje oborrit të Romës .	thërret	18	Sing
Ti do të injorohesh .	injorohesh	3	Sing
Shokët e ngarkuan të ngrinte degë të kësaj shoqërie në Ohër .	ngrinte	4	Sing
Ata u relaksuan .	relaksuan	2	Plur
Ai të sulmonte .	sulmonte	2	Sing
Ju votuakeni .	votuakeni	1	Plur
Ti adhuroje .	adhuroje	1	Sing
Ai do të krijonte .	krijonte	3	Sing
Syla largohet nga Kosova dhe emigron në Gjermani .	emigron	5	Plur
Autori iu përgjigj : Sa i përket preferimit të muhamedanizmit ndaj ortodoksisë mundem vetëm të pajtohem në mendimin me shpirtrat të cilët janë në këtë kalim .	pajtohem	15	Plur
Unë do të përkëdhelja .	përkëdhelja	3	Sing
Ai mbulon .	mbulon	1	Sing
Më vonë në teatrin e Dionisit i ngritën nje statujë prej bakri .	ngritën	7	Plur
Ti shkëlqeve .	shkëlqeve	1	Sing
Melodia e saj trimërore vjen nga thellësitë e shekujve deri në ditët tona e çan përpara drejt së ardhmes .	çan	14	Sing
Ju ikikeni .	ikikeni	1	Plur
Ti qeshe .	qeshe	1	Sing
Ne përgjithësofshim .	përgjithësofshim	1	Plur
Ne tradhëtonim .	tradhëtonim	1	Plur
Ti shpjeguakëshe .	shpjeguakëshe	1	Sing
Ti të zbulosh .	zbulosh	2	Sing
Unë kafshoj .	kafshoj	1	Sing
Ju themelofshit .	themelofshit	1	Plur
Ata të japin .	japin	2	Plur
Ata kërcyekëshin .	kërcyekëshin	1	Plur
Njësi bazë shoqërore e bashkësisë ishte familja e madhe patriarkale , që bashkonte disa breza dhe që drejtohej nga më plaku .	bashkonte	12	Sing
Ti do të flirtoje .	flirtoje	3	Sing
Ne të sodomizonim .	sodomizonim	2	Plur
Ti do të ledhatoje .	ledhatoje	3	Sing
Njërën do ta ngasë ky shoku ynë .	ngasë	3	Sing
Ju rrini .	rrini	1	Plur
Ti bashkëpunove .	bashkëpunove	1	Sing
Ne do të zhvirgjëroheshim .	zhvirgjëroheshim	3	Plur
Ju do të abonoheni .	abonoheni	3	Plur
Unë afirmoja .	afirmoja	1	Sing
Ky dallim erdhi se armenët me ndikimin e Julianit nga Halikarnasi , pranuan aftartodoketizmi , 454 kurse jakobitët pranuan ptartolatrizmin .	pranuan	12	Plur
Unë takoja .	takoja	1	Sing
Ne shkretuakëshim .	shkretuakëshim	1	Plur
Ai absorbon .	absorbon	1	Sing
Unë stopohesha .	stopohesha	1	Sing
Po ashtu nga kjo vitaminë varen edhe kondicioni trupor dhe kujtesa .	varen	5	Sing
Unë do të takoja .	takoja	3	Sing
Ti ndryshuake .	ndryshuake	1	Sing
Ata do të përkëdhelnin .	përkëdhelnin	3	Plur
Ne ardhkëshim .	ardhkëshim	1	Plur
Unë të zgjohesha .	zgjohesha	2	Sing
Ti qortuakëshe .	qortuakëshe	1	Sing
Luftëtarët kan reaguar shpejt dhe e vranë .	reaguar	2	Plur
Ti do të bisedoje .	bisedoje	3	Sing
Unë lëshuakam .	lëshuakam	1	Sing
Ai të fërkojë .	fërkojë	2	Sing
Ata të vyshkeshin .	vyshkeshin	2	Plur
Ne dhurojmë .	dhurojmë	1	Plur
Me pushtimin italian , Asimi qëndron në Shqipëri , por nuk do të zgjasë shumë dhe u internua në Italinë Veriore për rreth 18 muaj .	zgjasë	13	Sing
Ai theki .	theki	1	Sing
Ti të nderoje .	nderoje	2	Sing
Ju gëzofshit .	gëzofshit	1	Plur
Ti do të gaboje .	gaboje	3	Sing
Ti mardhsh .	mardhsh	1	Sing
Vieira mund të përdoret në çdo lojë për shkak të një muskuli në kofshën e tij .	përdoret	3	Sing
Të përballur me sulmues të huaj dhe murtaja , Perandoritë Perëndimore dhe Lindore ndaluan bashkëpunimin , dhe të ashtuquajturat kohët e errëta lindën .	lindën	22	Plur
Pastaj ai u emërua kreu i njësisë së analizave dhe informacionit në Zyrën e Jashtme Federale , një funksion që ai e mbajti deri më 1976 .	mbajti	22	Sing
Ata do të ofendonin .	ofendonin	3	Plur
Unë do të udhëzoj .	udhëzoj	3	Sing
Ti u lafsh .	lafsh	2	Sing
Ju uruat .	uruat	1	Plur
Ju e dini që rruga është e vështirë dhe e lodhshme .	dini	2	Plur
Ti gënjeve .	gënjeve	1	Sing
Ata do të nënkuptojnë .	nënkuptojnë	3	Plur
Ne të kundërshtonim .	kundërshtonim	2	Plur
Ata shurruakëshin .	shurruakëshin	1	Plur
Ju të sakrifikoni .	sakrifikoni	2	Plur
Ne të thoshim .	thoshim	2	Plur
Ju të shtegtonit .	shtegtonit	2	Plur
Unë uroja .	uroja	1	Sing
Ti do të organizoje .	organizoje	3	Sing
Turma zgjodhi të lirohej Barabbaja dhe të kryqëzohej Jezusi .	lirohej	3	Sing
Ju do të parapëlqenit .	parapëlqenit	3	Plur
Pastaj i pyet se përse ata ngulin këmbë për të sulmuar Tiranën me kaq ngut është e dyta herë që ngulin këmbë , të njëjtën gjë kanë shtruar edhe 3 apo 4 ditë më parë .	ngulin	6	Plur
Ti u relaksuakëshe .	relaksuakëshe	2	Sing
Ata të ndalonin .	ndalonin	2	Plur
Ti zgjoheshe .	zgjoheshe	1	Sing
Ti do të thekësh .	thekësh	3	Sing
Ata të nderojnë .	nderojnë	2	Plur
Ai të mëndë .	mëndë	2	Sing
Ata shqipuan .	shqipuan	1	Plur
Ata të masturboheshin .	masturboheshin	2	Plur
Ju ndenjçit .	ndenjçit	1	Plur
Ju të lidhnit .	lidhnit	2	Plur
Ju do të abuzoni .	abuzoni	3	Plur
Sa i përket kafshëve ato dallojnë për nga ngjyra e lëkurës dhe mundësia për përshtatshmëri .	dallojnë	5	Plur
Ai do të udhëtojë .	udhëtojë	3	Sing
Ata u sulmofshin .	sulmofshin	2	Plur
Nëntë të dhjetat thërrasin Luter si kushtrim , kurse dhjeta tjetër nuk e çan kokën rreth Luterit dhe thërret : Vdekje oborrit të Romës .	thërrasin	3	Plur
Ata veçojnë .	veçojnë	1	Plur
Mënyra më e drejtpërdrejtë dhe më e hapur për të matur vlerën rms është matja e nxehtësisë që e gjeneron ngarkesa dhe e krahason atë me nxehtësinë të cilën e gjeneron ngarkesa e njohur e një tensioni njëkahor .	gjeneron	19	Sing
Ju jepni .	jepni	1	Plur
Ata do të mësojnë .	mësojnë	3	Plur
Me stimulim të mjaftueshëm , zona mund të fillojë të ënjtet dhe të ndjehet në prekje si një bizele e vogël .	ënjtet	10	Sing
Ai mendonte se si do nxiste të ngriheshin me guxim kundër shtypjes e do të bëhej krah në raste hallesh .	mendonte	1	Sing
Ne ofendojmë .	ofendojmë	1	Plur
Ju filluat .	filluat	1	Plur
Ai ndalte .	ndalte	1	Sing
Unë të njoftoj .	njoftoj	2	Sing
Ky është një fakt të cilin edhe ata vetë e pranojnë .	pranojnë	10	Plur
Unë shtegtoj .	shtegtoj	1	Sing
Ata ndihin .	ndihin	1	Plur
Unë njoftofsha .	njoftofsha	1	Sing
Studimet e mesme i kreu në Shkodër kurse studimet e larta në Moskë për inxhinieri nafte .	kreu	4	Sing
Ai u afruaka .	afruaka	2	Sing
Veliu u pendua që nuk e ndaloi makinën , por tani ishte vonë , pasi e kishte marrë kthesën .	ndaloi	6	Sing
Ne do të ligjërojmë .	ligjërojmë	3	Plur
Ne do të përsosim .	përsosim	3	Plur
Unë do të pompoj .	pompoj	3	Sing
Ne të gënjejmë .	gënjejmë	2	Plur
Ne do të shtypim .	shtypim	3	Plur
Ata ngrënçin .	ngrënçin	1	Plur
Ai shpif .	shpif	1	Sing
Unë u sodomizova .	sodomizova	2	Sing
Ju thënçit .	thënçit	1	Plur
Ai të abonohej .	abonohej	2	Sing
Ne do të urinonim .	urinonim	3	Plur
Unë nderoja .	nderoja	1	Sing
Ky vendbanim shtrihet në një fushëgropë përmes së cilës bie një lumë i vogël që e quajnë Përroni .	quajnë	16	Sing
Ne besojmë .	besojmë	1	Plur
Ata stimulojnë .	stimulojnë	1	Plur
Unë fërgoja .	fërgoja	1	Sing
Ju të gëzonit .	gëzonit	2	Plur
Ata këndonin .	këndonin	1	Plur
Ju të shpifni .	shpifni	2	Plur
Ai të zhvirgjërohej .	zhvirgjërohej	2	Sing
Ata interpretuakëshin .	interpretuakëshin	1	Plur
Ai do të bashkëvepronte .	bashkëvepronte	3	Sing
Ata do të dorëzoheshin .	dorëzoheshin	3	Plur
Ti do të flirtosh .	flirtosh	3	Sing
Por pushteti i perandorit nuk ndihej fortë në këtë pjesë të perandorisë dhe kështu mund të formoheshin vende të mëdha dhe të vegjël që mund të quheshin autonome .	formoheshin	16	Plur
Ne ledhatojmë .	ledhatojmë	1	Plur
Ne do të lidhim .	lidhim	3	Plur
Ju mëndët .	mëndët	1	Plur
Patito nuk është i vetmi që merr një të dashurin : Leandro , pavarësisht nga martesa e tij me Bianca , i jep zemrën e tij për të Carmen , i cili pranon .	pranon	32	Sing
Ti përkufizon .	përkufizon	1	Sing
Ai do të dëshirojë .	dëshirojë	3	Sing
Ti lëpin .	lëpin	1	Sing
Ai do të zgjojë .	zgjojë	3	Sing
Ju qani .	qani	1	Plur
Ai do të abonohej .	abonohej	3	Sing
Ata veçonin .	veçonin	1	Plur
Ju do të ndryshoheni .	ndryshoheni	3	Plur
Ata sakrifikuakan .	sakrifikuakan	1	Plur
Ne kënduakemi .	kënduakemi	1	Plur
Unë mas .	mas	1	Sing
Ai do të dërmonte .	dërmonte	3	Sing
Ai do të qeshë .	qeshë	3	Sing
Ai u punësoi .	punësoi	2	Sing
Ti u relaksofsh .	relaksofsh	2	Sing
Ne të trishtohemi .	trishtohemi	2	Plur
Ata të sulmonin .	sulmonin	2	Plur
Ju të fillonit .	fillonit	2	Plur
Ti abuzon .	abuzon	1	Sing
Ai reaguakësh .	reaguakësh	1	Sing
Ju arësyetuat .	arësyetuat	1	Plur
Ne të injoroheshim .	injoroheshim	2	Plur
Ata propozonin .	propozonin	1	Plur
Që në kohët e themelimit të Romës shpesh herë organizoheshin aktivitete ose festa fetare në qendër të së cilave qëndronin garat në sporte të ndryshme .	organizoheshin	9	Plur
Ata pastrojnë .	pastrojnë	1	Plur
Aty ai u carmatos dhe u internua në Gjakovë nga qeveria e Jugosllavisë .	carmatos	3	Sing
Ju sulmuakeni .	sulmuakeni	1	Plur
Ai thau .	thau	1	Sing
Unë qikam .	qikam	1	Sing
Për fat të mirë , të gjitha pikturat që kishte strehuar ishin ruajtur dhe së bashku me koleksionin e artit mbretëror tashmë të ekspozuar në pallat formoi aksionet e Galerisë Kombëtare të Artit .	formoi	26	Sing
Ata besuakëshin .	besuakëshin	1	Plur
Ata kishin për detyrë të plaçkitnin , të vrisnin popullsinë e Muriqit të sipërm dhe ta digjnin atë , përfundimisht .	vrisnin	8	Plur
Ne u afruam .	afruam	2	Plur
Ti të sodomizoheshe .	sodomizoheshe	2	Sing
Në Shqipëri erdhën eshtrat , me kujdes e me ceremoni , por gjaku i derdhur mbeti !	erdhën	2	Plur
Ne zbehkëshim .	zbehkëshim	1	Plur
Unë do të mirësoj .	mirësoj	3	Sing
Ne të qortonim .	qortonim	2	Plur
Ju zbuluakëshit .	zbuluakëshit	1	Plur
Ju krahasonit .	krahasonit	1	Plur
Ai preferuakësh .	preferuakësh	1	Sing
Ne të justifikojmë .	justifikojmë	2	Plur
Ti shihje .	shihje	1	Sing
Ata kundërthënkëshin .	kundërthënkëshin	1	Plur
Ai skllavëroftë .	skllavëroftë	1	Sing
Pas luftërave që pasuan , Kremlini pësoi dëme të mëdha , por jo të pariparueshme .	pasuan	3	Plur
Që nga zbulimi i tyre , pallatat e shkrepave i kanë bërë arkeologët të ngrenë vazhdimisht pyetjen , pse ndodhi kështu ?	ngrenë	14	Plur
Ju të avulloni .	avulloni	2	Plur
Unë grumbullova .	grumbullova	1	Sing
Libri përbëhet nga dy pjesë të cilat dallohen qartë nga njëra-tjetra .	dallohen	7	Plur
Unë relaksohem .	relaksohem	1	Sing
Ju keqkuptoni .	keqkuptoni	1	Plur
Ata të zbehnin .	zbehnin	2	Plur
Ata dëshiruan .	dëshiruan	1	Plur
Unë do të adhuroj .	adhuroj	3	Sing
Ne do të zhvirgjëronim .	zhvirgjëronim	3	Plur
Ata do të pastrojnë .	pastrojnë	3	Plur
Ju pshurrni .	pshurrni	1	Plur
Unë do të pshurrja .	pshurrja	3	Sing
Ti reagon .	reagon	1	Sing
Skenari që paraqet në zbulesën e tij Gjoni , shkruhet se kur të shfaqet në mbarë botën numri 666 , askush nuk mund të blejë apo shesë pa " numrin e Shtazës " .	shkruhet	9	Sing
Ai thëntë .	thëntë	1	Sing
Ju do të krijoni .	krijoni	3	Plur
Veçse kryesorja mungon i nderuari eskavatorist .	mungon	2	Sing
Ne zhvirgjëronim .	zhvirgjëronim	1	Plur
Lindi në Shën Pjetërburg , Rusi në vitin 1899 dhe jetoi atje deri në moshën 18 vjeçare .	Lindi	0	Sing
Vetëm në vitin 1990 fluturimet ndërkombëtare filluan të ateronin në Gjermani dhe Zvicër .	ateronin	8	Plur
Ju do të fshini .	fshini	3	Plur
Ata peshohen .	peshohen	1	Plur
Ne të lëshonim .	lëshonim	2	Plur
Në shtator të vitit 1807 anglezët kapitulluan .	kapitulluan	6	Plur
Ti do të këndosh .	këndosh	3	Sing
Ne shpifshim .	shpifshim	1	Plur
Ai mbarohej .	mbarohej	1	Sing
Ata do të ngacmonin .	ngacmonin	3	Plur
Ti sodomizohesh .	sodomizohesh	1	Sing
Ju shfuqizofshit .	shfuqizofshit	1	Plur
Unë shpirtërova .	shpirtërova	1	Sing
Për të përmirësuarit të shoqërisë , sistemi shkollar lipset të përmbledhë edhe shkolla të veçanta për sakatërit .	përmbledhë	10	Sing
Ne reagofshim .	reagofshim	1	Plur
Ju do të preferoni .	preferoni	3	Plur
Ti stimuluakëshe .	stimuluakëshe	1	Sing
Ju do të sakrifikonit .	sakrifikonit	3	Plur
Ai jetuakësh .	jetuakësh	1	Sing
E shartuar me mezhdrave përballon kushte më të vështira tokësore dhe më tepër gëlqerore .	përballon	4	Sing
Ne ndryshofshim .	ndryshofshim	1	Plur
Ai stimulonte .	stimulonte	1	Sing
Ai të argëtojë .	argëtojë	2	Sing
Ai të ndalojë .	ndalojë	2	Sing
Ndarja e punës është ajo që gjithnjë e më tepër luan rolin që më parë e luante vetëdija kolektive .	luan	10	Sing
Në shtator 1783 , ai ishte zgjedhur si anëtar i akademisë së Arrasit , në takime të cilat ai shkonte rregullisht .	shkonte	19	Sing
Ju të hidhëroheni .	hidhëroheni	2	Plur
Ju do të kërkoni .	kërkoni	3	Plur
Unë sodomizoja .	sodomizoja	1	Sing
Unë mëndja .	mëndja	1	Sing
Sidoqoftë , dy ngritje masive të jakobitëve që u lëshuan më 1715 dhe 1745 dështuan ta largonin " Shtepinë Hanover " nga froni britanik .	largonin	16	Plur
Unë skllavëroj .	skllavëroj	1	Sing
Ti të lahesh .	lahesh	2	Sing
Ata abstenuakëshin .	abstenuakëshin	1	Plur
Ata të preknin .	preknin	2	Plur
Ju ngritkëshit .	ngritkëshit	1	Plur
Ju u abonuat .	abonuat	2	Plur
Ju ngrikeni .	ngrikeni	1	Plur
Ne do të dhembim .	dhembim	3	Plur
Unë të krijoja .	krijoja	2	Sing
Percepton thellësi , prandaj frikësohet nga lartësia dhe nga rrëzimi .	Percepton	0	Plur
Ata do të armatosin .	armatosin	3	Plur
Ne ardhshim .	ardhshim	1	Plur
Ai u zgjoftë .	zgjoftë	2	Sing
Ai të fërgojë .	fërgojë	2	Sing
Ne të zgjojmë .	zgjojmë	2	Plur
Ai rënkuaka .	rënkuaka	1	Sing
Unë u relaksuakam .	relaksuakam	2	Sing
Ne do të transferojmë .	transferojmë	3	Plur
Ai ledhaton .	ledhaton	1	Sing
Ti abuzuakëshe .	abuzuakëshe	1	Sing
Ushtritë ruse filluan të përparonin përmes Maleve Ballkan .	përparonin	4	Plur
Për disa ditë rënkoi në shtrat nga temperatura e lartë dhe më 13 qershor vdiq në krevat i sëmurë .	rënkoi	3	Plur
Mos u kënaqeni shum me fitoren tuaj , kush e di si mund të bëhet nesër .	kënaqeni	2	Plur
Qëndruam para grykës për një çast pa këmbyer asnjë fjalë .	Qëndruam	0	Plur
Qendra e fshatit , kryet e mahallës , kroni , e pra çdo vendtakim i mundshëm largojnë së paku për një moment telashen e rëndë të të qenurit i vetmuar .	largojnë	16	Plur
Ne do të konsistonim .	konsistonim	3	Plur
Unë votofsha .	votofsha	1	Sing
Përrenjtë dhe luginat e vogla që lidhin liqenin me pellgun e Drinit krijojnë fjorde të vegjël që futen në brendësi të masiveve malorë .	krijojnë	12	Plur
Ju të injoroheni .	injoroheni	2	Plur
Më vonë rrënohet edhe kisha ortodokse .	rrënohet	2	Sing
Ai ndihkësh .	ndihkësh	1	Sing
Ju të transferoni .	transferoni	2	Plur
Çdo vit vazhdon të japë në jetën e përditshme , dhe afron dicka tek çdo njeri .	afron	11	Sing
Ata harruan .	harruan	1	Plur
Ju lëpitë .	lëpitë	1	Plur
Por ndryshon puna kur jepet , të themi , jeta e antagonisteve , të cilët notojnë në luks , ndonjëherë edhe në ves .	notojnë	15	Plur
Ne zbukurojmë .	zbukurojmë	1	Plur
Ne ndryshojmë .	ndryshojmë	1	Plur
Ti përsos .	përsos	1	Sing
Ai ledhatoftë .	ledhatoftë	1	Sing
Ti do të peshoheshe .	peshoheshe	3	Sing
Myslimanët e lexojnë këtë ajet para se të flejnë .	flejnë	8	Plur
Ata absorbuan .	absorbuan	1	Plur
Unë të shkatërroja .	shkatërroja	2	Sing
Ne do të zhvilloheshim .	zhvilloheshim	3	Plur
Ata u masturbuakan .	masturbuakan	2	Plur
Ne abdikofshim .	abdikofshim	1	Plur
Limfa luan rolin e këmbimit të materieve ndërmjet gjakut dhe indeve tjera .	luan	1	Plur
Ti do të udhëzosh .	udhëzosh	3	Sing
Ti masturbuake .	masturbuake	1	Sing
