Dwa osobowe samochody zderzyły się dachami .	zderzyły	3	Plur
W miastach do 200 tys . mieszkańców PO i PiS zremisowały .	zremisowały	10	Plur
Odstawił em parasol , usiadł em obok Ryśka .	Odstawił	0	Sing
Nie były nigdy wydawane , przechowywali śmy je w archiwum rodzinnym .	przechowywali	5	Plur
Stawiał sobie wielkie problemy i plon jego pracy był wielki .	Stawiał	0	Sing
Zaczął em go obnażać …	Zaczął	0	Sing
Dodawał też , że korzystał z jawnych źródeł .	korzystał	4	Sing
Żołnierze poznańskiego garnizonu pełnili honorową straż .	pełnili	3	Plur
- Wyszło , że mam o 0,65 metra większe mieszkanie .	Wyszło	1	Sing
Siedzimy naprzeciw siebie , pijemy herbatę , jemy piernik domowego wypieku .	jemy	7	Plur
Agnieszka Strumiłowska opowiedziała mi historię z jej czasów studenckich .	opowiedziała	2	Sing
- Czy w szkołach pobliskich pracują nauczyciele z mniejszości ?	pracują	5	Plur
Uprawnienia selekcjonerskie dają prawo do odstrzału samców zwierzyny płowej .	dają	2	Plur
Panowie nie mieli najmniejszych problemów z dziwnie skleconą reprezentacją Reszty Świata , panie też gładko wygrały z osłabioną ekipą USA .	wygrały	15	Plur
- To rekin , a ty się boisz , że przy pierwszej okazji wytarmoszę go za płetwy .	boisz	7	Sing
no pan optuje za Niemcami .	optuje	2	Sing
Zaraz po lekcjach pierwszy wybiegał em z klasy i pędził em do domu .	wybiegał	4	Sing
Dwie osoby zmarły przed szpitalem .	zmarły	2	Plur
Emil Drejtser urodził się w Odessie , wyemigrował do USA w 1974 roku .	wyemigrował	7	Sing
Postanowił , że jej nie odpuści .	odpuści	5	Sing
Klasztor na Jasnej Górze przeżywa prawdziwe oblężenie .	przeżywa	4	Sing
I podobno wcale ich nie dogonili .	dogonili	5	Plur
– Po co go tu przysłali ?	przysłali	5	Plur
- Masz , bierz .	bierz	3	Sing
Wyraźnie pokazują to sondaże .	pokazują	1	Plur
Nie znali się za życia .	znali	1	Plur
– zrobię wam zdjęcie .	zrobię	1	Sing
Mucha wypoczywała na jego dłoni .	wypoczywała	1	Sing
Bóg go wysłuchał , wróciła szczęśliwie .	wysłuchał	2	Sing
Do głosowania nad projektem dojdzie prawdopodobnie w sobotę .	dojdzie	4	Sing
Udawał , że nie może znaleźć listu .	Udawał	0	Sing
Rzadko je to uszczęśliwia , często się buntują i wtedy cała rodzina ma problemy .	uszczęśliwia	3	Sing
Postarajmy się wyśledzić je od początku .	Postarajmy	0	Plur
Usiedli obydwaj przy herbacie zaparzonej w grubych szklankach .	Usiedli	0	Plur
Sprawy budżetowe zajmą więc zapewne sporo czasu na czwartkowej sesji .	zajmą	2	Plur
Idę coś zjeść .	Idę	0	Sing
Kolejne inwentaryzacje dowodzą , że na półkach biblioteki brakuje kolejnych tytułów .	dowodzą	2	Plur
Również wysokie pozycje zajęły inne polskie załogi .	zajęły	3	Plur
Powstało z komitetów na rzecz referendum w sprawie karania za aborcję .	Powstało	0	Sing
Szczep nie zazieleni się więcej .	zazieleni	2	Sing
W pierwszej kolumnie kroczą woje Chrobrego .	kroczą	3	Plur
Pyta , czy długo będziemy czekać .	Pyta	0	Sing
Zamordował ją konkubent , do którego przeniosła się z córką .	przeniosła	6	Sing
Tego typu testowania zwykle jednak nie przeprowadzają członkowie rządu .	przeprowadzają	6	Plur
Pociski są przerdzewiałe i posiadają zapalniki .	posiadają	4	Plur
Zdarzenie z kamykiem nie wychodziło mu z głowy .	wychodziło	4	Sing
Gdzieś tam w toalecie cicho zaskrzypiały drzwi , a na dużej sali czyjeś kroki szybko zdążały w tę stronę .	zdążały	15	Plur
Ślizgawki w Dąbrowie Górniczej odbywają się już od 4 lat .	odbywają	4	Plur
- Nie powtarzaj mi tego , bo jeszcze zmienię zdanie .	powtarzaj	2	Sing
Krytykowali , ale zatwierdzili . . .	zatwierdzili	3	Plur
Nie kryją się z tym , chcą być widziani , rozpoznani ?	kryją	1	Plur
Dotychczas obowiązek donoszenia WKU o studentach , którzy przerwali naukę , spoczywał na uczelniach .	spoczywał	11	Sing
Zmieniały się tylko nazwiska i wielkość zdeprawowanych pieniędzy .	Zmieniały	0	Plur
– pokaż !	pokaż	1	Sing
Potrząsnął głową , odchrząknął .	odchrząknął	3	Sing
Prosi się też zakłady pracy , które dysponują autobusami , by wspomogły komunikację zastępczą .	wspomogły	11	Plur
Stali i trzymali się w objęciach .	Stali	0	Plur
– Mógł .	Mógł	1	Sing
- Panie przodowniku , jak pragnę wolności , to same równe chłopaki .	pragnę	5	Sing
I koniecznie zabierz ze sobą jakąś książkę .	zabierz	2	Sing
Spróbował poruszyć głową .	Spróbował	0	Sing
Owa niezapomniana chwila zawierała nieprawdopodobny ładunek patosu .	zawierała	3	Sing
Postanowiłam , że nie będę się zmuszała do pracy , ale wzięło mnie i poprawiłam całość .	wzięło	11	Sing
a ile płacicie ?	płacicie	2	Plur
Przewiduję obopólne korzyści .	Przewiduję	0	Sing
Banki akcyjne brały prowizje od swych usług i szukały zysku .	szukały	8	Plur
Przewodnictwo , ruch lodu i przesiąkanie wody przemieszczają ciepło w obrębie lodowca .	przemieszczają	7	Plur
Ale góry się nie poddawały .	poddawały	4	Plur
Świadczy o tym choćby ceremoniał religijny podczas zaprzysiężenia .	Świadczy	0	Sing
Potem nagle umilkł i równie nagle wrzasnął .	umilkł	2	Sing
Po przewrocie władzę w Algierii objęła Rada Rewolucyjna .	objęła	5	Sing
Po kilku miesiącach pracownicy stają się bierni , chorują na śpiączkę .	chorują	8	Plur
Unosiła się wokół nich anielska aura .	Unosiła	0	Sing
W jej twarzy , mokrej od łez rozmazanych i czerwonej , tężały w osłupieniu szkliste , bladoniebieskie oczy .	tężały	11	Plur
- Łechczesz moją próżność .	Łechczesz	1	Sing
Ręce mu drżały , gdy podnosił szklankę .	drżały	2	Plur
Wieczorem wymykają się z hoteliku , by spojrzeć na ulubioną maszynę i pocałować ją na dobranoc .	wymykają	1	Plur
- Ja każdemu poradzę .	poradzę	3	Sing
Firma skontaktowała się ze mną , przedstawiając opinię rzeczoznawcy .	skontaktowała	1	Sing
– Policzysz , jak zechcesz .	Policzysz	1	Sing
- Blondynka popatrzyła na tancerzy , którzy przy bufecie głośno rozmawiali z właścicielem knajpy .	popatrzyła	2	Sing
Dojedli śniadanie , wyjęli papierosy , zapalili .	wyjęli	3	Plur
Czy wiedzieli coś o sobie ?	wiedzieli	1	Plur
- Ulegam przemocy .	Ulegam	1	Sing
W katowickim oddziale WBK pierwszy klient wykupił wszystkie akcje .	wykupił	6	Sing
- W pani wierszach , które zawsze tak intensywnie portretują otoczenie i pejzaż , nie ma śladu Warszawy .	portretują	9	Plur
Uczą się i pomagają innym .	Uczą	0	Plur
W tym miejscu skarpa załamywała się pod kątem prostym .	załamywała	4	Sing
W niedzielę , kiedy ojciec wrócił z kościoła , Piotr jeszcze spał .	spał	11	Sing
Nawiązują kontakty w miasteczku , zakładają meliny .	Nawiązują	0	Plur
Idę do miasta .	Idę	0	Sing
Mogł em szczęście dać .	Mogł	0	Sing
Wsuwa się pod głowę leżącego , błądzi palcami po jego twarzy .	Wsuwa	0	Sing
Ten pocałunek parzy mi dłoń .	parzy	2	Sing
Zboża mniej się opłacają .	opłacają	3	Plur
Policjanci z pobliskiego komisariatu przyznają , że docierają do nich sygnały o rozbojach .	docierają	7	Plur
Dwukrotnie SKO przyznało im rację .	przyznało	2	Sing
Ale ja nie będę się mścił . . .	mścił	5	Sing
Krytykowali , ale zatwierdzili . . .	Krytykowali	0	Plur
włożyła ś .	włożyła	0	Sing
Nagle zauważam , że balkon chwieje się i pęka .	chwieje	5	Sing
- Jeśli mnie podejrzewacie . . .	podejrzewacie	3	Plur
Są pożyteczne , zbliżają ludzi i umacniają przyjaźnie , a artystom garmażerni , barmanom , kelnerom i sprzątaczkom płaci kasjer ambasady .	umacniają	6	Plur
Gdy rozpędzał je kamień , uciekały w krzaki z pyskami wbitymi w puszki po konserwach .	uciekały	5	Plur
- Macie rację , tylko Hiszpanie mogli wymyślić barok .	Macie	1	Plur
Stolicę zamieszkuje dziś 1,115.000 ludzi .	zamieszkuje	1	Sing
Dzieci się uczą na pamięć długości rzek , głębokości jezior . . .	uczą	2	Plur
Długo machali rękami zostającemu na peronie Staszkowi Kuli .	machali	1	Plur
Teraz do kontrakcji przystąpili wszyscy ludzie przegranego Rybnika .	przystąpili	3	Plur
W Olsztynie pod drzwiami szpitalnymi zmarły ostatnio dwie osoby .	zmarły	5	Plur
– Tyle głów rozłupali śmy przed twoją . . .	rozłupali	3	Plur
Miejmy nadzieję , że ich nowa redakcja zawierać będzie wnioski autorów omawianej publikacji .	Miejmy	0	Plur
Do poradni chirurgicznej i pogotowia ratunkowego napływali poszkodowani piesi .	napływali	6	Plur
Festiwal zorganizował WOAK i Podlaskie Kuratorium Oświaty w Białymstoku .	zorganizował	1	Sing
Może nauczysz się wreszcie , jak się takie rzeczy załatwia .	nauczysz	1	Sing
– dlaczego tego już nie produkują ?	produkują	5	Plur
Rządowy projekt chroni dzieci i młodzież .	chroni	2	Sing
Apostołowie tego nie praktykowali .	praktykowali	3	Plur
Idą czwórkami .	Idą	0	Plur
Ani my ciebie nie pobudzamy , ani ty się nie dzielisz .	pobudzamy	4	Plur
Dlaczego tak go wciągały ?	wciągały	3	Plur
Obowiązują tu także egzaminy teoretyczne .	Obowiązują	0	Plur
– powycierali .	powycierali	1	Plur
Połączyły siły .	Połączyły	0	Plur
- Pomyślał em o tym .	Pomyślał	1	Sing
Szedł w pełnym słońcu , skronie przygniatał piekący ciężar .	przygniatał	6	Sing
Te grzechy spowiada tylko Chrystus .	spowiada	2	Sing
Tymczasem nasi reporterzy odnajdują mężczyznę , na którego wezwanie zareagowali nocą policjanci .	odnajdują	3	Plur
Ze zdziwieniem spostrzegł , że jego lewa noga stopą dotyka mu twarzy .	spostrzegł	2	Sing
Tutaj jedynie pokrótce opiszemy ten standard i nieco uzupełnimy zaprezentowane w wymienionych artykułach informacje .	opiszemy	3	Plur
Zaproponowali , że przerobią telefon tak , by można było z niego bezpłatnie rozmawiać .	Zaproponowali	0	Plur
Powtarzał to tak głośno , że na całej ulicy było go słychać .	Powtarzał	0	Sing
Zaczął się wielki exodus .	Zaczął	0	Sing
Nocą słyszymy skrzypienie , jakby ktoś przechadzał się po niebie ułożonym ze starych , drewnianych desek .	słyszymy	1	Plur
Niech pada !	pada	1	Sing
Akceptacja wyraża obiektywną prawdę o człowieku , a nie tylko subiektywne przeżycia jednostki .	wyraża	1	Sing
Oni nie kierowali wydarzeniami , nawet nie próbowali .	próbowali	7	Plur
Podniosły głowy ratuszowe lwy .	Podniosły	0	Plur
Wprowadzić mechanizm , by sądy respektowały takie ugody .	respektowały	5	Plur
Spotkanie w urzędzie wywarło na wszystkich jego uczestnikach niesamowite wrażenie .	wywarło	3	Sing
Gonią mnie potwory .	Gonią	0	Plur
Plama pływała w zakolu , nie spłynęła nurtem .	spłynęła	6	Sing
Ludka potrząsnęła głową .	potrząsnęła	1	Sing
Uważam , że pomógł .	Uważam	0	Sing
Stłuces głobe !	Stłuces	0	Sing
- Zbita z tropu uśmiechnęła się niepewnie .	uśmiechnęła	4	Sing
Byli w wielu innych związkach , które się jednak rozsypały .	Byli	0	Plur
Stworzyła polski oddział EquiLibre , organizowała konwoje z pomocą dla byłej Jugosławii , Kazachstanu , Czeczenii .	Stworzyła	0	Sing
Wyniki badań nad wszystkimi 13 właściwościami doskonale ilustruje przejrzysty wykres na 165 stronie książki .	ilustruje	7	Sing
Na skrzyżowaniach wyrastają rośli policjanci , gazeciarze wciskają przechodniom papierowe płachty i przekrzykują się nowościami z wczorajszego dnia i nocy , która właśnie minęła .	przekrzykują	12	Plur
Dzięki temu amatorzy kąpieli słonecznych będą mogli się poopalać .	mogli	6	Plur
Elizabeth uśmiechnęła się do kobiet , a one uśmiechnęły się do niej .	uśmiechnęły	8	Plur
Ponoć nie życzyli sobie ich obecności inni dziennikarze . . .	życzyli	2	Plur
Dziewczyny mówią , że piszczała , płakała , śmiała się , przykucnęła , usiłując uspokoić drżące od wysiłku mięśnie i wtedy rzuciły się na nią . . .	przykucnęła	11	Sing
Liczyli zdobyte łupy , oglądali własne i nieprzyjacielskie straty .	oglądali	4	Plur
Jakie priorytety wiążą się z mincerzami ?	wiążą	2	Plur
Nie wstąpi jego stopa junacka w strzemiona ojcowe .	wstąpi	1	Sing
- Pisali śmy razem komunikaty z posiedzeń TKK .	Pisali	1	Plur
Podała mi lusterko .	Podała	0	Sing
Podczas ceremonii otwarcia Spływu organizatorzy przyznali liczne odznaczenia zasłużonym kajakarzom .	przyznali	5	Plur
Wtedy Bóg złapie to całe towarzystwo łącznie ze mną i wrzuci w ogień piekielny , a będzie tam płacz i zgrzytanie zębów .	złapie	2	Sing
Zakończyły się sukcesem .	Zakończyły	0	Plur
Należy się cieszyć , że w tych wielkich odkryciach uczestniczą nasi koledzy .	uczestniczą	9	Plur
Za każdy samochód zabierali się od razu mechanicy , zmieniali koła , usuwali uszkodzenia powstałe w czasie forsownego treningu , wymieniali zdarte nakładki hamulcowe , regulowali silniki .	wymieniali	20	Plur
Cały nakład rozszedł się błyskawicznie .	rozszedł	2	Sing
- Napijmy się .	Napijmy	1	Plur
Starał em się wejść w sytuację doktora Ciszewskiego .	Starał	0	Sing
Szeroko otwierał szkarłatne oczy , drgały mu wrażliwe nozdrza .	otwierał	1	Sing
Pani Rylicka odchyliła się do tyłu .	odchyliła	2	Sing
- Nie trza , damy se sami radę !	damy	4	Plur
Równocześnie , zdecydowana większość uważa , że w Polsce tylko nieliczni mogą się wzbogacić .	uważa	4	Sing
Ciałem szarpią suche torsje .	szarpią	1	Plur
Oglądam się .	Oglądam	0	Sing
Napastników zdradziły nagrania kamer na dworcu i w brukselskim metrze .	zdradziły	1	Plur
Trzeszczą cekaemy i tną powietrze .	tną	3	Plur
Hipermarkety zmieniają swoich właścicieli .	zmieniają	1	Plur
Nagrali razem pierwszą płytę .	Nagrali	0	Plur
Nad głową ojca dyrektora od kilku tygodni gromadzą się czarne chmury .	gromadzą	7	Plur
Na huśtawce huśta się dziecko , huśtawka skrzypi .	huśta	2	Sing
Zastrzeżenia wojewody dotyczyły tylko Polaków na stanowiskach kierowniczych .	dotyczyły	2	Plur
Szybuje do ziemi .	Szybuje	0	Sing
- Rządowi nie wierzę .	wierzę	3	Sing
Chodź , poszukamy czegoś na Trzynachę .	poszukamy	2	Plur
Mieli śmy już za sobą wzniesienie i za zakrętem opadającej łagodnie drogi wyłonił się skraj cmentarza .	wyłonił	12	Sing
Stwierdziła z zadowoleniem , że całość prezentuje się bardzo wiarygodnie , zwłaszcza w przyćmionym świetle .	Stwierdziła	0	Sing
Padli sobie w objęcia .	Padli	0	Plur
Przywożą nam żywność przez góry z Władykaukazu .	Przywożą	0	Plur
Informacje i dokumenty , którymi dysponujemy , wskazują jednak , że poseł kłamie .	kłamie	12	Sing
Zranił go w głowę .	Zranił	0	Sing
Za Pożarowem rozpoczynają się lasy i jeziora .	rozpoczynają	2	Plur
Zebranych powitał burmistrz Bogdan Małecki , on też wygłosił okolicznościowe przemówienie .	powitał	1	Sing
Dotknięta wojennymi ciężarami buntowała się i odmawiała odrabiania pańszczyzny .	odmawiała	6	Sing
Policjanci z pobliskiego komisariatu przyznają , że docierają do nich sygnały o rozbojach .	docierają	7	Plur
Spekulowano nawet , że odejdzie z partii wraz z Jurkiem .	odejdzie	4	Sing
Wojewoda doda jej dla splendoru nieszczupły taborek .	doda	1	Sing
Czekają nagrody .	Czekają	0	Plur
Ale ci politycy z kolei nie gwarantują przeprowadzenia koniecznych reform gospodarczych .	gwarantują	6	Plur
Gładkie oblicze strzygonia stężało , alabastrowa skóra napięła się , jakby miała zaraz pęknąć .	miała	11	Sing
Zagryzła wargi .	Zagryzła	0	Sing
Trzech innych wytoczyło księdzu oddzielny proces .	wytoczyło	2	Sing
Przebywa w szpitalu .	Przebywa	0	Sing
Nie sądzisz ?	sądzisz	1	Sing
Ilu prezesów pani przetrzymała ?	przetrzymała	3	Sing
Zgodził em się ostatecznie na kolej .	Zgodził	0	Sing
Na wojnę odpowiedzmy wojną .	odpowiedzmy	2	Plur
Trzy lata temu rozstał się z górniczą spółką mieszkaniową w Nikiszowcu .	rozstał	3	Sing
Nie kieruję się przy tym ideologią wegetariańską , choć z nią sympatyzuję .	sympatyzuję	11	Sing
Już 9 dni z nim się męczę . . .	męczę	6	Sing
Obrazy cyfrowe składają się z połączonych ze sobą pikseli o różnych barwach lub tonach .	składają	2	Plur
Wilk zastanowił się chwilę , po czym z lekkim drżeniem w sercu zadał najważniejsze pytanie .	zastanowił	1	Sing
Giną więc wozy , których właściciele nie ubezpieczają ze względu na wysokie stawki .	Giną	0	Plur
Konsjerżka , jak większość konsjerżek Portugalka , szorowała chodnik i mury ryżową szczotką .	szorowała	7	Sing
Po jednemu wsiąkały w próżnię . . .	wsiąkały	2	Plur
- Zacisnęła pięści pochlapane krwią .	Zacisnęła	1	Sing
Słuchali śmy chciwie tej nocy otaczającej nas ciasno .	Słuchali	0	Plur
- Nie wierz złośliwcom !	wierz	2	Sing
Zupełnie nisko nad głowami unosi się helikopter .	unosi	4	Sing
Przekonał się , że to gra interesów .	Przekonał	0	Sing
- Skoro pani minister już podniosła kwestię wpływów podatkowych z rozmaitych województw i ich proporcji , myślę , że warto się nad nimi zastanowić , gdyż są one czasami dziwne i nie wiadomo , z czego wynikają .	wynikają	36	Plur
- Powinna to zrobić dobrowolnie .	Powinna	1	Sing
Czyli płaci się za to , żeby nic nie robili .	robili	9	Plur
Podzielcie się z nami swoimi smutkami i radościami .	Podzielcie	0	Plur
Stary wiadukt przy ulicy Oświęcimskiej stanowił ogromną uciążliwość dla kierowców .	stanowił	5	Sing
Poszły nad Ślęzę .	Poszły	0	Plur
Jego anegdoty traktowały o najrozmaitszych księżach dziwakach , których w okolicy nie brakło , a których przygody tchnęły często humorem z epoki Seweryna Soplicy czy nawet Paska .	tchnęły	17	Plur
Zeszyty dostał od nauczycielki za sprzątanie lasu .	dostał	1	Sing
- Połóżmy się tu i odpocznijmy .	Połóżmy	1	Plur
Po zajęciu miejscowości Krzyżacy zmasakrowali miejscową ludność .	zmasakrowali	4	Plur
W tym przypadku straty wynosiły 3000 zł .	wynosiły	4	Plur
W Konstancinie-Jeziornie i Spale przygotowują się piłkarskie reprezentacje do nadzwyczaj ważnych spotkań .	przygotowują	4	Plur
Co lubią maturzyści ?	lubią	1	Plur
A poza tym , w kwestiach kuchni w szkołach i sprzątania szkół , dobrem dzieci zasłania się przede wszystkim chęć utrzymania własnego stołka .	zasłania	15	Sing
Pan hrabia nawet przez moment nie miał nas za szpiegów , inaczej nie udzielił by nam tak dogłębnych wyjaśnień .	udzielił	13	Sing
Piłkarze FC Porto zapewnili sobie wczoraj ponownie tytuł mistrzów Portugalii .	zapewnili	3	Plur
Popełniasz błąd .	Popełniasz	0	Sing
W Wielkopolsce brakuje 300 gliniarzy .	brakuje	2	Sing
Oni myśleli , że byłam nówka i Miszka mnie rozdziewiczył .	myśleli	1	Plur
Do Warszawy dotarli już o gęstym zmroku .	dotarli	2	Plur
Wokół murów wyrosną piękne ogrody .	wyrosną	2	Plur
Opiszę ci wszystko !	Opiszę	0	Sing
Splotła silne dłonie .	Splotła	0	Sing
Kradli telefony komórkowe , sprzęt komputerowy i inne cenne przedmioty .	Kradli	0	Plur
Szczególnie serdecznie zapraszamy do współpracy nowo powstałe firmy .	zapraszamy	2	Plur
- Nasi konkurenci złożyli skargi już kilka miesięcy temu .	złożyli	3	Plur
I dlatego ich potępiamy .	potępiamy	3	Plur
- Znowu zajmujesz się jakimś morderstwem ?	zajmujesz	2	Sing
Po obejżeniu tych trzech filmów z niepokojem oglądam wiadomości .	oglądam	7	Sing
Rozdzielali zwaśnione strony w ramach misji pokojowych ONZ .	Rozdzielali	0	Plur
Aby pozbyć się niespokojnego ducha z Apulii , Onufry wysłał Roberta do Kalabrii .	wysłał	9	Sing
Dziadek zamknął drzwi i przesunął korbę .	zamknął	1	Sing
Prezydenci Polski , Ukrainy i Rumunii spotkali się na roboczych rozmowach w Bukareszcie .	spotkali	6	Plur
Powstał i stanowczym krokiem podszedł do telefonu .	Powstał	0	Sing
Zaprosimy cię na otwarcie , przysięgam .	Zaprosimy	0	Plur
Cofnął nogę ze sprzęgła , silnik zaskoczył .	zaskoczył	6	Sing
I poślemy cię do takiego miejsca , z którego się nie wychodzi .	poślemy	1	Plur
Pokręciła głową .	Pokręciła	0	Sing
Niestety , słabiutki wokal pojawiał się we wszystkich utworach tej trójki .	pojawiał	4	Sing
- Myślał em , że rano komary nie gryzą .	gryzą	8	Plur
Chłopiec nalewa do drugiego kieliszka .	nalewa	1	Sing
Poseł SLD Maciej Manicki złożył sprzeciw .	złożył	4	Sing
– Bywa , że rolnicy jeszcze przynoszą pisma .	przynoszą	6	Plur
Hakerzy zaatakowali stronę internetową Watykanu .	zaatakowali	1	Plur
A wy nie zdążyli ście !	zdążyli	3	Plur
Psychiatra przysuwa krzesło do leżanki i siada obok Bartodzieja z notesem w ręku .	przysuwa	1	Sing
Wiecie , kiedy się odzywa ?	Wiecie	0	Plur
Bo tego oczekują .	oczekują	2	Plur
Z tych samych środków , które zasiliły konto Hufca ZHP , dofinansowanie zdobyło także Stowarzyszenie Na Rzecz Szkolnictwa Specjalnego .	zasiliły	6	Plur
Jeszcze nie oszacowali strat .	oszacowali	2	Plur
Wyprostowała plecy .	Wyprostowała	0	Sing
Księgarnia mieści się na 350 metrach kwadratowych .	mieści	1	Sing
Do domu weszli przez pomieszczenia gospodarcze , po wyjęciu z futryn okna .	weszli	2	Plur
Ale przedtem wyceń mnie .	wyceń	2	Sing
Pił eś ?	Pił	0	Sing
Dzięki temu po wyjęciu dwóch foteli uzyskamy dodatkową powierzchnię bagażową .	uzyskamy	6	Plur
Parafianie wysłali skargę do biskupa koszalińskiego Kazimierza Nycza .	wysłali	1	Plur
Wargi nie pulsowały triumfującą czerwienią .	pulsowały	2	Plur
Opadli na szerokie siedzenia .	Opadli	0	Plur
Podniosła słuchawkę telefonu i wystukała numer Filipa .	wystukała	4	Sing
Zmieniamy ludzi , którzy zawiedli .	Zmieniamy	0	Plur
Bardzo się wstydzę .	wstydzę	2	Sing
W rogu pokoju skrzypią klepki podłogi .	skrzypią	3	Plur
Zastawał em Janka w ciemnym pokoju .	Zastawał	0	Sing
– Bywa , że rolnicy jeszcze przynoszą pisma .	przynoszą	6	Plur
Ćwiczyła w hełmofonie .	Ćwiczyła	0	Sing
- Rysiek , dam ci ciężarówkę , ale mi nią przywieziesz Nałkowską z Adamowizny i Gojawiczyńską ze Stawiska !	przywieziesz	10	Sing
Oprócz słuchania Steczkowskiej delegaci zajmowali się dyskusją o strajku generalnym .	zajmowali	4	Plur
Pierwsze i drugie miejsce zajęły słowackie dziewczęta , ubrane w getry i krótkie falbankowe spódniczki .	zajęły	4	Plur
Nie wychodzili razem i prawie ze sobą nie rozmawiali .	wychodzili	1	Plur
- Po całym świecie się uczył em .	uczył	5	Sing
Drwale ściągali już z roboty do swoich rzeczy leżących przy drodze .	ściągali	1	Plur
Jedli śmy te doskonałe ogórki i zapijali śmy wódką .	zapijali	6	Plur
Umyte brokuły dzielimy na cząstki i układamy w naczyniu .	dzielimy	2	Plur
Rozumisz , Dziunia ?	Rozumisz	0	Sing
Rządek Indian Chamula patrzył w milczeniu z wysokiego muru .	patrzył	3	Sing
Postawicie nam ćwiartkę , a my już damy facetowi radę .	damy	7	Plur
Ty coś ćwiczysz ?	ćwiczysz	2	Sing
- Tym bardziej nie zechcą wypuścić .	zechcą	4	Plur
Za jego uwolnienie bandyci zażądali 300 tys . euro .	zażądali	4	Plur
Oj , słyszą .	słyszą	2	Plur
- Oczy bankiera wyrażały życzliwość i zaciekawienie .	wyrażały	3	Plur
Gdy kupowali lekarstwa , ojciec zabrał wózek z dzieckiem i zniknął .	kupowali	1	Plur
Teraz składamy paskowy patchwork , ocieplenie i podszewkę , zszywamy wzdłuż prostego brzegu i obszywamy lamówką .	składamy	1	Plur
Ale jak zinterpretować pojawienie się kolędników w finałowej scenie , kiedy rozjadą się już Konrad i ksiądz Piotr ?	rozjadą	11	Plur
Sylwetka loki chwiała się w oczach Awaru , głowa stawała się coraz cięższa .	chwiała	2	Sing
Wiem , co zrobię !	zrobię	3	Sing
- Obrażacie nas .	Obrażacie	1	Plur
Komisje Rady już pracują .	pracują	3	Plur
Dziewczyny konkurują tylko przed publicznością , w garderobie sobie pomagają .	pomagają	9	Plur
Pan zanotuje sobie prywatny numer posła . . .	zanotuje	1	Sing
Pewien brytyjski rolnik leczył swą chorą krowę piwem .	leczył	3	Sing
Tam dyżurna kosmetyczka obejrzy pani cerę , udzieli porady i wskaże , jakie mleczko będzie najwłaściwsze , a może jeszcze doradzi jakiś krem .	udzieli	7	Sing
Czy ekonomiści liczą , że Balcerowicz będzie korzystał z ich rad ?	korzystał	7	Sing
Wielokrotnie słuchałem komentarzy osób , które po raz pierwszy zetknęły się z tymi obrazami .	zetknęły	9	Plur
Jak on by głosował ?	głosował	3	Sing
Truchtali spokojnie , bez pośpiechu , z przodu dostrzegli sylwetkę w zielonym mundurze , zbliżyli się powoli .	Truchtali	0	Plur
Psy darły jamy , ziemia sypała się za ogonami .	sypała	5	Sing
Lekarze reanimowali ciężko rannego .	reanimowali	1	Plur
Huntington nie przyjmuje zatem argumentu o globalnej sekularyzacji .	przyjmuje	2	Sing
Powrót odbywa się w tempie przyspieszonym .	odbywa	1	Sing
Oddychał prędko , dławiła go flegma .	Oddychał	0	Sing
- Przez chwilę odpędzała natarczywą złą myśl , ale ta zła myśl wracała .	odpędzała	3	Sing
– Dziennikarze wmówili sądowi i ludziom , że Róża musi wrócić do biologicznych rodziców .	wmówili	2	Plur
Pocałowała mnie w czoło i wyszła , zanim zdążył em coś powiedzieć .	Pocałowała	0	Sing
W lesie zwolnili śmy .	zwolnili	2	Plur
Tym razem atrakcyjność potyczki podniesie fakt , że Hoop i Zepter reprezentują mocno zmienione oblicza .	podniesie	4	Sing
Wracajcie pod szyb po ludzi , siekiery i kilofy .	Wracajcie	0	Plur
- Zapłacili z góry za dwa tygodnie i powiedzieli , że zostaną prawdopodobnie do końca miesiąca .	powiedzieli	8	Plur
W godzinę później złożyli wizytę gubernatorowi .	złożyli	3	Plur
Mam prawo przypuszczać , że reakcje Polaków w takim wypadku odbiegały by od zachowania Amerykanów .	odbiegały	10	Plur
Peugeot jedzie za Oplem , który zatrzymuje się przy pierwszym domu we wsi .	zatrzymuje	6	Sing
Karteczki te złożymy do klasowego skarbca .	złożymy	2	Plur
Całowała go drobnymi , szybkimi pocałunkami .	Całowała	0	Sing
Przekupnie w bazarowych zaułkach opowiadali , że upadek rządu jest bliski i nieuchronny , a ministrowie i generałowie knują spiski albo pakują walizy i szykują się do ucieczki za granicę .	knują	18	Plur
Ja stoję w bruździe i w uniesionej ręce trzymam zapalony fanarek .	stoję	1	Sing
Znowu zostały tylko we trzy .	zostały	1	Plur
Na witrynie umieścili też nazwiska ponad 500 znanych ludzi , którzy podpisali się pod protestem przeciwko zakazowi Marszu Równości .	podpisali	11	Plur
Przedtem włóczyli się po mieście , topniał śnieg , szumiało w rynnach , czuć było powiewy ciepła i zgnilizny , nad dachami tłukły się kłębiaste chmury .	szumiało	9	Sing
Przyszła Kryśka i zdziwiła się , że jestem taka blada .	zdziwiła	3	Sing
Pytam , czy przekonała już kiedyś jakiegoś nauczyciela , że powinien zmienić pracę .	Pytam	0	Sing
Cztery z nich trafiły do szpitala .	trafiły	3	Plur
Pomódlcie się ze mną .	Pomódlcie	0	Plur
Oddając zużyte elektrolity , które tam będą regenerowane , napełnimy zbiorniki nowymi roztworami .	napełnimy	9	Plur
Nawet o tym nie śniła m , przeznaczenie , znaczenie , zna-czenie .	śniła	4	Sing
Tak przynajmniej zapowiadają komunikaty PIHM-u .	zapowiadają	2	Plur
Funkcjonariusze inspekcji celnej przy pomocy biegłych ustalili , że przy próbie wywozu najprawdopodobniej naruszone zostały przepisy Kodeksu celnego .	ustalili	6	Plur
Odsuńcie się , ludzie !	Odsuńcie	0	Plur
O drugie miejsce zawzięcie walczyły reprezentacja Belgradu oraz Alita Alytus .	walczyły	4	Plur
Łapcie się za portfele !	Łapcie	0	Plur
- Zrobił em .	Zrobił	1	Sing
Zdjął płaszcz i wszedł do saloniku .	Zdjął	0	Sing
W ogólnym rozgardiaszu jedynie Kosiński i Gorczyca zachowywali się spokojnie .	zachowywali	7	Plur
NBP OBNIŻYŁ o 4 punkty procentowe stopę swoich kredytów .	OBNIŻYŁ	1	Sing
Gdy odbywa służbę wojskową w Maroku , wielkie wrażenie robi na nim głęboka religijność wyznawców Islamu .	odbywa	1	Sing
– ale ten system się na początku nie zajmował artystami .	zajmował	8	Sing
Zbliżył się do nas , wydawał się zakłopotany .	wydawał	5	Sing
Sowy się kłócą .	kłócą	2	Plur
– Ja się tym zajmę .	zajmę	4	Sing
- Czy firmy chętnie się godzą na podział budżetu ?	godzą	5	Plur
Zawsze powtarzał , że od dziecka chciał ją poznać .	powtarzał	1	Sing
Michał naciągnął mi na oczy kaptur , omotał szalikiem i kazał wracać do domu .	omotał	7	Sing
My też nie znamy prawdy .	znamy	3	Plur
Auto zostało całkowicie zniszczone , a kierowcę strażacy wydobyli za pomocą narzędzi hydraulicznych .	wydobyli	8	Plur
Dzieci się uczą na pamięć długości rzek , głębokości jezior . . .	uczą	2	Plur
Przez godzinę z boiska wiało nudą , a piłkarze prezentowali futbol plażowy .	prezentowali	9	Plur
A więc teraz szczodrze wynagrodzi mu niedosyt !	wynagrodzi	4	Sing
Również państwo bardzo się starało , żeby księża wzięli swoje .	starało	4	Sing
Skoro przez kilka lat podążałeś w kierunku przeciwnym do swego domu , nie zdziw się , że dzisiaj znajdujesz się w odległości kilkuset mil od niego .	zdziw	13	Sing
Chcemy szacunku .	Chcemy	0	Plur
Udało się zbudować nowy naród , społeczeństwo o własnej tożsamości .	Udało	0	Sing
- O , tu już przesadziła ś !	przesadziła	5	Sing
Wykąpiemy się na golasa .	Wykąpiemy	0	Plur
A ten głupi Rzymianin powiedział , że go tam odeśle . . .	odeśle	9	Sing
- Wyznał .	Wyznał	1	Sing
Sędziowie orzekli , że nie można ratować jednych , poświęcając życie innych ludzi .	orzekli	1	Plur
Stefan nieraz nadkładał drogi po pracy , by popatrzyć , jak rośnie ich dom .	rośnie	11	Sing
W pewnym momencie neoprezbiter klęka twarzą do wiernych , wyciąga ku nim ręce i prosi o modlitwę .	wyciąga	9	Sing
Jadzia wolała by , żeby za bardzo nie oddalały się od siebie i żeby Dominika tak nie latała .	oddalały	8	Plur
Nie widzicie , że się na nas uwziął ?	uwziął	7	Sing
Anioł zadowolony śmieje się z diabła .	śmieje	2	Sing
No , nie mitręż , dziewczyno .	mitręż	3	Sing
Albo zesłać mu śmierć , zanim się zestarzeje .	zestarzeje	7	Sing
Może w styczniu zaproszę cię na chrzciny .	zaproszę	3	Sing
Dosiadł się do nich , napełnił talerz zupą pomidorową .	napełnił	5	Sing
Wizytator przeprosił kierownika i udał się z powrotem do klasy szóstej .	udał	4	Sing
Ryzykowały i sposobem lokat .	Ryzykowały	0	Plur
Tu biło serce Orkiestry .	biło	1	Sing
I koniecznie zabierz ze sobą jakąś książkę .	zabierz	2	Sing
Praca w okupowanych szpitalach przebiega normalnie .	przebiega	4	Sing
Nie ruszaj się .	ruszaj	1	Sing
Prezydent Bush zapewniał w środowym przemówieniu telewizyjnym , że siły koalicji będą maksymalnie oszczędzały ludność cywilną .	zapewniał	2	Sing
- Byli tacy , co całą noc tam siedzieli i widzieli .	widzieli	10	Plur
Nasi politycy nie dostrzegają Przełomu .	dostrzegają	3	Plur
Ale niech się pan tym zbytnio nie przejmuje .	przejmuje	7	Sing
Uczył się w Liceum Technik Plastycznych w Zakopanem prowadzonym przez Antoniego Kenara .	Uczył	0	Sing
Pani Jadwiga uśmiechnęła się do niego .	uśmiechnęła	2	Sing
PQBoot to narzędzie do zmiany partycji bootującej dla tych użytkowników , którzy tylko od czasu do czasu potrzebują skorzystać z innego systemu .	potrzebują	17	Plur
Teraz leżą tam w ciemności oba kosmyki i płyną w przyszłość spiralnym torem .	płyną	8	Plur
Co się roi w twoim szalonym ruskim łbie ?	roi	2	Sing
– a do Dusznik jedziecie ?	jedziecie	4	Plur
Później Dąbrowska podobno się na mnie obraziła , bo porównał em ją gdzieś z Orzeszkową .	obraziła	6	Sing
Najpierw myślał em , że śnię .	śnię	5	Sing
Dwa osobowe samochody zderzyły się dachami .	zderzyły	3	Plur
Skontaktuję się z mamą trojaczków w najbliższych dniach .	Skontaktuję	0	Sing
O szczegóły poprosimy porucznika Achselringa .	poprosimy	2	Plur
W samej końcówce rozpaczliwe broniliśmy się i naprawdę radomianie napędzili nam wielkiego stracha .	napędzili	9	Plur
Nie znali się za życia .	znali	1	Plur
Dawali śmy mu złoto . . .	Dawali	0	Plur
Jego anegdoty traktowały o najrozmaitszych księżach dziwakach , których w okolicy nie brakło , a których przygody tchnęły często humorem z epoki Seweryna Soplicy czy nawet Paska .	traktowały	2	Plur
– Wyglądam jak dziwka .	Wyglądam	1	Sing
Stoi sobie tak na publicznej drodze i straszy .	straszy	7	Sing
– Mieliśmy listę Wildsteina , teraz wypłynęła tak zwana lista 500 , o której istnieniu poinformował prezes IPN Janusz Kurtyka .	poinformował	15	Sing
Właścicielom wystarcza kino domowe , a bogate panie nie potrafią docenić kunsztu Anny Jaxy - Chamiec .	wystarcza	1	Sing
Odpowiedzi takie zaliczała m do poprawnych mimo zaistniałej pomyłki .	zaliczała	2	Sing
Niektóre rzeki nie zamarzają w ogóle .	zamarzają	3	Plur
Łapcie się za portfele !	Łapcie	0	Plur
Gdy zgasło światło , kamera pokazała , że zabawiali się ze sobą pod kołdrą .	zabawiali	8	Plur
Trzy osoby podejrzane o korupcję , w tym profesora , który przewodniczył komisji egzaminującej weterynarzy , zatrzymali warmińsko - mazurscy policjanci .	przewodniczył	11	Sing
Nie lubiły tylko pijaków , szczekały , kiedy opierali się o płot .	lubiły	1	Plur
Na tej klepce bracia mocno się poślizgnęli .	poślizgnęli	6	Plur
Gdzieś tam w toalecie cicho zaskrzypiały drzwi , a na dużej sali czyjeś kroki szybko zdążały w tę stronę .	zaskrzypiały	5	Plur
Dostrzegają je twoje oczy , słyszą je twoje uszy .	słyszą	5	Plur
W oddzielnych grupach ćwiczą panie i panowie , później znów spotykają się i odbywają wspólnie zajęcia choreograficzno - taneczne .	odbywają	13	Plur
Wynajmujemy pokój prywatny w biurze obsługi turystów .	Wynajmujemy	0	Plur
Popatrzyli śmy z Ludwikiem na siebie , zaskoczeni , bez słowa .	Popatrzyli	0	Plur
Dopakowuje torbę .	Dopakowuje	0	Sing
Długi ograniczył się do spojrzenia .	ograniczył	1	Sing
Donald Tusk umiejętnie punktował ogólnikowe wypowiedzi swych konkurentów .	punktował	3	Sing
Uśmiechnij się do nich i zejdź im z oczu .	Uśmiechnij	0	Sing
woda się got .	got	2	Sing
– jeszcze dziesięć godzin wyjeżdżę i zdaję . .	wyjeżdżę	4	Sing
Starszy kiwnął głową .	kiwnął	1	Sing
Obiecali mu , że wygra kolejny przetarg .	Obiecali	0	Plur
Niech pan pomyśli , jaką rodzice mieli by niespodziankę , gdyby pan ukończył siedem klas .	ukończył	12	Sing
Powiedzieli mi , że ojciec popełnił samobójstwo .	Powiedzieli	0	Plur
- Byli tacy , co całą noc tam siedzieli i widzieli .	Byli	1	Plur
Powoduje wysokie bezrobocie i sprawia , że państwo zadłuża się na bardzo wysoki procent .	Powoduje	0	Sing
Wnętrze Ejakulatio błyszczało .	błyszczało	2	Sing
Dzielili się obaj z księdzem zgodnie .	Dzielili	0	Plur
Prezydent Aleksander Kwaśniewski podpisał nową ordynację wyborczą do Sejmu i Senatu .	podpisał	3	Sing
Było tak zmasakrowane , że myśliwi z trudem ustalili jego płeć .	ustalili	8	Plur
Tym razem milicjanci interweniowali natychmiast .	interweniowali	3	Plur
Dziewczynka opuściła już intensywną terapię i razem z rodzicami przeniosła się na zwykły oddział .	opuściła	1	Sing
Wybaczamy mu .	Wybaczamy	0	Plur
Dopiero oni wciągnęli kobietę do łodzi .	wciągnęli	2	Plur
Dziecko utopiło się w żwirowisku w okolicach Wrocławia .	utopiło	1	Sing
Niemcy słuchają .	słuchają	1	Plur
Weź to pod uwagę .	Weź	0	Sing
Albo sami z ochotą wplątywali się w lokalne wojenki i rebelie .	wplątywali	4	Plur
Blady strach na wieś padał , kiedy Hanke pojawiał się z tym aparatem .	padał	4	Sing
Czasem cisnę spust , a ten diabeł uprze się i nie wystrzeli .	uprze	7	Sing
Z czego mam się cieszyć , że kości rozsiejemy po świecie ?	rozsiejemy	8	Plur
- Kiernacki usiadł bez pośpiechu .	usiadł	2	Sing
Lamentują , jakby śpiewali .	Lamentują	0	Plur
Obecnie mówimy czasem , że są to bryły platońskie .	mówimy	1	Plur
Poprawimy się !	Poprawimy	0	Plur
Decyzja zapadła , mimo że szefowie tajnych służb ostrzegli , iż Palestyńczycy wyjdą na ulice .	ostrzegli	8	Plur
Znalazł też Kwaśniewski niefortunnych obrońców .	Znalazł	0	Sing
Forum jednoczy ludzi , umożliwia działanie realne .	jednoczy	1	Sing
Podłączyli śmy go do sztucznych komór , czekał na dawcę .	Podłączyli	0	Plur
Kiwa tylko ze smutkiem głową .	Kiwa	0	Sing
Oprócz Polaków odpływali na tę wyprawę także i cudzoziemcy , wszyscy spod znaku republikańskiego .	odpływali	2	Plur
Nie powiedzieli .	powiedzieli	1	Plur
Chłopak zerwał się z miejsca , złapał posążek i ścisnął mocno w dłoni .	złapał	6	Sing
Nie słuchaj ich wszystkich , nie czytaj żadnych książek .	słuchaj	1	Sing
- Ekspertyza balistyczna wykluczyła udział żołnierzy niemieckich w zastrzeleniu 49-letniego mężczyzny w Koniecpolu .	wykluczyła	3	Sing
Owa niezapomniana chwila zawierała nieprawdopodobny ładunek patosu .	zawierała	3	Sing
Tylko nie skacz .	skacz	2	Sing
Powiedzieli mi , że ojciec popełnił samobójstwo .	Powiedzieli	0	Plur
Kiwnął em na barmana , żeby zapłacić .	Kiwnął	0	Sing
Po zdjęciu serwetki i położeniu jej na kolanach na małym talerzyku spożyjemy przekąskę .	spożyjemy	11	Plur
Z pism Slazskiej Energetiki wynika , że opalana węglem nowa elektrociepłownia w Trzyńcu będzie spełniała wszystkie europejskie normy ekologiczne .	spełniała	14	Sing
Papieros sparzył mi palce , rzuciłem go w śnieg .	sparzył	1	Sing
Terroryści wyciągnęli broń i strzelali w powietrze .	strzelali	4	Plur
Niemal wszystkie nici myśli kwestionującej prowadzą do Kartezjusza .	prowadzą	5	Plur
Darmosz zgasił papierosa , ruszył za nimi .	zgasił	1	Sing
Zmierzyła m ciśnienie krwi .	Zmierzyła	0	Sing
Powiedział em , że uczą , uśmiechnął em się do Rogera i wychylił em kieliszek .	wychylił	12	Sing
Uważam , że pomógł .	Uważam	0	Sing
Wicemistrzynie Polski z Mielca nie dały pograć w Krakowie Wiśle i opuściły ostatnie miejsce w tabeli właśnie na rzecz podopiecznych Lesława Kędryny .	opuściły	11	Plur
We znaki dały się też niewyczyszczone przed zimą przewody kominowe .	dały	2	Plur
Kuba , zbliż no się do mnie , niech cię pocałuję .	zbliż	2	Sing
- Polecę .	Polecę	1	Sing
Żegnamy się nowo poznaną piosenką i okolicznościowym hasłem .	Żegnamy	0	Plur
- Zapewniamy pełną dyskrecję .	Zapewniamy	1	Plur
na budowę jakiegoś tam mostu zbierają pieniądze .	zbierają	5	Plur
A czemu pytasz ?	pytasz	2	Sing
Takoż mocno rozgrzewa .	rozgrzewa	2	Sing
Andrzej Kowerski pozostawał w jej cieniu i nie wiadomo , jak to znosił .	znosił	12	Sing
To wszyscy wiedzą !	wiedzą	2	Plur
Nerwowy kupiec odruchowo wcisnął mu sakiewkę do ręki .	wcisnął	3	Sing
Zaatakował chłopak .	Zaatakował	0	Sing
Przychodzimy , aby szczątek ostatni od zagłady uchronić .	Przychodzimy	0	Plur
Nie spała całą noc i teraz leży w łóżku .	spała	1	Sing
- A CO TO ZNACZY NAPRAWDĘ ?	ZNACZY	4	Sing
Kiedy sprawa się wydała , wyleciała z hukiem ze szpitala .	wyleciała	5	Sing
A ogrzewania wyłączyć nie możemy , bo to zaszkodzi świeżo zakonserwowanym freskom w obu synagogach .	zaszkodzi	8	Sing
– akurat Kasi pasowała .	pasowała	3	Sing
W uroczystości uczestniczyli wierni w kolorowych łowickich wełniakach .	uczestniczyli	2	Plur
Inwestorzy zagraniczni muszą wpłacić pieniądze z góry w nadziei , że biuro maklerskie wywiąże się ze zobowiązania .	wywiąże	13	Sing
Zauważył em , że po raz pierwszy powieki nie zakrywały jego źrenić , żółtych i okrągłych .	zakrywały	9	Plur
- Bywają .	Bywają	1	Plur
Oklapł , opadły mu ramiona i tylko piwny brzuszek sterczał nad paskiem spodni .	opadły	2	Plur
Papierową śmierć zafundowali śmy już kilku osobom .	zafundowali	2	Plur
- Jajo przywiózł do nas osobiście dyrektor płockiego zoo .	przywiózł	2	Sing
Organizatorzy postarali się też o prezenty dla wykonawców .	postarali	1	Plur
- Nie kradnę , nie sprzedaję narkotyków i nie morduję za pieniądze .	morduję	9	Sing
Na ścianach wisiały pamiątkowe fotografie i adresy gratulacyjne .	wisiały	2	Plur
– nic nie zrobisz .	zrobisz	3	Sing
Żołnierze okopali się tam i celnymi strzałami odpierali atakujących .	okopali	1	Plur
Ukończyła tylko drugą klasę podstawówki .	Ukończyła	0	Sing
W ten sposób wzrasta częstotliwość sygnałów .	wzrasta	3	Sing
Trzynastolatek był członkiem grupy przestępczej , w której działali oskarżeni o jego późniejsze zabójstwo .	działali	8	Plur
Ofiarą neofaszystów może być każdy , bo na zdjęciach są też ludzie , którzy jedynie znaleźli się w pobliżu różnych manifestacji .	znaleźli	15	Plur
Zasalutował i wyszedł z poczty .	Zasalutował	0	Sing
Muszę zobaczyć .	Muszę	0	Sing
Wszędzie fruwają papiery i pierze .	fruwają	1	Plur
Jeszcze w 1576 , jak wspominają akta wizytacyjne , mieszkali tu wolni Prusowie .	wspominają	5	Plur
- Ale chyba nie uchylił się od pojedynku ?	uchylił	4	Sing
Poproszę o jakieś fajne stanowisko .	Poproszę	0	Sing
Nie lubiły tylko pijaków , szczekały , kiedy opierali się o płot .	opierali	8	Plur
– zajączka nie ruszali ście ?	ruszali	3	Plur
Kierowca wrzuca wsteczny i na pełnym gazie taranuje pieszych .	taranuje	7	Sing
- Takie imię wymyślił em dla pani .	wymyślił	3	Sing
Sprawę wyjaśnimy .	wyjaśnimy	1	Plur
Teraz Bóg jeden raczy wiedzieć .	raczy	3	Sing
Piasek zasypywał aryki , pola i domy .	zasypywał	1	Sing
Taboret upadł z dramatycznym łoskotem , a on , wierzgając nogami , zawisł niczym gotowy do wypatroszenia wieprz .	zawisł	12	Sing
Celnikom wyjaśniła , że muszlę kupiła w Acapulco za 20 dolarów .	kupiła	5	Sing
Od tego czasu gnębiony przez feudałów lud rumuński niejednokrotnie chwytał za broń .	chwytał	9	Sing
- Ale dzieci lubiły się tam bawić .	lubiły	3	Plur
Zostawiam wam Owsika , trzeba z nim natychmiast wyjść .	Zostawiam	0	Sing
Przeglądam dziennik swój .	Przeglądam	0	Sing
Opaski przeglądamy w lipcu i niszczymy znajdujące się tam gąsienice .	przeglądamy	1	Plur
Zdziwiła się i nic nie odrzekła .	Zdziwiła	0	Sing
Jakby się nie liczyli w tym spotkaniu .	liczyli	3	Plur
Tenisiści stołowi Energetyka Opoki Trzebinia znają już terminy spotkań barażowych o I ligę , w których ich rywalem będzie zwycięzca II ligi łódzko - świętokrzyskiej Start Brzezina .	znają	5	Plur
Ponieważ na pukanie nikt nie reagował , policjanci wyważyli drzwi .	wyważyli	8	Plur
Padają pierwsi zabici .	Padają	0	Plur
Okradli ich z zegarków i łańcuszków .	Okradli	0	Plur
Zaprosimy cię na otwarcie , przysięgam .	Zaprosimy	0	Plur
Posiadam spore zbiory i wciąż poszukuję nowych .	poszukuję	5	Sing
Zwodujcie Wałęsę .	Zwodujcie	0	Plur
Sznur tirów przecina niemal cały Wrocław , ma dziesięć kilometrów długości , stoi w nim kilkaset ciężarowek .	przecina	2	Sing
Teraz zwłoki Odiego leżą w chłodni .	leżą	3	Plur
Zwierzę polubiło piwko i bez kufla nie daje się wydoić .	polubiło	1	Sing
Najbliżsi rywale Orfe także nie rezygnują z przejęcia kolejnych mniejszych dystrybutorów .	rezygnują	5	Plur
Wtedy skończyły się zamówienia .	skończyły	1	Plur
Policjanci alkoholu nie poczuli , ale na wszelki wypadek kazali mu dmuchnąć w alkomat .	poczuli	3	Plur
Wszyscy żegnali mnie serdecznie , zapraszali na przyszłość .	żegnali	1	Plur
Wyszli z bramy .	Wyszli	0	Plur
Z oceanicznego epicentrum rozbiegły się fale tsunami .	rozbiegły	3	Plur
Najciekawiej zapowiada się w Moskwie , gdzie miejscowy Spartak podejmuje Ajax Amsterdam .	podejmuje	9	Sing
Jeżeli jednak coś wylicytowali śmy , czeka nas rozliczenie się z domem aukcyjnym .	wylicytowali	3	Plur
Ale powstają rzeczy wspaniałe . . .	powstają	1	Plur
Podstawowe problemy przemysłowej produkcji i masowych zastosowań półprzewodnikowych źródeł światła niebieskiego wydają się już rozwiązane .	wydają	11	Plur
Tamci odchodzą , pozostaje sam .	odchodzą	1	Plur
Tiry wyjechały z Warszawy tydzień temu .	wyjechały	1	Plur
- Danka odwróciła się wyniośle i pobiegła na piętro .	odwróciła	2	Sing
– Czy oni znają jakąś prawdę , czy mogą znać jakąś prawdę ?	znają	3	Plur
O piątej przyszli Hauboldowie , zrobili śmy im herbatę i było dość przyjemnie .	zrobili	5	Plur
Ludzie podchodzili do okien i wpatrywali się w niebo .	wpatrywali	5	Plur
Należało to robić dokładnie , inaczej paczki spadały przy wjeżdżaniu do windy .	Należało	0	Sing
Uroczystości weselne zaczynały się od wtorku .	zaczynały	2	Plur
Miasto otuliła mgła .	otuliła	1	Sing
Protestują przeciwko zamierzonej budowie .	Protestują	0	Plur
Sielawa i sieja składają ikrę w listopadzie i grudniu .	składają	3	Plur
Dali wzgardę i zdradę , zapłacili zwykłą swą monetą .	zapłacili	5	Plur
Przystupa odstawiła szklankę po whisky i skuliła się w fotelu , pan Cox wyglądał , jakby się właśnie obudził .	odstawiła	1	Sing
Nie niszcz mojego dzieła !	niszcz	1	Sing
Bartodziej kładzie się na leżance .	kładzie	1	Sing
Wczoraj , po zamknięciu lokali wyborczych , niemieckie media zapowiedziały , że pani minister ustąpi ze stanowiska .	ustąpi	14	Sing
Odgłosy tego polskie media zagłuszały białoruską wrzawą .	zagłuszały	4	Plur
Przerwali terapię we Mstowie i w krótkim czasie zmarli z powodu narkotycznego przedawkowania .	Przerwali	0	Plur
i dotarli śmy do tkaniny i dzianiny .	dotarli	1	Plur
– Ja w każdym razie wybieram chłodny prysznic .	wybieram	5	Sing
Zwracajmy szczególną uwagę na bezpieczeństwo dzieci .	Zwracajmy	0	Plur
O tym , że dzieci przeżywają koszmar , dorośli dowiadują się najczęściej przypadkiem .	dowiadują	9	Plur
Historia uczy , że podziały nigdy nie budowały , a zawsze burzyły .	budowały	7	Plur
Postanowił go szybko zlokalizować .	Postanowił	0	Sing
Z wolna milkły także widmowe instrumenty .	milkły	2	Plur
Do skomplikowanych wzorów używamy deski przywiązanej do sznurka .	używamy	3	Plur
W Charkowie 300 osób odkryło ostatnio karaimskie korzenie .	odkryło	4	Sing
- Jedziemy do Paryża .	Jedziemy	1	Plur
Commercial Union od 1991 roku działa również na rynku naszych ubezpieczeń życiowych .	działa	5	Sing
Kaczka bez brata nikogo nie ugryzie w łydkę .	ugryzie	5	Sing
Stłuces głobe !	Stłuces	0	Sing
Kochał Dorę , ale nie potrafił odejść od Zofii , swej żony .	Kochał	0	Sing
Próbowali go powalić i zakneblować mu usta .	Próbowali	0	Plur
- Spóźnili śmy się .	Spóźnili	1	Plur
Najlepiej będzie , jeśli zajmę się tym zaraz .	zajmę	4	Sing
Oburzamy się , że prezydent Juszczenko stawia pomniki Banderze i pielęgnuje pamięć o nim i jego bandziorach .	Oburzamy	0	Plur
– Nie rozumiesz , telefon dołączył em do magnetofonu i nagrywa mi , no .	nagrywa	10	Sing
Utworzył em to hasło , ponieważ nikt wcześniej go nie utworzył .	utworzył	10	Sing
Dwie osoby zmarły przed szpitalem .	zmarły	2	Plur
Ograniczenie szybkości obowiązuje tutaj od soboty z powodu rutynowych prac konserwatorskich .	obowiązuje	2	Sing
Sprawą zajmują się policjanci z 6 komisariatu na Górnej .	zajmują	1	Plur
Wśród podróżnych zapanowała panika .	zapanowała	2	Sing
Ostatnio przebiła się lewa górna 2 !	przebiła	1	Sing
Udzieliła m mu wyczerpujących informacji .	Udzieliła	0	Sing
Ciężarówki zwiozły młodzież z najdalszych krańców województwa .	zwiozły	1	Plur
Ale ja go rozumiem i wszystkich dziennikarzy proszę o to samo .	rozumiem	3	Sing
I Pan Jezus krzyż nad nimi uczynił , a oni się zamienili w trzy drzewa jabłonne .	uczynił	6	Sing
Króliki rozmnażają się bardzo szybko i są nawet plagą na niektórych terenach .	rozmnażają	1	Plur
Czy my wszyscy zasługujemy na życie w państwie rządzonym przez państwa Kaczyńskich ?	zasługujemy	3	Plur
W Miedźnej wiedzą , że nie zdarzy się cud . . .	wiedzą	2	Plur
Nie składają donosów do prokuratury , nie przejmują się całodobowym uśmiercaniem poczętych ?	składają	1	Plur
Słyszałam , że nieźle sobie radzisz .	radzisz	5	Sing
We współczesnej dyskusji takie zarzuty stawiali H . Williams , N . Abercrombie , J . Larrain , W . Carlsnaes .	stawiali	5	Plur
Rodzice wciąż pracują .	pracują	2	Plur
Serdecznie dziękujemy .	dziękujemy	1	Plur
Kobiety za nim przepadały .	przepadały	3	Plur
Zarządzenie to obowiązuje aż do odwołania .	obowiązuje	2	Sing
Nawet kiedy sami tego żądają .	żądają	4	Plur
Odbył jedynie krótką telefoniczną pogawędkę z prezydentem ZSRR Gromowem .	Odbył	0	Sing
Witamy , witamy . . .	witamy	2	Plur
Nie odwódźcie mnie . . .	odwódźcie	1	Plur
Zaciskam powieki .	Zaciskam	0	Sing
I tutaj mnożą się problemy .	mnożą	2	Plur
Przylgnął do niej z całych sił .	Przylgnął	0	Sing
Istniała wcześniej i będzie istniała potem .	Istniała	0	Sing
Niepodzielnie królowały wszędzie radość i uśmiech .	królowały	1	Plur
Przyjadą goście z miasta .	Przyjadą	0	Plur
- Nie układa się jej pod rynkowego konkurenta , ale warto wiedzieć , w co on gra .	układa	2	Sing
Iskierka zgasła , ustępując miejsca podejrzliwości .	zgasła	1	Sing
Poruszył em się na łóżku , które odpowiedziało sprężyście .	Poruszył	0	Sing
Usiedli na zwalonej kłodzie .	Usiedli	0	Plur
W Ameryce pozostały do dziś .	pozostały	2	Plur
Począł myśleć gorączkowo .	Począł	0	Sing
– Może coś rozpozna .	rozpozna	3	Sing
- Ciągle siedzę .	siedzę	2	Sing
Mam już 80 lat , a moje zdrowie się pogarsza .	pogarsza	9	Sing
W niedzielę rano odprawiono z okazji rocznicy śmierci kompozytora msze święte w kościołach sióstr Wizytek i św . Krzyża , gdzie spoczywa serce Chopina .	spoczywa	21	Sing
W 10 sklepach sprzedawcy odmówili , żądając okazania dokumentów , w jednym przypadku alkohol sprzedano .	odmówili	4	Plur
Powiodła m oczami dookoła i nagle zastygła m z przerażenia .	Powiodła	0	Sing
Policjanci z pobliskiego komisariatu przyznają , że docierają do nich sygnały o rozbojach .	przyznają	4	Plur
Ale kłamstwa się wydały .	wydały	3	Plur
Usmaż jeszcze kiedyś faworki , błagam .	Usmaż	0	Sing
- Stadion opanowali Chińczycy .	opanowali	2	Plur
Jak ustalili policjanci , podawał alkohol 16-letniej dziewczynie .	ustalili	1	Plur
Biedny Drossos , sami analfabeci głosowali na niego …	głosowali	5	Plur
W kuchni unoszą się smakowite zapachy , pani Grażyna wyciąga z szuflady sztućce .	unoszą	2	Plur
Władze hiszpańskie działały niezwykle szybko .	działały	2	Plur
Dziecko znalazło by się w niebezpieczeństwie , gdyby motłoch je odkrył .	odkrył	10	Sing
Sugerowała , że przed egzaminem można było kupić testy .	Sugerowała	0	Sing
Zarzucił mu Pan , że utrwala sejmokrację .	Zarzucił	0	Sing
Przekazał em informację dyżurnemu , aby to wyjaśnił .	wyjaśnił	7	Sing
Padają Zakłady Cegielskiego w Poznaniu , a dialog przenosi się na ulice .	Padają	0	Plur
Oczywiście , przecież nie stawiamy przecinków w zdaniu pojedynczym .	stawiamy	4	Plur
- Gramy !	Gramy	1	Plur
Poprosił em marszałka o wyznaczenie mediatora .	Poprosił	0	Sing
Ale trzej bracia nie zważali na przeszkody .	zważali	4	Plur
które autor konfrontuje no .	konfrontuje	2	Sing
– jak wyszły ?	wyszły	2	Plur
Za każdy samochód zabierali się od razu mechanicy , zmieniali koła , usuwali uszkodzenia powstałe w czasie forsownego treningu , wymieniali zdarte nakładki hamulcowe , regulowali silniki .	zmieniali	9	Plur
Płacimy i idziemy na dworzec .	Płacimy	0	Plur
Niech płaszczą się przed groźnym wieprzem !	płaszczą	1	Plur
Nazywa się Bonda .	Nazywa	0	Sing
- Obierz kilka kartofli .	Obierz	1	Sing
Lecz protektor w niebieskiej bluzie poklepał go po ramieniu .	poklepał	5	Sing
Obecnie we Francji wykłada na uniwersytecie w Awinionie .	wykłada	3	Sing
Musiały jej powiedzieć , teraz .	Musiały	0	Plur
Zgłosiły się trzy panie .	Zgłosiły	0	Plur
Milczeli przez dłuższą chwilę .	Milczeli	0	Plur
Jakoś do tej pory obywamy się bez tego .	obywamy	4	Plur
Osiągnęła sukces .	Osiągnęła	0	Sing
Wygrywała m cię do ostatka .	Wygrywała	0	Sing
Rozpoczęli zwożenie kamiennych płyt .	Rozpoczęli	0	Plur
Ruszyły sprawy spadkowe .	Ruszyły	0	Plur
- Widzę , że pan niezbyt się przejął tą zbrodnią .	przejął	7	Sing
Przyzwoitość każe szanować gości i ja właśnie w ten elegancki sposób uszanuję Jagodowe wakacje .	każe	1	Sing
W Polsce staram się jeździć wolniej .	staram	2	Sing
czy ty wierzysz w świat radykalnie wegetariański ?	wierzysz	2	Sing
Miliony ludzi straciło oszczędności całego życia .	straciło	2	Sing
Wysiedli z samochodów , zaniepokojeni , szukają .	Wysiedli	0	Plur
Z połączonych dłoni zrobili koło .	zrobili	3	Plur
Bandyci pobili Rosjanina i wyrzucili z samochodu na Pradze .	wyrzucili	4	Plur
Po zdjęciu serwetki i położeniu jej na kolanach na małym talerzyku spożyjemy przekąskę .	spożyjemy	11	Plur
Pękali śmy z dumy .	Pękali	0	Plur
A my na te konto gruchniem sobie piwa .	gruchniem	5	Plur
Do głosowania nad uchwałą Senatu przystąpimy jutro rano .	przystąpimy	5	Plur
Zgadzam się .	Zgadzam	0	Sing
Można , bo istnieją historyczne analogie .	istnieją	3	Plur
Wejdźcie więc do podziemnych lochów pełnych zasadzek i niespodzianek .	Wejdźcie	0	Plur
- Wracał ten , który poszedł do kierowcy .	poszedł	5	Sing
Analiza spektrometryczna wykazała , że jego skład izotopowy jest typowy dla procesów reaktorowych , a nie wybuchu jądrowego .	wykazała	2	Sing
Wypchnął eś to całe gówno , Euzebku .	Wypchnął	0	Sing
Teraz wynajmuje mieszkanie w Rzeszowie .	wynajmuje	1	Sing
Jeśli odczuwasz zbyt silną potrzebę izolacji , samotności , nie pozwól na zamknięcie się w swoich myślach , obawach i wyobrażeniach .	pozwól	10	Sing
Zawrzały dusze , serca i umysły .	Zawrzały	0	Plur
Zapytali , czy rozpoznaje chłopaka na zdjęciu .	rozpoznaje	3	Sing
Doceniała to .	Doceniała	0	Sing
Beczący głos uciszył sprzysiężonych .	uciszył	2	Sing
Przewrócił się w hotelowym hallu łamiąc żebra .	Przewrócił	0	Sing
Dokonują wstrząsającej ekspertyzy zniszczeń .	Dokonują	0	Plur
– Każdy popełnia błędy , Dinah .	popełnia	2	Sing
Jeśli jednak różnice te nie pozwalają wam zbudować takiego formalnego porozumienia , dajcie zielone światło do współdziałania ludziom tworzącym wasze ugrupowania .	pozwalają	5	Plur
- Sława , Maryna i Krzysztof podbiegają i odbierają od niej paczki .	odbierają	8	Plur
– I twoje mięśnie tak się spinają ?	spinają	6	Plur
- Zabija się tylko dla jedzenia .	Zabija	1	Sing
Zbliżają się ferie , już niedługo pociągi z Warszawy do Zakopanego zapełnią się młodzieżą .	Zbliżają	0	Plur
Niezadowolenie wyrazili również jej koledzy z SDP .	wyrazili	1	Plur
Tu jest strefa przygraniczna , sami rozumiecie .	rozumiecie	6	Plur
Na zakupy zabierajmy ze sobą koszyk lub płócienną torbę .	zabierajmy	2	Plur
Porozmawiajmy o ludziach .	Porozmawiajmy	0	Plur
Podwórko pachniało cytrusami .	pachniało	1	Sing
Hazard pochłonął go bez reszty .	pochłonął	1	Sing
Odjadę wkrótce .	Odjadę	0	Sing
Jakoś się to potem rozwinęło .	rozwinęło	4	Sing
W czwartkowe popołudnie gasili płonący śmietnik przy ul. Brodzińskiego w Proszowicach .	gasili	3	Plur
Modna kobieta pozostawi w swojej szafie spodenki do kolan oraz rybaczki .	pozostawi	2	Sing
Biorę torbę i wychodzę .	Biorę	0	Sing
Przy wspólnym stole jadają tu studenci izraelscy i palestyńscy .	jadają	3	Plur
Czy tamci mogli oczekiwać takiego kataklizmu ?	mogli	2	Plur
Nie podali jednak szczegółów .	podali	1	Plur
Toboła odprowadził Dębskiego na łodziowy .	odprowadził	1	Sing
Okupując wejście , czekały , co się wydarzy .	wydarzy	7	Sing
Panie ze Skarszew pełniły rolę obserwatorek .	pełniły	3	Plur
Spotkali się , przypadli sobie do gustu .	przypadli	3	Plur
Teraz już wiem na pewno , że nas oszukały ście .	oszukały	8	Plur
Słuchaj , co ci rzeknie herold !	Słuchaj	0	Sing
Jakąś łzę pani uroniła ?	uroniła	3	Sing
Popatrz na tych młodych KZT .	Popatrz	0	Sing
Zamknął em tylko oczy , aby lepiej czuć dotyk i słyszeć własne myśli .	Zamknął	0	Sing
Nawet moje złe duchy odwróciły się do mnie plecami .	odwróciły	4	Plur
- Macie chyba trzecią szklaneczkę . . .	Macie	1	Plur
Ktoś inny w złości kopie ławkę i rzuca głośno soczyste przekleństwa .	rzuca	7	Sing
W ubiegłym roku trzynastki pochłonęły 54.537 złotych .	pochłonęły	4	Plur
Wywiercili dziury w ścianie .	Wywiercili	0	Plur
Dla zachęty wspomniała by m , że dostanie czekoladę .	dostanie	7	Sing
Nie jadam po dziewiątej .	jadam	1	Sing
Policjanci śmieją się , odreagowując stres .	śmieją	1	Plur
Starem z przyczepą załadowaną piaskiem kierował kursant .	kierował	5	Sing
Mogli by w nich uczestniczyć kandydaci Unii Wolności oraz Wałęsa i Olszewski , jeśli tylko zechcą i będą mieli poparcie 15 parlamentarzystów i 300 radnych .	zechcą	15	Plur
Zdjął z głowy czapkę i zaczął machać nią ponad głową .	Zdjął	0	Sing
Splątały się sznurki .	Splątały	0	Plur
ZChN-owcy argumentują , że w klubie nie odbyła się żadna debata na temat polityki gospodarczej prowadzonej przez koalicję .	argumentują	1	Plur
Nie podał Klossowi ręki , wskazał mu tylko krzesło .	podał	1	Sing
Pracował em .	Pracował	0	Sing
W dniu Debaty zamykam się razem ze stosem dokumentacji w pokoju redakcyjnym , wyłączam telefon komórkowy i nie ma mnie praktycznie dla nikogo .	wyłączam	13	Sing
Na zakończenie chcę powiedzieć , że klub Unii Demokratycznej wnioskuje o skierowanie projektu do odpowiednich komisji .	wnioskuje	9	Sing
Wkrótce też natknęli się na mężczyzn ściągających skórę z zabitego kozła .	natknęli	2	Plur
Na ich stoliku leżały pokruszone papierosy , cygara , przewrócone filiżanki .	leżały	3	Plur
Wciąż drożeją zboża , głównie żyto , a ceny pszenicy ustabilizowały się na wysokim poziomie .	ustabilizowały	10	Plur
Reagował jak ideowy socjalista .	Reagował	0	Sing
Zaraz wrócę .	wrócę	1	Sing
Za dawno przywykł do posłuchu .	przywykł	2	Sing
- Krzyknęła histerycznie matka , a Anna przycupnęła w kącie za szafą .	przycupnęła	7	Sing
Nie patrz poza siebie .	patrz	1	Sing
Zwierzenia Ani poruszyły mnie do głębi .	poruszyły	2	Plur
Ekspertyza potwierdziła podpalenie .	potwierdziła	1	Sing
Opiekę sprawuje opiekun .	sprawuje	1	Sing
Uśmiechnęła się .	Uśmiechnęła	0	Sing
Wiem , że tu przyjdziecie .	przyjdziecie	4	Plur
Podobnie wypowiadali się przedstawiciele państw Zachodu i Trzeciego Świata .	wypowiadali	1	Plur
W tym roku stołeczni stróże prawa odkryli na Mazowszu już osiem takich fabryk .	odkryli	6	Plur
Wjeżdżamy między niechlujne zabudowania Płaszowa .	Wjeżdżamy	0	Plur
– Modesta dotykała ust serwetką , ostrożnie , żeby nie rozmazać szminki .	dotykała	2	Sing
Lecz myszy popłynęły za nim , dopadły go na wieży i zagryzły .	popłynęły	2	Plur
Uważają nas za moskalofilów , takich zaprzańców antyukraińskich , podczas gdy sami deklarują ukraiński patriotyzm .	Uważają	0	Plur
Pokoje stanowią wyłączną własność poszczególnych lokatorów .	stanowią	1	Plur
Przewrócił em jakieś puszki , stracił em kamerę , ale świeca płonie .	płonie	11	Sing
- Walendziak dyscyplinuje .	dyscyplinuje	2	Sing
Tylko spróbuj !	spróbuj	1	Sing
Szumią przy tym troszkę .	Szumią	0	Plur
- Ale płacicie wy .	płacicie	2	Plur
Do dziś w sądownictwie pracują osoby , które rozpoczynały swoją karierę w latach stalinowskich .	rozpoczynały	8	Plur
Izba tonęła w półmroku .	tonęła	1	Sing
W 2007 roku neurolodzy amerykańscy wyciągnęli je z muzeum i poddali badaniu rezonansem magnetycznym .	poddali	10	Plur
Oprócz okradania opolan eseldziaki kantowały również kumpli w interesach .	kantowały	4	Plur
Z łatwością pokonują one rzeki i jeziora jadąc pod wodą .	pokonują	2	Plur
Podnieśliśmy go , położyli na ławce .	położyli	3	Plur
Z niepokojem spoglądają oni na pochmurne niebo i termometr , śledząc przy tym pilnie prognozy meteorologiczne .	spoglądają	2	Plur
Ten film zmusza do myślenia .	zmusza	2	Sing
Pokrzepiła mnie tym na duchu .	Pokrzepiła	0	Sing
- Wcale nie zwariowaliśmy , tylko uważamy , że z taką nogą spacerować nie możesz .	uważamy	6	Plur
Stali wśród namiotów , w których krzątali się nadwołżańscy Niemcy , zruszczeni po wiekach .	krzątali	6	Plur
Uparci i bezkompromisowi , jednych przerażali , innych zachwycali .	przerażali	5	Plur
Rada Nadzorcza towarzystwa na wczorajszym posiedzeniu pominęła sprawy personalne .	pominęła	6	Sing
Jednak po dokładnych oględzinach straż pożarna odkryła ofiarę pożaru .	odkryła	6	Sing
Tak wielka ilość pokryje z nadwyżką chłonność rynku .	pokryje	3	Sing
Nad bezpieczeństwem w Zachodniopomorskiem czuwało 2500 policjantów , w tym 500 z drogówki .	czuwało	4	Sing
Jeśli resort zaakceptuje programy , będzie je finansować .	zaakceptuje	2	Sing
- Mieszkamy tu wszyscy od urodzenia , lecz nigdy jej nie widzieliśmy .	Mieszkamy	1	Plur
- Przyszli śmy tu wieczorem , by naprawić jedną z maszyn .	Przyszli	1	Plur
Wyrzekliśmy się naszych zasad i małpujemy kraje , które pogrążyły się w nihilizmie moralnym !	pogrążyły	9	Plur
Rozmawiam , dyscyplinuję .	Rozmawiam	0	Sing
- Dopóki rząd i koalicja nie podejmą decyzji , dopóty każdy może wypowiadać swoje zdanie .	podejmą	6	Plur
W tej sytuacji wiele przedziałów w pociągach nad morze , w góry i na Mazury zajmują koloniści .	zajmują	15	Plur
Zostawiła kartkę .	Zostawiła	0	Sing
Czy to wpłynie na treść raportu ?	wpłynie	2	Sing
Rozmawiał eś z Anną ?	Rozmawiał	0	Sing
Czasem przyglądam się swoim kolegom .	przyglądam	1	Sing
Sztandar bojowy podniosły także narody podbite i uciemiężone przez carat .	podniosły	2	Plur
Opadły mi ręce . . .	Opadły	0	Plur
Dla cięższej gramatury gastronomicznej trzykrotnie polskości się wyparł em .	wyparł	7	Sing
Strażacy wstępnie określili straty na 15.000 złotych .	określili	2	Plur
Wydaje mi się , że jest to jedna z tych wypowiedzi prezydenta , z których nic nie wynika .	Wydaje	0	Sing
- Ucząc języka , jednocześnie budzimy w dzieciach intelekt , ciekawość świata .	budzimy	5	Plur
Drugi pod względem kapitalizacji giełdowej Wielkopolski Bank Kredytowy osiągnął bardzo dobrą miesięczną dynamikę zysków wynoszącą 81,4 proc .	osiągnął	8	Sing
Robi się te rzeczy !	Robi	0	Sing
Zośka lekko się zmieszała .	zmieszała	3	Sing
Nowość polegała na tym , że nauczyciele chrześcijańscy wykazywali , iż w osobie Jezusa Chrystusa wypełniły się wszystkie przepowiednie proroków .	wypełniły	15	Plur
Zapada mrok , bierze lekki przymrozek .	Zapada	0	Sing
Ilia jeszcze drzemał .	drzemał	2	Sing
Tu składała ręce błagalnie , tam rozkładała je gestem perswazji .	rozkładała	6	Sing
– Od której ty urzędujesz tam teraz ?	urzędujesz	4	Sing
Lękają się .	Lękają	0	Plur
Wybierz dowolny chat , umów się z przyjacielem na określoną godzinę i rozmawiaj do woli .	Wybierz	0	Sing
ja im tłumacze .	tłumacze	2	Sing
- Tam napijemy się kawy .	napijemy	2	Plur
Stacja Nędza wielokrotnie zmieniała swoją nazwę .	zmieniała	3	Sing
14-letni chłopak nie jadł , nie mówił , nie umiał korzystać z toalety .	jadł	3	Sing
Teraz straszą budynki ogołocone z szyb i armatury .	straszą	1	Plur
Wtedy do akcji wkroczyli rodzice Marianny Czupinki .	wkroczyli	3	Plur
Nagrali razem pierwszą płytę .	Nagrali	0	Plur
- W Warszawie wstawała wcześnie rano .	wstawała	3	Sing
Wójcicki przewrócił się i uderzył głową o chodnik .	przewrócił	1	Sing
Jeśli jednak obietnica ta się potwierdzi , śmieci zasypią nas dopiero w przyszłym roku .	zasypią	8	Plur
Zyta milknie , Blanka opowiada o kłopotach małżeńskich .	milknie	1	Sing
SLD-owcy odwzajemniają to uczucie .	odwzajemniają	1	Plur
Rozpadają się wraz z nami , przestają istnieć .	Rozpadają	0	Plur
Ale nie tylko same ulice irytują .	irytują	5	Plur
Po incydentach w meczu derbowym ukarali ście Cracovię zamknięciem stadionu na dwa mecze .	ukarali	5	Plur
Uległ wzruszeniu stary pedagog i zajął się wdowim synem z całą życzliwością .	Uległ	0	Sing
Dokąd zdąża i czego pragnie ?	pragnie	4	Sing
Słuchali z zażenowaniem .	Słuchali	0	Plur
- Kapliczka przylegała do kościoła katolickiego , Łemkowie z niej od wielu lat nie korzystali .	korzystali	14	Plur
Pierwsze krople deszczu zadudniły o trumnę i zmieszały się ze święconą wodą , którą ksiądz rozpryskiwał z kropidła podobnego do królewskiego berła .	zadudniły	3	Plur
Okazało się również , że motocyklista nawet nie hamował przed uderzeniem .	hamował	8	Sing
Do dziś w sądownictwie pracują osoby , które rozpoczynały swoją karierę w latach stalinowskich .	pracują	4	Plur
Niemal wszystkie nici myśli kwestionującej prowadzą do Kartezjusza .	prowadzą	5	Plur
My tę opinię już znamy .	znamy	4	Plur
Rodzice wciąż pracują .	pracują	2	Plur
Komisja rewizyjna rady powiatowej zawnioskowała o udzielenie absolutorium i przesłała stosowny wniosek do Regionalnej Izby Obrachunkowej w Bydgoszczy .	zawnioskowała	4	Sing
Skupieni operatorzy delikatnie manipulowali skomplikowanymi urządzeniami odbioru przekazywanej informacji .	manipulowali	3	Plur
Wieczorem działki otuliły się dymem .	otuliły	2	Plur
Panującej atmosferze uległa również obsada maszynowni .	uległa	2	Sing
- Działania operacyjne ustały , a C . ciągle piął się w górę .	ustały	3	Plur
Szły dzieci przez pole minowe i wesoło machały rączkami .	Szły	0	Plur
Podpisuje się pani pod tym zdaniem ?	Podpisuje	0	Sing
Czy czynniki religijne nie ograniczają wolności wyborów politycznych obecnego rządu ?	ograniczają	4	Plur
- Ale już niedługo zniknie .	zniknie	4	Sing
Ale sposobu na usmażenie mózgu ode mnie nie dostaniesz .	dostaniesz	8	Sing
Dali wzgardę i zdradę , zapłacili zwykłą swą monetą .	Dali	0	Plur
Chwycił walizkę i pędem dopadł drzwi wyjściowych .	Chwycił	0	Sing
Siedzę dziś cały dzień w domu i obiad jemy w domu .	Siedzę	0	Sing
Podobno seryjni mordercy różnią się od innych ludzi chromosomalnie ?	różnią	3	Plur
Następnie Aleksander Zawadzki dokonał otwarcia muzeum w dziesiątym Pawilonie .	dokonał	3	Sing
Policja ustala przyczynę zdarzenia .	ustala	1	Sing
Nieznani sprawcy w nocy z wtorku na środę zbezcześcili cmentarz w Akwizgranie .	zbezcześcili	8	Plur
– oj no nie szkodzi no .	szkodzi	4	Sing
I panna Wanda zaledwie rzuciła na nie okiem .	rzuciła	4	Sing
Kobiety już niosą dla nas prowiant !	niosą	2	Plur
Przychodzą kibice .	Przychodzą	0	Plur
Ameryka nie marzy o czymś jeszcze trudniejszym niż Irak i Afganistan .	marzy	2	Sing
Idąc czuł , że wzbudza ciekawość , ludzie stawali , patrzyli za nim .	wzbudza	4	Sing
O decyzji tej poinformowała arabska telewizja Al-Dżazira .	poinformowała	3	Sing
Stanisław N . nie jest jedynym szczecińskim nauczycielem , któremu zarzuca się łapówkarstwo .	zarzuca	10	Sing
Zatrzymał się na miejscu i na wszelki wypadek uniósł ręce .	Zatrzymał	0	Sing
Zacisnął zęby .	Zacisnął	0	Sing
Zaproponowali , że przerobią telefon tak , by można było z niego bezpłatnie rozmawiać .	przerobią	3	Plur
Dzięki archiwum zachowały się kopie .	zachowały	2	Plur
Na czas akcji z kamienicy ewakuowano 10 osób , które nad ranem wróciły do swoich mieszkań .	wróciły	12	Plur
– chłopaki zaśpiewają jakąś ckliwą melodię . .	zaśpiewają	2	Plur
Z piętra wyżej zszedł dystyngowany sąsiad z chartem na białej smyczy .	zszedł	3	Sing
Aktor mamrocze coś niewyraźnie pod nosem , ale ma mikrofon i widz go zrozumie .	mamrocze	1	Sing
Bez trudu odnajdziesz ją też w teatrze , powieści , malarstwie .	odnajdziesz	2	Sing
Za metą w Wengen potłukł się .	potłukł	4	Sing
A teraz płyniemy jeszcze dalej . . .	płyniemy	2	Plur
Ta rzuciła słuchawką .	rzuciła	1	Sing
W niedzielę świątynia jest pełna i wszyscy wierzą , że znowu będzie tutaj diecezja .	wierzą	7	Plur
W dobrych warunkach mnożą się bardzo szybko .	mnożą	3	Plur
- Zapytał em żartobliwie , choć starała się mówić poważnie .	starała	6	Sing
- A niby czemu przeczę ?	przeczę	4	Sing
Komisje wnoszą o przyjęcie tej poprawki .	wnoszą	1	Plur
- Langer z grubasami popychał dziennikarską brać do wyjścia .	popychał	4	Sing
Dym i kurz dławił , ale jeszcze bardziej dławił strach .	dławił	3	Sing
Wytarł szkło do sucha i wymalował pierwsze zdanie .	wymalował	5	Sing
Cieszę się , że nic nie posłała m .	posłała	6	Sing
Przygotujemy wszystko i wtedy napijemy się maty .	Przygotujemy	0	Plur
- Już dawno umarł .	umarł	3	Sing
Tak już chyba na serio nie mówimy , a nasz cyniczny wiek jakąś aurę śmieszności wokół słowa zbudował .	zbudował	17	Sing
- Bo się pierdolą .	pierdolą	3	Plur
Osobiście poznała m swojego zaciekłego wroga .	poznała	1	Sing
Aż siedem kraks spowodowali motocykliści .	spowodowali	3	Plur
Tematy prac rodzą się nagle .	rodzą	2	Plur
Słyszeli , że niedaleko jest grupa młodych ludzi , ale zajęli się sobą .	Słyszeli	0	Plur
Podobny sprzęt otrzymywały od niego dzieci i w ten sposób kontaktował się z nimi .	kontaktował	10	Sing
Podstawowym problemem jest to , że na tym terenie mieszkają 2 rodziny .	mieszkają	9	Plur
- Jeśli czegoś nie lubię , nie zrobię tego za żadne pieniądze .	zrobię	7	Sing
– Dzwonił jakiś Kluba , pytał się , czy wiesz , że Zając nie żyje .	wiesz	9	Sing
Zaprzestań dążenia .	Zaprzestań	0	Sing
Wózek zwolnił biegu i przystanął .	przystanął	4	Sing
- A ja mówię panu profesorowi , że nie pójdę .	pójdę	9	Sing
Poznali śmy już nazirejczyków , ponieważ należał do nich Samson .	Poznali	0	Plur
Zwycięskie drużyny otrzymają nagrody pieniężne .	otrzymają	2	Plur
Ale nie mówmy o tym teraz .	mówmy	2	Plur
- Pytali , czy mamy jeszcze jakieś pieniądze .	Pytali	1	Plur
Jeśli pogoda dopisze , będziemy wykonywać te prace bez przerwy .	dopisze	2	Sing
Henryk informował , że Jenny przespała granicę i nikt jej nawet nie budził .	budził	12	Sing
– oglądamy ci szafki . .	oglądamy	1	Plur
Później strzałami w powietrze sterroryzował kasjerkę i zmusił ją do wydania pieniędzy .	zmusił	7	Sing
Wyborcy zdecydowali , że powinni zasiąść w Sejmie .	zdecydowali	1	Plur
Zaprosił do Varietes Budapest .	Zaprosił	0	Sing
Omówmy ten schemat na przykładzie .	Omówmy	0	Plur
- Nie patrz tak .	patrz	2	Sing
Do Warszawy dotarli już o gęstym zmroku .	dotarli	2	Plur
Nieruchomo stojąc w powietrzu nad kwiatami lecimy .	lecimy	6	Plur
Dziwnie było iść białymi korytarzami , nie wiedząc , dokąd prowadzą .	prowadzą	10	Plur
Robią to dziewiarze na dziewiarskich maszynach .	Robią	0	Plur
Człowiek wpakuje się w jakąś historię .	wpakuje	1	Sing
Rycerzy głodno nie puszczą .	puszczą	3	Plur
Przyszłość nieuchronnie zweryfikuje te hierarchie .	zweryfikuje	2	Sing
Gdzie się rozgrywa pierwowzór ?	rozgrywa	2	Sing
Zdziwilibyście się , ile nas łączyło .	łączyło	5	Sing
Strzeż się , Segubie !	Strzeż	0	Sing
Pod koniec gotowania dodajemy sos sojowy i na kilka minut pozostawiamy pod przykryciem .	dodajemy	3	Plur
Oczekując na swoją kolej , rozmawiają i oglądają filmy w świetlicy pod czujnym okiem opiekuna Rudolfa Dyrksa .	oglądają	7	Plur
Jeżeli Golędzinów nadjedzie , wygra wielką stawkę .	nadjedzie	2	Sing
Groźni faszyści są bezkarni , bo stronę założyli na amerykańskim serwerze .	założyli	7	Plur
Nie stoję o nie .	stoję	1	Sing
Dopomogą w twojej biedzie . "	Dopomogą	0	Plur
Popędzali swoje konie , bo koniecznie chcieli dopaść upatrzonej zwierzyny .	chcieli	6	Plur
- My tu o wzniosłych rzeczach mówimy .	mówimy	6	Plur
– ale już to działa ?	działa	4	Sing
Płacić również nie zamierzały .	zamierzały	3	Plur
Na wczasy jeżdżą osoby nietrendowe .	jeżdżą	2	Plur
Całujemy twoje lodowe stopy .	Całujemy	0	Plur
Cyfry nas nie interesują , tylko zdobywamy rynek .	interesują	3	Plur
Nie popisywała się przecież .	popisywała	1	Sing
Przeziębicie się !	Przeziębicie	0	Plur
Wśród podhalańskich Cyganów z bezwzględności słynie jego współpracownik , współoskarżony w Oświęcimiu , Stanisław Kamiński z Czarnej Góry .	słynie	5	Sing
Prace metaloplastyczne w kościele wykonywał Władysław Gąsienica Makowski .	wykonywał	4	Sing
Na nim konie tańczą .	tańczą	3	Plur
Bawi mnie to w jakiś ponury sposób .	Bawi	0	Sing
Uczucia decydują o przyszłości i sekwencji wydarzeń .	decydują	1	Plur
Tym głównie Stronnictwo będzie się różniło od większości europejskich partii chadeckich , w których liberalizm gospodarczy miesza się z ideami socjaldemokratycznymi i nauką społeczną Kościoła .	różniło	5	Sing
- Myślał em , że rano komary nie gryzą .	Myślał	1	Sing
W dobrych warunkach mnożą się bardzo szybko .	mnożą	3	Plur
Trzecioligowcy strzelili kontaktowego gola , ale w ostatnim kwadransie dwie bramki dla Lecha wypracował Remień .	strzelili	1	Plur
– W pewnym momencie jedna , która nagrywała wszystko kamerą , zaczęła machać ręką , byśmy szybko odjechali .	nagrywała	7	Sing
Twoje dalekosiężne projekty spotkają się ze zrozumieniem najbliższej osoby .	spotkają	3	Plur
- Jakby kładli śnieg z dołu do góry , nic by się nie stało .	stało	13	Sing
Ale już nie zdążyli , na pozostałym kawałku lądowały niemieckie dywizje pancerne .	lądowały	8	Plur
Mijała minuta za minutą , czas wlókł się w nieskończoność , a nie pojawiał się nikt .	wlókł	6	Sing
Wojska etiopskie kontynuują ofensywę w Erytrei .	kontynuują	2	Plur
Chorąży Nałęcz - Komornicki wydawał swoim moździerzystom komendy spokojnie i prawie beznamiętnie .	wydawał	4	Sing
Eli chwycił wiadra i ruszył za nią kamienistą dróżką .	chwycił	1	Sing
Musi na niego skoczyć .	Musi	0	Sing
- Chyba ci te czary na głowę zaszkodziły .	zaszkodziły	7	Plur
Omawiana książka jeszcze raz to potwierdza .	potwierdza	5	Sing
Robimy następny duży krok do III ligi .	Robimy	0	Plur
Krew ciągle płynęła mu z nosa .	płynęła	2	Sing
Wczoraj już od piątej rano kupcy wyprowadzali się .	wyprowadzali	6	Plur
Yennefer opuściła głowę , spojrzała między swoje uda , nad którymi przemykały złote rybki .	przemykały	11	Plur
Mógł by ś tego nie przeżyć .	Mógł	0	Sing
Furtka skrzypi , Dostojewski wystaje z pyska psa .	skrzypi	1	Sing
– bo oni na wieś dzwonią . .	dzwonią	5	Plur
W Betlejem zupełnie utracili ducha dociekliwości , z punktu widzenia intelektualisty zachowali się nadzwyczaj pokornie .	utracili	3	Plur
Siedemdziesięciu chorych leżało na słomianych barłogach we własnym kale .	leżało	2	Sing
Wszystkich pilnowali policjanci .	pilnowali	1	Plur
Nowi ustne rozpoczęli od geografii .	rozpoczęli	2	Plur
Adam , przeżyjemy to .	przeżyjemy	2	Plur
Gdy dorośnie , zbuduje swoją katedrę , tworząc powieściowy świat W poszukiwaniu straconego czasu .	dorośnie	1	Sing
Trzech sprytnych chłopców szukało nawet syrenki w przedszkolnym akwarium .	szukało	3	Sing
Ten biało - czarny kocur zdobył szturmem serca pracowników Downing Street , a z czasem jego sława rozprzestrzeniła się na cały kraj .	rozprzestrzeniła	17	Sing
Jeszcze bardziej przyśpieszyła kroku .	przyśpieszyła	2	Sing
Błagam , nie chorujcie i żadnych kłopotów nie miejcie !	chorujcie	3	Plur
Przyjechał ze wsi z forsą , chciał kupić motorek .	Przyjechał	0	Sing
Elżbieta rozstaje się z mężem , zabiera synka i ze Śląska przenosi się do Tarnowa .	zabiera	6	Sing
Grozi , że odbierze nam część pieniędzy .	odbierze	3	Sing
Symbolizują zmienną fortunę i uzasadniają nawoływania do stoickiego znoszenia dopustów losu albo chrześcijańskiej ufności w Bogu .	Symbolizują	0	Plur
Polityk przebywał tam krótko .	przebywał	1	Sing
I zrozumieli ludzie , że tu Bóg był , i zburzyli ten sądowy dom , aby w nim nikt już więcej po Panu Jezusie nie sądził , a przed jabłonnymi drzewami postawili krzyż i on do dziś tam stoi .	sądził	25	Sing
- Czy ja dobrze słyszę ?	słyszę	4	Sing
Bardzo żałuje , że robił dotąd .	żałuje	1	Sing
Dziękujemy panu , panie komisarzu .	Dziękujemy	0	Plur
Nie patrzył na mnie .	patrzył	1	Sing
W Raciborzu odbywa się wiele imprez kulturalnych .	odbywa	2	Sing
Dostrzegła m , że patrzą na mnie ze współczuciem .	patrzą	4	Plur
Nie licz na udany romans .	licz	1	Sing
Poprawiał wciąż aparat w uchu , jakby chciał lepiej usłyszeć .	Poprawiał	0	Sing
Dziwnym trafem niezależne spółki węglowe zaproponowały bardzo podobne podwyżki .	zaproponowały	5	Plur
Darowizny przekazane na jej rzecz podlegają odpisowi podatkowemu .	podlegają	5	Plur
W zeszłym roku lekarz stwierdził , że ma świnkę .	stwierdził	4	Sing
Na tej klepce bracia mocno się poślizgnęli .	poślizgnęli	6	Plur
- Przez 40 lat płaciliśmy składki na służbę zdrowia , a teraz , kiedy jej na-prawdę potrzebujemy , wypinają się na nas .	potrzebujemy	16	Plur
Ale już nie zdążyli , na pozostałym kawałku lądowały niemieckie dywizje pancerne .	lądowały	8	Plur
Na Siemiradzkiego wybrzydzali krytycy , ale publiczność uwielbiała jego obrazy .	wybrzydzali	2	Plur
Zabrali mi prywatność , nawet moje łóżko stało się własnością państwa .	Zabrali	0	Plur
Radni poruszyli problem złych nawierzchni dróg , domagając się ich remontu .	poruszyli	1	Plur
Każdemu kazał wprzódy próby odbywać i różnych sztuk dokazywać w swojej obecności .	kazał	1	Sing
Adam wspaniale tańczył , okazywał Edycie dużo zainteresowania .	okazywał	4	Sing
- Może razem jechać , weźmiemy motor ?	weźmiemy	5	Plur
Gospodarze odpowiedzieli dwoma golami Ralfa Hauptmanna i Austriaka Tony Polstera .	odpowiedzieli	1	Plur
Przyjaciele użyczali jej chętnie .	użyczali	1	Plur
- Ja nie spotykam się z takimi opiniami .	spotykam	3	Sing
Kompromitowali nie tylko siebie , ale i Polskę .	Kompromitowali	0	Plur
Nawet Nagroda Nobla mu nie dorównuje !	dorównuje	5	Sing
W wysokiej trawie leżały setki stygnących ludzkich ciał .	leżały	3	Plur
W piątek wieczorem odwiedziły ją w domu i namówiły na spacer .	namówiły	8	Plur
- Przyzwyczajajmy dzieci do picia mleka !	Przyzwyczajajmy	1	Plur
Odwrotnie nie przekazuje się żadnych wiadomości .	przekazuje	2	Sing
Jedynie opisywane przez panią żółwie na Seszelach się p . . .	p	8	Plur
W niektórych takich antykach robili schowki " .	robili	4	Plur
Odbyło się taksowanie .	Odbyło	0	Sing
W deklaracji żądają , by prezydent złożył dymisję .	żądają	2	Plur
Na wrocławski Rynek rzeczywiście przybyły tłumy .	przybyły	4	Plur
Zaciągam się papierosem i próbuję przypomnieć sobie dawnego Dziedziuszkę .	próbuję	4	Sing
Duchy lubią takie miasteczka .	lubią	1	Plur
Ogień szedł przed Tobą i pożerał nieprzyjaciół .	szedł	1	Sing
Klasnął w ręce .	Klasnął	0	Sing
Wierni poczuli się zawiedzieni .	poczuli	1	Plur
- Sam pan oceni .	oceni	3	Sing
Siadł em przy niej .	Siadł	0	Sing
- Będziemy grali , mam taką nadzieję .	grali	2	Plur
Przypomniał sobie , że od trzech dni nie golił się i nie umył przyzwoicie . . .	golił	8	Sing
Ponadto dostali śmy kamizelki , za które żaden z nas nie zapłacił .	zapłacił	11	Sing
Kiedy wreszcie natrafił na schody i znalazł się na ulicy , kolegów przed pałacem już nie było ; najwidoczniej nie mogąc się go doczekać udali się bez niego na miasto .	natrafił	2	Sing
Tępe łby zamieszczają zdjęcia .	zamieszczają	2	Plur
Ofiarę udusili paskiem i dobili kamieniami .	udusili	1	Plur
Tuż po publikacji rozdzwoniły się telefony z zamówieniami .	rozdzwoniły	3	Plur
Dostrzegł podporucznika Kowalika , skinął mu porozumiewawczo głową .	skinął	4	Sing
Nawet nie chce się takich słów komentować .	chce	2	Sing
U młodej dziewczyny psychiatra z Modusa rozpoznał początki choroby psychicznej , dziewczyna myśli o samobójstwie .	rozpoznał	6	Sing
Nocami przychodziły do mojego łóżka , kochały mnie .	kochały	6	Plur
Namierzyli ich razem z prokuratorami .	Namierzyli	0	Plur
Niektórym się sprawdziło .	sprawdziło	2	Sing
Dręczą go też różne niemężne pokusy .	Dręczą	0	Plur
Opary porannej mgły nad jeziorem znikały w złotych promieniach słońca .	znikały	5	Plur
Jeżeli ciasto troszeczkę rozlatuje się w oleju , oznacza to , że zostało prawidłowo przyrządzone .	rozlatuje	3	Sing
Nie odpowiem pani raczej na to pytanie .	odpowiem	1	Sing
U ludów słowiańskich rodzina miała charakter patriarchalny , a przewodził jej ojciec .	przewodził	9	Sing
Jutro nigdy nie umiera .	umiera	3	Sing
O co poszło ?	poszło	2	Sing
" Obywatelu Bukowiński , proponujemy wam repatriację do Polskiej Republiki Ludowej " .	proponujemy	4	Plur
30 kilogramów falsyfikatów miało wartość 4 milionów dolarów .	miało	3	Sing
Bez pardonu wpychały rzeczy do kieszeni i toreb .	wpychały	2	Plur
Rozrywka jest kołem zamachowym telefonii komórkowej , a MMS bardzo ją uatrakcyjnią .	uatrakcyjnią	11	Plur
- Jego oczy patrzą chytrze .	patrzą	3	Plur
Prawdziwy dramat przeżywa rodzina Tomka .	przeżywa	2	Sing
Z innych danych wynika , że z 37 masowców , które zatonęły w okresie od stycznia 1992 do marca 1996 , większość stanowiły statki tanich bander .	zatonęły	11	Plur
Wtedy wracali chłopi , a wraz z nimi albo wkrótce po nich w pandższirskich wioskach pojawiali się mudżahedini .	wracali	1	Plur
Wszystko wskazywało na to , że jednak tak nie było , ale należało to dokładnie sprawdzić .	wskazywało	1	Sing
I przeczytaj coś o Simone de Beauvoir .	przeczytaj	1	Sing
Marta poczuła ukłucie .	poczuła	1	Sing
( komendant rzucił słuchawką ) .	rzucił	2	Sing
Studenci medycyny alarmują z kolei , że w przyszłym roku będą musieli zdawać egzamin dyplomowy , a nie ma jeszcze jego kryteriów .	musieli	11	Plur
Mało brakowało , a miłość do zajączka Kamil przypłacił by życiem .	brakowało	1	Sing
Na leśnej drodze zaatakował ją rowerzysta .	zaatakował	3	Sing
– Mock zapalił i rozsiadł się w fotelu .	rozsiadł	4	Sing
Na dworzec odprowadził nas profesor Garraud , doktor Adler i przełożona pielęgniarek , pani Grivet .	odprowadził	2	Sing
Oferował swoje usługi .	Oferował	0	Sing
Szklanki przechodziły z rąk do rąk .	przechodziły	1	Plur
Istnieją też miasta , dla których nigdy nie ustaje karnawał .	Istnieją	0	Plur
Później strzałami w powietrze sterroryzował kasjerkę i zmusił ją do wydania pieniędzy .	sterroryzował	4	Sing
Decyzje w tej sprawie podjęły Mostostal Warszawa , Elektrim , Polifarb i Okocim .	podjęły	4	Plur
Terroryści wyciągnęli broń i strzelali w powietrze .	wyciągnęli	1	Plur
Kelner przesunął się obok ich stolika do okna .	przesunął	1	Sing
Pozbierał em rozrzucone papierzyska i przypomniał em sobie sen .	Pozbierał	0	Sing
Pożeracz Chmur przełknął ostatni kęs i oblizał palce .	przełknął	2	Sing
Indie stanowczo zaprzeczają .	zaprzeczają	2	Plur
Potem zwiedzili miasto .	zwiedzili	1	Plur
Dali ście zły przykład , sprowokowali ście do grzechu !	sprowokowali	5	Plur
Obudzimy Anamarię o dwunastej .	Obudzimy	0	Plur
Japończycy z entuzjazmem przyjęli inicjatywę reżysera .	przyjęli	3	Plur
Urządzimy też prywatny gabinet .	Urządzimy	0	Plur
Jakimowski zdębiał .	zdębiał	1	Sing
Oczy Nony zalśniły .	zalśniły	2	Plur
Przerwali terapię we Mstowie i w krótkim czasie zmarli z powodu narkotycznego przedawkowania .	zmarli	8	Plur
Twierdzili , że nie oddali córki do szpitala , bo nie mogliby jej odwiedzać .	Twierdzili	0	Plur
Jadą i kopcą .	kopcą	2	Plur
– Powiedz mi na koniec naszego miesiąca . . .	Powiedz	1	Sing
jeszcze ciasto kupujemy .	kupujemy	2	Plur
– Czy używasz prezerwatyw ?	używasz	2	Sing
Nikt go tu nie zapraszał !	zapraszał	4	Sing
Musi , niczego nie dostrzegając , dalej spokojnie obierać włoszczyznę .	Musi	0	Sing
nie uświadomili kurde . .	uświadomili	1	Plur
Niech państwo płaci !	płaci	2	Sing
Czy zdąży ?	zdąży	1	Sing
Piłsudczycy nie dopuścili do dyskusji w Sejmie , który zresztą został rozwiązany 30 sierpnia 1930 r . , w połowie kadencji .	dopuścili	2	Plur
Na wrocławski Rynek rzeczywiście przybyły tłumy .	przybyły	4	Plur
Przypuszcza , że uczył się nowych słów .	Przypuszcza	0	Sing
Wykształciuchy bronią się przed premierem .	bronią	1	Plur
A jaki się ukazywał Annaliese Micheal ?	ukazywał	3	Sing
Na pewno też wywołał by protesty spowodowane dalszym naruszaniem stabilności sytuacji podatników .	wywołał	3	Sing
Dwie ranne osoby trafiły do szpitala .	trafiły	3	Plur
Lubi to .	Lubi	0	Sing
Rozdają publiczne pieniądze na rzecz Kościoła katolickiego , modlą się żarliwie przed kamerami , marzą o cenzurze obyczajowej .	Rozdają	0	Plur
Tam czekały już na nich armatki wodne , podstawione przez władze .	czekały	1	Plur
Handluje z powodzeniem .	Handluje	0	Sing
Napastnicy grozili nastolatkom , że ich pobiją .	pobiją	6	Plur
- Ucząc języka , jednocześnie budzimy w dzieciach intelekt , ciekawość świata .	budzimy	5	Plur
On też ją rozpoznał i uśmiechnął się do niej .	rozpoznał	3	Sing
Polski lud w nic nie wierzy .	wierzy	5	Sing
Drugiej , rozładowanej do połowy w Pruszkowie , rabusie nie tknęli .	tknęli	10	Plur
To państwo Kaczyńscy wiedzą i rządu do dymisji nie podadzą .	wiedzą	3	Plur
Doświadczył tego na sobie mecenas Jan Murasz .	Doświadczył	0	Sing
Czy na to go dzisiaj plecy swędziały ?	swędziały	6	Plur
Właśnie zakończył się trzeci , diecezjalny etap konkursu .	zakończył	1	Sing
Rozpoczął się kolejny rok akademicki .	Rozpoczął	0	Sing
W milczeniu spożywali zimną konsolację , szczękały sztućce , dworscy w ciemnych surdutach sprawnie zmieniali misy .	zmieniali	14	Plur
Nauczyciele wymienili spojrzenia .	wymienili	1	Plur
- A ty się zamknij !	zamknij	4	Sing
Siła uderzenia wbiła renaulta w innego tira .	wbiła	2	Sing
Z trudem dostrzegam siedzących pod oknem Stefana i Wiktora .	dostrzegam	2	Sing
Dymek w tym czasie ekspanderem przymocował otwartą klapę .	przymocował	5	Sing
I jeszcze coś szumiało .	szumiało	3	Sing
Czemu mi ją obrzydzacie ?	obrzydzacie	3	Plur
Nie wiem , czy wybory zweryfikowały ten pogląd .	zweryfikowały	5	Plur
Trudniej było się zdecydować , na co pójdę .	pójdę	7	Sing
Dysponują one stu czterdziestu trzema traktorami , osiemdziesięcioma snopowiązałkami .	Dysponują	0	Plur
- Pewnie , wszyscy Polacy cesarzowi służą .	służą	6	Plur
Posłowie udzielili też rządowi absolutorium z wykonania ubiegłorocznego budżetu .	udzielili	1	Plur
Postęp techniczny dosięgnął także brytyjskich amatorów herbaty .	dosięgnął	2	Sing
Daje to 210 głosów .	Daje	0	Sing
Dajcie mi broń !	Dajcie	0	Plur
W ten sposób wykorzystywał swoją władzę .	wykorzystywał	3	Sing
Józinek ochłonie , sprzątnie , przeprosimy się .	przeprosimy	5	Plur
Nie powiedzieli .	powiedzieli	1	Plur
Pei Fan nie odzywał się , pogrążony we własnych myślach .	odzywał	3	Sing
Wreszcie zdarzyła się prawdziwa katastrofa .	zdarzyła	1	Sing
Tu ujawniała się jego sumienność , skrupulatność i krytycyzm .	ujawniała	1	Sing
Po feriach zimowych do nowej szkoły wprowadzili się uczniowie Liceum Ogólnokształcącego w Drohiczynie .	wprowadzili	6	Plur
Wczoraj ciśnienie wynosiło ponad 1000 hektopaskali .	wynosiło	2	Sing
Zgromadzili się gapie .	Zgromadzili	0	Plur
Wrześniowe wybory zmieniły polityczny układ parlamentu .	zmieniły	2	Plur
Polska powoli suszyła się po wielkiej powodzi , a uwaga Czytelników kierowała się na politykę .	kierowała	11	Sing
Wyłączyła komputer i podeszła do lustra .	Wyłączyła	0	Sing
- Całkowicie zgadzam się z odkryciami naukowców .	zgadzam	2	Sing
Niestety , wykonane opodal obwałowania niewiele dały .	dały	6	Plur
Wtórna samotność zdaje się jeszcze cięższa .	zdaje	2	Sing
Nie imała się ich rdza .	imała	1	Sing
- Nikt się nie rozłazi , panie kapralu !	rozłazi	4	Sing
Nie zajedziesz nigdy , nie odwiedzisz .	zajedziesz	1	Sing
Podobały jej się ogrody otaczające stare wille .	Podobały	0	Plur
Poklepał chłopca po ramieniu .	Poklepał	0	Sing
Do minionej środy takie pismo do starostwa w Bytowie nie nadeszło .	nadeszło	10	Sing
W lasach pasły się krowy i owce , czasem ozwał się poryk niedźwiedzia lub gniewne parsknięcie rysia .	pasły	2	Plur
Ucichli wszyscy , czekając na znak .	Ucichli	0	Plur
Ułoży się most , star przejedzie , kratownice wrócą na miejsce , zatrzemy ślady i poczekamy .	zatrzemy	12	Plur
Drzwi uchyliły się z lekkim skrzypieniem nie naoliwionych zawiasów .	uchyliły	1	Plur
Dla zachęty wspomniała by m , że dostanie czekoladę .	wspomniała	2	Sing
Potem przemawiali inni mówcy i debata ciągnęła się przez następną godzinę .	ciągnęła	6	Sing
- Już całkiem zwariowali ście !	zwariowali	3	Plur
Wypowiedział wojnę wielu bardzo różnym środowiskom .	Wypowiedział	0	Sing
Pomilczeli chwilę .	Pomilczeli	0	Plur
Obstawimy łoże tabliczkami . . .	Obstawimy	0	Plur
W ten sposób stworzył duży sektor socjalistyczny w gospodarce algierskiej .	stworzył	3	Sing
Wiatr zmęczył się także .	zmęczył	1	Sing
Prezydent zaprzeczył i wytoczył nam proces .	wytoczył	3	Sing
Znał w mieście każdą uliczkę i każdy zaułek .	Znał	0	Sing
Przy czwartym zerwali obrady i ustawili się w kolejce , by podpisać listę obecności .	zerwali	2	Plur
Milczał em .	Milczał	0	Sing
Następnie Aleksander Zawadzki dokonał otwarcia muzeum w dziesiątym Pawilonie .	dokonał	3	Sing
Kto ją sformuował ?	sformuował	2	Sing
Wyszli śmy na ląd , żeby rozprostować kości .	Wyszli	0	Plur
Dzieci jeszcze się uczą .	uczą	3	Plur
Po rozmowie z nimi demonstranci się rozeszli .	rozeszli	6	Plur
Nacierają na nas wrogie czołgi .	Nacierają	0	Plur
Uciekli z polany i skryli się między drzewami .	Uciekli	0	Plur
Przepisuję im leki uspokajające , herbatki nasenne i zapewniam , że Amerykanie strzegą naszego bezpieczeństwa .	strzegą	12	Plur
Po wojnie w polskich więzieniach siedzieli prawie wszyscy , którzy nie uciekli za granicę .	uciekli	11	Plur
Bo gdy został proboszczem , nie pozwolił radzie parafialnej wprowadzić się procesją do plebanii i kościoła .	pozwolił	6	Sing
Policja identyfikowała ofiary na podstawie znalezionych przy nich przedmiotów osobistych .	identyfikowała	1	Sing
Nie piszą o nim podręczniki , tradycja nie przekazuje jego zasług potomnym .	piszą	1	Plur
Gorące spojrzenia towarzyszyły kandydatkom do korony podczas całego rejsu .	towarzyszyły	2	Plur
Dziękujemy w imieniu Agnieszki Kulig .	Dziękujemy	0	Plur
Zawalili śniegiem całą górę nierówno i musiało strzelić .	musiało	6	Sing
Istotnie , w damskim pokoju aż syczało .	syczało	6	Sing
I wcześniej Smolański gwałtownie manifestował swoje poglądy .	manifestował	4	Sing
Za każdy samochód zabierali się od razu mechanicy , zmieniali koła , usuwali uszkodzenia powstałe w czasie forsownego treningu , wymieniali zdarte nakładki hamulcowe , regulowali silniki .	usuwali	12	Plur
Nakręcił 60 filmów dokumentalnych i stworzył ponad 300 programów telewizyjnych .	Nakręcił	0	Sing
Wcześniej objął władzę w wyniku zamachu stanu .	objął	1	Sing
Ukończyły wyścig razem , trzymając się za ręce .	Ukończyły	0	Plur
Ręką wskazał mi fotel .	wskazał	1	Sing
Po urodzeniu odżywia się mlekiem matki .	odżywia	2	Sing
Znajdujemy się u początku naszego eksperymentu .	Znajdujemy	0	Plur
Nadzieja miesza się z rozpaczą .	miesza	1	Sing
Na spotkanie z Jeffreyem przyszła spóźniona , umówili się w kawiarni nieopodal opery .	umówili	7	Plur
Napięta żyłka świsnęła i pękła w przeponie .	pękła	4	Sing
Wchodzimy do starej kamienicy .	Wchodzimy	0	Plur
Wypowiadamy je w różnych sytuacjach i z różnych powodów .	Wypowiadamy	0	Plur
Do przyczyn nawet nie sięgną !	sięgną	4	Plur
Musieli się też czasem zabawić .	Musieli	0	Plur
- Bywa , że czuję się w teatrze obco .	Bywa	1	Sing
Nagie , surowe ściany tchnęły mroźną wilgocią .	tchnęły	4	Plur
- Sądy podchodzą do tajnych współpracowników bardzo liberalnie , nie eliminują z życia społecznego agentów .	podchodzą	2	Plur
Otaczają one miasto od południa i zachodu .	Otaczają	0	Plur
- On nigdy nie zjedzie chłopu z drogi , choćby był w próżni .	zjedzie	4	Sing
Nie znał em go przedtem , bo za moich czasów wileńskich był jeszcze sztubakiem , a potem przebywał za granicą .	znał	1	Sing
Inżynier Arthur Kühne westchnął , ale uśmiech nie schodził z jego twarzy .	schodził	8	Sing
Koledzy z zasadniczej górniczej patrzyli w niebo i czekali .	patrzyli	4	Plur
Znów pomógł mu aspirant .	pomógł	1	Sing
- Knujecie !	Knujecie	1	Plur
Nie mogł em .	mogł	1	Sing
Nadal nie wiedzą , jaka będzie matura .	wiedzą	2	Plur
Machała m mu fartuchem , żeby lądował na łące pod lasem , ale ten chłopak chyba się przestraszył , że zawadzi o druty .	przestraszył	17	Sing
Ręce mu drżały , gdy podnosił szklankę .	podnosił	5	Sing
Rosyjsko - niemiecka inwestycja ominie Polskę i inne państwa Europy Środkowej .	ominie	4	Sing
Był by upadł .	upadł	2	Sing
Spojrzał na mnie zaskoczony .	Spojrzał	0	Sing
Naraz przystanęli , bo zdawało się im , że słychać czyjeś kroki .	przystanęli	1	Plur
Przyjechały 102 osoby .	Przyjechały	0	Plur
R . pomagał ukryć zwłoki .	pomagał	2	Sing
Recepcjonistce oczy rozszerzyły się ze zdumienia .	rozszerzyły	2	Plur
Przeszli kilka kroków w milczeniu .	Przeszli	0	Plur
Miliony ludzi straciło oszczędności całego życia .	straciło	2	Sing
W Europie początkowo kawę sprzedawali medycy , zalecając ją na smutki i przygnębienie .	sprzedawali	4	Plur
Porucznik nie zamierzał wykładać swoich kart , a przynajmniej nie zamierzał robić tego od razu .	zamierzał	10	Sing
Alona wybierała produkty ze straganów , a pan Jeffrey nosił za nią koszyk .	wybierała	1	Sing
Dyskusje utykały na poziomie kosztorysów .	utykały	1	Plur
- Proboszcz pierwszy nadpił .	nadpił	3	Sing
Chcemy też , by nasi gracze wzorowali się na najniebezpieczniejszej odmianie raptorsów - globoraptorach .	wzorowali	6	Plur
W I lidze piłkarskiej rozpoczyna się runda wiosenna .	rozpoczyna	4	Sing
Tworzymy silny zespół i to jest nasz największy atut .	Tworzymy	0	Plur
Powybijają ci zęby .	Powybijają	0	Plur
Inżynier Arthur Kühne westchnął , ale uśmiech nie schodził z jego twarzy .	westchnął	3	Sing
Ze stara wyciekał olej i płyn chłodzący , a przyczepa miała zdemontowany hamulec awaryjny .	wyciekał	2	Sing
Pierwsze krople deszczu zadudniły o trumnę i zmieszały się ze święconą wodą , którą ksiądz rozpryskiwał z kropidła podobnego do królewskiego berła .	zmieszały	7	Plur
Ale myśli nabyte od ikon pozostały .	pozostały	5	Plur
Patrzył na Petera ze smutkiem i zdumieniem zmieszanym z podziwem .	Patrzył	0	Sing
Niektórzy szukali ich na dalekiej mroźnej północy .	szukali	1	Plur
Co sprawiło , że zaangażował się pan w ten ruch i tę ideologię ?	zaangażował	4	Sing
Jean Paul nie odzywał się .	odzywał	3	Sing
Saperzy wydobyli we wtorek sześć artyleryjskich pocisków burzących z czasów II wojny światowej , odkrytych na terenie budowy na krakowskim Prądniku Czerwonym .	wydobyli	1	Plur
Przy wynoszeniu rannego w pojedynkę ujmujemy go oburącz pod ramiona .	ujmujemy	5	Plur
– Ten komplet narzędzi służył do ćwiartowania korpusów .	służył	4	Sing
Jak podały miejscowe rozgłośnie radiowe , wykoleiły się dwa wagoniki podziemnej kolejki .	podały	1	Plur
– Ale mecz przesunęli ście na następny dzień . . .	przesunęli	3	Plur
Współczesne trendy cywilizacyjne sprzyjają siłom zła , lecz dobro nie odpuszcza .	sprzyjają	3	Plur
W ostateczności wyjdę na taras .	wyjdę	2	Sing
Mogę się tylko domyślać , że mechanicy zabiją barana , który od rana obgryza skraj plastikowego worka , i przyniosą mi moją część .	przyniosą	19	Plur
Oskarżano nas , że w Bielicznej sprzedali śmy prywatnemu nabywcy kilkaset hektarów wraz z cmentarzem i cerkwią .	sprzedali	6	Plur
Trzęsą mi się nogi .	Trzęsą	0	Plur
Siedział odchylony za swoim biurkiem z taką miną , jakby dowodził całą policją , Interpolem i FBI na dodatek i delektował się kawą .	delektował	20	Sing
- Teraz nadszedł czas , by śmy się moralnie zrewanżowali .	zrewanżowali	9	Plur
Zresztą nie obrażaj mnie !	obrażaj	2	Sing
- Rozmawiał pan z Filipiakiem ?	Rozmawiał	1	Sing
Sami zgłaszali się do wszystkich naszych działań .	zgłaszali	1	Plur
Był ujmujący w obejściu , bez przerwy się uśmiechał .	uśmiechał	8	Sing
Nie rokowało to najlepiej .	rokowało	1	Sing
Podczas obchodu można było się przekonać , że nastąpiły gruntowne zmiany w pomieszczeniach CSiK .	nastąpiły	8	Plur
Interesanci spojrzeli we wskazanym kierunku i oniemieli z radości .	oniemieli	6	Plur
Zuzanna uchyla się od mówienia o sobie .	uchyla	1	Sing
Pan poseł pomagał panu ministrowi , nie mogę za to go skarcić .	pomagał	2	Sing
Nic nie zapowiada takiego scenariusza .	zapowiada	2	Sing
Zatruwa życie obywateli .	Zatruwa	0	Sing
Polacy pokonali 28 zespołów z całego świata i po raz pierwszy zdobyli puchar .	pokonali	1	Plur
Ich odrobienie przekraczało siły jednego pokolenia .	przekraczało	2	Sing
Wracał em do Bud już po północy .	Wracał	0	Sing
- Powinno być łatwiej , bo Husajna nie otaczają fanatycy .	otaczają	8	Plur
Przeczesał się i obciągnął mundur .	obciągnął	3	Sing
Wzięli w niej udział przedstawiciele policji z Niemiec , Czech , Słowacji , Węgier , Ukrainy i Polski .	Wzięli	0	Plur
W Betlejem zupełnie utracili ducha dociekliwości , z punktu widzenia intelektualisty zachowali się nadzwyczaj pokornie .	utracili	3	Plur
Zdążyli . . . ?	Zdążyli	0	Plur
W dokumentach dowódcy szczycą się tym , że stłumili bunt bez użycia broni .	szczycą	3	Plur
- Moszczyński kiwał głową .	kiwał	2	Sing
Ţe nie zapomniała . . .	zapomniała	2	Sing
Podróżujący pierwszą klasą będą odtąd mogli wypoczywać podczas lotu na rozkładanych podwójnych siedzeniach .	mogli	5	Plur
Reanimowali Piotra .	Reanimowali	0	Plur
- Zaliczyli śmy nawet test wypadkowy .	Zaliczyli	1	Plur
Jak to skończysz , spróbuj Stendhala i Buddenbrooków Tomasza Manna . . .	spróbuj	4	Sing
Długo się nie widzieli śmy , chyba ze dwa tygodnie .	widzieli	3	Plur
- Następni zdezerterowali ?	zdezerterowali	2	Plur
Wszyscy się tłukli .	tłukli	2	Plur
Odrabiamy je w gruncie rzeczy do dzisiaj .	Odrabiamy	0	Plur
Nie robimy z tego tajemnicy .	robimy	1	Plur
Weszli do środka .	Weszli	0	Plur
Nikt nie zamierzał ustąpić .	zamierzał	2	Sing
Dzięki archiwum zachowały się kopie .	zachowały	2	Plur
Postanowił go szybko zlokalizować .	Postanowił	0	Sing
potem z nimi opijali .	opijali	3	Plur
Wstaję , wyglądam przez okno .	wyglądam	2	Sing
- Myśleli śmy , że się nie uda .	Myśleli	1	Plur
Urwał em .	Urwał	0	Sing
- Oto głoszę Twoje Królestwo .	głoszę	2	Sing
Dziś stąd wyruszamy , może jeszcze zdążę ucałować jego stygnącą rękę .	wyruszamy	2	Plur
- Patrz !	Patrz	1	Sing
Ocean wtargnął w głąb lądu i nie odpłynął cały , tworząc jeziora rozmiaru mórz , bo głęboka płyta litosferycznego płaszcza Kwinty uległa zgnieceniu , a wody zapełniły powstałe na powierzchni depresje .	uległa	21	Sing
Na bezdomne po Powstaniu Warszawskim dwie głośne pisarki czekały w Łodzi zarezerwowane dla nich mieszkania .	czekały	8	Plur
Zimą bywało , że nie jadła tygodniami .	jadła	5	Sing
Mechanicy zajęli się już samochodem Gorczycy .	zajęli	1	Plur
Wicemistrzynie Polski z Mielca nie dały pograć w Krakowie Wiśle i opuściły ostatnie miejsce w tabeli właśnie na rzecz podopiecznych Lesława Kędryny .	dały	5	Plur
Zahamował i wychylił się .	Zahamował	0	Sing
Nazajutrz , w czwartek , mieli śmy lekcję zaraz po obiedzie .	mieli	5	Plur
Ale dzieciaki i tak odbijają piłki o ściany pod oknami .	odbijają	4	Plur
Redukcja zatrudnienia obejmie przede wszystkim pracowników administracji i obsługi produkcji .	obejmie	2	Sing
Kosmonauci przechodzili ją jednak nieraz w czasie treningów .	przechodzili	1	Plur
Zarzucił mu Pan , że utrwala sejmokrację .	Zarzucił	0	Sing
Kiedy wdychasz powietrze , czuj to .	wdychasz	1	Sing
- Posiada osobowość prawną .	Posiada	1	Sing
Błagam , nie chorujcie i żadnych kłopotów nie miejcie !	miejcie	8	Plur
- Szybko mijają te kraje .	mijają	2	Plur
Niektóre sprawy trafiły nawet do kolegium .	trafiły	2	Plur
Pochodzi z wielodzietnej rodziny wiejskiej .	Pochodzi	0	Sing
Łamią się piersi , trzeszczy kość , próchnieją dłonie , twarze bledną . . .	bledną	11	Plur
Parokrotnie Wajdowie osobiście kwestowali na ulicach Japonii .	kwestowali	3	Plur
Przed kolejną gonitwą wszyscy idą popatrzeć na padok , gdzie zaprezentują się wystawione do niej konie .	zaprezentują	10	Plur
Po tym ułożyli śmy się na ziemi , by spać .	ułożyli	2	Plur
W grudniu sprzedali mieszkanie i każde z nich poszło w swoją stronę .	sprzedali	2	Plur
Wszystko rozbija się o zachowanie ludzi i organizację .	rozbija	1	Sing
Kobiety przystrajają drzewko kolorowymi wstążkami , śpiewając przy tym tradycyjne pieśni .	przystrajają	1	Plur
W tym roku o tytuł najlepszej walczyło 160 pism .	walczyło	6	Sing
Dratewkę pani Joasia wyrwała z bestialskich łap pewnego szewca , którego niech piekło pochłonie .	wyrwała	3	Sing
Twoje inicjatywy , konkretne , praktyczne i pożyteczne , zyskają uznanie i poparcie .	zyskają	9	Plur
Po tym wypadku jakby się otrząsnął .	otrząsnął	5	Sing
Nie szukał cierpienia ani śmierci .	szukał	1	Sing
Ogień trzaskał w ciszy , dzieci wybiegły na dwór przestraszone .	wybiegły	6	Plur
Zimna woda tryskała na głowę , szyję i płonące uszy .	tryskała	2	Sing
Staruszkowie skwapliwie wyściskali Pindla , a on stał oszołomiony .	wyściskali	2	Plur
Oprócz Wałęsy wszyscy licytowali się radykalnością .	licytowali	3	Plur
Wypłynęli śmy z Baški .	Wypłynęli	0	Plur
Wyobrażał sobie minę Każe-duba czytającego jego raport .	Wyobrażał	0	Sing
Przewagę mieli lubinianie , a goście grali wyjątkowo pasywnie .	grali	6	Plur
- Właśnie wysikała m się do niej .	wysikała	2	Sing
Nagranie wykazało , że w przestępstwie pomagali ochroniarzowi dwaj inni młodzi mężczyźni .	pomagali	6	Plur
Na piersiach dyndały im krzyże z Jezusem Chrystusem .	dyndały	2	Plur
Poprawkę skrytykował już dyrektor wykonawczy Światowego Kongresu Żydów Elan Steinberg .	skrytykował	1	Sing
Milczeli śmy .	Milczeli	0	Plur
Dziecko przejechało w ten sposób aż 6 pięter .	przejechało	1	Sing
Siedział już w oknie , z nogami wystawionymi na zewnątrz , ale w porę obezwładnili go i ściągnęli z okna strażnicy miejscy .	obezwładnili	14	Plur
Na pewno marzł w zimie .	marzł	2	Sing
Używają go specsłużby w ponad 40 krajach .	Używają	0	Plur
Czołgi i wozy pancerne strzegą więzienia , do którego ciężarówki wojskowe bez przerwy przywożą aresztowanych .	przywożą	13	Plur
Działacze liczą , że związek nie będzie ścigany z całą surowością .	liczą	1	Plur
Chodźcie za mną .	Chodźcie	0	Plur
Koniec przedstawienia , teraz kretyni biją brawa i proszą o bisy . . .	biją	5	Plur
Posiada ok. 150 ciekawych i zróżnicowanych egzemplarzy .	Posiada	0	Sing
Zresztą francuzica niepotrzebnie wylicza kunsztowne potrawy , bo generał lubi tylko prostą kuchnię .	wylicza	3	Sing
Mam pracę do czerwca , rozbieramy teraz czwarty piec .	rozbieramy	5	Plur
Spodziewałem się , że może choć raz się coś uda .	uda	9	Sing
Dotychczas nie ośmielał się poruszać z matką tych spraw .	ośmielał	2	Sing
Poza tym , spotykam się z nimi na gruncie zawodowym .	spotykam	3	Sing
Przybysze z najnowszej fali na ogół stronią od polonijnych organizacji społecznych .	stronią	6	Plur
Wyprowadzają one małe koźlęta na płaty śniegu i uczą je zjeżdżać na racicach .	uczą	8	Plur
W tym dniu życzenia owocnych obrad przekazali zjazdowi przewodniczący delegacji partii komunistycznych i robotniczych z krajów socjalistycznych .	przekazali	6	Plur
Zeszła z głównej alejki i skręciła w sieć bocznych dróżek .	skręciła	5	Sing
Poruszał rytmicznie kolanami , unosząc lekko siedzącą na nich kobietę .	Poruszał	0	Sing
Interesanci spojrzeli we wskazanym kierunku i oniemieli z radości .	spojrzeli	1	Plur
- Pomodlimy się . . .	Pomodlimy	1	Plur
Nie składają donosów do prokuratury , nie przejmują się całodobowym uśmiercaniem poczętych ?	przejmują	7	Plur
Pozwolą Państwo , że coś przypomnę .	Pozwolą	0	Plur
– Boi się zaufać komukolwiek .	Boi	1	Sing
Obecnie staramy się to maksymalnie uprościć i są już tego efekty .	staramy	1	Plur
Wracamy do szosy i jedziemy w stronę sąsiedniego Falsztyna .	Wracamy	0	Plur
Blask gwiazdy uciekał od oka .	uciekał	2	Sing
Samozwańczy gliniarz posługuje się oryginalną legitymacją .	posługuje	2	Sing
Głowa jego chwiała się bezwładnie na ramieniu Dziadzi .	chwiała	2	Sing
Oczy powoli przyzwyczajały się do mroku .	przyzwyczajały	2	Plur
Złoty instrument sprezentowało mu bractwo kurkowe .	sprezentowało	2	Sing
Pokiwał em tylko głową .	Pokiwał	0	Sing
Gdy nikt nie reagował na dzwonek , włączyli syrenę .	reagował	3	Sing
Miejscowi Polacy zapowiadają zaskarżenie decyzji do sądu .	zapowiadają	2	Plur
Zaczęły spadać .	Zaczęły	0	Plur
Związane ciała poruszyły się słabo .	poruszyły	2	Plur
Kompromitowali nie tylko siebie , ale i Polskę .	Kompromitowali	0	Plur
Ogień rozprzestrzeniał się bardzo szybko .	rozprzestrzeniał	1	Sing
Razem medytowali , jedli to samo , oglądali to samo .	medytowali	1	Plur
Wydaje się to niezwykle mało prawdopodobne .	Wydaje	0	Sing
Aż tu dobiegał potężny głos dziedzica .	dobiegał	2	Sing
Zaczął również przejmować ministerstwa .	Zaczął	0	Sing
- Postanowił em się urżnąć .	Postanowił	1	Sing
Proboszcz uczepił się ostatniego słowa .	uczepił	1	Sing
Kto jeszcze nie przysłał swojego scenariusza ?	przysłał	3	Sing
Począł myśleć gorączkowo .	Począł	0	Sing
Trzymajcie się !	Trzymajcie	0	Plur
Utnij na dwie dulki i schodź , bo palić się strasznie chce .	Utnij	0	Sing
Niech spełnią się wszystkie jej marzenia !	spełnią	1	Plur
Zachichotała do własnych erotycznych skojarzeń .	Zachichotała	0	Sing
Chodził em tak , aż zatrzymał em się przed domem .	Chodził	0	Sing
- Jurek mnie puścił .	puścił	3	Sing
Matka kilkakrotnie dziennie karmi małe .	karmi	3	Sing
Jeńcy wojenni listy piszą . . .	piszą	3	Plur
Ciało , które ginie , jest jedynie opakowaniem dla duszy .	ginie	3	Sing
Siedzimy naprzeciw siebie , pijemy herbatę , jemy piernik domowego wypieku .	Siedzimy	0	Plur
Bywa , że dzieci ulegają nam , podporządkowują się naszej woli .	podporządkowują	7	Plur
No , widzisz , widzisz , sam widzisz . . .	widzisz	4	Sing
Po chwili znaleźli się w podziemiach domu .	znaleźli	2	Plur
Co oni wiedzą o Leninie ? ”	wiedzą	2	Plur
Smętnie kapie deszcz i jest duszno .	kapie	1	Sing
A jemu nie wierzą .	wierzą	3	Plur
Mocno uścisnął em mu rękę , on przedłużył uścisk .	przedłużył	7	Sing
Zeszła już na dalsze miejsca , a jej przyszłość rysuje się niewesoło .	rysuje	9	Sing
Trzeszczą cekaemy i tną powietrze .	Trzeszczą	0	Plur
W Boskiej Rzeczywistości problemy nie istnieją .	istnieją	5	Plur
- Wielu z nich rzeczywiście nawiązuje do debaty w mediach , ale niech ich wiarygodność ocenia prokurator .	ocenia	15	Sing
Musieli śmy się pożegnać .	Musieli	0	Plur
Na przemian straszą i obiecują .	straszą	2	Plur
Władze bały się tam zaglądać , a jedyne prawo wyznaczał pistolet czy karabin .	wyznaczał	9	Sing
Z radością witali również państwa Paleniów sąsiedzi , którzy na tę okazję upiekli specjalny tort .	upiekli	12	Plur
Przerażona dziewczyna pobiegła do ciotki , która mieszka za ścianą , i w sekrecie opowiedziała , co robił jej tata .	pobiegła	2	Sing
Wczoraj dopiął swego , chociaż musiał sporo dołożyć do umówionych wcześniej 300 tysięcy .	dopiął	1	Sing
Siadał em w kącie na kanapce obok Lili i słuchał em , jak Borys śpiewa .	słuchał	9	Sing
Coś zachrzęściło na poduszce , ale poruszył się .	zachrzęściło	1	Sing
Taki stosunek nie może sprzyjać należytemu rozwojowi myśli twórczej wśród pracowników Stoczni , a tym samym przynosi straty państwu .	przynosi	16	Sing
Kościół prostuje mój kręgosłup moralny .	prostuje	1	Sing
– Dziennikarze wmówili sądowi i ludziom , że Róża musi wrócić do biologicznych rodziców .	wmówili	2	Plur
Po piętnastu minutach nadchodzi .	nadchodzi	3	Sing
Wyprowadzają one małe koźlęta na płaty śniegu i uczą je zjeżdżać na racicach .	Wyprowadzają	0	Plur
Minęły dwa lata .	Minęły	0	Plur
Ponadto badania te świadczą , że koncentraty alkoholowe różnych roślin są dobrym środkiem zapobiegawczym przeciw grypie .	świadczą	3	Plur
Przez chwilę jeszcze posłuchajmy , co mówią o Kwaśniewskim jego zwolennicy .	posłuchajmy	3	Plur
Nie poradzili by sobie z tym .	poradzili	1	Plur
Pogłębiły się zmarszczki , sczerniały sińce pod oczami ; był blady i jakby przygarbiony .	Pogłębiły	0	Plur
Winien em je opieczętować .	Winien	0	Sing
Oznacza to , że zgadzają się one na taką praktykę .	zgadzają	4	Plur
Wydawało się , że fiskus nie będzie dłużej gnębił Waldemara Gronowskiego , legnickiego piekarza , który przez ponad 10 lat rozdawał pieczywo najuboższym .	rozdawał	20	Sing
Ja też miewał em pokusy .	miewał	2	Sing
Zaciągam się papierosem i próbuję przypomnieć sobie dawnego Dziedziuszkę .	Zaciągam	0	Sing
Skrzypnęły drzwi i Liść wszedł do środka .	Skrzypnęły	0	Plur
- Zapłacili z góry za dwa tygodnie i powiedzieli , że zostaną prawdopodobnie do końca miesiąca .	Zapłacili	1	Plur
Często jednak dociekliwość pracowników straży powoduje , że za kratki trafiają groźni przestępcy .	trafiają	10	Plur
Kola parsknął śmiechem .	parsknął	1	Sing
Przedtem włóczyli się po mieście , topniał śnieg , szumiało w rynnach , czuć było powiewy ciepła i zgnilizny , nad dachami tłukły się kłębiaste chmury .	tłukły	22	Plur
Jego serce ledwie się ruszało .	ruszało	4	Sing
Rozdają publiczne pieniądze na rzecz Kościoła katolickiego , modlą się żarliwie przed kamerami , marzą o cenzurze obyczajowej .	modlą	8	Plur
Irena odeszła z innym , tak to wyglądało bardzo powierzchownie .	odeszła	1	Sing
Należała do mojego pokolenia , została też przez to pokolenie dobrze przyjęta .	Należała	0	Sing
Na twarzy Marii zgasł uśmiech .	zgasł	3	Sing
Tymczasem nasi reporterzy odnajdują mężczyznę , na którego wezwanie zareagowali nocą policjanci .	zareagowali	9	Plur
– nie dała ci ?	dała	2	Sing
Rozczytywał em się w Słowackim i w myślach nazywał em ją Ellenai .	nazywał	8	Sing
Wytrzymaj , Natalio .	Wytrzymaj	0	Sing
– Jak pan ocenia swoich kolegów ?	ocenia	3	Sing
Rozdali kilofy i łomy .	Rozdali	0	Plur
Przed przyjęciem do pracy sprawdza kierowców , wyrywkowo bada ich też alkomatem .	sprawdza	4	Sing
Tak już chyba na serio nie mówimy , a nasz cyniczny wiek jakąś aurę śmieszności wokół słowa zbudował .	mówimy	6	Plur
Frik bez słowa zatrzasnął drzwi taksówki .	zatrzasnął	3	Sing
Policjanci przywieźli pijanego radiowozem do szpitala .	przywieźli	1	Plur
Inni nie wytrzymywali i popełniali samobójstwo .	wytrzymywali	2	Plur
On należał do tych chłopaków , którym się udało , którzy na przemianie zyskali .	zyskali	13	Plur
Stało się .	Stało	0	Sing
Elżbieta rozstaje się z mężem , zabiera synka i ze Śląska przenosi się do Tarnowa .	przenosi	11	Sing
Nazwał je żyłami bez mięśni .	Nazwał	0	Sing
Błędek może domyślał się tego niedoszłego dalszego ciągu .	domyślał	2	Sing
Stare by może uciekły , ale małe dorosły i zostały .	zostały	9	Plur
Giną więc wozy , których właściciele nie ubezpieczają ze względu na wysokie stawki .	ubezpieczają	7	Plur
Zajęły one terytoria w sąsiedztwie swych matek .	Zajęły	0	Plur
Przebywa tam nadal .	Przebywa	0	Sing
Machała m mu fartuchem , żeby lądował na łące pod lasem , ale ten chłopak chyba się przestraszył , że zawadzi o druty .	zawadzi	20	Sing
Coś poruszyło się z tyłu , za ramieniem dziesiętnika .	poruszyło	1	Sing
Z rodziną bawili się w ciuciubabkę .	bawili	2	Plur
Tylko w minioną sobotę w atakach terrorystycznych w Bagdadzie zginęło ponad 40 osób .	zginęło	9	Sing
Na scenie bez przerwy prezentowały się zespoły młodzieżowe z Reska , Szczecina , Polic i Wolina .	prezentowały	4	Plur
Stali wśród namiotów , w których krzątali się nadwołżańscy Niemcy , zruszczeni po wiekach .	Stali	0	Plur
On mnie poznał z Jankiem Pospieszalskim .	poznał	2	Sing
- Ale wybieramy .	wybieramy	2	Plur
- Na razie nie planujemy kolejnych dzieci .	planujemy	4	Plur
Mimo że Amerykanie uznali operację za udaną , z rejonu walk zdołało wymknąć się wielu partyzantów .	zdołało	11	Sing
W wspomnianych zestawach nie figurują te nazwiska .	figurują	4	Plur
Czy ekonomiści liczą , że Balcerowicz będzie korzystał z ich rad ?	liczą	2	Plur
Na zakończenie uroczystości głos zabrał sam ks . kardynał Sodano , który na początku niemal czystą polszczyzną przywitał przybyłych gości oraz wyraził swoje zadowolenie z pobytu we Wrocławiu .	przywitał	17	Sing
Wezwali Marcina .	Wezwali	0	Plur
Zrozumiał em wszystko .	Zrozumiał	0	Sing
Powiedz , czego chcesz ode mnie , młodzieńcze ?	chcesz	3	Sing
Tylko wówczas widzimy , że Orfeusz zawiódł .	zawiódł	6	Sing
– Ile pan zarabia ?	zarabia	3	Sing
Mana wypiła łapczywie kilka łyków .	wypiła	1	Sing
Mimo ciepłego dnia pani domu przyjęła ją otulona w brązowy blezer , spod ciemnej spódnicy wystawały chude łydki .	wystawały	15	Plur
Który nie dostarczył zboża na przemiał , będzie odpowiadał .	dostarczył	2	Sing
Straty generalnej nikt nie podlicza .	podlicza	4	Sing
Nie psuj im humorów .	psuj	1	Sing
Że coś wymyśli i zorganizuje .	wymyśli	2	Sing
Romansuje z sekretarką ?	Romansuje	0	Sing
Kiedy go wciśniemy , wycisza wszystkie dźwięki .	wciśniemy	2	Plur
Mieszkał z ojcem i nie chciał , żeby ktoś wiedział , że płaci takie duże rachunki .	płaci	12	Sing
Dziewczyna po raz kolejny nie stawiła się na rozprawę , choć osobiście odebrała wezwanie .	odebrała	12	Sing
Rozmawiam , dyscyplinuję .	dyscyplinuję	2	Sing
Za naszym domem też tęsknił , pisał , że nie może zapomnieć Wigilii przy kolędach na Wzgórzu .	tęsknił	4	Sing
Robią to dziewiarze na dziewiarskich maszynach .	Robią	0	Plur
Parowozy zawsze fascynowały i przerażały .	fascynowały	2	Plur
Nie lubiły tylko pijaków , szczekały , kiedy opierali się o płot .	szczekały	5	Plur
Szef czeczeńskiej delegacji Usman Imajew , zanim zachorował , powiedział dziennikarzom , że obie strony osiągnęły już porozumienie .	osiągnęły	15	Plur
Zaraz spróbuję lepiej wyjaśnić , co mam na myśli .	spróbuję	1	Sing
Późny , głęboki zmierzch na przedmieściu , przez które biegnie do apteki żona umierającego .	biegnie	9	Sing
Milion konsumentów nieprzestrzegających zasad koszerności dokonało przełomu na rynku spożywczym .	dokonało	5	Sing
Bandyci odjeżdżają .	odjeżdżają	1	Plur
Okulary od siebie z pokoju przynosi , druty za uszy zawija .	przynosi	5	Sing
Na kostce drżało całe ciało zawodników .	drżało	2	Sing
Ogień szedł przed Tobą i pożerał nieprzyjaciół .	pożerał	5	Sing
W swoim dawnym kształcie kapelusz nie ostał się .	ostał	6	Sing
Lekarze opatrzyli stłuczenia , zwichnięcia i złamania u 14 pacjentów .	opatrzyli	1	Plur
- Czy uważa pan , że po to , by utrzymać trzeźwość , alkoholik potrzebuje AA do końca życia ?	potrzebuje	14	Sing
Teraz ma roczek i czasem bawimy sie w cienie na ścianie .	bawimy	5	Plur
One mi nie dają poczucia trwania i bezpieczeństwa .	dają	3	Plur
Wrócił po chwili , wycierał starannie dłonie ręcznikiem .	Wrócił	0	Sing
Co jakiś czas wydawało mi się , że teraz już mogę coś wydrukować albo że już mi wolno wyjechać .	wydawało	3	Sing
Nie odcinam się od przeszłości .	odcinam	1	Sing
Przyjechali też strażacy z OSP z Poronina , Suchego i Kościeliska .	Przyjechali	0	Plur
Lech Kaczyński w czasie kampanii wspiął się na szczyty .	wspiął	5	Sing
- Przejdzie , nie warto się przejmować .	Przejdzie	1	Sing
Gdy Cahirowi czupryna nieco mocniej przyschnie do czerepu , powędrujemy ku Toussaint .	powędrujemy	9	Plur
Podrożały stanowiska .	Podrożały	0	Plur
Cztery kowane wozy pojechały za siostrami .	pojechały	3	Plur
Obowiązują wizy , odprawa paszportowa , a przy wyjeździe celnik gruntownie przeszukuje rzeczy w poszukiwaniu skarbów , których tak wiele stąd ukradziono .	Obowiązują	0	Plur
- Nie przesadzaj z tym zaufaniem .	przesadzaj	2	Sing
Kilka dni temu ktoś załatwił się pod ich oknem .	załatwił	4	Sing
— Odpocznie od tego nieszczęścia .	Odpocznie	1	Sing
Przepraszam , nawet po pouczeniu pana marszałka zacznę od kilku zdań wstępu .	zacznę	7	Sing
Ostatnio dwie sprawy trafiły do sądu .	trafiły	3	Plur
Dostał oklaski od zebranych , ale odpowiedzi oficjalnej nie otrzymał .	Dostał	0	Sing
Widzieli Kamienną po raz pierwszy .	Widzieli	0	Plur
Tańczą na środku pokoju .	Tańczą	0	Plur
Obdarował pan ojciec klasztor , obdarował !	obdarował	5	Sing
Koniecznie zadzwoń i przeproś za zwłokę .	zadzwoń	1	Sing
Rozdzieram kopertę .	Rozdzieram	0	Sing
Moje koty ostrzą na nich pazury nawet po kilka razy dziennie .	ostrzą	2	Plur
Poczuła swą kobiecość i było z tym cudownie .	Poczuła	0	Sing
Nazwał to nawet stalinizmem XXI wieku .	Nazwał	0	Sing
Jednak już wkrótce Nizioł i Wapiński ze zdumieniem odkryli , że Łapiński nie dotrzymuje wcześniej danego słowa .	odkryli	8	Plur
Wybiła trzecia .	Wybiła	0	Sing
– obraziła ś się .	obraziła	1	Sing
Ponieważ skóra w tym miejscu wiotczeje najszybciej , zacznij używać kremu pod oczy , który działa trochę silniej .	wiotczeje	5	Sing
W pewnym momencie Józef Z . stwierdził , że pójdzie się zdrzemnąć .	stwierdził	6	Sing
Nawet załatwił em już sobie jedną , ale się nie odważył em .	załatwił	1	Sing
- Nie dzwonił eś .	dzwonił	2	Sing
Już naprawdę ręce przy Tobie opadają .	opadają	5	Plur
Przyjadą goście z miasta .	Przyjadą	0	Plur
- Sama zatelefonuję .	zatelefonuję	2	Sing
Mijając miejsce , w którym zginął Młody , wzdrygnęła się i odwróciła wzrok .	odwróciła	11	Sing
– Policzysz , jak zechcesz .	zechcesz	4	Sing
Władze bały się tam zaglądać , a jedyne prawo wyznaczał pistolet czy karabin .	bały	1	Plur
Partyjni stratedzy planują więc przedsięwzięcia z myślą o wyborach dalszych , tych pojutrze .	planują	2	Plur
– Czy ktoś z państwa też prowadził siedemnastkę ?	prowadził	6	Sing
Frajer odjedzie .	odjedzie	1	Sing
Obaj milczymy .	milczymy	1	Plur
W rozdrażnieniu Pierre chwycił go silnie zębami .	chwycił	3	Sing
Państwo nie zarobi .	zarobi	2	Sing
Bolko nie posiadał się z radości .	posiadał	2	Sing
- Ale ty w Boga nie wierzysz .	wierzysz	6	Sing
Po przykrych porażkach przychodziły miłe niespodzianki .	przychodziły	3	Plur
Jakoś się pogodzimy .	pogodzimy	2	Plur
Mocne łuki brwi jakby nastroszyły się .	nastroszyły	4	Plur
Igor Kantorowski zajmował się również krytyką literacką .	zajmował	2	Sing
Mimo to naukowcy zalecają ostrożność w rozpowszechnianiu komórek wśród dzieci i młodzieży .	zalecają	3	Plur
– nie mogę .	mogę	2	Sing
Karol nie chce tego pawlacza rozdwoić ?	chce	2	Sing
Andrzej Michaluk wybiegł na dach z kocem .	wybiegł	2	Sing
- Przymierzymy jeszcze !	Przymierzymy	1	Plur
Paliła swoje mentolowe , wydmuchiwała dym , jakby mnie odpychała .	Paliła	0	Sing
Z radia dobiegały ostatnie tony walca Brahmsa .	dobiegały	2	Plur
Zaczęło się od tego , że kupili śmy koledze na urodziny tarczę i sami zaczęli śmy grać .	kupili	6	Plur
Olszyna , o której wspomniał on przed chwilą , była już niedaleko .	wspomniał	4	Sing
Ale kiedy wymagało by to przekroczenia granic prawa , Bill powstrzymał się z pomocą .	powstrzymał	10	Sing
Zatrzymali śmy się także na jeden dzień w Bourges , a stamtąd pojechali śmy już do Niemiec .	Zatrzymali	0	Plur
– czyli rozpraszasz ?	rozpraszasz	2	Sing
Patrzy , a tu we włosach łonowych roi się od weszek .	roi	7	Sing
Jerzy ogląda klucz .	ogląda	1	Sing
I od początku szedł numer , potem znowu ktoś trącił . . .	trącił	9	Sing
Oni w domu mają klimę i nie wietrzą się tak jak my .	wietrzą	7	Plur
Czarna suka posapuje .	posapuje	2	Sing
Mężczyzna upadł .	upadł	1	Sing
Pracował z trudem , mozolił się nad każdym słowem .	Pracował	0	Sing
Antyterroryści spuścili się po linach ze śmigłowca wprost pod drzwi gangstera .	spuścili	1	Plur
Solenizantki złożyły życzenia sąsiadującym z nimi w kalendarzu Ernestom i Bożenom .	złożyły	1	Plur
Widownia westchnęła ze współczuciem , a Iwana to uskrzydliło .	westchnęła	1	Sing
Policjanci jedynie pouczyli kierowcę i sporządzili notatkę służbową .	pouczyli	2	Plur
Zubożała również ludność okolicznych wsi .	Zubożała	0	Sing
Najpierw myślał em , że mówi do mnie .	myślał	1	Sing
Pewną aktywność przejawiają tylko mieszkańcy domów sąsiadujących ze świątynią .	przejawiają	2	Plur
Odsuwa miskę po chwili .	Odsuwa	0	Sing
Lekarze zdecydowali się na operację , ale brakowało dawcy .	zdecydowali	1	Plur
- Dobrze , zostawmy to .	zostawmy	3	Plur
Otworzyła oczy i uśmiechnęła się .	uśmiechnęła	3	Sing
Zaczyna padać .	Zaczyna	0	Sing
Wznawiam posiedzenie .	Wznawiam	0	Sing
Na poboczu ustawiły sobie nawet specjalne siedzisko .	ustawiły	2	Plur
Możecie iść do domu .	Możecie	0	Plur
Z wnioskiem takim wystąpił naczelnik OSP Arkadiusz Pindral .	wystąpił	3	Sing
Dziś znów ubecja krąży po osiedlu .	krąży	3	Sing
Dziewczyna wysupłała zza dekoltu banknoty dziesięciomarkowe .	wysupłała	1	Sing
Wirują mu musztardowe księżyce i słońca , a na samym dole żagla zjawia się łeb wieloryba o mikroskopijnych , czerwonych oczach .	Wirują	0	Plur
Wszyscy znamy historię Abrahama i Izaaka .	znamy	1	Plur
Dokonują wstrząsającej ekspertyzy zniszczeń .	Dokonują	0	Plur
Chmury rozsunęły się na moment , odsłaniając wytarty miedziak słońca .	rozsunęły	1	Plur
Dodatkowe połączenia D dopełniają charakter układu .	dopełniają	3	Plur
Jeżeli nie masz , tobyś na pewno ukrywał , gdybyś miał .	ukrywał	7	Sing
Tu obserwatorzy uroczystej chwili padli ofiarami drobnej mistyfikacji .	padli	4	Plur
Słuchaj , Piotr był zalany , spadał ze schodów , wyskakiwał z okna .	Słuchaj	0	Sing
Batura przygryzł wargi .	przygryzł	1	Sing
Często chodzili do pubu , pili piwo , rozmawiali .	rozmawiali	8	Plur
Chodzi o to , żeby demonstracje odbywały się w spokoju , żeby w minimalnym stopniu zakłócały życie innych ludzi i żeby nie było polską normą bicie policjantów , okupowanie budynków , wyrywanie znaków drogowych czy niszczenie samochodów .	zakłócały	15	Plur
Odtąd oba oddziały działały wspólnie .	działały	3	Plur
Poznań jest właściwie jedynym większym miastem na terenie naszego kraju , na które spoglądały oczy wielkiego poety .	spoglądały	13	Plur
Znajomość karate pomińmy . . .	pomińmy	2	Plur
Dotyczą one przeszłości .	Dotyczą	0	Plur
- Na tym wyczerpali śmy listę posłów zapisanych do zabrania głosu .	wyczerpali	3	Plur
Dostrzegają je twoje oczy , słyszą je twoje uszy .	Dostrzegają	0	Plur
" Zrobimy " !	Zrobimy	1	Plur
Wypadła ś z gry ?	Wypadła	0	Sing
Prawie wszyscy komentatorzy dowodzą , że Orfeusz nie ponosi winy za utratę Eurydyki .	dowodzą	3	Plur
Teraz umocnią się na rynku .	umocnią	1	Plur
Wylegitymował się pan ?	Wylegitymował	0	Sing
Policjanci już od dwóch tygodni szukali fałszywek .	szukali	5	Plur
Udali śmy się do Kroczewa .	Udali	0	Plur
Deportacje wkrótce przetrzebiły Polaków .	przetrzebiły	2	Plur
Chodzimy dwa razy w tygodniu do kina , do teatru .	Chodzimy	0	Plur
- Nie chcą , bym ich utrzymywał .	utrzymywał	6	Sing
Zastanów się nad tym !	Zastanów	0	Sing
W jego moskiewskim salonie bywała śmietanka przedrewolucyjnej Rosji .	bywała	4	Sing
Jego łupem padały głównie radioodtwarzacze i głośniki .	padały	2	Plur
Zgadzając się co do celu , uważamy , że metoda jego osiągnięcia nie jest dobra .	uważamy	6	Plur
Należy starać się odnaleźć każdego postrzałka .	Należy	0	Sing
Bierzemy pod lupę najbliższych sąsiadów .	Bierzemy	0	Plur
Jadą i kopcą .	Jadą	0	Plur
Wracają i pracują solidnie .	pracują	2	Plur
Na morskiej jednostce mogą być zatrudnione tylko te osoby , które posiadają aktualne świadectwo zdrowia .	posiadają	11	Plur
W niedzielę młodzieńcy rozpalili ognisko na strychu .	rozpalili	3	Plur
Może do nas przyjdą .	przyjdą	3	Plur
A przecież poeta świetnie wiedział , że cud wiosny zdarza się regularnie co roku .	zdarza	9	Sing
Rozbieram się do snu .	Rozbieram	0	Sing
Raport podkreśla , że w wielu krajach najpoważniejszym problemem jest wysokie bezrobocie .	podkreśla	1	Sing
Turska przyznała , że jest przerażona , bo nie wyklucza , że nastolatka mogła zarazić inne osoby .	wyklucza	9	Sing
Kia sephia , którą kierował 67-letni Henryk M . , nie zatrzymała się przed przejściem i potrąciła staruszkę .	zatrzymała	11	Sing
Jeśli jest , jak przypuszczam , Niemcy mocno się rozczarują .	przypuszczam	4	Sing
Ciotka nie przysyłała dolarów , ciotka brodatego syna Cybucha rozwijała świadomość .	rozwijała	9	Sing
– Bo chyba pana Macierewicza trzymają się żarty .	trzymają	5	Plur
Młodzi zamieszkali na ul. Chrobrcgo .	zamieszkali	1	Plur
– Rzucili się na pana ?	Rzucili	1	Plur
Kiedy mówi się o cudach w Lourdes , kiedy ktoś dostąpił cudownego uzdrowienia , Kościół prosi lekarzy , aby wypowiedzieli się na ten temat .	wypowiedzieli	19	Plur
Uzywa Pan terminów , których pan nie zdefiniował .	zdefiniował	7	Sing
Powstrzymało go pytanie .	Powstrzymało	0	Sing
Weźmy na przykład pomnik w centrum wsi .	Weźmy	0	Plur
Widzicie , lyrijski orzeł czarny i rivskie rauty czerwone .	Widzicie	0	Plur
Inspirował się także muzyką klasyczną i rockiem .	Inspirował	0	Sing
Używaj zawsze tych samych słów i określeń .	Używaj	0	Sing
Poruszyły się wskaźniki na podświetlanych zegarach .	Poruszyły	0	Plur
Parafowanie umowy nie poprawiło szans wyborczych AWS , ale sprawa ta dalej jest wykorzystywana do celów politycznych .	poprawiło	3	Sing
– Twój czas minął .	minął	3	Sing
Miasto Detroit do tej pory płonie , a wyjątkowo upalna pogoda sprzyja rozszerzaniu się pożarów .	płonie	5	Sing
Mówią , że kobieta wcale nie była w ciąży .	Mówią	0	Plur
Czy malował je kiedyś dla sprawdzenia samego siebie ?	malował	1	Sing
Używają go specsłużby w ponad 40 krajach .	Używają	0	Plur
Sex Pistols gramy od paru ładnych lat na specjalne okazje .	gramy	2	Plur
Mocno uścisnął em mu rękę , on przedłużył uścisk .	uścisnął	1	Sing
- Nie zajmujemy się leczeniem , ale poprawiamy społeczne funkcjonowanie .	poprawiamy	7	Plur
Śpią w noclegowni koło lokomotyw .	Śpią	0	Plur
Wszyscy się roześmieli .	roześmieli	2	Plur
Dlatego skończył polonistykę i dziennikarstwo .	skończył	1	Sing
- Pytał em też Mędrców , ale pokiwali tylko głowami i orzekli , że ich komputery nie są w stanie tej zagadki rozwikłać .	Pytał	1	Sing
Przyniósł mu kiedyś steward nieświeży kotlet .	Przyniósł	0	Sing
Tak zabawili się trzej tarnobrzescy gimnazjaliści .	zabawili	1	Plur
Pracowicie wyodrębnił pojęcia takie jak ból , smutek , rozpacz , cierpienie , żal .	wyodrębnił	1	Sing
Steve zaklina się , że po każdym dyżurze szykuje ekstra posiłek czworonożnemu ratownikowi .	zaklina	1	Sing
Oczy powlekła biaława szklistość , co wzmogło tajemnicę spojrzenia .	powlekła	1	Sing
Nieuchronne podziały pogłębił niski poziom politycznych dyskusji .	pogłębił	2	Sing
Lamentują , jakby śpiewali .	śpiewali	3	Plur
Ułatwi ona włączenie się do ruchu jadącym z Koziegłów do Poznania .	Ułatwi	0	Sing
Spod czerni i płomieni zaczynały już wyglądać żółtawe żebra trupa .	zaczynały	4	Plur
Musi w jakikolwiek sposób dowieść swej wiarygodności .	Musi	0	Sing
Wchodzimy w wiraż , coraz bardziej zbliżając się do sklepienia kanału , które naraz przybiera jaskrawoniebieski kolor z domieszką fosforyzującego fioletu .	Wchodzimy	0	Plur
Uczą się i pomagają innym .	pomagają	3	Plur
Swojego domku obitego papą Wanda Kędzierska trochę się wstydzi .	wstydzi	8	Sing
To po to zafundowali ci laptopa ?	zafundowali	3	Plur
Poruszył em się na łóżku , które odpowiedziało sprężyście .	odpowiedziało	7	Sing
Znów pomógł mu aspirant .	pomógł	1	Sing
I o to się rozchodzi !	rozchodzi	4	Sing
Majowe weekendy zapowiadają się naprawdę ładnie !	zapowiadają	2	Plur
Obie spółki ustaliły identyczne ceny .	ustaliły	2	Plur
- Stadion opanowali Chińczycy .	opanowali	2	Plur
- Błagała mnie o łaskę .	Błagała	1	Sing
Wchodzimy do starej kamienicy .	Wchodzimy	0	Plur
– którą też przeczytała m całą .	przeczytała	3	Sing
Szafę zamykamy na klucz i obiecujemy sobie otworzyć ją dopiero po egzaminach .	zamykamy	1	Plur
W październiku podczas pierwszych tegorocznych mrozów zamarzły cztery osoby .	zamarzły	6	Plur
My takiej nie prowadzimy , nie wykonujemy zadań publicznych dla zysku , ale dla dobra mieszkańców .	prowadzimy	3	Plur
Prosze ułożyć mi coś , żeby ludzie zębami zgrzytali , włosy darli , płakali , ale i równocześnie wroga szukali . . .	płakali	13	Plur
Najwięcej pochłoną inwestycje w oświacie , drogowe , wodociągowe i proekologiczne .	pochłoną	1	Plur
Do przyczyn nawet nie sięgną !	sięgną	4	Plur
- Czekają .	Czekają	1	Plur
Jak długo Szczuka zabawi w Ostrowcu ?	zabawi	3	Sing
Uśmiechnęła się tylko do siebie .	Uśmiechnęła	0	Sing
Do spa udają się osoby świadome , dla których dbanie o siebie to przyjemność .	udają	2	Plur
Wybiegł em .	Wybiegł	0	Sing
Jeśli pogoda dopisze , będziemy wykonywać te prace bez przerwy .	dopisze	2	Sing
Następnie podgrzewamy i przesączamy przez gęste sito .	przesączamy	3	Plur
Na atramentowej powierzchni wody chybotał się samotny biały żagiel .	chybotał	4	Sing
- Zatrzymaj się , bo strzelę !	strzelę	5	Sing
obudzili śmy . .	obudzili	0	Plur
– Słuchaj , do których drutów w telefonie podłączył eś magnetofon ?	podłączył	8	Sing
– Przypomina . . .	Przypomina	1	Sing
- Pójdziesz za to siedzieć , wiesz ?	Pójdziesz	1	Sing
- Każdy twórca marzy chyba , żeby odnieść wielki sukces .	marzy	3	Sing
Wracamy do szosy i jedziemy w stronę sąsiedniego Falsztyna .	jedziemy	4	Plur
– Wojtek wszystko zawsze wie najlepiej . .	wie	4	Sing
Projekt zakończył się uroczystym śniadaniem wielkanocnym .	zakończył	1	Sing
Komisja przekształciła się w rodzaj seminarium , gdzie bibliotekarki pogłębiały swą wiedzę o dziecku i książce .	pogłębiały	9	Plur
De Berle wątpił .	wątpił	2	Sing
Naprawdę rzadko się zdarza w województwie , że w jakiejś dziedzinie sięgamy po pierwsze miejsca .	sięgamy	11	Plur
Układali śmy stóg .	Układali	0	Plur
Obie też towarzyszyły swoim synom na uroczystości wręczenia stypendiów w Pałacu Prezydenckim .	towarzyszyły	2	Plur
Wypraszam sobie takie porównania .	Wypraszam	0	Sing
Serca dzieci wyrastają nad rzekę .	wyrastają	2	Plur
Nie dała by sobie rady .	dała	1	Sing
Występujesz gdzieś teraz ?	Występujesz	0	Sing
Grożą za to wysokie kary i areszt .	Grożą	0	Plur
Ale konia i wóz oddasz ?	oddasz	4	Sing
Jednak nawet wtedy eksperci zgodnie twierdzili , że boom internetowy kiedyś wróci .	twierdzili	5	Plur
Gdy nikt nie reagował na dzwonek , włączyli syrenę .	włączyli	7	Plur
- Analfabetyzmowi wydali śmy zdecydowaną walkę , spodziewamy się niebawem zlikwidować go całkowicie .	spodziewamy	7	Plur
- Z syna zrobili bandziora .	zrobili	3	Plur
Gramoli się wolno poprzez gałęzie olch .	Gramoli	0	Sing
Zatoczył wesoło ręką i rozejrzał się po pokoju .	Zatoczył	0	Sing
Sowy się kłócą .	kłócą	2	Plur
Profesor Knapczak skończył wreszcie przemówienie .	skończył	2	Sing
Szczególne podziękowania kierujemy do rodziców naszych wychowanków .	kierujemy	2	Plur
- Przyjeżdżają i od progu mówią , że cały obszar kupują .	Przyjeżdżają	1	Plur
Żółty krawat tylko mu fruwa na wietrze , kurtka rozpięta .	fruwa	4	Sing
Policja odwozi ją na komisariat .	odwozi	1	Sing
Nie składają donosów do prokuratury , nie przejmują się całodobowym uśmiercaniem poczętych ?	przejmują	7	Plur
Ostre cięcia grożą też prezesom państwowych spółek .	grożą	2	Plur
Silny Sojusz na pewno będzie skrupulatnie punktował potknięcia koalicjantów .	punktował	6	Sing
W Małej Komorzy z tego powodu zapaliły się sadze .	zapaliły	6	Plur
Najciekawiej zapowiada się w Moskwie , gdzie miejscowy Spartak podejmuje Ajax Amsterdam .	zapowiada	1	Sing
Na wczasy jeżdżą osoby nietrendowe .	jeżdżą	2	Plur
- Czy różnice interesów w koalicji nie przeszkodzą w kontynuowaniu reform ?	przeszkodzą	7	Plur
Rozłożył dłonie .	Rozłożył	0	Sing
- Mogło by się tak komuś wydawać .	Mogło	1	Sing
Bogu zawierzam i w Bogu pokładam nadzieję .	pokładam	5	Sing
- Zabraniam ci !	Zabraniam	1	Sing
Chrześcijaństwo nakazuje miłość bliźniego .	nakazuje	1	Sing
Popędzali swoje konie , bo koniecznie chcieli dopaść upatrzonej zwierzyny .	Popędzali	0	Plur
– Zachowywał em się spokojnie .	Zachowywał	1	Sing
Rada Nadzorcza towarzystwa na wczorajszym posiedzeniu pominęła sprawy personalne .	pominęła	6	Sing
Zbliżył się do nas , wydawał się zakłopotany .	Zbliżył	0	Sing
Pseudokibicom ze Stalowej Woli upiekło się , choć nieźle w sobotę nabroili .	nabroili	11	Plur
Nigdy tego nie jadła m !	jadła	3	Sing
W wielu miastach widzieli śmy gigantyczne kolejki .	widzieli	3	Plur
Tym razem atrakcyjność potyczki podniesie fakt , że Hoop i Zepter reprezentują mocno zmienione oblicza .	reprezentują	11	Plur
Za chwilę zjawią się kapłanki , a ja , jako bezbożnica , zostanę zelżona i wyrzucona stąd na zbity pysk .	zjawią	2	Plur
– wiesz co ?	wiesz	1	Sing
Truchtali spokojnie , bez pośpiechu , z przodu dostrzegli sylwetkę w zielonym mundurze , zbliżyli się powoli .	dostrzegli	8	Plur
Zapisał to wszystko po niemiecku i przeczytał mi na głos .	przeczytał	6	Sing
Nie pamiętam " .	pamiętam	1	Sing
Urodę stołu znakomicie podniosą antyczne lichtarze ze świecami , kryształy i srebra .	podniosą	3	Plur
Na koniec zacieramy ślady .	zacieramy	2	Plur
Rannymi cywilami zaopiekowali się najpierw amerykańscy sanitariusze z personelu naziemnego .	zaopiekowali	2	Plur
W sobotę gmach sądu w Bielsku-Białej przypominał twierdzę .	przypominał	6	Sing
Oprócz słuchania Steczkowskiej delegaci zajmowali się dyskusją o strajku generalnym .	zajmowali	4	Plur
Obie części składamy podszewką do środka , zszywamy po brzegach , obszywamy lamówką .	obszywamy	11	Plur
Siedzę dziś cały dzień w domu i obiad jemy w domu .	jemy	8	Plur
Większość nie stosowała się do obowiązujących zakazów zatrzymywania i postoju .	stosowała	2	Sing
Naprawdę rzadko się zdarza w województwie , że w jakiejś dziedzinie sięgamy po pierwsze miejsca .	zdarza	3	Sing
Uciszała nas kelnerka .	Uciszała	0	Sing
W Londynie również zaciekle występowały przeciwko nim europejskie feministki .	występowały	4	Plur
Nazywa się Golan Drozdeck .	Nazywa	0	Sing
Bywa jednak , że ja pytam , aby przedłużyć jej obecność .	Bywa	0	Sing
JAJKO SIĘ NIE TŁUCZE !	TŁUCZE	3	Sing
Uruchomił trzy gaśnice proszkowe i hydrant .	Uruchomił	0	Sing
- Legnij !	Legnij	1	Sing
Do tego dochodzą rachunki za telefon , wydatki na materiały piśmienne , na znaczki .	dochodzą	2	Plur
Beacie towarzyszył mój starszy kuzyn , inżynier Wacław Straszyński .	towarzyszył	1	Sing
Zapomnij też o wszelkich środkach uśmierzających ból .	Zapomnij	0	Sing
Jego oczy przestraszone , rozbiegane cofnęły się jeszcze bardziej .	cofnęły	5	Plur
Okno było otwarte , ogród szarzał pod niebem bez barwy .	szarzał	5	Sing
Oni uczestniczyli w tym spektaklu .	uczestniczyli	1	Plur
Nie wierzycie im ?	wierzycie	1	Plur
Zaraz skonam z głodu .	skonam	1	Sing
- Pogadamy sobie jeszcze i odprowadzę ją do drzwi hotelu .	odprowadzę	5	Sing
Rozpaczliwie jęczał .	jęczał	1	Sing
A więc chroniła i tuliła .	chroniła	2	Sing
moja mama strasznie chlała i paliła marihuanę .	chlała	3	Sing
- Dali śmy Kwaśniewskiemu szansę , bo mówił dużo o prostych ludziach .	Dali	1	Plur
Idąc czuł , że wzbudza ciekawość , ludzie stawali , patrzyli za nim .	patrzyli	10	Plur
- Zbiórkę poprzedziła akcja informacyjna , uczniowie wiedzą , na jaki dobry cel popłyną pieniądze .	wiedzą	7	Plur
Daje on młodym ludziom szansę wykazania się umiejętnościami organizatorskimi .	Daje	0	Sing
Trzy strzały trafiły przebywających w wartowni żołnierzy .	trafiły	2	Plur
Zgodnie z oczekiwaniami po złoto sięgnęły ekipy gospodarzy .	sięgnęły	5	Plur
Położenie geopolityczne i ropa sprawiają , że tu krzyżują się interesy wielu państw , w tym Rosji , USA i Turcji .	sprawiają	4	Plur
O czym Pan pisze ?	pisze	3	Sing
Podobnie zachowała się burżuazja niemiecka .	zachowała	1	Sing
- Naszym kolegom wciąż się zdaje , że wygrali . . .	zdaje	5	Sing
Wszyscy klaskali .	klaskali	1	Plur
spytasz się Wojtka w piątek ?	spytasz	0	Sing
Mokra dłoń sunie ślisko po szkle .	sunie	2	Sing
– Korepetycje jej dajesz ?	dajesz	3	Sing
Zadziwił mnie Jarosław Kaczyński .	Zadziwił	0	Sing
Uważają , że to obowiązek państwa .	Uważają	0	Plur
Sprawą zainteresował się referat I-szy i przez kontrolę korespondencji może uzyskamy dalsze miejsca zachowanych rzeczy .	uzyskamy	10	Plur
Opadły mi ręce . . .	Opadły	0	Plur
Wszyscy się pocą .	pocą	2	Plur
– ja sobie to wyobraziła m inaczej .	wyobraziła	4	Sing
Spojrzałem na kobietę i stwierdziłem , że po raz pierwszy jej twarz zasługiwała na uwagę .	zasługiwała	12	Sing
W takie wieczory milkły rozmowy .	milkły	3	Plur
Przede wszystkim wywozili ruchomy majątek i żywność .	wywozili	2	Plur
W dzień , gdy próbował ją pocałować w usta , odsunęła się .	próbował	4	Sing
Artyści z trzech akademii sztuk pięknych oglądali wczoraj budynki przy ulicy Zamkowej .	oglądali	6	Plur
- Bo się pierdolą .	pierdolą	3	Plur
Wymknął się za kotarę z dzbankiem po wodę .	Wymknął	0	Sing
Niech płaszczą się przed groźnym wieprzem !	płaszczą	1	Plur
Uniwersytety przyjęły w ostatnim czasie ogromną liczbę studentów .	przyjęły	1	Plur
Skoro przez kilka lat podążałeś w kierunku przeciwnym do swego domu , nie zdziw się , że dzisiaj znajdujesz się w odległości kilkuset mil od niego .	znajdujesz	18	Sing
Co znów wyrwało z kręgu tej kultury wielu intelektualistów .	wyrwało	2	Sing
Straszny ziąb w nawie , nawet anioł ze środkowego pilastru wydaje się drżeć z chłodu .	wydaje	10	Sing
Popierają regionalne środowiska twórcze .	Popierają	0	Plur
Odwołany rząd , który zostaje przez Sejm zmuszony do rządzenia , zwykle przestaje pracować .	przestaje	12	Sing
Może ekolodzy zainteresowali by się tą sprawą .	zainteresowali	2	Plur
Proszą też o wszelkie informacje , które mogłyby pomóc w odnalezieniu sprawcy .	Proszą	0	Plur
Splątała się jawa ze snem .	Splątała	0	Sing
Dzięki poradnikowi dowiadujemy się , że roczną deklarację oznaczają cyfry 01 .	oznaczają	8	Plur
Komory zadziałały , ale organizm był już zbyt wycieńczony .	zadziałały	1	Plur
We wtorek ci sami uczestnicy licytacji zaproponowali 1.500 zł .	zaproponowali	6	Plur
Gdy Cahirowi czupryna nieco mocniej przyschnie do czerepu , powędrujemy ku Toussaint .	przyschnie	5	Sing
Policjanci z Inspektoratu Komendy Głównej ustalili wstępnie , że zachowanie policyjnej eskorty było nieprawidłowe .	ustalili	5	Plur
– Chce pani powiedzieć , że Pająkowski by sprawdził ?	sprawdził	8	Sing
Ciężko poranili kilkunastu policjantów .	poranili	1	Plur
Tu się podkradli .	podkradli	2	Plur
- Pokręciła m głową i spojrzała m na nią z prawdziwym zachwytem .	Pokręciła	1	Sing
Rozłożyli śmy mapę na stoliku .	Rozłożyli	0	Plur
Gdy Dominika przyjechała po matkę , Babel dożywał swych dni .	dożywał	7	Sing
Rodzice Agnieszki nie motywowali jej do nauki .	motywowali	3	Plur
- Chcemy również upowszechnić ten rodzaj sportu wśród osób niepełnosprawnych .	Chcemy	1	Plur
Decyzja zapadła , mimo że szefowie tajnych służb ostrzegli , iż Palestyńczycy wyjdą na ulice .	wyjdą	12	Plur
Surowo zwracam panu na to uwagę w tej chwili .	zwracam	1	Sing
- Nie układa się jej pod rynkowego konkurenta , ale warto wiedzieć , w co on gra .	gra	16	Sing
Takie parlamentarne metody nie odpowiadają mi , rozumiecie ?	rozumiecie	7	Plur
Nie dostawał przepustek .	dostawał	1	Sing
Zmuszają was tam do zachowania ciszy elektronicznej ?	Zmuszają	0	Plur
Przed obecnymi na spotkaniu wystąpili dzisiejsi uczniowie szkoły .	wystąpili	4	Plur
Postrzelili go , ale jakoś dowlókł się do tego krzyża .	Postrzelili	0	Plur
Naczelnik ulicznych rzeźników wykrzywił twarz .	wykrzywił	3	Sing
Ze zdziwieniem spostrzegł , że jego lewa noga stopą dotyka mu twarzy .	dotyka	9	Sing
- Pogaaaniaaaj !	Pogaaaniaaaj	1	Sing
Razem medytowali , jedli to samo , oglądali to samo .	oglądali	7	Plur
Czyżby oni wszyscy ulegli zbiorowej halucynacji , skoro po powrocie z kina mówią , że im się podobało ?	ulegli	3	Plur
Uważają nas za moskalofilów , takich zaprzańców antyukraińskich , podczas gdy sami deklarują ukraiński patriotyzm .	deklarują	12	Plur
Wykąpiemy się na golasa .	Wykąpiemy	0	Plur
Lekcja kończy się rozczarowaniem , ale mistrz wydaje się daleki od rezygnacji .	kończy	1	Sing
Po spełnieniu toastu świeżo upieczeni małżonkowie rzucają za siebie kieliszki .	rzucają	6	Plur
Chociaż faktem jest , że Hubal okropnie przeżył te zdarzenia .	przeżył	7	Sing
Spojrzał nawet porozumiewawczo na babuszkę .	Spojrzał	0	Sing
- Przyrzeknę . . . ?	Przyrzeknę	1	Sing
Aj , czyżby się porozumieli ? !	porozumieli	4	Plur
A potem dwupłatowiec wniknął w nasz bombowiec niczym duch .	wniknął	3	Sing
Techniki układali w zamknięty występ .	układali	1	Plur
Trzy strzały trafiły przebywających w wartowni żołnierzy .	trafiły	2	Plur
Ubrała m się i zeszła m na dół .	zeszła	4	Sing
Rozdzielali zwaśnione strony w ramach misji pokojowych ONZ .	Rozdzielali	0	Plur
CZY UMIESZ CELEBROWAĆ SUKCESY ?	UMIESZ	1	Sing
Może narażę się na krytykę ze strony pana premiera Pawlaka , ale wciąż zbyt wielkie znaczenie przywiązujemy do umów międzyrządowych .	przywiązujemy	16	Plur
Jeszcze po południu zawieszony prezes największego polskiego ubezpieczyciela nie wiedział , czy członkowie rady podejmą jakieś decyzje w jego sprawie .	podejmą	14	Plur
Poza tym zawsze proponuję lewicy , by odeszła od ideologicznej walki z prawicą i przeszła na spory o gospodarkę .	odeszła	7	Sing
Radujmy się z nimi , bo żyją !	Radujmy	0	Plur
Pistol poprawiał krawat , a Fanga wręczał kluczyki .	wręczał	6	Sing
– Nie twierdzę , że działamy najlepiej i nie popełniamy błędów .	popełniamy	9	Plur
- Polecisz .	Polecisz	1	Sing
Jak zwykle pedantyczny Andrzej misternie układał fryzurę .	układał	5	Sing
- Niech Pan ześle anioła , by prowadził was w drodze .	ześle	3	Sing
Dlaczego tak go wciągały ?	wciągały	3	Plur
ty próbowała ś to mleko dla dzieci ?	próbowała	1	Sing
Zapytam , jakiej pomocy oczekuje .	oczekuje	4	Sing
Cenimy Pana za honor .	Cenimy	0	Plur
Minęły dwa lata .	Minęły	0	Plur
Ale działy się inne rzeczy .	działy	1	Plur
Poza tym tych delikatnych wzorów nie zalewała minia i lakier .	zalewała	6	Sing
Może nauczysz się wreszcie , jak się takie rzeczy załatwia .	załatwia	9	Sing
Potem odważniej zaatakowali gospodarze .	zaatakowali	2	Plur
- Nie powtarzaj mi tego , bo jeszcze zmienię zdanie .	zmienię	8	Sing
Myślał em , że mi się bom zerwie z talii !	zerwie	7	Sing
Czym latają nasze VIP-y ?	latają	1	Plur
Plecy Dobrskiego zdradzały tak wielkie rozgoryczenie .	zdradzały	2	Plur
Nieco częściej czyniły to kobiety .	czyniły	2	Plur
Tematy prac rodzą się nagle .	rodzą	2	Plur
Niemcy ciągle kontratakują w Normandii .	kontratakują	2	Plur
Zastąpił go ks. Antoni Dunajski .	Zastąpił	0	Sing
Owinięty w zwiewne szaty , zasiadał na schodach świątyń , medytując godzinami .	zasiadał	5	Sing
Uśmiecham się .	Uśmiecham	0	Sing
- Ja im się poddam .	poddam	4	Sing
Wieczorny mrok gęstniał coraz bardziej w drobnym i dokuczliwym deszczu .	gęstniał	2	Sing
Ciągnęła monolog , w którym celnie uwypukliła nieludzkie cechy jego matki .	Ciągnęła	0	Sing
One potrzebują równego traktowania .	potrzebują	1	Plur
Wszystko płynie .	płynie	1	Sing
Z ciał potopionych stryjów wylęgły się tysiące myszy i wyruszyły wszystkie do Kruszwicy , prosto na dwór zbrodniarza .	wyruszyły	9	Plur
Wziął em lodowaty prysznic , po śniadaniu wyłączył em telefony i w ciszy gabinetu nastawił em w pamięci taśmę mojego życia .	nastawił	14	Sing
Rozbiegli się Kaszubi , pod przymusem do tej walki pędzeni .	Rozbiegli	0	Plur
Zmęczeni wysiadali śmy z ciasnej szoferki .	wysiadali	1	Plur
Przybywały tabunami .	Przybywały	0	Plur
Grenlandia nie zniknie .	zniknie	2	Sing
nie widzieli ście się ?	widzieli	1	Plur
Brakowało jakiegoś rysu dawnego Jeffa .	Brakowało	0	Sing
O tej rozmowie zapominamy .	zapominamy	3	Plur
Rozczytywał em się w Słowackim i w myślach nazywał em ją Ellenai .	Rozczytywał	0	Sing
Leki na obniżenie temperatury nie działały , a sytuacja , według słów Havlovej , w nocy z poniedziałku na wtorek stała się krytyczna .	działały	5	Plur
Załogi z niepokojem śledzą ciche chmury nadchodzące z południa .	śledzą	3	Plur
Polacy zdobywali to wzgórze .	zdobywali	1	Plur
Lampa przygasła .	przygasła	1	Sing
Już mnie tu nie zastaną i będą bardzo zdziwieni .	zastaną	4	Plur
Nie łudźmy się , że będziemy pierwsi .	łudźmy	1	Plur
Wtedy ja stanowię publiczność .	stanowię	2	Sing
Prosi się też zakłady pracy , które dysponują autobusami , by wspomogły komunikację zastępczą .	dysponują	7	Plur
Przetarł stół .	Przetarł	0	Sing
Pakistańczycy zarzucają Indiom stosowanie bomb kasetowych i bomb z napalmem .	zarzucają	1	Plur
Zatrzymani wczoraj przestępcy od roku działali na własną rękę .	działali	5	Plur
Jezus przynosi życie .	przynosi	1	Sing
I te bilety uśmierzyły wzburzone umysły golibrody i wynalazcy .	uśmierzyły	3	Plur
Tak właśnie zrobiliśmy , a tych handlarzy , którzy pracowali półlegalnie , przegonili pogranicznicy .	przegonili	12	Plur
Robotnicy tylko wtedy poprą reformę , jeśli będą mieli jakieś zabezpieczenie .	poprą	3	Plur
Grób Pikusia i Miśka rozświetlają znicze .	rozświetlają	4	Plur
Ponieważ na pukanie nikt nie reagował , policjanci wyważyli drzwi .	wyważyli	8	Plur
Funkcjonariusze apelują do mieszkanek Kwidzyna , aby w najbliższym czasie unikały ciemnych miejsc .	unikały	10	Plur
Mogą jednak interweniować , gdy mają dowody przestępczej działalności .	Mogą	0	Plur
Czujesz bluesa ?	Czujesz	0	Sing
Mówimy o wyborach .	Mówimy	0	Plur
Grożąc bonią wepchnęli go do citroena i odjechali .	odjechali	7	Plur
Bogu zawierzam i w Bogu pokładam nadzieję .	zawierzam	1	Sing
Maluchy i starsza młodzież spędzały tam czas po lekcjach , ucząc się i bawiąc .	spędzały	4	Plur
Edek odmówił , nie chciał zostawić Mali .	odmówił	1	Sing
W Boskiej Rzeczywistości problemy nie istnieją .	istnieją	5	Plur
Wraz z kadrą wyjadą Daria Kasperska , Paulina Rytwińska i Agnieszka Karcz .	wyjadą	3	Plur
Z Jackiem Kuroniem współpracowali śmy i nadal współpracujemy .	współpracowali	3	Plur
Systematycznie prowadzili kontrole , zmierzające do ujawnienia różnego rodzaju piractwa .	prowadzili	1	Plur
Komisja przetargowa miasta i Zarządu Dróg Miejskich wybrała najtańszą ofertę .	wybrała	7	Sing
Szef mówił , że Niemcy zebrali tam co najlepsze swoje dywizje , okrutnie umocnili sia , obwarowali i przygotowali do długiej obrony .	umocnili	13	Plur
Przykręca knot i dmucha w płomień lampy .	Przykręca	0	Sing
Orzechowe oczy garncarza wpatrzyły się badawczo w twarz Kaliasa .	wpatrzyły	3	Plur
Przebiegające pod miastem chodniki kopalni zalano wodą , a wzgórze zgniło i zapadło się w ziemię jak przydeptane .	zapadło	12	Sing
Jako nieletni odbył karę w poprawczaku .	odbył	2	Sing
Jedna osoba zginęła , trzy zostały ranne .	zostały	5	Plur
Nie twierdzę , że prowadzimy wojnę promową .	prowadzimy	4	Plur
Oni nie kierowali wydarzeniami , nawet nie próbowali .	kierowali	2	Plur
Sprzeciwili się projektowi ustawy , która pozwoli na przynoszący zysk import odpadów nuklearnych .	Sprzeciwili	0	Plur
Wiele projektował em , sporo podróżował em .	podróżował	5	Sing
Gospodarz milczał opuściwszy powieki , jakby się lękał zdradzić spojrzeniem .	lękał	7	Sing
Ksiądz jęknął .	jęknął	1	Sing
Wypełniła ją bez reszty .	Wypełniła	0	Sing
Słońce ogrzewało twarz i osuszało stopy .	ogrzewało	1	Sing
Działajmy nocą , najlepiej na kolanach .	Działajmy	0	Plur
Może to dla Ciebie niewiele znaczy , ale MI twój wiersz podobał się bardzo .	podobał	11	Sing
Zbliżają się ferie , już niedługo pociągi z Warszawy do Zakopanego zapełnią się młodzieżą .	zapełnią	11	Plur
Leki na obniżenie temperatury nie działały , a sytuacja , według słów Havlovej , w nocy z poniedziałku na wtorek stała się krytyczna .	działały	5	Plur
– Wątpię .	Wątpię	1	Sing
osobiście twierdzę , że to nie jest dobry pomysł .	twierdzę	1	Sing
" Tak chciał Bóg , żeby nasz umysł w sprawach matematycznych osiągał pewność logiczną , ale w religii osiągał ją dzięki prawdopodobieństwu nagromadzonemu . "	osiągał	11	Sing
Co - to wiedzą Aleksander Kwaśniewski i Krzysztof Janik .	wiedzą	3	Plur
Dzieci pracują ?	pracują	1	Plur
Politycy opozycji poinformowali również , że zamierzają złożyć do Trybunału Konstytucyjnego wniosek w sprawie niekonstytucyjności ustawy o ABW i AW .	poinformowali	2	Plur
Prosimy naszych czytelników i internautów o włączenie się do akcji .	Prosimy	0	Plur
Salony na parterze udostępniono publiczności i pełniły one rolę muzeum .	pełniły	6	Plur
Bez przesady , nie jestem już tym , co wycierał się na Mazurach w pomarańczowy ręcznik .	wycierał	9	Sing
jakoś się chyba dogadali dość dobrze ?	dogadali	3	Plur
Przez całe epoki piwo było napojem do śniadania , piło się piwo z serem .	piło	9	Sing
Portal Wirtualna Polska gościł wczoraj premiera Jerzego Buzka .	gościł	3	Sing
Co wolisz ?	wolisz	1	Sing
Robiły śmy kanapki , stroiły śmy półmiski .	Robiły	0	Plur
Odwróciła się i zaczęła szybko iść w moją stronę .	Odwróciła	0	Sing
Wcześniejsze doniesienia mówiły , że był to zamach samobójczy .	mówiły	2	Plur
A ten głupi Rzymianin powiedział , że go tam odeśle . . .	odeśle	9	Sing
Kładę się na łóżku i nic mi się nie chce .	chce	9	Sing
Zadeklarowali , że w stacji znajdą zatrudnienie mieszkańcy Szypliszek .	Zadeklarowali	0	Plur
Pracodawcy nie przejmują się z reguły samopoczuciem swoich telepracowników .	przejmują	2	Plur
- Nie jedź do Jerozolimy !	jedź	2	Sing
- Nie przypominała m jej sobie , poprosiła m , aby weszła do środka .	przypominała	2	Sing
Zbliżali się do niej groźnie .	Zbliżali	0	Plur
Jak ustalili policjanci , podawał alkohol 16-letniej dziewczynie .	podawał	4	Sing
Pod koniec gotowania dodajemy gomasio i natkę pietruszki .	dodajemy	3	Plur
Lech Kaczyński w czasie kampanii wspiął się na szczyty .	wspiął	5	Sing
Ale miało by to sens , jeśli owoce trafiły by do niego jeszcze dzisiaj .	trafiły	8	Plur
- Wykopię ten dół .	Wykopię	1	Sing
Twierdzą , że gazeta naruszyła ich dobre imię .	Twierdzą	0	Plur
- Już się o ciebie nie martwię .	martwię	6	Sing
IV Zjazd Absolwentów Liceum Ogólnokształcącego odbył się w sobotę w Tucholi .	odbył	5	Sing
Nie umiem w tych sprawach trzymać języka za zębami .	umiem	1	Sing
Stąd zawróciła .	zawróciła	1	Sing
Prosze ułożyć mi coś , żeby ludzie zębami zgrzytali , włosy darli , płakali , ale i równocześnie wroga szukali . . .	szukali	19	Plur
Do niczego nie przyznała się podczas badań .	przyznała	3	Sing
Wessie je mózg , wątroba , rurką pępowiny popłyną do Poli .	Wessie	0	Sing
Świat Rydzyka tego wszystkiego nie wydumał .	wydumał	5	Sing
Neandertalczycy żyli w Europie dwieście tysięcy lat .	żyli	1	Plur
Czas okrutnie ścieśnił tę rodzinę .	ścieśnił	2	Sing
Wtedy wracali chłopi , a wraz z nimi albo wkrótce po nich w pandższirskich wioskach pojawiali się mudżahedini .	pojawiali	15	Plur
– a czy jakaś historia łączy się z tą sową ?	łączy	5	Sing
Słuchaj , co ci rzeknie herold !	rzeknie	4	Sing
Nowość polegała na tym , że nauczyciele chrześcijańscy wykazywali , iż w osobie Jezusa Chrystusa wypełniły się wszystkie przepowiednie proroków .	wykazywali	8	Plur
- Uklęknijcie . . .	Uklęknijcie	1	Plur
Spustoszył potem Kujawy i zabrał wielkie łupy , które jednak mistrz prowincji mu wydarł .	wydarł	13	Sing
- Wiecie , kto to jest Andrzej Wroński ?	Wiecie	1	Plur
W tegorocznym VIII turnieju wystartowało 18 drużyn podzielonych na 6 grup .	wystartowało	4	Sing
Powiedzieli , że dom płonie .	Powiedzieli	0	Plur
- Zakrzyknęła .	Zakrzyknęła	1	Sing
A gdzież to panowie tak podróżują ?	podróżują	5	Plur
- Cieszę się , że wreszcie doszło do pielgrzymki w waszym kraju .	doszło	6	Sing
Wszystko płynie .	płynie	1	Sing
Na pogrzeb ojca przyjechał w mundurze .	przyjechał	3	Sing
Saszce rzeczywiście odeszła chętka do dalszej rozmowy .	odeszła	2	Sing
Odwróciła się i zaczęła szybko iść w moją stronę .	Odwróciła	0	Sing
Barwy te składają się na addytywny model barw .	składają	2	Plur
Wielu wywiadów nie udzielam .	udzielam	3	Sing
19-letnia mieszkanka Koszalina przekonała kolegów , aby pomogli jej oszukać bank .	pomogli	7	Plur
Obie części składamy podszewką do środka , zszywamy po brzegach , obszywamy lamówką .	zszywamy	7	Plur
Umarli o tym wiedzą i może dlatego sami przychodzą do nas .	wiedzą	3	Plur
Zaproponowali , że przerobią telefon tak , by można było z niego bezpłatnie rozmawiać .	Zaproponowali	0	Plur
Polacy jadący w autokarze spoglądają z nietajoną dumą na wielkiego rodaka .	spoglądają	4	Plur
- No widzicie ?	widzicie	2	Plur
Sprawą zajmują się policjanci z 6 komisariatu na Górnej .	zajmują	1	Plur
Próbują wszelkimi sposobami wyprowadzić ich ze strefy wojny .	Próbują	0	Plur
Ale ujęli sporo .	ujęli	1	Plur
Wyrównują one nierówności , jednocześnie przyklejając płytki .	Wyrównują	0	Plur
Ustalili ponadto , że w przestępczym autobiznesie działa ponad 1500 osób .	Ustalili	0	Plur
Na pewno ściągnięte przez niego duszyczki nie płaciły składek .	płaciły	7	Plur
