Lorine prsia ma zľahka tlačili na hrudníku , a o poschodie vyššie ležala v studenej izbe mŕtva Marga .	tlačili	4	Neut
Niečo mi zvieralo hrdlo .	zvieralo	2	Neut
Sadol som si a vybral z tašky fľašu whisky .	Sadol	0	Masc
Chvíľu čakal , ale mnoho ľudí mu netlieskalo .	netlieskalo	7	Neut
Srdce mi bilo ako zvon , no odľahlo mi , len čo za sebou zavrela .	bilo	2	Neut
Už dávno sa s nimi nehrám , ale ani vo sne by mi nenapadlo , aby som ich vyhodila .	nenapadlo	13	Neut
Spomenul som si na dve veci : na hysterickú eufóriu učiteľov po incidente , pri ktorom sa spomenulo meno mytologického božstva záhrobného sveta .	spomenulo	17	Neut
Mauglí pokrútil hlavou a chytil sa neďalekého stromčeka .	chytil	4	Masc
Zjavilo sa mi vo sne a mne stále znie v ušiach jeho hlas .	Zjavilo	0	Neut
Musím sa priznať , že sa mi ten nápad ohromne páčil , hoci znel neuveriteľne .	znel	13	Masc
Maja si pospomínala na všetky nebezpečenstvá , o ktorých im vykladala slečna Kasandra .	pospomínala	2	Fem
“ Neuveriteľné ! “ zvolala som .	zvolala	4	Fem
Vilko najprv reptal , ale potom ho Maja nespoznávala .	nespoznávala	8	Fem
Jeho záujem opäť ochabol .	ochabol	3	Masc
Začervenala som sa a zľahka som ho plesla po kolene .	Začervenala	0	Fem
Vtrhli do panského domu ako roj sršňov až sa Maja s Rudkom hanbili .	hanbili	12	Masc
Za oknom sa brieždilo .	brieždilo	3	Neut
Bez slova a bez pozdravu Martin odišiel , ticho zatvoril za sebou dvere .	zatvoril	9	Masc
Uprostred pretekov som prestala plávať a šliapala som vodu až k miestu , kde sa ponoril .	ponoril	15	Masc
Zrazu od úžasu onemela .	onemela	3	Fem
Vo Winstonovi zápasili zvláštne pocity .	zápasili	2	Masc
“ Ako je to možné ! “ zvolala prekvapene Maja .	zvolala	7	Fem
“ A čo sa stalo ? “ spýtala sa zvýšeným hlasom .	stalo	4	Neut
More postupne zmizlo a ona sa otočila ku mne .	zmizlo	2	Neut
“ Nanosilo ju sem dvadsať tiav . “	Nanosilo	1	Neut
Pred priateľovou ordináciou čakalo zo dvadsať ľudí , lavice pri stene boli obsadené .	čakalo	3	Neut
So zovretým hrdlom som sa rozhliadol okolo seba .	rozhliadol	5	Masc
Primátor Komárna Štefan Pásztor po svojej sekretárke odkázal SME , že sa k problému nevyjadrí .	odkázal	7	Masc
Možno by jej to celkom prospelo . “	prospelo	5	Neut
Oprela som sa o čalúnené sedadlo a vtom Mustang zrýchlil .	Oprela	0	Fem
Nikto vlastne nevedel , kam ide .	nevedel	2	Masc
NAHÁČI POTOPILI TITANIC	POTOPILI	1	Masc
Chvalabohu , nič sa mu nestalo .	nestalo	5	Neut
Vtom sa vo dverách zjavila aj neforemná Buchta .	zjavila	4	Fem
“ Tú šóru v žiadnom prípade nezvládneme , “ povedal Rýchlik a začal cúvať .	povedal	9	Masc
Dúfal , že jeho jasnovidecká kariéra potrvá dlhšie .	Dúfal	0	Masc
Toto dielo vznikalo postupne od konca 10 storočia do počiatku storočia 12 .	vznikalo	2	Neut
Našla som svojho osobného Spasiteľa , Ježiša Krista vo svetle Ježišovho evanjelia , v ňom som poznala posolstvo pokoja , lásky , radosti a šťastia .	poznala	16	Fem
Rozprávala , akoby jej vynechávalo srdce .	Rozprávala	0	Fem
Chvíľu leteli , až pristáli v spustnutej záhrade , kde bola pod obrovskou smutnou vŕbou hlbočizná studňa .	pristáli	4	Masc
Čo iné mi ostávalo ?	ostávalo	3	Neut
Mlčky ho sledovala celá trieda .	sledovala	2	Fem
Mohlo byť len zo stromu , do ktorého sa zaťalo sekerou so zatvorenými očami .	zaťalo	9	Neut
Jazmína pozrela dolu a zbadala otca .	pozrela	1	Fem
Na tvári som jej videla , že ju to vzalo , a keď vstala zo stoličky , bála som sa , že odíde z kuchyne .	vzalo	9	Neut
Mňa sa zatiaľ zmocnilo dvojnásobné rozrušenie .	zmocnilo	3	Neut
Snažil sa vyliezť po steble trávy hore , ale steblo sa pod jeho váhou nebezpečne naklonilo nabok .	naklonilo	15	Neut
Veci sa vyvinuli inak , než som sa obával .	vyvinuli	2	Fem
Na vrchole koleso chvíľu postálo a náš vozík sa knísal zboka nabok .	postálo	4	Neut
Zaznel rachot .	Zaznel	0	Masc
Oslík zahol do jednej z ulíc .	zahol	1	Masc
“ Mimozemšťania , “ zašepkal Rudko vystrašene .	zašepkal	4	Masc
Vytrhol sa z pavúčej priadze takou silou , že nič netušiaceho pavúka s ôsmimi nohami prevrátilo horeznačky .	prevrátilo	15	Neut
“ Videl som ťa v bazéne a mal som sa ti vyhnúť .	Videl	1	Masc
Týchto ľudí , ktorí pochádzali zo strednej triedy zamestnancov a z vyšších vrstiev robotníckej triedy , sformoval a zoradil jalový svet zmonopolizovaného priemyslu a scentralizovanej vlády .	zoradil	18	Masc
Nassir zdvihol maličký uzlík .	zdvihol	1	Masc
Niečo mu chýbalo : opatrnosť , rezervovanosť , niečo ako sebazáchranná obmedzenosť .	chýbalo	2	Neut
Usilovne cvičila až to uši trhalo .	trhalo	5	Neut
Boli tam mravce , lykožrút Fridolín s Buchtou , aj rodinka ploštíc .	Boli	0	Masc
Nateraz však sa O ' Brien odvrátil .	odvrátil	6	Masc
Jedli mlčky , veľmi zriedka prehodili nejaké slovo .	Jedli	0	Masc
“ Pozor ! “ varovne skríkla Bela .	skríkla	5	Fem
Vždy mu odporovala , keď povedal niečo podobné .	odporovala	2	Fem
Nemalo by to zmysel .	Nemalo	0	Neut
Jazmína preglgla .	preglgla	1	Fem
Zmocnil sa ma akýsi ošiaľ .	Zmocnil	0	Masc
Pred bránou Maju oslepilo žiarivé svetlo , až privrela oči .	privrela	8	Fem
Krist , nenamáhaj sa , nepoučuj ma o tom , o čom ma stará mama poučila už dávno ‐ pradávno .	poučila	15	Fem
Očakávala som niečo iné , ona však nevyslovila jedinú výčitku .	Očakávala	0	Fem
Soni ma prosila , aby som nerobil hlúposti .	prosila	2	Fem
Jedného dňa sochu odtiaľ strhol dav , ktorý rozzúrilo jej namyslené povýšenectvo .	strhol	4	Masc
Kráčal po chodbe a očakával guľku .	očakával	4	Masc
Napokon sa vybrali do mesta .	vybrali	2	Fem
Na tretí deň ráno spratal päť porcií raňajok a spokojne sa ponaťahoval .	spratal	4	Masc
Aladinove kráľovské rúcho zmizlo .	zmizlo	3	Neut
Svoje životy zasvätili dobytiu sveta , ale vedia aj to , že vojna má sa viesť do nekonečna a nemá ju korunovať víťazstvo .	zasvätili	2	Fem
Jedného večera mi zatelefonovali deti .	zatelefonovali	3	Neut
Kapituloval , to bolo jasné .	Kapituloval	0	Masc
“ Chŕŕŕŕŕ ! “ zachrčal netvor , keď sa mu šíp zaryl do chrbta .	zachrčal	4	Masc
Prebehla cez cestu .	Prebehla	0	Fem
Uži si trocha , prikázala som si .	prikázala	4	Fem
Čo sa týka vzťahov Novgorodcov a podmanených ugro ‐ fínskych plemien , formálne podriadené kmene si zachovávali značnú dávku nezávislosti .	zachovávali	16	Masc
Winston bol ženatý a pravdepodobne ešte stále je ženatý , lebo pokiaľ vie , jeho žena nezomrela .	nezomrela	16	Fem
Veronika sa najprv urazila , ale keď jej Ferdo vysvetlil , že rehotanie je taká zvláštna psia choroba , trochu sa upokojila .	vysvetlil	9	Masc
K tomu sa podávalo trnkové víno a deťom ponúkli fialovú malinovku .	podávalo	3	Neut
Najprv so mnou nechcela hovoriť .	nechcela	3	Fem
S odporným škrekotom z nej stúpali čarodejné výpary .	stúpali	5	Masc
S ťažkým srdcom sa Herkules lúčil s rodičmi a oni ho s ťažkým srdcom púšťali .	púšťali	14	Masc
Poletím za tebou , “ povedal Vilko , obrátil sa na bok a zaspal .	zaspal	13	Masc
Aj Maja so škriatkom opustili topoľ a leteli , kým nedoleteli k domu , kde sa v oknách ešte svietilo .	svietilo	19	Neut
Tak tomu hovorím názorný príklad fungovania zóny najbližšieho vývinu , o ktorej som písala minule !	písala	13	Fem
Obaja súhlasili , no nič im nenapadalo .	súhlasili	1	Masc
Mykla plecami .	Mykla	0	Fem
Zaľúbil som sa do nej akousi zvláštnou láskou , ktorá ma nepobádala písať verše , ako som ich písal pre Teutu .	Zaľúbil	0	Masc
Teší ma , “ jachtala som .	jachtala	4	Fem
Hanbila sa tak , že chcela na mieste umrieť .	Hanbila	0	Fem
Keď vyniesli nahor aj poslednú stoličku , bolo už celkom tma .	vyniesli	1	Masc
Začiatkom týždňa sme písali ďalší test a profesor Tayerle nám ho dnes priniesol opravený .	priniesol	12	Masc
Nijaký taký papier neexistoval .	neexistoval	3	Masc
Nanešťastie si Tekla zaumienila , že pri tejto príležitosti predvedie huslové sólo .	zaumienila	3	Fem
Pohladkal som ho a veru ani sa nehol .	nehol	7	Masc
“ Amy ! “ zvolal rozpačito .	zvolal	4	Masc
Najskôr ma začal vzrušovať dotyk jej rúk .	začal	2	Masc
Pred okienkom do pivnice ležal lesklý tvor s červenými očami a nahlas funel .	funel	12	Masc
Dieťa spokojne ležalo a nič nenaznačovalo , že sa vlci chystajú vyjsť z jaskyne .	nenaznačovalo	5	Neut
Vzápätí som sa však vrátila do skutočnosti .	vrátila	4	Fem
Keď dohovoril , usmial sa svojím záhadným úsmevom a ustúpil nabok , aby uvoľnil cestu Lori .	dohovoril	1	Masc
Na tomto mieste sa niť mojich úvah zamotala .	zamotala	7	Fem
Ako som počúval otcove husle , pred očami sa mi zjavil portrét ženy z medailónu .	počúval	2	Masc
“ Máte pridobré srdce , “ poznamenala Kráska .	poznamenala	6	Fem
Trápilo ma niečo iné : musím zvíťaziť nad zvieraťom , ktoré sa vo mne prebudilo .	prebudilo	14	Neut
Spoza steny začula hlasy .	začula	2	Fem
Všetkých , ktorí tam bývali , stihlo nešťastie .	stihlo	6	Neut
Začervenala som sa , ale s úsmevom som pokrčila plecami .	pokrčila	8	Fem
“ To rada počujem , “ vyhlásila Lienka .	vyhlásila	6	Fem
Mravce roztiahli plachtu a razom všetko stíchlo .	stíchlo	6	Neut
Pomaly vstala a po niekoľkých knísavých krokoch zasa našla rovnováhu .	našla	8	Fem
Ale ani pre myšiaka sa všetko neskončilo .	neskončilo	6	Neut
Pevnejšie pritlačila veko košíka a odháňala Syreetinu zvedavú opičku .	pritlačila	1	Fem
Pomyslel som si , že plače .	Pomyslel	0	Masc
Mlčky mi podal obálku , čo sa podobala obálke , ktorú mi zverila Liza .	podobala	7	Fem
Zrazu vdýchla sladučkú jemnú vôňu a pustila sa za ňou .	pustila	6	Fem
Šesť perzských žonglérov zasa hádzalo nožmi .	hádzalo	4	Neut
Dlho očakávaná guľka mu vnikla do mozgu .	vnikla	4	Fem
Kala priviedla dieťa k svojej rodine .	priviedla	1	Fem
Vôbec som neveril tomu , čo sa hovorí .	neveril	2	Masc
Cítila som , že sa červenám .	Cítila	0	Fem
Zatiaľ čo silnejšie uviazal stužku a zavesil mi ju na krk , stála som na mieste .	uviazal	3	Masc
Najprv zavládlo neprirodzené ticho .	zavládlo	1	Neut
Nezdalo sa mi však , že som ho presvedčila .	Nezdalo	0	Neut
Jachtala som , rýchlo som zavrela notes a strčila ho späť do vaku .	zavrela	5	Fem
Prednosta podzemnej dráhy náhodou našiel starú čižmu , ktorá sa na tento účel výborne hodila .	hodila	14	Fem
Vykročil som cez cestu .	Vykročil	0	Masc
Tmavovlasé dievča sedelo ihneď za nimi .	sedelo	2	Neut
Cez tenké steny sem zvonku dopadalo iba chabé svetlo .	dopadalo	5	Neut
Cítila som , aké má teplé dlane .	Cítila	0	Fem
“ Počkaj , až ochutnáš Safiyinu špecialitu , “ nadšene vravel , keď sluhovia kládli na stôl ťažký strieborný podnos s polguľovitým vrchnákom .	kládli	14	Masc
Zrazu zatajila dych , oslepila ju farebná ligotavá žiara .	zatajila	1	Fem
Z palice vyšľahol zelený blesk .	vyšľahol	2	Masc
Rodičia zhasli svetlo a vyšli z izby .	vyšli	4	Masc
Vstala a odišla .	Vstala	0	Fem
Winstonovo telo zalial razom na každom kúsku studený pot .	zalial	2	Masc
Po niekoľkých minútach mu však naskočilo ďalšie , pravdepodobnejšie vysvetlenie .	naskočilo	5	Neut
Vybral som z neho pokrčený oblek .	Vybral	0	Masc
Motýľ sa opäť zasmial .	zasmial	3	Masc
Nič som nevidel .	nevidel	2	Masc
Vietor silnel a v ďatelinových hlavičkách nebezpečne zašumelo .	zašumelo	7	Neut
Takto som uvažoval , keď som sa našiel na kolenách .	uvažoval	2	Masc
Nemohla sa dočkať , kedy preberieme moje citové záležitosti , a tak prišla k nám .	Nemohla	0	Fem
V nasledujúcich dňoch som márne čakal , že niekto z nich mi zverí nejaký list .	čakal	5	Masc
Šer Chán prikývol .	prikývol	2	Masc
Chcela dva doláre .	Chcela	0	Fem
Odpovedala , že je v poriadku .	Odpovedala	0	Fem
Potom sa všetko vyvinulo nečakaným smerom .	vyvinulo	3	Neut
A ja som jej neprezradil niečo , čo ma ťažilo veľmi dlho po jej odchode .	ťažilo	9	Neut
“ Uteč , Mauglí , uteč ! “ kričal Balú .	kričal	8	Masc
Keď leteli okolo sladko rozvoniavajúceho jazmínového kra , neodolali a sadli si naň .	neodolali	8	Masc
Prichádzali a záhadne odchádzali ďalší väzni .	odchádzali	3	Masc
Aladin pozrel na Abua .	pozrel	1	Masc
Zrútil sochu a vláčil ju po uliciach našej štvrte .	Zrútil	0	Masc
Syme zdvihol zrak . " Tam prichádza Parsons , " poznamenal .	poznamenal	10	Masc
Vedel , že v neďalekej jaskyni žije vlčia rodinka , ktorej sa nedávno narodili mladé vĺčatá .	narodili	13	Neut
A Maja odvetila : “ Udeľuje sa milosť , končím . “	odvetila	2	Fem
Maja naň mala obrovskú chuť , no držala sa v úctivej vzdialenosti .	držala	7	Fem
A hrozilo by , že sa stratí čaro našich ľúbostných stretnutí .	hrozilo	1	Neut
Čím dlhšie som tam šliapala vodu , tým väčšia zlosť ma chytala .	chytala	11	Fem
Sultán si vzdychol .	vzdychol	2	Masc
Natoľko ma zaskočil , že som ho skoro ostriekala .	ostriekala	8	Fem
Cítil som vôňu jeho tela , ktorá bola premiešaná so zápachom tabaku a alkoholu .	Cítil	0	Masc
Jabĺčko vypadlo dievčine z ruky .	vypadlo	1	Neut
V nedeľu 18 . apríla sa konalo zasadnutie zborového presbyterstva .	konalo	6	Neut
Vzápätí niečo vrzlo .	vrzlo	2	Neut
Tigríča sledovalo , ako sa rozkotúľali , a skočilo medzi ne !	rozkotúľali	5	Neut
Keď mravenisku hrozilo nebezpečenstvo , statočne ho bránili .	hrozilo	2	Neut
Našiel som vašu opičku ! “	Našiel	0	Masc
V Bullocku nás ovalil závan chladného klimatizovaného vzduchu a lákavá vôňa novučičkých šiat .	ovalil	3	Masc
Vzal pero a napísal :	Vzal	0	Masc
Srdce mi bilo ako zvon , no odľahlo mi , len čo za sebou zavrela .	odľahlo	7	Neut
Sadol som si k stolu , odkiaľ som mohol sledovať pohyb pred vchodom do televízie Sírius .	Sadol	0	Masc
“ Kto to tu plače ? “ spýtala sa tá krehká drobučká bytosť a zvedavo sa poobzerala okolo seba .	spýtala	7	Fem
Vošiel som dnu a uľavil som si .	uľavil	4	Masc
“ Nie , nie , “ poponáhľala sa Maja s odpoveďou .	poponáhľala	6	Fem
Avšak hoci som sa strácal v tieni režisérov a hviezd filmového plátna , netrápil som sa .	strácal	4	Masc
Keď sme vychádzali z izby , že pôjdeme k autu , uvidel som vec , ktorá zvrátila ten večer nepredvídaným smerom .	zvrátila	16	Fem
Jediná nádej , že ju uvidím , bola virtuálna , závisela od toho , či sa rozhodne trápiť ma vo sne .	závisela	10	Fem
Nahradilo ich niekoľko všeobecných slov , čím sa zlikvidovali .	zlikvidovali	8	Neut
Slniečko hrialo , ľan schol a krtko zaspal .	hrialo	1	Neut
Rozvinul príkaz , ktorý predtým odložil stranou .	odložil	5	Masc
Bežala k otvorenému oknu .	Bežala	0	Fem
Keď som čítala posledné riadky , myslela som na mamu , ktorá robila zázraky , aby sme dajako vyšli .	robila	12	Fem
A nohy ma priviedli do obchodu , kde predávali alkoholické nápoje .	priviedli	3	Fem
Naozaj , mravenisko vyzeralo ako pevnosť .	vyzeralo	3	Neut
Keď sme vychádzali z izby , že pôjdeme k autu , uvidel som vec , ktorá zvrátila ten večer nepredvídaným smerom .	uvidel	11	Masc
* Čo nám prinieslo 20 . storočie ?	prinieslo	3	Neut
Vtedy mi pripadalo prirodzené vyhľadať v tme jej ruku .	pripadalo	2	Neut
Usmiala som sa .	Usmiala	0	Fem
Terk bežala k lagúne a vytiahla Tarzana , ktorý sa poriadne napil vody .	napil	11	Masc
Zobudil som sa o dvanásť hodín .	Zobudil	0	Masc
Pripomínal jej trochu Teklu a chcela rýchlo odletieť .	Pripomínal	0	Masc
Očká zažmurkali .	zažmurkali	1	Neut
Keď pred správami zaznela trúbka , vždy to znamenalo víťazstvo .	zaznela	3	Fem
“ Ostalo , zvyšok by som vám mohla ponúknuť , “ povedala Maja .	Ostalo	1	Neut
Pokrútil hlavou .	Pokrútil	0	Masc
Rozpovedal im o svojej ceste k Pánovi i svojom živote s Ním .	Rozpovedal	0	Masc
“ Kto ma volá ? “ ozvalo sa .	ozvalo	6	Neut
Zachvátila ma panika , nevládal som utekať .	nevládal	4	Masc
Čakala som na Chrisa .	Čakala	0	Fem
Snažil sa vyliezť po steble trávy hore , ale steblo sa pod jeho váhou nebezpečne naklonilo nabok .	Snažil	0	Masc
Po záležitosti so Soni som nezažil nijaké ľúbostné dobrodružstvo .	nezažil	5	Masc
Vrátila sa domov skôr ako ja a zdalo sa , že je pokojná .	zdalo	7	Neut
Vôbec som im neprotirečil , postupoval som podľa inej taktiky .	neprotirečil	3	Masc
Nemalo nijaké okná .	Nemalo	0	Neut
Aj to mu naháňalo strach .	naháňalo	3	Neut
Bola nefalšovane na smrť vystrašená , čo sa dalo pochopiť .	dalo	8	Neut
Keď sa chrobák zjavil znovu , vyzeral namrzene a hodil na zem kúsok medu .	hodil	9	Masc
Ako predpokladal , pán Charrington nerobil s prenájmom izby nijaké drahoty .	predpokladal	1	Masc
Jachtala som , rýchlo som zavrela notes a strčila ho späť do vaku .	strčila	8	Fem
Kým komáre krúžili koldokola na kraji lesa , na krajinu pomaličky sadala tma .	krúžili	2	Masc
Žuk meškal , a hoci som sa všemožne pokúšal opäť zaspať , nedarilo sa mi to .	nedarilo	12	Neut
" To robí táto pliaga , " povedala , strhla si šarlátovú šerpu Antisexuálnej ligy mládeže a odhodila ju na konár .	strhla	9	Fem
Chvíľu som ležal so zatajeným dychom .	ležal	2	Masc
Za nič na svete však nechcela opustiť svoju rodinku , a tak sa Rudko a Flip rozhodli , že jej občas pomôžu .	nechcela	5	Fem
Malo sukničku z makových lupienkov a usmievalo sa .	usmievalo	6	Neut
Tigríča sledovalo , ako sa rozkotúľali , a skočilo medzi ne !	skočilo	8	Neut
Súviselo to jednak s už spomenutým rozvinutým fungovaním systému vlastníckych kostolov a kláštorov a jednak s existenciou otónsko - sálskeho ríšskeho cirkevného systému v Nemecku .	Súviselo	0	Neut
Slečna sa znepokojila .	znepokojila	2	Fem
Po chvíli prišli na svet štyri drobnučké šteniatka .	prišli	2	Neut
Videl , ako Júlia zodvihla pohár a privoňala k nemu s úprimnou zvedavosťou .	privoňala	7	Fem
Po očku som sledovala , ako vkĺzol za volant .	vkĺzol	6	Masc
Motýľ Emanuel ostal ako obarený .	ostal	2	Masc
Siahol mu do vrecka na šatách a keď vytiahol ruku , mal na dlani veľký červený rubín .	Siahol	0	Masc
“ Výborný nápad , “ súhlasila som .	súhlasila	5	Fem
Len nedávno mali v banke celoročné hodnotenie a dnes sa dozvedela , že jej riaditeľ zvýšil plat .	dozvedela	10	Fem
Niečo dopadlo na posteľ za Winstonovým chrbtom .	dopadlo	1	Neut
Jazmína zdvihla hlavu a uvidela , že princ Omar tuho spí .	uvidela	4	Fem
Poznal som tú ženu , vedel som , aké má meno .	vedel	5	Masc
More postupne zmizlo a ona sa otočila ku mne .	otočila	6	Fem
“ Ty chceš ísť na túru ? “ spýtala som sa a pozrela na hodinky .	pozrela	12	Fem
Veď čo už zvýšilo z toho , čo z neho mučením nevypáčili ?	zvýšilo	3	Neut
Nikdy by jej nezišlo na um , že bezvýsledný čin nemá význam .	nezišlo	3	Neut
Prikývla a povedala , že sa o chvíľu vráti .	Prikývla	0	Fem
Ukazuje sa teda , že tým stredoslovenským nárečím , ktorÉ Štúrovci povýšili na spisovný JAZYK , bol prestížny liptovský mestský jazyk .	povýšili	11	Masc
Svojím typickým gestom si O ' Brien upravil na nose okuliare .	upravil	7	Masc
Ruky ma zúfalo boleli a na krátky , ale nepríjemný okamih som nadobudla dojem , že spadnem na nesprávnu stranu .	boleli	3	Fem
Chytil ma za ruku , aby som sa spamätala .	spamätala	8	Fem
Maja s Vilkom sedeli na lesnej čistine a vymýšľali si o nich príbehy .	vymýšľali	8	Masc
Usmiala som sa .	Usmiala	0	Fem
Winstona bolestne bodlo pri srdci .	bodlo	2	Neut
Vzdychla si .	Vzdychla	0	Fem
Vendelín zasa zosmutnel .	zosmutnel	2	Masc
Ťarbavo sa pohyboval po javisku a nevedel sa naučiť úlohu .	nevedel	6	Masc
Ani nemukla a bez pohnutia sa dívala na spiace dieťa .	dívala	6	Fem
Zvyšné zuby mu vytrhli a dali mu nové protézy .	vytrhli	3	Masc
Pršalo , slnko sa schovalo za mraky .	Pršalo	0	Neut
Len čo bola Maja preč , schytil Vilko palicu .	schytil	6	Masc
Tú ženu som nepoznal , nikdy som ju nestretol .	nepoznal	3	Masc
Zišiel zo stolčeka .	Zišiel	0	Masc
Večer už boli unavení a z meravého sedenia ich bolel vzadu krk .	bolel	9	Masc
Buď som nečakal , že mi do toho zasiahne , alebo mal vo svojom výzore i držaní tela stále čosi neprirodzené , čo ma znepokojovalo a zároveň uvádzalo do rozpakov .	uvádzalo	27	Neut
V prípade , že z manželstva nevzišli deti , Strana nepovoľovala rozvod , zato podporovala odlúčenie .	nevzišli	6	Neut
Ten leták na mňa nezapôsobil .	nezapôsobil	4	Masc
Poslúchol som ju a podišiel k oknu .	Poslúchol	0	Masc
“ Asi tri , “ odvetil Rýchlik .	odvetil	5	Masc
“ To sa nemalo stať ! “ kričal nešťastný Herkules .	nemalo	3	Neut
Bola horúca júlová noc a vládla dusivá spara .	vládla	5	Fem
Prišlo „ ale “ , ktoré som počul iba nejasne .	počul	7	Masc
Na chvíľu zdvihol hlavu ; opäť ten nepriateľský záblesk .	zdvihol	2	Masc
Prešiel z izby do stiesnenej kuchynky .	Prešiel	0	Masc
Niekto ťa prepadol ? “ vypytovala sa hlavná sestra .	prepadol	2	Masc
Prekvapilo ma to , ale Truhlík mi prezradil , že sa vslatne narodil v kine .	Prekvapilo	0	Neut
Šance na zachovanie výsledkov tunajších reforiem boli lepšie ako v Dolnom Lotrinsku , lebo tieto reformné strediská požívali citeľnú podporu svetskej aristokracie .	požívali	17	Neut
Objímal kmeň a hrdo zdvihol bradu .	zdvihol	4	Masc
V straníckych obchodoch každú chvíľu niečo chýbalo .	chýbalo	6	Neut
Nič nie je skutočné , usúdil som nakoniec .	usúdil	5	Masc
Usnul šepkajúc : " Zdravý rozum sa nedá zaznamenať štatisticky " a s pocitom , že táto jeho poznámka obsahuje hlbokú múdrosť .	Usnul	0	Masc
Väčšie zlá sústavne unikali ich pozornosti .	unikali	3	Neut
Prvý , druhý , tretí aj štvrý odkaz mi nechala Blythe a zneli čoraz rozčúlenejšie .	zneli	12	Masc
“ Idem , “ podujala som sa .	podujala	4	Fem
Pokrčil plecami a podal mi Colu .	podal	3	Masc
V noci sa zatvárala do medailónu a patrila Profesorovi .	zatvárala	3	Fem
Porota však ocenila práce slimákov Šuchtáka a Plazivca , ktorý si prekrásne vymaľovali domčeky .	ocenila	2	Fem
Niekto zo susedov si mohol všimnúť , že som bol preč , mohol by sa ma zvedavo vypytovať , kde som bol , a to by stačilo , aby sa som sa rozčúlil .	rozčúlil	32	Masc
Svätojánske mušky , lienky a niekoľko včiel sedelo alebo ležalo na dlážke a smutne vyčkávalo na svoj osud .	ležalo	9	Neut
Viečka sa roztvorili .	roztvorili	2	Neut
“ Vážne som chcela ísť po tréningu za tebou , ale vyfučalo mi to z hlavy .	chcela	3	Fem
Vaša žena zomrela , povedal .	povedal	4	Masc
Namiesto odpovede sa však stvorenie posúvalo dopredu .	posúvalo	5	Neut
Mohla by sa ma pýtať na Lorinu svadbu a ja by som nevedel , čo jej povedať .	nevedel	12	Masc
“ Ja som navine ! “ hrdo zvolal Tarzan .	zvolal	7	Masc
Tigríča sledovalo , ako sa rozkotúľali , a skočilo medzi ne !	sledovalo	1	Neut
Telefón mlčal .	mlčal	1	Masc
Ostražito sa zakrádala k neznámemu miestu , keď začula plač .	zakrádala	2	Fem
Bol som rozjarený , ohúrený od šťastia , ktoré vo mne vzbudzovalo obavy .	vzbudzovalo	11	Neut
Videla som , ako zabočil na našu ulicu .	Videla	0	Fem
“ Správne , “ povzbudzovali ich akrobati .	povzbudzovali	4	Masc
Preglgla som .	Preglgla	0	Fem
“ Prineste i za mňa , “ vyhlásil Vilko a skočil do postele .	vyhlásil	7	Masc
Ako sa hovorilo , túto škandalóznu informáciu potvrdila sama herečka , ktorá sa nervovo zrútila .	zrútila	14	Fem
Mala som dojem , že som sa vrátila z cesty okolo sveta .	vrátila	7	Fem
Predavačka sa silene usmievala , aby dala najavo , že ju to pobavilo .	pobavilo	12	Neut
Obávala som sa , že dám najavo priveľké nadšenie , ak sa otočím ku Chrisovi celá naradostená .	Obávala	0	Fem
Pocítila ľútosť a pritisla ma k sebe .	pritisla	3	Fem
Pozvala na ňu Blythe a Ricka a podávala moje obľúbené jedlá : zemiakovú kašu , pizzu , celozrnný chlieb , španielske chimichangas , makaróny so syrom a orechový koláč .	podávala	7	Fem
Nemohla som pochopiť , ako to zo mňa vyletelo .	vyletelo	8	Neut
Z televíznej obrazovky zaznel zúrivý , ohlušujúci rev .	zaznel	3	Masc
Uniklo mi „ ach ! “ .	Uniklo	0	Neut
Služobníctvo by ťa tu našlo .	našlo	4	Neut
Vážka sa polichotene usmiala .	usmiala	3	Fem
Ale oni nič nerobili ani nehovorili .	nerobili	3	Masc
Na druhý deň som zistil , že ležím celkom oblečený na skladacej posteli .	zistil	4	Masc
A stalo sa .	stalo	1	Neut
Netrvalo dlho a nad jaskynkou sa zachvel list , spod ktorého vyliezol prečudesný chrobák .	zachvel	6	Masc
Vo dverách sa objavila plavovláska , pripomínajúca plavovlasé dievčatá z výťahu .	objavila	3	Fem
Skončilo sa to trochu ináč .	Skončilo	0	Neut
Kurz dolára trochu klesol , pomyslel som si .	pomyslel	5	Masc
Drobné štuchnutie však Balúa netrápilo .	netrápilo	4	Neut
Postavila sa na špičky prstov a pobozkala ma .	pobozkala	6	Fem
Všetko očernelo .	očernelo	1	Neut
Tatko sa hneval na deti , lebo ukrutne vyvádzali , a mamka sa hnevala na tatka , že je precitlivený .	hnevala	13	Fem
Jej telo akoby doňho prelievalo časť svojej mladosti a elánu .	prelievalo	4	Neut
Oznam Ministerstva hojnosti zakončilo ďalšie sólo na trúbku , ktoré potom vystriedala dychovka .	zakončilo	3	Neut
Kým som si to stačila uvedomiť , po tvári mi tiekli slzy a potichu som vzlykala .	vzlykala	15	Fem
Zazrela som ho , keď vystrkoval z obloženia svoj odporný rypák .	Zazrela	0	Fem
Vták opäť kývol lesklou čiernou hlavou .	kývol	2	Masc
Zem sa ustavične triasla a kopček z hliny rástol a rástol .	triasla	3	Fem
Aziza sa zamračila .	zamračila	2	Fem
Omar pustil vankúš a skočil na zem .	skočil	4	Masc
Išli sme za školu , kde – trochu vyššie – vyvieral prameň , ktorý tam vymlel priehlbinu .	vymlel	15	Masc
Stiahol ju nadol , takže kľačali tvárou v tvár .	kľačali	5	Masc
Nevidel som nič , nikto ma nesledoval .	Nevidel	0	Masc
Nateraz ho však z jeho filozofovania vytrhlo prudké trhnutie .	vytrhlo	6	Neut
Ja som nehľadal Istanbul ani bývalé hlavné mesto nejakej inej ríše .	nehľadal	2	Masc
Raz Makulienka vraví : “ Niečo by som chcela . “	chcela	8	Fem
Ľubomír Ďurovič do komunistickej strany nevstúpil .	nevstúpil	5	Masc
Samozrejme , že som mu nepovedala , že mám domáce väzenie .	nepovedala	5	Fem
Najprv som začula , ako čosi v kríkoch zašumelo .	začula	2	Fem
Niečo cvaklo , akoby niekto uvoľnil príchytku , a zarinčalo rozbité sklo .	cvaklo	1	Neut
Začul prekrásny hlas Šípkovej Ruženky , ktorý sa niesol lesom .	Začul	0	Masc
Ustráchaní sedeli na akejsi lúke a nevedeli , kadiaľ sa ide domov .	sedeli	1	Masc
Robíme , čo môžeme , aby z toho vyšlo fantastické predstavenie .	vyšlo	8	Neut
Vyvesili na tabuľu text , ale ani to nepomohlo , lebo Vilko sa z lenivosti nenaučil dobre čítať .	Vyvesili	0	Masc
Klesol som na stoličku .	Klesol	0	Masc
Namiesto toho som ho opäť poprosila , aby mi dovoliť dotknúť sa ich .	poprosila	5	Fem
Spoza stola ma vytiahol smútočný pochod dychovej kapely .	vytiahol	3	Masc
Nevidel som nijakú uniformu .	Nevidel	0	Masc
Toto posledné konštatovanie sa ma dotklo .	dotklo	5	Neut
Dobre vedel , že dal Džahijovi na opravu strechy raz toľko , ako potreboval .	vedel	1	Masc
Stiahol kombinézu nabok a prezeral si jej hladký , biely bok .	Stiahol	0	Masc
Už mnoho generácií múch obývalo kráľovský palác v stajni .	obývalo	4	Neut
Bola polnoc .	Bola	0	Fem
V ten deň , keď som sa prebudila chorá , som sledovala z obloka návrat osadenstva vily .	prebudila	7	Fem
Potom dodala známu vec s ujom a v priestore môjho mozgu zaburácalo slovo „ impotent “ .	dodala	1	Fem
Tatko sa hneval na deti , lebo ukrutne vyvádzali , a mamka sa hnevala na tatka , že je precitlivený .	vyvádzali	8	Neut
Dievčatko pozrelo hore .	pozrelo	1	Neut
Vtedy sa naraz ukázalo , že komunistická strana s jej zločineckými spôsobmi skrachovala .	skrachovala	12	Fem
To by vyzeralo !	vyzeralo	2	Neut
Nič sa nedalo robiť .	nedalo	2	Neut
Pre chlad som za stolom nikdy nezaspal .	nezaspal	6	Masc
Miatla ho vôňa povetria i zeleň lístia .	Miatla	0	Fem
Náhlila som sa do kabínky pri bazéne , napchala som mokré veci do vaku , obula si mokré tenisky a vybehla von .	obula	15	Fem
Pretože bolo kakarátky , nepohádali sa , ale išli spolu na zmrzlinu .	nepohádali	4	Fem
Vzápätí pribehli mandelinčatá s boľavými bruchami , takže musela ošetriť aj ich .	pribehli	1	Neut
Našej susedke - záhradkárke sa naše mičurinčenie ale veľmi nepáčilo .	nepáčilo	9	Neut
Zovrelo mi žalúdok a zrýchlil sa mi pulz .	Zovrelo	0	Neut
Videla som , že Chrisovi síce odľahlo , no po chvíli sa zasa tváril vážne .	odľahlo	6	Neut
A pred pevnosťou cvičilo vojsko .	cvičilo	3	Neut
Keď práve nemala v ústach štipec na bielizeň , mohutným kontraaltom spievala :	spievala	11	Fem
Namiesto toho spoznala iného , prečudesného spoločníka z čeľade hmyzu .	spoznala	2	Fem
Keď Shannon otvorila dvere , sprisahanecky ma objal okolo pliec a vliezol na zadné sedadlo .	otvorila	2	Fem
Mala som tie najlepšie úmysly .	Mala	0	Fem
Na nič spred začiatku šesťdesiatych rokov sa nepamätala a ( zo všetkých známych ) jediný človek , ktorý často rozprával o rokoch pred Revolúciou , bol jej starý otec .	rozprával	19	Masc
Tigríča jej nešikovne skočilo do náručia a princezná zacítila mäkulinkú teplú guľku s hodvábnou srsťou .	skočilo	3	Neut
Neváhal a rozhádzal všetky kamene , zničil všetky znamenia .	rozhádzal	2	Masc
Mušiakovi Pavlovi sa mušia slečna zapáčila na prvý pohľad .	zapáčila	5	Fem
Približovala sa k nemu zohnutá , popolavo sivá postava , ktorá pripomínala kostlivca .	pripomínala	11	Fem
Potom sa vrhol do vody a rozpleštil sa na člne , až ma od smiechu rozbolelo brucho .	rozbolelo	15	Neut
To nás obidvoch vždy uvoľnilo , mohli sme sa správať prirodzene .	uvoľnilo	4	Neut
Pocítil , že na znak nesúhlasu pokrčila ramená .	pokrčila	6	Fem
Bol to pochmúrny deň , oblaky viseli nízko , smerom k močiaru udierali blesky .	viseli	6	Masc
Videla som ju zopár ráz na plaveckých pretekoch , lenže nikdy nás nikto nepredstavil .	Videla	0	Fem
Vzápätí sa ozvalo ďalšie hop a koník sedel oproti Maji .	ozvalo	2	Neut
Stále som kľačal na kolenách a čelo sa mi pokrylo potom .	pokrylo	9	Neut
Všetko prebehlo v tichosti , vedenie fakulty nevydalo nijaké oficiálne vyhlásenie .	prebehlo	1	Neut
Keď preberal znova volant , prikryl mi ruky , ktoré ostali naspodu .	preberal	1	Masc
Pripadalo by mi znesiteľnejšie , keby kvôli nemu nespal ani Chris .	nespal	8	Masc
Zostávali mi teda poviedky .	Zostávali	0	Fem
Vo Francúzsku už počas panovania posledných Karolovcov zanikla silná ústredná panovnícka moc .	zanikla	7	Fem
Keď som to vyslovil , prebehli mi po tele zimomriavky .	vyslovil	3	Masc
Len čo sa jej dotkol , myklo ňou a akoby zmeravela .	myklo	6	Neut
Keby som bol prehltol tú návnadu , moje postavy by ma boli priviedli do hrobu .	prehltol	3	Masc
Ministerstvo lásky nemalo okná .	nemalo	2	Neut
Straníčky sa nikdy nefarbili .	nefarbili	3	Fem
Nenávisť vyvrcholila .	vyvrcholila	1	Fem
Paravojenské oddiely pritom zabíjali a vyháňali nesrbských civilistov .	zabíjali	3	Masc
Pocítil , že na znak nesúhlasu pokrčila ramená .	Pocítil	0	Masc
Muselo sa mu to stať v noci , “ odvetila Bibi .	Muselo	0	Neut
Prevrátila sa a klesla na dno .	klesla	3	Fem
Zvonka sa ozývalo čoraz viac nespokojencov .	ozývalo	2	Neut
“ Chŕŕŕŕŕ ! “ zachrčal netvor , keď sa mu šíp zaryl do chrbta .	zaryl	11	Masc
Takáto bola podstata jeho slov , ktoré ma rozčúlili .	rozčúlili	8	Neut
Schmatol jeden z Winstonových zostávajúcich predných zubov palcom a ukazovákom .	Schmatol	0	Masc
Potom vzal Balú Mauglího na plecia a Baghíra kráčal za nimi .	vzal	1	Masc
Prisunula sa ku mne a spýtala sa , či som v poriadku .	Prisunula	0	Fem
Srdce mu poskočilo .	poskočilo	2	Neut
Publikum burácalo .	burácalo	1	Neut
Na zem padal teplý dážď a obyvatelia Makovej lúky sa skryli .	skryli	10	Masc
Spýtala sa to veľmi vážne .	Spýtala	0	Fem
Tekla sedela prikrčená v kúte a zlomyseľne pozorovala jej márne úsilie .	pozorovala	7	Fem
Kým svetlo stihlo zmiznúť , upozornil som naň taxikára .	stihlo	2	Neut
Neprestal zvončeky trhať .	Neprestal	0	Masc
Lenže Jasper chcel peniaze , ktoré mu sľúbila za krádež šteniat .	sľúbila	7	Fem
Potom mu priložila ucho k jej srdcu .	priložila	2	Fem
“ Spím , “ odvetilo lekno .	odvetilo	4	Neut
Mauglího myšlienky prerušil Baghírov prísny hlas .	prerušil	2	Masc
Na tvári som jej videla , že ju to vzalo , a keď vstala zo stoličky , bála som sa , že odíde z kuchyne .	videla	4	Fem
Vymenoval som štyri číslice , ktoré tvorili číslo mojej izby .	tvorili	6	Fem
Nostradamus nič také nepredpovedal . . .	nepredpovedal	3	Masc
Popri potoku kvitli biele lekná .	kvitli	2	Neut
V druhej polovici tohto storočia prvé nebezpečenstvo vlastne pominulo .	pominulo	8	Neut
Mama zdvihla hlavu a ja som uvidela jej vystrašenú tvár .	zdvihla	1	Fem
Je to chronologicky prvá zbierka , ktorú zostavil neznámy autor z rímskych reformných kruhov .	zostavil	7	Masc
Po chvíli však medzi nami zavládlo napäté ticho a obaja sme sa otočili k oknu .	zavládlo	5	Neut
Zaplietla sa do niečoho neznámeho , ako keby ju lapila neviditeľná nitka .	lapila	9	Fem
Otočila sa a odletela .	odletela	3	Fem
Stáli pred obrazovkou .	Stáli	0	Masc
Cítila som , ako sa mi do hlavy hrnie krv .	Cítila	0	Fem
“ Nepiekla to , “ odvetil .	odvetil	5	Masc
Hľadala čosi v šatách , potom sa vrátila , usmiala sa , ľahla si a naznačila mi , aby som urobil to isté .	usmiala	9	Fem
Všetko prebehlo v tichosti , vedenie fakulty nevydalo nijaké oficiálne vyhlásenie .	nevydalo	7	Neut
A zvolil som ten najdrsnejší spôsob .	zvolil	1	Masc
“ Nie , “ odvetila som a žmurkla na Chrisa .	odvetila	4	Fem
“ Čo sa s tebou deje , Amy ? “ vypytoval sa ma po pretekoch tréner August a odviedol ma nabok , kým ostatní nastupovali do autobusu .	odviedol	18	Masc
Dievčatko išlo do kúpeľne .	išlo	1	Neut
Proroctvo otcovho priateľa , že bude zo mňa básnik , sa nesplnilo .	nesplnilo	11	Neut
Najradšej obhrýzalo Džafarove obľúbené topánky z najjemnejšej kože .	obhrýzalo	1	Neut
“ Taký balíček s prekvapením , “ dodal Smí .	dodal	7	Masc
Cítila som ľútosť a hrôzu .	Cítila	0	Fem
Hladko som vkĺzla pod vodu a vynorila sa na hladine .	vynorila	6	Fem
Podstrčil mu ho redaktor z televízie , ktorá všetko nakrúcala .	Podstrčil	0	Masc
Mamu som zbadala na rovine , keď sa na nebi zablyslo a rozľahol sa mocný hrom .	zablyslo	10	Neut
Jedna ruka jej ovisla nabok , telo sa jej uvoľnilo .	uvoľnilo	9	Neut
Niečo cvaklo , akoby niekto uvoľnil príchytku , a zarinčalo rozbité sklo .	zarinčalo	9	Neut
Súžitie etník tu teda fungovalo na princípe spoločenstiev v ktorých jednotlivé zložky popri sebe slobodne existovali a zároveň sa ovplyvňovali , miešali a splývali .	ovplyvňovali	19	Fem
Jazmína ho objala .	objala	2	Fem
Zopár minút preskakovali z témy na tému , keď vtom ich rev z televíznej obrazovky vyzval , aby držali jazyk za zubami .	držali	18	Masc
Tu sa jeho snahy stretávali s úsilím miest rostovsko ‐ suzdaľskej oblasti .	stretávali	4	Fem
Celý zvyšok predpoludnia sa mu pracovalo veľmi ťažko .	pracovalo	5	Neut
Zhíkla som a uhla sa , takže namiesto môjho líca Rick druhý raz pobozkal vzduch .	pobozkal	13	Masc
Väčšie zlá sústavne unikali ich pozornosti .	unikali	3	Neut
Chcela zistiť , odkiaľ pochádza tá zvláštna neznáma hudba .	Chcela	0	Fem
Nebojte sa , “ zakričala Polly .	zakričala	4	Fem
Vonku sa ozýval bzukot a cvrlikanie , všade poletovali motýle a slniečko krásne prehrievalo zem .	prehrievalo	13	Neut
Maja sa však nedala odradiť .	nedala	3	Fem
Roztočil som laso a chytil stonožku do slučky .	chytil	4	Masc
Hodila . . .	Hodila	0	Fem
“ Čo sa deje ? “ spýtal sa Chris , hoci sme to obaja vedeli .	spýtal	6	Masc
Ak mám byť úprimná , dojalo ma to .	dojalo	5	Neut
V ten deň od rána lialo .	lialo	5	Neut
Úľ sa vzďaľoval a jej sa zdalo , akoby pod ňou utekala zem .	zdalo	6	Neut
Preleteli sme cez oddelenie topánok , kozmetiky , vyhli sme sa nápadne namaľovaným predavačkám , ktoré ponúkali masky , líčidlá a vzorky kolínskej .	ponúkali	16	Fem
Nehybnú princeznú nechala ležať na studenej kamennej dlážke .	nechala	2	Fem
A zobudilo lekno .	zobudilo	1	Neut
Najviac z nich vzniklo , resp . začínalo vznikať , v rokoch pontifikátu Gregora VII .	začínalo	7	Neut
Na tvári som jej videla , že ju to vzalo , a keď vstala zo stoličky , bála som sa , že odíde z kuchyne .	bála	17	Fem
Ležala schúlená , otočená ku mne chrbtom .	Ležala	0	Fem
Rozrývalo mi to dušu a ničilo nervy .	Rozrývalo	0	Neut
Zobudilo ma zvonenie telefónu .	Zobudilo	0	Neut
Horšie však bolo , že ten divý kôň zmizol .	zmizol	8	Masc
Ale tomu neuniklo nič .	neuniklo	2	Neut
Nemala inú možnosť , keď jej Roger odmietol šteniatka predať .	Nemala	0	Fem
“ To je môj koniec ! “ kričal zronene .	kričal	7	Masc
Naozaj mi šťastie prialo .	prialo	3	Neut
Pršalo , slnko sa schovalo za mraky .	schovalo	4	Neut
Mauglí rýchlo zaspal na lôžku z lístia , ale Baghíra poúčal Balúa .	zaspal	2	Masc
Zmätene som zastal pri dverách izby .	zastal	2	Masc
Sledoval som ju pohľadom , až kým sa nestratila v dave .	nestratila	8	Fem
Lori sa naklonila a natiahla ku mne tvár .	naklonila	2	Fem
Blythe dobre vedela , že mama by ma pustila .	pustila	8	Fem
Zavrtela som hlavou , aby som tie myšlienky zahnala .	Zavrtela	0	Fem
V dôsledku rímsko - centralistickej tendencie zbierok prevzali do nich zostavovatelia i viaceré úplne alebo čiastočne sfalšované texty , ktoré však svojím obsahom zodpovedali stanoviskám a snaženiam reformátorov .	zodpovedali	23	Fem
Znovu ho objala .	objala	2	Fem
A prostredníctvom Faiky ma priviedla na stretnutie s Hádom .	priviedla	4	Fem
“ To je zbytočné , “ odvetila , prišla za mnou a objala ma okolo pliec .	objala	12	Fem
V ten deň som zaplávala osobný rekord .	zaplávala	4	Fem
Chris na mňa spoza knihy pozrel .	pozrel	5	Masc
Na chvíľu zavládlo ticho .	zavládlo	2	Neut
Nevidieť tú reláciu , povedal by som spolu s Freudom , že za všetkým je sexuálne pudenie , ale tých dvadsať minút mi otvorilo oči .	otvorilo	23	Neut
Pocítila prenikavú , pálčivú bolesť .	Pocítila	0	Fem
Ihneď ho ohúrila jej zmena k horšiemu .	ohúrila	2	Fem
Strojene sa usmial .	usmial	2	Masc
Abu sledoval , kam pozerá , a zbadal dievča .	zbadal	7	Masc
“ Zaplaťte , “ povedal Rýchlik , ktorý dal kolovať plaveckú čiapku .	povedal	4	Masc
Vrátila som sa domov , keď sa zvečerievalo .	zvečerievalo	7	Neut
Keď si Lori sadla do auta , sklonila sa nad volant , plecia sa jej roztriasli a ja som si zarazene uvedomil , že vzlyká .	roztriasli	15	Neut
Zrýchlil sa mi pulz a spomenula som si na sen , v ktorom ma bozkával .	Zrýchlil	0	Masc
Slnko akoby pripekalo teraz ešte silnejšie .	pripekalo	2	Neut
Zaštebotal dobrý deň a cmukol mužovi na líce veľký uslintaný bozk .	cmukol	4	Masc
Toľko stačilo , aby sa vydesilo aj dieťa .	vydesilo	5	Neut
Tá prezývka mu prischla preto , lebo sa v bazéne rútil ako rýchlik .	prischla	3	Fem
“ Keby som nevedela , že máte bezpečnostný systém , “ doberala som si Chrisa , “ preliezla by som plot a skočila dnu . “	preliezla	17	Fem
Možno si až teraz uvedomila , kam to jej klamstvo viedlo .	viedlo	10	Neut
“ Nikdy nevystúpim na Olymp , “ vravel Filovi .	vravel	7	Masc
Húf mojich postáv i muž , ktorý mi radil , aby som pohol mozgom , zmizli .	zmizli	15	Masc
Obrazovka načas zmĺkla .	zmĺkla	2	Fem
Chcel by sa stať prezidentom USA .	Chcel	0	Masc
Nepodarilo sa mi to .	Nepodarilo	0	Neut
Keď sa neskôr vracali domov a pozorovali hviezdy , vystrašil ich hrozný krik .	pozorovali	6	Masc
Steblo sa zlomilo a on skončil na chrbte .	zlomilo	2	Neut
Nemal som dôvod zapierať .	Nemal	0	Masc
Nestalo sa to prvý raz .	Nestalo	0	Neut
Maja s Rudkom sa práve vracali domov , keď sa strhol vietor .	strhol	10	Masc
Do slovenských častí Uhorska sa vtedy utiahla jedna časť českých emigrovaných protestantov a tu našli v používaní svoj vlastný spisovný jazyk presne tak , ako vo svojej českej vlasti .	utiahla	6	Fem
“ Môžeš , “ odvetilo sloníča .	odvetilo	4	Neut
Sprevádzali ho ďalší štyria strážcovia s vytasenými mečmi .	Sprevádzali	0	Masc
Zasmiala sa .	Zasmiala	0	Fem
Skutočnosť , že som na teba myslela , bola nebezpečná .	myslela	6	Fem
“ Kedykoľvek , “ odvetil Chris s úsmevom , zvrtol sa a plával k trénerovi .	zvrtol	9	Masc
Prikývla som a tuhšie ma privinul .	privinul	5	Masc
“ Na oslavu tvojho úspechu , “ dodala som nepresvedčivo .	dodala	7	Fem
“ Ocko ! “ zvolala Jazmína , keď sultán zmizol .	zmizol	9	Masc
Winston počúval obrazovku .	počúval	1	Masc
“ Čakali , že aspoň jeden z nás pôjde v ich šľapajach .	Čakali	1	Masc
Už na začiatku nás zblížila šťastná okolnosť .	zblížila	4	Fem
“ Mhm , “ zamrmlala som .	zamrmlala	4	Fem
Kalif sa nahol dopredu , očividne ho to zaujalo .	zaujalo	8	Neut
Ako sedemnásťročný sa stal okresným zakladateľom Antisexuálnej ligy mládeže , ako devätnásťročný navrhol nový druh ručného granátu , ktorý zaradilo do výzbroje Ministerstvo mieru a ktorý už pri prvej skúške jediným výbuchom zabil tridsaťjeden euroázijských zajatcov .	zaradilo	19	Neut
Keď uplynul tretí deň a ja som sa v ten večer konečne ocitol sám , bol som na pokraji nervového vyčerpania .	uplynul	1	Masc
Pskov — hoci šlo v prípade Pskova o mesto podriadené Novgorodu , napriek tomu jeho „ zázemie tvorilo územie veľké zhruba ako Flandersko .	šlo	3	Neut
V ten deň som sa ho nedozvedel , lebo dievčatko ku mne opäť zaujalo nepriateľský postoj drobnej šelmy .	nedozvedel	6	Masc
Veľmi ma to prekvapilo .	prekvapilo	3	Neut
Zrazu som začula klopkanie na okno , no neposkočilo mi srdce ako inokedy .	neposkočilo	8	Neut
Na chvíľu zavládlo ticho .	zavládlo	2	Neut
Baghíra zatajil dych .	zatajil	1	Masc
Keď sa raz rozhodla piecť v takú nezvyčajnú hodinu , nikto jej v tom nezabráni .	rozhodla	3	Fem
Spomenul som si na dve veci : na hysterickú eufóriu učiteľov po incidente , pri ktorom sa spomenulo meno mytologického božstva záhrobného sveta .	Spomenul	0	Masc
Zatiaľ čo sa Chris profesora na všeličo vypytoval , Rick si pedantne zapisoval každé jeho slovo .	zapisoval	12	Masc
Ale ja som nevedel , že by zomrel niekto z domu .	nevedel	3	Masc
Maja vyskočila , schytila Svetlanku a zakrútila sa s ňou dokola .	zakrútila	6	Fem
“ Zlatúšikovia moji , “ nariekala skormútene .	nariekala	5	Fem
Otrasený , ale zdravý sa z nej vymotal .	vymotal	7	Masc
Vedela , že ho má v hrsti .	Vedela	0	Fem
Zasmiala som sa .	Zasmiala	0	Fem
Mauglí sa však stále tvrdohlavo držal stromčeka .	držal	5	Masc
Mauglí tancoval Balúovi pred nosom a zrazu ho nečakane zasiahol do ňufáka .	zasiahol	9	Masc
Rozochvel som sa a pomyslel som si , že rovnako rozochvieť sa musela aj ona .	Rozochvel	0	Masc
Hrozne ma bolia kĺby a nestihla som spojenie . “	nestihla	5	Fem
" poznamenal .	poznamenal	1	Masc
Mestské zastupiteľstvo schválilo umiestnenie menších sôch šiestich patrónov Európy na Nádvorie Európy , ktoré je vo výstavbe .	schválilo	2	Neut
Približovala sa k nemu zohnutá , popolavo sivá postava , ktorá pripomínala kostlivca .	Približovala	0	Fem
V niekoľkých sekundách po prebudení sen i spomienka , ktorá ho podnietila , splynuli v jeho mysli v jedno .	podnietila	11	Fem
A hoci tú knihu ešte nedočítal , vedel , že práve toto je konečné Goldsteinovo posolstvo .	vedel	7	Masc
Takéto oduševnenie stačilo na to , aby som sa zmenil .	stačilo	2	Neut
Úľ sa vzďaľoval a jej sa zdalo , akoby pod ňou utekala zem .	utekala	11	Fem
Zasmial sa a ja som si uvedomila , že napätie pominulo .	pominulo	10	Neut
“ Kamže sa ponáhľate , “ prehovoril pavúk .	prehovoril	6	Masc
“ Prosím vás pekne ! “ zvolal lúčny koník Flip .	zvolal	6	Masc
Vtedy sa naraz ukázalo , že komunistická strana s jej zločineckými spôsobmi skrachovala .	ukázalo	3	Neut
“ Odmlčala som sa .	Odmlčala	1	Fem
Ale keď veľký vlk vopchal do košíka ňufák , bábätko sa zasmialo .	zasmialo	11	Neut
Postupne ju cítila čoraz silnejšie .	cítila	2	Fem
S čím som mala súhlasiť ? “ nechápala som .	nechápala	7	Fem
Keď ma zbadala , usmiala sa a zakývala mi .	usmiala	4	Fem
V nemocnici sa naňho vrhlo desať mravcov .	vrhlo	4	Neut
Blythe bola úžasná , odpustila mi , že som na ňu nakričala kvôli plesu .	nakričala	11	Fem
Neobjal ma , nepriblížil sa ku mne , ani nezavrel oči .	Neobjal	0	Masc
V rohu na sklápacom stole v pološere sa jasne lesklo sklené ťažidlo , ktoré tam kúpil na poslednej návšteve .	kúpil	15	Masc
V záhrade sa oslavovali narodeniny .	oslavovali	3	Fem
Kým Mauglí triasol Baghírom , aby sa prebudil , zjavilo sa obďaleč stádo slonov .	zjavilo	9	Neut
" Niekedy , " poznamenala , " pohrozia človeku niečím -- niečím , čomu nedokáže vzdorovať , na čo nedokáže ani pomyslieť .	poznamenala	4	Fem
Odhrnula som mokré plavky , prázdne kokakolové plechovice , ceruzky , listy vytrhnuté z notesa a knižku Kto chytá v žite so somárskymi ušami .	Odhrnula	0	Fem
Winston ležal mlčky .	ležal	1	Masc
Bolo to v jeden januárový deň , z popolavej oblohy padal jemný dážď .	padal	10	Masc
Mladá žena sa usmiala a na lícach sa jej urobili jamky .	usmiala	3	Fem
“ Alebo radšej s Aladinom , “ zaškriekal posmešne Jago .	zaškriekal	7	Masc
Mama rázne podišla k oknu .	podišla	2	Fem
Literárne činný od roku 1898 , jeho prvá kniha poviedok vyvolala roku 1903 senzáciu — bezpochyby spôsobom stvárnenia i výberom tém .	vyvolala	10	Fem
Ako sme vychádzali z miestnosti , nastal v triede všeobecný ruch .	nastal	6	Masc
Určite však videla , ako k nej zamieril a hádam aj pochopila , že jej niečo naznačoval .	naznačoval	16	Masc
Sadli si na rímsu a Maja zreteľne videla , čo sa dnu deje .	Sadli	0	Masc
Vtom Aladin zdvihol mešec .	zdvihol	2	Masc
Na povrchu hlainy sa ukázali špinavé bublinky a obecenstvo tlieskalo .	tlieskalo	9	Neut
Skryl som sa za obrovitý strom .	Skryl	0	Masc
Slnečný svit , ktorý prenikal nespočetným lístím , ich ešte stále pálil na tvárach .	pálil	11	Masc
Bežali do domu , aby zistili , či niečo nezmizlo .	nezmizlo	9	Neut
Maja sa naň lačno vrhla .	vrhla	4	Fem
Strážca prižmúril oči a poobzeral sa dookola .	prižmúril	1	Masc
So zábleskom nádeje častejšie myslel na O ' Briena .	myslel	4	Masc
Išlo to ako na bežiacom páse .	Išlo	0	Neut
Uršuľa sa usmievala , keď princa ťahali na morské dno .	ťahali	6	Fem
Lulu tigra najprv prekvapene sledovala , ale po chvíli sa rozosmiala .	rozosmiala	10	Fem
Lenže svedomie mi nedalo , a musela som jej niečo povedať .	nedalo	3	Neut
Mohutná posteľ pri okne bola zastlaná dotrhanými prikrývkami a na poduške chýbala obliečka .	chýbala	11	Fem
Vymenoval som štyri číslice , ktoré tvorili číslo mojej izby .	Vymenoval	0	Masc
Chytil ma za ruku a bežali sme dolu kopcom až k svetlám .	Chytil	0	Masc
Priplávala som ku kovovým schodíkom a s námahou som vystupovala von , keď ma striaslo .	striaslo	14	Neut
“ Je mi tak čudne , “ tíško zašepkala Snehulienka .	zašepkala	8	Fem
Keď auto odišlo , ulica sa vyprázdnila .	vyprázdnila	6	Fem
To sa Vilkovi náramne hodilo .	hodilo	4	Neut
Súžitie etník tu teda fungovalo na princípe spoločenstiev v ktorých jednotlivé zložky popri sebe slobodne existovali a zároveň sa ovplyvňovali , miešali a splývali .	existovali	15	Fem
Za okamih boli preč a na lúčke opäť zavládol mier .	zavládol	8	Masc
V poslednom čase ju Ministerstvo hojnosti veľmi obľubovalo .	obľubovalo	7	Neut
Patril Brucháčovi .	Patril	0	Masc
Nespýtal som sa ho , či sa pamätá na obdobie , keď som s ním každú nedeľu chodieval do bábkového divadla .	Nespýtal	0	Masc
Spočiatku som mala nepríjemný pocit , že sa na mňa všetci dívajú , ale trvalo to len moment .	trvalo	14	Neut
“ Áno , “ prerušil ma .	prerušil	4	Masc
Išla som k dverám jej izby : “ Volá Rick , “ zašepkala som .	Išla	0	Fem
Počul , ako Júlia zaťala zuby . " Asi by sme sa mali rozlúčiť , " poznamenal .	poznamenal	16	Masc
Pred okienkom do pivnice ležal lesklý tvor s červenými očami a nahlas funel .	ležal	4	Masc
“ Myslím to vážne , “ povedal a začervenal sa .	začervenal	8	Masc
Z dverí vykúkli ospalé včely .	vykúkli	2	Fem
Nevládal by bežať , nevládal by uderiť .	nevládal	4	Masc
Všetkým sa zdal veľmi zaujímavý , najmä pavúčici Hedvige .	zdal	2	Masc
Poslúchol som ju a podišiel k oknu .	podišiel	4	Masc
Zatiaľ čo sa Chris profesora na všeličo vypytoval , Rick si pedantne zapisoval každé jeho slovo .	vypytoval	7	Masc
Vytvoríme kapitálotvornú vrstvu , ktorá bude zárukou blaha ľudu , presvedčivo hlásal tvorca blaha svojich prívržencov .	hlásal	11	Masc
Zaželala mi , aby ma rýchlo preložili .	Zaželala	0	Fem
So žiarivým trojzubcom v mohutnej ruke sa nad nimi týčila ako predzvesť smrteľných bleskov .	týčila	9	Fem
Znamená to teda , že on je jediný , komu ešte zostala pamäť ?	zostala	11	Fem
To sa opakovalo niekoľkokrát .	opakovalo	2	Neut
Ochráni Jazmínu , nech by jej hrozilo čokoľvek .	hrozilo	6	Neut
“ Narušujú morálku našich detí , “ kričal do mikrofónu .	kričal	7	Masc
Jeho telom zalomcoval ukrutne bolestivý záchvat hrôzy .	zalomcoval	2	Masc
Blythe sa zasmiala .	zasmiala	2	Fem
“ Máš úplnú pravdu , “ odvetil Nassir .	odvetil	6	Masc
Pokračovala v nezmenenom tempe stále bližšie k jeho stolu .	Pokračovala	0	Fem
Keď sa mi posmievala , zmocňovala sa ma trpká zlosť , napriek tomu medzi nami nedochádzalo k scénam .	nedochádzalo	15	Neut
V dvanástom storočí spolu s Vladimírom Zaleským zatienila Rostov a usilovala sa o kolonizáciu severovýchodných území .	usilovala	10	Fem
Na Jazmínino prekvapenie predavač vytiahol obrovský ostrý dlhý nôž .	vytiahol	4	Masc
V tom polosvite som mal všetky dôvody myslieť si , že tam trčím zbytočne , aj keď človek , na ktorého som čakal , sa nevolal Godot .	nevolal	25	Masc
Objímal kmeň a hrdo zdvihol bradu .	Objímal	0	Masc
Možno tu zohrali určitú úlohu slová „ Si neskutočne milý “ .	zohrali	2	Neut
“ Ale , počkaj chvíľu , “ odvetil Mauglí .	odvetil	7	Masc
Keď sme všetko spratali , odšuchatala som sa do obývačky a prepínala kanály na televízore .	prepínala	11	Fem
Piateho mája sa začalo Pražské povstanie a z rádia sa ozývala výzva o pomoc .	ozývala	10	Fem
Nie ! “ zhrozene zvolala Wendy .	zvolala	4	Fem
Potom sa pomaly pobral opačným smerom .	pobral	3	Masc
Cieľom Strany nebolo len to , aby medzi mužmi a ženami nevznikali vzťahy vernosti , nad ktorými nemala moc .	nevznikali	11	Masc
“ Uhádla si , “ povedal Chris a obrátil sa ku mne .	Uhádla	1	Fem
Z maku vyšlo ako z lesa drobučké dievčatko .	vyšlo	2	Neut
Avšak rodine malého paviána sa nepáčilo , ako sa Jane správa k ich mláďaťu a nazlostení začali dievčinu prenasledovať .	nepáčilo	5	Neut
Trápila sa pre ne .	Trápila	0	Fem
Ja som zatiaľ porovnal jej tvár so Soninou .	porovnal	3	Masc
Maja znervóznela .	znervóznela	1	Fem
A správne pochopila moju stŕpnutosť .	pochopila	2	Fem
Dlho sedela na kraji lesa a pozerala , ako zlaté klasy zľahka povievajú v letnom vánku .	pozerala	6	Fem
Splývali pred mojím duševným zrakom v podobe Lori , ktorá bola ich poslednou metamorfózou .	Splývali	0	Fem
Aladin pokrčil plecami .	pokrčil	1	Masc
Na to neboli obyvatelia Makovej lúky zvyknutí a znervózňovalo ich to .	znervózňovalo	8	Neut
“ Prečo si to spravila ? “ skríkla som na ňu .	spravila	4	Fem
“ Čo by si chcela robiť v sobotu ? “ spýtal sa Chris a ja som na uchu zacítila jeho dych .	zacítila	18	Fem
Boli to prekrásne slová , ale zároveň ma vystrašili .	vystrašili	8	Neut
Pripadalo mu to , akoby sa džungľou rútili tisíce zvierat .	Pripadalo	0	Neut
Nateraz sa uzavrel pred vzdialenejšími zvukmi a počúval len kvákanie , ktoré sa valilo z obrazovky .	počúval	7	Masc
Okolo nás pulzovala noc a ozývali sa známe zvuky okolia : tlmený hukot čerpadiel v okolitých bazénoch .	ozývali	5	Masc
Slovná zásoba A sa vôbec nedala použiť na literárne účely a na politické a filozofické dišputy .	nedala	5	Fem
Chris sa držal vľavo , šiel v pruhu , ktorý rozhodne neviedol ku knižnici .	držal	2	Masc
Chceli zistiť , čo sa deje .	Chceli	0	Fem
Sedel na stoličke neprirodzene vzpriamene a jeho mocné prsia sa nadúvali a zachvievali , akoby mal čeliť nárazu vlny .	zachvievali	12	Neut
Potom sa jedného dňa prízemie vyprázdnilo .	vyprázdnilo	5	Neut
Prsty sa jej skrivili a nechty sa premenili na zahnuté pazúriská .	skrivili	3	Masc
Moje bunky sa rozochveli .	rozochveli	3	Fem
Srdce mu divoko bilo .	bilo	3	Neut
Bol som šťastný ako blška , že sa jej nič nestalo .	nestalo	10	Neut
Vonku zaznel dupot ťažkých čižiem .	zaznel	1	Masc
Strana , samozrejme , vyhlasovala , že oslobodila proletov z jarma .	oslobodila	7	Fem
Drobné žieňa s pieskovými vlasmi sa vrhlo na operadlo stoličky pred ňou .	vrhlo	6	Neut
Počula som tikanie nástenných hodín a vlastný dych .	Počula	0	Fem
Nadýchol sa .	Nadýchol	0	Masc
Uprostred noci sa zobudila , čo sa jej nikdy nestalo .	nestalo	9	Neut
Rozprávala , akoby jej vynechávalo srdce .	vynechávalo	4	Neut
To stačilo .	stačilo	1	Neut
Maja sa zasmiala .	zasmiala	2	Fem
Poznali ho všetky ženy , vedeli , o čo mu ide .	vedeli	5	Fem
V mysli mu mimovoľne naskočila ďalšia spomienka .	naskočila	4	Fem
Nakoniec si urobila z nosidiel trampolínu , začala skákať kotrmelce a nosidlá tak rozhojdala , že ich včielky sotva udržali .	urobila	2	Fem
Otvorila okienko , akože naňho zakričí , ale vzápätí si to rozmyslela .	rozmyslela	11	Fem
Tá za desaťročia sústredeného výskumu vyprodukovala stovky monografických a časopiseckých spracovaní danej témy .	vyprodukovala	5	Fem
Trošku sa pritom začervenal .	začervenal	3	Masc
“ Nehnevám sa , “ odvetila Makulienka .	odvetila	5	Fem
“ Zastavte svet , nech sa prestane krútiť ! “ zvolal .	zvolal	10	Masc
Podala mi pohár a ja som vystrúhal biedny úsmev .	Podala	0	Fem
Táto povinnosť sa však nevzťahovala na produkty , ktoré sa jednak priamo a jednak symbolicky týkali základných prejavov kresťanského kultu .	nevzťahovala	4	Fem
Najviac ma rozptyľovalo , že mi celý deň behal po rozume ten bozk .	rozptyľovalo	2	Neut
Pocítil som znechutenosť .	Pocítil	0	Masc
V tomto prestrojení si ma počkala pri Truhlíkovej posteli .	počkala	5	Fem
Oči jej vystúpili z jamiek a z vyškerených úst vypadali všetky zuby okrem jedného .	vystúpili	2	Neut
Keď pred správami zaznela trúbka , vždy to znamenalo víťazstvo .	znamenalo	8	Neut
Jazmína sa milo usmiala .	usmiala	3	Fem
Snehulienka práve piekla koláč .	piekla	2	Fem
Zvolila som nesprávne slová .	Zvolila	0	Fem
“ Ale keď kapitán Hook na tom trvá ! “ vysvetľoval John , starší z Wendiných bratov .	vysvetľoval	10	Masc
Zastavila ho .	Zastavila	0	Fem
Pokrčil plecami a podal mi Colu .	Pokrčil	0	Masc
Takto som kedysi čakával na Doloru .	čakával	3	Masc
Vtedy zdvihla hlavu .	zdvihla	1	Fem
Terk si začala priateľa väčšmi vážiť , ale Kerchak sa zlostil .	zlostil	10	Masc
Volala sa Znepokojenia .	Volala	0	Fem
Chvíľu trvalo , kým zbadali drozda .	trvalo	1	Neut
“ Haló ? “ ozvala som sa a moje podozrenie sa potvrdilo .	potvrdilo	11	Neut
Stala si na kameň a začala vrzúkať .	začala	5	Fem
V obrovských presýpacích hodinách princeznú Jazmínu zatiaľ zasypával piesok .	zasypával	7	Masc
Jej oddychovanie prezrádzalo , že opäť usína .	prezrádzalo	2	Neut
Považovala to za skvost vtipnosti a s potešením ho vzala do náručia .	vzala	9	Fem
“ Mimochodom , “ poznamenal chrobák , “ zabudol som sa predstaviť .	zabudol	8	Masc
Dobre sa bavíte ? “ spýtal sa Džafar .	spýtal	5	Masc
Vyzerala ako cievka nití .	Vyzerala	0	Fem
Dúfal som , že ju nečítal .	Dúfal	0	Masc
V Studiofilme sa povrávalo , že šéfa čochvíľa odvolajú ; označovali ho za liberálneho modernistu a bolo iróniou osudu , že najostrejšie na neho útočil týždenník Október .	povrávalo	3	Neut
Doteraz som sa učila , “ odvetila som , “ a bojím sa , že mi to vyfučí z hlavy . “	učila	3	Fem
Nikto ma nikam nepredvolal .	nepredvolal	3	Masc
Človek by si myslel , že som mu ponúkla sviatočný obed .	myslel	3	Masc
Ale ani to som neurobila .	neurobila	4	Fem
V tej izbe bývalo predo mnou niekoľko brigádnikov z mesta , predstaviteľov robotníckej triedy .	bývalo	3	Neut
“ Čakám na teba , “ odvetil .	odvetil	6	Masc
Rozumel som , čo mi povedala .	Rozumel	0	Masc
Pila som , lebo som sa bála , povedala mi .	Pila	0	Fem
Nadovšetko túžil po krajci chleba .	túžil	1	Masc
Mala som pocit bezpečia a veľmi sa mi to páčilo .	páčilo	9	Neut
Hypnotizujúce oči civeli do jeho vlastných .	civeli	2	Neut
Abu zakašlal .	zakašlal	1	Masc
Vnútri sa krásna kobylka rozdvojila a vyskočili z nej Bôľ a Zmätok .	rozdvojila	4	Fem
Opäť som zmenil názor , k čomu ma priviedlo niečo neočakávané .	zmenil	2	Masc
Snívalo sa Ferdovi o boji ?	Snívalo	0	Neut
Iba my s Chrisom sme tak zúrivo nepísali a nehrbili sa nad lavicami .	nehrbili	9	Masc
Komár unudene pozrel do trávy .	pozrel	2	Masc
“ Chodí spať ako slniečko , “ povzdychol si motýľ Emanuel .	povzdychol	7	Masc
Všetky prísady sa zmiešali a vznikla tmavá tekutina .	zmiešali	3	Fem
“ Naozaj ? “ zvolala prekvapená Snehulienka .	zvolala	4	Fem
“ Pozor ! “ zvolal jeden z chrobákov .	zvolal	4	Masc
“ Nebolelo ! “	Nebolelo	1	Neut
Zarazilo ma to .	Zarazilo	0	Neut
Koniec rebríka preťal okno a prelomil rám .	preťal	2	Masc
A Winstona najviac deprimovalo vedomie jeho vlastnej intelektuálnej menejcennosti .	deprimovalo	3	Neut
Zo zlatej čaše popíjal víno a džin mu masíroval nohy .	popíjal	3	Masc
Zasadalo zborové presbyterstvo	Zasadalo	0	Neut
“ Sledovala som ho na chate . “	Sledovala	1	Fem
“ Veru mohla , “ odvetila makovica .	odvetila	5	Fem
Neodvážila sa otvoriť oči a ja som pochopil , že očakáva niečo strašné .	Neodvážila	0	Fem
Pripadalo by mi znesiteľnejšie , keby kvôli nemu nespal ani Chris .	Pripadalo	0	Neut
Reformátori 11 . storočia však už dospeli k precíznejšej formulácii , ktorá , podľa nás , reprezentuje nimi presadzovanú snahu o čo najpresnejšie vymedzenie sfér vplyvu svetskej a cirkevnej moci .	dospeli	6	Masc
Ich obvinenia ma trápili .	trápili	3	Neut
Keď sa Šer Chán obzrel za seba , od strachu zareval .	zareval	10	Masc
Postupne sa zdvíhanie a klesanie ich hrudí spomalilo a prešlo do normálneho rytmu a s príjemným pocitom bezmocnosti sa od seba oddelili .	spomalilo	7	Neut
Na Makovej lúke panovalo ticho .	panovalo	3	Neut
Pozvala na ňu Blythe a Ricka a podávala moje obľúbené jedlá : zemiakovú kašu , pizzu , celozrnný chlieb , španielske chimichangas , makaróny so syrom a orechový koláč .	Pozvala	0	Fem
Sopky vreli , vyčíňali búrky a zemetrasenia , svet bol plný zmätku a veľkého zdesenia .	vreli	1	Fem
Po rokom 1044 sa nachádza správa o narodení Vseslava , ktorému matka na radu volchvov uviazala amulet , spôsobiaci že z chlapca vyrástol krutý a nemilosrdný človek .	uviazala	15	Fem
“ Zachránil som nás ! “	Zachránil	1	Masc
Vďaka týmto skúsenostiam pre mňa teoreticky neexistovalo nijaké tajomstvo súvisiace s túžbami , ktoré nútia muža pokúšať sa o zblíženie so ženou .	neexistovalo	6	Neut
Dnes meškáš , povedala , bála som sa , že neprídeš .	bála	5	Fem
Najprv zamierila za Flipom .	zamierila	1	Fem
Kŕčovito sa pridržiaval kôry , aby ho neodfúkol vietor .	pridržiaval	2	Masc
Veselo sa prechádzali medzi hosťami , usmievali sa a povzbudzovali ich , aby sa u nich cítili ako doma .	prechádzali	2	Masc
Flip zívol .	zívol	1	Masc
Budem škaredá ! “ vravela a nedočkavo obracala ošúchané listy .	obracala	7	Fem
Keď to povedal , položil mi nečakanú otázku .	položil	4	Masc
Obom sa chcelo spať .	chcelo	2	Neut
Winstonovi sa zapichla do ruky ihla .	zapichla	2	Fem
Zasmial sa a na druhý deň mi ich priniesol .	Zasmial	0	Masc
Dokázala to !	Dokázala	0	Fem
“ Rick ? “ spýtala som sa prekvapene .	spýtala	4	Fem
Na Makovej lúke sa nič nedialo , a tak zamierila do lesa .	nedialo	5	Neut
Na dvore som hadicou napustila slnkom zohriatu vodu a začala som šampónovať auto .	napustila	4	Fem
Nikdy nič podobné nevidel .	nevidel	3	Masc
Keď pozrela pod seba , zistila , že uviazla v pavúčej sieti .	zistila	5	Fem
Všetky zvieratká bežali do bezpečia , no Polly letela po zobák vody .	bežali	2	Neut
Pomaly som jej vyzliekol kombiné .	vyzliekol	3	Masc
Ostrihomská synoda tiež zakázala , aby bol za kňaza vysvätený otrok ( sluha ) .	zakázala	3	Fem
O dvadsať minút nastalo úplné zatmenie .	nastalo	3	Neut
Zároveň však Cluny urobilo veľký krok na ceste k libertas , lebo vytvorilo spoločenstvo ( zväčša ) úplne slobodných kláštorov , ktoré nepodliehali laikom .	urobilo	3	Neut
S námahou som vytiahol kľúč .	vytiahol	3	Masc
A zajatcov pekne pribúdalo .	pribúdalo	3	Neut
“ Takto to vyzerá na Mesiaci , “ povedala som Cheryl Wagnerovej , maturantke , čo sedela vedľa mňa .	sedela	16	Fem
Vtedy som sa naposledy ocitol tak blízko neho .	ocitol	4	Masc
Bola noc a biele tváre a šarlátové transparenty zalievalo zlovestné svetlo .	zalievalo	8	Neut
Vzduch preťal prenikavý hlas trúbky .	preťal	1	Masc
Netušili však , akí je múdry !	Netušili	0	Masc
Jej prenikavý krik Vilka prebral .	prebral	4	Masc
Aladin pristál na hromade šperkov .	pristál	1	Masc
Bál som sa , že ma skritizuje za názov , ktorý som prevzal z jednej Čechovovej poviedky .	Bál	0	Masc
Preletela na list toho neznámeho tvora a sadla si vedľa neho .	sadla	7	Fem
Nenávidel ma .	Nenávidel	0	Masc
Opäť zdvihol zrak na portrét Veľkého brata .	zdvihol	1	Masc
Ale sukničku s volánikmi horko ‐ ťažko uniesla .	uniesla	7	Fem
Prikrčená som vyliezla na vrchol strechy , chvíľu som balansovala a opatrne som zliezla na opačnú stranu .	vyliezla	2	Fem
“ S čím ? “ zvolala zúfalo .	zvolala	5	Fem
Polovicu zo všetkého , čo vo mne je , mám z domu , z toho , čo sa doma povedalo , napríklad pri stole .	povedalo	19	Neut
Vtedy som ju otočil k sebe .	otočil	3	Masc
Keď som mala bundu na sebe , zistila som , že ju nepotrebujem .	zistila	7	Fem
Nezhromaždilo sa tam veľa ľudí .	Nezhromaždilo	0	Neut
Nákladné autá ešte stále prechádzali okolo a ľudia ešte stále na ne hladovo civeli .	prechádzali	4	Neut
“ Vyhral si ! “	Vyhral	1	Masc
Telefón zazvonil vo chvíli , keď som začal hľadať šach .	zazvonil	1	Masc
Takého odporného tvora ešte nevidela .	nevidela	4	Fem
Poprosila ma o cigaretu .	Poprosila	0	Fem
Kalich zvončeka , kde strávila noc , sa knísal vo vetre a bolo tam chladno .	knísal	8	Masc
Srdce mu divoko bilo .	bilo	3	Neut
Raz som chytil muchu a vlastnoručne som ju hodil do pavučiny , ale nevidel som , že by sa objavil nejaký pavúk , ktorý by ju zožral .	nevidel	13	Masc
Natiahla sa k zásuvke na mojej strane a prehŕňala sa v nej , až kým nenašla škatuľku cigariet .	nenašla	15	Fem
Stalo sa to len včera večer a Rick sa určite pred chalanmi nevyťahoval , ako vlažne som ho odbila .	odbila	18	Fem
Predal mi ich za cenu , aká bola uvedená na novinách .	Predal	0	Masc
Otvoril som kufor .	Otvoril	0	Masc
Čoskoro som však zapochybovala o svojom odhodlaní , lebo pred školou ma dobehol Chris a chytil za ruku .	zapochybovala	3	Fem
Trápilo ma niečo iné : musím zvíťaziť nad zvieraťom , ktoré sa vo mne prebudilo .	Trápilo	0	Neut
Abu strčil hlavu do mešca .	strčil	1	Masc
Nateraz sa uzavrel pred vzdialenejšími zvukmi a počúval len kvákanie , ktoré sa valilo z obrazovky .	uzavrel	2	Masc
Ani nemukla a bez pohnutia sa dívala na spiace dieťa .	nemukla	1	Fem
Náhlila som sa do kabínky pri bazéne , napchala som mokré veci do vaku , obula si mokré tenisky a vybehla von .	Náhlila	0	Fem
Ležala som na doske a pozerala naňho .	pozerala	5	Fem
Sviečky som vložila do mosadzných svietnikov a postavila ich na stôl .	vložila	2	Fem
Ležala som na doske a pozerala naňho .	Ležala	0	Fem
Domčeky vyzdobili girladnami a Vilko s Emilom urobili na jednom krtinci kĺzačku , kde šantili deti .	šantili	14	Neut
Lori nemala ani najmenšie podozrenie , že vo mne sa prebudilo zviera .	prebudilo	10	Neut
Keď však Winston opravoval pôvodný plán , znížil číslo na 57 miliónov , aby vyhovel bežným požiadavkám na prekročenie kvóty .	vyhovel	14	Masc
“ Pusti mi chvost , ty tupec , “ skríkol Šer Chán .	skríkol	9	Masc
Svätojánska muška mala tenulinký hlások a Maja ju takmer nepočula .	nepočula	9	Fem
Sledovalo línie Lorinho tela , hltalo ho očami .	Sledovalo	0	Neut
Tváril som sa , že odchádzam spokojný , a v tom bol paradox .	Tváril	0	Masc
Ten chlapec si doň predtým vopchal žabu .	vopchal	5	Masc
Na chvíľu som sa započúval do ticha na schodišti .	započúval	4	Masc
Otočil sa ku mne a nedopovedal .	nedopovedal	5	Masc
Verila , že neurobím to čo ona .	Verila	0	Fem
Človek by si myslel , že som mu ponúkla sviatočný obed .	ponúkla	8	Fem
Akýsi muž mi povedal , že odišla pred hodinou .	povedal	3	Masc
Znehybnel som , ležiac na boku : to vzlykala Marga .	Znehybnel	0	Masc
Myseľ mi zaletela k Lori .	zaletela	2	Fem
Tarzana urazilo , že sa Kerchak hnevá a utiekol do džungle .	urazilo	1	Neut
Nasledovali ďalšie veci , ktoré boli podľa Sergeja podpichovaním na Cerberovu adresu , hoci jeho meno sa tam nespomínalo .	nespomínalo	18	Neut
Splašené zviera takmer okamžite zastalo .	zastalo	4	Neut
Aby ma Chris nepovažoval za decko pretože , nemám mamin súhlas , nič som mu nevravela .	nepovažoval	3	Masc
Najdivokejšie vrieskali školopovinné deti .	vrieskali	1	Neut
Chris pokrútil hlavou , akoby si to rozmyslel .	pokrútil	1	Masc
Zviera síce svojím výzorom naháňalo hrôzu , no Gaston bol presvedčený , že ho aj tak zabije a Bela oľutuje deň , keď sa zaňho odmietla vydať .	naháňalo	4	Neut
Chris zažmurkal .	zažmurkal	1	Masc
Opatrne si sadol vedľa na stoličku a uprene sledoval Radžu .	sadol	2	Masc
Tak sa hovorievalo .	hovorievalo	2	Neut
Robili taký rámus , že sa ich rev ozýval široko ‐ ďaleko po celej džungli .	ozýval	8	Masc
Netrvalo dlho a obaja lavínu skyprili , takže sa párik cvrčkov ľahko dostal von .	Netrvalo	0	Neut
Maja zaletela na breh , aby si na chvíľu odpočinula .	zaletela	1	Fem
“ Mama mi ho poslala .	poslala	4	Fem
Podarilo sa mu vyšklbnúť mu niekoľko pierok .	Podarilo	0	Neut
Zostalo ti deväť , desať , jedenásť zubov .	Zostalo	0	Neut
Winstona predovšetkým dráždilo , že v tom rámuse hlasov sotva počul Parsonsove slová , takže ho musel sústavne žiadať , aby svoje nezmysly opakoval .	dráždilo	2	Neut
Jazmína neveriacky zažmurkala .	zažmurkala	2	Fem
To je tajomstvo , povedalo , neprezradím ho každému .	povedalo	4	Neut
Dieťa prikývlo , akoby mu rozumelo .	rozumelo	5	Neut
Ťažko sa mi dýchalo , trápilo ma určité tušenie .	dýchalo	3	Neut
Netrvalo dlho a opäť sa ozvalo zvonenie .	ozvalo	5	Neut
Potichučky som vyliezla hore a prešmykla sa dnu .	prešmykla	5	Fem
Klotilda pochopila .	pochopila	1	Fem
Každý pohlavný styk , ktorému nič nechýbalo , bol vzburou .	nechýbalo	6	Neut
Lori po rusky nerozumela , ja som občas zachytil nejaké slovo .	zachytil	8	Masc
“ Myslíš , že nás spoznal ? “ spýtal sa Chris , keď sme sa prestali triasť .	spýtal	8	Masc
“ Z nás sa nikdy nestanú piráti , “ hrdo vyhlásila Wendy .	vyhlásila	10	Fem
Stalo sa to len včera večer a Rick sa určite pred chalanmi nevyťahoval , ako vlažne som ho odbila .	Stalo	0	Neut
Zároveň som zatúžil po ďalšom pohári whisky .	zatúžil	2	Masc
“ Nenávidí Mauglího a túži po pomste , “ vysvetľoval Baghíra .	vysvetľoval	9	Masc
“ Môjmu kráľovskému uchu sa donieslo , že chceš ostať v džungli . “	donieslo	5	Neut
S odporom hľadel na bielu masu pred sebou .	hľadel	2	Masc
“ Vážne som chcela ísť po tréningu za tebou , ale vyfučalo mi to z hlavy .	vyfučalo	11	Neut
Pskov — hoci šlo v prípade Pskova o mesto podriadené Novgorodu , napriek tomu jeho „ zázemie tvorilo územie veľké zhruba ako Flandersko .	tvorilo	17	Neut
Maja sa ponáhľala za ním .	ponáhľala	2	Fem
Švihák Pedro sa v letku obrátil a zmizol kdesi v diaľke .	zmizol	7	Masc
Netvor na ňu hľadel rovnakým pohľadom .	hľadel	3	Masc
Preglgla som .	Preglgla	0	Fem
Lori bola vedľa mňa , aby mi potvrdila , že Irma , ktorú pohltilo nebo , teraz letí do iného sveta .	pohltilo	13	Neut
Jaskyne ma vždy lákali .	lákali	3	Fem
Zavrela znútra dvere na školskej budove , zastrčila závoru , vzala ma za ruku a viedla za sebou .	vzala	10	Fem
Očakávala som niečo iné , ona však nevyslovila jedinú výčitku .	nevyslovila	7	Fem
Modlime sa a pomáhajme im na ich ceste , aby sa aj ich srdce zapálilo víťazstvom lásky , pravdy , nádeje a života .	zapálilo	14	Neut
Na druhej strane položili telefón .	položili	3	Masc
Rozlomila ju na dve polovice a jednu dala Winstonovi .	Rozlomila	0	Fem
Cez kombinézu cítil jej prsníky , zrelé , ale pevné .	cítil	2	Masc
Pokrčila som plecami .	Pokrčila	0	Fem
“ Poď sem , Chris , “ zašepkala som .	zašepkala	7	Fem
Princezná vzala tigríča do svojej postele .	vzala	1	Fem
Pani učiteľka sa usmievala a pousádzala ich okolo stola .	pousádzala	5	Fem
Položila telefón .	Položila	0	Fem
Dejiny sa zastavili .	zastavili	2	Fem
Skôr či neskôr sa Abdullah vráti , ale dovtedy sa na Aladina usmialo šťastie .	usmialo	12	Neut
Na chvíľu zavládlo trápne ticho , ale potom mu mama podala ruku .	zavládlo	2	Neut
Maja vyskočila , schytila Svetlanku a zakrútila sa s ňou dokola .	schytila	3	Fem
Začala som s kapitolou o zatmení a snažila sa spomenúť na to , čo som videla .	Začala	0	Fem
“ Ostanem tu ! “ kričal .	kričal	5	Masc
Snehulienka váhala .	váhala	1	Fem
A hneď volala motýľa Emanuela , aby ju tam v noci nenechával .	nenechával	11	Masc
Zasmial sa a ja som si uvedomila , že napätie pominulo .	Zasmial	0	Masc
Prekvapilo ma to .	Prekvapilo	0	Neut
Bol plochý a hranatý , na chrbte mal pekný vzor a zdalo sa , že spí .	zdalo	11	Neut
Zdalo sa mu , že to tu pozná .	Zdalo	0	Neut
Pristúpil k zrkadlu bližšie .	Pristúpil	0	Masc
Tekla sedela prikrčená v kúte a zlomyseľne pozorovala jej márne úsilie .	sedela	1	Fem
Mama zbledla .	zbledla	1	Fem
Nezjavil sa mi tam Hádes .	Nezjavil	0	Masc
Toľko stačilo , aby sa vydesilo aj dieťa .	stačilo	1	Neut
Strážca prižmúril oči a poobzeral sa dookola .	poobzeral	4	Masc
Po rokom 1044 sa nachádza správa o narodení Vseslava , ktorému matka na radu volchvov uviazala amulet , spôsobiaci že z chlapca vyrástol krutý a nemilosrdný človek .	vyrástol	22	Masc
Rudko a Flip by s ním najradšej vyrazili dvere .	vyrazili	7	Masc
Princezná Jazmína pozerala z okna do hlbokej púštnej noci .	pozerala	2	Fem
Syme zmizol .	zmizol	1	Masc
Zrazu mi napadlo , že vtedy nás to zblížilo , keď bral vážne môj problém s obrátkou .	zblížilo	8	Neut
Zobrala ďalšie dve dievčatá , ostatných nechala tak a celé popoludnie špehovali dajakého čudáka .	Zobrala	0	Fem
Napokon chytil vak a hodil mi ho na kolená .	chytil	1	Masc
Majine jemné krídelká sa jagali ako perly a zlatisté telíčko na slnku len tak žiarilo .	jagali	4	Neut
Spytovaní náhodní chodci i sociológovia a ďalší odborníci sa vzácne zhodli .	zhodli	10	Masc
Pedro stál práve pred zrkadlom a obdivoval sa .	obdivoval	6	Masc
Uvedomila som si , že ma nepočúval .	nepočúval	6	Masc
Anita jej to sľúbila a zložila .	sľúbila	3	Fem
Potom dodala známu vec s ujom a v priestore môjho mozgu zaburácalo slovo „ impotent “ .	zaburácalo	11	Neut
Namáhavo som preglgla .	preglgla	2	Fem
Obliekal sa čisto , nosil košeľu s kravatou .	nosil	4	Masc
Nechodieval k nemu nikto okrem stareny v širokých nohaviciach .	Nechodieval	0	Masc
Lenže milé bábätko trhalo Jane obrázok z rúk .	trhalo	3	Neut
Keď videl , ako sa bavia , hneď sa chcel pridať .	videl	1	Masc
Natiahla sa k zásuvke na mojej strane a prehŕňala sa v nej , až kým nenašla škatuľku cigariet .	Natiahla	0	Fem
Nešlo to .	Nešlo	0	Neut
Ale Lori pochopila zmysel mojich slov po svojom .	pochopila	2	Fem
Marga nebola doma .	nebola	1	Fem
Pozrela som na ňu a napravila som si zelenú košeľu , ktorú som si dala na rande .	napravila	5	Fem
“ Uf ! “ zamrmlala som .	zamrmlala	4	Fem
“ Isteže , “ povedal Chris , keď ma odtiahla nabok .	odtiahla	9	Fem
Veľa sa naučila a nazbierala dôležité skúsenosti .	nazbierala	4	Fem
Odišla som preč , nechala som ho tam .	nechala	4	Fem
Vyklonila som sa a pobozkala ho na ucho .	pobozkala	4	Fem
“ Tu som , Amy ! “ zakričala škodoradostne .	zakričala	7	Fem
Vtom som pozrela hore a zbadala pri bazéne Chrisa .	zbadala	5	Fem
Žiarlivá kráľovná sa hrozne nahnevala , že jej nevlastná dcéra je krajšia ako ona , a prikázala poľovníkovi , aby princeznú zabil .	nahnevala	4	Fem
Do hrdinského zápasu o dva litre mlieka som sa zapojil , keď sa narodil Tom .	zapojil	9	Masc
" Vlastne by to na veci nič nezmenilo , " poznamenal .	nezmenilo	7	Neut
Urobila som adventný veniec a zavesila na dvere .	zavesila	5	Fem
Rozbúchalo sa mi srdce .	Rozbúchalo	0	Neut
Očakával som ich .	Očakával	0	Masc
Keď z jabĺčka odkvapkal jed , zjavila sa na ňom smrtka .	odkvapkal	3	Masc
So zatajeným dychom sledovala , ako Snehulienka zahryzla do jabĺčka .	zahryzla	7	Fem
Veľmi som chcela , aby ostali spolu , no cítila som sa pri nich trochu navyše .	chcela	2	Fem
A on stále striehol na mramorových schodoch podstavca bez sochy .	striehol	3	Masc
Pod gaštanom stálo niekoľko stolov a stoličiek a za živým plotom presvitala tehlová budova hostinca .	stálo	2	Neut
Povedala , že sa cíti unavená a na druhý deň musí zavčasu vstávať .	Povedala	0	Fem
Niekedy plakala .	plakala	1	Fem
A zaúčinkovalo to .	zaúčinkovalo	1	Neut
Šikovne využil pobyt folklórnych skupín a súborov z celého Slovenska v Bratislave , ktoré sem chodili na náklady Opusu alebo rozhlasu nahrávať platne .	chodili	15	Masc
To Maju nahnevalo .	nahnevalo	2	Neut
Titan Ľadovec dokončil jeho dielo a zmrazil lávu dychom .	zmrazil	6	Masc
Pravdepodobne sa napokon nevyrobili vôbec nijaké topánky .	nevyrobili	3	Fem
A tento rok to prišlo zas .	prišlo	4	Neut
“ A teraz zavri oči , “ prikázal .	prikázal	7	Masc
Keď sa však priblížila , uvidela v tráve svetlovlasé spiace dievčatko v červených šatôčkach .	priblížila	3	Fem
“ No ak to nezistí , nezabije nás , “ navrhol Bôľ .	navrhol	10	Masc
“ Mohla by som doplniť aj najhulvátskejší ? “ dodala Aziza .	dodala	9	Fem
Globalizácia nevznikla sama od seba a nevznikla ani náhodou .	nevznikla	6	Fem
Dieťa prikývlo , akoby mu rozumelo .	prikývlo	1	Neut
Ďakujem , “ odvetila som a vymanila si studené prsty spod jeho rúk .	odvetila	3	Fem
Makové zrniečka v nej zašušťali , ako keď sa presýpajú myšlienky .	zašušťali	4	Neut
Veľmi sa mi páčilo aj skadarské nárečie , aj skadarskí básnici .	páčilo	3	Neut
Nemám čas , “ odvrkla som .	odvrkla	4	Fem
A predsa , po prečítaní vedel , že nie je blázon .	vedel	5	Masc
“ Vy máte šťastie ! “ povedala mora Maji , lebo vedela , čo znamená stretnutie so škriatkom kvetov .	vedela	11	Fem
Pred mojím duševným zrakom sa čosi zablyslo .	zablyslo	6	Neut
Hlas sa odmlčal .	odmlčal	2	Masc
Keď Tayerle povedal slovo dvojica , Chris sa otočil a spýtavo na mňa pozrel , pričom nadvihol obočie .	otočil	8	Masc
A dodala : Narodila som sa v internácii .	dodala	1	Fem
Zrazu však vyšľahli obrovské plamene a vyrazili princovi štít z ruky .	vyrazili	6	Masc
Chúďa Maja ronila trpké slzy .	ronila	2	Fem
Človeka to bohvieako nezaujímalo , popíjal z pohára a škriabal na papier tie svoje znaky .	škriabal	9	Masc
Mravčia masérka Tina mu už polhodinu masírovala nohy .	masírovala	6	Fem
Práve poletovala medzi bielymi jazmínovými kvetmi a nevšimla si jemnulinké a tenulinké vlákna napnuté medzi konárikmi .	nevšimla	7	Fem
Mala pravdu a ja som to dobre vedel .	Mala	0	Fem
Pri ďalšej skúške vymenila slák za golfovú palicu , takže Klotilda musela kričať a prišla o hlas .	musela	11	Fem
Zabudla na cigaretu , ktorá jej zhorela , a pozorne ho počúvala .	Zabudla	0	Fem
Ako na zavolanie sa zjavila Meg .	zjavila	4	Fem
Povedal , že môjho starého otca zabili , lebo tak prikázal Hádes .	prikázal	10	Masc
Rozbehla som sa a skočila , pričom sa hladina rozbúrila ako po výbuchu .	rozbúrila	9	Fem
Keď konečne nastala správna konštelácia hviezd , Hádes vyslobodil Titanov z podzemného väzenia .	vyslobodil	8	Masc
Uvítala každú príležitosť , aby som vypadla z mesta na čerstvý vzduch .	vypadla	6	Fem
“ To je moja mama , “ povedalo .	povedalo	7	Neut
Zaujalo ma to ! “ povedala so smiechom Jazmína .	Zaujalo	0	Neut
A veselili sa , kým nezapadlo slnko .	nezapadlo	5	Neut
“ Asi som ho zabudol u vás na streche ! “	zabudol	4	Masc
Mala som pocit bezpečia a veľmi sa mi to páčilo .	Mala	0	Fem
“ To je idiotský nápad ! “ zvolal , ale videla som , že sa mu to páči .	zvolal	7	Masc
Jeho bezstarostný pohľad ma však varoval .	varoval	5	Masc
Zhlboka sa nadýchla , poriadne si vydrhla predné nohy a ostala nehybne sedieť na liste ako prikovaná .	vydrhla	6	Fem
Vrátila sa za svitania a hneď si ľahla .	ľahla	7	Fem
Za ním vyšla starena , ktorá sa hneď skryla pod dáždnik .	skryla	8	Fem
Zebríčaťu sa nesmierne páčilo , keď mu prečesávala hrivu .	páčilo	3	Neut
Trvalo to až do Drača .	Trvalo	0	Neut
Vtom sa mladík zháčil .	zháčil	3	Masc
Keď sa ku mne sklonila , že ma pobozká , zacítila som pach alkoholu .	sklonila	4	Fem
Miestnosť bola priveľmi stiesnená , lebo všetky steny dookola podopierali nespočítateľné množstvo zaprášených rámov naukladaných jeden na druhý .	podopierali	9	Fem
“ Presne , “ povedala a zadívala sa na mňa .	zadívala	6	Fem
Všetci sa uveličene zahľadeli hore .	zahľadeli	3	Masc
“ To sa zle skončí , “ kuvikal dážďovka Vendelín , ale nikto ho nepočúval .	kuvikal	7	Masc
Tešila som sa , ale zároveň mi chýbali tie chvíle , keď sme po večierkoch spolu posedeli a rozoberali každý detail .	Tešila	0	Fem
Vrátila sa za svitania a hneď si ľahla .	Vrátila	0	Fem
Winstona bolestne bodlo pri srdci .	bodlo	2	Neut
Majine jemné krídelká sa jagali ako perly a zlatisté telíčko na slnku len tak žiarilo .	žiarilo	14	Neut
Navyše nepriateľskú osu hral jeho kamarát hnojník Kurt .	hral	3	Masc
“ No dovoľ ! “ vyhŕkla som .	vyhŕkla	5	Fem
“ Určite ťa zaskočila moja výnimočná krása , “ zašveholilo .	zašveholilo	9	Neut
Chris sa poškriabal na hlave a rozpačito na mňa pozrel .	pozrel	9	Masc
Rozčúlil sa , že ho vyrušujem po pracovnom čase .	Rozčúlil	0	Masc
“ Nie , “ odvetila som .	odvetila	4	Fem
Trvalo to tri týždne .	Trvalo	0	Neut
Niečo ostro cvaklo .	cvaklo	2	Neut
Vilko sa v tej chvíli prebral .	prebral	5	Masc
Ich vedúca im čosi nahlas rozprávala v ich jazyku .	rozprávala	5	Fem
Aladin si vzdychol , odľahlo mu , že mal tentoraz šťastie .	odľahlo	4	Neut
Netrvalo dlho a opäť sa ozvalo zvonenie .	Netrvalo	0	Neut
Chabo som sa zasmiala a zadívala sa do zeme .	zasmiala	3	Fem
A pred očami sa mi zjavila Lorina tvár .	zjavila	5	Fem
Formulácia „ Volumus , ut episcopi habeant potestatem . . . “ implikuje interpretáciu , že biskupi , vykonávali svoj úrad z vôle panovníka , že on im udeľoval mandát na reálne pôsobenie v ich úrade .	udeľoval	28	Masc
Tá otázka ma zmiatla .	zmiatla	3	Fem
Chlapci sa vyšplhali z rokliny , no len čo zastali Hádesovi pri nohách , premenili sa na Bôľ a Zmätok .	premenili	14	Masc
“ Čo ? “ spýtal sa , akoby pristál z Marsu .	spýtal	4	Masc
Koleso sa krútilo a náš vozík pomaly stúpal na vrchol .	krútilo	2	Neut
Bosorka si škodoradostne pomädlila ruky .	pomädlila	3	Fem
Vždy povstali noví a noví zadubenci , ktorí sa mu dali zviesť .	povstali	1	Masc
Ťažko by pri nich obstál nejaký anonym .	obstál	4	Masc
Odľahlo mi .	Odľahlo	0	Neut
Zastupiteľstvo súhlasilo s umiestnením vo vojenskom kostole .	súhlasilo	1	Neut
Opantal ho pocit absolútnej bezmocnosti .	Opantal	0	Masc
Potom pozrel hore .	pozrel	1	Masc
Nilus bol skôr predstaviteľom východného typu mnícha , v osobe ktorého sa spájala vysoká miera asketizmu s rovnako vysokou úrovňou vzdelanosti a kvality duchovného života .	spájala	12	Fem
Schytil jeden z mečov a zahnal sa na Džafara .	zahnal	5	Masc
Povedal som to nezrozumiteľnou , smiešnou ruštinou .	Povedal	0	Masc
“ Nemyslím , “ odvetila som .	odvetila	4	Fem
Ešte chvíľu na mňa skúmavo s úsmevom hľadel .	hľadel	7	Masc
Keď Shannon otvorila dvere , sprisahanecky ma objal okolo pliec a vliezol na zadné sedadlo .	vliezol	11	Masc
V tých miestach sa nikdy neobjavili divé kačice .	neobjavili	5	Fem
Jemu to pripadalo ako večnosť .	pripadalo	2	Neut
Marga odchádzala , strácala sa v dave , autobus ju viezol do ktorejsi dediny v nížine .	strácala	3	Fem
“ Dostaneš možnosť , “ ubezpečoval ho Fil .	ubezpečoval	5	Masc
Ukrutne sa zľakli a hneď to hlásli svojmu veliteľovi .	hlásli	6	Masc
Kŕč povolil .	povolil	1	Masc
Oznámila mi , že ma pozýva .	Oznámila	0	Fem
“ Vyzeráš , akoby si tu mysľou ani nebola . “	nebola	8	Fem
Už dávno som stratil kontakt so svetom kina a v nových televíziách ma nikto nepoznal .	nepoznal	14	Masc
Zakrátko si Makulienka obliekala novú sukničku s volánikmi a motýľ Emanuel frak s dlhými krídlami .	obliekala	3	Fem
Kalif sa tváril smutne .	tváril	2	Masc
Na lúke pred stromom sa ozývalo funenie a nejasné hlasy .	ozývalo	5	Neut
Bavilo ma písať kompozície a na vynikajúcom skalickom gymnáziu boli veľmi dobré podmienky pre kultúru .	Bavilo	0	Neut
Vrelo to vo mne .	Vrelo	0	Neut
Zviera vo mne zavylo .	zavylo	3	Neut
Išla som k dverám jej izby : “ Volá Rick , “ zašepkala som .	zašepkala	12	Fem
Nakukol pomedzi húštinu a uvidel troch tvorov v šatách namiesto kožušiny .	Nakukol	0	Masc
Keď Šer Chán narátal do desať , otvoril oči .	narátal	3	Masc
“ Som včela , pane ! “ zvolala výhražne .	zvolala	7	Fem
Lori sa červenala .	červenala	2	Fem
Odtiahla som sa .	Odtiahla	0	Fem
Páčilo sa mu , že je kapitánom nášho tímu .	Páčilo	0	Neut
" začal opatrne .	začal	1	Masc
Už dávno som stratil kontakt so svetom kina a v nových televíziách ma nikto nepoznal .	stratil	3	Masc
Vystrela k nemu zdravú ruku a on jej pomohol na nohy .	Vystrela	0	Fem
Keď leteli okolo sladko rozvoniavajúceho jazmínového kra , neodolali a sadli si naň .	sadli	10	Masc
Pripomínal jej trochu Teklu a chcela rýchlo odletieť .	chcela	5	Fem
Potkany by ho určite napadli a zakrátko by ho obžrali na kosť .	obžrali	9	Masc
Prvý deň sa deťom v škole veľmi páčilo !	páčilo	7	Neut
Chcel byť vtipný , ale rozzúrilo ma to .	rozzúrilo	5	Neut
Sestrička , ktorá si uvedomila , že ju o niečo okradol , tíško zanariekala .	zanariekala	13	Fem
Nezdalo sa mi , že veštia nejaké zásadné zmeny .	Nezdalo	0	Neut
“ Možno by sa princeznej páčili nové šaty , “ navrhol Nassir .	páčili	5	Fem
Vysvetľovala to takto :	Vysvetľovala	0	Fem
Netrvalo dlho a vedľa nej sa pod veľkým černicovým kríkom zjavil tučný svetlohnedý pavúk .	Netrvalo	0	Neut
Poznala som aj všelijaké iné historky , podozvedala som sa ich , keď k mame chodili na návštevu ženy .	chodili	15	Fem
Povedala , že by sme mali odísť bez rozlúčky , nechcela , aby sme nechali Irme odkaz , kam ideme , a ja som pozbieral odvahu .	nechcela	10	Fem
Znamenalo to , že mama ma nepustí do školy .	Znamenalo	0	Neut
Maja volala o pomoc , čo jej hrdlo stačilo .	stačilo	8	Neut
Nedávalo to zmysel .	Nedávalo	0	Neut
Priveľmi by to kričalo .	kričalo	3	Neut
Pokrútil hlavou .	Pokrútil	0	Masc
Otvorila ťažké drevené dvere a vstúpila do svojho laboratória .	vstúpila	5	Fem
Do izby sa vrútila Júlia .	vrútila	3	Fem
Aladin pokrčil plecami .	pokrčil	1	Masc
Ja som očakával , že tú poviedku neuverejnia .	očakával	2	Masc
Jej centrom bol vŕšok , na ktorom sa zrejme nachádzalo hradisko .	nachádzalo	9	Neut
Polly sa začervenala a hanblivo klapla zobákom .	klapla	5	Fem
“ Haló , “ prihlásila sa Anita .	prihlásila	4	Fem
Zavrela znútra dvere na školskej budove , zastrčila závoru , vzala ma za ruku a viedla za sebou .	zastrčila	7	Fem
" A si vinný ? " opýtal sa Winston .	opýtal	6	Masc
“ Čo je ? “ vyľakane vyhŕkol sultán .	vyhŕkol	6	Masc
“ Rozmliaždi ho , Džafar , “ škriekal škodoradostne Jago .	škriekal	7	Masc
Heather mu niečo zašepkala do ucha .	zašepkala	3	Fem
Nič sa nedalo robiť .	nedalo	2	Neut
Videl , ako Júlia zodvihla pohár a privoňala k nemu s úprimnou zvedavosťou .	Videl	0	Masc
V minulosti zakrýval kacírsku myseľ maskou konformizmu .	zakrýval	2	Masc
Kým som vystúpil z auta , odvážil som sa otočiť hlavu .	odvážil	6	Masc
Ale mňa to okno vôbec nezaujímalo .	nezaujímalo	5	Neut
Fajčila cigaretu a čítala noviny .	Fajčila	0	Fem
Ocitla sa v spleti úzkych uličiek , ktoré sa ponášali ako vajce vajcu .	ponášali	9	Fem
Poznala som aj všelijaké iné historky , podozvedala som sa ich , keď k mame chodili na návštevu ženy .	Poznala	0	Fem
Tekla vychrlila niekoľko oplzlých pavúčich nadávok , ale na silného Chrabroša si netrúfla , a tak kľajúc zaliezla pod vädnúci list .	netrúfla	12	Fem
Prešlo niekoľko dní a princezná ani len nepomyslela na návrat domov .	nepomyslela	7	Fem
Winston si prečítal nevhodný článok .	prečítal	2	Masc
Tvrdil som to stále .	Tvrdil	0	Masc
Sledovalo línie Lorinho tela , hltalo ho očami .	hltalo	5	Neut
Chýbalo v ňom čokoľvek dvojzmyselné .	Chýbalo	0	Neut
Keď po prižmúrení vytlačil z očí slzy , náhle pocítil hlad .	vytlačil	3	Masc
Pohľadal som letenku .	Pohľadal	0	Masc
Po špičkách som zišiel do salóna na prízemí , kde som na chvíľu zastal so zatajeným dychom .	zastal	13	Masc
Na hrebeni sa otočil a zaparkoval autom celkom pri okraji cesty .	otočil	3	Masc
Nahradilo ich niekoľko všeobecných slov , čím sa zlikvidovali .	Nahradilo	0	Neut
Obrátila som sa v očakávaní , že to bol prelud .	Obrátila	0	Fem
Chris zaprotestoval , ale zavrela som okno .	zavrela	4	Fem
V izbe som našla len Zhlúpnutého Sokrata .	našla	3	Fem
Prestala som na to myslieť .	Prestala	0	Fem
Napokon sa ozvalo klopanie na dvere .	ozvalo	2	Neut
Zväčša to boli obyčajní zločinci , ale našla sa tam aj hŕstka politických väzňov .	našla	7	Fem
Vrátila sa domov skôr ako ja a zdalo sa , že je pokojná .	Vrátila	0	Fem
Prehľadal ten kus lesa krížom ‐ krážom , ale niečo ho ustavične ťahalo späť k starej borovici .	ťahalo	12	Neut
Vyklonila som sa a pobozkala ho na ucho .	Vyklonila	0	Fem
Aj keď mi jeho správanie pripadalo čudné , obdivovala som jeho odhodlanie .	pripadalo	5	Neut
Aladin sa uškrnul a podal Abdullahovi krištáľovú guľu .	podal	4	Masc
To ho dopálilo .	dopálilo	2	Neut
Vďaka tomu sa tu až do obludných rozmerov rozrástlo uplatňovanie tzv . práva vlastníckej cirkvi .	rozrástlo	8	Neut
Neotvoril oči ihneď .	Neotvoril	0	Masc
Aladin tuho premýšľal .	premýšľal	2	Masc
Winston zdvihol hlavu a počúval .	zdvihol	1	Masc
Jago však naňho zazrel .	zazrel	3	Masc
Jej telo akoby doňho prelievalo časť svojej mladosti a elánu .	prelievalo	4	Neut
Prišlo „ ale “ , ktoré som počul iba nejasne .	Prišlo	0	Neut
Zrazu sa zavlnila tráva .	zavlnila	2	Fem
Čarodejnica odhrnula vejúci plášť a dobré víly onemeli od hrôzy , keď zbadali Zorničku .	onemeli	7	Fem
Nereagoval som .	Nereagoval	0	Masc
Keď som si naň spomenula , zakrútila sa mi hlava .	spomenula	4	Fem
“ Ako bolo včera večer ? “ vyhŕkla nahlas , keď som otvorila kuchynské dvere .	vyhŕkla	7	Fem
Včielky sa držali za ruky .	držali	2	Fem
Oni to hlúpe drevené chlapčisko priam zbožňovali .	zbožňovali	6	Masc
Odraz sa , povedala som si na konci dráhy po prvej dĺžke a hladko som to zvládla .	zvládla	16	Fem
Keby som bol prehltol tú návnadu , moje postavy by ma boli priviedli do hrobu .	priviedli	12	Fem
Ten súvisí s iným bláznom , ktorý býval v našej štvrti .	býval	7	Masc
Keď dedinskí nafúkanci z môjho ročníka uverejnili na jeho stránkach nejakú báseň , naparovali sa celý mesiac .	uverejnili	6	Masc
Niekto vliezal do okna .	vliezal	1	Masc
Neskoro večer , keď bandy surových proletov vyvádzali na uliciach , vládla v meste zvláštna horúčkovitá atmosféra .	vládla	11	Fem
Abdullah pokrčil plecami .	pokrčil	1	Masc
Fridolína striaslo pri spomienke na ďatľov smrtonosný jazyk .	striaslo	1	Neut
Jazmína pozrela dolu a zbadala otca .	zbadala	4	Fem
To ju zobudilo .	zobudilo	2	Neut
Ponášalo sa to na rovnicu o dvoch neznámych .	Ponášalo	0	Neut
Opustila strom , ktorý ju chránil , a veľkými oblúkmi letela povetrím .	Opustila	0	Fem
Pri príležitosti svojho odchodu a ukončenia zimného obdobia som vyhlásil , že zaplatím koňak všetkým , ktorí budú od dvanástej až do tretej poobede v kaviarenskej časti obchodu .	vyhlásil	9	Masc
Tuším mi to lichotilo .	lichotilo	3	Neut
Napriek tomu som jej požiadavku splnil .	splnil	5	Masc
“ Zabije ? “ zvolal Mauglí .	zvolal	4	Masc
“ Nie , “ odvetila som .	odvetila	4	Fem
Nateraz sa uzavrel pred vzdialenejšími zvukmi a počúval len kvákanie , ktoré sa valilo z obrazovky .	valilo	13	Neut
Celý zvyšok predpoludnia sa mu pracovalo veľmi ťažko .	pracovalo	5	Neut
Podľa jej interpretácie sa otočila chrbtom kvôli mne .	otočila	4	Fem
“ I mne sa raz snívalo , že budem učiť najväčšieho hrdinu všetkých čias , “ vyhlásil Fil .	snívalo	5	Neut
Bol to nádherný okamih : sedeli sme vedľa seba v prítmí autobusu a žlté pouličné osvetlenie ožiarilo Chrisovi tvár .	ožiarilo	16	Neut
Zaviedla Aladina dnu a zavolala sluhu , ktorý ihneď priniesol mešec zlata .	Zaviedla	0	Fem
V dome zavládlo hrobové ticho .	zavládlo	2	Neut
Nikdy predtým som nevidela živú korytnačku .	nevidela	3	Fem
Kým komáre krúžili koldokola na kraji lesa , na krajinu pomaličky sadala tma .	sadala	11	Fem
Kým som si to stačila uvedomiť , po tvári mi tiekli slzy a potichu som vzlykala .	tiekli	10	Fem
Rovnako prekvapujúco dobre vedela rozprávať bez pohybovania perami .	vedela	3	Fem
A otočil som sa na druhý bok .	otočil	1	Masc
Keď som sa vrátila domov , vzala som tranzistor a sadla som si k obloku .	sadla	10	Fem
Istý zmysel v ňom nachádzali moji neprajníci .	nachádzali	4	Masc
Chris vystrúhal grimasu a potom znovu prikývol .	prikývol	6	Masc
Po očku som sledovala , ako vkĺzol za volant .	sledovala	3	Fem
Srdce mu poskočilo .	poskočilo	2	Neut
“ Ešte si to rozmyslím , “ zahučal obor , ale už sa knísal nepriateľovi v ústrety .	zahučal	7	Masc
Naše prvé dobrodružstvo vtedy trvalo až do septembra .	trvalo	4	Neut
Mal na sebe krátke nohavice farby kaki a športovú košeľu .	Mal	0	Masc
Šľahúne boli pružné a Vilko jasal : “ To je vynikajúca trampolína ! “	jasal	5	Masc
Mal na mysli Aladina .	Mal	0	Masc
V jej neprítomnosti som predložil rukopis tej poviedky priamo šéfovi .	predložil	4	Masc
Povedala , že sa volá Liza .	Povedala	0	Fem
Zazneli dva iné hlasy .	Zazneli	0	Masc
Pomaly vstala a po niekoľkých knísavých krokoch zasa našla rovnováhu .	vstala	1	Fem
Raz sa podobali na rybu , potom na obra alebo na obriu včelu .	podobali	2	Neut
Po vypnutí obrazovky nastalo v miestnosti hrobové ticho .	nastalo	3	Neut
Do sklenej nádoby , v ktorej varila zázračný nápoj , pridávala čarovné prísady , a pritom čítala .	varila	6	Fem
Smiala som sa , akoby sme boli len kamoši , ale keď som si sadla do auta vedľa Shannon , naskočili mi na ruke zimomriavky , keď sa ma Chris dotkol .	dotkol	30	Masc
Nevinne som prikývla .	prikývla	2	Fem
V ten večer asi vedela , že je to naše posledné stretnutie .	vedela	4	Fem
Kalich zvončeka , kde strávila noc , sa knísal vo vetre a bolo tam chladno .	strávila	4	Fem
Chvíľu len tak posedával a hlúpo zízal na papier .	posedával	3	Masc
Nočným ovzduším sa nieslo vzrušenie .	nieslo	3	Neut
Dieťa rodičov Vnútornej strany sa nenarodilo do Vnútornej strany .	nenarodilo	5	Neut
“ Nepiekla to , “ odvetil .	Nepiekla	1	Fem
Aj keď vo chvíli , keď sa to stalo , ležal na chrbte , mal čudný pocit , že ho do tejto polohy niečo zrazilo .	ležal	10	Masc
Popoludní o tretej sa začínali Majstrovstvá Makovej lúky v skákaní .	začínali	4	Neut
Čo iné im ostávalo , museli prestať s hašterením a začať odčerpávať vodu .	ostávalo	3	Neut
Potom ma táto scéna stále prenasledovala .	prenasledovala	5	Fem
A jeho želanie zostať v ten deň so mnou ma dojalo .	dojalo	10	Neut
“ Veď ti vravím , “ odvetil Balú .	odvetil	6	Masc
Zasadanie otvoril a viedol predsedajúci zborový farár brat Bakalár .	otvoril	1	Masc
Také niečo by bolo nepredstaviteľne nebezpečné , aj keby vedel , ako to uskutočniť .	vedel	9	Masc
Začínalo sa brieždiť .	Začínalo	0	Neut
Vtom si Chris všimol model vesmíru , ktorý učiteľ vytiahol na ukážku , chytil sa za srdce a predstieral , že padá dozadu .	predstieral	18	Masc
Po dlhom období dažďov vykúklo opäť slniečko .	vykúklo	4	Neut
Prišlo mi jej tak trochu ľúto .	Prišlo	0	Neut
Abuov citlivý noštek vykrúcalo od najodpornejších pachov a jeho jemné ušká urážalo nedôstojné pokrikovanie .	urážalo	11	Neut
Rýchlo som upratala zo stola a ponáhľala sa do svojej izby .	ponáhľala	6	Fem
A hneď volala motýľa Emanuela , aby ju tam v noci nenechával .	volala	2	Fem
Potom oko zasa zatvorilo .	zatvorilo	3	Neut
“ Môžem si to ešte rozmyslieť ? “ spýtala sa .	spýtala	8	Fem
Keď sa mi posmievala , zmocňovala sa ma trpká zlosť , napriek tomu medzi nami nedochádzalo k scénam .	posmievala	3	Fem
Meg totiž verila , že iba Fil môže odvrátiť Herkulovu porážku .	verila	2	Fem
Maja sa od rozčúlenia celá triasla .	triasla	5	Fem
Takto ma zastihol Tom .	zastihol	2	Masc
Konečne prišla jar a Maja sa zobudila zo zimného spánku .	zobudila	6	Fem
Ležal v bezvedomí na zemi .	Ležal	0	Masc
Svätojánske mušky , lienky a niekoľko včiel sedelo alebo ležalo na dlážke a smutne vyčkávalo na svoj osud .	vyčkávalo	14	Neut
Deti sa veľmi tešili , keď Lulu kŕmila mláďatká .	tešili	3	Neut
Musím rešpektovať Marginu požiadavku , aby som deťom nič nepovedal , a zároveň musím nájsť pre Irmu nejaké presvedčivé vysvetlenie .	nepovedal	9	Masc
Podrobnosti o tom , čo sa stalo , som sa dozvedela trochu neskôr .	stalo	6	Neut
Vstal som .	Vstal	0	Masc
Keď som sa vrátila domov , vzala som tranzistor a sadla som si k obloku .	vrátila	3	Fem
Polly to nesmierne potešilo .	potešilo	3	Neut
Takto zrejme uvažovala aj mama .	uvažovala	2	Fem
“ Ja som sa nikdy nechcel ženiť , “ hundral nespokojne Vilko , “ a ty mi zrazu podstrčíš dieťa ! “	hundral	9	Masc
Začudovane zlietla nižšie a zistila , že je to veľké tiché lesné jazierko , v ktorom sa zrkadlí obloha .	zistila	4	Fem
“ Dobre , “ povedal .	povedal	4	Masc
Srdce mu v prsiach búchalo hrôzostrašne hlasito .	búchalo	4	Neut
Potom hudba stíchla , a keď Maja znovu otvorila oči , uvidela cvrčka , ako odlieta do jasnej mesačnej noci .	uvidela	11	Fem
Keď však videl tých zamyslených zubáčov , nedalo mu to .	nedalo	7	Neut
V tej chvíli mi bolo všetko jasné , vedela som , v čom je problém .	vedela	8	Fem
Tak sa učili variť , robiť jednoduché kuchynské práce ako umývanie riadu , škrabanie zemiakov , krájanie chleba .	učili	2	Neut
V chodbe páchla varená kapusta a staré handrové rohožky .	páchla	2	Fem
Podobalo sa to pokusu o ťah v šachovej partii , keď už má človek mat .	Podobalo	0	Neut
To malo obrovský národnozáchovný význam v druhej polovici XIX . storočia , keď maďarizácia reálne ohrozovala samotnú existenciu slovenského národa .	ohrozovala	15	Fem
Človeka to bohvieako nezaujímalo , popíjal z pohára a škriabal na papier tie svoje znaky .	nezaujímalo	3	Neut
Nemalo zelené oči .	Nemalo	0	Neut
Zišlo mu na um , že ešte stále nepozná jej priezvisko , ani jej adresu .	Zišlo	0	Neut
Volala sa Liza .	Volala	0	Fem
Usmiala som sa na Chrisa , a on sa uškrnul , ako keby mu naozaj odľahlo , že súhlasím .	odľahlo	15	Neut
Keď víly nechali princeznú na chvíľočku v paláci osamote , zjavilo sa pred ňou jagavé svetlo .	zjavilo	10	Neut
Niekoľko dvojíc tancovalo , iní sa bavili pri stoloch a bolo tam veselo i príjemne .	tancovalo	2	Neut
Túžil som vypiť tú vodku čo najrýchlejšie .	Túžil	0	Masc
Do ôsmej som vypil tretinu fľaše .	vypil	3	Masc
Vraj pri takých veľkonočných oblievačkách chlapci najviac a najčastejšie oblievali najkrajšie dievčatá z dediny .	oblievali	9	Masc
Keď vystúpila z pásma žltkastého svitu a na chvíľu zastala na rozhraní medzi svetlom a temnotou , nemyslel som na to , že ide priamo ku mne , aby napravila chybnú interpretáciu vecí , ktorú vyprodukoval môj mozog .	napravila	29	Fem
Všetci by lavínu najradšej čo najrýchlejšie odstránili , no nevedeli ako .	odstránili	6	Masc
Na všeobecné počudovanie sa prihlásil leňoch Vilko .	prihlásil	4	Masc
“ Utiekol som im ! “ vyhlásil zadyččaný .	vyhlásil	6	Masc
Prichádzali tam , keď si ich predvolal Cerberus .	predvolal	6	Masc
Keď prehovoril , bolo to v ľahkom , konverzačnom tóne .	prehovoril	1	Masc
Neviem , či na mňa viac zapôsobila skutočnosť , že môjho starého otca zabili , alebo meno Hádes , ktoré náš hosť ticho precedil cez zuby .	zapôsobila	6	Fem
Čím dlhšie som tam šliapala vodu , tým väčšia zlosť ma chytala .	šliapala	4	Fem
Uvítala každú príležitosť , aby som vypadla z mesta na čerstvý vzduch .	Uvítala	0	Fem
Otvorila oči .	Otvorila	0	Fem
Nateraz sa uzavrel pred vzdialenejšími zvukmi a počúval len kvákanie , ktoré sa valilo z obrazovky .	valilo	13	Neut
“ Ty pokúšaš moju trpezlivosť ? “ zreval .	zreval	7	Masc
Čo som neurobil ja , urobili medzitým iní .	neurobil	2	Masc
“ Sľubujem , “ naradostene odvetil .	odvetil	5	Masc
Celkom mi vyfučalo z hlavy , že som sa s ňou mala stretnúť v knižnici .	vyfučalo	2	Neut
Trvalo to , až kým výťah nezastal na siedmom poschodí .	nezastal	6	Masc
Nato zaznel výstrel , odrazila som sa a vyrazila ako šíp .	odrazila	4	Fem
“ Erik ! “ zvolala Ariela .	zvolala	4	Fem
Do chrobákovho obydlia dopadalo tlmené červené svetlo a sladká vôňa bola oveľa prenikavejšia .	dopadalo	3	Neut
Neskôrnateli vnútorne .	Neskôrnateli	0	Masc
Raisa sa , naopak , veľmi začudovala .	začudovala	6	Fem
Začervenala som sa , ale s úsmevom som pokrčila plecami .	Začervenala	0	Fem
V ten deň som sa ho nedozvedel , lebo dievčatko ku mne opäť zaujalo nepriateľský postoj drobnej šelmy .	zaujalo	13	Neut
Na takú dokonalú odpoveď som sa vtedy nezmohla , napadla mi až na druhý deň .	napadla	9	Fem
Pôvabne sa vzniesol do vzduchu , zatrepotal krídlami a bol preč .	vzniesol	2	Masc
Pozrela som na hodinky .	Pozrela	0	Fem
“ Čo si želáš ? “ spýtala sa pokojne .	spýtala	6	Fem
Vyzerala staršie a veľmi intelektuálsky .	Vyzerala	0	Fem
Vtom ju niečo zozadu potiahlo za krídlo .	potiahlo	4	Neut
Chodili jej normálnou poštou do školy , kde učila .	Chodili	0	Masc
Horace a Jasper sedeli na starej pohovke obklopení tuctami šteniatok a pozerali televíziu .	pozerali	11	Masc
Chris pootvoril ústa a zľahka mi hrýzol pery , ako keby ich ochutnával .	hrýzol	6	Masc
V rohu na sklápacom stole v pološere sa jasne lesklo sklené ťažidlo , ktoré tam kúpil na poslednej návšteve .	lesklo	9	Neut
Ale to sa nedalo spoľahlivo určiť .	nedalo	3	Neut
Preboha ! “ zvolala som a udrela som sa po čele .	zvolala	3	Fem
Jej slová ma prekvapili .	prekvapili	3	Neut
Veselo sa prechádzali medzi hosťami , usmievali sa a povzbudzovali ich , aby sa u nich cítili ako doma .	povzbudzovali	9	Masc
Rozprávala , akoby jej vynechávalo srdce .	vynechávalo	4	Neut
Lietal kade ‐ tade a volal jej meno .	Lietal	0	Masc
Keď konečne zaspala , bola tma .	zaspala	2	Fem
Nahol sa ku mne a odhrnul mi z tváre mokré vlasy .	odhrnul	5	Masc
Presne , “ povedal Chris .	povedal	3	Masc
V uplynulých rokoch ukázalo silný vzťah k demokratickým hodnotám a silu riešiť mnohé problémy .	ukázalo	3	Neut
V popoludňajšej tíši prekvapovala hlasitosť jeho zvuku .	prekvapovala	3	Fem
“ Modlíš sa ? “ vyrušil ma akýsi hlas .	vyrušil	5	Masc
Prešla hodina , a mama nechodila .	nechodila	5	Fem
Všetky tieto ich snahy mali aj svoju právnu dimenziu , vďaka čomu sa v okolí reformných pápežov vytvorilo „ nové “ reformné kánonické právo .	vytvorilo	17	Neut
Aby mu to nebolo ľúto , zlizol aj on jeden pohlavok ako ostatní .	nebolo	3	Neut
Abu sa zamračil .	zamračil	2	Masc
V Gregorovom ponímaní by to znamenalo komendovanie Uhorska sv . Petrovi , ktorého nástupca by vládcovi krajiny udelil kráľovskú korunu .	znamenalo	5	Neut
Najskôr som začul psí brechot .	začul	2	Masc
Namiesto toho urobila večeru , ako na zmierenie , a celú večnosť čakala , že sa vrátim .	čakala	12	Fem
Keď sa Peter raz topil na mori , Ježiš mu podal ruku a zachránil ho .	zachránil	13	Masc
Nakoniec ma chcela privítať .	chcela	2	Fem
Aj tak sa vybrala pod harmanček , či náhodou pod lístkom neostala nejaká kvapôčka .	neostala	11	Fem
Uvedomila som si , že na mňa čaká , a rozbúchalo sa mi srdce .	rozbúchalo	10	Neut
N . T . bol za stenou , vyšetroval Margu .	vyšetroval	8	Masc
Pre mňa by nastal koniec sveta , keby Liza zverejnila moje tajomstvo .	zverejnila	9	Fem
Zrazu zažmurkal a prekvapene na oboch pozrel .	pozrel	6	Masc
Keď som tak urobil , spamätal som sa .	spamätal	5	Masc
Okolo hučal a bzučal najrôznejší hmyz a v stromoch na plné hrdlo vyspevovali vtáci .	bzučal	3	Masc
Nikdy som sa nezaoberal otázkami vlastnej tvorby jazyka . "	nezaoberal	3	Masc
Zrejme uplynuli týždne a mesiace .	uplynuli	1	Masc
Chris sa držal vľavo , šiel v pruhu , ktorý rozhodne neviedol ku knižnici .	neviedol	11	Masc
Možno ich nevidel .	nevidel	2	Masc
Veľa včiel opustilo mesto s novou kráľovnou , aby niekde vo veľkom šírom svete založili nové včelstvo .	opustilo	2	Neut
Za jasotu spoluobčanov prevzali cenu a Dr . Slimák slzil od dojatia , pretože v tejto súťaži doteraz nijaký slimák nevyhral .	prevzali	3	Masc
Zrazu z domu vybehol neznámy muž .	vybehol	3	Masc
Musí byť pohodlný , viem , aby sa v ňom Lienke dobre sedelo a dobre pérovaný , aby nedostala kočovú chorobu .	sedelo	12	Neut
Závidela som chalanom , tí sa majú .	Závidela	0	Fem
Napokon usúdil , že najbezpečnejším miestom je kantína .	usúdil	1	Masc
Na trhovisku ho zarazilo množstvo čudných vecí a kadejakých vôní .	zarazilo	3	Neut
Tieto kritické postrehy Soni vyslovila pri našom poslednom prázdninovom stretnutí pred začiatkom tretieho ročníka .	vyslovila	4	Fem
Pocítila , že sa blíži explózia , a odtiahla sa .	Pocítila	0	Fem
Ale ja som Marge nič nepovedal ani v to ráno , ani neskôr .	nepovedal	5	Masc
Súžitie etník tu teda fungovalo na princípe spoločenstiev v ktorých jednotlivé zložky popri sebe slobodne existovali a zároveň sa ovplyvňovali , miešali a splývali .	fungovalo	4	Neut
Dvere sa napodiv pohli a ja som stuhol .	pohli	3	Fem
Prejav ma neprekvapil .	neprekvapil	2	Masc
A tak sa stalo , že nakoniec som sa na jednej hodine roztriasla , keď som si predstavila niečo strašné : v budúcnosti ma čaká to isté , čo stihlo moju mamu .	stihlo	29	Neut
V takých chvíľach to nemalo zmysel .	nemalo	4	Neut
Blythe dobre vedela , že mama by ma pustila .	vedela	2	Fem
Jeho veľká , odporná tvár sa priblížila , oči sa mu trochu zúžili .	zúžili	12	Neut
Ale oni nič nerobili ani nehovorili .	nehovorili	5	Masc
Roztvoril denník .	Roztvoril	0	Masc
Vystúpenie veľkého množstva jeho bojových oddielov sa dalo chápať i ako pohanský nepokoj — prežitky predkresťanskej viery sa u Estóncov udržali neobvykle dlho .	dalo	7	Neut
Prešlo desať období dažďov a za tie roky ľudské mláďa vyrástlo .	vyrástlo	10	Neut
Vznikol okolo rokov 1220 — 1230 .	Vznikol	0	Masc
Piateho mája sa začalo Pražské povstanie a z rádia sa ozývala výzva o pomoc .	začalo	3	Neut
Ostalo aj pre mamičku .	Ostalo	0	Neut
Žiarlivá kráľovná sa hrozne nahnevala , že jej nevlastná dcéra je krajšia ako ona , a prikázala poľovníkovi , aby princeznú zabil .	prikázala	16	Fem
Marga mi však ukazovala listy , ktoré dostávala .	dostávala	7	Fem
“ To bude nuda ! “ uštipačne prehodila Maja .	prehodila	7	Fem
Usmiala sa naňho a potom odišla .	Usmiala	0	Fem
Táto imunita ( nenarušiteľnosť ) sa potom vzťahovala aj na všetkých ľudí , ktorí sa v objekte zdržiavali .	vzťahovala	7	Fem
Tentoraz to prišlo skôr . "	prišlo	2	Neut
Uvedomila som si , že na mňa čaká , a rozbúchalo sa mi srdce .	Uvedomila	0	Fem
Žaba nemohla kričať a had ju prehltol v tichosti .	nemohla	1	Fem
Nemohla som pochopiť , ako to zo mňa vyletelo .	Nemohla	0	Fem
Tarzana to povzbudilo a prisahal : “ Budem najlepšia opica , aká kedy prišla na svet ! “	povzbudilo	2	Neut
Mysľou zalietol do zamotaného sveta doublethinku .	zalietol	1	Masc
Vtom mi Chris stisol ruku .	stisol	3	Masc
Winton začal šepotom .	začal	1	Masc
Abuov citlivý noštek vykrúcalo od najodpornejších pachov a jeho jemné ušká urážalo nedôstojné pokrikovanie .	vykrúcalo	3	Neut
Nemala som najmenšiu chuť rozoberať pred ním svoje zmätené pocity a zbabraný test .	Nemala	0	Fem
Jedného dňa stretla na malinčí čudného tvora .	stretla	2	Fem
V tej chvíli zišiel zo svojho ležoviska na strome Baghíra , ktorý pozorne počúval všetko , čo sa vravelo .	zišiel	3	Masc
Vzdelanecké pozadie rodiny malo pre moju budúcnosť VEĽMI DÔLEŽITÚ úlohu . “	malo	3	Neut
Húf mojich postáv i muž , ktorý mi radil , aby som pohol mozgom , zmizli .	radil	8	Masc
Tie slová akoby viseli medzi nami vo vzduchu .	viseli	3	Neut
O ' Brien nič nepoznamenal .	nepoznamenal	4	Masc
Dvere zamkla znútra na kľúč a cez temnú chodbu – svetlo nebolo zažaté – ma zaviedla do izby , kde sme zastali oproti sebe .	zamkla	1	Fem
Vrátil som sa a znovu som si sadol k stolu .	sadol	7	Masc
Na slnku jej telo žiarilo .	žiarilo	4	Neut
“ Zatváram , “ odvetilo lekno .	odvetilo	4	Neut
" A kto ťa udal ? " opýtal sa Winston .	opýtal	7	Masc
Za to , že som neprehltol spomenutú návnadu , nevďačím nijakej inteligencii .	neprehltol	5	Masc
Chcela som , aby bral život trocha vážnejšie .	bral	4	Masc
Nestalo sa nič mimoriadne .	Nestalo	0	Neut
Práve preto upútalo môj pohľad niečo veľmi zvláštne .	upútalo	2	Neut
“ Môžeme vám nejako pomôcť ? “ zdvorilo sa vypytovala Maja .	vypytovala	9	Fem
Chutilo jedlo vždy takto ?	Chutilo	0	Neut
Dal som mu takéto meno , keď som s akousi ľahkosťou presvedčil sám seba , že toto meno najlepšie pristane môjmu hrdinovi .	presvedčil	11	Masc
Chutilo jedlo vždy takto ?	Chutilo	0	Neut
“ To je ono ! “ zvolal Balú .	zvolal	6	Masc
Boli tu naukladané , akoby čakali na odvoz , a Ferdo na ne vyjavene hľadel .	čakali	5	Neut
Ani som sa nepohla .	nepohla	3	Fem
O chvíľu sa tam zjavila i Kala .	zjavila	4	Fem
Vytrhol som mu ho a opäť som ho vypil až do dna .	vypil	8	Masc
Keď sa však hlasuje v parlamente o zmluve s Vatikánom , zriadení katolíckej univerzity , SNS to podporila . "	podporila	17	Fem
Podala Aladinovi mincu .	Podala	0	Fem
Chvíľu ho nechali metať sa vo vode , no potom prilákali k studni muža , čo okopával záhradku .	okopával	16	Masc
Vlak bol plný proletov so sviatočnou náladou , ktorú v každom vyvolávalo letné počasie .	vyvolávalo	11	Neut
Po hodine na mňa Chris čakal pred triedou .	čakal	5	Masc
Malo sukničku z makových lupienkov a usmievalo sa .	Malo	0	Neut
Aj keď v noci ešte nelietala , rozprestrela krídla a opustila svoju bezpečnú dutinku v strome .	rozprestrela	7	Fem
“ To je zbytočné , “ namietla som .	namietla	6	Fem
Nerob zo seba hlupáka , povedali mi .	povedali	5	Neut
A v mozgu sa mi vynorila zabudnutá scéna .	vynorila	5	Fem
Meg márne odmietala , lebo podľa starej dohody s Hádesom vymenila svoju slobodu za život bývalého priateľa .	odmietala	2	Fem
Na mieste , kde sedelo , ostala vlhká , tmavá škvrna .	sedelo	4	Neut
“ Čo vlastne robíš ? “ vypytovali sa ďalej .	vypytovali	6	Masc
“ Čo mi nesieš , Emanuel ? “ vypytovalo sa slniečko .	vypytovalo	8	Neut
Moje záhady sa vyriešili .	vyriešili	3	Fem
Chcel som sa stretnúť s človekom číslo jeden a to ho zrejme prekvapilo .	prekvapilo	12	Neut
Winston ihneď vyplatil štyri doláre a zasunul si vysnívanú vecičku do vrecka .	vyplatil	2	Masc
Na chvíľu ožiarilo murény oslnivé hrôzostrašné svetlo , no po chvíli sa rozprskli na tisíc márnych kusov .	ožiarilo	2	Neut
“ Herkules nám dal niečo , čo sme obaja stratili .	stratili	9	Masc
Pozrela som na hodinky a zmocnili sa ma obavy .	Pozrela	0	Fem
Chris mi otvoril a ja som nastúpila .	nastúpila	6	Fem
Jeho vyduté biele bruško pripomínalo huňatý kopček .	pripomínalo	4	Neut
Do horúcich pekiel , pomyslel si .	pomyslel	4	Masc
Silno som ho zovrela , akoby ma mal ochrániť .	zovrela	3	Fem
Keď som to dokončila , odľahlo mi a bola som so sebou spokojná .	odľahlo	5	Neut
Deti boli v kostole veľmi tichučko a správali sa vzorne .	správali	7	Neut
Jej fyzická prítomnosť stačila , aby sa pohlo zviera , ktoré sa vo mne skrývalo .	skrývalo	14	Neut
Na stoloch stáli všelijaké fľaštičky a v bankách bublali záhadné tekutiny .	bublali	8	Fem
Zrazu sa ma zmocnilo presvedčenie , že som to zbabrala , ani kytička sedmokrások ma nemohla utešiť .	zmocnilo	3	Neut
Nevidieť tú reláciu , povedal by som spolu s Freudom , že za všetkým je sexuálne pudenie , ale tých dvadsať minút mi otvorilo oči .	povedal	4	Masc
Keď som prišla domov a ocitla sa v izbe , toto všetko mi uviazlo v hrdle .	uviazlo	13	Neut
“ Čo bude stáť za to ! “ skríkla som .	skríkla	8	Fem
Voda bola chladná ako vždy , a tak som si na zahriatie zaplávala niekoľko dĺžok .	zaplávala	12	Fem
Ak má môj rod zomrieť , tak chcem zomrieť i ja , pomyslela si .	pomyslela	12	Fem
Malá Maja sa začervenala .	začervenala	3	Fem
Herkules má ťažkosti ! “ vravela mu , keď ho odväzovala .	odväzovala	10	Fem
Vtedy však zaznelo z obrazovky prenikavé pískanie .	zaznelo	2	Neut
Priveľmi by to kričalo .	kričalo	3	Neut
Otvorila som dvere .	Otvorila	0	Fem
Ako sme už spomenuli , clunyjská reforma sa dostala aj do Lotrinska .	dostala	8	Fem
Takto som trávieval večery , márnil som čas pred televízorom .	trávieval	2	Masc
Neobjavil sa nijaký strážnik .	Neobjavil	0	Masc
Takmer ihneď usnuli a driemali asi polhodinu .	usnuli	2	Masc
Napla svaly na nohách , vystrela plecia , pozbierala odvahu a slabo sa na mňa usmiala .	pozbierala	8	Fem
“ Pomôžem ti , “ povedala Chris , keď som sa snažila udržať rovnováhu na okennom parapete .	snažila	11	Fem
Spojil ruky a ja som sa na ne postavila .	postavila	8	Fem
" Ešte mŕtvi nie sme , " poznamenala Júlia prozaicky .	poznamenala	7	Fem
Jedna ruka jej ovisla nabok , telo sa jej uvoľnilo .	ovisla	3	Fem
Pohľad , ktorý sa mi naskytol , ma vydesil .	vydesil	8	Masc
Nečakal na myšiakove ďalšie požiadavky a dvaapolmetrovým skokom sa vzdialil .	Nečakal	0	Masc
Naučil ju i zopár tónov a zakrátko už Jazmína zabávala hostí jednoduchou melódiou .	zabávala	9	Fem
Pripadalo mi to trápne .	Pripadalo	0	Neut
“ Mal som vedieť , že to je tvoja práca ! “	Mal	1	Masc
Keď sa telo spojilo s dušou , dievčina zažmurkala a otvorila oči .	spojilo	3	Neut
Na príjazdovej ceste pred Taco Villa stál dlhočizný rad áut , v ktorých sedeli decká z našej školy .	sedeli	13	Neut
Obaja súhlasili , no nič im nenapadalo .	nenapadalo	6	Neut
Zatriasli námesačníkom a prezradili mu , kto je zlodej .	Zatriasli	0	Masc
Zlá víla sa princovi Filipovi posmievala , no prezradila mu , že iba on môže zrušiť Zorničkinu kliatbu , ak ju pobozká .	prezradila	8	Fem
Čo sa však nestalo !	nestalo	3	Neut
Snežilo husto , padali veľké vločky .	Snežilo	0	Neut
“ Nemôžem , “ čo znamenalo , že ho nemôžem pozvať dnu , a nie bozkávať sa .	znamenalo	5	Neut
Pohltili ich autá .	Pohltili	0	Neut
Zamestnanci Oddelenia záznamov nerozprávali o svojej práci radi .	nerozprávali	3	Masc
Vonku sa ozýval bzukot a cvrlikanie , všade poletovali motýle a slniečko krásne prehrievalo zem .	ozýval	2	Masc
Ďalej sa nestalo nič zvláštne .	nestalo	2	Neut
" My sme mŕtvi , " opakovala Júlia verne .	opakovala	6	Fem
Pustil fľašu z kopca , ale zgúľala sa do potoka a voda ju unášala ako lodičku .	zgúľala	6	Fem
Tentoraz zavrel oči .	zavrel	1	Masc
Po známej zrážke s okrajom bazéna ma boleli päty a prestala som si veriť .	boleli	7	Fem
Vlasáč bez pozdravu oddupkal do tmy .	oddupkal	3	Masc
Vzápätí sa zjavila svetlovlasá hlávka a nakoniec sa z kvetu vynorilo drobučké stvorenie .	vynorilo	10	Neut
Chvíľu ho nechali metať sa vo vode , no potom prilákali k studni muža , čo okopával záhradku .	prilákali	10	Masc
Jej fyzická prítomnosť stačila , aby sa pohlo zviera , ktoré sa vo mne skrývalo .	pohlo	7	Neut
Nad lúkou sa zotmelo a svetojánske mušky sa museli postarať o osvetlenie ihriska .	zotmelo	3	Neut
Veľa včiel opustilo mesto s novou kráľovnou , aby niekde vo veľkom šírom svete založili nové včelstvo .	založili	14	Fem
Dúfal som , že ju nečítal .	nečítal	5	Masc
“ Kto vás uvrhol do tohto biedneho väzenia ?	uvrhol	3	Masc
Delina urobila to isté .	urobila	1	Fem
Bronzová čaša , zdobená rúčkou s vtáčikom pripomína uctievanie vtákov u ugrofínskych národov — ak karelský poľovník zabil vtáka čakalo ho nešťastie .	čakalo	19	Neut
Slová mi uviazli v hrdle .	uviazli	2	Neut
Naposledy požiadalo o povolenie na postavenie súsošia na svojom pozemku Gymnázium Ľudovíta Jaroslava Šuleka .	požiadalo	1	Neut
Mama sa zrejme nemohla utešiť tým , že jej otcovi zostalo meno .	nemohla	3	Fem
Myslela som si , že neprídeš , povedala .	Myslela	0	Fem
Od smiechu som takmer nevládala chodiť .	nevládala	4	Fem
V temnej miestnosti blikalo iba svetlo sviec .	blikalo	3	Neut
Aj keď vo chvíli , keď sa to stalo , ležal na chrbte , mal čudný pocit , že ho do tejto polohy niečo zrazilo .	stalo	8	Neut
Nevedel som to .	Nevedel	0	Masc
Malé dieťa sedelo s ockom pri večeri .	sedelo	2	Neut
Iba sa trochu sklonila , odkryla deku a ja som uvidel tvár spiaceho človiečika , ktorý nemal takmer nijaké vlasy .	nemal	16	Masc
Oči ma neklamali .	neklamali	2	Neut
Svedčilo o tom správanie mojich rodičov .	Svedčilo	0	Neut
Pred domom kuny Chytráčky viali pestré slepačie perá , Alfonz vystavoval lesklú kukuricu a kliešťak Drakula voňavé krvavé klobásky .	viali	4	Neut
Dieťa spokojne ležalo a nič nenaznačovalo , že sa vlci chystajú vyjsť z jaskyne .	ležalo	2	Neut
Všetci smutne hľadeli do prázdneho košíka , kde predtým ležali šteniatka .	ležali	9	Neut
Vietor im prilepil tenké kombinézy na telo .	prilepil	2	Masc
Chcel som tej rieke zabrániť , aby vyrazila von , bolo to však nemožné .	Chcel	0	Masc
A strechu Džahijovej chatrče strhla púštna búrka .	strhla	4	Fem
Napokon sa to stalo .	stalo	3	Neut
Zároveň so svetlom som zapol televízor .	zapol	4	Masc
Niečo , čo by nevydesilo Lavdima Lavdoshaja .	nevydesilo	4	Neut
Povedal som jej „ na zdorovie “ .	Povedal	0	Masc
“ Keby som nevedela , že máte bezpečnostný systém , “ doberala som si Chrisa , “ preliezla by som plot a skočila dnu . “	skočila	22	Fem
Spolu s ním bývala v tom istom byte aj rodina s troma veľkými mládencami .	bývala	3	Fem
Za jeho stiahnutými mihalnicami sa pohyboval celý les prstov v akomsi tanci , vykrúcal sa a skrúcal , strácal sa jeden za druhým a znova sa objavoval .	vykrúcal	13	Masc
Abu sa zamračil a poodišiel nabok od krištáľovej gule .	poodišiel	4	Masc
Za očami matne rozoznala biely ňufáčik a zlato ‐ čierny pásikavý kožuštek .	rozoznala	3	Fem
Maja zaletela na breh , aby si na chvíľu odpočinula .	odpočinula	9	Fem
Poznal som naspamäť všetky Čechovove poviedky a novely , ktoré vyšli v albánčine .	vyšli	10	Fem
Vtedy víly pochopili , že je načase , aby dievčine povedali pravdu .	pochopili	2	Fem
Viedol ma ešte asi dvadsať metrov a tam zastal .	Viedol	0	Masc
Usmiala som sa na mamu a štrngli sme si .	Usmiala	0	Fem
Ľúbil som všetky ženy , s ktorými som mal pomer .	Ľúbil	0	Masc
Maja od ľaku vykríkla .	vykríkla	3	Fem
Obrátil sa dozadu a usmial sa .	usmial	4	Masc
Chcel byť vtipný , ale rozzúrilo ma to .	Chcel	0	Masc
Toto spoločenstvo nám poskytlo hlboké zážitky , mnoho podnetov na zamyslenie , mnoho motivácie k modlitbám a pocit Božej prítomnosti .	poskytlo	3	Neut
Nehodilo sa mi do " krámu " .	Nehodilo	0	Neut
Len čo to dopovedala , zniesol sa nad ňou modrý tieň , v ktorom stála ako v jazierku .	dopovedala	3	Fem
Ale ona nezdvihla zrak .	nezdvihla	2	Fem
Winston poznal , že mu za hlavu prisúvajú akýsi ťažký prístroj .	poznal	1	Masc
Jazmína sa zhlboka nadýchla .	nadýchla	3	Fem
Jazmína si vzdychla .	vzdychla	2	Fem
Opustil som Lori .	Opustil	0	Masc
Keď vystúpila z pásma žltkastého svitu a na chvíľu zastala na rozhraní medzi svetlom a temnotou , nemyslel som na to , že ide priamo ku mne , aby napravila chybnú interpretáciu vecí , ktorú vyprodukoval môj mozog .	nemyslel	17	Masc
Tam na kamennom tróne sedel sám kráľ opíc .	sedel	4	Masc
Vstal som a zamieril k pultu .	Vstal	0	Masc
Pani učiteľka sa usmievala a pousádzala ich okolo stola .	usmievala	3	Fem
Keď pozrela pod seba , zistila , že uviazla v pavúčej sieti .	uviazla	8	Fem
Znovu sa ozval zvonivý hlas a nocou sa niesla prekrásna melódia .	ozval	2	Masc
Vedela , že z toho má v hlave zmätok .	Vedela	0	Fem
Moje postavy ma prenasledovali .	prenasledovali	3	Fem
Sú tam psi ? “ spýtal sa ma , kým sa vyšvihol na múr .	vyšvihol	11	Masc
Mama mi o ňom nikdy predtým nerozprávala .	nerozprávala	6	Fem
Na svoj husľový koncert pozvala celé okolie .	pozvala	4	Fem
Pre nesúhlas samosprávy blokovalo KDH vstup SMK do Európskej demokratickej únie .	blokovalo	3	Neut
A predsa to nefungovalo .	nefungovalo	3	Neut
Pred bránou Maju oslepilo žiarivé svetlo , až privrela oči .	oslepilo	3	Neut
Hrozba rozvodu visela nado mnou ako Damoklov meč .	visela	2	Fem
Bežala na rodnú lúku , ktorú po búrke ľahko našla .	Bežala	0	Fem
Píše Lize , pomyslel som si .	pomyslel	3	Masc
Zvieratká odpočívali pred svojimi príbytkami , večerali a popíjali púpavovú šťavu od cikád .	odpočívali	1	Neut
Zdalo sa , že je bystrý .	Zdalo	0	Neut
" Áno , " prisvedčil Winston .	prisvedčil	4	Masc
Kedysi ich zalievali do skla .	zalievali	2	Masc
Uvedomila som si , že to , čo vravela , mohlo pokojne platiť aj na Chrisa .	mohlo	10	Neut
Uveličene sa obzerala okolo seba .	obzerala	2	Fem
Nová Koncepcia ochrany prírody a krajiny bude obsahovať racionálny systém manažmentu chránených území , prehodnotí ich cieľový stav a navrhne opatrenia a programy starostlivosti tak , aby chránené územia slúžili aj verejnosti .	slúžili	29	Neut
Už štrnásť mesiacov nijaké číslo so sedmičkou na konci nevyhralo .	nevyhralo	9	Neut
“ Je v šoku , nehýbe sa , “ zistili mravce .	zistili	9	Masc
Myšlienka , že sa môžem stať otrokom svojich postáv , mi naháňala hrôzu .	naháňala	11	Fem
Najdivokejšie vrieskali školopovinné deti .	vrieskali	1	Neut
Pinocchiovo prvé predstavenie malo obrovský úspech .	malo	3	Neut
Bola noc a biele tváre a šarlátové transparenty zalievalo zlovestné svetlo .	zalievalo	8	Neut
Na plece mu zľahka doľahla čiasi ruka .	doľahla	4	Fem
Kde ‐ tu si na chvíľočku odpočinula , aby sa spamätala .	spamätala	10	Fem
Na záver tohto pamätného dňa dala princezná otcovi pusu na dobrú noc a mravčie vojsko vymenovalo kráľa za svojho čestného člena .	vymenovalo	15	Neut
Nenávidel som ten byt ; kým sme tam bývali , zomrel otec a po ňom aj Brunilda .	Nenávidel	0	Masc
Netrvalo dlho a predsedov príklad nasledovali súčasne Sabri aj veterinárny technik .	Netrvalo	0	Neut
Netrvalo dlho a nad jaskynkou sa zachvel list , spod ktorého vyliezol prečudesný chrobák .	Netrvalo	0	Neut
Odložila som knihu a otvorila zošit z angličtiny .	Odložila	0	Fem
Lykožrút Fridolín potom odniesol víťaza medzi jasajúcich divákov .	odniesol	3	Masc
Je veľmi pravdepodobné , že uhorskí zákonodarcovia formulovali príslušné právne normy o celibáte pod vplyvom výziev reformátorov .	formulovali	7	Masc
Nato zaznel výstrel , odrazila som sa a vyrazila ako šíp .	zaznel	1	Masc
Viedli ma polámané vetvičky a udupaná tráva .	Viedli	0	Fem
Tentoraz nemal nijaké ťažkosti .	nemal	1	Masc
V sobotu doobeda odstraňovala deficit spánku , ktorý sa nahromadil za celý týždeň .	odstraňovala	3	Fem
Vedela som , že obaja túžime , aby táto čarovná noc trvala večne .	Vedela	0	Fem
Mauglí so supmi sa smiali , keď im tiger zmizol z dohľadu .	zmizol	9	Masc
Anita jej to sľúbila a zložila .	zložila	5	Fem
Keď sa telo spojilo s dušou , dievčina zažmurkala a otvorila oči .	zažmurkala	8	Fem
Maja ho ustavične chválila a polichotený Vilko len tak rástol .	chválila	3	Fem
Svojho času som ich spomínal pri popisovaní nosenia fotografickej tašky na ruksaku .	spomínal	4	Masc
Vtedy som začul zvonenie .	začul	2	Masc
“ Ďakujem , “ odvetila som rozpačito .	odvetila	4	Fem
Netrvalo dlho , a policajti prišli do kaviarne zatknúť zlodeja .	Netrvalo	0	Neut
Odpovedala mi vyhýbavo .	Odpovedala	0	Fem
Ja som nepostrehol nijaký náznak , že by mala strach .	nepostrehol	2	Masc
Celú noc som sa prevaľoval na posteli v hotelovej izbe a nemohol som sa zmieriť s realitou .	nemohol	11	Masc
Spýtal som sa ho , ako sa volá , ale ono mi nechcelo povedať svoje meno .	nechcelo	12	Neut
Vtedy som si pomyslel na Irmu .	pomyslel	3	Masc
Pripadalo mu to , akoby sa džungľou rútili tisíce zvierat .	rútili	7	Neut
To Maju naštvalo .	naštvalo	2	Neut
Za celé tie roky som ani raz neodovzdala prácu po termíne .	neodovzdala	7	Fem
Na jeho tvári viseli matkine ustráchané oči .	viseli	3	Neut
Otočil krídlami a zachytil silnejší vietor .	Otočil	0	Masc
Herkulovi sa na tvári zračilo záhadné odhodlanie .	zračilo	4	Neut
Medzitým prestalo pršať a svitlo slniečko .	svitlo	4	Neut
“ Chvalabohu , “ vyhŕkol , len čo lapil dych .	lapil	8	Masc
Kravy bučali a zo slamy utekalo všetko živé .	utekalo	5	Neut
Ostražito sa zakrádala k neznámemu miestu , keď začula plač .	začula	8	Fem
Potom som sa vrhla na astronómiu .	vrhla	3	Fem
Prerušilo ju ohlušujúce chrčanie .	Prerušilo	0	Neut
Vtom sa dieťa rozkričalo a prekvapený Baghíra uskočil .	rozkričalo	3	Neut
Lienka sa držala nad vodou z posledných síl .	držala	2	Fem
Zúril , až mu vlasy dupkom stáli .	Zúril	0	Masc
A keď som ho počúval , pri akejsi zmene v zafarbení jeho hlasu sa mi na chvíľu zazdalo , že ho poznám .	zazdalo	17	Neut
Chris síce prikývol , ale šibalsky mu sem ‐ tam myklo kútikmi úst .	prikývol	2	Masc
“ Tak uspíme slniečko ! “ navrhla Makulienka .	navrhla	6	Fem
Uteč ! “ kričal .	kričal	3	Masc
Zvŕtala som sa pred zrkadlom a spomínala na Chrisov bozk .	Zvŕtala	0	Fem
Ak sa tak stalo , mrzí ma to .	stalo	3	Neut
Amaris zdvihla parádny ružový šašovský kostým .	zdvihla	1	Fem
Som rada , že som pomohla . “	pomohla	5	Fem
Naháňalo mi to strach .	Naháňalo	0	Neut
Raisa na stretnutie neprišla .	neprišla	3	Fem
Išiel som do kuchyne .	Išiel	0	Masc
V poslednom čase sa už mnohému naučila .	naučila	6	Fem
Veď hrdinu by nemalo nič rozptyľovať .	nemalo	3	Neut
“ Iba jedna včielka , “ odvetila Maja .	odvetila	6	Fem
Ďalšie zasadnutie zborového presbyterstva sa konalo dňa 16 . 5 . 2004 .	konalo	5	Neut
Snehulienke sa zakrútila hlava a obchádzali ju mdloby .	zakrútila	2	Fem
Bolo zamračené , malo pršať .	malo	3	Neut
No kým si Aladin stačil odhryznúť , čosi ho zaujalo .	zaujalo	9	Neut
Otvorila som okno a zazrela na Chrisa .	zazrela	4	Fem
Ležala som v posteli a po tvári mi stekali slzy .	stekali	8	Fem
Srdce mu poskočilo .	poskočilo	2	Neut
Zostal som sedieť v kresle , aj keď sa dvere otvorili a do miestnosti vošli dvaja muži , nové tváre .	Zostal	0	Masc
Mal pocit , že ho v žalúdku páli oheň .	Mal	0	Masc
“ Možno by sa jej páčila fretka , “ navrhla Syreeta .	navrhla	9	Fem
Videl svoj pád v celej hĺbke , pocítil svoj hriech v celej jeho veľkosti .	Videl	0	Masc
To všetko mi jedného dňa porozprával Sergej , pri močiari .	porozprával	5	Masc
Domorodcom prišlo vhod , že som sa ubytoval v tej izbe .	prišlo	1	Neut
Niekto zo susedov si mohol všimnúť , že som bol preč , mohol by sa ma zvedavo vypytovať , kde som bol , a to by stačilo , aby sa som sa rozčúlil .	stačilo	26	Neut
Uršulino obrovské nafúknuté telo zaberalo polovicu oblohy .	zaberalo	4	Neut
Tá myšlienka mu v skutočnosti v mysli skrsla v podobe vidiny , skleného ťažidla , ktoré sa zrkadlilo na povrchu sklápacieho stola .	zrkadlilo	17	Neut
Malo by ísť o Benedikta , Cyrila , Metoda , Brigitu , Katarínu a Teréziu , všetko svätých .	Malo	0	Neut
Postupne sa zdvíhanie a klesanie ich hrudí spomalilo a prešlo do normálneho rytmu a s príjemným pocitom bezmocnosti sa od seba oddelili .	prešlo	9	Neut
Chcela ho odohnať , ale Tarzan jej chytil ruku .	chytil	7	Masc
Otvorila ťažké drevené dvere a vstúpila do svojho laboratória .	Otvorila	0	Fem
Chvíľu stála a pozerala sa naňho , potom nahmatala zips na jeho kombinéze .	nahmatala	8	Fem
Pavol , ktorý bol do Fridy zaľúbený až po uši , sa zľakol a začal ju hľadať .	zľakol	12	Masc
Keď sa napokon obzrela , škriatka už nebolo .	obzrela	3	Fem
Zlá víla sa princovi Filipovi posmievala , no prezradila mu , že iba on môže zrušiť Zorničkinu kliatbu , ak ju pobozká .	posmievala	5	Fem
KDH v januári 2000 zablokovalo vstup SMK do Európskej demokratickej únie .	zablokovalo	4	Neut
Majino mužstvo zvíťazilo .	zvíťazilo	2	Neut
Podala mi pohár a ja som vystrúhal biedny úsmev .	vystrúhal	6	Masc
Doletel k nim aj Vilko .	Doletel	0	Masc
Nato ma pobozkal .	pobozkal	2	Masc
Čo všetko by sa s ňou dalo robiť !	dalo	6	Neut
Zaznel zvonec a všetko stíchlo .	stíchlo	4	Neut
A očervenel som .	očervenel	1	Masc
Prišla i Maja , ktorá cítila zodpovednosť za Vilka .	Prišla	0	Fem
V tomto omámení som si spomenul na niečo zvláštne , čo som kdesi čítal alebo počul .	počul	15	Masc
Snažila som sa zachovať rozvahu , ale u Favatovcov sa zažínalo jedno svetlo za druhým .	zažínalo	10	Neut
Povrávalo sa , že aj samotného Goldsteina tam pred rokmi a desiatkami rokov niekoľkokrát videli .	Povrávalo	0	Neut
Vedel , že ho má vo svojej hadej moci , ktorou môže zhypnotizovať aj to najživšie zviera .	Vedel	0	Masc
Zišlo mu na um , že až doteraz ho zrejme nevidela na voľnom priestranstve v plnom dennom svetle .	Zišlo	0	Neut
Vrhol pohľad na ciferník .	Vrhol	0	Masc
Jedného dňa sochu odtiaľ strhol dav , ktorý rozzúrilo jej namyslené povýšenectvo .	rozzúrilo	8	Neut
Obzvlášť odvtedy , čo som sa presťahovala do prízemného bytu po mojej starej tete , ktorá chovala a vykrmovala túlavé mačky z celého sídliska .	vykrmovala	18	Fem
Znervóznela som .	Znervóznela	0	Fem
Hook sa napokon obrátil k Wendy , zľahka sa dotkol klobúka a vystrúhal poklonu .	dotkol	9	Masc
Ťažko sa mi dýchalo , trápilo ma určité tušenie .	trápilo	5	Neut
“ Abu , dnes sa dobre najeme ! “ povedal Aladin .	povedal	9	Masc
Odmlčala sa , aby sa nadýchla .	nadýchla	5	Fem
Nezískala ho ani Matica , ani občianske združenie Komorra a nedarí sa to ani gymnáziu .	Nezískala	0	Fem
Podarilo sa mi vybehnúť na chodbu , ale tam sa mi podlomili nohy .	Podarilo	0	Neut
Jedného rána sa v úli rozzvučalo poplašné zariadenie .	rozzvučalo	5	Neut
Vilka vyučovanie celkom vyčepalo .	vyčepalo	3	Neut
Zrazu sa zachvela zem a dievčatko skoro spadlo .	spadlo	7	Neut
Sadla som si vedľa neho a rukami som si objala kolená .	objala	9	Fem
Chcela dva doláre .	Chcela	0	Fem
Stretla ho v tieni čiernej bazy , keď počúvala spev červienky .	Stretla	0	Fem
„ Nebyť toho , Slovensko by dnes neexistovalo , “ hovorí Ľubomír Ďurovič .	neexistovalo	7	Neut
Mohlo byť len zo stromu , do ktorého sa zaťalo sekerou so zatvorenými očami .	Mohlo	0	Neut
A skrýva v sebe tajomstvo , ktoré vo mne ustavične vzbudzovalo pocit viny .	vzbudzovalo	10	Neut
Ocitlo sa osamote s Lori a zo svojej skrýše všetko pozorne vnímalo : tvary Lorinho tela , jej dych , vôňu jej mäsa .	Ocitlo	0	Neut
Videla som , ako zabočil na našu ulicu .	zabočil	4	Masc
Vláda sa zároveň zaväzuje presadiť v zdravotníctve tvrdé rozpočtové obmedzenie tak , aby od roku 2004 nedochádzalo k tvorbe nového dlhu .	nedochádzalo	16	Neut
Aladin začal byť netrpezlivý .	začal	1	Masc
Abu z celej sily nahlas kýchol .	kýchol	5	Masc
Odhrnula som mokré plavky , prázdne kokakolové plechovice , ceruzky , listy vytrhnuté z notesa a knižku Kto chytá v žite so somárskymi ušami .	Odhrnula	0	Fem
Srdce mu od radosti poskočilo , keď Wendy urobila posledný krôčik a zmizla .	poskočilo	4	Neut
Zdalo by sa teda , že Somogyvárske opátstvo bude vďaka zväzku so svojím materským opátstvom súčasťou clunyjskej „ kongregácie “ .	Zdalo	0	Neut
V Gregorovom ponímaní by to znamenalo komendovanie Uhorska sv . Petrovi , ktorého nástupca by vládcovi krajiny udelil kráľovskú korunu .	udelil	17	Masc
Aladina raz z Rahimovho obchodu vyhnali , keď sa Abu usiloval chvostom potiahnuť trs banánov .	usiloval	10	Masc
Prišla i Maja , ktorá cítila zodpovednosť za Vilka .	cítila	5	Fem
John sa vystrel , vypäl hruď , ale bol nesmierne smutný .	vypäl	4	Masc
Na slnku jej telo žiarilo .	žiarilo	4	Neut
Maja s Vilkom sedeli na lesnej čistine a vymýšľali si o nich príbehy .	sedeli	3	Masc
Zablúdil som očami na jej hruď .	Zablúdil	0	Masc
Položil mi poslednú otázku .	Položil	0	Masc
Ocitlo sa osamote s Lori a zo svojej skrýše všetko pozorne vnímalo : tvary Lorinho tela , jej dych , vôňu jej mäsa .	vnímalo	11	Neut
Chcela som , aby bral život trocha vážnejšie .	Chcela	0	Fem
Mauglí miloval svoju rodinu .	miloval	1	Masc
Slnko na nich pražilo , pot ho svrbel na tvári .	pražilo	3	Neut
Klopanie sa opakovalo .	opakovalo	2	Neut
“ Dobrý deň , “ zakričala veselo Blythe mame .	zakričala	5	Fem
Vyhladil ho .	Vyhladil	0	Masc
Vlak sa šinul svojou slimačou pomalosťou .	šinul	2	Masc
“ Mala som pocit , že sa vznášam ! “ vravela som mame , keď za mnou pribehla a objala ma .	pribehla	17	Fem
Napokon zvíťazila láska .	zvíťazila	1	Fem
“ Čo som spravil ? “ spýtal sa Abdullah .	spravil	3	Masc
Od tej chvíle som sa myšlienky , že tá mačka mi vidí do duše , nevedela zbaviť .	nevedela	15	Fem
Dievča sa pozviechalo na kolená .	pozviechalo	2	Neut
Dal priniesť koše kvetov , podnosy so sladkými včelími špicmi a jazmínové koláčiky .	Dal	0	Masc
Ako sa hovorilo , túto škandalóznu informáciu potvrdila sama herečka , ktorá sa nervovo zrútila .	hovorilo	2	Neut
Postupne sa zdvíhanie a klesanie ich hrudí spomalilo a prešlo do normálneho rytmu a s príjemným pocitom bezmocnosti sa od seba oddelili .	oddelili	21	Masc
A tak sa pavúčikovia pustili priasť ľan .	pustili	4	Masc
Kedy sa zmenili Rickove city ku mne a prečo som si to nevšimla ?	nevšimla	12	Fem
“ Tu budeš bývať ! “ skríkol na ohromeného Pinocchia .	skríkol	6	Masc
Keď chcel , úplne vypol a okolie preňho neexistovalo .	neexistovalo	8	Neut
Vystrela k nemu zdravú ruku a on jej pomohol na nohy .	Vystrela	0	Fem
Vo Zvedoch som robila vedúcu oddielu .	robila	3	Fem
Aj keď vo chvíli , keď sa to stalo , ležal na chrbte , mal čudný pocit , že ho do tejto polohy niečo zrazilo .	zrazilo	24	Neut
Ako som vychádzala zo školy , zbadala so , že sedí na trávniku pri zastávke môjho autobusu .	vychádzala	2	Fem
Vaša žena zomrela , povedal .	zomrela	2	Fem
Zadnými nohami držal pavúka v šachu a prednými trhal sieť okolo napoly zadusenej Maji .	trhal	8	Masc
Zúril , až mu vlasy dupkom stáli .	stáli	6	Masc
Utekala som , čo mi nohy stačili .	Utekala	0	Fem
Parsons , ktorého to bombardovanie číslami priviedlo až do akéhosi nedefinovateľného nadšenia , si vytiahol fajku z úst .	priviedlo	6	Neut
Prikázali mi , aby som bol na druhý deň okolo poludnia v hotelovej hale , odkiaľ pôjdeme do kostola na svadobný obrad .	Prikázali	0	Masc
Stiahol kombinézu nabok a prezeral si jej hladký , biely bok .	Stiahol	0	Masc
Supy zložili Mauglího na zem .	zložili	1	Masc
Sultán spustil plecia .	spustil	1	Masc
“ Máš nejaký problém ? “ spýtala sa Jill , keď plávala popri mne .	spýtala	6	Fem
Samozrejme , ja som o tom nič nevedel .	nevedel	7	Masc
Ktorási euroázijská armáda ( Oceánia bola vo vojne s Euroáziou , Oceánia od nepamäti bola vo vojne s Euroáziou ) sa neuveriteľne rýchlo presúvala na juh .	presúvala	23	Fem
Dal jednému zo svojich mužov znamenie .	Dal	0	Masc
Urobila som adventný veniec a zavesila na dvere .	Urobila	0	Fem
Každý teraz prosil o žiletky .	prosil	2	Masc
Mama by sa nepotešila , keby som sa správala podľa vlastných predstáv .	nepotešila	3	Fem
Už sa zmrákalo a Katka mala slzy nakrajíčku .	zmrákalo	2	Neut
Veľmi by tvoj capko zúril , keby si sa dnes poobede ulial ? “	ulial	11	Masc
Ihneď som spoznala zvuk maminho auta .	spoznala	2	Fem
Zdalo sa mu , že jej na tej oblude vskutku záleží .	Zdalo	0	Neut
Vylúčené , aby sa Chris dozvedel , že ma Rick pobozkal .	pobozkal	10	Masc
V tejto súvislosti použila výraz „ špicľovanie “ .	použila	3	Fem
Keď som to vyslovil , prebehli mi po tele zimomriavky .	prebehli	5	Fem
Na obzore zbadala piesočný vír ako malé tornádo .	zbadala	2	Fem
Hádes nemohol pokojne spávať , kým sa nepresvedčil , že tvoj otec je mŕtvy .	nemohol	1	Masc
Išlo to !	Išlo	0	Neut
Iba to najdôležitejšie , čo nás priviedlo až sem .	priviedlo	6	Neut
Toto ministerstvo však nemuselo uspokojovať mnohoraké potreby straníkov , ale opakovať celú operáciu na nižšej úrovni pre blaho proletariátu .	nemuselo	3	Neut
Sloníča sa usmialo .	usmialo	2	Neut
Prešlo niekoľko dní a princezná ani len nepomyslela na návrat domov .	Prešlo	0	Neut
Rozrývalo mi to dušu a ničilo nervy .	ničilo	5	Neut
Ako dopadol ?	dopadol	1	Masc
Vstal som a otočil som sa mu chrbtom .	Vstal	0	Masc
Napokon preletel cez domček slimáka Oskara a skončil na baze .	preletel	1	Masc
Rýchlo ju prezrela a zistila , že sa na svet pýtajú šteniatka .	prezrela	2	Fem
Keby ste tu vyrastali , pripadalo by vám to normálne .	pripadalo	5	Neut
Sultána odhodilo nabok .	odhodilo	1	Neut
Júlia tíško zapišťala , v jej hlase sa ozvalo prekvapenie .	ozvalo	8	Neut
Povzbudzovalo svojich favoritov a už sa ozývali aj prvé heslá .	Povzbudzovalo	0	Neut
Dobre vedel , že dal Džahijovi na opravu strechy raz toľko , ako potreboval .	potreboval	13	Masc
Prehltol posledný dúšok čaju .	Prehltol	0	Masc
Nehovoriac o tom , že popoludní mávala stále program , chodila na súkromné hodiny angličtiny .	mávala	6	Fem
V prijímacej sieni to vyzeralo , akoby sa tadiaľ prehnala búrka .	vyzeralo	4	Neut
Unaveným krokom som vyšiel po schodoch nášho domu .	vyšiel	3	Masc
Nemala som veľmi na výber , a tak som ostala vo vode .	Nemala	0	Fem
Prekvapujúco sa podobala na Lori .	podobala	2	Fem
Strašná babizňa spokojne zakrákala .	zakrákala	3	Fem
Slovo „ idiot “ mi uviazlo v hrdle .	uviazlo	5	Neut
" A čo sa stalo s tým mužom ? " opýtal sa Winston .	stalo	4	Neut
Nikto ho zatiaľ neuderil .	neuderil	3	Masc
Niekedy sa objavovali obyvatelia Čarodejníckej vily , všetkých som poznala a vedela som , aký bol osud každého z nich .	poznala	9	Fem
Na moje kaktusové obdobie som si spomenula celkom nedávno .	spomenula	6	Fem
A Trúbeľko sa zasa radoval , že sa Ferdovi nič zlé nestalo .	nestalo	11	Neut
Keď som sa raz vrátil zo sveta do rodného mraveniska , zhrozil som sa .	zhrozil	11	Masc
Pod bielym strniskom starcova tvár očervenala .	očervenala	5	Fem
Najprv však chcela spoznať človeka .	chcela	2	Fem
Trvalo to , až kým výťah nezastal na siedmom poschodí .	Trvalo	0	Neut
Túto fantastickú predstavu rázne rozbila Lorina prítomnosť .	rozbila	4	Fem
Chcel som , aby sa Soni smiala .	Chcel	0	Masc
Barbie ich s úsmevom sledovala .	sledovala	4	Fem
Od radosti sa rozosmiala , lebo niečo podobné by urobila i ona .	rozosmiala	3	Fem
" A to už bolo čo ? " opýtal sa prekvapene .	opýtal	8	Masc
Keď sa chrobák zjavil znovu , vyzeral namrzene a hodil na zem kúsok medu .	zjavil	3	Masc
Zo zlatej čaše popíjal víno a džin mu masíroval nohy .	masíroval	8	Masc
Vzala Maju za ruku a odviedla ju do miestnosti , kde boli samé medové plásty .	Vzala	0	Fem
Do tej sa odhadzovala makulatúra .	odhadzovala	3	Fem
Priplietol sa tam iný blázon : Plné gate .	Priplietol	0	Masc
Ráno sa Alfonz za bratovo správanie všetkým ospravedlňoval .	ospravedlňoval	7	Masc
Jasne som chápal len absurdnosť situácie , v akej som sa ocitol .	ocitol	11	Masc
Na hlase som jej poznala , že ju to zaskočilo .	zaskočilo	9	Neut
Bola tu celá reťaz zvláštnych oddelení , ktoré sa zaoberali proletárskou literatúrou , hudbou , dramatickým umením a vôbec zábavou .	zaoberali	9	Neut
“ Hlupák ! “ zrevala a chytila si poranenú ruku .	zrevala	4	Fem
Niečo ostro cvaklo .	cvaklo	2	Neut
Zostal som v posteli .	Zostal	0	Masc
Slniečko hrialo , ľan schol a krtko zaspal .	zaspal	7	Masc
“ Ešte si to rozmyslím , “ zahučal obor , ale už sa knísal nepriateľovi v ústrety .	knísal	13	Masc
Potom sa rozhostilo ticho .	rozhostilo	2	Neut
“ Ako to myslíš ? “ zaujímal sa škriatok .	zaujímal	6	Masc
Utekala som , čo mi nohy stačili .	stačili	6	Fem
Spolu s ním ma objala aj Irma a obidvaja sa rozvzlykali .	objala	4	Fem
“ U mravcov , “ odvetila mravčia zdravotná sestrička .	odvetila	5	Fem
Slovo „ drúk “ malo tentoraz ničivý účinok .	malo	4	Neut
Máte kvalitnú vodku , poznamenala , čo som vôbec nečakal .	poznamenala	4	Fem
Vychrlila tie otázky tak rýchlo , že som nestačila reagovať .	nestačila	8	Fem
Pozdvihol zrak nahor k tej obrovskej tvári .	Pozdvihol	0	Masc
Už dávno sa s nimi nehrám , ale ani vo sne by mi nenapadlo , aby som ich vyhodila .	vyhodila	18	Fem
Keď na mňa pozrel a usmial sa , pripadala som si krásna , zbožňovaná a múdra .	usmial	5	Masc
Nejedno dieťa už vytklo s bolesťou svojim rodičom : Vy ste na vine , že som sa dostal na zlú cestu , lebo vy sami ste nebrali Ježiša vážne a neviedli ste ma k Nemu .	vytklo	3	Neut
Obrátil sa dozadu a usmial sa .	Obrátil	0	Masc
Alebo prežili príliš náročnú noc .	prežili	1	Masc
“ Ale to som predsa nechcela ! “ zvolala Lienka , keď predseda súdu vyhlásil rozsudok .	nechcela	5	Fem
Jazmína zaváhala .	zaváhala	1	Fem
Ale ona mi nepripomínala nijakú herečku .	nepripomínala	3	Fem
Zo strachu o seba , pre svoju povýšenú zbabelosť zaprel svojho Majstra a Pána .	zaprel	9	Masc
Bol teplý podvečer a Maja zaliezla do svojej škáročky v strome .	zaliezla	5	Fem
Zobrala ďalšie dve dievčatá , ostatných nechala tak a celé popoludnie špehovali dajakého čudáka .	špehovali	11	Fem
Zdalo sa mi , že to v ňom vrie .	Zdalo	0	Neut
V prípade , že z manželstva nevzišli deti , Strana nepovoľovala rozvod , zato podporovala odlúčenie .	nepovoľovala	10	Fem
“ Čo ? “ spýtala som sa .	spýtala	4	Fem
“ Akú širokú perspektívu máš na mysli ? “ spýtala som sa .	spýtala	9	Fem
Trvalo to len chvíľu .	Trvalo	0	Neut
To , čo videl , ho rozzúrilo .	rozzúrilo	6	Neut
Nič lepšie robiť nemohol .	nemohol	3	Masc
Nepovažovalo sa za žiaduce , aby proleti mali silné politické cítenie .	Nepovažovalo	0	Neut
Namrzený Mauglí si sadol na opačný koniec .	sadol	3	Masc
Náš program je plánom , aby Slovensko využilo svoju veľkú príležitosť a zaujalo v európskom spoločenstve dôstojné , rešpektované a zodpovedné postavenie .	zaujalo	12	Neut
V izbe podo mnou spával Profesor , oddeľovala nás iba tenká dosková podlaha .	spával	4	Masc
Ozval sa melodický piskot a na leknový list sa zniesol jemný priesvitný tieň .	zniesol	9	Masc
Baghíra nestrácal ani chvíľu , zdvihol košík a odniesol ho k jaskyni .	zdvihol	5	Masc
Najprv som sa rozprávala s ostatnými dievčatami , tváriac sa , že si ju nevšímam .	rozprávala	3	Fem
“ Páliš ? “ spýtal sa opatrne bodliak .	spýtal	4	Masc
Žena sa postavila na stupienok s katedrou , otvorila triednu knihu a začala čítať naše mená .	otvorila	8	Fem
Mama mi oznámila , že chceš ísť na vysokú a samozrejme , chcem ti podľa svojich možností pomôcť .	oznámila	2	Fem
Za týchto okolností sa mi v diaľke zjavilo mytologické božstvo záhrobného sveta .	zjavilo	7	Neut
V tom istom fascikli som mal odložené aj ďalšie texty , ktoré som neskôr zoskupil do samostatného fascikla .	zoskupil	14	Masc
Nie , táto zvláštna myšlienka nikdy Winstonovi na um nezišla .	nezišla	9	Fem
V lete 1948 v Prahe zažiadal o zahraničné štipendium .	zažiadal	5	Masc
Radža v košíku ticho zavrčal .	zavrčal	4	Masc
“ Nič sa nestalo , “ odpovedala som hanblivo .	nestalo	3	Neut
Keď som v jeden z tých dní vyšla zo školskej budovy , vonku ma čakal Sergej .	vyšla	7	Fem
" okríkol agresívne hostinského .	okríkol	1	Masc
Obe upierali naňho zrak .	upierali	1	Fem
Nepobozkala ma .	Nepobozkala	0	Fem
Winston usúdil , že nepostačí iba zmeniť zmysel prejavu Veľkého brata .	usúdil	1	Masc
Mama ho priniesla len pre mňa .	priniesla	2	Fem
“ Ako môžete také niečo povedať ! “ vyhŕkla Maja .	vyhŕkla	8	Fem
Chcela som zaplniť ticho , čo medzi nami zavládlo , a tresla som parádnu hlúposť .	zavládlo	8	Neut
Najprv som začula , ako čosi v kríkoch zašumelo .	zašumelo	8	Neut
Márne sa prezliekala , v našej izbe sa vždy našlo niečo , čo smrdelo kravínom .	smrdelo	13	Neut
Kravy bučali a zo slamy utekalo všetko živé .	bučali	1	Fem
Chytil Balúovi hlavu a nežne ju hladkal .	Chytil	0	Masc
Opice skákali z konára na konár a preskakovali koruny stromov , čo rástli pozdĺž brehu rieky .	rástli	12	Masc
Mama sedela na stoličke pri stole .	sedela	1	Fem
“ Presne , “ odvetil Chris .	odvetil	4	Masc
Bol by som nerád , keby mi bezočivá penica uchmatla tučnú korisť .	uchmatla	9	Fem
Začudovane zlietla nižšie a zistila , že je to veľké tiché lesné jazierko , v ktorom sa zrkadlí obloha .	zlietla	1	Fem
Zlej víle ostávala posledná nádej — havran .	ostávala	2	Fem
Zrazu ich však prerušilo hlasné a falošné vrzúkanie huslí .	prerušilo	3	Neut
Ťava sa potkla o voz a všetky granátové jabĺčka popadali na zem .	popadali	9	Neut
Otvoril mešec a zacinkal .	zacinkal	3	Masc
Ukrutne ma to potešilo .	potešilo	3	Neut
Zasmiala som sa , keď vychrlila tie otázky .	vychrlila	5	Fem
Prenikla ma horúčosť .	Prenikla	0	Fem
Pokrčila plecami a usmiala sa .	usmiala	3	Fem
Toľko oblizoval Jazmíne tvár , až ju zadúšalo od smiechu .	zadúšalo	7	Neut
Vybral desať najlepších policajtov a tí potom starostlivo prehľadali lúku .	Vybral	0	Masc
Otvorila oči a pred sebou uvidela svätojánsku mušku Svetlanku .	uvidela	5	Fem
Vždy som mal podozrenie , že v mojich vzťahoch s neznámou ženou vycítil čosi nečisté .	vycítil	12	Masc
Namiesto veľkého podnosu niesla malú tácku , na ktorej bola len jedna šálka s kávou a jeden pohár s rakijou .	niesla	3	Fem
“ Prisahám na svoj včelí život , že môj kamarát stratil pri nehode vedomie a prebral sa iba zázrakom ! “	prebral	15	Masc
Chris pokrčil plecami .	pokrčil	1	Masc
" Nezabil som ju .	Nezabil	1	Masc
Objavil sa pri dverách obchodu , zdvihol ruky a povystieral sa .	zdvihol	6	Masc
Baghíra ho ťahal , ale Mauglí sa pevne držal stromčeka .	držal	8	Masc
Chcela som zaplniť ticho , čo medzi nami zavládlo , a tresla som parádnu hlúposť .	Chcela	0	Fem
Vytopilo nás ?	Vytopilo	0	Neut
Šaty , ktoré šila Flóra , sa nevydarili .	nevydarili	7	Fem
“ Žobrákov nekŕmime , “ povedal sluha .	povedal	5	Masc
“ Prehľadaj ma , “ odvetil Káa .	odvetil	5	Masc
Na obidvoch stranách ulice , kde sa chodci náhlili po chodníkoch , parkovali autá .	parkovali	12	Neut
Na druhej strane niektoré slová poukazovali úprimne a s pohŕdaním na skutočný charakter oceánskej spoločnosti .	poukazovali	5	Neut
Pomaly kráčali po dlhom schodišti , ktoré viedlo na strechu , kde bývali , a boli hladní , unavení a veľmi sklamaní .	viedlo	7	Neut
Prepáčila by mi to , aj keby vedela , že som to odkladala kvôli nočnému astronomickému klubu s Chrisom ?	vedela	7	Fem
“ Dúfam , že mi nechalo aspoň zákusok . “	nechalo	5	Neut
Na zem padal teplý dážď a obyvatelia Makovej lúky sa skryli .	padal	2	Masc
Ja som cítila tvoj pohľad .	cítila	2	Fem
Pri slávnostných obradoch ju potom niesol jej najuznávanejší člen .	niesol	5	Masc
Tuho som ich zavrela a čakala .	zavrela	3	Fem
Všetky deti sa tam túlili k sebe .	túlili	4	Neut
Nevládala som naňho pozrieť .	Nevládala	0	Fem
Práve tadiaľ prechádzal po tráve .	prechádzal	2	Masc
Pomyslel som si , že sa mi to len zdá .	Pomyslel	0	Masc
Rozzúrená sa zvrtla a kamennými schodmi zbehla do zámockej pivnice .	zvrtla	2	Fem
Zatvoril som oči .	Zatvoril	0	Masc
Vilka očarili .	očarili	1	Masc
Neveril som vlastným ušiam .	Neveril	0	Masc
Zdalo sa mu , že naň čakal celý život .	Zdalo	0	Neut
Do sklenej nádoby , v ktorej varila zázračný nápoj , pridávala čarovné prísady , a pritom čítala .	pridávala	10	Fem
Zrazu v tom tichu zaburácal jeho hlas .	zaburácal	4	Masc
Vendelín prikývol .	prikývol	1	Masc
Aladin držal špajľu horúcej pečenej jahňaciny , ktorú ukradol zo stánku .	držal	1	Masc
Vtom sa ozval srdcervúci výkrik .	ozval	2	Masc
Skrytá bytosť zmizla .	zmizla	2	Fem
Odišla som preč , nechala som ho tam .	Odišla	0	Fem
Marga sa posadila na posteli .	posadila	2	Fem
Nespýtala som sa ho to .	Nespýtala	0	Fem
Pustili sa do upratovania školských plástov .	Pustili	0	Fem
V tej chvíli zažiarilo v miestnosti zlovestné zelené svetlo .	zažiarilo	3	Neut
Chutila výborne .	Chutila	0	Fem
“ Chcela by som , aby ste mi vyveštili budúcnosť , ale nemám veľa peňazí . “	Chcela	1	Fem
Prešlo desať období dažďov a za tie roky ľudské mláďa vyrástlo .	Prešlo	0	Neut
Vtedy sa prítomným naskytol pohľad na Gimov obrovský penis .	naskytol	3	Masc
Mal som pocit , že za známymi črtami tváre , ktorých som sa vo sne neraz dotýkal , sa skrýva akési tajomstvo .	dotýkal	16	Masc
V jedno vetristé popoludnie zaspala pani Mandelinka uprostred obeda na stoličke a oni sa jej starali o drobizg .	starali	15	Masc
Vietor hvízdal v konároch a trápil sporadické , ufúľané krókusy .	hvízdal	1	Masc
Na jeho dvere ktosi zaklopal .	zaklopal	4	Masc
“ Ty , “ odvetil .	odvetil	4	Masc
Nákladné autá ešte stále prechádzali okolo a ľudia ešte stále na ne hladovo civeli .	prechádzali	4	Neut
Odmlčala sa , aby sa nadýchla .	Odmlčala	0	Fem
Sčista - jasna sa mu videlo celkom možné , že sa hlúpo mýlil .	videlo	5	Neut
Herkules má ťažkosti ! “ vravela mu , keď ho odväzovala .	vravela	5	Fem
Svätojánske mušky , lienky a niekoľko včiel sedelo alebo ležalo na dlážke a smutne vyčkávalo na svoj osud .	sedelo	7	Neut
Ale otec ma nepočúval . “	nepočúval	3	Masc
Dvere sa napodiv pohli a ja som stuhol .	stuhol	7	Masc
Dodala , že aj ja sa jej páčim .	Dodala	0	Fem
Dievčatko vstalo a vyšlo z miestnosti .	vstalo	1	Neut
Moji rodičia sa báli .	báli	3	Masc
Prešmykla sa okolo Kasandry a vonku sa nadýchla čerstvého vzduchu .	Prešmykla	0	Fem
A čo ho tam čakalo ?	čakalo	4	Neut
Baghíra ho ťahal , ale Mauglí sa pevne držal stromčeka .	ťahal	2	Masc
Niet pochýb , že mi ju poslala do cesty prozreteľnosť .	poslala	6	Fem
Vtedy vyšla moja KNIHA Paradigmatika spisovnej ruštiny , ktorá sa stala celoštátnou univerzitnou učebnicou ruskej TEORETICKEJ morfológie .	vyšla	1	Fem
Polícia včera oznámila , že Korac pri pokuse o zadržanie spáchal samovraždu .	spáchal	10	Masc
Mama pila doma , nikdy sa nestalo , že by sa vrátila z kravínov a razila alkoholom .	nestalo	6	Neut
Práve vtedy tréner August zapískal .	zapískal	4	Masc
Rozbúrila more a na rozčerenej , spenenej hladine sa ako atrament černela tekutina , ktorú vypúšťajú iba chobotnice .	černela	11	Fem
A tak sa stalo , že nakoniec som sa na jednej hodine roztriasla , keď som si predstavila niečo strašné : v budúcnosti ma čaká to isté , čo stihlo moju mamu .	stalo	3	Neut
Spôsoboval mi najväčšie utrpenie .	Spôsoboval	0	Masc
Zjavila sa vo dverách , mala na sebe čierno ‐ bielu uniformu .	Zjavila	0	Fem
Takže väčšina účastníkov oslavy si nemohla uvedomiť súvislosti .	nemohla	5	Fem
Vzdychla si .	Vzdychla	0	Fem
Niekoľkokrát ho už videla z bezpečnej vzdialenosti , ale nikdy sa neodvážila k nemu priblížiť .	videla	3	Fem
Sedel na stoličke neprirodzene vzpriamene a jeho mocné prsia sa nadúvali a zachvievali , akoby mal čeliť nárazu vlny .	nadúvali	10	Neut
Pocítila ľútosť a pritisla ma k sebe .	Pocítila	0	Fem
Maja smutne pokrútila hlavou .	pokrútila	2	Fem
A vtedy zaznel prenikavý treskot .	zaznel	2	Masc
O jej fair ‐ play správaní sa na druhý deň písalo aj v novinách .	písalo	10	Neut
“ Ty rád vyjednávaš , “ povedal Herkules .	povedal	6	Masc
Delina predo mnou nikdy nevyriekla toto slovo .	nevyriekla	4	Fem
Aj ja som rada , prehodila Lori , aj ja som bola otrávená až na smrť .	prehodila	5	Fem
“ Nemôžem to počúvať ! “ zamrmlala som a pohodlne sa oprela .	zamrmlala	6	Fem
Bohužiaľ , vzali si z nich príklad všetky deti a tiež sa chceli hrať v odpadovej jame .	chceli	12	Neut
Vysoko na oblohe uprostred jasných hviezd žiaril guľatý mesiac .	žiaril	6	Masc
Herkules medzitým navštívil v chráme Dia a predviedol milovanému otcovi svoje víťazstvá .	predviedol	7	Masc
Paradoxne som si želal , aby neprišiel .	neprišiel	6	Masc
Žena sa postavila na stupienok s katedrou , otvorila triednu knihu a začala čítať naše mená .	postavila	2	Fem
A oblial ma studený pot .	oblial	1	Masc
Aj Maja so škriatkom opustili topoľ a leteli , kým nedoleteli k domu , kde sa v oknách ešte svietilo .	nedoleteli	10	Masc
A zasmial som sa .	zasmial	1	Masc
Chrobák zhovievavo pokrútil hlavou .	pokrútil	2	Masc
“ Som najslávnejší človek v Grécku ! “ namietal Herkules .	namietal	8	Masc
Mama sa správala odmerane .	správala	2	Fem
Chris síce prikývol , ale šibalsky mu sem ‐ tam myklo kútikmi úst .	myklo	10	Neut
“ Cítil som , že ma čoskoro prepustí . “	Cítil	1	Masc
Vo vzduchu sa vznášali farebné balóniky , v pestrých stánkoch bolo množstvo všakovakých dobrôt .	vznášali	3	Masc
“ PÄŤ TELEFONÁTOV ! “ zvolala som , keď som zbadala , že doma v chodbe bliká svetielko na odkazovači .	zbadala	10	Fem
Mala pravdu a ja som to dobre vedel .	vedel	7	Masc
“ Ak to je dôvod na oslavu , tak oslavuj častejšie , “ odvetila som .	odvetila	13	Fem
Mravce roztiahli plachtu a razom všetko stíchlo .	roztiahli	1	Masc
Bojoval proti vykorisťovaniu v indickej spoločnosti , proti krviprelievaniu medzi hinduistami a moslimami , proti vojne , za politickú nezávislosť svojej krajiny .	Bojoval	0	Masc
Škoda , že Tayerle je taký nezáživný profesor , pretože astronómia , ktorú sme tento týždeň preberali , mi pripadala nesmierne zaujímavá .	pripadala	19	Fem
“ Hraj ako ja , “ zašepkal .	zašepkal	6	Masc
Veď čo už zvýšilo z toho , čo z neho mučením nevypáčili ?	nevypáčili	11	Masc
Márne sa prezliekala , v našej izbe sa vždy našlo niečo , čo smrdelo kravínom .	našlo	9	Neut
Určite však videla , ako k nej zamieril a hádam aj pochopila , že jej niečo naznačoval .	pochopila	11	Fem
“ Ďakujem , “ povedala som , lebo nič lepšie mi nenapadlo .	nenapadlo	11	Neut
So srdcom , ktoré mu tuhlo , kráčal Winston v jeho pätách .	tuhlo	5	Neut
Mal som príležitosť poznať dievčinu , ktorá sa volala Lori , ale ona sa stratila .	volala	8	Fem
Chytila som ho za ruku .	Chytila	0	Fem
“ Ale to som predsa nechcela ! “ zvolala Lienka , keď predseda súdu vyhlásil rozsudok .	vyhlásil	14	Masc
Do sklenej nádoby , v ktorej varila zázračný nápoj , pridávala čarovné prísady , a pritom čítala .	čítala	16	Fem
Keď boli sviatky , chodil z domu do domu a oznamoval ľuďom , že majú ísť na mítingy .	oznamoval	10	Masc
Keď sa telo spojilo s dušou , dievčina zažmurkala a otvorila oči .	otvorila	10	Fem
Flip zvolal obyvateľov lúčky , aby sa prišli s kamarátom rozlúčiť .	zvolal	1	Masc
Potom sa vrhol do vody a rozpleštil sa na člne , až ma od smiechu rozbolelo brucho .	vrhol	2	Masc
Maja s úžasom obdivovala jeho veľké krídla s červeným vzorom .	obdivovala	3	Fem
S tými slovami sa vzniesla a odletela .	vzniesla	4	Fem
Takmer ihneď usnuli a driemali asi polhodinu .	driemali	4	Masc
Opatrne som vstala , aby som ju nezobudila a išla som vypnúť televízor .	vstala	2	Fem
Vystrelil vychudnutú ruku .	Vystrelil	0	Masc
Na nebi ani mráčka a z blankytného neba hrialo slnko .	hrialo	8	Neut
Napriek tomu to však neplatilo bezvýhradne .	neplatilo	4	Neut
Winston zapálil horák a postavil naň kanvicu s vodou .	zapálil	1	Masc
Vtom sa mu zlatisté oči rozžiarili .	rozžiarili	5	Neut
Vošla som do tichého bytu .	Vošla	0	Fem
Opäť som zmenil názor , k čomu ma priviedlo niečo neočakávané .	priviedlo	8	Neut
Hlúpa tvár pod svetlými vlasmi ho vítala s rozžiareným úsmevom .	vítala	6	Fem
Keď auto odišlo , ulica sa vyprázdnila .	odišlo	2	Neut
Utiekla z paláca pred nekonečným zástupom nápadníkov .	Utiekla	0	Fem
Irme sa to nepáčilo .	nepáčilo	3	Neut
Vtedy si uvedomil , že Meg po celý čas donášala Hádesovi .	uvedomil	2	Masc
Napokon zlá víla priviedla princeznú do izbietky na samom vrchu vežičky .	priviedla	3	Fem
Lorina tvár nadobudla purpurovú farbu , pery sa jej roztvorili .	nadobudla	2	Fem
“ Tuším si našla otcov list , “ povedala mama .	našla	3	Fem
Husté čierne vlasy jej padali na plecia a zakrývali tvár .	padali	4	Masc
Obzvlášť odvtedy , čo som sa presťahovala do prízemného bytu po mojej starej tete , ktorá chovala a vykrmovala túlavé mačky z celého sídliska .	presťahovala	6	Fem
Za ten čas sa okolo nich zhromaždila skupina zvedavcov a medzi nimi aj Flip .	zhromaždila	6	Fem
Keby som dal tie texty Deline , pochopila by , že ich stredobodom je ona .	pochopila	7	Fem
Medzitým prišlo na plaváreň zopár deciek z oddielu a ich hlasy sa ozývali po vykachličkovanom priestore .	prišlo	1	Neut
Nešiel som na letisko .	Nešiel	0	Masc
Napriek tomu som neodišla .	neodišla	3	Fem
Neúnavný hlas ďalej vyspevoval :	vyspevoval	3	Masc
Kým som takto uvažoval , zdalo sa mi , že som na niečo prišiel .	zdalo	5	Neut
Práve začalo popŕchať .	začalo	1	Neut
Chris je najrýchlejší plavec v Delfíne , ale rekord v prsiach doteraz neprekonal .	neprekonal	12	Masc
Odskočili od seba .	Odskočili	0	Masc
Ostala však sedieť na rohožke .	Ostala	0	Fem
“ A správaj sa slušne , srdiečko , “ zašepkala .	zašepkala	9	Fem
Zároveň však Cluny urobilo veľký krok na ceste k libertas , lebo vytvorilo spoločenstvo ( zväčša ) úplne slobodných kláštorov , ktoré nepodliehali laikom .	vytvorilo	12	Neut
Tekla vychrlila niekoľko oplzlých pavúčich nadávok , ale na silného Chrabroša si netrúfla , a tak kľajúc zaliezla pod vädnúci list .	zaliezla	17	Fem
Iných stopárov som tu zatiaľ ešte nevidel .	nevidel	6	Masc
Zaburácal silný výbuch , ktorý akoby zodvihol vydláždený chodník ; na chrbát mu dopadla spŕška ľahkých predmetov .	Zaburácal	0	Masc
Aladin hodil Rasoulovi horúcu špajľu a ten ju bez rozmýšľania chytil .	chytil	10	Masc
Zabudla však , že včelia kráľovná má oddaných a dobre vycvičených vojakov , ktorí zakrátko votrelca zlikvidovali .	zlikvidovali	16	Masc
Každý zo stupňov svätenia od ordinanda vyžadoval , aby spĺňal príslušné predpoklady na jeho získanie .	spĺňal	9	Masc
Spoločne vyrazili jabĺčko babizne z ruky .	vyrazili	1	Masc
* Niektorým poslancom padlo zaťažko zverejniť svoje majetkové priznanie .	padlo	3	Neut
“ Tu je diera , “ zašepkala som a vybrala trs trávy , ktorý zakrýval vyčnievajúci stupienok z palmového dreva .	vybrala	9	Fem
Vydesený som si sadol do prvej lavice .	sadol	3	Masc
Na tvári som jej videla , že ju to vzalo , a keď vstala zo stoličky , bála som sa , že odíde z kuchyne .	vstala	13	Fem
Buď som nečakal , že mi do toho zasiahne , alebo mal vo svojom výzore i držaní tela stále čosi neprirodzené , čo ma znepokojovalo a zároveň uvádzalo do rozpakov .	znepokojovalo	24	Neut
Maja sa zatiaľ obzerala .	obzerala	3	Fem
Keď som si naň spomenula , zakrútila sa mi hlava .	zakrútila	6	Fem
Z druhého konca dlhej , jasne osvetlenej chodby sa k nemu blížila osamelá postava .	blížila	11	Fem
Keď sa začal semester , pustil som sa pod vedením profesora SommerfelTa do čítania textov .	pustil	5	Masc
Schytilo dievčinku labkami a vraví : “ Ty moja krásna dievčinka , odnesiem si ťa do hniezda ! “	Schytilo	0	Neut
Sestrička , ktorá si uvedomila , že ju o niečo okradol , tíško zanariekala .	uvedomila	4	Fem
Povedal som jej , nech si sadne , ale ona sa zdráhala .	zdráhala	11	Fem
Práve sa chystala roztiahnuť krídla a vzlietnuť , keď v tieni steny zbadala strážcu .	chystala	2	Fem
“ Len sa tak netvárte , “ namietala vážka Kráska .	namietala	7	Fem
Pokiaľ išlo o poznámky , Rick bol takpovediac profesionál .	išlo	1	Neut
Z obilia sa robila múka a z nej sa piekol chlieb .	robila	3	Fem
Zarazil som sa .	Zarazil	0	Masc
Pripomínali mi najdaromnejšie obdobie môjho života .	Pripomínali	0	Masc
Prinajmenšom ohľadom zlata v peňaženke sa mýlila , obavy som však určite nemal .	mýlila	6	Fem
“ Mám odísť ? “ Chris sa zatváril urazene .	zatváril	7	Masc
V poslednom čase ju Ministerstvo hojnosti veľmi obľubovalo .	obľubovalo	7	Neut
Bála som sa , že keby som naznačila , po čom túžim , mama by si našla aj tretie zamestnanie .	naznačila	7	Fem
S kŕdľami strák , ktoré poletovali po pustom parku pri Domove dôstojníkov .	poletovali	5	Fem
Tento delikt poznali oba hlavné zdroje cirkevného práva – Biblia i rímske právo .	poznali	2	Masc
Spratal neuveriteľné množstvo kukuričných placiek a mľaskal pritom a navyše ich zlostil híkavým smiechom .	mľaskal	6	Masc
Správal sa , akoby sa nič nestalo .	nestalo	6	Neut
Vážne prikývol .	prikývol	1	Masc
