“ Určite hľadáte Fawada , obchodníka so šperkami , “ povedala , keď k nej podišli .	hľadáte	2	Pres
Odraz sa , povedala som si na konci dráhy po prvej dĺžke a hladko som to zvládla .	zvládla	16	Past
“ Nehnevám sa , “ odvetila Makulienka .	Nehnevám	1	Pres
Však vieš , že sa tá zbierka robí od domu k domu .	vieš	1	Pres
Reklama nás každý deň bombarduje rôznymi výzvami , sľubuje bohatstvo , zdravie a úspech .	bombarduje	4	Pres
“ Akú širokú perspektívu máš na mysli ? “ spýtala som sa .	spýtala	9	Past
Po celý čas som sa díval smerom k osvetlenému pásmu , kde sa zástup žien tlačil pred skleným priečelím obchodu .	tlačil	15	Past
Vláda pripraví a realizuje systém ochrany slovenského spotrebiteľa a prostredníctvom legislatívy ho prispôsobí stavu , ktorý bude zodpovedať legislatíve EÚ .	pripraví	1	Pres
Spýtala sa to veľmi vážne .	Spýtala	0	Past
Regula metského biskupa podrobne ustanovuje i podmienky prijatia do spoločenstva kanonikov a v rámci nich predpisuje pre kandidáta povinnosť odovzdať všetok majetok kostolu , pri ktorom mieni pôsobiť .	mieni	26	Pres
Počuješ ma ?	Počuješ	0	Pres
Pripomínali mi najdaromnejšie obdobie môjho života .	Pripomínali	0	Past
Po rokom 1044 sa nachádza správa o narodení Vseslava , ktorému matka na radu volchvov uviazala amulet , spôsobiaci že z chlapca vyrástol krutý a nemilosrdný človek .	uviazala	15	Past
Mala pravdu a ja som to dobre vedel .	Mala	0	Past
Navrhneme zmeny , ktoré sú nevyhnutné pre vybudovanie moderného sociálneho systému .	Navrhneme	0	Pres
Rozzúreného Šuchtáka vystrieda slimák Plazivec a hra pokračuje .	pokračuje	7	Pres
“ Utiekol som im ! “ vyhlásil zadyččaný .	Utiekol	1	Past
Trávniky sa premenia na oceány bahna a autá uviaznu pred domami .	premenia	2	Pres
Vyskočil na rovné nohy a Gaston užasnuto hľadel na mohutnú postavu , ktorá sa nad ním vztýčila .	hľadel	7	Past
Vytvoríme kapitálotvornú vrstvu , ktorá bude zárukou blaha ľudu , presvedčivo hlásal tvorca blaha svojich prívržencov .	Vytvoríme	0	Pres
Duchovia sa však v tomto prípade nechcú objaviť — boja sa kríža , ktorý má Novgorodec pri sebe .	nechcú	6	Pres
" Nechápeš , že jediným cieľom newspeaku je zúžiť rozsah myslenia ?	Nechápeš	1	Pres
Aladin zle spal .	spal	2	Past
Niečo , čo by nevydesilo Lavdima Lavdoshaja .	nevydesilo	4	Past
Práve preto upútalo môj pohľad niečo veľmi zvláštne .	upútalo	2	Past
Kapituloval , to bolo jasné .	Kapituloval	0	Past
Poslušne som sa za ňou vliekla a zaháňala myšlienky na matematické rébusy , čo ma doma čakajú .	čakajú	16	Pres
Ukazuje sa teda , že tým stredoslovenským nárečím , ktorÉ Štúrovci povýšili na spisovný JAZYK , bol prestížny liptovský mestský jazyk .	Ukazuje	0	Pres
Zodvihol zrak .	Zodvihol	0	Past
Maja niekoľkokrát zamávala krídlami a vzniesla sa .	zamávala	2	Past
Také meno si želal môj otec .	želal	3	Past
Obrovský panter zdvihol košík a opatrne ho položil na breh .	položil	7	Past
Keď uplynul tretí deň a ja som sa v ten večer konečne ocitol sám , bol som na pokraji nervového vyčerpania .	uplynul	1	Past
Ak sa neponáhľate , počkajte chvíľu . “	neponáhľate	2	Pres
“ Kam ideme , Baghíra ? “ spýtal sa Mauglí .	ideme	2	Pres
Rozprávanie Ľubomíra Ďuroviča PRIPRAVILA Kveta Škvarková .	PRIPRAVILA	3	Past
“ Už letím ! “ kričí Polly .	letím	2	Pres
Len čo sa na zámku zjavím , kliatbu svoju im vyjavím !	vyjavím	10	Pres
Až doteraz vlastne nepostrehol , aký je chudý a slabý .	nepostrehol	3	Past
Marga odhalila jeho prítomnosť s oneskorením .	odhalila	1	Past
Poznal som tú ženu , vedel som , aké má meno .	vedel	5	Past
Na oslavu prišli všetci olympskí bohovia a priniesli množstvo nádherných darov .	priniesli	7	Past
Neviem vysvetliť , prečo sme nechodili na rande ako iní .	nechodili	5	Past
Chvíľu sa preťahovali , až napokon odlomili panvici rúčku .	odlomili	6	Past
Asi verili svojim po zuby ozbrojeným bojovníkom , pred ktorými sa všetci trasú .	verili	1	Past
Z čiernej nočnej oblohy sa spustil lejak .	spustil	5	Past
Možno si až teraz uvedomila , kam to jej klamstvo viedlo .	uvedomila	4	Past
Zamieril som k činžiaku .	Zamieril	0	Past
Neodvážil som sa spýtať sa jej na to .	Neodvážil	0	Past
Viete , koľko tu stojí 1 - izbový byt ?	stojí	4	Pres
Máš poškodenú pamäť .	Máš	0	Pres
“ Čo sa to tu deje , Abu ? “ spýtal sa .	deje	5	Pres
Keď opätoval môj pohľad , vedela som , že je to naozaj on .	vedela	5	Past
Jazmína zdvihla hlavu a uvidela , že princ Omar tuho spí .	uvidela	4	Past
Nesmiem sa báť , hovorila si .	Nesmiem	0	Pres
Formality vybavíme zajtra .	vybavíme	1	Pres
“ Ja ťa ľúbim .	ľúbim	3	Pres
Zjavilo sa mi vo sne a mne stále znie v ušiach jeho hlas .	znie	8	Pres
Ani družka , ani sok ho nesledujú . Čo ho núti vysedávať na konári osamoteného stromu a vyludzovať hudbu do prázdna ?	nesledujú	6	Pres
„ Poznajú iba hlad a smäd , lásku a lopotu , sebectvo a skúposť .	Poznajú	1	Pres
Vláda dopracuje a predloží návrh zákona o voľbách do Európskeho parlamentu tak , aby Slovenská republika bola pripravená voliť poslancov do tohto orgánu v prvom polroku 2004 .	predloží	3	Pres
Kráčal som za ním po tichej chodbe nemocničného pavilónu a ani som si nevšimol , že Irma nie je s nami .	nevšimol	13	Past
“ Vezmi ju stadiaľ , ona odíde , a ty ostaneš . “	ostaneš	10	Pres
Chvíľu sa preťahovali , až napokon odlomili panvici rúčku .	preťahovali	2	Past
Chris na mňa pozrel , či mi nešibe .	pozrel	3	Past
Mauglí skĺzol po liane dolu .	skĺzol	1	Past
“ TUŠÍM MÁŠ DOBRÚ NÁLADU , “ podozrievavo povedala mama , keď som sa ponúkla , že jej umyjem auto , kým pôjde do práce .	MÁŠ	2	Pres
Hádes chvíľu premýšľal .	premýšľal	2	Past
Slniečko hrialo , ľan schol a krtko zaspal .	hrialo	1	Past
Prehovorili sme .	Prehovorili	0	Past
Takého neposedného spoločníka ešte nestretla .	nestretla	4	Past
Zavalíme ľan kameňom , aby ostal vo vode .	Zavalíme	0	Pres
Celý dojem nie je nijako uchvacujúci až do chvíle , keď požiadate o jedálny lístok .	požiadate	11	Pres
My z nich robíme pravdu .	robíme	3	Pres
Prečo existuje láska ?	existuje	1	Pres
Maličkosť , ktorá poteší .	poteší	3	Pres
Je tvrdohlavý , neodíde , ani keby som to ohlásila na polícii .	neodíde	3	Pres
Vraj pri takých veľkonočných oblievačkách chlapci najviac a najčastejšie oblievali najkrajšie dievčatá z dediny .	oblievali	9	Past
BERLINALE - KTO PRÍDE ?	PRÍDE	3	Pres
Nemohla som si spomenúť , odkiaľ ju poznám .	poznám	7	Pres
Nemohla som tomu uveriť .	Nemohla	0	Past
Lori bola vedľa mňa , aby mi potvrdila , že Irma , ktorú pohltilo nebo , teraz letí do iného sveta .	letí	17	Pres
Z Odilonovho listu Štefanovi I . sa dozvedáme , že clunyjský opát a prvý uhorský kráľ boli vo vzájomnom styku už pred odoslaním tohto listu vzniknuvšieho medzi rokmi 1031 – 1038 .	dozvedáme	7	Pres
Zaletela k nim , sadla na kvet a počúvala tiché zurčanie potoka .	Zaletela	0	Past
To a všeličo iné vlastne očakáva každý veliteľ útočiaceho vojska , uvažoval Ferdo .	očakáva	5	Pres
Aladin hodil Rasoulovi horúcu špajľu a ten ju bez rozmýšľania chytil .	hodil	1	Past
“ Ja to zvládnem , “ odvetila som trochu tichšie , lebo som nebola o tom stopercentne presvedčená .	zvládnem	3	Pres
Zatvorím oči a narátam do desať .	narátam	3	Pres
Z takého či onakého dôvodu sa im vravelo pamäťové diery .	vravelo	7	Past
Keď Ferdovi muži zajali celé nepriateľské vojsko , aj hlavný veliteľ otrokárov vyšiel z podzemnej chodby .	zajali	3	Past
“ To rada počujem , “ vyhlásila Lienka .	vyhlásila	6	Past
Rozhodol sa , že svoju ponuku vylepší .	vylepší	6	Pres
I keď som mala na sebe jeho bundu , naskočila mi husia koža , ale neuhla som sa .	naskočila	9	Past
Na chvíľu som sa započúval do ticha na schodišti .	započúval	4	Past
Najspokojnejšie však boli pestúnky , lebo im vrátia ukradnuté vajíčka .	vrátia	7	Pres
Stavím sa , že si dostal vši , povedala mi .	Stavím	0	Pres
V jednom kuse táral o Týždni nenávisti .	táral	3	Past
“ Blahoželám ! “ zvolal .	zvolal	4	Past
Malé dieťa sedelo s ockom pri večeri .	sedelo	2	Past
Obrátila som sa a zbadala som to prekrásne staré autíčko .	Obrátila	0	Past
“ Môžeš chodiť , kam len chceš . “	Môžeš	1	Pres
Winston si zopäl ruky nad hlavou .	zopäl	2	Past
“ Postavíme ti maštal , chuchlík , “ povedal som mu .	povedal	8	Past
Krist , nenamáhaj sa , nepoučuj ma o tom , o čom ma stará mama poučila už dávno ‐ pradávno .	poučila	15	Past
Táto téma by si preto iste zaslúžila samostatné obšírnejšie spracovanie .	zaslúžila	6	Past
Zaľúbil som sa do nej akousi zvláštnou láskou , ktorá ma nepobádala písať verše , ako som ich písal pre Teutu .	Zaľúbil	0	Past
Vo vzduchu sa vznášali farebné balóniky , v pestrých stánkoch bolo množstvo všakovakých dobrôt .	vznášali	3	Past
Keď si naň spomeniem , je mi do smiechu .	spomeniem	3	Pres
Musím rešpektovať Marginu požiadavku , aby som deťom nič nepovedal , a zároveň musím nájsť pre Irmu nejaké presvedčivé vysvetlenie .	Musím	0	Pres
Chrisova mama zabalila chlebíčky po štyroch do plastovej fólie a ešte do alobalu .	zabalila	2	Past
Wendy a chlapci vyjavene hľadeli , ako k oblohe stúpa čierny dym .	stúpa	9	Pres
“ Zvykneš si naňho . “	Zvykneš	1	Pres
Odkiaľ berú títo ľudia presvedčenie , že pre Bratislavčanov reformy neznamenajú záťaž ?	berú	1	Pres
Zostupujúc do hĺbok duševných priepastí , ( seba ) obnažuje , bičuje ( sa ) .	obnažuje	9	Pres
Vláda vytvorí podmienky pre uskutočnenie úspešného referenda o vstupe do EÚ , ktoré bude dokumentovať udržanie širokej podpory verejnosti tomuto historickému kroku .	vytvorí	1	Pres
Táto povinnosť sa však nevzťahovala na produkty , ktoré sa jednak priamo a jednak symbolicky týkali základných prejavov kresťanského kultu .	týkali	15	Past
" Tá nateraz postačí .	postačí	3	Pres
Aj keď v noci ešte nelietala , rozprestrela krídla a opustila svoju bezpečnú dutinku v strome .	nelietala	5	Past
Bál som sa , že zloží slúchadlo , a tak som sa usiloval rýchlo niečo vymyslieť .	Bál	0	Past
Svätoštefanský zákon pripúšťa , aby sa žena , ktorú manžel za istých okolností opustí , znovu vydala .	opustí	13	Pres
Uršuľa sa usmievala , keď princa ťahali na morské dno .	ťahali	6	Past
V noci sa zatvárala do medailónu a patrila Profesorovi .	patrila	7	Past
Oba tieto kánony zodpovedajú dávnej praxi latinskej cirkvi .	zodpovedajú	3	Pres
Vonku zaznel dupot ťažkých čižiem .	zaznel	1	Past
Podporí v rámci krajín EÚ kompatibilnosť v oblasti vzájomného uznávania dokladov o dosiahnutí určitého stupňa vzdelania .	Podporí	0	Pres
Každý jeden šedý Reebok vás presvedčí , že tak skoro sa nič nezmení .	presvedčí	5	Pres
Odkiaľ berú títo ľudia presvedčenie , že pre Bratislavčanov reformy neznamenajú záťaž ?	neznamenajú	10	Pres
Veronika sa najprv urazila , ale keď jej Ferdo vysvetlil , že rehotanie je taká zvláštna psia choroba , trochu sa upokojila .	urazila	3	Past
Terk neverila vlastným očiam .	neverila	1	Past
Pri tejto myšlienke som sa začervenal .	začervenal	5	Past
Srdce mi bilo ako zvon , no odľahlo mi , len čo za sebou zavrela .	odľahlo	7	Past
Lori naštartovala auto .	naštartovala	1	Past
Bála som sa , že mi povie , že ich chytil , keď sa milovali .	povie	6	Pres
Chris sa zasmial .	zasmial	2	Past
Vtom si Chris všimol model vesmíru , ktorý učiteľ vytiahol na ukážku , chytil sa za srdce a predstieral , že padá dozadu .	predstieral	18	Past
Srdce mu v prsiach búchalo hrôzostrašne hlasito .	búchalo	4	Past
V tej chvíli Makulienka celkom stratila srdce .	stratila	5	Past
Prebúdzal som sa o druhej v noci na zvonenie mechanického budíka čínskej výroby , ktorý som mal na nočnom stolíku pri záhlaví postele .	Prebúdzal	0	Past
I vlasy ti vypadávajú v celých chuchvalcoch .	vypadávajú	3	Pres
Chodia vôbec do školy ?	Chodia	0	Pres
Cestujem do večnosti k Pánu Ježišovi Kristovi .	Cestujem	0	Pres
“ PÄŤ TELEFONÁTOV ! “ zvolala som , keď som zbadala , že doma v chodbe bliká svetielko na odkazovači .	zvolala	5	Past
“ Mám odísť ? “ Chris sa zatváril urazene .	zatváril	7	Past
Veľmi by tvoj capko zúril , keby si sa dnes poobede ulial ? “	zúril	4	Past
Vtedy sa rozhodli , že nadišiel čas , aby mu ukázali zlatý medailón , ktorý mal na krku , keď ho našli .	nadišiel	5	Past
Schytilo dievčinku labkami a vraví : “ Ty moja krásna dievčinka , odnesiem si ťa do hniezda ! “	odnesiem	12	Pres
Jeho kláštor musel mať dobrú povesť , lebo ako lotrinský vojvoda , tak aj flámsky markgróf mu odovzdali viaceré kláštory , aby v nich obnovil rehoľný život podľa reformných princípov .	obnovil	24	Past
Do toho domčeka prichádzal každý večer človek .	prichádzal	3	Past
“ Nijakú kobylku nepoznám , ukážeš mi ju , Vilko ? “	nepoznám	3	Pres
Jej prenikavý krik Vilka prebral .	prebral	4	Past
Dnes meškáš , povedala , bála som sa , že neprídeš .	meškáš	1	Pres
V ten deň mi povedala , že sa podobáme na Čechovových provinčných hrdinov .	podobáme	8	Pres
Teraz ma prenasledovatelia chytia , pomyslel si Ferdo .	chytia	3	Pres
Vážka sa polichotene usmiala .	usmiala	3	Past
“ Hej ! “ zvolala som a chytila volant .	chytila	7	Past
Ľudstvo svojou usilovnosťou prispelo k zrodu dvoch svetových vojen , ba v niektorých kútoch Zeme vojny pokračujú .	pokračujú	16	Pres
Nočným ovzduším sa nieslo vzrušenie .	nieslo	3	Past
V dôsledku rímsko - centralistickej tendencie zbierok prevzali do nich zostavovatelia i viaceré úplne alebo čiastočne sfalšované texty , ktoré však svojím obsahom zodpovedali stanoviskám a snaženiam reformátorov .	prevzali	7	Past
Uvedomila som si , že to , čo vravela , mohlo pokojne platiť aj na Chrisa .	vravela	8	Past
“ Myslím na dnešné preteky , “ zaklamala som .	Myslím	1	Pres
“ Radža naozaj nikomu neublíži , “ ubezpečovala ho Jazmína .	neublíži	4	Pres
Dvojtvárnosť trickstera súvisí s celkovým dualizmom , prítomným v systéme prírodného polyteizmu .	súvisí	2	Pres
Chvíľu sme stáli vo dverách , pretože nás ovalil svieži závan klimatizovaného vzduchu .	stáli	2	Past
“ Ďakujem , “ odvetila som a zrazu som znervóznela .	znervóznela	9	Past
Zasmiala sa .	Zasmiala	0	Past
" Tak ty ho nenávidíš .	nenávidíš	4	Pres
Nemajú čas ani myseľ na spory , ktoré by mohli vyplynúť z ich odlišných vyznaní .	Nemajú	0	Pres
Ferdo z toho usúdil , že bývalí otrokári nevedia ani písať .	nevedia	8	Pres
S letenkou v ruke som vyšiel z izby a zamieril k stolu , kde sedeli recepčné z môjho poschodia .	vyšiel	5	Past
Obávala som sa , že dám najavo priveľké nadšenie , ak sa otočím ku Chrisovi celá naradostená .	otočím	12	Pres
Vláda pripraví legislatívne a finančné predpoklady pre vznik povinného kapitalizačného piliera dôchodkového systému .	pripraví	1	Pres
“ Poznám tvojho otca veľmi dobre a viem , že sa nikdy nezmení .	nezmení	12	Pres
Mlčky som sedela v autobuse , keď sme sa viezli na preteky .	viezli	9	Past
Svoje fotografie odteraz nájdete vždy na adrese www . fotoindex . sk vo svojom súkromnom fotoalbume .	nájdete	3	Pres
Začudovane zlietla nižšie a zistila , že je to veľké tiché lesné jazierko , v ktorom sa zrkadlí obloha .	zistila	4	Past
Zachvátil ju vzlykot .	Zachvátil	0	Past
Poskakoval okolo mňa a od samej radosti sa jašil .	Poskakoval	0	Past
Neskoro večer , keď bandy surových proletov vyvádzali na uliciach , vládla v meste zvláštna horúčkovitá atmosféra .	vyvádzali	7	Past
Chan si zahrá Číňana , ktorý pricestuje na Divoký západ , aby zachránil unesenú dcéru čínskeho konzula .	zachránil	12	Past
Zlá víla vedela , že iba on môže zrušiť kliatbu , ktorou Zorničku zakliala .	zakliala	13	Past
Bol to nádherný okamih : sedeli sme vedľa seba v prítmí autobusu a žlté pouličné osvetlenie ožiarilo Chrisovi tvár .	sedeli	5	Past
Vláda urýchli a finančne posilní zákonom regulovaný proces vysporiadania vlastníctva pôdy a pripraví komasáciu a proces definitívneho doriešenia vydávania náhradných pozemkov .	pripraví	12	Pres
Zdvihla slúchadlo .	Zdvihla	0	Past
Dôsledky učenia Strany ju ani trochu nezaujímali .	nezaujímali	6	Past
Uvidíš sa aj zboka . "	Uvidíš	0	Pres
“ Nechcú nám ublížiť , Kerchak ! “ povedal .	Nechcú	1	Pres
Ponúka nám niečo , čo nepotrebujeme .	nepotrebujeme	5	Pres
Chceš vidieť , ako urobím leoparada ? “ spýtal sa .	urobím	4	Pres
Čarodejnica odhrnula vejúci plášť a dobré víly onemeli od hrôzy , keď zbadali Zorničku .	odhrnula	1	Past
Nikto neprotestoval , že sa predbiehame .	predbiehame	5	Pres
Ja mám za úlohu robiť sprostredkovateľku .	mám	1	Pres
“ Ty nemôžeš žiť !	nemôžeš	2	Pres
O niekoľko dní zmenila pracovné miesto : z kravínov prešla do kancelárií na družstve , stala sa upratovačkou .	prešla	9	Past
Zrazu začuli vystrašený krik .	začuli	1	Past
Nevidel som nič , nikto ma nesledoval .	Nevidel	0	Past
Maja zaviedla hostí na slávnostne vyzdobenú lúku a ponúkla im vyhliadkový let s vážkou , medové guľôčky , cukrovú vatu a mnoho iných dobrôt .	ponúkla	8	Past
“ Veľmi ma teší . “	teší	3	Pres
“ Tak ti teda prezradím , aká budúcnosť ťa čaká , “ odvetil Abdullah .	prezradím	4	Pres
Zostal som stáť , ani som sa nepohol .	nepohol	7	Past
Poznáte to .	Poznáte	0	Pres
“ Bol som sebecký a viem to .	viem	5	Pres
Vykročil k nemu , potom zastal ako vrastený do zeme .	zastal	5	Past
Celý ďalší týždeň jeho život pripomínal nepokojný sen .	pripomínal	5	Past
Vtedy zdvihla hlavu .	zdvihla	1	Past
“ Počujem prenasledovateľov !	Počujem	1	Pres
Krtko sa rozosmial .	rozosmial	2	Past
Skutočnosť , ktorú mi Lori oznámila , bola jednoduchá .	oznámila	5	Past
Rád vidím , ako kopú nohami .	kopú	4	Pres
Odložila som knihu a otvorila zošit z angličtiny .	otvorila	4	Past
Sergej mi takisto povedal , že zatiaľ sa môžem ísť poprechádzať po Nevskom prospekte .	povedal	3	Past
Keď sa začal semester , pustil som sa pod vedením profesora SommerfelTa do čítania textov .	pustil	5	Past
Zdalo sa mu , že naň čakal celý život .	Zdalo	0	Past
Ozval sa melodický piskot a na leknový list sa zniesol jemný priesvitný tieň .	Ozval	0	Past
Prvý knokdaun som zakúsil na nádvorí .	zakúsil	3	Past
Spomínaš si na to ? "	Spomínaš	0	Pres
“ Viem , si o tom presvedčená , “ povedala mama .	Viem	1	Pres
Vláda zdokonalí transparentný systém financovania cirkví a náboženských spoločností .	zdokonalí	1	Pres
Môžeme ich pripraviť o existenciu .	Môžeme	0	Pres
Musím sa priznať , že sa mi ten nápad ohromne páčil , hoci znel neuveriteľne .	Musím	0	Pres
Nemôžu sa .	Nemôžu	0	Pres
Do minúty zhorí na popol .	zhorí	2	Pres
Ja som zatiaľ porovnal jej tvár so Soninou .	porovnal	3	Past
Ak nemôže dostať Belu on , nedostane ju nikto , ani človek ani zviera .	nedostane	6	Pres
“ Stavím sa , že je to bytosť z inej planéty , “ zašepkala Maja a zatiaľ čo sakamaráti skrývali za jej chrbtom , podišla bližšie a navrhla neznámemu prehliadku Makovej lúky .	Stavím	1	Pres
" Mám tridsaťdeväť rokov .	Mám	1	Pres
Potrebujeme ľudí , ktorí budú ochotní počúvať svojho partnera , budú dostatočne vzdelaní na to , aby dokázali zaujať jasné stanovisko k mnohým problémom súčasnosti .	Potrebujeme	0	Pres
Možno to , čo sa potom stalo , zvalím na mesiac .	zvalím	8	Pres
Aby ma Chris nepovažoval za decko pretože , nemám mamin súhlas , nič som mu nevravela .	nemám	8	Pres
Vari ho špehuje ?	špehuje	2	Pres
“ Prosím vás , slečna , “ prosíkal .	prosíkal	7	Past
“ Čo to robíte ? “	robíte	3	Pres
“ Chcem , “ odvetil .	Chcem	1	Pres
“ Ty žartuješ , “ zvolala som a prekvapene vyvalila oči .	žartuješ	2	Pres
Možno to vyzerá nezmyselne , ale mne to pomáha .	vyzerá	2	Pres
V Hospodinu , Pánovi mám svoje útočište . . . „	mám	4	Pres
Určite bol nervózny , lebo hlas mu v tej krátkej vete preskočil do fistuly ako rozladené rádio .	preskočil	11	Past
Ostatní sú mimo -- nezáleží na nich . "	nezáleží	4	Pres
Baghíra nestrácal ani chvíľu , zdvihol košík a odniesol ho k jaskyni .	nestrácal	1	Past
Sama zájdem do chalúpky k siedmim trpaslíkom .	zájdem	1	Pres
Pedra totiž široko ‐ ďaleko poznali ako záletníka a donchuana .	poznali	5	Past
Dnes a zajtra spím u nej .	spím	3	Pres
Pozná ju každý .	Pozná	0	Pres
Vieš o tom , že Jaro zomrel ?	Vieš	0	Pres
“ Hádes nás zabije , keď to zistí ! “	zabije	3	Pres
Hugovi životopisci nás informujú o dobrom výsledku účinkovania opáta v Uhorsku .	informujú	3	Pres
V uhorských zákonníkoch sa stanovenie týchto pôstnych období objavuje už u sv . Štefana .	objavuje	8	Pres
Konečne sa blížil začiatok pretekov .	blížil	2	Past
Občas si spomenula na svoj roj vo včelom meste .	spomenula	2	Past
Napísali ho ceruzkou .	Napísali	0	Past
Jazmína sa vyštverala na vysokánsky štíhly kmeň jednej z najvyšších datľových paliem v kráľovskej záhrade .	vyštverala	2	Past
" Ľutujem , " podotkol Winston .	podotkol	4	Past
U dovážaných produktov zabezpečí elimináciu tých , ktoré nespĺňajú kritériá kvality a ktoré neprešli colným a daňovým vysporiadaním .	nespĺňajú	8	Pres
No keď Lulu kefovala tigriu srsť , diali sa čudné veci .	kefovala	3	Past
Takto som kedysi čakával na Doloru .	čakával	3	Past
“ Obviňujeme vás , že ste nám odcudzili drahocennú potravu , “ povedal prísne veliteľ a dal pokyn , aby ich zajali a postavili pred sudcu .	Obviňujeme	1	Pres
“ Čo mi nesieš , Emanuel ? “ vypytovalo sa slniečko .	vypytovalo	8	Past
Musí sa predsa vrátiť ku Geppettovi !	Musí	0	Pres
Svorka sa usadí okolo kmeňa stromu .	usadí	2	Pres
Prvýkrát počas celého výsluchu som sa mu pozrel do očí .	pozrel	7	Past
Vláda zvýši administratívnu kapacitu v oblasti regionálnej politiky .	zvýši	1	Pres
Želám príjemný víkend .	Želám	0	Pres
Mauglí sa trocha upokojil .	upokojil	3	Past
“ Vy tu bývate ? “ spýtala sa Maja .	bývate	3	Pres
Nemohla sa dočkať , kedy preberieme moje citové záležitosti , a tak prišla k nám .	preberieme	5	Pres
Koľkokrát Aladin počul , ako po nich pokrikujú tie isté slová !	pokrikujú	7	Pres
Kto si o Snehulienke rozum trúsi , ten rozletí sa na márne kusy !	trúsi	5	Pres
Im všetkým však patrí moja srdečná vďaka .	patrí	3	Pres
Stále konfrontovala fakty .	konfrontovala	1	Past
Na zem padal teplý dážď a obyvatelia Makovej lúky sa skryli .	skryli	10	Past
Keď som zložila , mama na mňa zhrozene pozrela .	pozrela	8	Past
Každý zavolá Ferdu na pomoc , keď niečo potrebuje .	zavolá	1	Pres
Všetci smutne hľadeli do prázdneho košíka , kde predtým ležali šteniatka .	hľadeli	2	Past
Kriminalisti dospeli k záveru , že ich napísali ženy .	dospeli	1	Past
Čo spraví s dievčaťom , to rozhodne neskôr .	spraví	1	Pres
V prvej časti kapitoly teda najprv načrtneme ich základný argumentačný potenciál , aby sme mohli v časti druhej pristúpiť k pokusu o vlastnú interpretáciu .	načrtneme	6	Pres
Zasmiala som sa , keď vychrlila tie otázky .	vychrlila	5	Past
Vonku sa ozýval bzukot a cvrlikanie , všade poletovali motýle a slniečko krásne prehrievalo zem .	prehrievalo	13	Past
Napokon sa mucha upokojila .	upokojila	3	Past
Náš vzťah trval rok .	trval	2	Past
“ A navyše mám tetovačku , “ ochotne doplnil Omar .	mám	3	Pres
Trkotali , sŕkali med a zapíjali ho pálenkou !	Trkotali	0	Past
Keby ste ho nenašli , leťte za slnečným svitom .	nenašli	3	Past
„ Akže umierajú vaši ľudia , sú do neba vynášaní , akže naši , idú k našim do priepasti . . . “	idú	14	Pres
Sprievod vyšiel z uličky za domom , čo znamená , že musel zomrieť niekto , kto býva v dome .	býva	16	Pres
Odpovedala , že je v poriadku .	Odpovedala	0	Past
A dodala : Narodila som sa v internácii .	dodala	1	Past
Winston sedel na svojom mieste a civel do prázdneho pohára .	sedel	1	Past
Bola noc a biele tváre a šarlátové transparenty zalievalo zlovestné svetlo .	zalievalo	8	Past
Práve pripravujem tortu na jej narodeniny .	pripravujem	1	Pres
Marga nechcela , aby sme zobudili Irmu .	zobudili	5	Past
“ Naozaj ? “ úctivo sa pýtal Pinocchio .	pýtal	6	Past
Rozumel som , čo mi povedala .	Rozumel	0	Past
Bála som sa , že ho tak ľahko znovu nezavriem .	nezavriem	9	Pres
Na jeho dvere ktosi zaklopal .	zaklopal	4	Past
Chcela by som sa na nej odviezť , “ povedala Makulienka .	Chcela	0	Past
“ Nazri do svojho srdca , ono ti povie , čo máš robiť . “	máš	11	Pres
Vchádzala na parkovacie miesto , kde trhane zastala .	zastala	7	Past
Sergej mi takisto povedal , že zatiaľ sa môžem ísť poprechádzať po Nevskom prospekte .	môžem	8	Pres
Máme jej celé kilo , " povedala .	Máme	0	Pres
Napriek mojej nezrozumiteľnej ruštine opäť pochopila .	pochopila	5	Past
Nikoho , kto raz vybočil , neušetríme .	neušetríme	6	Pres
Chan si zahrá Číňana , ktorý pricestuje na Divoký západ , aby zachránil unesenú dcéru čínskeho konzula .	pricestuje	6	Pres
" A vieš , ako dlho si tu ? "	vieš	2	Pres
Viem , že človeka spravodlivo vypočujú .	vypočujú	5	Pres
Nikto neprotestoval , že sa predbiehame .	neprotestoval	1	Past
Keď ho vypije , majú ho zabiť .	vypije	2	Pres
Vláda pripraví stratégiu riadenia štátneho dlhu , ktorej realizáciou príde k zníženiu nákladov štátneho rozpočtu .	pripraví	1	Pres
Usmial sa sám pre seba .	Usmial	0	Past
“ Čo bude stáť za to ! “ skríkla som .	skríkla	8	Past
Prestala som na to myslieť .	Prestala	0	Past
Medzitým prišlo na plaváreň zopár deciek z oddielu a ich hlasy sa ozývali po vykachličkovanom priestore .	ozývali	12	Past
Berte to tak , že ich píšu Marťania , s ktorými sa nikdy nedorozumiete .	píšu	6	Pres
" Nenávidím mravnú čistotu , nenávidím dobrotu !	nenávidím	5	Pres
Nikto mi neodpovedal .	neodpovedal	2	Past
Verila , že neurobím to čo ona .	Verila	0	Past
Rozvíjajú sa jednotlivé kniežatstvá .	Rozvíjajú	0	Pres
Drobná žena s pieskovými vlasmi zružovela a ústa otvárala a zatvárala ako ryba na suchu .	otvárala	8	Past
Z nešikovného mladíka sa stal šikovný vrtký chlapík , ochotný ukázať , čo vie .	vie	13	Pres
Navrhne systém transparentného financovania mediálneho prostredia .	Navrhne	0	Pres
Urobia z neho človeka . “	Urobia	0	Pres
More postupne zmizlo a ona sa otočila ku mne .	zmizlo	2	Past
Natoľko ma zaskočil , že som ho skoro ostriekala .	ostriekala	8	Past
Novozaložené mesto rýchlo zatláča do úzadia susedné centrum na hradisku Timerevo .	zatláča	3	Pres
V prijímacej sieni to vyzeralo , akoby sa tadiaľ prehnala búrka .	prehnala	9	Past
Musíme uznať , že rok 2004 bude významný pre 10 európskych štátov .	Musíme	0	Pres
“ Ricka zaujímajú vážne veci , “ namietla Blythe .	zaujímajú	2	Pres
Žije šťastne , nemá povinnosti a nič jej nechýba .	nechýba	8	Pres
Berte to tak , že ich píšu Marťania , s ktorými sa nikdy nedorozumiete .	nedorozumiete	13	Pres
Za oknom sa brieždilo .	brieždilo	3	Past
To sa menuje iniciatívnosť a innovatívnosť .	menuje	2	Pres
Datácia pečate vychádza z hypotetického predpokladu Izjaslavovej vlády v Novgorode v rokoch 1052 ‐ 1054 .	vychádza	2	Pres
Sklo je prirodzene náchylné rozbiť sa a plech nezaručuje odolnosť voči vlhkosti .	nezaručuje	8	Pres
“ Nenávidí Mauglího a túži po pomste , “ vysvetľoval Baghíra .	túži	4	Pres
Veľmi ma to prekvapilo .	prekvapilo	3	Past
Pri dychovke , čo kvôli nemu vyhrávala , tancoval s istou slečnou myškou ako divoch .	tancoval	8	Past
“ Nemyslím , “ odvetila som .	Nemyslím	1	Pres
Dnes meškáš , povedala , bála som sa , že neprídeš .	neprídeš	10	Pres
Zdalo sa mu , že naň čakal celý život .	čakal	6	Past
Nepatrí teda k spomenutému typu „ poľnohospodárskych miest “ .	Nepatrí	0	Pres
Vtom sa otvorili dvere a vošiel dnu lykožrút Fridolín .	vošiel	5	Past
“ Ty mi neveríš , však ? “	neveríš	3	Pres
Maja s Vilkom sedeli na lesnej čistine a vymýšľali si o nich príbehy .	vymýšľali	8	Past
" Hráš , vyhráš , hráš , prehráš .	prehráš	7	Pres
Nemyslite si , že nepôjdu .	nepôjdu	4	Pres
“ A nikto ma nechce . “	nechce	4	Pres
Ani v ten deň , ani neskôr si neželala , aby som použil prezervatív .	použil	12	Past
“ Zbytočne sa so mnou hádaš .	hádaš	5	Pres
Stala si na kameň a začala vrzúkať .	začala	5	Past
" Záleží mu iba na sebe , " opakoval po nej .	Záleží	1	Pres
Publikum nevie , či sa má smiať alebo plakať , ale napokon sa rozosmeje .	rozosmeje	13	Pres
Robili sme to v mori a ja som necítil váhu Soninho tela .	Robili	0	Past
Spýtal som sa ho , ako sa volá , ale ono mi nechcelo povedať svoje meno .	nechcelo	12	Past
Z týchto vzájomných kontaktov totiž vyplývajú isté indície o tom , do akej miery mohli byť myšlienky rímskych reformátorov recipované uhorskou cirkvou a jej zákonodarstvom .	vyplývajú	5	Pres
“ Prisahám na svoj včelí život , že môj kamarát stratil pri nehode vedomie a prebral sa iba zázrakom ! “	Prisahám	1	Pres
Vláda uskutoční revíziu úradov , pripraví zmeny v pracovno - právnej legislatíve a uskutoční reorganizáciu štátnej správy .	pripraví	5	Pres
Internet je médium , ktoré lezie pod kožu .	lezie	5	Pres
Vláda podporí doriešenie vlastníckych vzťahov k pôde a rozvoj trhu s pôdou .	podporí	1	Pres
Na druhom konci linky som začul jej hlas .	začul	5	Past
“ Nemôžem to počúvať ! “ zamrmlala som a pohodlne sa oprela .	Nemôžem	1	Pres
Asistovali im naše sestry , ktoré v zariadení pracujú .	pracujú	8	Pres
Volám sa Krist Tarapi .	Volám	0	Pres
“ Vezmeš Mauglího do osady , “ prikázal mu Baghíra .	Vezmeš	1	Pres
“ Odvahu veru máš .	máš	3	Pres
Zajac mohol byť vykladaný v systéme predkresťanských názorov jednak ako symbol plodnosti / dodnes spájame na veľkú noc vyobrazenia zajacov s vajíčkami , Nemci počas tohto sviatku hľadajú v záhrade vajíčka ukryté veľkonočným zajacom / .	hľadajú	27	Pres
Bola Ruska a ja som po nej túžil .	túžil	7	Past
Vláda zabezpečí novelu Zákonníka práce a zákona o verejnej službe tak , aby umožnila individuálnu diferenciáciu miezd a mobilitu zamestnancov v zdravotníckych zariadeniach .	umožnila	13	Past
Nikto z nich nevie nič o mojom ruskom dobrodružstve .	nevie	3	Pres
Spomenul si , že sedí s drevenou bábkou , na ktorej zarobí milióny .	sedí	4	Pres
“ Ani sa nečudujem , že pre ňu nemôžete nič vymyslieť .	nečudujem	3	Pres
“ Si v poriadku , Amy ? “ spýtal sa potichu chlapčenský hlas , keď som sa kašlúc vynorila .	spýtal	8	Past
Straník žije od narodenia po smrť pod dozorom Ideopolície .	žije	1	Pres
Dva ostrihomské kánony ustanovujú záležitosti okolo biskupov .	ustanovujú	3	Pres
“ Môžem si to ešte rozmyslieť ? “ spýtala sa .	spýtala	8	Past
“ Musím ťa zaviesť do osady , “ vyhŕkol napokon Balú .	Musím	1	Pres
Hľadala som niečo , čo mamu uspí .	uspí	6	Pres
Lorine prsia ma zľahka tlačili na hrudníku , a o poschodie vyššie ležala v studenej izbe mŕtva Marga .	tlačili	4	Past
Vláda pripraví legislatívny rámec inštitucionálneho vzdelávania zdravotníckych pracovníkov prostredníctvom rezortu školstva s možnosťou postgraduálnej prípravy pracovníkov v zdravotníctve v školách a inštitúciách , ktoré získajú akreditáciu pre príslušný typ vzdelávania .	pripraví	1	Pres
Išlo to !	Išlo	0	Past
Zdalo by sa teda , že Somogyvárske opátstvo bude vďaka zväzku so svojím materským opátstvom súčasťou clunyjskej „ kongregácie “ .	Zdalo	0	Past
Ten okamih prerušil prenikavý zvuk .	prerušil	2	Past
Zobudilo ma zvonenie telefónu .	Zobudilo	0	Past
Ja som nehľadal Istanbul ani bývalé hlavné mesto nejakej inej ríše .	nehľadal	2	Past
Euroáziu chráni jej obrovská rozloha .	chráni	1	Pres
Veci sa vyvinuli inak , než som sa obával .	vyvinuli	2	Past
A uzlovým bodom všetkých právnych formúl , ktoré sa týkajú rozoberaných hnutí , je vzťah tohto spoločenstva k štátnej moci , t . j . stret sveta šamanistického dualizmu s predstaviteľmi kniežacej moci , zjednocujúcimi krajinu .	týkajú	9	Pres
Rád vidím , ako kopú nohami .	vidím	1	Pres
Chichúňala sa a s džbánom na hlave sa pobrala do osady .	Chichúňala	0	Past
Istý zmysel v ňom nachádzali moji neprajníci .	nachádzali	4	Past
Spomenul som si na dve veci : na hysterickú eufóriu učiteľov po incidente , pri ktorom sa spomenulo meno mytologického božstva záhrobného sveta .	Spomenul	0	Past
Chcem jej uniknúť , zväzuje mi nohy .	zväzuje	4	Pres
Človek nikdy nevie , na čo natrafí .	nevie	2	Pres
“ Gól ! “ natešne kričí a pyšne sa obzerá .	kričí	5	Pres
Zajtra určite zasa vyjde slniečko !	vyjde	3	Pres
Začudovane zlietla nižšie a zistila , že je to veľké tiché lesné jazierko , v ktorom sa zrkadlí obloha .	zrkadlí	17	Pres
Podľa N . M . Tichomirova ide len o označenie ich sociálneho postavenia , my však vyslovujeme domnienku , že ide o pozostatok matriarchátu , zvlášť silného u ugrofínskych plemien .	vyslovujeme	16	Pres
“ Oslavujeme na tvoju počesť , “ povedala Halima .	Oslavujeme	1	Pres
Tá si vie vždy poradiť .	vie	2	Pres
Uvidíme , ako do celé dopadne .	Uvidíme	0	Pres
Na lúke vrcholili prípravy na dožinkovú slávnosť .	vrcholili	2	Past
Ocení ju aj " princezná na hrášku " .	Ocení	0	Pres
Prekvapená videla , ako zvonka preniká do spálne jemné modravé svetlo .	preniká	5	Pres
Vytriezvel som .	Vytriezvel	0	Past
Ja ich poznám .	poznám	2	Pres
Keď mama v ten deň dočítala list , neplakala .	neplakala	8	Past
Džafar oboma rukami schmatol čarodejnú palicu .	schmatol	3	Past
Svetové ríše , silné krajiny , politické systémy vznikajú a zanikajú , nič netrvá večne .	netrvá	13	Pres
“ Ty žartuješ ! “ odvetila som .	žartuješ	2	Pres
Ako starý priateľ tvojho nebohého otca považujem za potrebné , aby sme sa porozprávali celkom otvorene .	považujem	6	Pres
Nezáleží na tom , čo povieš či urobíš ; záleží jedine na tom , čo cítiš .	urobíš	7	Pres
Čakal som v obývačke , mal som na sebe oblek s kravatou .	Čakal	0	Past
“ V poslednom čase uvažujem často o svojej budúcnosti . “	uvažujem	4	Pres
Bolesť opäť ustúpila .	ustúpila	2	Past
Znovu sa ozval zvonivý hlas a nocou sa niesla prekrásna melódia .	ozval	2	Past
Vláda urýchli a finančne posilní zákonom regulovaný proces vysporiadania vlastníctva pôdy a pripraví komasáciu a proces definitívneho doriešenia vydávania náhradných pozemkov .	urýchli	1	Pres
Na pokojnej hladine plával medený odraz mesiaca .	plával	3	Past
Celý svet vyvalí oči , keď Belu a Gastona zbadá taký pár málokde zočí , krásavci jedna balada .	vyvalí	2	Pres
Lori nemala ani najmenšie podozrenie , že vo mne sa prebudilo zviera .	prebudilo	10	Past
Pomyslel som si , že keď ju tam zvalili a vláčili po uliciach , podarilo sa jej nejako utiecť , ako utekajú sochy , a prišla sa postaviť sem .	zvalili	8	Past
“ Viem , “ povedala som a vystúpila z auta , “ ale ak budem myslieť len na zábavu , môžem ísť zametať chodníky . “	môžem	20	Pres
Lenže oni neznesú , aby sa človek cítil takto .	neznesú	2	Pres
Jillina mama s otcom tam zamračení meravo sedeli , ako keby chceli silou vôle dotlačiť dcéru na stupienok víťazov .	sedeli	7	Past
Stále si myslíš , že sú štyri .	myslíš	2	Pres
Nehryzie , však ? “	Nehryzie	0	Pres
Tak tomu hovorím názorný príklad fungovania zóny najbližšieho vývinu , o ktorej som písala minule !	písala	13	Past
“ Veď Rahim povedal , že spolu urobíme obchod .	urobíme	7	Pres
“ Už ste v poriadku ? “ starostlivo sa pýtala Maja .	pýtala	9	Past
Zdivočenci sa zarazili .	zarazili	2	Past
Keby som ich mohla premeniť na chrobáky , obidvoch by som bez štipky milosrdenstva zabila .	mohla	3	Past
Reklama nás každý deň bombarduje rôznymi výzvami , sľubuje bohatstvo , zdravie a úspech .	sľubuje	8	Pres
Prežila dobrodružnú a namáhavú noc .	Prežila	0	Past
Začiatkom 11 storočia bolo pomerne málo významným sídlom — nespomína sa napr . pri delení údelov Vladimírovým synom .	nespomína	9	Pres
Odteraz sme jej rodičia , tak ju musíme niesť , “ povedala potom Vilkovi .	musíme	7	Pres
Jediná nádej , že ju uvidím , bola virtuálna , závisela od toho , či sa rozhodne trápiť ma vo sne .	uvidím	5	Pres
Niečo vás porazí . Život vás porazí . "	porazí	6	Pres
Ak raz človek spáchal ideozločin , určite ho raz čaká smrť .	spáchal	3	Past
Počul , ako sľubuje klamať , kradnúť , falšovať , vraždiť , rozširovať drogy , prostitúciu , a pohlavné choroby , liať deťom vitriol do tváre .	sľubuje	3	Pres
Rovnakého problému sa týka i posledný z ostrihomských kánonov , ktorý sa venuje vlastnému ordinačnému právu .	týka	3	Pres
Ja sa nebojím možnosti , že na seba vrhnem zlé svetlo .	vrhnem	8	Pres
Vláda prehodnotí doterajší spôsob podpory malého a stredného podnikania s akcentom na územnú samosprávu a prihraničnú spoluprácu .	prehodnotí	1	Pres
Potom som sa po špičkách odkradla do kuchyne a potichu som vypla hodiny .	vypla	11	Past
Na chvíľu Winston ignoroval ciferník .	ignoroval	3	Past
Pozoroval som každý štvorcový milimeter jej tváre .	Pozoroval	0	Past
Zničíme ho ! “ kričali .	Zničíme	0	Pres
Voda bola chladná ako vždy , a tak som si na zahriatie zaplávala niekoľko dĺžok .	zaplávala	12	Past
“ Neviem , “ povedala som váhavo .	Neviem	1	Pres
Na druhej strane jeho činy neupravuje nijaký zákon , ani nijaký jasne sformulovaný kódex správania .	neupravuje	5	Pres
Vďaka týmto skúsenostiam pre mňa teoreticky neexistovalo nijaké tajomstvo súvisiace s túžbami , ktoré nútia muža pokúšať sa o zblíženie so ženou .	nútia	14	Pres
Pri príležitosti svojho odchodu a ukončenia zimného obdobia som vyhlásil , že zaplatím koňak všetkým , ktorí budú od dvanástej až do tretej poobede v kaviarenskej časti obchodu .	zaplatím	12	Pres
Od straníkov sa vyžadoval podobný názor , aký mali starovekí Židia , ktorí síce vedeli , že všetky iné národy uctievajú nepravých bohov , ale to bolo všetko , čo o nich vedeli .	vedeli	14	Past
Otočil sa a prekvapene sa díval .	Otočil	0	Past
“ Bude tam titulok : Slávna rekordérka fotografuje reportérov , “ povedala Blythe .	fotografuje	7	Pres
Kráčal chodbou s bielymi kachličkami a mal pocit , že sa prechádza na slnku , v pätách mu kráčal ozbrojený dozorca .	prechádza	11	Pres
Odstránili sa odtiaľ všetky dvojvýznamy a významové odtiene .	Odstránili	0	Past
Chris zažmurkal .	zažmurkal	1	Past
Čakal som , kým zaparkuje auto , a potom sme išli do kaviarne pri ceste .	Čakal	0	Past
“ Tak , čo mi na to povieš ? “ spustil na Vilka .	povieš	7	Pres
Samozrejme , že som mu nepovedala , že mám domáce väzenie .	nepovedala	5	Past
Uvedomuješ si , aká osamotenosť nás potom čaká ?	Uvedomuješ	0	Pres
Ľahol som si do postele .	Ľahol	0	Past
Jedného dňa sochu odtiaľ strhol dav , ktorý rozzúrilo jej namyslené povýšenectvo .	strhol	4	Past
Po očku som sledovala , ako vkĺzol za volant .	sledovala	3	Past
" Len preto , že uprednostňujem klad pred záporom .	uprednostňujem	5	Pres
Na niektorých uliciach metropoly sa matky ani na chvíľku neodvážia nechať svoje bábätká samotné .	neodvážia	9	Pres
Uvedomujem si to , takáto obhajoba prezrádza určitý komplex .	Uvedomujem	0	Pres
Zovrel ju v náručí a vtedy zistil , že bozkáva živú , teplú tvár .	zistil	6	Past
“ Už dávno som opustila svoj roj , “ nesmelo odvetila Maja .	opustila	4	Past
Chvíľu čakal , ale mnoho ľudí mu netlieskalo .	netlieskalo	7	Past
Dal som mu takéto meno , keď som s akousi ľahkosťou presvedčil sám seba , že toto meno najlepšie pristane môjmu hrdinovi .	pristane	19	Pres
Boris svieti zrkadielkom do očí , končím , “ hlásil vysielačkou Vilko .	končím	6	Pres
Mama sa blížila spolu s ním .	blížila	2	Past
“ Už letím ! “ kričí Polly .	kričí	5	Pres
“ Tentoraz by sme mali hudbu vynechať a usporiadať maratónsky beh , “ navrhol Rudko a všetci nadšene súhlasili .	súhlasili	18	Past
Od tej chvíle vstupuje do hry slovenská časť Uhorska .	vstupuje	3	Pres
Teraz sa v noci budievam zo spánku a hrdlo mi zviera úzkosť : trápi ma nočná mora , že aj ja som v dave , ktorý ženie mamu v ústrety smrti .	zviera	10	Pres
Otočil sa ku mne a nedopovedal .	Otočil	0	Past
Chutila výborne .	Chutila	0	Past
Teraz som cítil , že nemám silu pokračovať pred Lori .	nemám	5	Pres
“ Ty nerozumieš , “ zašepkala Jazmína .	zašepkala	5	Past
Na rozdiel od svätoštefanskej legislácie sú tí , ktorí v nedeľu neprídu do kostola , potrestaní prísnejšie – telesným trestom .	neprídu	11	Pres
Spočiatku som mala nepríjemný pocit , že sa na mňa všetci dívajú , ale trvalo to len moment .	dívajú	11	Pres
Zachvátila ma panika , nevládal som utekať .	nevládal	4	Past
Od tej chvíle som sa myšlienky , že tá mačka mi vidí do duše , nevedela zbaviť .	vidí	11	Pres
Potom zlezie zo stromu a uteká domov . . .	zlezie	1	Pres
Chodíš tadiaľto domov pravidelne ?	Chodíš	0	Pres
Herkules si ho však nevšímal .	nevšímal	4	Past
Má pokojný , rozvážny hlas , dbá na každé slovo a tvári sa vážne .	dbá	6	Pres
Potom sa otvorili dvere a vošla mamička .	vošla	5	Past
“ Ako môžem byť múdra , keď ustavične meliete , “ odvrkla Maja .	môžem	2	Pres
Program prehliadky nájdete tu .	nájdete	2	Pres
Každá od neho však utiekla , pretože len čo otvoril ústa , ovalil ich zápach cesnaku a syra .	utiekla	4	Past
Zatvoril som oči .	Zatvoril	0	Past
Pustil Winstona a zároveň ho postrčil dozorcom .	postrčil	5	Past
Po desiatich dňoch lekárske konzílium posilnili českí lekári .	posilnili	5	Past
“ Vieš , musím chvíľu popremýšľať , “ povedal Káa .	musím	3	Pres
Ako som vychádzala zo školy , zbadala so , že sedí na trávniku pri zastávke môjho autobusu .	vychádzala	2	Past
“ Ubezpečujem vás , že nič nehrozí , “ kričal žene sultánov hlavný vezír Džafar .	nehrozí	6	Pres
Nečudujem sa , že výborne urobil záverečné ročníkové testy .	Nečudujem	0	Pres
Gaston od úžasu onemel , keď uvidel , ako Bela cvála na koni cez kamenný most .	uvidel	6	Past
Prečo lovíme zelené kravičky ?	lovíme	1	Pres
Povzdychol si .	Povzdychol	0	Past
O ' Briena vyparia .	vyparia	3	Pres
Zber uskutočňoval pomocou siete platených agentov .	uskutočňoval	1	Past
S tými slovami sa vzniesla a odletela .	odletela	6	Past
Jeho odvaha akoby sa zrazu sama od seba zakalila .	zakalila	8	Past
“ Mhm , “ povedal Aladin , kým čítal .	čítal	8	Past
Niekedy zaútočia najprv na oči .	zaútočia	1	Pres
“ Amy , “ zašepkal Chris , objal ma okolo krku a hladkal ma po vlasoch .	hladkal	12	Past
Mešťania sa nazlostili a upozornili Herkulovho otca , nech ho viac do mesta nepúšťa .	nazlostili	2	Past
Venujem svojej manželke Lili	Venujem	0	Pres
Priplával k okraju a stiahol polystyrénovú dosku .	Priplával	0	Past
Mala namaľovanú tvár .	Mala	0	Past
Dobre som vedela , čoho sa tá dôvera týka .	týka	8	Pres
" Práveže jestvovala !	jestvovala	2	Past
Pošlem ťa do soľných baní . "	Pošlem	0	Pres
Možno ti otec pomôže . “	pomôže	3	Pres
“ Ako môžem byť múdra , keď ustavične meliete , “ odvrkla Maja .	meliete	8	Pres
Pomysli na slobodu , ktorou ťa Boh obdaril , na možnosti , ktoré sa vďaka tomu pred tebou otvorili .	obdaril	7	Past
“ To je legálne ? “ vykríkol ktosi a všetci sa pustili do rehotu .	vykríkol	6	Past
Keď som čítala posledné riadky , myslela som na mamu , ktorá robila zázraky , aby sme dajako vyšli .	robila	12	Past
O kom to chrobáky rozprávali ?	rozprávali	4	Past
Všetci vedeli , že na papieri sa každý kvartál vyrobili astronomické počty topánok , kým vari polovica obyvateľov Oceánie chodila bosá .	vedeli	1	Past
Povedal som jej , že potrebujem na noc nejaké dievča .	potrebujem	5	Pres
Tak či onak ho dostane Ideopolícia .	dostane	4	Pres
V podstate som nedúfala , že príde , no keď som ho zbadala na opačnom konci preplnenej a zadymenej telocvične , myslela som si , že sa mi marí .	zbadala	12	Past
“ Ako to myslíš ? “	myslíš	3	Pres
Hľadala som v zásuvke nejaký papier na poznámky , keď som zbadala formulár na udelenie finančnej podpory počas štúdia na vysokej , ktorý mi dal ešte pred niekoľkými týždňami výchovný poradca pán Hatch .	zbadala	11	Past
“ Chcela by som , aby ste mi vyveštili budúcnosť , ale nemám veľa peňazí . “	nemám	12	Pres
Vláda sa zaväzuje v praxi realizovať už schválenú dikciu Európskej charty regionálnych alebo menšinových jazykov .	zaväzuje	2	Pres
Radža zdvihol hlavu a hrozivo zavrčal .	zdvihol	1	Past
Neodvážila sa otvoriť oči a ja som pochopil , že očakáva niečo strašné .	očakáva	10	Pres
Hladko som vkĺzla pod vodu a vynorila sa na hladine .	vkĺzla	2	Past
Jazmína zakašlala .	zakašlala	1	Past
V dome im Bibi vysvetlila , čo dáva psíkom jesť a kde majú svoje misky .	dáva	7	Pres
Politicky sa Rus rozdrobuje , cirkev , naďalej sa upevňujúca , slúži ako kladný protipól úpadku .	rozdrobuje	3	Pres
Flip sa ponúkol , že usporiada dobročinnú zbierku .	usporiada	5	Pres
Tu boli zvyknutí vyberané spôsoby a správali sa podľa spoločenských pravidiel .	správali	6	Past
Pokračovala v nezmenenom tempe stále bližšie k jeho stolu .	Pokračovala	0	Past
Maja usilovne premýšľala , kto by jej mohol najlepšie pomôcť .	premýšľala	2	Past
“ Tu je diera , “ zašepkala som a vybrala trs trávy , ktorý zakrýval vyčnievajúci stupienok z palmového dreva .	vybrala	9	Past
“ Vysvetlíme mu , že ja také niečo nikdy neurobím ! “	Vysvetlíme	1	Pres
“ To sa zle skončí , “ kuvikal dážďovka Vendelín , ale nikto ho nepočúval .	skončí	4	Pres
Polly to nesmierne potešilo .	potešilo	3	Past
“ Zajtra nás čaká dlhá cesta . “	čaká	3	Pres
Netrvalo dlho , a policajti prišli do kaviarne zatknúť zlodeja .	prišli	5	Past
Požiadavka primeraného vzdelania klerika nepotrebuje obšírnejší komentár .	nepotrebuje	4	Pres
Pani Shepherdová sa zasmiala , no mala som nepríjemný pocit , že mi neverí .	neverí	13	Pres
Máš však nebezpečnú zbraň — žihadlo .	Máš	0	Pres
Spev kohúta máva aj vo všednom , obyčajnom živote dvojaký význam .	máva	2	Pres
Rozprávali sme sa až po pretekoch .	Rozprávali	0	Past
“ Máte pekné tykadlá , “ povedala .	Máte	1	Pres
Naším zámerom je odstrániť najmä deformácie , ktoré zakladajú neopodstatnené nerovnosti medzi občanmi alebo zavádzajú do sociálneho systému cudzorodé prvky , akým je napríklad nesystémové včlenenie kúpeľnej starostlivosti do sociálneho poistenia .	zakladajú	8	Pres
Iba my s Chrisom sme tak zúrivo nepísali a nehrbili sa nad lavicami .	nepísali	7	Past
Keď preberal znova volant , prikryl mi ruky , ktoré ostali naspodu .	preberal	1	Past
Amaris zdvihla parádny ružový šašovský kostým .	zdvihla	1	Past
Trkotali , sŕkali med a zapíjali ho pálenkou !	sŕkali	2	Past
Bez slova a bez pozdravu Martin odišiel , ticho zatvoril za sebou dvere .	odišiel	6	Past
Toto ministerstvo však nemuselo uspokojovať mnohoraké potreby straníkov , ale opakovať celú operáciu na nižšej úrovni pre blaho proletariátu .	nemuselo	3	Past
Podľa viery ugrofínskych Čuvašov výšivka konskej hlavy na ženskej hrudi chráni pred nebezpečím pôrodu .	chráni	10	Pres
Nakoniec sme priniesli z kuchyne taniere , šalát a fašírku .	priniesli	2	Past
Jabĺčko vypadlo dievčine z ruky .	vypadlo	1	Past
“ Chcem to spraviť tak , aby si ostal v džungli . “	ostal	8	Past
Mauglí stál v pozore , keď plukovník pochodoval okolo neho na koniec radu a zasa späť .	pochodoval	7	Past
Chris sa obrátil a zbadal , že naňho pozerám , akoby mi čítal myšlienky .	pozerám	8	Pres
Sadol som si do podniku pri kine a čakal , kým príde určená hodina .	príde	11	Pres
Zrazu sa ma zmocnilo presvedčenie , že som to zbabrala , ani kytička sedmokrások ma nemohla utešiť .	zbabrala	9	Past
Pamätajte na Ježišove slová : Kto vytrvá do konca , bude spasený .	vytrvá	6	Pres
Nezhromaždilo sa tam veľa ľudí .	Nezhromaždilo	0	Past
Maja s Vilkom poprisili o kúsok smrčka a statočne ho prežúvali , len aby sa zavďačili hostiteľovi .	zavďačili	15	Past
Posledný kánon II . kolomanovskej synody o celibáte sa svojím obsahom vymyká prísnejšiemu tónu uznesení tohto cirkevného snemu .	vymyká	11	Pres
“ Viete čo ? “ povedal Ferdo kamarátom .	Viete	1	Pres
Jumbo si dupol nohou a vystrčil hrozivé tykadlá .	dupol	2	Past
A tu či inde sa v úplnej tajnosti nachádzali riadiace mozgy , ktoré koordinovali toto úsilie a určovali politickú líniu : rozhodovali o tom , že tento fragment minulosti sa zachová , tento sa sfalšuje a ďalší prestane jestvovať .	nachádzali	8	Past
Nedovolím to ani jednému , ani druhému .	Nedovolím	0	Pres
Pomyslel na obrazovku s uchom , ktorá nikdy neusne .	neusne	8	Pres
“ Musíš mať fotografickú pamäť . “	Musíš	1	Pres
Abdullah pokrčil plecami .	pokrčil	1	Past
“ Mám ťa vyskúšať ? “	Mám	1	Pres
Dúfam , že majú pravdu . “	Dúfam	0	Pres
“ Neviete , že vám piraňa za pár sekúd obžerie všetko mäso ? “	obžerie	9	Pres
Netrvalo dlho a obaja lavínu skyprili , takže sa párik cvrčkov ľahko dostal von .	Netrvalo	0	Past
Dnes to dotiahnu ďaleko takí , ako si ty . . .	dotiahnu	2	Pres
Isteže , už dnes nejestvuje dôvod či opodstatnenie na páchanie ideozločinov .	nejestvuje	4	Pres
“ Som Makulienka , “ vraví motýľovi .	vraví	5	Pres
Zakrátko pochopil , že sú to zlodeji , čo im ukradli med .	ukradli	10	Past
Jeho nádej opäť zhasínala .	zhasínala	3	Past
Ako základ zbierky to stačí .	stačí	4	Pres
Potrebujem finančnú podporu , ak chcem študovať .	chcem	5	Pres
Na takomto mieste prelínania sa dvoch kultúr sa ľahšie uchovávajú archaické prežitky .	uchovávajú	9	Pres
S tým však moja okamžitá strata optimizmu nesúvisí , a nesúvisí ani so skutočnosťou , že predstava takého scenára bola nezmyselná .	nesúvisí	10	Pres
“ Prečo ste neoslavovali aj vy ? “ vypytoval sa Vilko .	neoslavovali	3	Past
Touto syntézou môžme vysvetliť mnohé osobitosti hospodárskeho i politického života oblasti .	môžme	2	Pres
Z televíznej obrazovky zaznel zúrivý , ohlušujúci rev .	zaznel	3	Past
Zrazu sa nad ňou ktosi tichučko zasmial a akýsi hlások sa jej spýtal : “ Prečo sa bavíte so bzdochou ? “	zasmial	6	Past
Už dávno som stratil kontakt so svetom kina a v nových televíziách ma nikto nepoznal .	nepoznal	14	Past
“ Vezmem ho , “ zvolala som a letela k nemu , “ určite je to pre teba . “	Vezmem	1	Pres
M . N . Tichomirov fakt jednostranné vykladá len ako príčinu „ hladových vzbúr “ , Frojanov si všíma dôležitú okolnosť — volchovia sa zjavujú , aby zabezpečili blahobyt , hojnosť , úrodu .	vykladá	7	Pres
“ Vysvetlíme mu , že ja také niečo nikdy neurobím ! “	neurobím	9	Pres
Od straníkov sa vyžadoval podobný názor , aký mali starovekí Židia , ktorí síce vedeli , že všetky iné národy uctievajú nepravých bohov , ale to bolo všetko , čo o nich vedeli .	uctievajú	20	Pres
Kalif sa nahol dopredu , očividne ho to zaujalo .	nahol	2	Past
Ten grobian sa usmieval a vraví : “ ' Koho to tu máme ? '	vraví	5	Pres
Neveriacky som sa na ňu dívala , cítiac , ako ma zadúša od hnevu .	zadúša	11	Pres
V mnohých prípadoch to zaberie .	zaberie	4	Pres
“ Balú , ty žiješ ! “ zvolal Mauglí a hodil sa mu okolo krku .	Balú	1	Pres
Mama sa poteší , pomyslel som si .	poteší	2	Pres
“ Pochodujeme naprieč celým územím ! “	Pochodujeme	1	Pres
Stvoriteľ chcel , stvoril a riadi svoje stvorenie .	riadi	5	Pres
Spravované prostriedky poistencov dosahujú objem 200 mil .	dosahujú	3	Pres
Zažiješ neuveriteľné dobrodružstvá .	Zažiješ	0	Pres
Vtedy sa rozhodli , že nadišiel čas , aby mu ukázali zlatý medailón , ktorý mal na krku , keď ho našli .	rozhodli	2	Past
Vláda podporí dosiahnutie kritérií európskej úrovne stavania , kvalifikácie firiem , úspor energie a energetickej certifikácie budov .	podporí	1	Pres
“ Veď ti vravím , “ odvetil Balú .	vravím	3	Pres
Proleti si zachovali ľudskosť .	zachovali	2	Past
" Koľko prstov zdvíham , Winston ? "	zdvíham	3	Pres
Ponáhľala som sa , lebo ak pozrú z okna , uvidia , ako sedíme na múre .	pozrú	6	Pres
A začal som piť .	začal	1	Past
V Oceánii právo nejestvuje .	nejestvuje	3	Pres
A hneď volala motýľa Emanuela , aby ju tam v noci nenechával .	volala	2	Past
Zváži motivačné pravidlá pre využívanie domácich primárnych energetických zdrojov , vrátane využívania obnoviteľných zdrojov energie .	Zváži	0	Pres
Vilko sa v tej chvíli prebral .	prebral	5	Past
Nezáleží na tom , čo povieš či urobíš ; záleží jedine na tom , čo cítiš .	Nezáleží	0	Pres
Zničí ich raz a navždy !	Zničí	0	Pres
Alebo spoločne spáchajú samovraždu .	spáchajú	2	Pres
Prvý raz mám príležitosť byť so spisovateľom a filmovým scenáristom , povedala .	mám	2	Pres
Nemôžeš nikomu veriť . “	Nemôžeš	0	Pres
Neviem , či na mňa viac zapôsobila skutočnosť , že môjho starého otca zabili , alebo meno Hádes , ktoré náš hosť ticho precedil cez zuby .	precedil	23	Past
Džafar sa naňho opäť zahnal čarodejnou palicou .	zahnal	4	Past
A vyhrávam .	vyhrávam	1	Pres
Hmotný svet existuje , jeho zákony sa nemenia .	nemenia	7	Pres
Zatvorím oči a narátam do desať .	Zatvorím	0	Pres
Winston zdvihol šálku džinu , chvíľku naberal odvahu a potom obrátil do seba to tekuté svinstvo , ktoré malo pachuť oleja .	malo	18	Past
Myslíte si , že sa strana dostatočne nevenovala ekonomike ?	Myslíte	0	Pres
“ Nesmieš sa udrieť , nesmieš sa udrieť , nesmieš sa udrieť .	nesmieš	9	Pres
Sadli si na rímsu a Maja zreteľne videla , čo sa dnu deje .	Sadli	0	Past
V dome zavládlo hrobové ticho .	zavládlo	2	Past
Raz zbadala , ako pri potoku presvitá čosi červené .	presvitá	6	Pres
Priznám to rovno .	Priznám	0	Pres
Terk bežala k lagúne a vytiahla Tarzana , ktorý sa poriadne napil vody .	bežala	1	Past
Len čo som ju uvidel , mal som pocit , že mi pripomína ktorúsi z hrdiniek klasickej ruskej literatúry .	uvidel	4	Past
Mešťania sa nazlostili a upozornili Herkulovho otca , nech ho viac do mesta nepúšťa .	upozornili	4	Past
Keď mravenisku hrozilo nebezpečenstvo , statočne ho bránili .	bránili	7	Past
Niektoré úmrtia tak akosi predpokladáme , ľudia sa k nim systematicky dopracovávajú .	predpokladáme	4	Pres
Trochu sa zľakla , no pozrela hore .	zľakla	2	Past
Keď zazneli prvé tóny pomalej skladby , rozhodla som sa , že za ním pôjdem .	zazneli	1	Past
Dej románu sa odohráva na nej alebo pri nej .	odohráva	3	Pres
Spýtal som sa ho , ako sa volá , ale ono mi nechcelo povedať svoje meno .	volá	7	Pres
Musí to byť nejaký starý známy , uvažoval som .	Musí	0	Pres
Doteraz som sa učila , “ odvetila som , “ a bojím sa , že mi to vyfučí z hlavy . “	bojím	11	Pres
Po chvíli štartujeme automat elektronických šípok .	štartujeme	2	Pres
“ Máte Baghírovo slovo , “ dodal .	dodal	6	Past
Kasandra preto vyslala včielky popoludní na pole , aby nazbierali kukuricu .	nazbierali	9	Past
Od radosti sa rozosmiala , lebo niečo podobné by urobila i ona .	rozosmiala	3	Past
Čo povie ?	povie	1	Pres
Ale dlho ho potrebovať nebudeš , “ vraví pavúk Karkoško .	vraví	7	Pres
Nerob zo seba hlupáka , povedali mi .	povedali	5	Past
O chvíľu sa pri nej s hlasným bzučaním usadil komár .	usadil	8	Past
Spôsobuje mi najväčšie utrpenie .	Spôsobuje	0	Pres
Potom sa vrhol do vody a rozpleštil sa na člne , až ma od smiechu rozbolelo brucho .	rozpleštil	6	Past
Potrebovali sme istý čas , kým sme pochopili , že takáto pretvárka znamená zbytočné utrpenie .	Potrebovali	0	Past
Ja som vedel , že jej portrét sa nachádza medzi viečkami medailónu v skrini , kde sú uložené aj biele svadobné šaty so závojom .	nachádza	8	Pres
Odmietla , povedala , že nepije alkohol .	Odmietla	0	Past
Keď si Lori sadla do auta , sklonila sa nad volant , plecia sa jej roztriasli a ja som si zarazene uvedomil , že vzlyká .	vzlyká	24	Pres
Komárno nechce Cyrila a Metoda na verejnom priestranstve	nechce	1	Pres
“ Prosím vás , slečna , “ prosíkal .	Prosím	1	Pres
Posledný szabolcsský kánon , ktorý sa venuje kláštornému životu nariaďuje opátom a mníchom , aby sa nezúčastňovali na kalendových sedeniach , ale aby prijímali oblácie ich účastníkov v kláštoroch .	venuje	6	Pres
Žena sa postavila na stupienok s katedrou , otvorila triednu knihu a začala čítať naše mená .	otvorila	8	Past
“ Aša mi povedala , že to nevyjde .	nevyjde	7	Pres
Aj Maja so škriatkom opustili topoľ a leteli , kým nedoleteli k domu , kde sa v oknách ešte svietilo .	leteli	7	Past
Ona ustúpila dozadu , otočila sa mu chrbtom , ale ten chlap zostal pri zástupe žien .	otočila	4	Past
Vyrába umelé potreby , ktoré nás aktivujú , vyprázdňujú , ničia a zotročujú .	aktivujú	6	Pres
Vtom sa pred ním otvorila zem a vyliezla z nej tenká červenohnedá dážďovka .	vyliezla	7	Past
“ Slušne , “ zopakovala .	zopakovala	4	Past
Vládol tu čulý ruch , no Chrisa nevyrušil zo sústredenia .	nevyrušil	7	Past
Pracuje na Medzinárodnom letisku J . F . Kennedyho a volá sa Tom .	volá	10	Pres
Dokážem dobre vytipovať nezaradených ľudí .	Dokážem	0	Pres
“ Nepridátete sa ku mne , Alia ?	Nepridátete	1	Pres
“ Zabije ? “ zvolal Mauglí .	Zabije	1	Pres
Vrátila mi hárky s poviedkou .	Vrátila	0	Past
Práve sme sa pomilovali .	pomilovali	3	Past
Keď som vychádzal z izby , že za ním zájdem a poprosím ho o nejakú radu , opäť som pocítil svrbenie .	poprosím	11	Pres
Abu takisto pohladkal Rahima po hlave .	pohladkal	2	Past
“ Nepotrebujem nikoho ! “	Nepotrebujem	1	Pres
Chcela som jej povedať o Chrisovi , ale nedokázala som sa zdôveriť so všetkým , čo cítim .	cítim	16	Pres
“ Našla si ju ? “ spýtal sa Chris .	Našla	1	Past
Okrem rekodifikácie trestného práva vláda dopracuje legislatívny zámer rekodifikácie súkromného práva a na jeho základe vypracuje dlhodobý plán postupného vypracovania nových právnych predpisov .	dopracuje	5	Pres
“ Ospravedlníte ma na chvíľu ? “ spýtala sa .	Ospravedlníte	1	Pres
On aj nás prevedie cez križovatky	prevedie	3	Pres
Ja neviem .	neviem	1	Pres
Očakával som ich .	Očakával	0	Past
Švihák Pedro sa v letku obrátil a zmizol kdesi v diaľke .	zmizol	7	Past
Keď som sa raz vrátil zo sveta do rodného mraveniska , zhrozil som sa .	zhrozil	11	Past
Žijem , slečna , povedal som .	povedal	4	Past
Postupne sa zdvíhanie a klesanie ich hrudí spomalilo a prešlo do normálneho rytmu a s príjemným pocitom bezmocnosti sa od seba oddelili .	oddelili	21	Past
“ Buď ho pomôžeš nájsť , alebo ja prevezmem velenie ! “	prevezmem	8	Pres
Poslušnosť nestačí .	nestačí	1	Pres
Ľutujem to , úprimne .	Ľutujem	0	Pres
Niektorí vraveli , že Tatkov Gim vôbec nemusí byť až taký hlúpy .	vraveli	1	Past
Keď sa raz rozhodla piecť v takú nezvyčajnú hodinu , nikto jej v tom nezabráni .	nezabráni	14	Pres
Vážila som si tie slová , snívala o tom , že mi ich raz povie .	povie	14	Pres
Neviem , kedy som si tam prvýkrát všimol Doloru .	Neviem	0	Pres
Že sa utopím ?	utopím	2	Pres
Ona odíde prvá a po polhodine ju Winston bude nasledovať .	odíde	1	Pres
Winston poznal , že mu za hlavu prisúvajú akýsi ťažký prístroj .	prisúvajú	7	Pres
“ Šteklí ma .	Šteklí	1	Pres
Opatrne som vstala , aby som ju nezobudila a išla som vypnúť televízor .	nezobudila	7	Past
“ Ďakujem , “ odvetil polichotený Zlatko .	Ďakujem	1	Pres
Ako ho nájdem ?	nájdem	2	Pres
Takže teraz veľmi čakám , či niekto z mienkotvorných hláv Bútorovho elektorátu urobí sebakritickú analýzu tohto svojho fatálneho politického omylu .	čakám	3	Pres
“ Obviňujeme vás , že ste nám odcudzili drahocennú potravu , “ povedal prísne veliteľ a dal pokyn , aby ich zajali a postavili pred sudcu .	povedal	12	Past
Nenatrafili na nikoho , koho by sa mohli opýtať na cestu .	Nenatrafili	0	Past
No teraz ho Akéla zavolal .	zavolal	4	Past
Podarilo sa mi vybehnúť na chodbu , ale tam sa mi podlomili nohy .	Podarilo	0	Past
Pevnejšie pritlačila veko košíka a odháňala Syreetinu zvedavú opičku .	odháňala	5	Past
Žijem , slečna , povedal som .	Žijem	0	Pres
Tá žena mi položila ruku na hlavu a rozstrapatila mi vlasy .	rozstrapatila	8	Past
Ak si želáte dievča , povedala , zariadime to .	želáte	2	Pres
Potom vzal Balú Mauglího na plecia a Baghíra kráčal za nimi .	vzal	1	Past
Titan Ľadovec dokončil jeho dielo a zmrazil lávu dychom .	dokončil	2	Past
Myšlienka , že sa môžem stať otrokom svojich postáv , mi naháňala hrôzu .	môžem	4	Pres
Ty mi neveríš ? “	neveríš	2	Pres
Aby ma Chris nepovažoval za decko pretože , nemám mamin súhlas , nič som mu nevravela .	nevravela	15	Past
“ Nenávidí Mauglího a túži po pomste , “ vysvetľoval Baghíra .	Nenávidí	1	Pres
" Asi by som to vydržal , nebyť jednej veci , " povedal .	vydržal	5	Past
Niektoré úmrtia tak akosi predpokladáme , ľudia sa k nim systematicky dopracovávajú .	dopracovávajú	11	Pres
Zrejme padla na poranenú ruku .	padla	1	Past
Teší ma , “ jachtala som .	Teší	0	Pres
Nevládal by bežať , nevládal by uderiť .	nevládal	4	Past
Nado mnou sa ukladá tisícročná náplava .	ukladá	3	Pres
Ak odpovedala záporne , nenáhlil som sa .	odpovedala	1	Past
Zrejme odriekala modlitbu .	odriekala	1	Past
Z druhej strany neprišla nijaká odpoveď .	neprišla	3	Past
Do izby sa vrútila Júlia .	vrútila	3	Past
Pravdepodobne sa napokon nevyrobili vôbec nijaké topánky .	nevyrobili	3	Past
“ A prečo palác nepresťahujete inde ? “	nepresťahujete	4	Pres
Stavajú domy , čo plávajú na vode .	Stavajú	0	Pres
“ Rozumel .	Rozumel	1	Past
Len čo to Maja začula , zabudla na Hanibalovu prečnohu a ukázala žihadlo .	zabudla	6	Past
Ja pred jej príchodom neprežívam nič čarokrásne .	neprežívam	4	Pres
A veselili sa , kým nezapadlo slnko .	veselili	1	Past
Vlečiete sa ako slimáky !	Vlečiete	0	Pres
Ak drží grifon v pazúroch štyri púčky , vyjadruje sa tým jeho všadeprítomnosť .	vyjadruje	8	Pres
Naozaj mi šťastie prialo .	prialo	3	Past
Zasa sa ukáže slniečko .	ukáže	2	Pres
Keď si Lori sadla do auta , sklonila sa nad volant , plecia sa jej roztriasli a ja som si zarazene uvedomil , že vzlyká .	uvedomil	21	Past
“ V Aquitare jedia červíky , otec !	jedia	3	Pres
Vláda zvýši mieru informovania verejnosti v oblasti regionálnej politiky .	zvýši	1	Pres
Sledovalo línie Lorinho tela , hltalo ho očami .	Sledovalo	0	Past
" Nenávidím mravnú čistotu , nenávidím dobrotu !	Nenávidím	1	Pres
Mala som dojem , že som sa vrátila z cesty okolo sveta .	Mala	0	Past
Winston sa zľahka poškrabal na nose sponkou na spisy .	poškrabal	3	Past
V utorok píšeme test z astronómie .	píšeme	2	Pres
“ Čakali , že aspoň jeden z nás pôjde v ich šľapajach .	pôjde	8	Pres
Najprv som sa rozprávala s ostatnými dievčatami , tváriac sa , že si ju nevšímam .	nevšímam	14	Pres
Potrebujeme ľudí , ktorí budú ochotní počúvať svojho partnera , budú dostatočne vzdelaní na to , aby dokázali zaujať jasné stanovisko k mnohým problémom súčasnosti .	dokázali	17	Past
Rozsiahla a pomerne dobre organizovaná archeologická práca na teritóriu bývalého ZSSR , detailne zachytená v materiáloch časopisu „ Sovetskaja Archeologija “ / od roku 1990 Rosijskaja Archeologia / ho dáva k dispozícií veľké množstvo .	dáva	29	Pres
Keď som na nej otvoril dvere , zarazene som zastal na prahu : hrali tam šach dvaja učitelia .	zastal	9	Past
“ Vstávaj ! “ zvrieskol .	zvrieskol	4	Past
Ale ich vodca ma rázne prerušil .	prerušil	5	Past
Sľubujem , že všetko preberieme , “ presviedčal ma Chris .	Sľubujem	0	Pres
Očakával náš príchod .	Očakával	0	Past
" Tá nateraz postačí .	postačí	3	Pres
Na preklenutie rozdielov vo vzdelanostnej úrovni a štruktúre sa vláda zaväzuje v prvom roku volebného obdobia k vytvoreniu univerzity pre vysokoškolskú prípravu občanov maďarskej národnosti .	zaväzuje	10	Pres
“ Môžem byť vaším kapitánom ? “ spýtala sa .	Môžem	1	Pres
Milí konfirmandi , dnes sa stanete dospelými členmi nášho cirkevného zboru .	stanete	5	Pres
Moja matka by určite tvrdila , že minimálne stokrát .	tvrdila	4	Past
Blythe ostala chvíľu ticho , čo bol pre mňa jasný signál .	ostala	1	Past
Teraz sa v noci budievam zo spánku a hrdlo mi zviera úzkosť : trápi ma nočná mora , že aj ja som v dave , ktorý ženie mamu v ústrety smrti .	budievam	4	Pres
Ty ich neznášaš .	neznášaš	2	Pres
Čakala v sále .	Čakala	0	Past
“ Buď ho pomôžeš nájsť , alebo ja prevezmem velenie ! “	pomôžeš	3	Pres
" Ľutuješ , že si to neurobil ? "	neurobil	6	Past
“ To nič , “ odvetila som , ale pripúšťam , že som bola sklamaná .	pripúšťam	9	Pres
“ Máte Baghírovo slovo , “ dodal .	Máte	1	Pres
Wilsher , blondiak s nasprostastým výrazom na tvári , ktorého takmer nepoznal , ho s úsmevom pozýval na voľné miesto pri svojom stole .	pozýval	16	Past
Nič sme o sebe nevedeli .	nevedeli	4	Past
Ja som ich ani nepočúval , ani som si nič nemyslel .	nepočúval	4	Past
“ Ešte raz blahoželám , “ povedal Chris , keď si cestou späť sadol v autobuse vedľa mňa .	blahoželám	3	Pres
Prejav ma neprekvapil .	neprekvapil	2	Past
“ Takto to vyzerá na Mesiaci , “ povedala som Cheryl Wagnerovej , maturantke , čo sedela vedľa mňa .	vyzerá	3	Pres
M . N . Tichomirov fakt jednostranné vykladá len ako príčinu „ hladových vzbúr “ , Frojanov si všíma dôležitú okolnosť — volchovia sa zjavujú , aby zabezpečili blahobyt , hojnosť , úrodu .	zjavujú	24	Pres
Keď sa zasa vrátili do triedy , pani učiteľka im prečítala zaujímavú rozprávku .	vrátili	3	Past
Rozhodol sa letieť za nimi a za trest , že naňho zabudli , vzal so sebou všetkých susedov .	vzal	13	Past
Zajac mohol byť vykladaný v systéme predkresťanských názorov jednak ako symbol plodnosti / dodnes spájame na veľkú noc vyobrazenia zajacov s vajíčkami , Nemci počas tohto sviatku hľadajú v záhrade vajíčka ukryté veľkonočným zajacom / .	spájame	14	Pres
A potom som začal rozprávať v spánku .	začal	3	Past
Musí byť pohodlný , viem , aby sa v ňom Lienke dobre sedelo a dobre pérovaný , aby nedostala kočovú chorobu .	Musí	0	Pres
Rozumieš tomu ? "	Rozumieš	0	Pres
Nezdalo sa mi , že veštia nejaké zásadné zmeny .	Nezdalo	0	Past
Bratovi farárovi prajeme v tejto funkcii múdrosť , vytrvalosť a Božie vedenie .	prajeme	2	Pres
“ Ihneď ma pustite , “ zvolala Maja .	zvolala	6	Past
Mama nazrela do izby , aby sa presvedčila , či spím .	nazrela	1	Past
Cítila som , ako sa mi do hlavy hrnie krv .	hrnie	8	Pres
Lúčne svetielko sa stratilo v tme a o chvíľu už dievčatko z diaľky počulo veselú motýliu pieseň .	stratilo	3	Past
Chvíľu sme stáli vo dverách , pretože nás ovalil svieži závan klimatizovaného vzduchu .	ovalil	8	Past
Mama pila doma , nikdy sa nestalo , že by sa vrátila z kravínov a razila alkoholom .	vrátila	11	Past
“ Tak rozprávaj , “ súrila ma Blythe , keď sme nastúpili do jej džípu .	súrila	5	Past
Bez problémov našiel moje pery , akoby dôverne poznal moju tvár .	poznal	8	Past
Raisa sa , naopak , veľmi začudovala .	začudovala	6	Past
Bozkávala ma a dovolila mi , aby som ju bozkával na pery .	Bozkávala	0	Past
Mal som pocit , že za známymi črtami tváre , ktorých som sa vo sne neraz dotýkal , sa skrýva akési tajomstvo .	dotýkal	16	Past
Dobre vedel , že dal Džahijovi na opravu strechy raz toľko , ako potreboval .	potreboval	13	Past
V tejto súvislosti použila výraz „ špicľovanie “ .	použila	3	Past
Dvere sa napodiv pohli a ja som stuhol .	pohli	3	Past
Vo svojej džungli nijaké ľudské mláďa nestrpím ! “	nestrpím	6	Pres
Približovala sa k nemu zohnutá , popolavo sivá postava , ktorá pripomínala kostlivca .	Približovala	0	Past
Jeho prítomnosť vnáša do útvaru už spomenuté prvky hrdinskej epiky — mýtický boj za odstránenie chaosu sa mení na ochranu štátu a viery proti cudzím pohanom .	vnáša	2	Pres
Všetky ďalšie uhorské právne normy , ktoré reglementujú život kláštorných spoločenstiev nachádzame potom až medzi kánonmi I . ostrihomskej synody .	nachádzame	11	Pres
Len čo sa jej dotkol , myklo ňou a akoby zmeravela .	myklo	6	Past
Jedlo zásadne mení človeka po každej stránke .	mení	2	Pres
Keď som to dokončila , odľahlo mi a bola som so sebou spokojná .	odľahlo	5	Past
Miluje tlačové konferencie .	Miluje	0	Pres
Ktože by stál o takú úbožiačku , rada jej zakývam na rozlúčku .	zakývam	9	Pres
“ Keby som nevedela , že máte bezpečnostný systém , “ doberala som si Chrisa , “ preliezla by som plot a skočila dnu . “	preliezla	17	Past
“ A správaj sa slušne , srdiečko , “ zašepkala .	zašepkala	9	Past
Mediácii bráni násilný zásah zvonku — Janova prítomnosť , narúšajúca tak prvotnú rovinu mýtu .	bráni	1	Pres
“ Vieš , minulé leto som mal fantastický džob .	Vieš	1	Pres
Pokúsime sa teraz vyčleniť takéto opozície v rozoberaných úryvkoch .	Pokúsime	0	Pres
Zúril , až mu vlasy dupkom stáli .	Zúril	0	Past
Vtáky spievajú , proleti spievajú , Strana nespieva .	nespieva	7	Pres
Porozprával mu o svojom sne , v ktorom sa mal stať hrdinom , a požiadal učiteľa , nech mu pomôže .	pomôže	19	Pres
To každý človek uznáva , ale toto je príliš veľká záťaž na Mimobratislavčanov . “	uznáva	3	Pres
Keď sa o tom dozvie , usporiada slávnostný obed .	dozvie	4	Pres
Po týchto slovách zmenila tému , začala mi rozopínať nohavice .	zmenila	3	Past
Povedala mi , že užíva antikoncepčné tabletky .	užíva	4	Pres
Možnosť , že uverejním nejaký cyklus básní , som okamžite zavrhol .	uverejním	3	Pres
Vysvetlil mi , že mi musia položiť iba niekoľko otázok .	musia	5	Pres
Na manifestáciách vždy nesiem jednu časť transparentu .	nesiem	3	Pres
Náhlivo som vypol televízor a ona roztiahla pery do úsmevu .	vypol	2	Past
Abu si naradostene pošúchal ruky .	pošúchal	3	Past
Doteraz sa ešte nikto o ňu tak veľmi nebál .	nebál	8	Past
Nedýchala som , lebo skúmavo na mňa pozeral .	pozeral	7	Past
Klesol som na stoličku .	Klesol	0	Past
Hrozne mi chýbal a pocítila som priam fyzickú bolesť .	pocítila	4	Past
Postupne ju cítila čoraz silnejšie .	cítila	2	Past
Chris sa držal vľavo , šiel v pruhu , ktorý rozhodne neviedol ku knižnici .	neviedol	11	Past
Nech ich srdce stále viac a viac poznáva hodnotu tej blaženosti , ktorú nám pripravil Tvoj jednorodený Syn .	poznáva	7	Pres
Inštinktívne som zavrela oči — a vtom ma pobozkal .	zavrela	2	Past
“ Mala by si sa dať dokopy s Rickom , “ radila som jej šeptom .	radila	11	Past
Posledný szabolcsský kánon , ktorý sa venuje kláštornému životu nariaďuje opátom a mníchom , aby sa nezúčastňovali na kalendových sedeniach , ale aby prijímali oblácie ich účastníkov v kláštoroch .	nariaďuje	9	Pres
“ Ja si počkám , “ odmietla .	počkám	3	Pres
A Maja odvetila : “ Udeľuje sa milosť , končím . “	Udeľuje	5	Pres
Odtrhol som lesnú jahodu a položil ju ku kamennému prístrešku .	položil	5	Past
Ani nemukla a bez pohnutia sa dívala na spiace dieťa .	nemukla	1	Past
Nevieš napodobniť nejaké tichšie zviera ? “ spýtala sa Kala .	Nevieš	0	Pres
Heather mu niečo zašepkala do ucha .	zašepkala	3	Past
" Neviem .	Neviem	1	Pres
V rohu na sklápacom stole v pološere sa jasne lesklo sklené ťažidlo , ktoré tam kúpil na poslednej návšteve .	kúpil	15	Past
TRAVOLTA OPäŤ SPIEVA	SPIEVA	2	Pres
Vyšiel som von a chvíľu som nerozhodne postával : mám celkom odísť , alebo mám poslúchnuť chlapcovu radu a ísť do toho podniku ?	mám	9	Pres
Tak tomu hovorím názorný príklad fungovania zóny najbližšieho vývinu , o ktorej som písala minule !	hovorím	2	Pres
Z obrazovky sa ďalej valila riava vymyslenej štatistiky .	valila	4	Past
Najstaršie z nich sa objavujú v I . zákonníku sv . Ladislava .	objavujú	4	Pres
Veď sa dozviete .	dozviete	2	Pres
Napokon sa striga rozhodla , že s morskou vílou skoncuje raz a navždy .	skoncuje	9	Pres
Zlej víle pohrával na červených perách zlovestný úsmev .	pohrával	2	Past
“ Vidím , že nič neviete o našom žartíku .	Vidím	1	Pres
Chcem rozpovedať istý príbeh , a nechtiac ho zamotávam .	Chcem	0	Pres
Hľadala čosi v šatách , potom sa vrátila , usmiala sa , ľahla si a naznačila mi , aby som urobil to isté .	vrátila	7	Past
Keď sa neskôr vracali domov a pozorovali hviezdy , vystrašil ich hrozný krik .	pozorovali	6	Past
“ Ako sa voláš a kde bývaš ? “ spýtala sa toho stvoreniatka .	bývaš	6	Pres
“ Nemôžeme čakať .	Nemôžeme	1	Pres
Nechápeš , že smrť jednotlivca nie je vôbec smrť .	Nechápeš	0	Pres
Asi je choré , pomyslela si Maja .	pomyslela	4	Past
Vláda SR predloží nový zákon o rozpočtových pravidlách a pravidlách rozpočtového hospodárenia územnej samosprávy .	predloží	2	Pres
Zároveň svetská časť vládnúcej vrstvy prestáva mať záujem o monoteizmus vyjadrujúci myšlienku — jeden boh , jeden panovník .	prestáva	5	Pres
Navrhujem poradu skončiť .	Navrhujem	0	Pres
Čo spraví s dievčaťom , to rozhodne neskôr .	rozhodne	6	Pres
Boli tu velikánske depozitáre na uskladňovanie opravených dokumentov a skryté pece na ničenie pôvodných výtlačkov .	Boli	0	Past
To chlapča asi žartuje !	žartuje	3	Pres
Nezdalo sa mi , že veštia nejaké zásadné zmeny .	veštia	5	Pres
Už sa teším , to bude krása !	teším	2	Pres
“ Zastavte svet , nech sa prestane krútiť ! “ zvolal .	prestane	6	Pres
Ale ony medzitým zmizli , pohltila ich temnota .	pohltila	5	Past
Chcel som tej rieke zabrániť , aby vyrazila von , bolo to však nemožné .	vyrazila	7	Past
Zrýchlil sa mi pulz a spomenula som si na sen , v ktorom ma bozkával .	spomenula	5	Past
Chlapci sa vyšplhali z rokliny , no len čo zastali Hádesovi pri nohách , premenili sa na Bôľ a Zmätok .	zastali	9	Past
Aj tak sa vybrala pod harmanček , či náhodou pod lístkom neostala nejaká kvapôčka .	vybrala	3	Past
Letné prázdniny sa chýlili ku koncu .	chýlili	3	Past
Vláda pripraví legislatívne opatrenia , ktoré zjednodušia sankčný systém v daňovej oblasti .	zjednodušia	6	Pres
Musím vymyslieť nejakú tajnú skrýšu , kam ťa cez deň ukryjem .	ukryjem	10	Pres
Nákladné autá ešte stále prechádzali okolo a ľudia ešte stále na ne hladovo civeli .	prechádzali	4	Past
Bola tu celá reťaz zvláštnych oddelení , ktoré sa zaoberali proletárskou literatúrou , hudbou , dramatickým umením a vôbec zábavou .	zaoberali	9	Past
Dieťa rodičov Vnútornej strany sa nenarodilo do Vnútornej strany .	nenarodilo	5	Past
Vláda bude pri všetkých reformách venovať osobitnú pozornosť tomu , do akej miery navrhované zmeny prispievajú k zníženiu nezamestnanosti a finančnej náročnosti pre daňovníkov a k posilňovaniu motivácie hľadať prácu .	prispievajú	15	Pres
“ Tu býva jeden môj známy a veľmi rád prijíma návštevy . “	býva	2	Pres
Keď ho Snehulienka zje , naveky zaspí .	zje	3	Pres
Bronzová čaša , zdobená rúčkou s vtáčikom pripomína uctievanie vtákov u ugrofínskych národov — ak karelský poľovník zabil vtáka čakalo ho nešťastie .	pripomína	7	Pres
Neznámy tvor otvoril i druhé oko a ospalo žmúril na Maju .	žmúril	8	Past
Intenzívne sa pamätám na prístavbu javiska k cirkevnej sieni na evanjelickej fare .	pamätám	2	Pres
Marga sa zachvela .	zachvela	2	Past
Dohodneme sa ? “	Dohodneme	0	Pres
Smrteľne nebezpečné bolo predovšetkým to , ak niekto rozprával v spánku .	rozprával	8	Past
Začali sme na kolotočoch , kde sme vyliezli na koňa .	Začali	0	Past
Pre chlad som za stolom nikdy nezaspal .	nezaspal	6	Past
“ Dúfam , že mi nechalo aspoň zákusok . “	Dúfam	1	Pres
Aj keď vo chvíli , keď sa to stalo , ležal na chrbte , mal čudný pocit , že ho do tejto polohy niečo zrazilo .	stalo	8	Past
Neváhal a rozhádzal všetky kamene , zničil všetky znamenia .	Neváhal	0	Past
Možno moje postavy vedia hrať šach .	vedia	3	Pres
“ Ďakujem , “ povedala Makulienka , “ ibaže neviem , čo mám robiť , aby drozd vrátil Emanuelovi cylinder . “	neviem	9	Pres
“ Barbie , nevidela si Koru ? “ zakričala .	nevidela	3	Past
“ U nás budete zaručene spokojní , inak vám vrátime peniaze ! “ kričal .	vrátime	9	Pres
Každý sa napokon prizná .	prizná	3	Pres
Nemám náhodou vo vlasoch nejakú vetvičku ?	Nemám	0	Pres
Alebo si v pamäti vybavím knihu o arabskej kultúre ?	vybavím	4	Pres
Ide o state č . 2 , 17 , 20 a 28 .	Ide	0	Pres
Ďakujeme Ti za všetko dobré i ťažké , radostné i smutné , povzbudzujúce i skľučujúce , čo s Tvojou pomocou zvládli a prijali vo svojom živote .	zvládli	20	Past
Zúfalo trepal vo vzduchu nôžkami .	trepal	1	Past
“ To všetko je Ferdova vina , “ prehlásila .	prehlásila	8	Past
Myslím , že o sebe urobili veľmi pekný obraz , že aj Rómovia a deti z detského domova sa vedia správať na úrovni .	Myslím	0	Pres
Tentoraz sa ma nepýtala , či som v poriadku .	nepýtala	3	Past
Pochybovačne zdvihla obočie , pozrela na mňa a ďalej vykladala nákup .	vykladala	9	Past
“ Obávam sa , že ten chlapec sa nikdy neožení .	neožení	9	Pres
Winston zdvihol hlavu a počúval .	zdvihol	1	Past
“ Niet za čo , to je predsa samozrejmé , “ skromne odvetil Chrabroš .	Niet	1	Pres
Mauglí sa však stále tvrdohlavo držal stromčeka .	držal	5	Past
Ako vyzerajú ?	vyzerajú	1	Pres
Práve skončilo predstavenie jej prvej významnej práce .	skončilo	1	Past
Mama zjedla otravu na myši .	zjedla	1	Past
“ Tieto zbrane ti pomôžu zvíťaziť nad zlom , “ povedali mu .	pomôžu	4	Pres
Až potom zašiel mesiac za mraky .	zašiel	2	Past
Položila telefón .	Položila	0	Past
Abu položil na zem pred mladého muža vankúš .	položil	1	Past
Zároveň však Cluny urobilo veľký krok na ceste k libertas , lebo vytvorilo spoločenstvo ( zväčša ) úplne slobodných kláštorov , ktoré nepodliehali laikom .	nepodliehali	22	Past
Odvliekla princa na svoj zámok a uvrhla ho do temnice .	Odvliekla	0	Past
“ Mala som pocit , že sa vznášam ! “ vravela som mame , keď za mnou pribehla a objala ma .	vravela	10	Past
Sčista - jasna sa mu videlo celkom možné , že sa hlúpo mýlil .	mýlil	12	Past
Realita života na vidieku zatláča náboženské rozdiely do úzadia .	zatláča	4	Pres
Tarzana to povzbudilo a prisahal : “ Budem najlepšia opica , aká kedy prišla na svet ! “	prisahal	4	Past
Unášajú ma preč ! “	Unášajú	0	Pres
Miznú tak i zvyšky existencie predkresťanskej náhrady za škodu , nahradzujúce prechodne krvnú pomstu .	Miznú	0	Pres
“ Máte pridobré srdce , “ poznamenala Kráska .	Máte	1	Pres
Tyranizuje nás ťaživou krásou obrazov .	Tyranizuje	0	Pres
Zasiahnutý netvor sa zmietal od bolesti a zletel zo skaly .	zletel	7	Past
Oznamuje východ slnka a prebúdza zo spánku . .	Oznamuje	0	Pres
Brat kantor pre vážne osobné dôvody nemohol prísť , preto brat farár sprevádzal nábožný spev na gitare spolu s mládežníkmi , ktorí poslúžili programom a vystúpili aj s osobným vyznaním .	nemohol	6	Past
Vždy som mával zvláštny pocit , že ten človek ma neznáša .	neznáša	10	Pres
Nazvem ju Delina , podľa mena hrdinky .	Nazvem	0	Pres
“ Neviem , “ vraví myška , “ ale možno ti poradia tamtie modré kvietky . “	Neviem	1	Pres
“ Nádherne ti pristane k vlasom , “ dodala Blythe .	dodala	8	Past
Ako celý systém funguje ?	funguje	3	Pres
Prijme systém finančnej podpory preventívnych projektov .	Prijme	0	Pres
Myslím však , že vysoká škola má dve významné úlohy , ktoré so spomínanou rovnicou priamo nesúvisia .	Myslím	0	Pres
Ilúzia takejto taktiky netrvala dlho .	netrvala	3	Past
Bála som sa to povedať mame , ktorá prišla na polhodinu domov , aby sa prezliekla , kým pôjde do ďalšej práce .	pôjde	18	Pres
Dôverujem tomu zasľúbeniu , ktoré som prijala vierou .	Dôverujem	0	Pres
Tentoraz to prišlo skôr . "	prišlo	2	Past
Odvetil stroho :	Odvetil	0	Past
Tuším ju vskutku podozrieva .	podozrieva	3	Pres
Vlievali mi do duše chrabrosť .	Vlievali	0	Past
Keď dohovoril , usmial sa svojím záhadným úsmevom a ustúpil nabok , aby uvoľnil cestu Lori .	ustúpil	9	Past
“ Tú šóru v žiadnom prípade nezvládneme , “ povedal Rýchlik a začal cúvať .	začal	12	Past
Otvorila oči a pred sebou uvidela svätojánsku mušku Svetlanku .	Otvorila	0	Past
Išli sme až k nášmu vchodu na zadnej strane domu a celou cestou sme mlčali .	mlčali	14	Past
Prijal to .	Prijal	0	Past
V tom sne najsilnejší bol pocit sebaklamu , lebo v skutočnosti vedel , čo je za tým temným múrom .	vedel	11	Past
“ Počkám ťa ! “ zvolal Chris , bežiac pri mne .	zvolal	5	Past
Obávam sa , že ocko nedovolí , aby sa mu po paláci potuloval tiger .	nedovolí	5	Pres
Pozostáva z krátkych pasáží o jednotlivých mníchoch , v ktorých sa neopakovateľným spôsobom preplieta fantastika s reálnym videním sveta .	Pozostáva	0	Pres
Netrvalo dlho a opäť sa ozvalo zvonenie .	Netrvalo	0	Past
Chris sa zasmial a pomrvil sa na tvrdých hranatých škridlách .	zasmial	2	Past
Volala sa Znepokojenia .	Volala	0	Past
V prvých troch kapitolách sa teda pokúsime o prieskum problematiky v celoruskom rámci , odhliadnuc od jemnejších miestnych odlišností .	pokúsime	6	Pres
Vyslovím sa presnejšie .	Vyslovím	0	Pres
Uznal som za vhodné požiadať ich , aby ma zobudili o pol piatej .	Uznal	0	Past
Tichšie , lebo zobudíš môjho chlapčeka .	zobudíš	3	Pres
Rád by vedel , či dostali pána Charringtona .	vedel	2	Past
Akýsi neomylný inštinkt mi signalizoval , že aj ona myslí na mňa .	myslí	9	Pres
Vláda prijme opatrenia , ktoré zabránia možnosti subjektívneho rozhodovania štátneho zamestnanca vo všetkých oblastiach podnikania .	zabránia	5	Pres
Ochráni Jazmínu , nech by jej hrozilo čokoľvek .	hrozilo	6	Past
Hrá Muzička .	Hrá	0	Pres
“ Tu strávime noc .	strávime	2	Pres
Sľúbil by som jej i modré z neba , keby ho chcela .	chcela	11	Past
Vypáči z pamäte pána Charringtona zvyšok tej riekanky .	Vypáči	0	Pres
Kráčal som za ním po tichej chodbe nemocničného pavilónu a ani som si nevšimol , že Irma nie je s nami .	Kráčal	0	Past
Uvažovala som , akú časť pretekov teraz v duchu pláva .	pláva	9	Pres
Vzápätí pribehli mandelinčatá s boľavými bruchami , takže musela ošetriť aj ich .	musela	8	Past
„ Viera môže dávať človeku životnú istotu “ , mieni profesor Ďurovič .	mieni	9	Pres
“ Dostaneš možnosť , “ ubezpečoval ho Fil .	ubezpečoval	5	Past
Tu dnu , to vedel inštinktívne , sa svetlá nikdy nevypínajú .	vedel	4	Past
“ Rozlúč sa so svojím milým , “ posmievala sa Ariele .	posmievala	8	Past
Pelikánia slečna Polly má veľký zobák a veľmi sa jej nepáči .	nepáči	10	Pres
Vtáky spievajú , proleti spievajú , Strana nespieva .	spievajú	4	Pres
Ponáhľala som sa , lebo ak pozrú z okna , uvidia , ako sedíme na múre .	sedíme	13	Pres
Keď chcel , úplne vypol a okolie preňho neexistovalo .	neexistovalo	8	Past
Keď sa Šer Chán obzrel za seba , od strachu zareval .	obzrel	4	Past
Krtko prečesával ľan až z neho vyčesal jemné vlákna .	prečesával	1	Past
Napriek tomu ma niečo začalo znepokojovať .	začalo	4	Past
Prednosta podzemnej dráhy náhodou našiel starú čižmu , ktorá sa na tento účel výborne hodila .	hodila	14	Past
Výsledkom bude , že v nijakej oblasti sa nespotrebuje viac zdrojov , ako na ňu bude vyčlenených v rozpočtoch , ktoré schváli NR SR , resp . jednotlivé samosprávne orgány .	nespotrebuje	8	Pres
Za jasotu spoluobčanov prevzali cenu a Dr . Slimák slzil od dojatia , pretože v tejto súťaži doteraz nijaký slimák nevyhral .	slzil	9	Past
Potom sa pohodlne oprel a napil sa z fľaše .	napil	5	Past
Neobjal ma , nepriblížil sa ku mne , ani nezavrel oči .	nepriblížil	3	Past
“ Stále by ti hovorili , kam máš ísť a čo si máš obliecť . “	máš	7	Pres
Rozoberané nepokoje sa odohrávajú v Beloozere , Novgorode , Suzdali , roku 1091 sa objavuje volchv i v Rostove .	objavuje	14	Pres
Vláda prijme opatrenia , ktoré zabránia možnosti subjektívneho rozhodovania štátneho zamestnanca vo všetkých oblastiach podnikania .	prijme	1	Pres
Ale ja som Marge nič nepovedal ani v to ráno , ani neskôr .	nepovedal	5	Past
Chcela som sa spýtať , kde tie chrústy našiel .	Chcela	0	Past
Ja sa na Vianoce teším .	teším	4	Pres
Balú sa naňho usmial .	usmial	3	Past
“ Chcete povedať , že som herec ? “ pýtal sa Pinocchio .	Chcete	1	Pres
A opäť som zamieril kameru na Lorinu tvár .	zamieril	3	Past
Chris roztrhol jedno balenie , ale veľmi sa s ním nemaznal .	roztrhol	1	Past
A predovšetkým , nedovoľujeme mŕtvym , aby povstali proti nám .	nedovoľujeme	3	Pres
Tá správa bola jasná : jej telo túži po mojom tele .	túži	7	Pres
Do minúty zhorí na popol .	zhorí	2	Pres
Na príjazdovej ceste pred Taco Villa stál dlhočizný rad áut , v ktorých sedeli decká z našej školy .	sedeli	13	Past
“ Veď Rahim povedal , že spolu urobíme obchod .	povedal	3	Past
V Petrohrade som prvýkrát , nemám tu nijaké kontakty .	nemám	5	Pres
Odporná extáza strachu a pomstychtivosti , túžba zabíjať , mučiť , drúzgať tváre kováčskym mlátom akoby preskočila sťa elektrický prúd na všetkých a premenila každého aj proti jeho vôli na vrieskajúceho pomätenca s pokrivenou tvárou .	preskočila	16	Past
Napriek tomu to však neplatilo bezvýhradne .	neplatilo	4	Past
Sitek považuje za partnera KDH	považuje	1	Pres
Neskôrnateli vnútorne .	Neskôrnateli	0	Past
Chan si zahrá Číňana , ktorý pricestuje na Divoký západ , aby zachránil unesenú dcéru čínskeho konzula .	zahrá	2	Pres
" Mal som inú predstavu .	Mal	1	Past
“ Ostane so mnou celú noc , aby som sa nebála tmy . “	Ostane	1	Pres
“ Nemôžem , “ čo znamenalo , že ho nemôžem pozvať dnu , a nie bozkávať sa .	nemôžem	9	Pres
So záľubou som ho sledovala .	sledovala	4	Past
Mám osem nôh , osem očí a sedem chutí .	Mám	0	Pres
Záujemcov o šport poteší futbalový turnaj pre dospelých a jazda na koni pre deti .	poteší	3	Pres
Muži zo sprievodu to jednohlasne odobrili .	odobrili	5	Past
Polovicu zo všetkého , čo vo mne je , mám z domu , z toho , čo sa doma povedalo , napríklad pri stole .	mám	9	Pres
Tá žena mi položila ruku na hlavu a rozstrapatila mi vlasy .	položila	3	Past
Svedčilo o tom správanie mojich rodičov .	Svedčilo	0	Past
Sama sa predsa rozhodla , že opustí družky .	opustí	6	Pres
Tieto úvahy ma uvrhli do krízy , počas ktorej som si uvedomoval svoju vinu .	uvrhli	3	Past
Lori to trvalo dlho , ale neplakala .	neplakala	6	Past
Opice , čo držali Mauglího , sa zaškerili a pustili ho .	pustili	9	Past
Niečo v jej posunku mu naznačilo , že sestrička umiera .	umiera	9	Pres
Zákon prispeje k stabilizácii príjmov územnej samosprávy .	prispeje	1	Pres
Vláda prijme opatrenia na minimalizáciu možnosti vzniku korupcie a dopracuje systém kontroly zameraný na kontrolu použitia verejných prostriedkov , vrátane prostriedkov plynúcich z EÚ .	dopracuje	9	Pres
“ Ak ti na mne naozaj záleží , tak mi nerob zle !	záleží	6	Pres
Ja sa oňho postarám . “	postarám	3	Pres
Netrvalo dlho a nad jaskynkou sa zachvel list , spod ktorého vyliezol prečudesný chrobák .	Netrvalo	0	Past
Keď pozrela pod seba , zistila , že uviazla v pavúčej sieti .	zistila	5	Past
“ Musíte tam vletieť , “ radila Petronila s plnými ústami .	Musíte	1	Pres
Hook sa napokon obrátil k Wendy , zľahka sa dotkol klobúka a vystrúhal poklonu .	dotkol	9	Past
Trápilo ma niečo iné : musím zvíťaziť nad zvieraťom , ktoré sa vo mne prebudilo .	musím	5	Pres
Potom otočil ktorýmsi vypínačom a hlasy zmĺkli .	otočil	1	Past
Prišiel na to niekto iný : Zelené oči .	Prišiel	0	Past
Nemôžeme sa skrývať za masu ani za tradíciu cirkvi , keď nás Kristus oslovuje na ceste nášho života .	Nemôžeme	0	Pres
Celý svet vyvalí oči , keď Belu a Gastona zbadá taký pár málokde zočí , krásavci jedna balada .	zbadá	9	Pres
Dievča sa pozviechalo na kolená .	pozviechalo	2	Past
Ja to viem , prehovoril som po dlhom váhaní .	viem	2	Pres
Zem sa ustavične triasla a kopček z hliny rástol a rástol .	rástol	8	Past
Dieťa prikývlo , akoby mu rozumelo .	prikývlo	1	Past
To , čo videl , ho rozzúrilo .	rozzúrilo	6	Past
Bol som v jeho pracovni , mal som v sebe nerozumnú dávku alkoholu a čakal som , že všetko sa definitívne vyjasní a ja odídem .	vyjasní	21	Pres
“ Dokázal som to ! “ zvolal .	zvolal	6	Past
Vláda pripraví a realizuje systém ochrany slovenského spotrebiteľa a prostredníctvom legislatívy ho prispôsobí stavu , ktorý bude zodpovedať legislatíve EÚ .	realizuje	3	Pres
Deti boli v kostole veľmi tichučko a správali sa vzorne .	správali	7	Past
Napokon vstal , tackavo a hojdavo prešiel celou , hlboko ponoril ruku do vrecka na kombinéze a s rozpačitým výrazom podal mužovi s umrlčou tvárou ufúľaný kúsok chleba .	podal	20	Past
Pripomínal jej trochu Teklu a chcela rýchlo odletieť .	Pripomínal	0	Past
Pred okienkom do pivnice ležal lesklý tvor s červenými očami a nahlas funel .	ležal	4	Past
Vláda prehodnotí systém výkonu správy súdov , ktorý príliš zaťažuje sudcov administratívnymi činnosťami , osobitne pri štátnej správe jednotlivých súdov .	prehodnotí	1	Pres
“ Nie , “ odvetila som .	odvetila	4	Past
Zviera , čo obýva zámok , ja naskutku skolím .	obýva	3	Pres
Ponúka nám niečo , čo nepotrebujeme .	Ponúka	0	Pres
Neotvoril oči ihneď .	Neotvoril	0	Past
Teraz musím publikovať .	musím	1	Pres
V posledných mesiacoch žiletky patrili medzi nedostatkový tovar .	patrili	4	Past
Chýba jej predovšetkým jasnosť .	Chýba	0	Pres
Pomyslel som si , že sa mi to len zdá .	zdá	9	Pres
Faikiným rukojemníkom som zostal až do chvíle , keď sa rozhodla , že odíde , a vydala sa .	rozhodla	10	Past
Deti sa veľmi tešili , keď Lulu kŕmila mláďatká .	tešili	3	Past
Páčim sa Chrisovi !	Páčim	0	Pres
“ Nemôžem mať samé jednotky !	Nemôžem	1	Pres
Musí osloviť Amplefortha aj za cenu okríknutia z televíznej obrazovky .	Musí	0	Pres
Môže ísť o toporčeky s predĺženým poriskom , ktoré boli v Škandinávií predmetom symbolizujúcim hromy vrhajúceho Thora .	Môže	0	Pres
Spočiatku som svoje utrpenie dusila v sebe .	dusila	4	Past
Lavdim Lavdoshaj sa konečne rozhodol , že mi uverejní jednu poviedku v poslednom septembrovom čísle .	uverejní	8	Pres
“ Tak dobre , “ vraví .	vraví	5	Pres
Ďalší predavač ho zasa zbil vreckom šošovice .	zbil	4	Past
Pomôžu vám vyniesť nahor veci , povedal Cerberus a podal ten kľúč mame .	Pomôžu	0	Pres
Obrátila som sa a zbadala som to prekrásne staré autíčko .	zbadala	4	Past
Vo Winstonovi zápasili zvláštne pocity .	zápasili	2	Past
Na svoj husľový koncert pozvala celé okolie .	pozvala	4	Past
Pristane vám to .	Pristane	0	Pres
Takto sa volala Gorbačovova manželka .	volala	2	Past
Podporíme intenzívnu ekonomickú poľnohospodársku výrobu .	Podporíme	0	Pres
Zakrátko nevidela na cestu .	nevidela	1	Past
Šer Chán prikývol .	prikývol	2	Past
Neotáľa a vylezie na strom .	Neotáľa	0	Pres
“ Naozaj sľubujem . “	sľubujem	2	Pres
O chvíľu zaspalo .	zaspalo	2	Pres
Normálne som sa vykašlala na fyziku .	vykašlala	3	Past
Čo si teraz počne ?	počne	3	Pres
Otvoril som kufor .	Otvoril	0	Past
Vláda bude využívať štátne záruky iba v nevyhnutných prípadoch na prefinancovanie splatných úverov so štátnymi zárukami , ak to umožní zákon o štátnej pomoci a ak hrozí realizácia záruk z prostriedkov verejných financií .	umožní	19	Pres
Pred bránou Maju oslepilo žiarivé svetlo , až privrela oči .	oslepilo	3	Past
V tejto časti práce podávam prehľad zmienok o prvkoch pohanstva v skúmanej oblasti .	podávam	4	Pres
Dieťa vie čítať až vtedy , keď text pochopí .	pochopí	8	Pres
Iba pred piatimi dňami sa pohrával myšlienkou , že jej rozbije hlavu dlažobným kameňom , lenže čo tam teraz po tom ?	rozbije	10	Pres
Chcem vedieť , či niekedy nájdem pravú lásku . “	nájdem	5	Pres
" Nenávidím mravnú čistotu , nenávidím dobrotu !	nenávidím	5	Pres
Chcem vedieť , či niekedy nájdem pravú lásku . “	Chcem	0	Pres
Uveličene sa obzerala okolo seba .	obzerala	2	Past
“ Nech ti nelepí , vyhnem sa ti , ak sa vyhneš ty mne !	nelepí	3	Pres
Rovnako prekvapujúco dobre vedela rozprávať bez pohybovania perami .	vedela	3	Past
Finančne podporí rozvoj ľudských zdrojov a inštitucionálnej infraštruktúry regiónov , slúžiacej na realizáciu komplexnej regionálnej politiky .	podporí	1	Pres
Pri stanovení termínu veľkého pôstu siahli uhorskí zákonodarcovia k jeho starej východnej podobe ešte spred 7 . storočia , ktorá sa v 11 . storočí nepoužívala už ani na kresťanskom východe ani na západe .	nepoužívala	25	Past
Chcem jej uniknúť , zväzuje mi nohy .	Chcem	0	Pres
Neničíme kacíra preto , že nám odporuje ; pokým nám odporuje , neničíme ho .	neničíme	12	Pres
U nás jeme to , čo sa objedná cez donášku alebo mrazené jedlá , “ povedal Chris .	povedal	15	Past
A , prosím ťa , nalej mi ešte raz do tohto pohára !	prosím	2	Pres
Keď som vychádzal z izby , že za ním zájdem a poprosím ho o nejakú radu , opäť som pocítil svrbenie .	zájdem	9	Pres
Keď Herkules počul tie slová , vrátila sa mu odvaha .	počul	2	Past
Hrabala som sa vo vaku a hľadala som bundu .	Hrabala	0	Past
Aj bez ďalšieho vysvetľovania O ' Brien vedel , ako to myslí .	vedel	7	Past
Vzápätí sa zjavila svetlovlasá hlávka a nakoniec sa z kvetu vynorilo drobučké stvorenie .	vynorilo	10	Past
Chcela som , aby bral život trocha vážnejšie .	bral	4	Past
Prichádzali a záhadne odchádzali ďalší väzni .	Prichádzali	0	Past
Keď som jej zapaľoval cigaretu , prebehla mnou vlna zlosti .	zapaľoval	3	Past
A zdvihol sa .	zdvihol	1	Past
Som na teba pyšná , “ zvolala .	zvolala	6	Past
Maja sa rozhodla , že zaletí do chladného lesa , kde je ticho a tieň , aby mohla pokojne popremýšľať o všetkom , čo v noci zažila .	zažila	26	Past
“ Vieš , musím chvíľu popremýšľať , “ povedal Káa .	Vieš	1	Pres
Podráždene meditoval o materiálnych stránkach života .	meditoval	1	Past
“ O siedmej prídem po teba . “	prídem	3	Pres
Neničíme kacíra preto , že nám odporuje ; pokým nám odporuje , neničíme ho .	Neničíme	0	Pres
A teraz ti poviem niečo , čo ti vyrazí dych , “ začal Chris .	vyrazí	8	Pres
Bosorka sa nad ňou víťazne skláňala a zaškriekala .	zaškriekala	7	Past
Však vieš , že sa tá zbierka robí od domu k domu .	robí	7	Pres
Oznámila mi , že ma pozýva .	pozýva	5	Pres
Ja som uložil mladým batožinu do taxíka a nasadol som doň .	uložil	2	Past
Keď však Maja s Fridolínom krepčili v divom tanci , stala sa ďalšia katastrofa .	krepčili	5	Past
" Neviem -- mne už je to fuk .	Neviem	1	Pres
Maja sa od rozčúlenia celá triasla .	triasla	5	Past
Mama zdvihla oči od novín a usmiala sa .	usmiala	6	Past
Viete , koľko tu stojí 1 - izbový byt ?	Viete	0	Pres
Podporením priestupnosti školského systému v oblasti prechodu žiakov na vyšší stupeň školy bez prijímacích skúšok , vláda minimalizuje podmienky na korupciu v školstve .	minimalizuje	17	Pres
Pokrútila som hlavou .	Pokrútila	0	Past
Vidím dobre ? “ vyľakal sa Ferdo .	vyľakal	4	Past
Vo svojom blaženom sne Winston nevenoval nijakú pozornosť tomu , že mu nalieva pohár .	nalieva	12	Pres
Bála som sa , že keby som naznačila , po čom túžim , mama by si našla aj tretie zamestnanie .	túžim	11	Pres
" Záleží mu iba na sebe , " opakoval po nej .	opakoval	8	Past
Aziza sa zamračila .	zamračila	2	Past
Nebolo tajomstvom , že odoslané listy sa bežne otvárajú .	otvárajú	8	Pres
Ale to vedia všetci .	vedia	2	Pres
“ Zmizol , “ podotkla komárica , čo bežala okolo .	bežala	8	Past
“ Vidíš tú maličkú žltú hviezdu ?	Vidíš	1	Pres
Do roku 2006 vláda dokončí plnú profesionalizáciu Ozbrojených síl SR .	dokončí	4	Pres
Vedela som , že obaja túžime , aby táto čarovná noc trvala večne .	túžime	5	Pres
Počul som , že noviny platia dobre , keď chcú .	chcú	9	Pres
Nečakal som , že ju moje slová až tak rozosmejú .	rozosmejú	9	Pres
UMA A ETHAN ČAKAJÚ	ČAKAJÚ	3	Pres
Navyše , koniec 9 . a veľká časť 10 . storočia predstavujú aj vrchol úpadku stredovekého pápežstva .	predstavujú	11	Pres
Irma nevedela , že Marga leží v nemocnici .	leží	5	Pres
Iste chápete , že najprv vám musím položiť zopár otázok .	musím	6	Pres
Prikázal , aby obe uvrhli do väzenia .	uvrhli	4	Past
Pokrčila plecami a usmiala sa .	Pokrčila	0	Past
Unaveným krokom som vyšiel po schodoch nášho domu .	vyšiel	3	Past
Napokon mu prezradila aj svoje najväčšie želanie .	prezradila	2	Past
Flip zívol .	zívol	1	Past
Alfonz prijal s úľavou od kamarátov ponuku , že mu pomôžu pripraviť oslavu .	pomôžu	10	Pres
“ Ja snívam o tebe , a ty o vysokej .	snívam	2	Pres
My takéto chyby nerobíme .	nerobíme	3	Pres
Zákon sprehľadní pravidlá pre plnenie úloh prenesených zo štátnej správy na územnú samosprávu a doplní sústavu zákonov týkajúcich sa územnej samosprávy .	sprehľadní	1	Pres
Na schodišti som mal opäť zvláštny pocit , že ma niekto sleduje , a znova som rýchlym pohybom otočil hlavu , akoby som ho chcel nečakane prekvapiť .	sleduje	11	Pres
Marketing je súborom disciplín , ktoré sa zaoberajú trhom a v trhovej ekonomike človek má cenu , ktorá sa vyjadruje len peniazmi .	vyjadruje	19	Pres
Sú tu správy !	Sú	0	Pres
Rýchlo vyčarila drevený kolovrátok so zradným zeleným vretenom .	vyčarila	1	Past
Naším zámerom je odstrániť najmä deformácie , ktoré zakladajú neopodstatnené nerovnosti medzi občanmi alebo zavádzajú do sociálneho systému cudzorodé prvky , akým je napríklad nesystémové včlenenie kúpeľnej starostlivosti do sociálneho poistenia .	zavádzajú	14	Pres
Raz Makulienka vraví : “ Niečo by som chcela . “	vraví	2	Pres
Nad ňou sa vznášal cudzí motýľ .	vznášal	3	Past
Povedala mi , že sa milujeme naposledy .	milujeme	5	Pres
“ Ako si sa včera dostala domov ?	dostala	5	Past
Nezáleží na tom , čo povieš či urobíš ; záleží jedine na tom , čo cítiš .	záleží	9	Pres
Schytilo dievčinku labkami a vraví : “ Ty moja krásna dievčinka , odnesiem si ťa do hniezda ! “	vraví	4	Pres
Sprístupnením informácií o poskytnutých dotáciách výrazne obmedzí priestor pre korupciu a klientelizmus v podpornej politike štátu .	obmedzí	6	Pres
“ Výborný nápad , “ súhlasila som .	súhlasila	5	Past
Odborná porota vyberie najlepší film z kategórie režisérskych debutov a v tejto kategórii svojho favorita vyberie aj publikum .	vyberie	2	Pres
Keď to rozprával Maji , spozornela .	spozornela	5	Past
Dochádza k revitalizácií pohanstva v bojarských kruhoch .	Dochádza	0	Pres
“ Myslím to vážne , “ povedal a začervenal sa .	Myslím	1	Pres
Wilsher , blondiak s nasprostastým výrazom na tvári , ktorého takmer nepoznal , ho s úsmevom pozýval na voľné miesto pri svojom stole .	nepoznal	11	Past
Opice , čo držali Mauglího , sa zaškerili a pustili ho .	držali	3	Past
Zostávali mi teda poviedky .	Zostávali	0	Past
Verím ti .	Verím	0	Pres
Ľúbim ťa .	Ľúbim	0	Pres
Keď sme dojedli a mama upratala stôl , rodičia hrávali karty .	hrávali	9	Past
Keď konečne zaspala , bola tma .	zaspala	2	Past
Ale aj hlupáci a blbci vedia na seba vziať rôznu podobu .	vedia	5	Pres
Z tohto hľadiska meriam obdobie svojho pobytu v Čarodejníckej vile podľa intervalov , v akých otec odpovedal na mamine listy .	meriam	3	Pres
“ Hovoríte peniaze ? “	Hovoríte	1	Pres
Nechcem nič konkrétne .	Nechcem	0	Pres
Ak má môj rod zomrieť , tak chcem zomrieť i ja , pomyslela si .	pomyslela	12	Past
Nato ma pobozkal .	pobozkal	2	Past
Keď sme prišli domov , povedal som im , aby išli do izby .	povedal	5	Past
Odvtedy kríva .	kríva	1	Pres
Túto hru prerušil Tom .	prerušil	2	Past
Spolu sme sa potichučky vyšplhali na studenú strechu , a ako dvaja námesačníci sme vyliezli až hore .	vyšplhali	4	Past
Vláda zjednotí sadzby DPH pred vstupom do EÚ .	zjednotí	1	Pres
Musí ma dostať z mŕtvolného stavu .	Musí	0	Pres
V izbe podo mnou spával Profesor , oddeľovala nás iba tenká dosková podlaha .	oddeľovala	7	Past
Má pokojný , rozvážny hlas , dbá na každé slovo a tvári sa vážne .	tvári	11	Pres
“ Kráľ Louis , tak sa volám , to môže zariadiť .	volám	6	Pres
Dôležitejším znakom oboch kategórií šamanov je , že úspech ich činov nezávisí od toho , akú obetu bohu prinesú , ale od toho v akom vzťahu sú oni sami s bohmi — tj . od ich schopností .	nezávisí	11	Pres
Volám sa Kalif . “	Volám	0	Pres
Chcem spresniť , že v mojich očiach bol Profesor už takmer starec .	Chcem	0	Pres
Politicky sa Rus rozdrobuje , cirkev , naďalej sa upevňujúca , slúži ako kladný protipól úpadku .	slúži	11	Pres
Vždy som naznačil strelu a obe lopty som poslal do jeho protipohybu . "	naznačil	2	Past
Nevinne som prikývla .	prikývla	2	Past
Netešíš sa , že žiješ ?	Netešíš	0	Pres
Otrasený , ale zdravý sa z nej vymotal .	vymotal	7	Past
Mamina silueta stála vo dverách a obaja sme vycítili , že sa hnevá .	vycítili	8	Past
Bol vo väzení a do väzenia zatvárajú zlých ľudí , ale otec nebol zlý človek .	zatvárajú	6	Pres
Musíš ma pustiť !	Musíš	0	Pres
Teraz ťa pozývam ja , povedal som , ale Lori odvetila , že nič nechce .	pozývam	2	Pres
Odišla som preč .	Odišla	0	Past
Rudko im vysvetlil pravidlá a odpískal začiatok zápasu .	vysvetlil	2	Past
Dievčina sa usadila .	usadila	2	Past
Síce sme nevyhrali , ale verím , že aj to príde .	nevyhrali	2	Past
“ Ďakujem , “ povedala som ostýchavo .	Ďakujem	1	Pres
Obsah tvorili nevyberané útoky na maďarskú menšinu žijúcu na Slovensku .	tvorili	1	Past
Objal som ju .	Objal	0	Past
Potom sa predstavila .	predstavila	2	Past
Zaspíš , kým sa dopečie , “ vyhlásila som neisto .	dopečie	4	Pres
“ Letím náhodou okolo , “ zašveholila , “ a takmer som o vás zakopla . “	Letím	1	Pres
V období vzniku uhorskej cirkevnej organizácie problém , či si uhorský kráľ uzurpoval práva prináležiace Apoštolskému stolcu , ešte nehral rozhodujúcu úlohu .	nehral	19	Past
Čas uteká !	uteká	1	Pres
Chytil Balúovi hlavu a nežne ju hladkal .	Chytil	0	Past
Jasne som chápal len absurdnosť situácie , v akej som sa ocitol .	chápal	2	Past
Trávniky sa premenia na oceány bahna a autá uviaznu pred domami .	uviaznu	8	Pres
Potkany by ho určite napadli a zakrátko by ho obžrali na kosť .	obžrali	9	Past
“ Nedopustíme predsa , aby utiekli a varovali netvora , “ povedal ľuďom .	utiekli	5	Past
Prekvapená videla , ako zvonka preniká do spálne jemné modravé svetlo .	videla	1	Past
Rodičom sa však taký vývoj udalostí nepáčil a zišli sa na porade .	zišli	8	Past
Za jeho stiahnutými mihalnicami sa pohyboval celý les prstov v akomsi tanci , vykrúcal sa a skrúcal , strácal sa jeden za druhým a znova sa objavoval .	skrúcal	16	Past
V prípade , že z manželstva nevzišli deti , Strana nepovoľovala rozvod , zato podporovala odlúčenie .	nepovoľovala	10	Past
Len čo vošiel dnu , čakali ho tam Kráľovná zla a jej sluhovia .	vošiel	2	Past
Na hlase som jej poznala , že ju to zaskočilo .	zaskočilo	9	Past
“ Ako sa voláš ? “	voláš	3	Pres
Dnes tu však mali návštevu , sedeli na terase a jedli lahodne rozvoniavajúci ovocný koláč .	sedeli	6	Past
Odmietla , povedala , že nepije alkohol .	nepije	5	Pres
Musím niečo urobiť , inak hrozí , že sa nezúčastním na Lorinom svadobnom obrade .	Musím	0	Pres
Winston ho jemne uchopil za ruku .	uchopil	3	Past
Prešlo niekoľko dní a princezná ani len nepomyslela na návrat domov .	nepomyslela	7	Past
“ Zdá sa , že sa vracia váš priateľ .	vracia	6	Pres
Urobíme nejaké rozbory , určíme liečbu . . .	určíme	4	Pres
Zodvihol pohár a opäť vystrel ramená .	vystrel	4	Past
Začala som výčitkami , ale teraz pokračujem radami do nového roku .	pokračujem	6	Pres
“ Môžem si to ešte rozmyslieť ? “ spýtala sa .	Môžem	1	Pres
Ale ja som nepoznal šéfa televízie Sírius .	nepoznal	3	Past
Keď po prižmúrení vytlačil z očí slzy , náhle pocítil hlad .	vytlačil	3	Past
Kým som tam osamote sedel , začul som na chodbe kroky a hlasy .	začul	6	Past
Blythe plesla rukou po sedadle a otočila sa ku mne .	otočila	6	Past
Podporíme urýchlenie legislatívneho , inštitucionálneho a administratívneho dobudovania štruktúr potrebných na výkon Spoločnej poľnohospodárskej politiky .	Podporíme	0	Pres
Dieťa vie čítať až vtedy , keď text pochopí .	vie	1	Pres
“ Kto to tu plače ? “ spýtala sa tá krehká drobučká bytosť a zvedavo sa poobzerala okolo seba .	plače	4	Pres
Cirkevný trest spočíva v pokání .	spočíva	2	Pres
Boli ako zmyslov zbavené .	Boli	0	Past
Pavla výborne kryje Muf .	kryje	2	Pres
Vtom sa pred ním otvorila zem a vyliezla z nej tenká červenohnedá dážďovka .	otvorila	4	Past
Vezmeš si tie Finneganky ? “	Vezmeš	0	Pres
Neraz som videla , ako sa máča ľan .	máča	6	Pres
Ani jeden návrh ma nechytil za srdce .	nechytil	4	Past
Omar prikývol a usmial sa .	prikývol	1	Past
Koľkokrát Aladin počul , ako po nich pokrikujú tie isté slová !	počul	2	Past
Nebolo tajomstvom , že odoslané listy sa bežne otvárajú .	otvárajú	8	Pres
Tá myšlienka mu v skutočnosti v mysli skrsla v podobe vidiny , skleného ťažidla , ktoré sa zrkadlilo na povrchu sklápacieho stola .	zrkadlilo	17	Past
Ale ja som bol zmätený a nedokázal som reagovať .	nedokázal	6	Past
“ Myslela som , že robíš v El Rancho , “ vyhŕkla som bez rozmyslu .	robíš	5	Pres
Tekla sa tomu potešila a bola nadmieru spokojná .	potešila	3	Past
Z kúpeľne som vyšiel o pol hodiny .	vyšiel	3	Past
Každý jeden šedý Reebok vás presvedčí , že tak skoro sa nič nezmení .	nezmení	12	Pres
Známe uskromňovacie heslo " Jeme preto , aby sme žili . " nie je pravdivé .	Jeme	4	Pres
Takto nevyzerá ani autorka článku , ani kamarátova babka .	nevyzerá	1	Pres
Lori bola vedľa mňa , aby mi potvrdila , že Irma , ktorú pohltilo nebo , teraz letí do iného sveta .	pohltilo	13	Past
Na mieste , kde sedelo , ostala vlhká , tmavá škvrna .	sedelo	4	Past
Na bielizníku mi nechala odkaz : “ Dúfam , že si sa dobre bavila , srdiečko . “	Dúfam	7	Pres
Niekto mu podhodil falošnú mincu !	podhodil	2	Past
“ To my poznáme , “ povedal Flaps .	poznáme	3	Pres
Napokon usúdil , že najbezpečnejším miestom je kantína .	usúdil	1	Past
V tú nedeľu básne vyšli .	vyšli	4	Past
“ Z nás sa nikdy nestanú piráti , “ hrdo vyhlásila Wendy .	vyhlásila	10	Past
Vážne prikývol .	prikývol	1	Past
Hľadali ju všade , vnútri i vonku , ale bezvýsledne .	Hľadali	0	Past
Soni ma prosila , aby som nerobil hlúposti .	nerobil	6	Past
Zišla o ďalšie dva schody .	Zišla	0	Past
Netušil som , že na druhý deň moju formu , ktorú som opäť nadobudol vďaka Raise , zničí tá najabsurdnejšia udalosť v mojom živote .	zničí	17	Pres
Ale Kerchak to nevidí ! “	nevidí	3	Pres
Po štyroch dolároch starec zjavne pookrial .	pookrial	5	Past
Zrejme poznala ten sladiak naspamäť .	poznala	1	Past
V prípade , že z manželstva nevzišli deti , Strana nepovoľovala rozvod , zato podporovala odlúčenie .	nevzišli	6	Past
Ja by som si dovolil tvrdiť , že nefungujú .	dovolil	4	Past
A síce , že vôbec nejde o odkaz od Ideopolície , ale od nejakej ilegálnej organizácie .	nejde	5	Pres
Potom sa všetko vyvinulo nečakaným smerom .	vyvinulo	3	Past
A keď som ho počúval , pri akejsi zmene v zafarbení jeho hlasu sa mi na chvíľu zazdalo , že ho poznám .	zazdalo	17	Past
Niekde blízko pri vás sa určite potuluje bezprizorná neter , synovec , sused či kolegyňa .	potuluje	6	Pres
“ Poď sem , Chris , “ zašepkala som .	zašepkala	7	Past
Nedokáže sám vychovávať Jazmínu , dcéru , ktorá má toľko energie a predstavivosti .	Nedokáže	0	Pres
“ A teraz mi zaplať ! “ zhúkol na Jazmínu predavač .	zhúkol	7	Past
“ Nesmieš sa udrieť , nesmieš sa udrieť , nesmieš sa udrieť .	Nesmieš	1	Pres
Prikazujem ti to ! “	Prikazujem	0	Pres
Ženy a deti sledovali z úkrytu , ako sa muži skrývajú za Jumbom .	skrývajú	10	Pres
Mravce dovliekli celý kôš dobrôt , včielky priniesli ovocný medovník a Kasandra jazmínové želé .	priniesli	7	Past
Bežné prachovky naňho nestačia ” .	nestačia	3	Pres
S ťažkým nákladom sa vliekli po lesnej ceste .	vliekli	4	Past
Prvý raz po mnohých rokoch zabudol na všadeprítomnú televíznu obrazovku .	zabudol	5	Past
Sadol som si a vybral z tašky fľašu whisky .	Sadol	0	Past
Rodičom sa však taký vývoj udalostí nepáčil a zišli sa na porade .	nepáčil	6	Past
Nezískala ho ani Matica , ani občianske združenie Komorra a nedarí sa to ani gymnáziu .	nedarí	10	Pres
Nemám z toho dobrý pocit .	Nemám	0	Pres
Už som ho niekde počul .	počul	4	Past
Nemôžete ho minúť . “	Nemôžete	0	Pres
Vláda predloží zákon o zdravotníckych povolaniach a zariadeniach definujúci úlohy poskytovateľov a zdravotníckych pracovníkov .	predloží	1	Pres
Vyzeráš normálne a nevinne .	Vyzeráš	0	Pres
“ Vedel som , že s mamkou vlčicou problémy nebudú . “	Vedel	1	Past
Formulácia „ Volumus , ut episcopi habeant potestatem . . . “ implikuje interpretáciu , že biskupi , vykonávali svoj úrad z vôle panovníka , že on im udeľoval mandát na reálne pôsobenie v ich úrade .	vykonávali	18	Past
Vtedy som vyriekol jediné slová , o ktorých som si myslel , že vystihujú moje rozpoloženie .	vyriekol	2	Past
A čo ho tam čakalo ?	čakalo	4	Past
Začnem podľa poradia , od fascikla s číslom 1 .	Začnem	0	Pres
Vari ho špehuje ?	špehuje	2	Pres
“ Ako sa voláš a kde bývaš ? “ spýtala sa toho stvoreniatka .	spýtala	9	Past
Biely vždy dáva mat .	dáva	2	Pres
Medzitým prišlo na plaváreň zopár deciek z oddielu a ich hlasy sa ozývali po vykachličkovanom priestore .	prišlo	1	Past
Mauglí sa zamračil .	zamračil	2	Past
Napriek tomu Syme odhalil uňho niečo ako nedostatok nadšenia .	odhalil	3	Past
“ Asi mám , “ odvetil Chris a pokračoval v kreslení .	mám	2	Pres
Vtedy som zdvihol telefón a vytočil číslo 09 .	vytočil	5	Past
„ Čas , v ktorom žijem , viem , že je Tvojím darom .	žijem	5	Pres
Ak ťažké kvapky zasiahnu jej jemné krídelká , môžu ju poraniť .	zasiahnu	3	Pres
“ Kam ideme ? “ vypytoval sa .	vypytoval	5	Past
Vrátiš ju do štrnástich dní . "	Vrátiš	0	Pres
Pramenné materiály , ktoré zachytávajú 11 . storočie sa zmieňujú o prudkom nástupe novej ideológie do všetkých oblastí života .	zachytávajú	4	Pres
Pre mňa by nastal koniec sveta , keby Liza zverejnila moje tajomstvo .	nastal	3	Past
Položil som pohár na stôl a išiel som otvoriť .	Položil	0	Past
Našla osí roj , ktorý mal včelí palác zničiť .	Našla	0	Past
V poslednom čase ju Ministerstvo hojnosti veľmi obľubovalo .	obľubovalo	7	Past
Plukovníkovi Hatímu sa zježil chobot .	zježil	3	Past
Najťažší trest postihuje opäť kňazov , ktorí sa dopustili bigamie .	postihuje	2	Pres
“ Cvičíme . “	Cvičíme	1	Pres
Prerušilo ju ohlušujúce chrčanie .	Prerušilo	0	Past
Šikovne využil pobyt folklórnych skupín a súborov z celého Slovenska v Bratislave , ktoré sem chodili na náklady Opusu alebo rozhlasu nahrávať platne .	využil	1	Past
Uvidíte , nabudúce prídem za vami zas !	prídem	3	Pres
“ Ja teraz veľmi rada lietam , “ povedala Maja .	lietam	5	Pres
Jediný kanál s jasným obrazom vysielal pornografické scény .	vysielal	5	Past
Veľmi mi chýbal .	chýbal	2	Past
Ja to viem , prehovoril som po dlhom váhaní .	prehovoril	4	Past
Ak drží grifon v pazúroch štyri púčky , vyjadruje sa tým jeho všadeprítomnosť .	drží	1	Pres
Od tých čias bola mojím najvzácnejším pokladom , i keď miestami zodratým , ale na okrajoch som cítila šampónovú vôňu jeho vlasov .	cítila	17	Past
Dokázala to !	Dokázala	0	Past
“ Ďakujem , pani Hutchinsonová , “ odvetila som naradostene .	Ďakujem	1	Pres
Výučbu tancov povedie Jano Blaho , dôstojný nástupca Štefana Nosáľa na poste choreografa Lúčnice .	povedie	2	Pres
Ľúbim ťa .	Ľúbim	0	Pres
Nemal som dôvod zapierať .	Nemal	0	Past
Ustráchaní sedeli na akejsi lúke a nevedeli , kadiaľ sa ide domov .	nevedeli	6	Past
Dúfal som , že ju nečítal .	nečítal	5	Past
“ Môžeš chodiť , kam len chceš . “	chceš	6	Pres
Keď sa Šer Chán obzrel za seba , od strachu zareval .	zareval	10	Past
Zavalíme ľan kameňom , aby ostal vo vode .	ostal	5	Past
Správne sa nazdávala , že , práve prišiel do chalúpky učupenej v horskom údolí .	nazdávala	2	Past
Pozrela som pod seba a zacítila v žalúdku šteklivé vzrušenie .	Pozrela	0	Past
Príčiny ochorenia úzko súvisia s nezdravým životným štýlom , svoju významnú úlohu zohrávajú alkohol , fajčenie , nedostatok pohybu , nadváha a obezita , stres , poprípade nedostatok zdravých potravín .	zohrávajú	12	Pres
Pozdvihol zrak nahor k tej obrovskej tvári .	Pozdvihol	0	Past
Smiala som sa , akoby sme boli len kamoši , ale keď som si sadla do auta vedľa Shannon , naskočili mi na ruke zimomriavky , keď sa ma Chris dotkol .	sadla	14	Past
Pocítila , že sa blíži explózia , a odtiahla sa .	Pocítila	0	Past
Teraz sa v noci budievam zo spánku a hrdlo mi zviera úzkosť : trápi ma nočná mora , že aj ja som v dave , ktorý ženie mamu v ústrety smrti .	trápi	13	Pres
“ Čo si želáš ? “ spýtala sa pokojne .	spýtala	6	Past
Ak mám byť úprimná , dojalo ma to .	mám	1	Pres
Bol plochý a hranatý , na chrbte mal pekný vzor a zdalo sa , že spí .	spí	15	Pres
Deti si obľúbia veľký zobák pelikánej slečny a radi sa s ním zahrajú , keď uvidia slová KLIP ‐ KLAP !	uvidia	15	Pres
Winstonovo telo zalial razom na každom kúsku studený pot .	zalial	2	Past
“ Poviem vám to stručne a jasne , “ odvetil Ferdo .	odvetil	9	Past
Baghíra ho ťahal , ale Mauglí sa pevne držal stromčeka .	ťahal	2	Past
“ Pomôžem ti , “ povedala Chris , keď som sa snažila udržať rovnováhu na okennom parapete .	snažila	11	Past
“ Ide sa .	Ide	1	Pres
Oči ma neklamali .	neklamali	2	Past
Ručička vyskočila na šesťdesiat .	vyskočila	1	Past
Ak vojde dnu , bude pred nimi v bezpečí .	vojde	1	Pres
Makové zrniečka v nej zašušťali , ako keď sa presýpajú myšlienky .	zašušťali	4	Past
Na tretí deň ráno spratal päť porcií raňajok a spokojne sa ponaťahoval .	ponaťahoval	11	Past
Takéto zistenie zaujímavo dopĺňa a modifikuje pohľad na najvyspelejšie mesto stredovekej Rusi , mesto majúce bohaté styky s civilizačným okruhom západnej Európy .	dopĺňa	3	Pres
Vtrhli do panského domu ako roj sršňov až sa Maja s Rudkom hanbili .	hanbili	12	Past
Zostal som sedieť v kresle , aj keď sa dvere otvorili a do miestnosti vošli dvaja muži , nové tváre .	vošli	14	Past
“ Alma ? “ zakričal .	zakričal	4	Past
Keď sme asi hodinu kráčali po ceste pre vozy , mama odbočovala ku kravínom a ja som išla ďalej do školy .	išla	17	Past
Ten leták na mňa nezapôsobil .	nezapôsobil	4	Past
Aha , čo to visí na šnúre ?	visí	4	Pres
Okolo nás pulzovala noc a ozývali sa známe zvuky okolia : tlmený hukot čerpadiel v okolitých bazénoch .	pulzovala	2	Past
Husté čierne vlasy jej padali na plecia a zakrývali tvár .	padali	4	Past
Pokľakol pred ňou a vzal jej ruky do svojich .	vzal	4	Past
Ide teda , takpovediac , o problém výchovný .	Ide	0	Pres
Toto slovo mi naháňa strach .	naháňa	3	Pres
Na zemi ležal obrázok s prasknutým rámom .	ležal	2	Past
Sú v ňom i Greta Garbo , Betty Grable , Lucille Ball , Hedy Lamar , Mary Pickford , Ruth Gordon a Dinah Shore .	Sú	0	Pres
Sedela som pri telefóne a usmievala sa .	Sedela	0	Past
Zmizni lebo mi odplašíš zákazníkov .	odplašíš	3	Pres
Hmotný svet existuje , jeho zákony sa nemenia .	existuje	2	Pres
Skupina kánonov I . ostrihomskej synody sa venuje stanoveniu obsahu bohoslužieb a príbuzným kultovým predpisom .	venuje	7	Pres
Teším sa na Vaše odpovede a prajem príjemný týždeň ,	Teším	0	Pres
“ Ja som sa nikdy nechcel ženiť , “ hundral nespokojne Vilko , “ a ty mi zrazu podstrčíš dieťa ! “	hundral	9	Past
Preto predpokladáme , že žili pomerne izolovane od ostatného uhorského mníšstva .	predpokladáme	1	Pres
Za nič na svete však nechcela opustiť svoju rodinku , a tak sa Rudko a Flip rozhodli , že jej občas pomôžu .	pomôžu	21	Pres
Odfukujeme v spoločnosti braníckej desiatky .	Odfukujeme	0	Pres
Napriek tomu som túžil , aby sme sa takto vliekli nekonečne dlho .	vliekli	9	Past
Kto zažil sparné pražské popoludnie , vie veľmi dobre , čo znamená spojenie " správně vychlazená dvanáctka " .	zažil	1	Past
Obsiahly vlastivedný úvod ( Praefatio ) k Doležalovej gramatike napísal o generáciu starší Matej Bel .	napísal	9	Past
“ Haló ? “ ozvala som sa a moje podozrenie sa potvrdilo .	potvrdilo	11	Past
Myslím , že o sebe urobili veľmi pekný obraz , že aj Rómovia a deti z detského domova sa vedia správať na úrovni .	vedia	19	Pres
“ Blahoželám , Chris , “ povedala srdečne .	Blahoželám	1	Pres
Starého dobráckeho sultána zahalili kúdoly hmly .	zahalili	3	Past
“ Uhádla si , “ povedal Chris a obrátil sa ku mne .	povedal	5	Past
Keby som bol prehltol tú návnadu , moje postavy by ma boli priviedli do hrobu .	priviedli	12	Past
Otočila sa a odletela .	Otočila	0	Past
Neviem vysvetliť , prečo sme nechodili na rande ako iní .	Neviem	0	Pres
Ja by som si dovolil tvrdiť , že nefungujú .	nefungujú	8	Pres
Napokon usúdil , že najbezpečnejším miestom je kantína .	usúdil	1	Past
“ Môžeš , “ odvetilo sloníča .	Môžeš	1	Pres
Rád by som veril čestnosti politikov , ale realita na Slovensku je zatiaľ iná .	veril	3	Past
Práve vtedy tréner August zapískal .	zapískal	4	Past
Čo najrýchlejšie bežal preč .	bežal	2	Past
Chytil ma za ruku a bežali sme dolu kopcom až k svetlám .	Chytil	0	Past
Vzhľadom na vytrvalosť , akú prejavoval , som očakával , že takto zaboduje .	zaboduje	12	Pres
Páčim sa Chrisovi !	Páčim	0	Pres
Čarodejnica odhrnula vejúci plášť a dobré víly onemeli od hrôzy , keď zbadali Zorničku .	onemeli	7	Past
Marga mi svoju túžbu piť vysvetlila na druhý deň .	vysvetlila	5	Past
Keď Herkules počul tie slová , vrátila sa mu odvaha .	vrátila	6	Past
Regula metského biskupa podrobne ustanovuje i podmienky prijatia do spoločenstva kanonikov a v rámci nich predpisuje pre kandidáta povinnosť odovzdať všetok majetok kostolu , pri ktorom mieni pôsobiť .	predpisuje	15	Pres
Tomu ja hovorím prirodzený výber !	hovorím	2	Pres
Vybrala peňaženku a znova ju dala do plecniaka .	Vybrala	0	Past
K tejto problematike patria podľa nášho názoru i právne normy , ktoré upravujú niektoré procesné záležitosti .	upravujú	12	Pres
Nikto ho zatiaľ neuderil .	neuderil	3	Past
Veselo sa prechádzali medzi hosťami , usmievali sa a povzbudzovali ich , aby sa u nich cítili ako doma .	povzbudzovali	9	Past
“ Ty chceš ísť na túru ? “ spýtala som sa a pozrela na hodinky .	chceš	2	Pres
“ Dám príbor , “ ponúkol sa Chris , “ ak mi povieš , kde ho nájdem . “	povieš	12	Pres
Na povrchu hlainy sa ukázali špinavé bublinky a obecenstvo tlieskalo .	ukázali	4	Past
Chceš povedať , že Amy Wyseovej sa páči nejaký chalan ?	páči	7	Pres
Opäť prikývol .	prikývol	1	Past
“ Nejak to vymyslíme .	vymyslíme	3	Pres
Zmocnil sa ma nevysvetliteľný strach , mal som pocit , že ju už neuvidím .	neuvidím	13	Pres
“ Keď napríklad zavrem oči , vidím teba , Amy . “	vidím	6	Pres
" Vlastne by to na veci nič nezmenilo , " poznamenal .	nezmenilo	7	Past
Ak prirátam hodinu na pečenie , bude trištvrte na jedenásť .	prirátam	1	Pres
Sadol som si a vybral z tašky fľašu whisky .	vybral	4	Past
Ja sa volám Faika , odvetila .	volám	2	Pres
" Niekedy , " poznamenala , " pohrozia človeku niečím -- niečím , čomu nedokáže vzdorovať , na čo nedokáže ani pomyslieť .	nedokáže	14	Pres
“ Už som veľká , poradím si sama .	poradím	5	Pres
Žiadne z nich nevykazujú nejaké reformné vplyvy .	nevykazujú	3	Pres
Človeka to bohvieako nezaujímalo , popíjal z pohára a škriabal na papier tie svoje znaky .	škriabal	9	Past
A nohy ma priviedli do obchodu , kde predávali alkoholické nápoje .	predávali	8	Past
“ Vidím budúcnosť , v ktorej budeš neuveriteľne bohatý a mocný .	Vidím	1	Pres
Prihlásime ho do vzpieračskej súťaže , “ povedal .	povedal	7	Past
Už na mňa čakajú .	čakajú	3	Pres
Keby ste tu vyrastali , pripadalo by vám to normálne .	pripadalo	5	Past
Variant , že pôjdem po žobraní , sa mi nepáčil .	nepáčil	9	Past
Keď sa chrobák zjavil znovu , vyzeral namrzene a hodil na zem kúsok medu .	zjavil	3	Past
Tarzana urazilo , že sa Kerchak hnevá a utiekol do džungle .	hnevá	6	Pres
Holeňový vred mu natreli hojivou masťou .	natreli	3	Past
Anita jej to sľúbila a zložila .	sľúbila	3	Past
“ Náramne ! “ odvetil Stromboli .	odvetil	4	Past
Môžem ti hovoriť Jaz ? “	Môžem	0	Pres
Na bielizníku mi nechala odkaz : “ Dúfam , že si sa dobre bavila , srdiečko . “	nechala	3	Past
Oznamuje východ slnka a prebúdza zo spánku . .	prebúdza	4	Pres
" Je krásna , " pošepol .	pošepol	5	Past
Za nič na svete však nechcela opustiť svoju rodinku , a tak sa Rudko a Flip rozhodli , že jej občas pomôžu .	nechcela	5	Past
Vláda pripraví koncepciu legislatívnych opatrení a ekonomickú stratégiu pre digitalizáciu televízneho a rozhlasového vysielania .	pripraví	1	Pres
Delina predo mnou nikdy nevyriekla toto slovo .	nevyriekla	4	Past
Od tejto chvíle si môžete ľubovoľne vytvárať fotoalbumy s neobmedzeným počtom fotiek .	môžete	4	Pres
“ Vzdávam sa . “	Vzdávam	1	Pres
Povedala , že by sme mali odísť bez rozlúčky , nechcela , aby sme nechali Irme odkaz , kam ideme , a ja som pozbieral odvahu .	nechcela	10	Past
Vláda zásadnejšie prehodnotí doteraz platný dotačný systém podľa kritérií EÚ .	prehodnotí	2	Pres
Maja ju však nechala , nech rozpráva .	nechala	3	Past
“ Nepoznám nikoho , kto dosiahol taký vysoký počet bodov .	Nepoznám	1	Pres
Keď víly nechali princeznú na chvíľočku v paláci osamote , zjavilo sa pred ňou jagavé svetlo .	nechali	2	Past
( Cirkevnú sankciu teda zákon neobsahuje . )	neobsahuje	5	Pres
Chcem poďakovať aj sestrám , ktoré sa podieľajú na upratovaní nášho chrámu .	podieľajú	7	Pres
Steblo sa zlomilo a on skončil na chrbte .	zlomilo	2	Past
Polovicu zo všetkého , čo vo mne je , mám z domu , z toho , čo sa doma povedalo , napríklad pri stole .	povedalo	19	Past
Zdalo sa mu , že to tu pozná .	pozná	7	Pres
Jan prichádza do kraja po zvestiach o zabití žien volchvami .	prichádza	1	Pres
Menšie rozmery potešia pri balení .	potešia	2	Pres
“ Udupe ťa ! “	Udupe	1	Pres
Všade snorí polícia !	snorí	1	Pres
Ak nevyjde , nemáme dôvod stretnúť sa .	nemáme	3	Pres
Opatrne som vstala , aby som ju nezobudila a išla som vypnúť televízor .	išla	9	Past
“ Čo je ? “ zopakovala som .	zopakovala	5	Past
Presvedčil Záborského , že správna slovenská výslovnosť je „ ľist “ .	Presvedčil	0	Past
Nemá inú možnosť , musí to skúsiť .	Nemá	0	Pres
Potomstvo sa o tebe nikdy nedozvie .	nedozvie	5	Pres
Pritisol som ich k sebe .	Pritisol	0	Past
Usnul šepkajúc : " Zdravý rozum sa nedá zaznamenať štatisticky " a s pocitom , že táto jeho poznámka obsahuje hlbokú múdrosť .	Usnul	0	Past
Vzal kôš a deku , do ktorej sme sa spolu zabalili .	zabalili	10	Past
Recepčné sa podujali objednať taxík a zobudiť ma , kedy uznám za vhodné .	uznám	10	Pres
“ Nechodím s Rickom .	Nechodím	1	Pres
Zachytil ma , aby som sa neudrela .	Zachytil	0	Past
Na líci sa nachádza ruža so štyrmi lupienkami , obkolesená zložitou dekoratívnou obrubou .	nachádza	3	Pres
Zarazene vstali a skúmali , či sú celí .	skúmali	3	Past
Mal som pocit , že za známymi črtami tváre , ktorých som sa vo sne neraz dotýkal , sa skrýva akési tajomstvo .	skrýva	19	Pres
Opäť pomyslel na Katharine .	pomyslel	1	Past
" Niekedy , " poznamenala , " pohrozia človeku niečím -- niečím , čomu nedokáže vzdorovať , na čo nedokáže ani pomyslieť .	nedokáže	19	Pres
Uvidíte , nabudúce prídem za vami zas !	Uvidíte	0	Pres
Pracuje na Medzinárodnom letisku J . F . Kennedyho a volá sa Tom .	Pracuje	0	Pres
Široký nôž sa pri používaní zle drží v ruke .	drží	6	Pres
Niektoré z nich , vydané vo francúzštine , občas dávala aj mne , pričom mi nezabudla prikázať , aby som to nikomu neprezradil .	nezabudla	15	Past
Poskakoval okolo mňa a od samej radosti sa jašil .	jašil	8	Past
Niečo ma však na tom znepokojuje .	znepokojuje	5	Pres
Teší ma .	Teší	0	Pres
Očakávala som niečo iné , ona však nevyslovila jedinú výčitku .	Očakávala	0	Past
Ešte mal zalepené hlasivky a nemohol rozprávať .	nemohol	5	Past
“ Spomínam si , Ferdo , “ povedal tenkým hláskom .	Spomínam	1	Pres
Ak muža s tvárou umrlca odviedli o polnoci , bolo ráno , ak ráno , bolo popoludnie .	odviedli	5	Past
Kedy sa zmenili Rickove city ku mne a prečo som si to nevšimla ?	zmenili	2	Past
" Nie je to náhodou cukor ? " opýtal sa .	opýtal	8	Past
Nedokázala som urobiť jedinú slušnú obrátku .	Nedokázala	0	Past
Zahľadela sa mi do očí a spýtala sa , či ju beriem .	beriem	11	Pres
Bláznovstvo , bláznovstvo , bláznovstvo , pomyslel si znovu .	pomyslel	6	Past
Spoločne mu ukázali upravené domčeky i podzemné chodby .	ukázali	2	Past
“ Poviem vám to stručne a jasne , “ odvetil Ferdo .	Poviem	1	Pres
Počas jazdy sa Rýchlik a Jill hádali , ktorú stanicu naladia .	naladia	10	Pres
Balú potrebuje pomoc ! “	potrebuje	1	Pres
Pohľad , ktorý sa mi naskytol , ma vydesil .	naskytol	5	Past
Očká zažmurkali .	zažmurkali	1	Past
“ Máš právo sa na mňa hnevať .	Máš	1	Pres
Čosi podobné nariaďujú i uhorské právne normy .	nariaďujú	2	Pres
Počkajte , na okamih vás vyrušíme !	vyrušíme	5	Pres
Keď som sa vrátila domov , vzala som tranzistor a sadla som si k obloku .	vrátila	3	Past
Smrti sa , samozrejme , bojím .	bojím	5	Pres
Šéf sa zo všetkých síl pokúšal , aby som odišiel z jeho pracovne spokojný , aj keď mi tú poviedku neuverejní .	neuverejní	20	Pres
Keď vošiel , hluk hlasov zoslabol na polovicu .	vošiel	1	Past
Chcel byť so svojou rodinou a chcel ostať v džungli .	Chcel	0	Past
Zasadalo zborové presbyterstvo	Zasadalo	0	Past
Položil som slúchadlo na vidlicu a uprel som zrak na telefón .	uprel	6	Past
Vybral som z neho pokrčený oblek .	Vybral	0	Past
Ihneď ho ohúrila jej zmena k horšiemu .	ohúrila	2	Past
Winston videl , že na podnose prináša karafu a poháre .	prináša	6	Pres
Musí sa veľa učiť a Kasandrinou úlohou bolo vychovať ju a pripraviť na život včely .	Musí	0	Pres
Chcem poďakovať aj sestrám , ktoré sa podieľajú na upratovaní nášho chrámu .	Chcem	0	Pres
Netušila som , že počúvajú , ale zrazu všetci hýrili nápadmi .	počúvajú	4	Pres
“ Nijaké záhady sa nekonajú , “ odvetil Chris .	nekonajú	4	Pres
Faikiným rukojemníkom som zostal až do chvíle , keď sa rozhodla , že odíde , a vydala sa .	odíde	13	Pres
Nezískala ho ani Matica , ani občianske združenie Komorra a nedarí sa to ani gymnáziu .	Nezískala	0	Past
Každý deň , každú chvíľu budú porážaní , diskreditovaní , vysmievaní , opľuvaní -- a napriek tomu vždy prežijú .	prežijú	18	Pres
KDH v januári 2000 zablokovalo vstup SMK do Európskej demokratickej únie .	zablokovalo	4	Past
Dupot za Ferdom neutíchal a chodba pred ním sa akoby z ničoho nič končila .	končila	13	Past
Ten názov si prevzal z jednej Čechovovej poviedky , povedala mi .	prevzal	3	Past
Vláda vypracuje a realizuje projekt transformácie štátnych podnikov lesného hospodárstva v pôsobnosti Ministerstva pôdohospodárstva SR na štátnu akciovú spoločnosť založenú podľa osobitného zákona .	vypracuje	1	Pres
Nevyzerám v plavkách smiešne ?	Nevyzerám	0	Pres
Okrem zajatcov priemerný občan Oceánie nikdy nezočí občana Euroázie alebo Východoázie a zakazuje sa ovládať cudzie jazyky .	nezočí	6	Pres
Rodičia zaujímali miesta naproti sebe , ja som sedával medzi nimi .	sedával	8	Past
O jej fair ‐ play správaní sa na druhý deň písalo aj v novinách .	písalo	10	Past
Keď však Winston opravoval pôvodný plán , znížil číslo na 57 miliónov , aby vyhovel bežným požiadavkám na prekročenie kvóty .	vyhovel	14	Past
Chvíľu tam ležal akoby omráčený , pričom mu z úst a z nosa stekal pruh tmavej krvi .	stekal	13	Past
A tu či inde sa v úplnej tajnosti nachádzali riadiace mozgy , ktoré koordinovali toto úsilie a určovali politickú líniu : rozhodovali o tom , že tento fragment minulosti sa zachová , tento sa sfalšuje a ďalší prestane jestvovať .	prestane	37	Pres
S obavami na mňa pozrel .	pozrel	4	Past
Winstona vyparia .	vyparia	1	Pres
“ Ako sa voláš a kde bývaš ? “ spýtala sa toho stvoreniatka .	voláš	3	Pres
V hmle odchádza akýsi tieň .	odchádza	2	Pres
Mával som ich už dlhšie .	Mával	0	Past
Vtedy som začul zvonenie .	začul	2	Past
Miestnosť bola priveľmi stiesnená , lebo všetky steny dookola podopierali nespočítateľné množstvo zaprášených rámov naukladaných jeden na druhý .	podopierali	9	Past
Rozhodne a bezpochyby ozelenela .	ozelenela	3	Past
Literárne činný od roku 1898 , jeho prvá kniha poviedok vyvolala roku 1903 senzáciu — bezpochyby spôsobom stvárnenia i výberom tém .	vyvolala	10	Past
“ PÄŤ TELEFONÁTOV ! “ zvolala som , keď som zbadala , že doma v chodbe bliká svetielko na odkazovači .	zbadala	10	Past
So srdcom , ktoré mu tuhlo , kráčal Winston v jeho pätách .	tuhlo	5	Past
Mohol to spôsobiť nejaký známy z rokov strávených na fakulte , napríklad niektorý dedinský nafúkanec .	Mohol	0	Past
“ Vy máte šťastie ! “ povedala mora Maji , lebo vedela , čo znamená stretnutie so škriatkom kvetov .	máte	2	Pres
Nemieni sa vzdať bez boja , tak lacno svoju kožu nepredá .	nepredá	10	Pres
Asi sa dopočul , že chodím s Chrisom .	chodím	5	Pres
Madonna po úspechu albumu Ray of Light odriekla herecké ponuky .	odriekla	7	Past
Pochodíme spolu celý svet !	Pochodíme	0	Pres
Dolnolotrinská reforma sa viaže predovšetkým k pôsobeniu Gerharda .	viaže	3	Pres
“ Toto je tvoja detská izba , neskôr dostaneš večeru , “ vysvetľovala mu Maja .	dostaneš	8	Pres
Ten súvisí s iným bláznom , ktorý býval v našej štvrti .	súvisí	1	Pres
Marga mi však ukazovala listy , ktoré dostávala .	dostávala	7	Past
Vyznajme Bohu svoje hriechy , potom nám Boh daruje tento pokoj skrze vieru v Ježiša Krista .	daruje	8	Pres
Formulácia „ Volumus , ut episcopi habeant potestatem . . . “ implikuje interpretáciu , že biskupi , vykonávali svoj úrad z vôle panovníka , že on im udeľoval mandát na reálne pôsobenie v ich úrade .	implikuje	12	Pres
Zrazu si Aladin uvedomil , že naňho so záujmom hľadí vysoký , vážny a trochu zavalitý mladík .	hľadí	9	Pres
Niekto vliezal do okna .	vliezal	1	Past
Povie niečo ?	Povie	0	Pres
Čo to tu smrdí ?	smrdí	3	Pres
“ Musím rozmýšľať . “	Musím	1	Pres
„ Nebyť toho , Slovensko by dnes neexistovalo , “ hovorí Ľubomír Ďurovič .	neexistovalo	7	Past
V škole ich privítala pani učiteľka .	privítala	3	Past
Ide o unikátny nález brezovej listiny v karelčine , s využitím ruskej abecedy .	Ide	0	Pres
Winston sedel na svojom mieste a civel do prázdneho pohára .	civel	6	Past
“ Nechceme pomstu , “ povedal zmierlivo Ferdo .	Nechceme	1	Pres
Rozoberané nepokoje sa odohrávajú v Beloozere , Novgorode , Suzdali , roku 1091 sa objavuje volchv i v Rostove .	odohrávajú	3	Pres
Mal na sebe dlhý čierny kabát .	Mal	0	Past
V skutočnosti sa vyplácali iba malé sumy a výhercovia veľkých výhier neexistovali .	vyplácali	3	Past
Zdalo sa mu , že jej na tej oblude vskutku záleží .	záleží	10	Pres
Ten nový tlmočil .	tlmočil	2	Past
Usmiala som sa na mamu a štrngli sme si .	štrngli	6	Past
Dvere zamkla znútra na kľúč a cez temnú chodbu – svetlo nebolo zažaté – ma zaviedla do izby , kde sme zastali oproti sebe .	zamkla	1	Past
V podstate som nedúfala , že príde , no keď som ho zbadala na opačnom konci preplnenej a zadymenej telocvične , myslela som si , že sa mi marí .	marí	28	Pres
Musí byť pohodlný , viem , aby sa v ňom Lienke dobre sedelo a dobre pérovaný , aby nedostala kočovú chorobu .	viem	4	Pres
Z palice vyšľahol zelený blesk .	vyšľahol	2	Past
Chvíľu leteli , až pristáli v spustnutej záhrade , kde bola pod obrovskou smutnou vŕbou hlbočizná studňa .	pristáli	4	Past
“ Takže musím zavolať tvojmu otcovi , “ povedala .	musím	2	Pres
Keď preberal znova volant , prikryl mi ruky , ktoré ostali naspodu .	prikryl	5	Past
Po celý čas som sa díval smerom k osvetlenému pásmu , kde sa zástup žien tlačil pred skleným priečelím obchodu .	díval	5	Past
Rýchlo som upratala zo stola a ponáhľala sa do svojej izby .	upratala	2	Past
“ A tá cvrčica je pekná ? “ vypytoval sa , keď mu Maja všetko vyrozprávala .	vyrozprávala	15	Past
“ Vidím , že ťa čaká veľmi dobrá budúcnosť .	Vidím	1	Pres
Keď sa zasa vrátili do triedy , pani učiteľka im prečítala zaujímavú rozprávku .	prečítala	10	Past
Vtom som pozrela hore a zbadala pri bazéne Chrisa .	zbadala	5	Past
V súlade s medzinárodnými trendmi pripraví novú koncepciu celoživotného vzdelávania .	pripraví	5	Pres
“ Tá farba naozaj pripomína požiarnické auto . “	pripomína	4	Pres
Zvieratká odpočívali pred svojimi príbytkami , večerali a popíjali púpavovú šťavu od cikád .	večerali	6	Past
Aj ona sa mi zahľadela do očí .	zahľadela	4	Past
Zrazu zažmurkal a prekvapene na oboch pozrel .	pozrel	6	Past
“ Mohla by som doplniť aj najhulvátskejší ? “ dodala Aziza .	dodala	9	Past
Poďakovanie patrí aj posudzovateľom rukopisu – pánovi prof . PhDr . Richardovi Marsinovi , DrSc . a pánovi PhDr . Jánovi Steinhübelovi , CSc . , ktorí mi pomohli vylepšiť text svojimi cennými postrehmi .	patrí	1	Pres
Vcelku ľutujem , že som to neurobil . "	ľutujem	1	Pres
Stráca svoj vidiecky a náboženský charakter a stáva sa mestskou a svetskou .	Stráca	0	Pres
Tu dávam povely ja ! “	dávam	1	Pres
“ Vidím , že ťa čaká veľmi dobrá budúcnosť .	čaká	5	Pres
Počas jazdy sa Rýchlik a Jill hádali , ktorú stanicu naladia .	hádali	6	Past
Vzájomné porovnanie takto vytvorených jednotiek umožní plastickejší pohľad na danú problematiku a odhalí nové súvislosti dávno známych faktov .	umožní	5	Pres
V tomto podniku si nemôžem dovoliť luxus v podobe ďalšej whisky , ani keby som išiel dušu vypustiť .	išiel	15	Past
Ruky ma zúfalo boleli a na krátky , ale nepríjemný okamih som nadobudla dojem , že spadnem na nesprávnu stranu .	spadnem	16	Pres
Keď som čítala posledné riadky , myslela som na mamu , ktorá robila zázraky , aby sme dajako vyšli .	čítala	2	Past
Vznikol okolo rokov 1220 — 1230 .	Vznikol	0	Past
Zviera sa s rachotom zrúti do snehu .	zrúti	4	Pres
Okno bolo len zámienkou a ona to svojou ženskou intuíciou vytušila .	vytušila	10	Past
Nová Koncepcia ochrany prírody a krajiny bude obsahovať racionálny systém manažmentu chránených území , prehodnotí ich cieľový stav a navrhne opatrenia a programy starostlivosti tak , aby chránené územia slúžili aj verejnosti .	prehodnotí	14	Pres
Chlapec mu prebehol prstom po hrdle .	prebehol	2	Past
Kto odniesol vajíčka ?	odniesol	1	Past
Piateho mája sa začalo Pražské povstanie a z rádia sa ozývala výzva o pomoc .	ozývala	10	Past
Vyrába umelé potreby , ktoré nás aktivujú , vyprázdňujú , ničia a zotročujú .	ničia	10	Pres
Za slovenskú stranu sa tradične na organizácii prehliadky podieľa Slovenský filmový ústav a Asociácia slovenských filmových klubov , ktorá prostredníctvom MK SR udeľuje na prehliadke Hlavnú cenu Zlatý debut .	podieľa	8	Pres
Čakal som márne .	Čakal	0	Past
O ' Briena vyparia .	vyparia	3	Pres
" A sme tu , " oznamovala .	oznamovala	6	Past
Tentoraz mu ju však pripomenula najmä dusná horúčava toho popoludnia , keď mu na čele vyrazili kropaje potu .	pripomenula	4	Past
Onedlho začul dupot čižiem niekde mimo cely .	začul	1	Past
“ Počuješ ?	Počuješ	1	Pres
A takisto dúfam , že neskôr nevidel ani film Hmla .	nevidel	6	Past
“ Vidíš , Jago , “ povedal svojmu papagájovi .	Vidíš	1	Pres
“ Čakám na teba , “ odvetil .	Čakám	1	Pres
Počujete ma ?	Počujete	0	Pres
Chris pokrčil plecami .	pokrčil	1	Past
Márne sa prezliekala , v našej izbe sa vždy našlo niečo , čo smrdelo kravínom .	prezliekala	2	Past
Marga chcela , aby sme sa zaradili medzi korzujúcich .	chcela	1	Past
Kto si o Snehulienke rozum trúsi , ten rozletí sa na márne kusy !	rozletí	8	Pres
Fil mu vysvetlil , že doteraz ho sklamali všetci , ktorým pomáhal .	vysvetlil	2	Past
Zatiaľ čo sa Chris profesora na všeličo vypytoval , Rick si pedantne zapisoval každé jeho slovo .	zapisoval	12	Past
Pršalo , slnko sa schovalo za mraky .	Pršalo	0	Past
Profesor stál obďaleč , horko ‐ ťažko som mu videl časť tváre .	videl	9	Past
Možno tu zohrali určitú úlohu slová „ Si neskutočne milý “ .	zohrali	2	Past
Vari dnešní otcovia národa často nevravievajú , že naša milovaná vlasť je banánová republika ?	nevravievajú	5	Pres
Pomyslel som si , že plače .	plače	5	Pres
Marketing deformuje naše vnímanie a chápanie pravdy .	deformuje	1	Pres
Nepobozkala ma .	Nepobozkala	0	Past
Cez tenké steny sem zvonku dopadalo iba chabé svetlo .	dopadalo	5	Past
Vláda sa zaväzuje naďalej garantovať občianske slobody a všestranný rozvoj ľudských práv .	zaväzuje	2	Pres
Kde tá ľudská duša drieme ?	drieme	4	Pres
Nasleduje objavenie sa volchva v Rostove , udalosti v Polocku , sucho a Polovci .	Nasleduje	0	Pres
Rozvinutie tohto nariadenia nachádzame v prvom Kolomanovom zákonníku .	nachádzame	3	Pres
Marga nereagovala , takže to bol iba sluchový klam .	nereagovala	1	Past
Keď sa telo spojilo s dušou , dievčina zažmurkala a otvorila oči .	otvorila	10	Past
Zároveň však Cluny urobilo veľký krok na ceste k libertas , lebo vytvorilo spoločenstvo ( zväčša ) úplne slobodných kláštorov , ktoré nepodliehali laikom .	vytvorilo	12	Past
Syme zdvihol zrak . " Tam prichádza Parsons , " poznamenal .	zdvihol	1	Past
Takýto svet pripravujeme , Winston .	pripravujeme	2	Pres
V domčeku si odpočiniem .	odpočiniem	3	Pres
Priateľky a príbuzní ju ponechali svojmu osudu .	ponechali	4	Past
Musím vymyslieť nejakú tajnú skrýšu , kam ťa cez deň ukryjem .	Musím	0	Pres
Namiesto toho urobila večeru , ako na zmierenie , a celú večnosť čakala , že sa vrátim .	urobila	2	Past
Vláda pripraví program zameraný na ekonomický rozvoj , v rámci tohto programu vypracuje podprogramy pre jednotlivé sektory .	vypracuje	12	Pres
Z obilia sa robila múka a z nej sa piekol chlieb .	piekol	9	Past
Sadol som si do podniku pri kine a čakal , kým príde určená hodina .	čakal	8	Past
“ Hádam mi nechceš tvrdiť , že nezáleží na výsledkoch .	nezáleží	7	Pres
Možno sa tam jedného dňa vráti .	vráti	5	Pres
Veselo sa prechádzali medzi hosťami , usmievali sa a povzbudzovali ich , aby sa u nich cítili ako doma .	cítili	16	Past
Syme zdvihol zrak . " Tam prichádza Parsons , " poznamenal .	prichádza	6	Pres
Zhodil ma na trávu a veľmi dlho sme sa bozkávali .	bozkávali	9	Past
Vtedy som si pomyslel na Irmu .	pomyslel	3	Past
Nevedel som to .	Nevedel	0	Past
Prešiel . . .	Prešiel	0	Past
Hlavu si oprela o jeho rameno a príjemná vôňa jej vlasov zahnala zápach holubieho trusu .	zahnala	11	Past
Vyvoláva pokušenie .	Vyvoláva	0	Pres
Vláda pripraví aktualizáciu národnej stratégie prevencie kriminality a vytvorí legislatívne podmienky na jej realizáciu .	vytvorí	8	Pres
Tekla nadšene schytila husle a knísala sa za Majou .	knísala	5	Past
Z dejinného procesu ťa načisto odstránime .	odstránime	5	Pres
Myslel som to úprimne .	Myslel	0	Past
Zničená som si prisahala , že si cez obedňajšiu prestávku zaplávam a budem trénovať obrátky dovtedy , kým ich nezvládnem .	nezvládnem	19	Pres
“ Nepiekla to , “ odvetil .	odvetil	5	Past
Mysli na to , že možno tvoje deti dobre v škole prospievajú .	prospievajú	11	Pres
S takým nátreskom nerátal .	nerátal	3	Past
“ Hádes nás zabije , keď to zistí ! “	zistí	7	Pres
Abuov citlivý noštek vykrúcalo od najodpornejších pachov a jeho jemné ušká urážalo nedôstojné pokrikovanie .	urážalo	11	Past
“ Ostanem tu ! “ kričal .	Ostanem	1	Pres
To je fantastická novina ! “ zvolala som a objala ju .	zvolala	6	Past
Teraz musí urobiť , čo jej prikáže .	prikáže	6	Pres
Ja tomu len verím . Viem , že raz padnete .	verím	3	Pres
“ Volám sa . . . “	Volám	1	Pres
Úľ sa vzďaľoval a jej sa zdalo , akoby pod ňou utekala zem .	vzďaľoval	2	Past
“ To nikam nevedie . “	nevedie	3	Pres
Požiera slová bez akýchkoľvek zábran .	Požiera	0	Pres
Veľký brat je zovňajšok , v ktorom sa Strana ráči ukazovať svetu .	ráči	9	Pres
Jazmína zatajila dych .	zatajila	1	Past
Aj bez ďalšieho vysvetľovania O ' Brien vedel , ako to myslí .	myslí	11	Pres
Na rube sa nachádza ľudská postava v korune s insígniami v rukách .	nachádza	3	Pres
Priplávala som ku kovovým schodíkom a s námahou som vystupovala von , keď ma striaslo .	striaslo	14	Past
Keď som mal vši , nikam som necestoval , nechodieval som domov .	necestoval	7	Past
Chris na mňa pozrel , či mi nešibe .	nešibe	7	Pres
“ Ešte si to rozmyslím , “ zahučal obor , ale už sa knísal nepriateľovi v ústrety .	zahučal	7	Past
Tarzan podrástol a veľmi rád si matku doberal .	podrástol	1	Past
“ Blahoželám , zázračný silák , “ povedala Meg so slzami v očiach .	Blahoželám	1	Pres
Neobjal ma , nepriblížil sa ku mne , ani nezavrel oči .	Neobjal	0	Past
Sporenie prostredníctvom individuálnych účtov vytvorí priestor , aby v budúcnosti o čase svojho odchodu do dôchodku mohol rozhodovať sám občan .	vytvorí	4	Pres
Avšak rodine malého paviána sa nepáčilo , ako sa Jane správa k ich mláďaťu a nazlostení začali dievčinu prenasledovať .	nepáčilo	5	Past
Ale ona nezdvihla zrak .	nezdvihla	2	Past
Prišiel onedlho so stetoskopom v ruke .	Prišiel	0	Past
Keď Shannon otvorila dvere , sprisahanecky ma objal okolo pliec a vliezol na zadné sedadlo .	objal	7	Past
Vyrába umelé potreby , ktoré nás aktivujú , vyprázdňujú , ničia a zotročujú .	Vyrába	0	Pres
Snívalo sa Ferdovi o boji ?	Snívalo	0	Past
Pomaly kráčali po dlhom schodišti , ktoré viedlo na strechu , kde bývali , a boli hladní , unavení a veľmi sklamaní .	viedlo	7	Past
“ Myslíš , že nás spoznal ? “ spýtal sa Chris , keď sme sa prestali triasť .	spoznal	5	Past
“ Neviem , “ vraví myška , “ ale možno ti poradia tamtie modré kvietky . “	poradia	11	Pres
“ Musím sa učiť . “	Musím	1	Pres
Trošku sa pritom začervenal .	začervenal	3	Past
“ Rozdupeme Dia !	Rozdupeme	1	Pres
Detektíva Steva McGarretta hral Jack Lord .	hral	3	Past
Máme tu teda ďalší argument pre to , aby sme kánony o celibáte z druhej kolomanovskej synody nepovažovali za prejav úplného príklonu k normám reformného pápežstva .	Máme	0	Pres
Zhovára sa mi s tebou dobre .	Zhovára	0	Pres
Práve vyliezol zo svojho kopčeka .	vyliezol	1	Past
“ Nezistia to , “ odvetila Flóra .	Nezistia	1	Pres
Spočiatku som sa úspešne tváril , že ma zaujíma výlučne predstavenie .	zaujíma	8	Pres
Urobíme nejaké rozbory , určíme liečbu . . .	Urobíme	0	Pres
To nás veľmi teší .	teší	3	Pres
Vláda sa zároveň zaväzuje presadiť v zdravotníctve tvrdé rozpočtové obmedzenie tak , aby od roku 2004 nedochádzalo k tvorbe nového dlhu .	zaväzuje	3	Pres
Uvítala každú príležitosť , aby som vypadla z mesta na čerstvý vzduch .	vypadla	6	Past
Jeho monotónny hlas mi pripadal znesiteľný až dovčera , keď Chris povedal , že mu chýba iskra .	chýba	15	Pres
Dal som mu takéto meno , keď som s akousi ľahkosťou presvedčil sám seba , že toto meno najlepšie pristane môjmu hrdinovi .	Dal	0	Past
Stále som kľačal na kolenách a čelo sa mi pokrylo potom .	pokrylo	9	Past
“ Vy ten červík zjete ? “	zjete	4	Pres
V oblasti nemocenského poistenia prijme vláda opatrenia zamedzujúce zneužívaniu systému .	prijme	4	Pres
Nie je dobrý v počtoch , a preto sa často mýlil .	mýlil	10	Past
Ferdo si povedal , že mravce sú muzikálny národ a započúval sa .	povedal	2	Past
Namiesto toho som zašiel k predavačovi novín .	zašiel	3	Past
Neskoro večer , keď bandy surových proletov vyvádzali na uliciach , vládla v meste zvláštna horúčkovitá atmosféra .	vládla	11	Past
Vytrváte všetci ?	Vytrváte	0	Pres
Strana jestvuje .	jestvuje	1	Pres
Najprv Maja spoznala dobrého kamaráta , ktorý jej pripadal veľmi zvláštny .	spoznala	2	Past
Nehovoriac o tom , že popoludní mávala stále program , chodila na súkromné hodiny angličtiny .	mávala	6	Past
V zápale hry Maja prihrala Vilkovi , ten prudko kopol do lopty a lopta zmizla v kroví .	kopol	9	Past
Musím niečo urobiť , inak hrozí , že sa nezúčastním na Lorinom svadobnom obrade .	nezúčastním	9	Pres
“ Čo mi nesieš , Emanuel ? “ vypytovalo sa slniečko .	nesieš	3	Pres
Dôležitejším znakom oboch kategórií šamanov je , že úspech ich činov nezávisí od toho , akú obetu bohu prinesú , ale od toho v akom vzťahu sú oni sami s bohmi — tj . od ich schopností .	prinesú	18	Pres
Otvorila oči a pred sebou uvidela svätojánsku mušku Svetlanku .	uvidela	5	Past
Na plece mu zľahka doľahla čiasi ruka .	doľahla	4	Past
Usmiala som sa na Chrisa , a on sa uškrnul , ako keby mu naozaj odľahlo , že súhlasím .	Usmiala	0	Past
“ To sa nemalo stať ! “ kričal nešťastný Herkules .	kričal	7	Past
Ale ja nemôžem žiť bez tohto priznania .	nemôžem	2	Pres
Keď sa začal semester , pustil som sa pod vedením profesora SommerfelTa do čítania textov .	začal	2	Past
Teplé letné dni sa skončili a mladé včielky prvý raz zažili jeseň .	zažili	10	Past
Obrázkovým telefónom som zavolal kováča Kováčika a ten bez dlhých rečí koníka okoval .	zavolal	3	Past
Vonku opäť zaznel dupot čižiem .	zaznel	2	Past
Čoskoro som však zapochybovala o svojom odhodlaní , lebo pred školou ma dobehol Chris a chytil za ruku .	chytil	15	Past
Ale vlasy mu vstanú dupkom , keď si všimne niečo iné : trochu ďalej na konári , kam sa vyštveral , sedí medveď , ktorý tam vyliezol .	vstanú	3	Pres
Už ma bolia nohy . “	bolia	2	Pres
Vláda podporí rozvoj základného a aplikovaného výskumu na vysokých školách ako nevyhnutnej podmienky na poskytovanie kvalitného vysokoškolského vzdelávania a na zabezpečenie dlhodobo udržateľného rozvoja spoločnosti .	podporí	1	Pres
To sa opakovalo niekoľkokrát .	opakovalo	2	Past
Vážila som si tie slová , snívala o tom , že mi ich raz povie .	Vážila	0	Past
Nechcela som Chrisa znepokojiť , ale čím dlhšie tu ostaneme , tým skôr nás zbadajú .	zbadajú	14	Pres
Strhla aj mladšiu sestru a s rachotom prevrhli otcovu stoličku .	Strhla	0	Past
“ To je ono ! “ zvolal Balú .	zvolal	6	Past
“ Odkedy sa vy dve kamarátite ? “ neveriacky sa spýtala .	spýtala	10	Past
“ Pripadá mi to najmenej nebezpečné . “	Pripadá	1	Pres
Zviera vo mne zavylo .	zavylo	3	Past
A vravím ti , že nijaké číslo .	vravím	1	Pres
Hľadala som niečo , čo mamu uspí .	Hľadala	0	Past
Budete mať tri či štyri kontakty , ktoré príležitostne nahradíme novými .	nahradíme	9	Pres
“ Myslíš , že nás spoznal ? “ spýtal sa Chris , keď sme sa prestali triasť .	prestali	15	Past
Takéto oduševnenie stačilo na to , aby som sa zmenil .	stačilo	2	Past
Pousmejú sa a zíde im na um moja prezývka .	Pousmejú	0	Pres
Veď okolo neho lietame celé dni .	lietame	3	Pres
Nimi vysvätení kňazi teda nie sú právoplatne vysvätenými a nemôžu teda veriacim sprostredkovať dary Ducha Svätého .	nemôžu	9	Pres
Je ťažké nenávidieť niekoho , kto si natoľko neverí , že sa opičí po druhých .	opičí	12	Pres
Vláda považuje pružný trh práce schopný reagovať na hospodársky vývoj za nevyhnutnú podmienku znižovania nezamestnanosti .	považuje	1	Pres
“ Hneď ťa tam odnesiem . “	odnesiem	4	Pres
V každom prípade musím otvoriť oči a nesmiem veriť legendám .	musím	3	Pres
“ Zatváram , “ odvetilo lekno .	Zatváram	1	Pres
Maja zo zvedavosti priletela bližšie a sadla si na vedľajší list .	sadla	6	Past
“ Začni na ostrove Idra , kde vyhľadáš Filokteta , učiteľa hrdinov . “	vyhľadáš	7	Pres
Bála som sa , že mi povie , že ich chytil , keď sa milovali .	Bála	0	Past
Na fyzike patril k najlepším žiakom .	patril	2	Past
Vláda však v tejto súvislosti zastáva názor , že NATO i naďalej zostane hlavnou inštitúciou , prostredníctvom ktorej budú európski a severoamerickí spojenci i naďalej riešiť bezpečnostné otázky transatlantického rozmeru .	zastáva	5	Pres
“ Zdá sa , že Mauglí ako všetci ľudia má schopnosť priťahovať nebezpečenstvo , “ povedal .	povedal	15	Past
Neprezradila som jej , o čom sme sa rozprávali s Rickom , bála som sa , že sa nazúri , ak zistí , že som sa ich snažila dať dokopy .	nazúri	18	Pres
“ Pomôžem ti , “ povedala Chris , keď som sa snažila udržať rovnováhu na okennom parapete .	Pomôžem	1	Pres
Povedala , že sa volá Liza .	volá	4	Pres
Kŕč povolil .	povolil	1	Past
“ To je dobre , ale dúfam , že najprv budem bohatý a mocný . “	dúfam	6	Pres
Svätoštefanské zákony okrem toho nariaďujú aj povinnú nedeľnú návštevu kostola .	nariaďujú	4	Pres
Chrisov autobus zarachotil v zákrute a zabočil na HLavnú ulicu .	zabočil	6	Past
Keď dedinskí nafúkanci z môjho ročníka uverejnili na jeho stránkach nejakú báseň , naparovali sa celý mesiac .	naparovali	13	Past
“ Nesklamem ťa , otec , “ zvolal Herkules , keď s Pegasom leteli na ostrov Idra .	Nesklamem	1	Pres
Winston bol ženatý a pravdepodobne ešte stále je ženatý , lebo pokiaľ vie , jeho žena nezomrela .	vie	12	Pres
Prečo to tu píšem ?	píšem	3	Pres
Snažím sa vidieť päť . "	Snažím	0	Pres
Povedal som jej , nech si sadne , ale ona sa zdráhala .	sadne	6	Pres
Odložil som pohár a očami som opäť zablúdil k protiľahlým stolom , pri ktorých sedeli spomínaní ľudia .	sedeli	14	Past
Priadli , priadli až upriadli .	upriadli	4	Past
Vláda pripraví a realizuje systém ochrany slovenského spotrebiteľa a prostredníctvom legislatívy ho prispôsobí stavu , ktorý bude zodpovedať legislatíve EÚ .	prispôsobí	12	Pres
Blythe sa zatvárila sklamane .	zatvárila	2	Past
Strážca prižmúril oči a poobzeral sa dookola .	prižmúril	1	Past
Toľko stačilo , aby sa vydesilo aj dieťa .	stačilo	1	Past
Nestrácal som čas a priložil som oko k škáre v podlahovej doske .	Nestrácal	0	Past
Pokým nás kryjú tieto konáre , sme v bezpečí . "	kryjú	2	Pres
Vtedy som si pomyslel na syna .	pomyslel	3	Past
Držal ma za ruku .	Držal	0	Past
Uvažovala som , akú časť pretekov teraz v duchu pláva .	Uvažovala	0	Past
Prosíme o Vaše príspevky a finančnú podporu .	Prosíme	0	Pres
Vláda vytvorí legislatívne , administratívne a kontrolné mechanizmy pre efektívne čerpanie zdrojov z fondov EÚ .	vytvorí	1	Pres
Uvoľnený zub vytrhol O ' Brien aj s koreňom .	vytrhol	2	Past
“ Blahoželám , mami !	Blahoželám	1	Pres
Obávala som sa , že dám najavo priveľké nadšenie , ak sa otočím ku Chrisovi celá naradostená .	dám	5	Pres
Džin ho každý večer otupoval a džin ho každé ráno znovu oživoval .	oživoval	11	Past
“ Vezmi ju stadiaľ , ona odíde , a ty ostaneš . “	odíde	6	Pres
Vtedy mi položila ďalšiu otázku .	položila	2	Past
Húf mojich postáv i muž , ktorý mi radil , aby som pohol mozgom , zmizli .	radil	8	Past
Začala som s kapitolou o zatmení a snažila sa spomenúť na to , čo som videla .	videla	15	Past
Nepamätal som sa , či sme s Raisou vypili včerajšiu fľašu alebo nie .	vypili	8	Past
" Ako vyzerá ? "	vyzerá	2	Pres
Otvoril oči a s vďakou sa zahľadel na O ' Briena .	zahľadel	6	Past
Ani družka , ani sok ho nesledujú . Čo ho núti vysedávať na konári osamoteného stromu a vyludzovať hudbu do prázdna ?	núti	10	Pres
Neviem , čo mi to napadlo .	Neviem	0	Pres
Spomínaní suzdaľskí volchvi sa zjavujú práve v čase neúrody , aby ju pomohli zahnať .	zjavujú	4	Pres
Pred domom kuny Chytráčky viali pestré slepačie perá , Alfonz vystavoval lesklú kukuricu a kliešťak Drakula voňavé krvavé klobásky .	viali	4	Past
Začal ma trápiť komplex impotentnosti .	Začal	0	Past
Vláda si uvedomuje výzvy informačného veku .	uvedomuje	2	Pres
Vstala a odišla .	Vstala	0	Past
“ To ti vo vode vrátim , “ povedala som .	vrátim	5	Pres
Keď zazneli prvé tóny pomalej skladby , rozhodla som sa , že za ním pôjdem .	pôjdem	14	Pres
“ Dostaneš možnosť , “ ubezpečoval ho Fil .	Dostaneš	1	Pres
Už sme spomenuli , že pápežský úrad bol v desaťročiach pred reformou v hlbokej kríze .	spomenuli	2	Past
Chvíľu potrvá , kým si na seba opäť zvyknú .	potrvá	1	Pres
Celý svet vyvalí oči , keď Belu a Gastona zbadá taký pár málokde zočí , krásavci jedna balada .	zočí	13	Pres
A stiahol zlatý náprstok naspäť pod čiernu zem .	stiahol	1	Past
Vláda pripraví nový mediálny zákon .	pripraví	1	Pres
A teraz pomôžem ja tebe .	pomôžem	2	Pres
Biblia nám na to odpovedá .	odpovedá	4	Pres
Neotáľa a vylezie na strom .	vylezie	2	Pres
Herkules zajasal .	zajasal	1	Past
“ Tu niekde mám bundu , “ zamrmlal .	zamrmlal	7	Past
Podišiel som k oknu , že sa spýtam svojich postáv , čo si o tom myslia .	myslia	15	Pres
" Možno som sa nevyjadril celkom presne , " poznamenal .	poznamenal	9	Past
Chris síce prikývol , ale šibalsky mu sem ‐ tam myklo kútikmi úst .	myklo	10	Past
Ochráni Jazmínu , nech by jej hrozilo čokoľvek .	Ochráni	0	Pres
Usnul šepkajúc : " Zdravý rozum sa nedá zaznamenať štatisticky " a s pocitom , že táto jeho poznámka obsahuje hlbokú múdrosť .	obsahuje	19	Pres
A tu či inde sa v úplnej tajnosti nachádzali riadiace mozgy , ktoré koordinovali toto úsilie a určovali politickú líniu : rozhodovali o tom , že tento fragment minulosti sa zachová , tento sa sfalšuje a ďalší prestane jestvovať .	zachová	30	Pres
“ Vidíte , čo ste spravili ? “ zabzučala a starostlivo si kefovala jemné chĺpky na tele .	Vidíte	1	Pres
Usmiala som sa na Chrisa .	Usmiala	0	Past
Uvedomila som si , že som nevhodne zareagovala , lenže ten bozk ma naozaj vyviedol z miery .	Uvedomila	0	Past
“ Čo je to vrecko ? “ vystrašene sa pýtala Maja .	pýtala	9	Past
Veď ho strhne do hlbočiny , pomyslela si Polly .	strhne	2	Pres
“ Amy , “ povedal a jemne ma chytil za lakeť .	povedal	4	Past
" Nemám na mysli priznanie .	Nemám	1	Pres
Keď uplynul tretí deň a ja som sa v ten večer konečne ocitol sám , bol som na pokraji nervového vyčerpania .	ocitol	12	Past
Trápila sa pre ne .	Trápila	0	Past
Keď však Winston opravoval pôvodný plán , znížil číslo na 57 miliónov , aby vyhovel bežným požiadavkám na prekročenie kvóty .	znížil	7	Past
Deti si obľúbia veľký zobák pelikánej slečny a radi sa s ním zahrajú , keď uvidia slová KLIP ‐ KLAP !	obľúbia	2	Pres
Zahľadela sa mi do očí a spýtala sa , či ju beriem .	Zahľadela	0	Past
Teší ma , “ jachtala som .	jachtala	4	Past
Winston zapálil horák a postavil naň kanvicu s vodou .	zapálil	1	Past
Zviera , čo obýva zámok , ja naskutku skolím .	skolím	8	Pres
“ Štvrť na dvanásť , “ povedala som a Chris odvetil : “ Správne . “	odvetil	10	Past
Došlo mi , že po celý čas nad nami visel oveľa výraznejší dôkaz božskosti Mira Šatana .	visel	9	Past
“ Tomuto ja hovorím najpotrebnejšie veci , “ výsmešne škriekala opica .	škriekala	9	Past
Videl , ako Júlia zodvihla pohár a privoňala k nemu s úprimnou zvedavosťou .	zodvihla	4	Past
Na zlepšenie komunikácie s verejnosťou sa zavedú pravidelné stretnutia funkcionárov polície s občanmi .	zavedú	6	Pres
Sú tam psi ? “ spýtal sa ma , kým sa vyšvihol na múr .	vyšvihol	11	Past
Môžem ti pomôcť ? “ ľutovala ju Maja .	Môžem	0	Pres
Keď človek dostane vši , je to nepríjemné .	dostane	2	Pres
“ Prekvapuješ ma , Amy .	Prekvapuješ	1	Pres
Malo by ísť o Benedikta , Cyrila , Metoda , Brigitu , Katarínu a Teréziu , všetko svätých .	Malo	0	Past
Ľúbil som všetky ženy , s ktorými som mal pomer .	Ľúbil	0	Past
Utekala som , čo mi nohy stačili .	stačili	6	Past
Videla som , že Chrisovi síce odľahlo , no po chvíli sa zasa tváril vážne .	tváril	13	Past
Nápis tak vcelku nadobúda podobu kríža .	nadobúda	3	Pres
Išla som k dverám jej izby : “ Volá Rick , “ zašepkala som .	Išla	0	Past
Mal neuveriteľne dlhé , tenké nohy a smiešne , malé , hnedé a guľaté telíčko .	Mal	0	Past
Odtrhol rožtek balíčka .	Odtrhol	0	Past
Syma vyparia .	vyparia	1	Pres
Verila , že neurobím to čo ona .	neurobím	3	Pres
Musíš ísť na Olymp , musíš ho zastaviť . “	Musíš	0	Pres
Som chorá , povedala , zomriem .	zomriem	5	Pres
“ Nejdem ! “ odvrkol Mauglí .	Nejdem	1	Pres
“ Ani sa nečudujem , že pre ňu nemôžete nič vymyslieť .	nemôžete	8	Pres
Veľmi sa za to hanbím . “	hanbím	4	Pres
Človek očakával , že ho zabijú .	zabijú	5	Pres
Hľadala som v zásuvke nejaký papier na poznámky , keď som zbadala formulár na udelenie finančnej podpory počas štúdia na vysokej , ktorý mi dal ešte pred niekoľkými týždňami výchovný poradca pán Hatch .	Hľadala	0	Past
“ Toto hľadáš ? “ spýtal sa s úsmevom , keď sa po chvíli vynoril aj s kľúčikom .	hľadáš	2	Pres
Áno , teraz videl , že to odnepamäti vedel .	vedel	8	Past
Samozrejme , že som mu nepovedala , že mám domáce väzenie .	mám	8	Pres
Pani Parsonsovú vyparia .	vyparia	2	Pres
Trvalo to , až kým výťah nezastal na siedmom poschodí .	Trvalo	0	Past
A čo hnusné to tu rastie ?	rastie	5	Pres
Preboha ! “ zvolala som a udrela som sa po čele .	udrela	6	Past
Parsons , ktorého to bombardovanie číslami priviedlo až do akéhosi nedefinovateľného nadšenia , si vytiahol fajku z úst .	priviedlo	6	Past
“ I mne sa raz snívalo , že budem učiť najväčšieho hrdinu všetkých čias , “ vyhlásil Fil .	snívalo	5	Past
Zostávala mi poviedka .	Zostávala	0	Past
Pocítila , že sa blíži explózia , a odtiahla sa .	odtiahla	8	Past
Nechcem nič konkrétne .	Nechcem	0	Pres
Mama sa pobrala do kuchyne , no na polceste zastala .	zastala	9	Past
Máte kvalitnú vodku , poznamenala , čo som vôbec nečakal .	Máte	0	Pres
Niet pochýb , že mi ju poslala do cesty prozreteľnosť .	Niet	0	Pres
Vláda sa zároveň zaväzuje presadiť v zdravotníctve tvrdé rozpočtové obmedzenie tak , aby od roku 2004 nedochádzalo k tvorbe nového dlhu .	nedochádzalo	16	Past
Musí byť pohodlný , viem , aby sa v ňom Lienke dobre sedelo a dobre pérovaný , aby nedostala kočovú chorobu .	nedostala	18	Past
Miznem v temnej priepasti , v roztvorených ústach pohlcujúcich rieku času .	Miznem	0	Pres
Hrdlo mi zviera banálnosť .	zviera	2	Pres
Chcel som poprosiť aj redaktorku , aby už nevyužívala repliky mojich postáv .	Chcel	0	Past
Iná obsahová náplň priláka nový typ čitateľov , to je jasné .	priláka	3	Pres
Sestrička , ktorá si uvedomila , že ju o niečo okradol , tíško zanariekala .	okradol	10	Past
Naháňalo mi to strach .	Naháňalo	0	Past
V tej chvíli som otvoril oči a začul som vzlykot .	začul	7	Past
Vyzeráte úžasne ! “ vravel trom zošúvereným babizniam .	Vyzeráte	0	Pres
“ Vravela , že pozná sultána . “	Vravela	1	Past
Reformátori 11 . storočia však už dospeli k precíznejšej formulácii , ktorá , podľa nás , reprezentuje nimi presadzovanú snahu o čo najpresnejšie vymedzenie sfér vplyvu svetskej a cirkevnej moci .	reprezentuje	16	Pres
“ Ak chceš , môžeme začať od začiatku , “ povedal .	chceš	2	Pres
“ Pripravuje ju podľa starého rodinného receptu . “	Pripravuje	1	Pres
“ Nie , nie , “ poponáhľala sa Maja s odpoveďou .	poponáhľala	6	Past
Ako zažala lúčne svetielko	zažala	1	Past
Hru , ktorú hráme , nemôžeme vyhrať .	nemôžeme	5	Pres
“ Raz to oľutuješ , Rahim . “	oľutuješ	3	Pres
Na druhý deň som zistil , že ležím celkom oblečený na skladacej posteli .	ležím	7	Pres
Musí byť pri tom také život , zdravie a príčetnosť ohrozujúce nasadenie ?	Musí	0	Pres
Uvidíme , ako do celé dopadne .	dopadne	5	Pres
“ Stavím sa , že je to bytosť z inej planéty , “ zašepkala Maja a zatiaľ čo sakamaráti skrývali za jej chrbtom , podišla bližšie a navrhla neznámemu prehliadku Makovej lúky .	zašepkala	13	Past
Iba sa trochu sklonila , odkryla deku a ja som uvidel tvár spiaceho človiečika , ktorý nemal takmer nijaké vlasy .	sklonila	3	Past
Niet pochýb , v hlave mám zmätok .	mám	5	Pres
Svätoštefanský zákon pripúšťa , aby sa žena , ktorú manžel za istých okolností opustí , znovu vydala .	pripúšťa	2	Pres
Aladina raz z Rahimovho obchodu vyhnali , keď sa Abu usiloval chvostom potiahnuť trs banánov .	vyhnali	5	Past
“ Môžeme vám nejako pomôcť ? “ zdvorilo sa vypytovala Maja .	Môžeme	1	Pres
Keďže som neprišiel na nič lepšie , sedel som celý deň vo svojej izbe a v duchu som si predstavoval , že som ušiel z domu .	sedel	7	Past
“ Čakám na teba , “ odvetil .	odvetil	6	Past
Povedala , že by sme mali odísť bez rozlúčky , nechcela , aby sme nechali Irme odkaz , kam ideme , a ja som pozbieral odvahu .	ideme	19	Pres
John sa vystrel , vypäl hruď , ale bol nesmierne smutný .	vystrel	2	Past
Šance na zachovanie výsledkov tunajších reforiem boli lepšie ako v Dolnom Lotrinsku , lebo tieto reformné strediská požívali citeľnú podporu svetskej aristokracie .	požívali	17	Past
Uma Thurman a jej priateľ Ethan Hawke očakávajú v júni narodenie dieťaťa .	očakávajú	7	Pres
S hrdinským úsmevom povedala , že uvíta každú kritickú pripomienku , lebo doteraz jej nikto nič konkrétne nepovedal .	uvíta	6	Pres
Tu dnu , to vedel inštinktívne , sa svetlá nikdy nevypínajú .	nevypínajú	10	Pres
“ A teraz idem pohľadať to malé bezmocné úbožiatko . “	idem	3	Pres
Nalial som aj sebe .	Nalial	0	Past
Niet pochýb , že nikdy nemohlo jestvovať obdobie , keď to bolo celkom bežné .	Niet	0	Pres
Tak sa učili variť , robiť jednoduché kuchynské práce ako umývanie riadu , škrabanie zemiakov , krájanie chleba .	učili	2	Past
Bál som sa , že moji rodičia sa namiesto toho , aby ma bránili , postavia na stranu útočníka .	postavia	15	Pres
Na lúke pred stromom sa ozývalo funenie a nejasné hlasy .	ozývalo	5	Past
Počul som , že noviny platia dobre , keď chcú .	platia	5	Pres
“ Ďakujem , “ povedala Makulienka , “ ibaže neviem , čo mám robiť , aby drozd vrátil Emanuelovi cylinder . “	Ďakujem	1	Pres
Do Tvojej milosti ich porúčame .	porúčame	4	Pres
Pomyslel som si , že sa nebojí môjho semena .	nebojí	6	Pres
Zlá víla sa tvárila vyjavene .	tvárila	3	Past
Chodili jej normálnou poštou do školy , kde učila .	učila	8	Past
Môj úsmev do diaľky žiari , tvár zdobia mandľové oči .	zdobia	7	Pres
" Hráš , vyhráš , hráš , prehráš .	vyhráš	3	Pres
Do Winstonovej ruky sa zapichla ihla .	zapichla	4	Past
Nemám čas , “ odvrkla som .	Nemám	0	Pres
Jestvuje len jeden a jediný spôsob , ako sa zachrániť .	Jestvuje	0	Pres
To dievčisko nič nevie !	nevie	3	Pres
Vláda pripraví legislatívny rámec inštitucionálneho vzdelávania zdravotníckych pracovníkov prostredníctvom rezortu školstva s možnosťou postgraduálnej prípravy pracovníkov v zdravotníctve v školách a inštitúciách , ktoré získajú akreditáciu pre príslušný typ vzdelávania .	získajú	24	Pres
Schuti som sa zasmiala , keď šaškoval na trávniku .	zasmiala	3	Past
Ja som cítila tvoj pohľad .	cítila	2	Past
Na tomto mieste spomeniem dva Sonine domnelé nedostatky .	spomeniem	3	Pres
Mám z toho večera fotku .	Mám	0	Pres
Otvoril oči a s vďakou sa zahľadel na O ' Briena .	Otvoril	0	Past
“ Nikdy nevystúpim na Olymp , “ vravel Filovi .	nevystúpim	2	Pres
“ Nech ti nelepí , vyhnem sa ti , ak sa vyhneš ty mne !	vyhnem	5	Pres
Mamina silueta stála vo dverách a obaja sme vycítili , že sa hnevá .	hnevá	12	Pres
Maja vážne pozrela na svoju učiteľku .	pozrela	2	Past
Prihlásime ho do vzpieračskej súťaže , “ povedal .	Prihlásime	0	Pres
Jej duša odletela do neba o polnoci , keď sa striedali storočia .	odletela	2	Past
“ Netráp sa , niečo vymyslíme , “ povedala Makulienka .	vymyslíme	5	Pres
Viedli ma polámané vetvičky a udupaná tráva .	Viedli	0	Past
Neviem , či na mňa viac zapôsobila skutočnosť , že môjho starého otca zabili , alebo meno Hádes , ktoré náš hosť ticho precedil cez zuby .	zapôsobila	6	Past
“ Nechceš ochutnať ? “ spýtala sa bosorka .	Nechceš	1	Pres
Ak jej dovolím odísť , už ju neuvidím .	dovolím	2	Pres
Keď sa však hlasuje v parlamente o zmluve s Vatikánom , zriadení katolíckej univerzity , SNS to podporila . "	podporila	17	Past
Spoznal vajíčka na prvý pohľad .	Spoznal	0	Past
Je síce pravda , že nijaký súdruh Ogilvy nikdy neexistoval , ale zopár riadkov v tlači a niekoľko vyfabrikovaných fotografií čoskoro splodia jeho existenciu .	splodia	21	Pres
Nevdojak som sa poobzeral , či neuvidím Háda .	neuvidím	6	Pres
“ Naozaj ? “ spýtal sa Rick .	spýtal	4	Past
Otvoril mešec a vysypal zlaté mince na zem .	Otvoril	0	Past
Ako som takto táral , pochopil som , že rozprávam hlúposti .	rozprávam	9	Pres
To ju zobudilo .	zobudilo	2	Past
Na druhý deň som zistil , že ležím celkom oblečený na skladacej posteli .	zistil	4	Past
Winston ihneď vyplatil štyri doláre a zasunul si vysnívanú vecičku do vrecka .	zasunul	6	Past
Do slovenských častí Uhorska sa vtedy utiahla jedna časť českých emigrovaných protestantov a tu našli v používaní svoj vlastný spisovný jazyk presne tak , ako vo svojej českej vlasti .	utiahla	6	Past
“ No moment , “ skočila mi do reči Blythe .	skočila	5	Past
Ak sa raz oldspeak nahradí , posledné puto s minulosťou sa pretne .	pretne	11	Pres
Keď pozrela pod seba , zistila , že uviazla v pavúčej sieti .	pozrela	1	Past
Vláda prehodnotí systém výkonu správy súdov , ktorý príliš zaťažuje sudcov administratívnymi činnosťami , osobitne pri štátnej správe jednotlivých súdov .	zaťažuje	9	Pres
Strana vyzýva jedinca , aby poprel svedectvo vlastných očí a uší .	poprel	5	Past
My však každému ponaprávame mozog do dokonalosti , kým mu ho vystrelíme .	ponaprávame	3	Pres
A tu či inde sa v úplnej tajnosti nachádzali riadiace mozgy , ktoré koordinovali toto úsilie a určovali politickú líniu : rozhodovali o tom , že tento fragment minulosti sa zachová , tento sa sfalšuje a ďalší prestane jestvovať .	rozhodovali	21	Past
Ak sa priznám , zastrelia ťa , ak sa priznať odmietnem , aj vtedy ťa zastrelia .	odmietnem	10	Pres
Niektoré veci musia prísť .	musia	2	Pres
Vylial som zvyšnú vodku do pohára .	Vylial	0	Past
“ Teba , “ odvrkol a bol preč .	odvrkol	4	Past
Rozumieš tomu ? "	Rozumieš	0	Pres
Bál som sa , že ma skritizuje za názov , ktorý som prevzal z jednej Čechovovej poviedky .	skritizuje	6	Pres
Dobrosrdečný Rudo ju hneď utešoval .	utešoval	4	Past
Jazmína neveriacky zažmurkala .	zažmurkala	2	Past
Nekúpila som ho , povedala , priniesla som ti ho .	Nekúpila	0	Past
Chutilo jedlo vždy takto ?	Chutilo	0	Past
" My však na všetkých stupňoch život ovládame , Winston .	ovládame	7	Pres
Položila som mu ruku na plece .	Položila	0	Past
Mne to môžeš povedať . “	môžeš	2	Pres
Mýlil som sa .	Mýlil	0	Past
Keď to povedal , položil mi nečakanú otázku .	položil	4	Past
