Zaujalo ma to ! “ povedala so smiechom Jazmína .	smiechom	7	Inan
Možnosť , že uverejním nejaký cyklus básní , som okamžite zavrhol .	cyklus	5	Inan
Dieťa rodičov Vnútornej strany sa nenarodilo do Vnútornej strany .	rodičov	1	Anim
Obzvlášť odvtedy , čo som sa presťahovala do prízemného bytu po mojej starej tete , ktorá chovala a vykrmovala túlavé mačky z celého sídliska .	bytu	9	Inan
Mladí nastúpili do Lorinho auta .	Mladí	0	Anim
“ Hromy a blesky privej !	blesky	3	Inan
“ Počkaj , až ochutnáš Safiyinu špecialitu , “ nadšene vravel , keď sluhovia kládli na stôl ťažký strieborný podnos s polguľovitým vrchnákom .	podnos	19	Inan
Muži zo sprievodu to jednohlasne odobrili .	Muži	0	Anim
S cieľom zefektívnenia správy rozpočtových prostriedkov a správy finančných prostriedkov štátu vláda uskutoční kroky na urýchlené dobudovanie systému štátnej pokladnice .	prostriedkov	5	Inan
Od straníkov sa vyžadoval podobný názor , aký mali starovekí Židia , ktorí síce vedeli , že všetky iné národy uctievajú nepravých bohov , ale to bolo všetko , čo o nich vedeli .	straníkov	1	Anim
Bolo tu pododdelenie televíznych programov s inžiniermi , producentmi a s celými tímami špeciálne vybraných hercov , lebo dokázali imitovať hlasy .	producentmi	8	Anim
“ Ubezpečujem vás , že nič nehrozí , “ kričal žene sultánov hlavný vezír Džafar .	vezír	13	Anim
“ Blahoželám , zázračný silák , “ povedala Meg so slzami v očiach .	silák	4	Anim
Práve poletovala medzi bielymi jazmínovými kvetmi a nevšimla si jemnulinké a tenulinké vlákna napnuté medzi konárikmi .	konárikmi	15	Inan
Tak u mnohých národov existujú tzv . bieli šamani , spájaní s nebeskými silami a svetom hore a šamani čierni , zviazaní s podsvetím .	šamani	8	Anim
Jediný kanál s jasným obrazom vysielal pornografické scény .	kanál	1	Inan
Publikáciu napísal známy český novinár a publicista Miloš Čermák .	publicista	6	Anim
Veľavravným svedectvom sú nálezy belozerskej lepenej keramiky .	nálezy	3	Inan
Abu položil na zem pred mladého muža vankúš .	muža	6	Anim
Niekto zo susedov si mohol všimnúť , že som bol preč , mohol by sa ma zvedavo vypytovať , kde som bol , a to by stačilo , aby sa som sa rozčúlil .	susedov	2	Anim
Vystúpenie veľkého množstva jeho bojových oddielov sa dalo chápať i ako pohanský nepokoj — prežitky predkresťanskej viery sa u Estóncov udržali neobvykle dlho .	nepokoj	12	Inan
Popri hlavnom hrdinovi Kuberovi je ona ďalšou hrdinkou .	hrdinovi	2	Anim
Zajac mohol byť vykladaný v systéme predkresťanských názorov jednak ako symbol plodnosti / dodnes spájame na veľkú noc vyobrazenia zajacov s vajíčkami , Nemci počas tohto sviatku hľadajú v záhrade vajíčka ukryté veľkonočným zajacom / .	Zajac	0	Anim
Obyvatelia lúky sa začali zbiehať pred jej domom a chválili Klotildin spev .	spev	11	Inan
Vtom sa otvorili dvere a vošiel dnu lykožrút Fridolín .	lykožrút	7	Anim
Takéto zistenie zaujímavo dopĺňa a modifikuje pohľad na najvyspelejšie mesto stredovekej Rusi , mesto majúce bohaté styky s civilizačným okruhom západnej Európy .	okruhom	19	Inan
Do minúty zhorí na popol .	popol	4	Inan
Vtedy som zdvihol telefón a vytočil číslo 09 .	telefón	3	Inan
Vláda si uvedomuje , že súčasťou problémov v rezorte zdravotníctva a dôvodom nespokojnosti obyvateľstva je vysoká miera korupcie .	rezorte	8	Inan
Makulienka a motýľ Emanuel sklopili zrak .	motýľ	2	Anim
O ' Brienov sluha ich však oboch vpustil dnu bez jediného protestu .	protestu	11	Inan
Duchovní v tejto funkcii sa netešia veľkej úcte , sú ohováraní svojimi nevoľníkmi , mučení a zabíjaní .	nevoľníkmi	12	Anim
Uvoľnený zub vytrhol O ' Brien aj s koreňom .	zub	1	Inan
Slová týchto popevkov písal bez akéhokoľvek ľudského zásahu prístroj známy pod názvom " veršovač " .	veršovač	13	Inan
Nevznikla sama od seba , jej náväznosť na vierouku z desiateho storočia / i keď došlo k zrejmým posunom / svedčí o kontinuite jej vývoja .	posunom	18	Inan
Obávam sa , že ocko nedovolí , aby sa mu po paláci potuloval tiger .	ocko	4	Anim
Konečne prišla jar a Maja sa zobudila zo zimného spánku .	spánku	9	Inan
Nie je jasné , či ide o hračky , alebo o idolčeky .	idolčeky	11	Inan
Začala som mať podozrenie už pred rokom , povedala .	rokom	6	Inan
Medzi pretekármi pravdaže nchýbal ani Flip , ktorý mal v hľadisku spústu fanúšikov .	fanúšikov	12	Anim
V správaní mníchov samých .	mníchov	2	Anim
Pozrela som na jedálny lístok vyvesený nad pultom , potom na zem a do výkladu .	lístok	4	Inan
Faikiným rukojemníkom som zostal až do chvíle , keď sa rozhodla , že odíde , a vydala sa .	rukojemníkom	1	Anim
Za finančnú podporu sa chcem poďakovať Ekumenickej rade cirkví , nášmu drahému zboru a „ staršej “ mládeži ECAV v Prešove , modlitebnému spoločenstvu , kamarátom z tréningu Rovesník a jednotlivcom .	kamarátom	25	Anim
“ Neviem , “ vraví myška , “ ale možno ti poradia tamtie modré kvietky . “	kvietky	14	Inan
Keď sa však hlasuje v parlamente o zmluve s Vatikánom , zriadení katolíckej univerzity , SNS to podporila . "	parlamente	5	Inan
Na jeho základe sa bude financovať zdravotná starostlivosť nad rámec tzv . solidárneho balíka .	rámec	9	Inan
Je to kúsok histórie , ktorú zabudli zmeniť .	kúsok	2	Inan
Keby som dal tie texty Deline , pochopila by , že ich stredobodom je ona .	stredobodom	12	Inan
Moji priatelia dúfali , že sudcovia a Lienka sfúknu zvyšok a ja nebudem potrestaný .	priatelia	1	Anim
Tak je po Jaroslavovom víťazstve položený základ novgorodských výsad , ktorí Novgorodcom garantujú ochranu pred kniežacími družiníkmi a Varjagmi / no zároveň zabezpečujú kniežaciu družinu pred ľudom / .	družiníkmi	16	Anim
Vlak bol plný proletov so sviatočnou náladou , ktorú v každom vyvolávalo letné počasie .	proletov	3	Anim
Vtedy sme mali iných svätcov .	svätcov	4	Anim
Nechápeš , že smrť jednotlivca nie je vôbec smrť .	jednotlivca	4	Anim
Alan Smithee je meno , ktoré sa používa v titulkoch , keď ražisér z rôznych príčin nesúhlasí s uvedením vlastného mena .	titulkoch	9	Inan
Medzi seba a potkany musí postaviť inú ľudskú bytosť , telo inej ľudskej bytosti .	potkany	3	Inan
Objala ho okolo krku , nazývala ho miláčikom , zlatkom , láskou .	miláčikom	7	Anim
Brat a sestra !	Brat	0	Anim
Gil Mars , najbohatší muž sveta , je majiteľom počítačovej spoločnosti MarsTech , ktorá vyrába aj hračky pre deti tretieho tisícročia .	majiteľom	8	Anim
Pri štvrtej obrátke sa mi stužka s kľúčikom z krku vyvliekla .	krku	9	Inan
Prvý z apoštolov patril v celom kresťanskom svete k mimoriadne uctievaným svätcom .	svätcom	11	Anim
Všetky slony rýchlo zdvihli choboty .	choboty	4	Inan
Vypil ďalší dúšok džinu , vzal bieleho jazdca a pokusne ním tiahol . Šach !	jazdca	7	Anim
Protiprávna vojna v Iraku , ktorú rozpútala nesvätá aliancia náboženských fundamentalistov , megalománov a kšeftárov , je cynickým výsmechom všetkých hodnôt , ktoré naša západná civilizácia pokladá za nedotknuteľné .	fundamentalistov	10	Anim
I v našom rozprávaní ide o tvorenie — o tvorenie človeka .	človeka	10	Anim
“ Hej ! “ zvolala som a chytila volant .	volant	8	Inan
Na oslavu prišli všetci olympskí bohovia a priniesli množstvo nádherných darov .	bohovia	5	Anim
Do toho domčeka prichádzal každý večer človek .	domčeka	2	Inan
V dôsledku rímsko - centralistickej tendencie zbierok prevzali do nich zostavovatelia i viaceré úplne alebo čiastočne sfalšované texty , ktoré však svojím obsahom zodpovedali stanoviskám a snaženiam reformátorov .	zostavovatelia	10	Anim
Individualista , vzbúrenec , latentný terorista .	vzbúrenec	2	Anim
A vládca sveta mŕtvych sa mi zjavil v čiernej peleríne .	mŕtvych	3	Anim
Urobia z neho človeka . “	človeka	3	Anim
Boli to dvaja muži v civilnom obleku .	obleku	6	Inan
Šikovne využil pobyt folklórnych skupín a súborov z celého Slovenska v Bratislave , ktoré sem chodili na náklady Opusu alebo rozhlasu nahrávať platne .	súborov	6	Inan
Za to , že sme mohli deti a chovancov obdarovať , ďakujeme Zuzke Reiszovej , Milke Čopovej a Jankovi Pagurkovi .	chovancov	8	Anim
Prvý raz mám príležitosť byť so spisovateľom a filmovým scenáristom , povedala .	scenáristom	9	Anim
Rodičia jej dali meno Brunilda .	Rodičia	0	Anim
Keď Šer Chán nenašiel v záhyboch Káaovho tela nič , zavrčal .	záhyboch	5	Inan
Pri príležitosti svojho odchodu a ukončenia zimného obdobia som vyhlásil , že zaplatím koňak všetkým , ktorí budú od dvanástej až do tretej poobede v kaviarenskej časti obchodu .	obchodu	27	Inan
Omarov hlas .	hlas	1	Inan
“ Strach z fyziky ? “ spýtal sa , akoby som povedala najväčšiu hlúposť .	Strach	1	Inan
Winstonovo telo zalial razom na každom kúsku studený pot .	kúsku	6	Inan
Zrazu zbadal v kroví hlúčik tulákov .	tulákov	5	Anim
Vstúpil tam dozorca .	dozorca	2	Anim
Pred odchodom upchám dieru kusmi vrecoviny .	kusmi	4	Inan
Koniec sa blížil , ale Wendy bola pokojná a statočná .	Koniec	0	Inan
Ten chlapec tu býva ?	chlapec	1	Anim
“ Tento víkend ostanem doma .	víkend	2	Inan
Legislatívnym základom bude vládou vypracovaný návrh moderného zákona o výchove a vzdelávaní .	základom	1	Inan
Najmiernejším prívlastkom , ktorý by mi vmietla do tváre , by bolo slovo „ gauner “ .	prívlastkom	1	Inan
Umožniť jazykovedcovi rozhovoriť sa o systéme v jazyku , prináša zdanlivo nebezpečenstvo , že sa vstúpi do nezaujímavého a nudného sveta .	jazykovedcovi	1	Anim
Nimi vysvätení kňazi teda nie sú právoplatne vysvätenými a nemôžu teda veriacim sprostredkovať dary Ducha Svätého .	kňazi	2	Anim
N . P . Lichačev bol tiež autorom jednej z prvých teoretických prác o uvedených pečatiach .	autorom	7	Anim
Ešteže to spozorvali mravce a zavolali hasičov !	hasičov	6	Anim
Na obzore sa objavil čierny bod a ja som si pomyslela , že je to nejaký chrobák .	chrobák	16	Anim
Zachvátil ju vzlykot .	vzlykot	2	Inan
“ Je mi to ľúto , chlapče , “ smutne mu vravel Fil .	chlapče	6	Anim
S odporným škrekotom z nej stúpali čarodejné výpary .	škrekotom	2	Inan
Film bol nakrútený podľa skutočnej udalosti .	Film	0	Inan
O týždeň sme sa dozvedeli , že ju na rok vylúčili z fakulty .	týždeň	1	Inan
Neostanú však verní fanúšikovia skrátka .	fanúšikovia	3	Anim
Cieľom reformy poistenia v nezamestnanosti bude posilnenie princípu zásluhovosti ( poistného princípu ) a princípu osobnej zodpovednosti občana za vlastnú pracovnú a sociálnu situáciu .	občana	17	Anim
Na zlepšenie komunikácie s verejnosťou sa zavedú pravidelné stretnutia funkcionárov polície s občanmi .	občanmi	12	Anim
Ten leták na mňa nezapôsobil .	leták	1	Inan
Ide o unikátny nález brezovej listiny v karelčine , s využitím ruskej abecedy .	nález	3	Inan
Náhlivo som vypol televízor a ona roztiahla pery do úsmevu .	televízor	3	Inan
Na šiesty deň ráno príval zvitkov ustal .	zvitkov	5	Inan
Winston videl , že na podnose prináša karafu a poháre .	poháre	9	Inan
Zasiahnutý netvor sa zmietal od bolesti a zletel zo skaly .	netvor	1	Anim
Pani Parsonsová priniesla kľúč na matice .	kľúč	3	Inan
Kým odletím do nebeského pekla , musím si odčiniť nejaké hriechy tu , v pozemskom pekle .	hriechy	10	Inan
Lev IX . a jeho nástupcovia sa teda snažili cirkev už skutočne riadiť .	nástupcovia	5	Anim
“ Ostalo , zvyšok by som vám mohla ponúknuť , “ povedala Maja .	zvyšok	3	Inan
Tí prašiví tuláci nedajú pokoj ! “	tuláci	2	Anim
I ja mám občas dojem , že môj život riadia mamine nesplnené sny .	sny	12	Inan
“ Čo by si chcela robiť v sobotu ? “ spýtal sa Chris a ja som na uchu zacítila jeho dych .	dych	20	Inan
Rusi prenasledovali kacírstvo ešte krutejšie , než inkvizícia .	Rusi	0	Anim
Veselo sa prechádzali medzi hosťami , usmievali sa a povzbudzovali ich , aby sa u nich cítili ako doma .	hosťami	4	Anim
Cvrčkovia dali signál a diváci celkom zmĺkli .	Cvrčkovia	0	Anim
Cieľom Diskusného klubu je budovanie občianskej spoločnosti na kresťanskom morálnom základe .	základe	10	Inan
“ Strachopud , “ nafučala sa , ale pretože bola zvedavá , spomalila .	Strachopud	1	Anim
Oficiálne sa partneri nikdy nezmenili .	partneri	2	Anim
Spev kohúta máva aj vo všednom , obyčajnom živote dvojaký význam .	kohúta	1	Anim
V jedno vetristé popoludnie zaspala pani Mandelinka uprostred obeda na stoličke a oni sa jej starali o drobizg .	drobizg	17	Inan
Zasadanie otvoril a viedol predsedajúci zborový farár brat Bakalár .	farár	6	Anim
Vláda zjednotí sadzby DPH pred vstupom do EÚ .	vstupom	5	Inan
Minule sa môj kolega Rado Ondřejíček fejtónovým perom pustil do problému hlupákov medzi nami .	kolega	3	Anim
Začali sme na kolotočoch , kde sme vyliezli na koňa .	kolotočoch	3	Inan
Chytila Petronilu pod krk a niekoľkokrát ňou zatriasla .	krk	3	Inan
Za pôvodcu Otovej politiky Renovatia , ako aj jeho politiky voči krajinám ležiacim na východ od ríšskych hraníc sa pokladá Gerbert z Aurillacu .	pôvodcu	1	Anim
Vláda podporí doriešenie vlastníckych vzťahov k pôde a rozvoj trhu s pôdou .	trhu	9	Inan
Podišli sme k pultu , kde som objednala tortillu so syrom .	pultu	3	Inan
Pochopil som to , keď som prišiel na koniec schodišťa a stretol som suseda z prízemia .	suseda	13	Anim
Zdalo by sa teda , že Somogyvárske opátstvo bude vďaka zväzku so svojím materským opátstvom súčasťou clunyjskej „ kongregácie “ .	zväzku	10	Inan
Nervózny mladý slon Tantor ho zbadal .	slon	2	Anim
“ A teraz je na rade výcvik , “ oznámil som mu .	rade	5	Inan
Niektorí sa nazdávali , že drevorubač konal správne .	drevorubač	5	Anim
Potom Maja s kamarátmi pomáhala stroskotancom z vody na nové plavidlo .	stroskotancom	5	Anim
Práve sa chystala roztiahnuť krídla a vzlietnuť , keď v tieni steny zbadala strážcu .	strážcu	13	Anim
Bol mučiteľ , bol ochranca , bol inkvizítor , bol priateľ .	inkvizítor	7	Anim
Potom si kráľovná opäť zastala pred oválne zrkadlo v zlatom ráme .	ráme	10	Inan
Škole chýbali priestory , a tak žiaci prvého stupňa , čiže aj my prváčikovia , mávali vyučovanie popoludní .	prváčikovia	13	Anim
Nilus bol skôr predstaviteľom východného typu mnícha , v osobe ktorého sa spájala vysoká miera asketizmu s rovnako vysokou úrovňou vzdelanosti a kvality duchovného života .	mnícha	6	Anim
Starec zrejme zabudol na predsudky , ktoré mal proti celému litru .	predsudky	4	Inan
Herkules odniesol Meginho ducha k telu .	ducha	3	Anim
Naši neurológovia pracujú na tom už teraz .	neurológovia	1	Anim
Vtom si spomenula na poštového poslíčka Pavla , ktorý okrem správ roznášal po lúke dobrú náladu .	poslíčka	5	Anim
* Niektorým poslancom padlo zaťažko zverejniť svoje majetkové priznanie .	poslancom	2	Anim
Zo strachu o seba , pre svoju povýšenú zbabelosť zaprel svojho Majstra a Pána .	strachu	1	Inan
Zasadanie otvoril a viedol predsedajúci zborový farár brat Bakalár .	brat	7	Anim
Plávanie je môj najobľúbenejší šport .	šport	4	Inan
Bolo tu pododdelenie televíznych programov s inžiniermi , producentmi a s celými tímami špeciálne vybraných hercov , lebo dokázali imitovať hlasy .	hercov	15	Anim
Keď sa chrobák zjavil znovu , vyzeral namrzene a hodil na zem kúsok medu .	chrobák	2	Anim
Transparenty , manifestácie , heslá , hry , spoločné výlety -- a podobné gebuziny .	Transparenty	0	Inan
Na dobrú náladu im veselo vyhrávali muzikanti .	muzikanti	6	Anim
Výlet konfirmandov I . ročníka na Kráľovu hoľu 19 . 6 . 2004	konfirmandov	1	Anim
“ O tigrovi z hviezd .	tigrovi	2	Anim
V utorok píšeme test z astronómie .	utorok	1	Inan
Z toho človeka nevravel mozog , ale hrtan .	hrtan	7	Inan
S kŕdľami strák , ktoré poletovali po pustom parku pri Domove dôstojníkov .	kŕdľami	1	Inan
Unaveným krokom som vyšiel po schodoch nášho domu .	krokom	1	Inan
Si euroázijský špión !	špión	2	Anim
Ruky ma zúfalo boleli a na krátky , ale nepríjemný okamih som nadobudla dojem , že spadnem na nesprávnu stranu .	okamih	10	Inan
PREČ S VEĽKÝM BRATOM !	BRATOM	3	Anim
Sankcia teda obsahuje v sebe ako hľadisko trestné , tak aj hľadisko náhrady škody pozostalým .	pozostalým	14	Anim
Malo sukničku z makových lupienkov a usmievalo sa .	lupienkov	4	Inan
Budúcnosť patrí proletom .	proletom	2	Anim
V Studiofilme sa povrávalo , že šéfa čochvíľa odvolajú ; označovali ho za liberálneho modernistu a bolo iróniou osudu , že najostrejšie na neho útočil týždenník Október .	modernistu	14	Anim
" Len preto , že uprednostňujem klad pred záporom .	záporom	8	Inan
Bol symbolom dažďa a jeho životodarnej , plodivej sily .	dažďa	2	Inan
Vznik a charakter štatútu .	Vznik	0	Inan
Predavači tu núkali všeličo od výmyslu sveta — mosadzný riad , sladké datle i čerstvé ryby .	Predavači	0	Anim
Položil som pohár na stôl a išiel som otvoriť .	pohár	2	Inan
Mestské zastupiteľstvo schválilo umiestnenie menších sôch šiestich patrónov Európy na Nádvorie Európy , ktoré je vo výstavbe .	patrónov	7	Anim
Takého odporného tvora ešte nevidela .	tvora	2	Anim
Mal pocit , že ho v žalúdku páli oheň .	oheň	8	Inan
O chvíľu sa pri nej s hlasným bzučaním usadil komár .	komár	9	Anim
Plukovník Hatí zúril .	Plukovník	0	Anim
“ Ocko ! “ zvolala Ariela .	Ocko	1	Anim
Iba na začiatku textu zbierky je akýsi tematický zoznam , pri jednotlivých častiach ktorého sú uvedené čísla „ kánonov ” , vzťahujúcich sa k tomu - ktorému tematickému okruhu .	okruhu	28	Inan
Bez vyzvania im čašník priniesol ďalšie poháriky s džinom .	poháriky	6	Inan
Vláda pripraví stratégiu riadenia štátneho dlhu , ktorej realizáciou príde k zníženiu nákladov štátneho rozpočtu .	nákladov	12	Inan
Vláda podporí rozvoj základného a aplikovaného výskumu na vysokých školách ako nevyhnutnej podmienky na poskytovanie kvalitného vysokoškolského vzdelávania a na zabezpečenie dlhodobo udržateľného rozvoja spoločnosti .	rozvoja	23	Inan
Aktom spojenia sa s takouto bytosťou sa šaman vlastne dostáva na úroveň božských tvorcov .	tvorcov	13	Anim
Za jeho stiahnutými mihalnicami sa pohyboval celý les prstov v akomsi tanci , vykrúcal sa a skrúcal , strácal sa jeden za druhým a znova sa objavoval .	prstov	8	Inan
Generál zreval : “ Bojujte ako levy ! “	levy	6	Inan
Dobrovoľníci z rôznych organizácií pripravili bohatý program : divadelné , umelecké a hudobné dielne aj súťaže .	Dobrovoľníci	0	Anim
V ten deň som zaplávala osobný rekord .	rekord	6	Inan
Súčasnému vedúcemu katery doc . M . Danišovi patrí okrem toho aj moje srdečné poďakovanie za vytrvalú a všestrannú podporu pri vydaní tejto knihy .	vedúcemu	1	Anim
Koniec slova zanikol v záchvate bolesti .	záchvate	4	Inan
“ Prekvapil ma Tayerleho pokus o humor .	humor	6	Inan
Veľký panter pozorne nastražil uši .	panter	1	Anim
Podľa iných to bol hadži Qamil .	hadži	4	Anim
“ Pomôžem ti , “ povedala Chris , keď som sa snažila udržať rovnováhu na okennom parapete .	parapete	16	Inan
Niekedy sa objavovali obyvatelia Čarodejníckej vily , všetkých som poznala a vedela som , aký bol osud každého z nich .	osud	16	Inan
A mne sa zdá , že aj mamu prehltol akýsi had .	had	10	Anim
Polovicu zo všetkého , čo vo mne je , mám z domu , z toho , čo sa doma povedalo , napríklad pri stole .	domu	11	Inan
Ale aj hlupáci a blbci vedia na seba vziať rôznu podobu .	blbci	4	Anim
Myšlienka , že sa môžem stať otrokom svojich postáv , mi naháňala hrôzu .	otrokom	6	Anim
Občas sa niekto chabo a dosť bezvýsledne pokúsil sfúknuť dvadsaťcentimetrové plamene .	plamene	10	Inan
Drúk s newyorskou čiapkou , ktorý prišiel na túto svetovú križovatku , aby sa tu vymočil .	Drúk	0	Anim
So zlovestným úškľabkom na tvári Uršuľa chrlila na Arielu hromy ‐ blesky .	hromy	9	Inan
Mala som pocit bezpečia a veľmi sa mi to páčilo .	pocit	2	Inan
V prípade , ak si poslanci odsúhlasia platených sekretárov , môže sa stať , že " Ringom Čechom " budú poslanci a efekt bude mať sekretár .	poslanci	5	Anim
Hlúpa tvár pod svetlými vlasmi ho vítala s rozžiareným úsmevom .	úsmevom	9	Inan
Kláštory a ich opáti sú tu podriadení diecéznym biskupom , ktorých povinnosťou je kláštory často vizitovať .	opáti	3	Anim
Pred niekoľkými rokmi tam bol iba parčík .	parčík	6	Inan
Vyzývateľom bol Vilko .	Vyzývateľom	0	Anim
Celý personál ministerstva postupoval rovnako .	personál	1	Inan
Lúčny koník Flip	koník	1	Anim
Postupne sa k nemu pridávali všetci dedinčania .	dedinčania	6	Anim
Prvý knokdaun som zakúsil na nádvorí .	knokdaun	1	Inan
Správa a privatizácia národného majetku	majetku	4	Inan
Podpredsedom pre ekonomiku je V . Oberhauser .	Podpredsedom	0	Anim
Ich vedúca im čosi nahlas rozprávala v ich jazyku .	jazyku	8	Inan
Z Pobaltia pochádzajú náušnice podľa tvaru zvané vlčí zub .	tvaru	5	Inan
Princ Omar je z veľmi vznešenej rodiny .	Princ	0	Anim
Páni , oslovil som ich a pokúšal som sa pôsobiť rozvážne .	Páni	0	Anim
Moji priatelia dúfali , že sudcovia a Lienka sfúknu zvyšok a ja nebudem potrestaný .	sudcovia	5	Anim
V domčeku si odpočiniem .	domčeku	1	Inan
Môj mozog by na to asi nestačil .	mozog	1	Inan
Mal dlhý kabát , zdvihnutý golier , okuliare so strieborným rámom , červenastú tvár a husté šedivé vlasy .	rámom	10	Inan
Pod gaštanom stálo niekoľko stolov a stoličiek a za živým plotom presvitala tehlová budova hostinca .	plotom	10	Inan
Keď boli sviatky , chodil z domu do domu a oznamoval ľuďom , že majú ísť na mítingy .	domu	8	Inan
Ale ten namyslený chvastúň nemá nijaké sérum proti hadiemu jedu .	chvastúň	3	Anim
“ Chodí spať ako slniečko , “ povzdychol si motýľ Emanuel .	motýľ	9	Anim
Toto ministerstvo však nemuselo uspokojovať mnohoraké potreby straníkov , ale opakovať celú operáciu na nižšej úrovni pre blaho proletariátu .	straníkov	7	Anim
V ich národnom epose Kalevala nájdeme napr . starobylý výklad o pôvode sveta z vajca .	pôvode	11	Inan
ZLÁ VÍLA NETRPEZLIVO ČAKALA NA ZÁPAD SLNKA vo vlhkých tmavých rozvalinách kamenného hradu , ktorý stál na vysokom brale .	hradu	12	Inan
V tej chvíli tréner Augustus zapískal , čím dal znamenie , že dráhy treba uvoľniť na tréning .	tréner	3	Anim
Slovo „ drúk “ malo tentoraz ničivý účinok .	drúk	2	Anim
A predsa , po prečítaní vedel , že nie je blázon .	blázon	10	Anim
Posledný szabolcsský kánon , ktorý sa venuje kláštornému životu nariaďuje opátom a mníchom , aby sa nezúčastňovali na kalendových sedeniach , ale aby prijímali oblácie ich účastníkov v kláštoroch .	kánon	2	Inan
Otočila som sa a medzi divákmi som zazrela Jilliných rodičov .	rodičov	9	Anim
Faika si nič nevšimla a nevmietla mi do tváre nijaký prívlastok .	prívlastok	10	Inan
Vraj pri takých veľkonočných oblievačkách chlapci najviac a najčastejšie oblievali najkrajšie dievčatá z dediny .	chlapci	5	Anim
Zajac mohol byť vykladaný v systéme predkresťanských názorov jednak ako symbol plodnosti / dodnes spájame na veľkú noc vyobrazenia zajacov s vajíčkami , Nemci počas tohto sviatku hľadajú v záhrade vajíčka ukryté veľkonočným zajacom / .	zajacom	33	Anim
“ Toto hľadáš ? “ spýtal sa s úsmevom , keď sa po chvíli vynoril aj s kľúčikom .	úsmevom	8	Inan
Robili taký rámus , že sa ich rev ozýval široko ‐ ďaleko po celej džungli .	rámus	2	Inan
V prípade , ak si poslanci odsúhlasia platených sekretárov , môže sa stať , že " Ringom Čechom " budú poslanci a efekt bude mať sekretár .	poslanci	20	Anim
Ak muža s tvárou umrlca odviedli o polnoci , bolo ráno , ak ráno , bolo popoludnie .	muža	1	Anim
Zadnými nohami držal pavúka v šachu a prednými trhal sieť okolo napoly zadusenej Maji .	pavúka	3	Anim
" Si posledný človek , " poznamenal O ' Brien . " Si ochranca ľudského ducha .	ochranca	13	Anim
Dieťa spokojne ležalo a nič nenaznačovalo , že sa vlci chystajú vyjsť z jaskyne .	vlci	9	Anim
Rovnakú spoluprácu so svetským sudcom predpokladajú v citovaných ustanoveniach aj sledované súdobé cirkevnoprávne príručky .	sudcom	4	Anim
Ako sprievodcovia do podsvetia Samojedov slúžia napr . hranostaj a myš .	hranostaj	8	Anim
Iná obsahová náplň priláka nový typ čitateľov , to je jasné .	typ	5	Inan
Okrem poviedky Sexuálny nenásytník som dal Soni aj ďalšie texty tohto druhu .	druhu	11	Inan
Poďakovanie patrí aj posudzovateľom rukopisu – pánovi prof . PhDr . Richardovi Marsinovi , DrSc . a pánovi PhDr . Jánovi Steinhübelovi , CSc . , ktorí mi pomohli vylepšiť text svojimi cennými postrehmi .	text	30	Inan
Jeho kláštor musel mať dobrú povesť , lebo ako lotrinský vojvoda , tak aj flámsky markgróf mu odovzdali viaceré kláštory , aby v nich obnovil rehoľný život podľa reformných princípov .	princípov	29	Inan
Keď sa chrobák zjavil znovu , vyzeral namrzene a hodil na zem kúsok medu .	kúsok	12	Inan
Nasledujúci text je silne poškodený .	text	1	Inan
Restaurant Dynamo - Pštrossova 220 / 29 , Praha 1 , telefón 294224 .	telefón	11	Inan
Bolo to mnoho týždňov sexuálneho nepokoja .	nepokoja	5	Inan
Kolega mi porozprával o tejto epizóde práve v čase , keď moja mama dostala ten slávny list .	Kolega	0	Anim
Radža vždy odhadne charakter človeka .	človeka	4	Anim
Účastníci jedného letu stratili smer .	smer	4	Inan
Každý pokus o systematizáciu tejto otázky totiž nevyhnutne naráža na kolíziu metódy vedeckého prístupu s rozumovo nedefinovateľným fenoménom náboženstva a viery .	prístupu	13	Inan
“ I mne sa raz snívalo , že budem učiť najväčšieho hrdinu všetkých čias , “ vyhlásil Fil .	hrdinu	11	Anim
Voš žijúca v lone vystúpi nahor , na krk , voš z vlasov sa spustí dolu , na líce .	krk	8	Inan
Nazvem ho incidentom s bláznami .	bláznami	4	Anim
Domáci pán mal zlatý oblek s čiernymi pásikmi .	pán	1	Anim
Boli tam mravce , lykožrút Fridolín s Buchtou , aj rodinka ploštíc .	lykožrút	4	Anim
Ten šíp bohu patrí	bohu	2	Anim
Pod ním bola na fotografii Cruellina priateľka Anita , jej manžel Roger a ich kuchárka .	manžel	10	Anim
Vzápätí za ním s krikom vybehla i Bibina slúžka : “ Zastavte ho .	krikom	4	Inan
Winston zdvihol šálku džinu , chvíľku naberal odvahu a potom obrátil do seba to tekuté svinstvo , ktoré malo pachuť oleja .	džinu	3	Inan
“ Ako to myslíš ? “ zaujímal sa škriatok .	škriatok	8	Anim
Ako sprievodcovia do podsvetia Samojedov slúžia napr . hranostaj a myš .	sprievodcovia	1	Anim
Pôvodný text sa však nezachoval .	text	1	Inan
Nestoja totiž v opozícií voči sebe na rovine ideí a ideológie , ale voči zástupcom orgánov svetských .	zástupcom	14	Anim
Maja vyskočila a urobila zopár drepov .	drepov	5	Inan
Technologické spracovanie vychádza z ľahkého špeciálneho penového plastu s otvorenými pórmi , ktorý je uzatvorený vo vzduchotesnom obale .	pórmi	10	Inan
Preskúmal jej dlhé prsty , pekne vytvarované nechty , dlaň zatvrdnutú ťažkou prácou s množstvom mozoľov , hladkú pokožku pod zápästím .	prsty	3	Inan
V prípade , že z manželstva nevzišli deti , Strana nepovoľovala rozvod , zato podporovala odlúčenie .	rozvod	11	Inan
Dotyčný sa zaceril .	Dotyčný	0	Anim
Len čo vošiel dnu , čakali ho tam Kráľovná zla a jej sluhovia .	sluhovia	12	Anim
“ Dúfal som , že ťa tu nájdem , “ povedal a zosadol z bicykla .	bicykla	14	Inan
Buď som nečakal , že mi do toho zasiahne , alebo mal vo svojom výzore i držaní tela stále čosi neprirodzené , čo ma znepokojovalo a zároveň uvádzalo do rozpakov .	výzore	14	Inan
Cvrček pokračoval v hre na svojom krídle .	Cvrček	0	Anim
Od straníkov sa vyžadoval podobný názor , aký mali starovekí Židia , ktorí síce vedeli , že všetky iné národy uctievajú nepravých bohov , ale to bolo všetko , čo o nich vedeli .	bohov	22	Anim
Vtedy bol ôsmak a ja štvrtáčka .	ôsmak	2	Anim
Cieľom reformy poistenia v nezamestnanosti bude posilnenie princípu zásluhovosti ( poistného princípu ) a princípu osobnej zodpovednosti občana za vlastnú pracovnú a sociálnu situáciu .	princípu	7	Inan
V džungli by ste nenašli šťastnejšieho tvora .	tvora	6	Anim
S pocitom prihlúpleho vidiečana som prešiel po asfaltovej ceste , ktorá viedla k zhluku novopostavených budov .	vidiečana	3	Anim
Keď sme asi hodinu kráčali po ceste pre vozy , mama odbočovala ku kravínom a ja som išla ďalej do školy .	vozy	8	Inan
" My však na všetkých stupňoch život ovládame , Winston .	stupňoch	5	Inan
Skvelý psychológ , vyvolávač hrôzy , zaklínač šialenstva .	zaklínač	6	Anim
Volám sa ľan .	ľan	2	Inan
V tom istom fascikli som mal odložené aj ďalšie texty , ktoré som neskôr zoskupil do samostatného fascikla .	fascikli	3	Inan
Obra Jumba všetci oslavovali a vymenovali za čestného občana Makovej lúky .	občana	8	Anim
Ferdo a koník Chuchlík	koník	2	Anim
Tušil , že za nimi sa skrýva brloh zvieraťa .	brloh	7	Inan
Ani kolegovia .	kolegovia	1	Anim
Poďakovanie patrí aj posudzovateľom rukopisu – pánovi prof . PhDr . Richardovi Marsinovi , DrSc . a pánovi PhDr . Jánovi Steinhübelovi , CSc . , ktorí mi pomohli vylepšiť text svojimi cennými postrehmi .	pánovi	17	Anim
Zaťal zuby .	zuby	1	Inan
Tá za desaťročia sústredeného výskumu vyprodukovala stovky monografických a časopiseckých spracovaní danej témy .	výskumu	4	Inan
Kývol na sluhu a niečo mu zašepkal .	sluhu	2	Anim
Približovala sa k nemu zohnutá , popolavo sivá postava , ktorá pripomínala kostlivca .	kostlivca	12	Anim
Profesor Eugen Jóna , ktorý sa dejinami spisovnej slovenčiny dlhé roky zaoberal , si uvedomil potrebu dať do rúk slovenskej i medzinárodnej vedeckej verejnosti dostatočne prístupný skutočný text tohto základného diela .	text	27	Inan
Buď som nečakal , že mi do toho zasiahne , alebo mal vo svojom výzore i držaní tela stále čosi neprirodzené , čo ma znepokojovalo a zároveň uvádzalo do rozpakov .	rozpakov	29	Inan
Aby som sa definitívne vrátil do reality , na prvom poschodí výťah zastal .	výťah	11	Inan
Chlapec mu prebehol prstom po hrdle .	prstom	3	Inan
Pri rešpektovaní špecifík poľnohospodárskej výroby vláda bude podporovať rozvoj voľného trhu s agropotravinovými výrobkami a slobodnú konkurenciu v poľnohospodárskom podnikaní .	trhu	10	Inan
Zároveň však Cluny urobilo veľký krok na ceste k libertas , lebo vytvorilo spoločenstvo ( zväčša ) úplne slobodných kláštorov , ktoré nepodliehali laikom .	kláštorov	19	Inan
Sporenie prostredníctvom individuálnych účtov vytvorí priestor , aby v budúcnosti o čase svojho odchodu do dôchodku mohol rozhodovať sám občan .	občan	19	Anim
Mauglí veselo poskakoval vedľa medveďa .	medveďa	4	Anim
Spolu s ním bývala v tom istom byte aj rodina s troma veľkými mládencami .	mládencami	13	Anim
“ Maj sa , princ Ali Abubu ! “ kričal za ním Džafar .	princ	4	Anim
V 19 . storočí dochádza v Bengálsku k úpadku feudalizmu .	úpadku	8	Inan
Chlapci sa smiali , keď mocný pirát napol svaly na ruke , až sa mu na ramene zachvel vytetovaný pirátsky znak ‐ lebka so skríženými hnátmi .	pirát	6	Anim
Takže : ĽUDSKÝ PRST	PRST	3	Inan
Aj Maja so škriatkom opustili topoľ a leteli , kým nedoleteli k domu , kde sa v oknách ešte svietilo .	škriatkom	3	Anim
V prípade , že klerik žaluje laika , má sa spor prerokovať pred svetským sudcom .	klerik	4	Anim
Bol mučiteľ , bol ochranca , bol inkvizítor , bol priateľ .	mučiteľ	1	Anim
V každom prípade aj text jeho úvodu dal Doležalovej gramatike punc najautoritatívnejšieho zdroja poznania vtedajšieho spisovného jazyka Čechov i Slovákov .	úvodu	6	Inan
Balú sa napokon predsa len so špľachotom vynoril .	špľachotom	6	Inan
Iba sa trochu sklonila , odkryla deku a ja som uvidel tvár spiaceho človiečika , ktorý nemal takmer nijaké vlasy .	vlasy	19	Inan
Vlak sa šinul svojou slimačou pomalosťou .	Vlak	0	Inan
Smutné včielky sedeli pri raňakjách , na stole chýbal tanier s medom .	tanier	9	Inan
Znehybnel som , ležiac na boku : to vzlykala Marga .	boku	5	Inan
Protiprávna vojna v Iraku , ktorú rozpútala nesvätá aliancia náboženských fundamentalistov , megalománov a kšeftárov , je cynickým výsmechom všetkých hodnôt , ktoré naša západná civilizácia pokladá za nedotknuteľné .	megalománov	12	Anim
Najprv sa Radžu ukrutne bojíš a len čo odídem , ste najlepší priatelia .	priatelia	12	Anim
V podobnom duchu sa vyjadrovali aj prezident KOZ Ivan Saktor a jeho kolega Svetozár Korbel .	kolega	12	Anim
Džin ho každý večer otupoval a džin ho každé ráno znovu oživoval .	Džin	0	Inan
I . ostrihomská synoda nariaďuje , že únosca je povinný poskytnúť postihnutým majetkovú kompenzáciu a navyše má vykonať aj pokánie .	únosca	7	Anim
Švihák Pedro sa v letku obrátil a zmizol kdesi v diaľke .	Švihák	0	Anim
Založil ho Vladimír Monomach medzi rokmi 1098 a 1103 ako kniežací zámok na sútoku riek Kľazmy a Nerli .	rokmi	5	Inan
“ Ty podlý zradca ! “	zradca	3	Anim
Pohrebná trúba stále vyhrávala v ktoromsi kúte prázdneho priestoru môjho mozgu .	kúte	6	Inan
Ordinácia je akt , ktorým kandidát svätenia ( ordinand ) získava istý stupeň svätenia .	kandidát	5	Anim
Keď vystúpila z pásma žltkastého svitu a na chvíľu zastala na rozhraní medzi svetlom a temnotou , nemyslel som na to , že ide priamo ku mne , aby napravila chybnú interpretáciu vecí , ktorú vyprodukoval môj mozog .	mozog	37	Inan
Kapitoly vytvoria protiváhu hlboko miestne ukotveného archeologicko ‐ historického prehľadu a predkladajú nový zorný uhol na skúmanú tému .	prehľadu	9	Inan
Milí konfirmandi , dnes sa stanete dospelými členmi nášho cirkevného zboru .	konfirmandi	1	Anim
“ No , dovoľte ! “ zvolal chrobák a ukázal svaly .	chrobák	7	Anim
Poď so mnou do Petrohradu namiesto mojich rodičov .	rodičov	7	Anim
Individualista , vzbúrenec , latentný terorista .	terorista	5	Anim
Celý týždeň som bol náchylný uveriť , že to všetko bol iba sen .	týždeň	1	Inan
Zbierka uvádza pravé i nepravé dekretály viacerých pápežov , ako aj početné dokumenty pojednávajúce o výnimočných právach rímskeho biskupa .	dokumenty	12	Inan
Takže ak sa myšlienky zorganizovať rockový festival chytí skúsenejší organizátor , veríme , že festival , ktorému je dedina a ľudia v nej naklonení , sa bude znova konať .	organizátor	9	Anim
Prirodzeným dôsledkom takéhoto stretu je rozbíjanie vervi a úsilie o znevoľnenie smerdov .	smerdov	11	Anim
Z jedného na mňa upierala zrak Dolora .	zrak	5	Inan
Bol to fantastický pocit .	pocit	3	Inan
Práve vtedy tréner August zapískal .	tréner	2	Anim
" Nezmysel .	Nezmysel	1	Inan
Keď ju môj brat zbadal , od úzkosti div nezomrel .	brat	3	Anim
“ Dnes určite stretnem človeka ! “ volala naradostene .	človeka	4	Anim
Prsty sa jej skrivili a nechty sa premenili na zahnuté pazúriská .	nechty	5	Inan
Prašiví tuláci .	tuláci	1	Anim
V ten večer sa v paláci zhromaždili všetci dvorania , keď princezná Zornička tancovala s princom Filipom .	dvorania	8	Anim
Chcel som povedať tým civilistom , aby mi aspoň vysvetlili , čo odo mňa chcú .	civilistom	4	Anim
Sneh trval na tom , že musím zostať v tejto pasci .	Sneh	0	Inan
Otvoril mešec a zacinkal .	mešec	1	Inan
Chrobák Truhlík sa uzdravil a Lienka Ferdovi odpustila .	Chrobák	0	Anim
Odpovedala na môj dotyk .	dotyk	3	Inan
“ Pravdaže , poklad môj , “ odvetila mamička .	poklad	3	Inan
Ondrej Koč , zborový farár	farár	4	Anim
Ten koník za mnou naskutku priklusal .	koník	1	Anim
Hltači mečov súperili s predavačmi šperkov o jej pozornosť .	Hltači	0	Anim
Každá od neho však utiekla , pretože len čo otvoril ústa , ovalil ich zápach cesnaku a syra .	cesnaku	15	Inan
Pustil Winstona a zároveň ho postrčil dozorcom .	dozorcom	6	Anim
Ku koncu svojho života ( zomrel r . 1956 ) pôsobil ako predseda tejto organizácie .	predseda	12	Anim
“ To je nuda , “ nadhodil pán Sekáč .	pán	7	Anim
Jednostaj prichádzali a odchádzali všakovakí väzni : distribútori drog , zlodeji , banditi , šmelinári , opilci , prostitútky .	banditi	12	Anim
Ja som tropický motýľ !	motýľ	3	Anim
Od toho času neznášam zvonenie budíka .	budíka	5	Inan
Akýsi drevorubač sa vraj musel počas jednej zimnej noci vrátiť domov .	drevorubač	1	Anim
Zakrátko si Makulienka obliekala novú sukničku s volánikmi a motýľ Emanuel frak s dlhými krídlami .	motýľ	9	Anim
Zúčastnili sa jej aj chovanci ústavu .	chovanci	4	Anim
Siahol mu do vrecka na šatách a keď vytiahol ruku , mal na dlani veľký červený rubín .	rubín	16	Inan
Boj pavúka Hanibala s ľuďmi	Boj	0	Inan
Vláda upraví rámcové podmienky regionálneho rozvoja decentralizáciou verejných financií a zavedie nový , efektívnejší systém finančného vyrovnávania sociálno - ekonomických rozdielov vyšších územných celkov .	celkov	23	Inan
Trh určuje našu cenu .	Trh	0	Inan
Piráti alebo cez palubu !	Piráti	0	Anim
Brat kantor pre vážne osobné dôvody nemohol prísť , preto brat farár sprevádzal nábožný spev na gitare spolu s mládežníkmi , ktorí poslúžili programom a vystúpili aj s osobným vyznaním .	brat	10	Anim
o sny ten môj prečudesný milý .	milý	5	Anim
Účastníci jedného letu stratili smer .	Účastníci	0	Anim
Večer sa zakutral pod perinu a sníval o akrobatoch .	akrobatoch	8	Anim
Nálezy pečatí umožňujú určiť autorstvo , pravosť a čas vzniku dokumentu , dopĺňajú tak informácie o ňom .	dokumentu	10	Inan
Spoločne mu ukázali upravené domčeky i podzemné chodby .	domčeky	4	Inan
Muži zo sprievodu to jednohlasne odobrili .	sprievodu	2	Inan
Smutným hlasom im Kasandra oznámila , že v noci navšítvili komoru s medom zlodeji a spôsobili im veľkú škodu .	zlodeji	13	Anim
Neviditeľní jazdci na koňoch sú vyjadrením predstavy o zlých duchoch , schopných ubližovať človeku odnesením jeho duše do podsvetia .	koňoch	3	Inan
Vzniknutý kódex sa stáva základom tzv . Krátkej redakcie pravdy / kým kódex , vzniknutý roku 1037 v Kyjeve sa stáva základom pravdy priestrannej / .	základom	21	Inan
“ Koniec !	Koniec	1	Inan
Nastolíme po voľbách zmenu - odhalením zbohatlíkov , mafiánov , delikventov , korupčníkov a lobistov pri stálom sledovaní blaha občana .	zbohatlíkov	6	Anim
Vzhľadom na dôležitosť kvality verejných zamestnancov a význam osobných nákladov vláda bude pokračovať v reforme verejnej a štátnej služby .	Vzhľadom	0	Inan
U ugrofínskych národov fungoval orol ako predok a ochranca šamanov .	šamanov	9	Anim
Vláda v spolupráci s predstaviteľmi územnej samosprávy vytvorí transparentný inštitucionálny a finančný návrh na kofinancovanie regionálneho rozvoja z prostriedkov štátneho rozpočtu a z fondov EÚ .	predstaviteľmi	4	Anim
A nasledoval vzlykot .	vzlykot	2	Inan
Kto ti povedal , že si starec ?	starec	6	Anim
Medzi hereckými kandidátmi sú Humphrey Bogart , Sidney Poitier , Kirk Douglas , Harold Lloyd , Sir Laurence Olivier a John Belushi .	Sir	16	Anim
Na prvý pohľad je tu zrejmá podobnosť so znením kánonov , ktoré sa týkajú rehoľníkov .	kánonov	9	Inan
Nebol to dobrý nápad .	nápad	3	Inan
Vlani získal toto ocenenie režisér Stanley Donen .	režisér	4	Anim
Ohrozené boli mestá Brazzaville a Leopoldville . Človek sa nepotreboval pozrieť na mapu , aby vedel , čo to znamená .	Človek	7	Anim
Tarzan skočil vrčiac ako leopard a vyrušil rodinu .	leopard	4	Anim
“ Čo sa s tebou deje , Amy ? “ vypytoval sa ma po pretekoch tréner August a odviedol ma nabok , kým ostatní nastupovali do autobusu .	autobusu	26	Inan
Maja zaviedla hostí na slávnostne vyzdobenú lúku a ponúkla im vyhliadkový let s vážkou , medové guľôčky , cukrovú vatu a mnoho iných dobrôt .	let	11	Inan
Ja som uložil mladým batožinu do taxíka a nasadol som doň .	taxíka	6	Inan
“ Kto je tvoj ocino ? “ spýtal sa Mauglí .	ocino	4	Anim
Zažal fakľu a vysadol na koňa .	koňa	5	Anim
Hra na hudobné nástroje , vozy ako prostriedok na prekonávanie vzdialeností by mohli svedčiť i o narážke na potulných hudcov ‐ igricov , ktorí sú chápaní v celoeurópskom kontexte ako elementy , rušiace zabehaný poriadok .	nástroje	3	Inan
Okolo nás pulzovala noc a ozývali sa známe zvuky okolia : tlmený hukot čerpadiel v okolitých bazénoch .	zvuky	8	Inan
Odložil som pohár a očami som opäť zablúdil k protiľahlým stolom , pri ktorých sedeli spomínaní ľudia .	pohár	2	Inan
Trávniky sa premenia na oceány bahna a autá uviaznu pred domami .	Trávniky	0	Inan
Tak u mnohých národov existujú tzv . bieli šamani , spájaní s nebeskými silami a svetom hore a šamani čierni , zviazaní s podsvetím .	šamani	18	Anim
Buď to spôsobil príval jej vďačnosti , alebo slovo „ ujo “ , ktoré vyslovila s akousi sexuálnou dôvernosťou .	ujo	10	Anim
Zaznel zvonec a všetko stíchlo .	zvonec	1	Inan
Príčiny svojich neúspechov musí človek hľadať vo vlastnom vnútri a ja som tak robil .	neúspechov	2	Inan
Tu ide vlastne len o zhutnené zopakovanie už citovaného Kolomanovho zákona , teda opäť o určenie prvostupňového odvolacieho súdu .	súdu	18	Inan
Z politického hľadiska Koloman pápežovi vyhovel .	pápežovi	4	Anim
“ Nedopustíme predsa , aby utiekli a varovali netvora , “ povedal ľuďom .	netvora	8	Anim
Medzi pretekármi pravdaže nchýbal ani Flip , ktorý mal v hľadisku spústu fanúšikov .	pretekármi	1	Anim
Naučil ju i zopár tónov a zakrátko už Jazmína zabávala hostí jednoduchou melódiou .	tónov	4	Inan
Súčasťou návrhu bude aj kontrolný a monitorovací mechanizmus efektívneho využívania nástrojov podpory regionálneho rozvoja .	rozvoja	13	Inan
Grifony zapriahnuté v nebeských záprahoch božstiev fungovali ako zjednotitelia neba a zeme .	zjednotitelia	8	Anim
Winstona sa opäť zmocnil pocit bezmocnosti .	pocit	4	Inan
“ Viete čo ? “ povedal Ferdo kamarátom .	kamarátom	7	Anim
Nadovšetko túžil po krajci chleba .	chleba	4	Inan
Mravce dovliekli celý kôš dobrôt , včielky priniesli ovocný medovník a Kasandra jazmínové želé .	kôš	3	Inan
Škole chýbali priestory , a tak žiaci prvého stupňa , čiže aj my prváčikovia , mávali vyučovanie popoludní .	priestory	2	Inan
Ženy a deti sledovali z úkrytu , ako sa muži skrývajú za Jumbom .	muži	9	Anim
V jednom rohu podložky je ventil , po jeho otvorení pena nasáva vzduch , nafukuje sa .	ventil	5	Inan
Práve vtedy vošiel ráznym krokom guľatý pánko so špicatou briadkou .	pánko	6	Anim
“ Som včela , pane ! “ zvolala výhražne .	pane	4	Anim
Telový gel , šampón ?	šampón	3	Inan
“ Človek nikdy nevie , čo ako vypáli . “	Človek	1	Anim
Amulet teda posilňuje určité črty jeho charakteru do neobvyklých až nadprirodzených polôh , Vseslav sa stáva vyvolencom — podľa kresťanského kronikára — temných síl .	vyvolencom	16	Anim
“ Má ťažký otras mozgu , “ určila sestra diagnózu .	mozgu	4	Inan
Keď sa začal semester , pustil som sa pod vedením profesora SommerfelTa do čítania textov .	profesora	10	Anim
Slniečko hrialo , ľan schol a krtko zaspal .	krtko	6	Anim
Takého neposedného spoločníka ešte nestretla .	spoločníka	2	Anim
“ Páliš ? “ spýtal sa opatrne bodliak .	bodliak	7	Inan
So zlovestným úškľabkom na tvári Uršuľa chrlila na Arielu hromy ‐ blesky .	blesky	11	Inan
“ Toto hľadáš ? “ spýtal sa s úsmevom , keď sa po chvíli vynoril aj s kľúčikom .	kľúčikom	17	Inan
Zaburácal silný výbuch , ktorý akoby zodvihol vydláždený chodník ; na chrbát mu dopadla spŕška ľahkých predmetov .	predmetov	16	Inan
V podobnom duchu sa vyjadrovali aj prezident KOZ Ivan Saktor a jeho kolega Svetozár Korbel .	duchu	2	Anim
Medzi tieto nedovolené zamestnania patrilo i krčmárstvo , ktorého vykonávanie zakázali aj ostrihomskí synodálni otcovia .	otcovia	14	Anim
V lese som krok za krôčikom snoril pod krami a pod kameňmi .	lese	1	Inan
Bolo by hanba predstúpiť pred žiakov v takom stave .	žiakov	5	Anim
Na jej mieste bol postavený chrám sv . Iľju .	chrám	5	Inan
Jednou z hlavných postáv eposu je mýtický kováč lllmarillen .	eposu	4	Inan
Odtrhol rožtek balíčka .	rožtek	1	Inan
Ženu zachráni traktorista .	traktorista	2	Anim
. . . MÔJ PRIMÁRNY ZÁUJEM BOLI HUMANIÓRA .	ZÁUJEM	5	Inan
Pôjde najmä o precíznejšiu personálnu prácu , efektívnejšie využitie ich vlastných kontrolných a inšpekčných mechanizmov , ale tiež o uplatňovanie nových špecifických protikorupčných postupov .	postupov	23	Inan
Na všeobecné počudovanie sa prihlásil leňoch Vilko .	leňoch	5	Anim
Boj pavúka Hanibala s ľuďmi	pavúka	1	Anim
Podľa princípu siedmich slobodných umení prvým stupňom trivia je gramatika .	princípu	1	Inan
Má pokojný , rozvážny hlas , dbá na každé slovo a tvári sa vážne .	hlas	4	Inan
Keďže som neprišiel na nič lepšie , sedel som celý deň vo svojej izbe a v duchu som si predstavoval , že som ušiel z domu .	domu	25	Inan
Cieľom reformy je zastaviť demograficky podmienené zvyšovanie vnútorného dlhu priebežne financovaného dôchodkového systému a zvýšiť zaangažovanosť občanov na svojej životnej úrovni v dôchodkovom veku .	dlhu	8	Inan
Má netradičnú grafickú podobu a svojimi malými rozmermi sa zmestí do každej tašky a ku každému počítaču .	rozmermi	7	Inan
Imidž nie je na nič .	Imidž	0	Inan
Toto pápežské privilégium bolo vlastne uznaním , že Cluny sú centrom okolo neho vytvorenej skupiny kláštorov , teda právnym podkladom existencie takéhoto spoločenstva rehoľných domov .	domov	24	Inan
Košičanov vítali v Trnave kamene	Košičanov	0	Anim
Na hlavnej stránke v pravom menu je ikona určená pre registráciu nového používateľa .	používateľa	12	Anim
Neviditeľní jazdci na koňoch sú vyjadrením predstavy o zlých duchoch , schopných ubližovať človeku odnesením jeho duše do podsvetia .	jazdci	1	Anim
Zatiaľ čo sa Chris profesora na všeličo vypytoval , Rick si pedantne zapisoval každé jeho slovo .	profesora	4	Anim
Tak u mnohých národov existujú tzv . bieli šamani , spájaní s nebeskými silami a svetom hore a šamani čierni , zviazaní s podsvetím .	svetom	15	Inan
Z nálezov nefigurálneho charakteru je zaujímavý nález troch hlinených kraslíc .	nález	6	Inan
Boli sme najedení až po krk , keď Rýchlik vyhlásil , že sa ide na tortilly , po ktorých Delfíni zaručene zvíťazia .	krk	5	Inan
“ Vy máte šťastie ! “ povedala mora Maji , lebo vedela , čo znamená stretnutie so škriatkom kvetov .	škriatkom	17	Anim
Lykožrút Fridolín potom odniesol víťaza medzi jasajúcich divákov .	divákov	7	Anim
Videl , ako Júlia zodvihla pohár a privoňala k nemu s úprimnou zvedavosťou .	pohár	5	Inan
Nápisy č . 39 , 40 , 41 sú sústredené okolo dvoch krížov .	Nápisy	0	Inan
Až na komára Bzuča .	komára	2	Anim
Chris je najrýchlejší plavec v Delfíne , ale rekord v prsiach doteraz neprekonal .	plavec	3	Anim
Vláda sa zaväzuje v praxi realizovať už schválenú dikciu Európskej charty regionálnych alebo menšinových jazykov .	jazykov	14	Inan
A komentovali ste tvoje veľdiela o sexuálnych nenásytníkoch .	nenásytníkoch	7	Anim
Trojzubec sa odchýlil iným smerom .	Trojzubec	0	Inan
A za tým obrazom v tieni stála kolíska .	obrazom	3	Inan
V našich chlievoch niet jedinej kravy .	chlievoch	2	Inan
Ordinácia je akt , ktorým kandidát svätenia ( ordinand ) získava istý stupeň svätenia .	ordinand	8	Anim
Mešťania sa nazlostili a upozornili Herkulovho otca , nech ho viac do mesta nepúšťa .	Mešťania	0	Anim
Na okraji Tirany , keď sme prechádzali cez predmestie Lapraka , uviazli sme na križovatke .	okraji	1	Inan
Keď Herkules vstúpil do Téb , pyšne vyhlásil , že on je ten hrdina , ktorého potrebujú .	hrdina	13	Anim
Bol to pochmúrny deň , oblaky viseli nízko , smerom k močiaru udierali blesky .	močiaru	11	Inan
Stalo sa to len včera večer a Rick sa určite pred chalanmi nevyťahoval , ako vlažne som ho odbila .	chalanmi	11	Anim
Maja sa rozhodla , že zaletí do chladného lesa , kde je ticho a tieň , aby mohla pokojne popremýšľať o všetkom , čo v noci zažila .	lesa	8	Inan
Ona ustúpila dozadu , otočila sa mu chrbtom , ale ten chlap zostal pri zástupe žien .	chlap	11	Anim
Každý zo stupňov svätenia od ordinanda vyžadoval , aby spĺňal príslušné predpoklady na jeho získanie .	ordinanda	5	Anim
Nález železného kľúča od visiaceho zámku mohol súvisieť s už spomenutou ochrannou funkciou .	Nález	0	Inan
Potom tí muži začali vychádzať z izby a ja som sa vrátil do salóna .	muži	2	Anim
Podľa viery ugrofínskych Čuvašov výšivka konskej hlavy na ženskej hrudi chráni pred nebezpečím pôrodu .	pôrodu	13	Inan
Vláda bude zvyšovať prostriedky na vzdelávanie , aby sa postupne priblížili priemernej hodnote podielu z HDP v krajinách EÚ .	prostriedky	3	Inan
Duchovné osoby boli ideálnymi parlamenármi , lebo podľa dobových predstáv majú osobitnú ochranu boha pred nebezpečím .	boha	13	Anim
Keď som dokončil tento variant , zavrhol som ho .	variant	4	Inan
Pohrebná trúba stále vyhrávala v ktoromsi kúte prázdneho priestoru môjho mozgu .	priestoru	8	Inan
Kým sa malý Herkules hral s Pegasom , zjavil sa Hádes , boh podsvetia .	boh	12	Anim
Krtko prečesával ľan až z neho vyčesal jemné vlákna .	Krtko	0	Anim
“ Z nás sa nikdy nestanú piráti , “ hrdo vyhlásila Wendy .	piráti	6	Anim
Každá od neho však utiekla , pretože len čo otvoril ústa , ovalil ich zápach cesnaku a syra .	syra	17	Inan
Škriatok sa zasmial .	Škriatok	0	Anim
Delina by ma zaradila medzi šarlatánov .	šarlatánov	5	Anim
Z nálezov na Gorodišti sú zaujímavé predovšetkým miniatúrne toporčeky — amulety , známe zo Suzdaľa .	nálezov	1	Inan
Väčšina neskorších bádateľov sa uspokojila s jednoduchým reprodukovaním tohto zistenia .	bádateľov	2	Anim
Tradičnú retrospektívnu sekciu programovo každý rok napĺňajú filmy zástupcov jednotlivých krajín všetkých troch zúčastnených kinematografií .	zástupcov	8	Anim
M . N . Tichomirov fakt jednostranné vykladá len ako príčinu „ hladových vzbúr “ , Frojanov si všíma dôležitú okolnosť — volchovia sa zjavujú , aby zabezpečili blahobyt , hojnosť , úrodu .	blahobyt	28	Inan
Vláda prijme opatrenia na minimalizáciu možnosti vzniku korupcie a dopracuje systém kontroly zameraný na kontrolu použitia verejných prostriedkov , vrátane prostriedkov plynúcich z EÚ .	prostriedkov	17	Inan
Pomaly , sotva lapajúc dych , kráčali vpred .	dych	4	Inan
Ako vyzerá herec snov ?	herec	2	Anim
“ Odišla , “ povedal škriatok .	škriatok	5	Anim
“ Kamže sa ponáhľate , “ prehovoril pavúk .	pavúk	7	Anim
Na jeho základe sa bude financovať zdravotná starostlivosť nad rámec tzv . solidárneho balíka .	balíka	13	Inan
V Policajnom zbore sa zmení systém hodnotenia práce , ktorý bude akcentovať mieru spokojnosti občanov s činnosťou polície .	občanov	14	Anim
“ Neskáč ! “ kričali naňho ženy a deti a muži zatiaľ uzatvárali stávky .	muži	10	Anim
Muž bez brady spustil chlieb na podlahu .	Muž	0	Anim
Maja vedela , že blízko úľa je veľké mravenisko .	úľa	5	Inan
Vošla som do tichého bytu .	bytu	4	Inan
V dome im Bibi vysvetlila , čo dáva psíkom jesť a kde majú svoje misky .	psíkom	8	Anim
Diváci nahlas zhíkli .	Diváci	0	Anim
Priplietol sa tam iný blázon : Plné gate .	blázon	4	Anim
“ To tvrdí každý obžalovaný , “ odporoval sudca .	obžalovaný	4	Anim
Po rokom 1044 sa nachádza správa o narodení Vseslava , ktorému matka na radu volchvov uviazala amulet , spôsobiaci že z chlapca vyrástol krutý a nemilosrdný človek .	volchvov	14	Anim
Chudáčik nešťastný Pinocchio si v klietke bezmocne sadol .	Chudáčik	0	Anim
“ Začni na ostrove Idra , kde vyhľadáš Filokteta , učiteľa hrdinov . “	hrdinov	11	Anim
Druhá Doležalova inovácia je v gramatickom popise tohto jazyka .	popise	6	Inan
Jej centrom bol vŕšok , na ktorom sa zrejme nachádzalo hradisko .	vŕšok	3	Inan
Boli tu naukladané , akoby čakali na odvoz , a Ferdo na ne vyjavene hľadel .	odvoz	7	Inan
Ďakujem , “ odvetila som a vymanila si studené prsty spod jeho rúk .	prsty	9	Inan
Mala som dojem , že som sa vrátila z cesty okolo sveta .	sveta	11	Inan
Omar odvrátil zrak .	zrak	2	Inan
Smiala som sa , akoby sme boli len kamoši , ale keď som si sadla do auta vedľa Shannon , naskočili mi na ruke zimomriavky , keď sa ma Chris dotkol .	kamoši	8	Anim
Niekde blízko pri vás sa určite potuluje bezprizorná neter , synovec , sused či kolegyňa .	sused	12	Anim
Človek očakával , že ho zabijú .	Človek	0	Anim
Z toho človeka nevravel mozog , ale hrtan .	človeka	2	Anim
Jeho kláštor musel mať dobrú povesť , lebo ako lotrinský vojvoda , tak aj flámsky markgróf mu odovzdali viaceré kláštory , aby v nich obnovil rehoľný život podľa reformných princípov .	vojvoda	10	Anim
Články , zaujímavosti , recenzie .	Články	0	Inan
Okrem toho som mala zo seba hrozný pocit , pretože Rick sa len mierne knísal zboka nabok a meravo mi držal prsty .	pocit	7	Inan
Cieľom Strany nebolo len to , aby medzi mužmi a ženami nevznikali vzťahy vernosti , nad ktorými nemala moc .	mužmi	8	Anim
“ Pusti mi chvost , ty tupec , “ skríkol Šer Chán .	tupec	6	Anim
A za tým obrazom v tieni stála kolíska .	tieni	5	Inan
V úvode pasáže volchvi symbolizujú bielych šamanov , vysporiadávajúcich sa s čiernymi šamanmi .	volchvi	3	Anim
Stále v pohybe , akumulátor energie a nápadov .	nápadov	7	Inan
Kapsička na doklady	doklady	2	Inan
Vytvoríme kapitálotvornú vrstvu , ktorá bude zárukou blaha ľudu , presvedčivo hlásal tvorca blaha svojich prívržencov .	tvorca	12	Anim
Holeňový vred mu natreli hojivou masťou .	vred	1	Inan
Páčilo sa mu , že je kapitánom nášho tímu .	kapitánom	6	Anim
Za veľkými stolmi sedeli princovia a šľachtici .	stolmi	2	Inan
“ Vina je jednoznačne dokázaná ! “ vyhlásil predseda súdu .	súdu	9	Inan
V obrovských presýpacích hodinách princeznú Jazmínu zatiaľ zasypával piesok .	piesok	8	Inan
Už jej vzhľad mu naháňal hrôzu , a nielen vedomie , že je to on .	vzhľad	2	Inan
Raz dostali prídel čokolády .	prídel	2	Inan
Marga chcela , aby sme sa zaradili medzi korzujúcich .	korzujúcich	8	Anim
Odtiaľ som cez neveľké dvere , ktoré sme na noc zatvárali znútra hákom , vyšiel do dvora .	hákom	12	Inan
Napokon sme z kríkov vybrali Chrisov bicykel a pomaly sme vyšli na ulicu .	kríkov	3	Inan
Mal dlhý kabát , zdvihnutý golier , okuliare so strieborným rámom , červenastú tvár a husté šedivé vlasy .	kabát	2	Inan
Išli sme až k nášmu vchodu na zadnej strane domu a celou cestou sme mlčali .	domu	9	Inan
Fakt spomínaný oboma bádateľmi .	bádateľmi	3	Anim
Pri analýze skúmaného javu v práci sme použili viac vrstiev v úvode spomenutých prvkov .	úvode	11	Inan
To bola chvíľa druhého knokdaunu .	knokdaunu	4	Inan
Zasadanie otvoril a viedol predsedajúci zborový farár brat Bakalár .	farár	6	Anim
Keď sa napokon obzrela , škriatka už nebolo .	škriatka	5	Anim
Medzi hereckými kandidátmi sú Humphrey Bogart , Sidney Poitier , Kirk Douglas , Harold Lloyd , Sir Laurence Olivier a John Belushi .	kandidátmi	2	Anim
Rozhodol sa letieť za nimi a za trest , že naňho zabudli , vzal so sebou všetkých susedov .	susedov	17	Anim
Iskra podozrenia voči ošetrovateľovi , ktorá vo mne vzbĺkla , okamžite zhasla .	ošetrovateľovi	3	Anim
Hltači mečov súperili s predavačmi šperkov o jej pozornosť .	predavačmi	4	Anim
Bratovi farárovi prajeme v tejto funkcii múdrosť , vytrvalosť a Božie vedenie .	farárovi	1	Anim
Moji rovesníci sú momentálne na vrchole .	rovesníci	1	Anim
Vláda zabezpečí uvedenie nového registra obyvateľov do prevádzky .	registra	4	Inan
Zvíťazila som v najdôležitejších pretekoch .	pretekoch	4	Inan
Z Odilonovho listu Štefanovi I . sa dozvedáme , že clunyjský opát a prvý uhorský kráľ boli vo vzájomnom styku už pred odoslaním tohto listu vzniknuvšieho medzi rokmi 1031 – 1038 .	listu	24	Inan
Vyšiel som z obchodu .	obchodu	3	Inan
Prečo by vlastne tí mimozemšťania mali byť naši priatelia alebo nepriatelia , keď sa vyvíjali s úplne iným backgroundom , v inom kontexte , majú totálne iný spôsob dorozumievania , ich ciele a motivácie nechápeme ?	mimozemšťania	4	Anim
Vtom zazrela oslíka .	oslíka	2	Anim
Nová však bola energia , s akou tieto požiadavky nastoľovali a nová bola aj prísnosť trestov za nerešpektovanie týchto požiadaviek .	trestov	15	Inan
Potom Maja s kamarátmi pomáhala stroskotancom z vody na nové plavidlo .	kamarátmi	3	Anim
Tá žena mi položila ruku na hlavu a rozstrapatila mi vlasy .	vlasy	10	Inan
Miestodržiteľom uvedenej oblasti bol Monomachov syn Mstislav / od roku 1093 do roku 1096 , kedy sa začali jeho boje s Olegom Sviatoslavičom / .	Miestodržiteľom	0	Anim
Svojim členom nikdy nepomáhame .	členom	1	Anim
Je veľmi pravdepodobné , že uhorskí zákonodarcovia formulovali príslušné právne normy o celibáte pod vplyvom výziev reformátorov .	vplyvom	14	Inan
Zdravotníkovi som dal meno Vehap a črty ošetrovateľa .	Zdravotníkovi	0	Anim
V Gregorovom ponímaní by to znamenalo komendovanie Uhorska sv . Petrovi , ktorého nástupca by vládcovi krajiny udelil kráľovskú korunu .	nástupca	13	Anim
Winstona predovšetkým dráždilo , že v tom rámuse hlasov sotva počul Parsonsove slová , takže ho musel sústavne žiadať , aby svoje nezmysly opakoval .	rámuse	7	Inan
Vzápätí stál na balkóne Džafar oblečený v sultánovom rúchu .	balkóne	3	Inan
PREČ S VEĽKÝM BRATOM !	BRATOM	3	Anim
Je to chronologicky prvá zbierka , ktorú zostavil neznámy autor z rímskych reformných kruhov .	autor	9	Anim
Dôležitejším znakom oboch kategórií šamanov je , že úspech ich činov nezávisí od toho , akú obetu bohu prinesú , ale od toho v akom vzťahu sú oni sami s bohmi — tj . od ich schopností .	šamanov	4	Anim
Domáci pán mal zlatý oblek s čiernymi pásikmi .	pásikmi	7	Inan
" Zoberiem tú funkciu , ak to ľudia naozaj budú chcieť , " povedal režisér .	režisér	14	Anim
Bol začiatok novembra a noci bývali chladné .	začiatok	1	Inan
Bude mať názov Shanghai Noon a režisérom bude debutujúci Tom Dey .	režisérom	6	Anim
Rutherford mal mohutnú postavu , hrivu mastných , sivých vlasov , zjazvenú tvár s vačkami pod očami a hrubé negroidné pery .	vačkami	14	Inan
Samozrejme , že autorom pôvodnej myšlienky je VB , " dodal .	autorom	3	Anim
Obaja Aladinovi zákazníci chvíľu mlčali .	zákazníci	2	Anim
Slnečný svit , ktorý prenikal nespočetným lístím , ich ešte stále pálil na tvárach .	svit	1	Inan
Pedra totiž široko ‐ ďaleko poznali ako záletníka a donchuana .	záletníka	7	Anim
Nález železného kľúča od visiaceho zámku mohol súvisieť s už spomenutou ochrannou funkciou .	kľúča	2	Inan
Ku konfliktom a nedorozumeniam výrazne prispelo aj to , že sa maďarské „ nemzet “ dá používať v oboch týchto významoch .	významoch	20	Inan
Napriek svojej rozrušenosti som vytušil , že šéf hrá akúsi hru .	šéf	7	Anim
A tak bocian polámal ľan zobákom .	bocian	2	Anim
Ostražito sa zakrádala k neznámemu miestu , keď začula plač .	plač	9	Inan
Obaja sme na okamih upreli zrak na pohybujúce sa svetlo .	zrak	5	Inan
Nezavelil však na ústup , ale poslal dopredu ďalších zubáčov .	zubáčov	9	Anim
Prehľadal ten kus lesa krížom ‐ krážom , ale niečo ho ustavične ťahalo späť k starej borovici .	kus	2	Inan
Bez vyzvania im čašník priniesol ďalšie poháriky s džinom .	džinom	8	Inan
Zrazu však vyšľahli obrovské plamene a vyrazili princovi štít z ruky .	štít	8	Inan
“ Kde máš náklad ? “ zastavil otrokár Ferda .	otrokár	7	Anim
Za odchodom ženy s okuliarmi nasledoval príchod zvláštneho človeka .	človeka	8	Anim
Vnútil mi liace a koč s tým divým koňom .	koňom	8	Anim
Vláda bude pri riadení verejných financií postupne posilňovať význam strednodobého rozpočtového výhľadu .	výhľadu	11	Inan
“ Ešte si to rozmyslím , “ zahučal obor , ale už sa knísal nepriateľovi v ústrety .	obor	8	Anim
Spomenul som si na dve veci : na hysterickú eufóriu učiteľov po incidente , pri ktorom sa spomenulo meno mytologického božstva záhrobného sveta .	sveta	22	Inan
V úvode pasáže volchvi symbolizujú bielych šamanov , vysporiadávajúcich sa s čiernymi šamanmi .	šamanov	6	Anim
Mohlo byť len zo stromu , do ktorého sa zaťalo sekerou so zatvorenými očami .	stromu	4	Inan
Pokiaľ išlo o poznámky , Rick bol takpovediac profesionál .	profesionál	8	Anim
Pedra totiž široko ‐ ďaleko poznali ako záletníka a donchuana .	donchuana	9	Anim
Kráľ nebol v očiach súčasníkov obyčajným laikom .	laikom	6	Anim
Nový vládca tak prevzal atribúty vládcu starého .	vládca	1	Anim
Dosadzovanie duchovných do úradov laikmi bolo bežnou praxou raného stredoveku .	duchovných	1	Anim
Jeho kult sa spájal s kultom Poseidóna .	kultom	5	Inan
Tatko sa hneval na deti , lebo ukrutne vyvádzali , a mamka sa hnevala na tatka , že je precitlivený .	tatka	15	Anim
Opäť zdvihol zrak na portrét Veľkého brata .	portrét	4	Inan
Čašník stratil trpezlivosť .	Čašník	0	Anim
A človeka dnešných čias .	človeka	1	Anim
“ Otec , on spáva s potkanmi ! “	Otec	1	Anim
Je veľmi pravdepodobné , že uhorskí zákonodarcovia formulovali príslušné právne normy o celibáte pod vplyvom výziev reformátorov .	zákonodarcovia	6	Anim
Po celý čas som sa díval smerom k osvetlenému pásmu , kde sa zástup žien tlačil pred skleným priečelím obchodu .	obchodu	19	Inan
Rovnakého problému sa týka i posledný z ostrihomských kánonov , ktorý sa venuje vlastnému ordinačnému právu .	kánonov	8	Inan
Jeho telom zalomcoval ukrutne bolestivý záchvat hrôzy .	záchvat	5	Inan
U ugrofínskych národov fungoval orol ako predok a ochranca šamanov .	orol	4	Anim
“ Pri opičom more to tak býva , “ odvetil chlapec .	chlapec	10	Anim
“ Ranná čata pôjde chlapca hľadať . “	chlapca	4	Anim
Euroázia je spojenec .	spojenec	2	Anim
Brat kantor pre vážne osobné dôvody nemohol prísť , preto brat farár sprevádzal nábožný spev na gitare spolu s mládežníkmi , ktorí poslúžili programom a vystúpili aj s osobným vyznaním .	Brat	0	Anim
Keď dedinskí nafúkanci z môjho ročníka uverejnili na jeho stránkach nejakú báseň , naparovali sa celý mesiac .	nafúkanci	2	Anim
Bol rehoľníkom v niekoľkých kláštoroch v Itálii i Hispánii , no oveľa viac ho priťahoval eremitský spôsob života .	rehoľníkom	1	Anim
Vtedy bola zároveň jedným z hlavných nástrojov , vďaka ktorému udržiavali ľudské spoločnosti kontakt s hmotnou skutočnosťou .	nástrojov	6	Inan
Neviditeľní jazdci na koňoch sú vyjadrením predstavy o zlých duchoch , schopných ubližovať človeku odnesením jeho duše do podsvetia .	duchoch	9	Anim
“ Myslím na dnešné preteky , “ zaklamala som .	preteky	4	Inan
Muž , ktorý zostal stáť , mi povedal to isté po anglicky .	Muž	0	Anim
V tejto časti práce podávam prehľad zmienok o prvkoch pohanstva v skúmanej oblasti .	prvkoch	8	Inan
Vláda dopracuje a predloží návrh zákona o voľbách do Európskeho parlamentu tak , aby Slovenská republika bola pripravená voliť poslancov do tohto orgánu v prvom polroku 2004 .	parlamentu	10	Inan
“ Myslela som , že robíš v El Rancho , “ vyhŕkla som bez rozmyslu .	rozmyslu	14	Inan
Menšie rozmery potešia pri balení .	rozmery	1	Inan
Nebol to nik iný ako chrobák Truhlík .	chrobák	5	Anim
A tu či inde sa v úplnej tajnosti nachádzali riadiace mozgy , ktoré koordinovali toto úsilie a určovali politickú líniu : rozhodovali o tom , že tento fragment minulosti sa zachová , tento sa sfalšuje a ďalší prestane jestvovať .	mozgy	10	Inan
Neobjavil sa nijaký strážnik .	strážnik	3	Anim
Leopard Sabor sa chystal zaútočiť .	Leopard	0	Anim
Mravce dovliekli celý kôš dobrôt , včielky priniesli ovocný medovník a Kasandra jazmínové želé .	medovník	9	Inan
Ako šesťročného ( o rok skôr , než bolo zvykom ) ho na základe zvláštnej výnimky prijali medzi Zvedov a ako deväťročný sa stal vedúcim skupiny .	zvykom	9	Inan
Duchovní v tejto funkcii sa netešia veľkej úcte , sú ohováraní svojimi nevoľníkmi , mučení a zabíjaní .	Duchovní	0	Anim
Vo Zvedoch som robila vedúcu oddielu .	Zvedoch	1	Anim
Prvý z apoštolov patril v celom kresťanskom svete k mimoriadne uctievaným svätcom .	apoštolov	2	Anim
Má osem riadkov .	riadkov	2	Inan
Rodičia zhasli svetlo a vyšli z izby .	Rodičia	0	Anim
Pri veľkej bráne ho čakal náš domáci .	domáci	6	Anim
Na hlave mal klobúk a na krídlach vzácny vzor .	vzor	8	Inan
Položil som slúchadlo na vidlicu a uprel som zrak na telefón .	zrak	8	Inan
“ Pozrite na toho zbabelca ! “ zakričal nejaký nezbedník .	zbabelca	4	Anim
Cítila som na pokožke nežný dotyk jeho prstov .	prstov	7	Inan
“ Stavím sa , že je to bytosť z inej planéty , “ zašepkala Maja a zatiaľ čo sakamaráti skrývali za jej chrbtom , podišla bližšie a navrhla neznámemu prehliadku Makovej lúky .	chrbtom	22	Inan
“ Zato by som ti mal odhryznúť hlavu , maličká ! “ zreval rozzúrený sršeň .	sršeň	14	Inan
Za jeho stiahnutými mihalnicami sa pohyboval celý les prstov v akomsi tanci , vykrúcal sa a skrúcal , strácal sa jeden za druhým a znova sa objavoval .	les	7	Inan
Koloman mal v súvislosti so svojimi hospodárskymi reformami akiste zámer profitovať z potenciálu oboch týchto skupín obyvateľstva .	potenciálu	12	Inan
Tajná zbraň : krtkov tunel	tunel	4	Inan
“ Si mojím otrokom a zaraz mi splníš prvé želanie .	otrokom	3	Anim
Steblo sa zlomilo a on skončil na chrbte .	chrbte	7	Inan
Bál som sa , že moji rodičia sa namiesto toho , aby ma bránili , postavia na stranu útočníka .	útočníka	18	Anim
Pri ďalšej skúške vymenila slák za golfovú palicu , takže Klotilda musela kričať a prišla o hlas .	hlas	16	Inan
Sklo je prirodzene náchylné rozbiť sa a plech nezaručuje odolnosť voči vlhkosti .	plech	7	Inan
“ Ale keď kapitán Hook na tom trvá ! “ vysvetľoval John , starší z Wendiných bratov .	kapitán	3	Anim
Po zázraku s ostatkami Feodosija a pred vpádom Polovcov .	ostatkami	3	Inan
Kým komáre krúžili koldokola na kraji lesa , na krajinu pomaličky sadala tma .	kraji	5	Inan
“ Si správny chlapec , “ povedal .	chlapec	3	Anim
Rovnako pri dodaní či vyzdvihnutí fotografií ste ušetrení od úmorného vyčkávania v rade .	rade	12	Inan
Ocitlo sa osamote s Lori a zo svojej skrýše všetko pozorne vnímalo : tvary Lorinho tela , jej dych , vôňu jej mäsa .	tvary	13	Inan
" Zradila som ťa , " povedala bez okolkov .	okolkov	8	Inan
Čas — 1091 .	Čas	0	Inan
Prísnosť uhorských „ protialkoholických “ kánonov a aj ich početnosť svedčia o Kolomanovej snahe vykoreniť z klerických kruhov neduh nadmerného požívania alkoholu .	alkoholu	21	Inan
Podľa Irminých pokynov – samotná Irma vybavovala všelijaké formality – ma poprosili , aby som odišiel z domu a vrátil sa podľa možnosti až večer .	pokynov	2	Inan
Nejaký riaditeľ podniku alebo vedúci brigády na družstve , kde som absolvoval pravidelný mesiac fyzickej práce .	vedúci	4	Anim
Vtom začula výkrik .	výkrik	2	Inan
Vodné vtáky teda i kačky sú späté s kultom slnca , keďže svojim jarným príletom zvestujú vzrast jeho moci .	príletom	14	Inan
Šesť perzských žonglérov zasa hádzalo nožmi .	nožmi	5	Inan
Podľa Irminých pokynov – samotná Irma vybavovala všelijaké formality – ma poprosili , aby som odišiel z domu a vrátil sa podľa možnosti až večer .	domu	17	Inan
Nepekný odev môže všetko pokaziť .	odev	1	Inan
Nachádzala sa tam kancelária šéfa televízie Sírius .	šéfa	4	Anim
Predavači tu núkali všeličo od výmyslu sveta — mosadzný riad , sladké datle i čerstvé ryby .	riad	9	Inan
Súd sa konal za účasti veľkého obecenstva .	Súd	0	Inan
V oblasti prepravných povolení v cestnej doprave sa realizuje nový transparentný systém založený na princípe nárokovosti pri splnení požadovaných kritérií a podmienok	princípe	14	Inan
Potkany vedeli , čo bude nasledovať .	Potkany	0	Inan
“ Odíď a daj mi pokoj !	pokoj	5	Inan
Lykožrút Fridolín potom odniesol víťaza medzi jasajúcich divákov .	Lykožrút	0	Anim
Týchto ľudí , ktorí pochádzali zo strednej triedy zamestnancov a z vyšších vrstiev robotníckej triedy , sformoval a zoradil jalový svet zmonopolizovaného priemyslu a scentralizovanej vlády .	zamestnancov	8	Anim
Tieto funkcie sú nápadne podobné funkcii kléru na starej Rusi — pri kláštoroch boli útulky pre chorých a existovali dokonca „ kláštorní lekári “ , ktorí spadali do kompetencie cirkevného práva .	chorých	16	Anim
Mušiakovi Pavlovi sa mušia slečna zapáčila na prvý pohľad .	Mušiakovi	0	Anim
Areál Zväzu spisovateľov smrdí močom .	spisovateľov	2	Anim
Prirodzeným dôsledkom takéhoto stretu je rozbíjanie vervi a úsilie o znevoľnenie smerdov .	stretu	3	Inan
Po večere v lunaparku sme išli zopár ráz po škole do knižnice .	večere	1	Inan
Marketing je súborom disciplín , ktoré sa zaoberajú trhom a v trhovej ekonomike človek má cenu , ktorá sa vyjadruje len peniazmi .	Marketing	0	Inan
Horšie však bolo , že ten divý kôň zmizol .	kôň	7	Anim
Považovala to za skvost vtipnosti a s potešením ho vzala do náručia .	skvost	3	Inan
O chvíľu tam bola upratovacia čata mravcov .	mravcov	6	Inan
Nakoniec sme priniesli z kuchyne taniere , šalát a fašírku .	taniere	5	Inan
Na rozdiel od rodičov som sa Profesora nebál .	rodičov	3	Anim
Chan si zahrá Číňana , ktorý pricestuje na Divoký západ , aby zachránil unesenú dcéru čínskeho konzula .	konzula	16	Anim
Obrázkovým telefónom som zavolal kováča Kováčika a ten bez dlhých rečí koníka okoval .	telefónom	1	Inan
Za očami matne rozoznala biely ňufáčik a zlato ‐ čierny pásikavý kožuštek .	ňufáčik	5	Inan
A zovrel som ruky za chrbtom , silne .	chrbtom	5	Inan
Buchta láskyplne sledovala siláka Fridolína .	siláka	3	Anim
“ To mi ver , “ odvetil a postrapatil Mauglímu vlasy .	vlasy	10	Inan
Ale keď veľký vlk vopchal do košíka ňufák , bábätko sa zasmialo .	vlk	3	Anim
Šaty boli dlhé , biele a viseli medzi Profesorovými oblekmi .	oblekmi	9	Inan
“ Na to sa spoľahnite ! “ začal vyjednávať chrobák Truhlík .	chrobák	9	Anim
Vláda pripraví a realizuje systém ochrany slovenského spotrebiteľa a prostredníctvom legislatívy ho prispôsobí stavu , ktorý bude zodpovedať legislatíve EÚ .	spotrebiteľa	7	Anim
Posledný szabolcsský kánon , ktorý sa venuje kláštornému životu nariaďuje opátom a mníchom , aby sa nezúčastňovali na kalendových sedeniach , ale aby prijímali oblácie ich účastníkov v kláštoroch .	opátom	10	Anim
“ Tuším si našla otcov list , “ povedala mama .	list	5	Inan
Faika odišla po úbočí vrchu , nadol .	vrchu	4	Inan
Zavedenie inštitútu manažéra súdu zníži počet funkcionárov súdov , ktorí obmedzene vykonávajú súdnictvo .	funkcionárov	6	Anim
Uvedomila som si , že som nevhodne zareagovala , lenže ten bozk ma naozaj vyviedol z miery .	bozk	11	Inan
Z tohto hľadiska meriam obdobie svojho pobytu v Čarodejníckej vile podľa intervalov , v akých otec odpovedal na mamine listy .	intervalov	11	Inan
Trvalá pozornosť bude venovaná rozvoju vzťahov s Ukrajinou , ktorá je naším najväčším susedom .	susedom	13	Anim
Hugovi životopisci nás informujú o dobrom výsledku účinkovania opáta v Uhorsku .	opáta	8	Anim
Herkules skočil do jaskyne smrti , aby zachránil Meginu dušu , a z mládenca sa razom stal starec na pokraji smrti .	mládenca	13	Anim
Môj mozog zatiaľ začínal špekulovať .	mozog	1	Inan
Pri cieli sa skrýval osiak Boris a zrkadielkom oslňoval ostatných pretekárov , len aby pomohol svojmu zmrzačenému kamarátovi zvíťaziť .	kamarátovi	17	Anim
“ Poď k nám , Amy , “ navrhol Chris , keď autobus zastal pri obrubníku .	obrubníku	15	Inan
Zber uskutočňoval pomocou siete platených agentov .	agentov	5	Anim
“ Ale veď sú ako dobrí priatelia , “ namietala som .	priatelia	6	Anim
Malé dieťa sedelo s ockom pri večeri .	ockom	4	Anim
Lákal ho nádherný palác v diaľke .	palác	3	Inan
Ako zlodeji sme sa vyhýbali osvetleniu a snažili sa skrývať v bezpečí noci .	zlodeji	1	Anim
Zväčša to boli obyčajní zločinci , ale našla sa tam aj hŕstka politických väzňov .	zločinci	4	Anim
Zároveň však Cluny urobilo veľký krok na ceste k libertas , lebo vytvorilo spoločenstvo ( zväčša ) úplne slobodných kláštorov , ktoré nepodliehali laikom .	krok	5	Inan
Namiesto nich mal drobnú kartónovú škatuľku a v nej dva chrústy .	chrústy	10	Inan
Starec po ňom hodil bochník starej pity .	Starec	0	Anim
Keď sme dojedli a mama upratala stôl , rodičia hrávali karty .	stôl	6	Inan
Ženy aj muži .	muži	2	Anim
Vláda zabezpečí implementáciu koncepcie integrácie zdravotne postihnutých do života , aby mohli pracovať a plnohodnotne sa zúčastňovať na živote spoločnosti .	postihnutých	6	Anim
Nehovoriac o tom , že popoludní mávala stále program , chodila na súkromné hodiny angličtiny .	program	8	Inan
Budúci pápež však podmienil svoj nástup do úradu – a to bolo v súdobých podmienkach niečím úplne novým – vykonaním regulárnej voľby klérom a ľudom Ríma .	klérom	22	Inan
“ Bude najsilnejší zo všetkých bohov , “ hrdo vyhlásil Zeus .	bohov	5	Anim
kríž zo štyrmi bodkami na prekrížení znamená zasiate pole , symbol plodnosti .	kríž	0	Inan
“ Viem , “ povedala som a vystúpila z auta , “ ale ak budem myslieť len na zábavu , môžem ísť zametať chodníky . “	chodníky	23	Inan
ODCHODY A návraty ĽUBOMÍRA Ďuroviča ( I . )	ODCHODY	0	Inan
Veľkého brata nepočul nikto .	brata	1	Anim
Dôraz tentoraz patrí na slovo jedinečný .	Dôraz	0	Inan
Však vieš , že sa tá zbierka robí od domu k domu .	domu	11	Inan
Pod nimi bolo viacero vkusných papierových balíčkov .	balíčkov	6	Inan
Práve vtedy vošiel ráznym krokom guľatý pánko so špicatou briadkou .	krokom	4	Inan
Keď som na nej otvoril dvere , zarazene som zastal na prahu : hrali tam šach dvaja učitelia .	šach	15	Inan
Lekári robili tajnosti	Lekári	0	Anim
Najdôležitejšie informácie v marketingovej spoločnosti sú napísané na okraji a malými písmenami .	okraji	8	Inan
Ferdo z toho usúdil , že bývalí otrokári nevedia ani písať .	otrokári	7	Anim
Straník žije od narodenia po smrť pod dozorom Ideopolície .	dozorom	7	Inan
Slová týchto popevkov písal bez akéhokoľvek ľudského zásahu prístroj známy pod názvom " veršovač " .	názvom	11	Inan
Hral v tom filme hlavného hrdinu .	filme	3	Inan
Ani jej strýko nie je veľmi na beletriu .	strýko	2	Anim
Sporenie prostredníctvom individuálnych účtov vytvorí priestor , aby v budúcnosti o čase svojho odchodu do dôchodku mohol rozhodovať sám občan .	priestor	5	Inan
Naopak , mama sedávala za stolom a písala listy .	stolom	5	Inan
A uzlovým bodom všetkých právnych formúl , ktoré sa týkajú rozoberaných hnutí , je vzťah tohto spoločenstva k štátnej moci , t . j . stret sveta šamanistického dualizmu s predstaviteľmi kniežacej moci , zjednocujúcimi krajinu .	dualizmu	28	Inan
V ušiach mi zostala len ozvena jeho hlasu a v diaľke , na úpätí podstavca bez sochy , som uvidel Háda .	podstavca	14	Inan
Vláda bude i naďalej venovať sústredenú pozornosť podpore efektívnych programov boja proti drogám .	programov	9	Inan
Kráľ nebol v očiach súčasníkov obyčajným laikom .	súčasníkov	4	Anim
Jazmína zdvihla hlavu a uvidela , že princ Omar tuho spí .	princ	7	Anim
Skvelý psychológ , vyvolávač hrôzy , zaklínač šialenstva .	vyvolávač	3	Anim
Jedlo zásadne mení človeka po každej stránke .	človeka	3	Anim
Vsunuté medzi pasážami o volchvoch na Beloozere a v Novgorode .	volchvoch	4	Anim
Spytovaní náhodní chodci i sociológovia a ďalší odborníci sa vzácne zhodli .	sociológovia	4	Anim
Netvor na ňu hľadel rovnakým pohľadom .	pohľadom	5	Inan
Jednostaj prichádzali a odchádzali všakovakí väzni : distribútori drog , zlodeji , banditi , šmelinári , opilci , prostitútky .	opilci	16	Anim
Vybral desať najlepších policajtov a tí potom starostlivo prehľadali lúku .	policajtov	3	Anim
Popri potoku kvitli biele lekná .	potoku	1	Inan
Winton začal šepotom .	šepotom	2	Inan
Boli to moji kolegovia a kolegyne .	kolegovia	3	Anim
Aby mu to nebolo ľúto , zlizol aj on jeden pohlavok ako ostatní .	pohlavok	10	Inan
Prečo by vlastne tí mimozemšťania mali byť naši priatelia alebo nepriatelia , keď sa vyvíjali s úplne iným backgroundom , v inom kontexte , majú totálne iný spôsob dorozumievania , ich ciele a motivácie nechápeme ?	nepriatelia	10	Anim
Amulet teda posilňuje určité črty jeho charakteru do neobvyklých až nadprirodzených polôh , Vseslav sa stáva vyvolencom — podľa kresťanského kronikára — temných síl .	charakteru	6	Inan
Mesto zrodu Vseslava volchva .	volchva	3	Anim
Prijatie novely zákona o štátnej službe umožní okrem iného zamestnanie špičkových odborníkov v ústredných štátnych orgánoch za adekvátneho mzdového ohodnotenia a odstráni nepružnosť zamestnávania v štátnej službe .	odborníkov	11	Anim
Vo Zvedoch som robila vedúcu oddielu .	Zvedoch	1	Anim
Za jej chrbtom mi zostala v zábere Talianova tvár .	chrbtom	2	Inan
Bolo ich tam ako maku .	maku	4	Inan
Ona by mala policajtom všetko vysvetliť .	policajtom	3	Anim
S očividným uspokojením dokázal rozprávať o náletoch vrtuľníkov na nepriateľské dediny , o procesoch s ideozločincami , o ich priznaniach a o popravách v katakombách Ministerstva lásky .	vrtuľníkov	7	Inan
Druhý a tretí riadok spolu dávajú meno Sežir .	riadok	3	Inan
Potom otočil ktorýmsi vypínačom a hlasy zmĺkli .	hlasy	5	Inan
Za slovenskú stranu sa tradične na organizácii prehliadky podieľa Slovenský filmový ústav a Asociácia slovenských filmových klubov , ktorá prostredníctvom MK SR udeľuje na prehliadke Hlavnú cenu Zlatý debut .	debut	28	Inan
Nazlostený Džafar vyskočil z trónu , ktorý pripomínal kobru .	trónu	4	Inan
Na festivale sa predstavia rómske aj nerómske hudobné zoskupenia z celého Slovenska .	festivale	1	Inan
Vytvoríme kapitálotvornú vrstvu , ktorá bude zárukou blaha ľudu , presvedčivo hlásal tvorca blaha svojich prívržencov .	prívržencov	15	Anim
Obaja rýchlo dýchali , ale okolo kútikov úst sa jej znovu objavil úsmev .	kútikov	6	Inan
Dobre som poznal mená všetkých dobových talianskych spevákov aj všetkých futbalistov .	futbalistov	10	Anim
Ani bratanci sa sem už neodvážia prísť , priatelia k nám prestali chodiť na návštevu už dávno .	bratanci	1	Anim
Spevák skupiny sa s deťmi rozprával a pýtal sa ich na to , čo si myslia o Bohu .	Spevák	0	Anim
Tam na kamennom tróne sedel sám kráľ opíc .	tróne	3	Inan
A uvedomovať si , že som na tomto svete jediným Loriným zástupcom .	zástupcom	11	Anim
Otočila som sa a medzi divákmi som zazrela Jilliných rodičov .	divákmi	5	Anim
Hlavnými aktérmi tohto procesu boli cisár Oto III . a pápež Silvester II .	aktérmi	1	Anim
Namiesto toho spoznala iného , prečudesného spoločníka z čeľade hmyzu .	spoločníka	6	Anim
Wendy a chlapci vyjavene hľadeli , ako k oblohe stúpa čierny dym .	chlapci	2	Anim
Ešte mu v ušiach znel smiech a potlesk divákov .	divákov	8	Anim
Bola noc a biele tváre a šarlátové transparenty zalievalo zlovestné svetlo .	transparenty	7	Inan
A otočil som sa na druhý bok .	bok	6	Inan
Takýmito duchmi môžu byť medvede , vlky , zajace , jelene , kačky , orly , sovy a vrany .	medvede	4	Inan
Lavdima Lavdoshaja zaraďovali k príslušníkom konzervatívneho krídla .	príslušníkom	4	Anim
Ostrihomská synoda tiež zakázala , aby bol za kňaza vysvätený otrok ( sluha ) .	kňaza	8	Anim
Takto som trávieval večery , márnil som čas pred televízorom .	večery	3	Inan
Hra na hudobné nástroje , vozy ako prostriedok na prekonávanie vzdialeností by mohli svedčiť i o narážke na potulných hudcov ‐ igricov , ktorí sú chápaní v celoeurópskom kontexte ako elementy , rušiace zabehaný poriadok .	prostriedok	7	Inan
Šéf sa zo všetkých síl pokúšal , aby som odišiel z jeho pracovne spokojný , aj keď mi tú poviedku neuverejní .	Šéf	0	Anim
Neter môjho kamaráta je vysokoškoláčka .	kamaráta	2	Anim
Koľko je takých cestovateľov , Pane ?	cestovateľov	3	Anim
A kým je môj pas v rukách toho muža , veci vonkoncom nevyzerajú dobre .	muža	8	Anim
To všetko mi jedného dňa porozprával Sergej , pri močiari .	močiari	9	Inan
Zbadala ho na steble trávy , práve z orlíčka popíjal sladký nektár .	nektár	11	Inan
Každý pokus o systematizáciu tejto otázky totiž nevyhnutne naráža na kolíziu metódy vedeckého prístupu s rozumovo nedefinovateľným fenoménom náboženstva a viery .	fenoménom	17	Inan
Dobrosrdečná dievčina sa mu však neustála snaží dohodiť nejakého priateľa .	priateľa	9	Anim
Mauglí stál v pozore , keď plukovník pochodoval okolo neho na koniec radu a zasa späť .	plukovník	6	Anim
Bol to smiešny prejav .	prejav	3	Inan
Strachu z pasce ma zbavil ošetrovateľ .	ošetrovateľ	5	Anim
Individualista , vzbúrenec , latentný terorista .	Individualista	0	Anim
“ Poďme do reštaurácie mojich rodičov .	rodičov	5	Anim
Náš dnešný spisovný jazyk je skutočným kompromisom medzi radikálnou normou štúrovcov a požiadavkami bernolákovcov i tradíciou českou či československou .	štúrovcov	10	Anim
Neďaleko jazdil na koni mladý princ .	princ	5	Anim
Prednosta podzemnej dráhy náhodou našiel starú čižmu , ktorá sa na tento účel výborne hodila .	Prednosta	0	Anim
On a zopár jemu podobných boli poslednými živými spojovacími článkami so zašlým kapitalizmom .	kapitalizmom	12	Inan
Vláda predloží zákon o zdravotníckych povolaniach a zariadeniach definujúci úlohy poskytovateľov a zdravotníckych pracovníkov .	pracovníkov	13	Anim
Jeho zbierka totiž , podľa nás , predstavuje prechodný typ cirkevnoprávnej zbierky , ktorý stojí medzi cirkevnoprávnymi zbierkami vzniknuvšími v období dominancie germánskeho práva a zbierkami reformnými , ktoré sú predstupňom diel klasickej kánonistiky .	predstupňom	30	Inan
Bez slova a bez pozdravu Martin odišiel , ticho zatvoril za sebou dvere .	pozdravu	4	Inan
Jej priebeh je možné zrekonštruovať zhruba takto — Pred obradom samotným bolo postavené obetisko s pôdorysom štvoruholníka so štyrmi stĺpmi v rohoch .	rohoch	21	Inan
Svedčí o tom podobnosť pečatí č . 4 a 5 s pečaťami č . 6 až 9 patriacimi Izjaslavovým bratom Svjatopolkovi a Vsevolodovi .	bratom	19	Anim
Vo vzduchu sa vznášali farebné balóniky , v pestrých stánkoch bolo množstvo všakovakých dobrôt .	balóniky	5	Inan
Kiež by som mala menší zobák . “	zobák	5	Inan
Bolo sivé popoludnie s oblohou veštiacou sneh , keď sa človeka zmocňuje ubíjajúca otupnosť a uvoľnenie prináša len alkohol .	alkohol	18	Inan
Najstaršie z nich sa objavujú v I . zákonníku sv . Ladislava .	zákonníku	8	Inan
Ani bratanci sa sem už neodvážia prísť , priatelia k nám prestali chodiť na návštevu už dávno .	priatelia	8	Anim
V tom okamihu bolo po vysokoškolských plánoch .	okamihu	2	Inan
Vedľa v sieni sa zatiaľ zhromaždenie skončilo a v sršňom meste zavládol pokoj .	pokoj	12	Inan
Prítomný je celý panteon vladimírovej pohanskej reformy .	panteon	3	Inan
Piráti opäť začali spievať .	Piráti	0	Anim
“ Ďakujem , “ povedala Makulienka , “ ibaže neviem , čo mám robiť , aby drozd vrátil Emanuelovi cylinder . “	drozd	16	Anim
Našťastie za prvým bukom stretli Truhlíka a zistili , že aj on má na otrokárov ťažké srdce .	otrokárov	14	Anim
Po rokom 1044 sa nachádza správa o narodení Vseslava , ktorému matka na radu volchvov uviazala amulet , spôsobiaci že z chlapca vyrástol krutý a nemilosrdný človek .	rokom	1	Inan
Víťaz získava CD alebo DVD podľa vlastného výberu !	Víťaz	0	Anim
Rudko Bielohlávok dal faul !	faul	3	Inan
Niekto z mojich niekdajších šéfov , vedúcich kádrového oddelenia alebo veliteľov na vojenských cvičeniach .	veliteľov	10	Anim
Trávniky sa premenia na oceány bahna a autá uviaznu pred domami .	domami	10	Inan
Aký som ja chrobák !	chrobák	3	Anim
Tie obleky mi poskytli kľúč k riešeniu .	kľúč	4	Inan
Nasťahovali sme sa sem iba pred štyrmi dňami .	dňami	7	Inan
Je síce pravda , že nijaký súdruh Ogilvy nikdy neexistoval , ale zopár riadkov v tlači a niekoľko vyfabrikovaných fotografií čoskoro splodia jeho existenciu .	súdruh	6	Anim
“ Ty máš chlp ? “ vykríkla .	chlp	3	Inan
Jodie Foster sa vracia k filmu .	filmu	5	Inan
Z okienok v plástoch vykuli rozospaté včelie hlávky .	plástoch	3	Inan
“ Tí psi sú dnes mojimi hosťami . “	hosťami	6	Anim
Veľký brat je zovňajšok , v ktorom sa Strana ráči ukazovať svetu .	brat	1	Anim
Jan prichádza do kraja po zvestiach o zabití žien volchvami .	volchvami	9	Anim
Chvíľu len tak posedával a hlúpo zízal na papier .	papier	8	Inan
Tento chlapík sa nikdy autorke nepáčil .	chlapík	1	Anim
Asi verili svojim po zuby ozbrojeným bojovníkom , pred ktorými sa všetci trasú .	bojovníkom	6	Anim
„ Ypsilon ako hláska nie je funkčný a v slovenskom jazyku takej hlásky niet .	jazyku	10	Inan
Príslušníka vojenskej polície , poľovníka a manželský pár v stredných rokoch .	Príslušníka	0	Anim
Z Velesa sa stal Vlasij , ochranca dobytka .	ochranca	6	Anim
Pri dychovke , čo kvôli nemu vyhrávala , tancoval s istou slečnou myškou ako divoch .	divoch	14	Anim
Hostia však boli čoraz zachmúrenejší .	Hostia	0	Anim
Výučbu tancov povedie Jano Blaho , dôstojný nástupca Štefana Nosáľa na poste choreografa Lúčnice .	nástupca	7	Anim
Ako šesťročného ( o rok skôr , než bolo zvykom ) ho na základe zvláštnej výnimky prijali medzi Zvedov a ako deväťročný sa stal vedúcim skupiny .	Zvedov	18	Anim
Čakanie na šéfa . . .	šéfa	2	Anim
Šer Chán ich počúval zo svojho úkrytu z kroví .	úkrytu	6	Inan
Bol to cvrček .	cvrček	2	Anim
Podporí v rámci krajín EÚ kompatibilnosť v oblasti vzájomného uznávania dokladov o dosiahnutí určitého stupňa vzdelania .	dokladov	10	Inan
Vláda dopracuje a predloží návrh zákona o voľbách do Európskeho parlamentu tak , aby Slovenská republika bola pripravená voliť poslancov do tohto orgánu v prvom polroku 2004 .	poslancov	19	Anim
Na smrť Veľkého brata ?	brata	3	Anim
Jeho meno vzniklo od chlpatosti silných mužov , vodcov .	vodcov	8	Anim
Krásne Vianoce Vám prajem , priatelia .	priatelia	5	Anim
Zo Škandinávie je známe časté zamieňanie toporov s poriskom čiastočne vysunutým nad čepeľ .	toporov	6	Inan
Prvý raz mám príležitosť byť so spisovateľom a filmovým scenáristom , povedala .	spisovateľom	6	Anim
Ani predstavitelia oficiálnej kritiky .	predstavitelia	1	Anim
Takýmito duchmi môžu byť medvede , vlky , zajace , jelene , kačky , orly , sovy a vrany .	orly	14	Inan
V ich národnom epose Kalevala nájdeme napr . starobylý výklad o pôvode sveta z vajca .	výklad	9	Inan
Rozoberané nepokoje sa odohrávajú v Beloozere , Novgorode , Suzdali , roku 1091 sa objavuje volchv i v Rostove .	volchv	15	Anim
Túto zmenu nepredvídal ani anonym , ani ja sám .	anonym	4	Anim
Detský biblický tábor pripravujeme v prekrásnom prostredí Žiarskej doliny v dňoch 31 . 7 . až 7 . 8 . 2004	tábor	2	Inan
A sme aj cudzoložníci .	cudzoložníci	3	Anim
Kompletný program 3 . Gay Film Festivalu Slovakia nájdete na Film Site v rubrike Ceny a festivaly .	festivaly	16	Inan
Potom sa vrhol do vody a rozpleštil sa na člne , až ma od smiechu rozbolelo brucho .	smiechu	14	Inan
V obvodnom kine , vzdialenom od centra , obyčajne premietali staré filmy .	filmy	11	Inan
Sporenie prostredníctvom individuálnych účtov vytvorí priestor , aby v budúcnosti o čase svojho odchodu do dôchodku mohol rozhodovať sám občan .	dôchodku	15	Inan
Šéf nie je prítomný .	prítomný	3	Anim
Vtom sa odraz mesiaca rozbil na črepy , no zakrátko sa zasa zjavil na hladine .	odraz	2	Inan
PREČ S VEĽKÝM BRATOM !	BRATOM	3	Anim
Za jasotu spoluobčanov prevzali cenu a Dr . Slimák slzil od dojatia , pretože v tejto súťaži doteraz nijaký slimák nevyhral .	slimák	19	Anim
Vláda zabezpečí novelu Zákonníka práce a zákona o verejnej službe tak , aby umožnila individuálnu diferenciáciu miezd a mobilitu zamestnancov v zdravotníckych zariadeniach .	zamestnancov	19	Anim
Naďalej som stál na slnku , pri policajtoch .	policajtoch	7	Anim
Že Mečiar , suverénny víťaz prvého kola , v druhom kole bol spektakulárne odmietnutý , je spravodlivý trest za roky jeho vládnutia .	trest	17	Inan
Veľmi by tvoj capko zúril , keby si sa dnes poobede ulial ? “	capko	3	Anim
Ale vlasy mu vstanú dupkom , keď si všimne niečo iné : trochu ďalej na konári , kam sa vyštveral , sedí medveď , ktorý tam vyliezol .	konári	15	Inan
Zopár minút preskakovali z témy na tému , keď vtom ich rev z televíznej obrazovky vyzval , aby držali jazyk za zubami .	rev	11	Inan
Scenár - adaptácia : Tenká červená čiara	Scenár	0	Inan
Zároveň svetská časť vládnúcej vrstvy prestáva mať záujem o monoteizmus vyjadrujúci myšlienku — jeden boh , jeden panovník .	monoteizmus	9	Inan
Lykožrút Fridolín potom odniesol víťaza medzi jasajúcich divákov .	víťaza	4	Anim
Moji rodičia sa báli .	rodičia	1	Anim
Gil Mars , najbohatší muž sveta , je majiteľom počítačovej spoločnosti MarsTech , ktorá vyrába aj hračky pre deti tretieho tisícročia .	sveta	5	Inan
Niekto z mojich niekdajších šéfov , vedúcich kádrového oddelenia alebo veliteľov na vojenských cvičeniach .	šéfov	4	Anim
Vysypte do nej kuskus a vypnite oheň .	oheň	6	Inan
V tej izbe bývalo predo mnou niekoľko brigádnikov z mesta , predstaviteľov robotníckej triedy .	brigádnikov	7	Anim
“ Super , “ povedala som , keď sme kráčali ku kabrioletu .	kabrioletu	11	Inan
Naši žiaci a rodičia sú pobúrení .	rodičia	3	Anim
Základným prvkom reformy verejných financií bude zavedenie tvrdého rozpočtového obmedzenia v celom okruhu verejných financií .	prvkom	1	Inan
Septembrové voľby potvrdili pevnosť demokratických základov Slovenskej republiky .	základov	5	Inan
Neničíme kacíra preto , že nám odporuje ; pokým nám odporuje , neničíme ho .	kacíra	1	Anim
Je známe , že hlinené nápodoby medvedích láb , slúžili na ochranu domáceho krbu .	krbu	13	Inan
Vláda dopracuje a predloží návrh zákona o voľbách do Európskeho parlamentu tak , aby Slovenská republika bola pripravená voliť poslancov do tohto orgánu v prvom polroku 2004 .	návrh	4	Inan
Z maku vyšlo ako z lesa drobučké dievčatko .	maku	1	Inan
A vtedy dobráckemu panterovi čosi napadlo .	panterovi	3	Anim
Obávam sa , že ocko nedovolí , aby sa mu po paláci potuloval tiger .	tiger	13	Anim
Pechota pozostáva z jediného vojaka .	vojaka	4	Anim
Pelikánia slečna Polly má veľký zobák a veľmi sa jej nepáči .	zobák	5	Inan
Zrazu ma jedna zúrivá krava nabrala na rohy .	rohy	7	Inan
Chvíľu ho nechali metať sa vo vode , no potom prilákali k studni muža , čo okopával záhradku .	muža	13	Anim
Do izby vstúpil pán Charrington .	pán	3	Anim
“ Ehm . . . som u obchodníka , ktorý dodáva potraviny . “	obchodníka	7	Anim
Vláda uplatní rovnaký postup pri priznávaní štátnej pomoci a zriadi register prijímateľov štátnej pomoci a register prijímateľov iných investičných stimulov .	stimulov	19	Inan
Bonus : vodovzdorné zápalky	Bonus	0	Inan
“ A nezabudnite na vrecká , kam zabalíte psom zvyšky . “	zvyšky	9	Inan
V blízkej osade Poklony bola Velesova svätyňa , uctievaná pri veľkom dube .	dube	11	Inan
Presne takého muža by som si želala .	muža	2	Anim
Úzky ružový pás na oblohe ohlasoval príchod nového dňa .	pás	2	Inan
Pri schodoch zastal .	schodoch	1	Inan
Bol prvým z nového tzv . „ druhého “ typu posadnikov v Novgorode .	posadnikov	10	Anim
Duchovia sa však v tomto prípade nechcú objaviť — boja sa kríža , ktorý má Novgorodec pri sebe .	Duchovia	0	Anim
Tayerle nám povedal , že o 00 . 08 sa mesiac začne postupne pohybovať do tieňa zeme .	tieňa	15	Inan
“ Sme kamoši .	kamoši	2	Anim
Veď hrdinu by nemalo nič rozptyľovať .	hrdinu	1	Anim
Dnes priniesla zebre a medvedíkovi plnú škatuľu šťavnatých jabĺk .	medvedíkovi	4	Anim
Rozvinul príkaz , ktorý predtým odložil stranou .	príkaz	1	Inan
Obrázkovým telefónom som zavolal kováča Kováčika a ten bez dlhých rečí koníka okoval .	kováča	4	Anim
Právo na prístup ku kultúrnym hodnotám je jedným z dôležitých práv všetkých občanov .	občanov	12	Anim
Potom tí muži začali vychádzať z izby a ja som sa vrátil do salóna .	salóna	13	Inan
Súčasťou návrhu bude aj kontrolný a monitorovací mechanizmus efektívneho využívania nástrojov podpory regionálneho rozvoja .	nástrojov	10	Inan
V jednom kuse táral o Týždni nenávisti .	kuse	2	Inan
Dôležitejším znakom oboch kategórií šamanov je , že úspech ich činov nezávisí od toho , akú obetu bohu prinesú , ale od toho v akom vzťahu sú oni sami s bohmi — tj . od ich schopností .	bohu	17	Anim
Vláda pripraví legislatívne a finančné predpoklady pre vznik povinného kapitalizačného piliera dôchodkového systému .	predpoklady	5	Inan
Ale šéf na nič neprišiel .	šéf	1	Anim
Chris šliapal vodu a ako psík krúžil okolo mňa .	psík	5	Anim
Tkali od rána do večera .	večera	4	Inan
Systematicky podrýva súdržnosť rodiny , zato svojho vodcu označuje pomenovaním , ktoré priamo vyvoláva pocity rodinnej vernosti .	pocity	14	Inan
Hubert pozval všetkých na koncert pri príležitosti krásneho letného večera .	večera	9	Inan
Od ľaku urobil Vilko kotrmelec .	ľaku	1	Inan
Opatrne som vstala , aby som ju nezobudila a išla som vypnúť televízor .	televízor	12	Inan
“ Kým nebude jeho hlava visieť na múre môjho domu , dovtedy nebudeme v bezpečí . “	múre	7	Inan
Ako som vychádzala zo školy , zbadala so , že sedí na trávniku pri zastávke môjho autobusu .	autobusu	16	Inan
Vzápätí však na votrelcov zaútočili svietniky , vešiaky , skrine , hodiny a riad .	votrelcov	3	Anim
Dvojtvárnosť trickstera súvisí s celkovým dualizmom , prítomným v systéme prírodného polyteizmu .	trickstera	1	Anim
Avšak hoci som sa strácal v tieni režisérov a hviezd filmového plátna , netrápil som sa .	režisérov	7	Anim
A predovšetkým , nedovoľujeme mŕtvym , aby povstali proti nám .	mŕtvym	4	Anim
Všetky zvieratká bežali do bezpečia , no Polly letela po zobák vody .	zobák	10	Inan
Priatelia po sebe hlasno pokrikovali .	Priatelia	0	Anim
Hook sa otočil k pirátovi Smíovi a posmešne napodobnil dievčatko .	pirátovi	4	Anim
Zobudil ma zvonček pri dverách bytu .	zvonček	2	Inan
Najmiernejším prívlastkom , ktorý by mi vmietla do tváre , by bolo slovo „ gauner “ .	gauner	14	Anim
Na okraje slohového zošita mi písal ľúbostné odkazy , alebo ma chcel bozkávať , kým som čítala .	odkazy	7	Inan
Roku 1095 bol obliehaný svojim bratom Olegom , V . Monomachom a Svjatopolkom Izjaslavičom .	bratom	5	Anim
“ Určite hľadáte Fawada , obchodníka so šperkami , “ povedala , keď k nej podišli .	šperkami	7	Inan
Takáto interpretácia stvorenia človeka diablom je zjednodušením .	diablom	4	Anim
M . N . Tichomirov fakt jednostranné vykladá len ako príčinu „ hladových vzbúr “ , Frojanov si všíma dôležitú okolnosť — volchovia sa zjavujú , aby zabezpečili blahobyt , hojnosť , úrodu .	volchovia	22	Anim
Najpresvedčivejšia bola verzia , podľa ktorej všetko spôsobil Sonin denník .	denník	9	Inan
" Nič to , drahý .	drahý	4	Anim
Naše dotyky v tme boli len rozmarom .	rozmarom	6	Inan
Z kuchyne som vzala dva vínové poháre a veľkú fľašu malinovky .	poháre	6	Inan
No keď sa stane na brehu jazera nehoda , Polly zachraňuje !	brehu	5	Inan
Strana vyzýva jedinca , aby poprel svedectvo vlastných očí a uší .	jedinca	2	Anim
“ Vidíš , Jago , “ povedal svojmu papagájovi .	papagájovi	8	Anim
Nečudujem sa , že výborne urobil záverečné ročníkové testy .	testy	8	Inan
Podporením priestupnosti školského systému v oblasti prechodu žiakov na vyšší stupeň školy bez prijímacích skúšok , vláda minimalizuje podmienky na korupciu v školstve .	žiakov	7	Anim
Vďaka týmto skúsenostiam pre mňa teoreticky neexistovalo nijaké tajomstvo súvisiace s túžbami , ktoré nútia muža pokúšať sa o zblíženie so ženou .	muža	15	Anim
Hra na hudobné nástroje , vozy ako prostriedok na prekonávanie vzdialeností by mohli svedčiť i o narážke na potulných hudcov ‐ igricov , ktorí sú chápaní v celoeurópskom kontexte ako elementy , rušiace zabehaný poriadok .	hudcov	19	Anim
Pre chlad som za stolom nikdy nezaspal .	chlad	1	Inan
Ak drží grifon v pazúroch štyri púčky , vyjadruje sa tým jeho všadeprítomnosť .	grifon	2	Anim
Založil ho Vladimír Monomach medzi rokmi 1098 a 1103 ako kniežací zámok na sútoku riek Kľazmy a Nerli .	sútoku	13	Inan
Herkules skočil do jaskyne smrti , aby zachránil Meginu dušu , a z mládenca sa razom stal starec na pokraji smrti .	pokraji	19	Inan
Opice skákali z konára na konár a preskakovali koruny stromov , čo rástli pozdĺž brehu rieky .	konár	5	Inan
Všetci s údivom pozerali na obrovské šalátové hlavy .	údivom	2	Inan
“ Žobrákov nekŕmime , “ povedal sluha .	Žobrákov	1	Anim
“ Poľovník mi priniesol dôkaz .	Poľovník	1	Anim
Iba sa trochu sklonila , odkryla deku a ja som uvidel tvár spiaceho človiečika , ktorý nemal takmer nijaké vlasy .	človiečika	13	Anim
Opustená strecha , kde bývali , bola na severe od trhoviska .	severe	8	Inan
Ochrannú funkciu mal krížik , zakončujúci ihlicu z mosadze .	krížik	3	Inan
Potom dodala známu vec s ujom a v priestore môjho mozgu zaburácalo slovo „ impotent “ .	priestore	8	Inan
Bolo tu pododdelenie televíznych programov s inžiniermi , producentmi a s celými tímami špeciálne vybraných hercov , lebo dokázali imitovať hlasy .	programov	4	Inan
Pozvala na ňu Blythe a Ricka a podávala moje obľúbené jedlá : zemiakovú kašu , pizzu , celozrnný chlieb , španielske chimichangas , makaróny so syrom a orechový koláč .	chlieb	18	Inan
Takže väčšina účastníkov oslavy si nemohla uvedomiť súvislosti .	účastníkov	2	Anim
A po ďalšej minúte sa opäť rozburácal divoký rev davu .	davu	9	Inan
Za opáta Odona , Bernonovho nástupcu , sa potom vytvorili predpoklady , aby sa Cluny stalo strediskom skupiny kláštorov .	predpoklady	10	Inan
“ Kvak , “ zvolala na krtka žaba , “ počkaj , pomôžem ti .	krtka	6	Anim
V sobotu doobeda odstraňovala deficit spánku , ktorý sa nahromadil za celý týždeň .	týždeň	12	Inan
Koncepciu Slovenských večerov vymyslel Igor Medlen , vtedajší tajomník Folklórneho festivalu vo Východnej .	večerov	2	Inan
Vláda zabezpečí zavedenie elektronického podpisu .	podpisu	4	Inan
“ Mhm , nehovorte tak , “ namietal lúčny koník Flip .	koník	9	Anim
Vláda prijme strednodobý komplexný programový dokument rozvoja regiónov , zabezpečí prípravu , prerokovanie a schválenie plánovacích a programových dokumentov v oblasti regionálnej politiky s dôrazom na zlepšenie ekonomickej a sociálnej súdržnosti a prehĺbi uplatňovanie princípu partnerstva .	regiónov	7	Inan
Hlavu si oprela o jeho rameno a príjemná vôňa jej vlasov zahnala zápach holubieho trusu .	vlasov	10	Inan
Začali sme na kolotočoch , kde sme vyliezli na koňa .	koňa	9	Anim
Nato dostal Rudko správny nápad !	nápad	4	Inan
Zaštebotal dobrý deň a cmukol mužovi na líce veľký uslintaný bozk .	mužovi	5	Anim
Jasajúci diváci ho odniesli na pleciach domov .	diváci	1	Anim
Za veľkými stolmi sedeli princovia a šľachtici .	princovia	4	Anim
Ich bojový pokrik prilákal spústu divákov .	pokrik	2	Inan
Rozzúreného Šuchtáka vystrieda slimák Plazivec a hra pokračuje .	slimák	3	Anim
Nerob zo seba hlupáka , povedali mi .	hlupáka	3	Anim
Ako s kamošom .	kamošom	2	Anim
Pre potreby rozvíjajúcej sa cirkevnej organizácie bol na základe tohto štatútu okolo roku 1100 vytvorený štatút nový , ktorý sa stal základným archetypom pre všetky neskoršie odpisy .	odpisy	26	Inan
Keď sa neskôr vracali domov a pozorovali hviezdy , vystrašil ich hrozný krik .	krik	12	Inan
Najprv Maja spoznala dobrého kamaráta , ktorý jej pripadal veľmi zvláštny .	kamaráta	4	Anim
Navyše nepriateľskú osu hral jeho kamarát hnojník Kurt .	hnojník	6	Anim
Dovtedy musí ostať v úkryte vo zvončeku .	úkryte	4	Inan
Hľadala som v zásuvke nejaký papier na poznámky , keď som zbadala formulár na udelenie finančnej podpory počas štúdia na vysokej , ktorý mi dal ešte pred niekoľkými týždňami výchovný poradca pán Hatch .	poradca	30	Anim
Kala pozrela do domu a zbadala stopy po zápase .	domu	3	Inan
“ Podľa mňa by mal mať šofér právo veta , “ navrhol Rýchlik .	šofér	6	Anim
Tatko sa hneval na deti , lebo ukrutne vyvádzali , a mamka sa hnevala na tatka , že je precitlivený .	Tatko	0	Anim
Vláda pripraví legislatívny rámec inštitucionálneho vzdelávania zdravotníckych pracovníkov prostredníctvom rezortu školstva s možnosťou postgraduálnej prípravy pracovníkov v zdravotníctve v školách a inštitúciách , ktoré získajú akreditáciu pre príslušný typ vzdelávania .	pracovníkov	7	Anim
Pochybovačne zdvihla obočie , pozrela na mňa a ďalej vykladala nákup .	nákup	10	Inan
Motýľ Emanuel poletoval kdesi nad lúkami a Makulienka ostala doma sama .	Motýľ	0	Anim
A urobil na dokumente tri krížiky .	dokumente	3	Inan
Tamojší zdravotník i Delina prišli do tej dediny z mesta .	zdravotník	1	Anim
“ Vy ste jasnovidec ? “	jasnovidec	3	Anim
“ Ocko ! “ zvolala Jazmína , keď sultán zmizol .	Ocko	1	Anim
Len spomedzi študentov náročnej školy vzídu študenti , ktorí sa dokážu presadiť v silnej konkurencii .	študenti	6	Anim
Hľadala som v zásuvke nejaký papier na poznámky , keď som zbadala formulár na udelenie finančnej podpory počas štúdia na vysokej , ktorý mi dal ešte pred niekoľkými týždňami výchovný poradca pán Hatch .	pán	31	Anim
Ide opäť o prívesky — amulety .	prívesky	3	Inan
Najťažší trest postihuje opäť kňazov , ktorí sa dopustili bigamie .	trest	1	Inan
Zavalíme ľan kameňom , aby ostal vo vode .	ľan	1	Inan
Celý ďalší týždeň jeho život pripomínal nepokojný sen .	týždeň	2	Inan
Vláda bude nasledovať tieto trendy .	trendy	4	Inan
Máme tu teda ďalší argument pre to , aby sme kánony o celibáte z druhej kolomanovskej synody nepovažovali za prejav úplného príklonu k normám reformného pápežstva .	celibáte	12	Inan
Keď sme dojedli a mama upratala stôl , rodičia hrávali karty .	rodičia	8	Anim
Potom začul ďalší zvuk — ľudské hlasy !	zvuk	3	Inan
Poďakovanie patrí aj posudzovateľom rukopisu – pánovi prof . PhDr . Richardovi Marsinovi , DrSc . a pánovi PhDr . Jánovi Steinhübelovi , CSc . , ktorí mi pomohli vylepšiť text svojimi cennými postrehmi .	pánovi	6	Anim
Polly sa začervenala a hanblivo klapla zobákom .	zobákom	6	Inan
V estónskej rozprávke Hromovládcové gajdy je zasa zachovaný obraz starobylého dualizmu v postavách vládcu hromov Pikneho a vrchného čerta Vanatuhiho .	čerta	18	Anim
Uhorskí zákonodarcovia vytvárali zákony a kánony v prvom rade s ohľadom na konkrétne domáce podmienky a snaženia reformátorov boli pre nich druhoradé .	zákonodarcovia	1	Anim
Prívesky podobného typu boli nájdené vo vladimírskych kurganoch a v Jaroslavli .	kurganoch	7	Inan
“ Vráťte sa , vy zlodeji ! “ hrmel za nimi predavačov zúrivý rev .	rev	13	Inan
Akékoľvek doklady o Fulbertovom ideovom vplyve na Boniperta však chýbajú .	doklady	1	Inan
Keby som dal tie texty Deline , pochopila by , že ich stredobodom je ona .	texty	4	Inan
Zároveň bude vláda zdôrazňovať a vytvárať podmienky na zvyšovanie vedomia zodpovednosti občanov za vlastnú a všeobecnú bezpečnosť .	občanov	11	Anim
PREČ S VEĽKÝM BRATOM !	BRATOM	3	Anim
Nezávislosť sudcov a záruky jej zabezpečenia sú jednou stranou mince .	sudcov	1	Anim
Pred dvermi sa objavovali košíky s prekrásnymi plodmi od výmyslu sveta .	sveta	10	Inan
S kamarátmi do sveta ?	kamarátmi	1	Anim
V širších súvislostiach to zasa podľa nás poukazuje na podobnosť postavenia franských panovníkov a Štefana I . vo svojich štátnych cirkvách .	panovníkov	12	Anim
“ Nech sa ten smiešny plukovník Hatí prepadne ! “	plukovník	5	Anim
Bol som Faikiným rukojemníkom .	rukojemníkom	3	Anim
Preto szabolcsská synoda schválila niekoľko kánonov , ktoré ich mali brániť pred takouto ujmou .	kánonov	5	Inan
Bojoval proti vykorisťovaniu v indickej spoločnosti , proti krviprelievaniu medzi hinduistami a moslimami , proti vojne , za politickú nezávislosť svojej krajiny .	moslimami	12	Anim
So zovretým hrdlom som sa rozhliadol okolo seba .	hrdlom	2	Inan
NAHÁČI POTOPILI TITANIC	NAHÁČI	0	Anim
Pani učiteľka odviedla svoju triedu a predseda motýlieho spolku hovoril niečo o podvode .	spolku	8	Inan
Chlap pochopí , že vlky môžu prísť každú chvíľu .	Chlap	0	Anim
Dlho očakávaná guľka mu vnikla do mozgu .	mozgu	6	Inan
Nastolíme po voľbách zmenu - odhalením zbohatlíkov , mafiánov , delikventov , korupčníkov a lobistov pri stálom sledovaní blaha občana .	občana	19	Anim
Maja s Vilkom poprisili o kúsok smrčka a statočne ho prežúvali , len aby sa zavďačili hostiteľovi .	hostiteľovi	16	Anim
Chrisova mama zabalila chlebíčky po štyroch do plastovej fólie a ešte do alobalu .	chlebíčky	3	Inan
Ani družka , ani sok ho nesledujú . Čo ho núti vysedávať na konári osamoteného stromu a vyludzovať hudbu do prázdna ?	konári	13	Inan
Všetky pôžitky sa zničia .	pôžitky	1	Inan
Poďakovanie patrí aj posudzovateľom rukopisu – pánovi prof . PhDr . Richardovi Marsinovi , DrSc . a pánovi PhDr . Jánovi Steinhübelovi , CSc . , ktorí mi pomohli vylepšiť text svojimi cennými postrehmi .	posudzovateľom	3	Anim
Vláda je pritom presvedčená o nevyhnutnosti zavádzať do rezortu pôdohospodárstva , pri rešpektovaní niektorých špecifík , trhové podmienky a slobodnú konkurenciu .	rezortu	8	Inan
Podľa mňa boli pôvodcami jej stáleho utrpenia muži .	muži	7	Anim
Bežala za veliteľom mravcov a prosila ho , aby vyhlásil po Flipovi pátranie .	mravcov	3	Inan
Predseda našej nadácie mal v tom hoteli raz popoludní tlačovú konferenciu a ja som na ňu pozvala Irmu .	Predseda	0	Anim
Cieľom rekodifikácie trestného práva bude prísnejší postih páchateľov násilných trestných činov a moderný trestný proces , ktorý bude rýchly a efektívny .	páchateľov	7	Anim
Baghíra zatajil dych .	dych	2	Inan
Sergej mi vysvetlil , že tak sa volal jeden hrôzostrašný pes .	pes	10	Anim
Muž bez brady počúvol .	Muž	0	Anim
Jednostaj prichádzali a odchádzali všakovakí väzni : distribútori drog , zlodeji , banditi , šmelinári , opilci , prostitútky .	distribútori	7	Anim
Zodvihol zrak .	zrak	1	Inan
Nazvem ho incidentom s bláznami .	incidentom	2	Inan
Boli sme spojenci .	spojenci	2	Anim
Vzápätí však včielka Maja začula iný hlas , oveľa tichší a jemnejší .	hlas	6	Inan
Ako sedemnásťročný sa stal okresným zakladateľom Antisexuálnej ligy mládeže , ako devätnásťročný navrhol nový druh ručného granátu , ktorý zaradilo do výzbroje Ministerstvo mieru a ktorý už pri prvej skúške jediným výbuchom zabil tridsaťjeden euroázijských zajatcov .	výbuchom	31	Inan
Želám príjemný víkend .	víkend	2	Inan
Súviselo to jednak s už spomenutým rozvinutým fungovaním systému vlastníckych kostolov a kláštorov a jednak s existenciou otónsko - sálskeho ríšskeho cirkevného systému v Nemecku .	kostolov	10	Inan
Duchovné osoby boli ideálnymi parlamenármi , lebo podľa dobových predstáv majú osobitnú ochranu boha pred nebezpečím .	parlamenármi	4	Anim
Škoda , že Tayerle je taký nezáživný profesor , pretože astronómia , ktorú sme tento týždeň preberali , mi pripadala nesmierne zaujímavá .	týždeň	15	Inan
Margin predčasný odchod z tohto sveta som pripravoval ja .	sveta	5	Inan
Mimoriadne škaredú , s mimoriadne škaredým a nepriateľským pohľadom .	pohľadom	8	Inan
Chlapče , tvoje básne páchnu potuchlinou , povedal mi .	Chlapče	0	Anim
" Niekedy , " poznamenala , " pohrozia človeku niečím -- niečím , čomu nedokáže vzdorovať , na čo nedokáže ani pomyslieť .	človeku	8	Anim
Je to veľmi jednoduché , vysvetlil mi doktor .	doktor	7	Anim
Plukovníkovi Hatímu sa zježil chobot .	Plukovníkovi	0	Anim
Takýmito duchmi môžu byť medvede , vlky , zajace , jelene , kačky , orly , sovy a vrany .	zajace	8	Inan
Jednoznačne ide o účelovú mystifikáciu s cieľom zmanipulovať konanie bežného občana a obrať ho o posledné základné životné istoty .	občana	10	Anim
“ Musíme byť ticho , “ šepkal škriatok .	škriatok	7	Anim
O chvíľu ich už viedli k najlepšiemu stolu v záhrade Amirovej slávnej reštaurácie Kebab .	stolu	7	Inan
“ Čo sa s tebou deje , Amy ? “ vypytoval sa ma po pretekoch tréner August a odviedol ma nabok , kým ostatní nastupovali do autobusu .	tréner	15	Anim
I . ostrihomská synoda nariaďuje , že únosca je povinný poskytnúť postihnutým majetkovú kompenzáciu a navyše má vykonať aj pokánie .	postihnutým	11	Anim
Nastolíme po voľbách zmenu - odhalením zbohatlíkov , mafiánov , delikventov , korupčníkov a lobistov pri stálom sledovaní blaha občana .	mafiánov	8	Anim
Za opáta Odona , Bernonovho nástupcu , sa potom vytvorili predpoklady , aby sa Cluny stalo strediskom skupiny kláštorov .	opáta	1	Anim
“ Tak poďme privítať môjho nápadníka . “	nápadníka	5	Anim
u Martina nemám čo do zvonca .	zvonca	5	Inan
Teraz sa v noci budievam zo spánku a hrdlo mi zviera úzkosť : trápi ma nočná mora , že aj ja som v dave , ktorý ženie mamu v ústrety smrti .	dave	23	Inan
Všetci obyvatelia Makovej lúky sa zišli na čistine , kde Rudko poriadal letecké preteky .	preteky	13	Inan
Dodržiaval som toto pravidlo , odkedy som napísal prvú hlúposť z toho cyklu , krátku esej s dlhým názvom Orgazmus alebo Hrôza zo sexuálneho vyčerpania .	cyklu	12	Inan
Zostal som sedieť v kresle , aj keď sa dvere otvorili a do miestnosti vošli dvaja muži , nové tváre .	muži	16	Anim
Zbehom a pútnikom vo filmoch a knihách trvá návrat do rodnej obce neraz celé desaťročia .	Zbehom	0	Anim
Tieto funkcie sú nápadne podobné funkcii kléru na starej Rusi — pri kláštoroch boli útulky pre chorých a existovali dokonca „ kláštorní lekári “ , ktorí spadali do kompetencie cirkevného práva .	kléru	6	Inan
Škriatok , ktorý opustí kvet , má zázračnú moc .	Škriatok	0	Anim
Medzitým zavládol v úli pokoj .	pokoj	4	Inan
Roku 1966 pri vykopávkach v Iľjinskom rajóne bol nájdený stredný trám s tlamou draka .	draka	13	Anim
Winstonovo telo zalial razom na každom kúsku studený pot .	pot	8	Inan
Muž s prenikavým hlasom po jeho ľavici bezohľadne rozprával ďalej .	Muž	0	Anim
Pôsobil tam ako tlmočník a povedal , že keď Angličania pristáli , ich prvou požiadavkou bolo vybudovať poľné WC .	tlmočník	3	Anim
Lúče slnka , ktoré pretínali okno priečne , dopadali na zaprášené dosky stolov .	stolov	12	Inan
Jej vládcov nespájajú pokrvné zväzky , ale príslušnosť k spoločnému učeniu .	vládcov	1	Anim
“ Chcete povedať , že som herec ? “ pýtal sa Pinocchio .	herec	6	Anim
Robili taký rámus , že sa ich rev ozýval široko ‐ ďaleko po celej džungli .	rev	7	Inan
Sama zájdem do chalúpky k siedmim trpaslíkom .	trpaslíkom	6	Anim
Vzápätí však na votrelcov zaútočili svietniky , vešiaky , skrine , hodiny a riad .	riad	13	Inan
Po štyroch dolároch starec zjavne pookrial .	dolároch	2	Inan
Potom zlezie zo stromu a uteká domov . . .	stromu	3	Inan
Šesť perzských žonglérov zasa hádzalo nožmi .	žonglérov	2	Anim
Pri tom seriáli by som dnes nevydržala .	seriáli	2	Inan
Tentoraz by mohol pripomenúť pamiatku súdruha Ogilvyho .	súdruha	5	Anim
Nočný strážnik Vilko	strážnik	1	Anim
Odhrnula som mokré plavky , prázdne kokakolové plechovice , ceruzky , listy vytrhnuté z notesa a knižku Kto chytá v žite so somárskymi ušami .	notesa	14	Inan
Žiaden z pápežov pred Gregorom VII . nešiel do priamej konfrontácie s najvyšším reprezentantom svetskej moci .	reprezentantom	13	Anim
V období vzniku uhorskej cirkevnej organizácie problém , či si uhorský kráľ uzurpoval práva prináležiace Apoštolskému stolcu , ešte nehral rozhodujúcu úlohu .	stolcu	16	Inan
Tak sa učili variť , robiť jednoduché kuchynské práce ako umývanie riadu , škrabanie zemiakov , krájanie chleba .	riadu	11	Inan
Abu mal aj nový fez so strapcom .	strapcom	6	Inan
Ak drží grifon v pazúroch štyri púčky , vyjadruje sa tým jeho všadeprítomnosť .	pazúroch	4	Inan
Milí konfirmandi , dnes sa stanete dospelými členmi nášho cirkevného zboru .	členmi	7	Anim
Vláda podporí rozvoj základného a aplikovaného výskumu na vysokých školách ako nevyhnutnej podmienky na poskytovanie kvalitného vysokoškolského vzdelávania a na zabezpečenie dlhodobo udržateľného rozvoja spoločnosti .	výskumu	6	Inan
Tu dávam povely ja ! “	povely	2	Inan
Vybrala peňaženku a znova ju dala do plecniaka .	plecniaka	7	Inan
Z Odilonovho listu Štefanovi I . sa dozvedáme , že clunyjský opát a prvý uhorský kráľ boli vo vzájomnom styku už pred odoslaním tohto listu vzniknuvšieho medzi rokmi 1031 – 1038 .	opát	11	Anim
Vláda uplatní rovnaký postup pri priznávaní štátnej pomoci a zriadi register prijímateľov štátnej pomoci a register prijímateľov iných investičných stimulov .	prijímateľov	16	Anim
Istý zmysel v ňom nachádzali moji neprajníci .	neprajníci	6	Anim
Drobná žena s pieskovými vlasmi zružovela a ústa otvárala a zatvárala ako ryba na suchu .	vlasmi	4	Inan
“ Držím ti palce , Amy , “ povedal s úsmevom , ktorý by roztopil i ľad .	ľad	16	Inan
Zámerom je dostať všetkých záujemcov do blízkosti rómskej lokality .	záujemcov	4	Anim
Ostrihomská synoda tiež zakázala , aby bol za kňaza vysvätený otrok ( sluha ) .	sluha	12	Anim
Teraz ma prenasledovatelia chytia , pomyslel si Ferdo .	prenasledovatelia	2	Anim
Na obidvoch stranách ulice , kde sa chodci náhlili po chodníkoch , parkovali autá .	chodci	7	Anim
Opäť zdvihol zrak na portrét Veľkého brata .	brata	6	Anim
Nastolíme po voľbách zmenu - odhalením zbohatlíkov , mafiánov , delikventov , korupčníkov a lobistov pri stálom sledovaní blaha občana .	delikventov	10	Anim
Stretol by som sa tam so slovom „ anonym “ .	anonym	8	Anim
V tomto podniku si nemôžem dovoliť luxus v podobe ďalšej whisky , ani keby som išiel dušu vypustiť .	luxus	6	Inan
Srdce ťa ešte stále ťahá k oldspeaku s celou jeho neurčitosťou a zbytočnými významovými odtieňmi .	oldspeaku	6	Inan
Keď zazneli prvé tóny pomalej skladby , rozhodla som sa , že za ním pôjdem .	tóny	3	Inan
Zrazu od úžasu onemela .	úžasu	2	Inan
Človek nikdy nevie , na čo natrafí .	Človek	0	Anim
Opäť ho premohol pocit bezmocnosti .	pocit	3	Inan
Keby som ich mohla premeniť na chrobáky , obidvoch by som bez štipky milosrdenstva zabila .	chrobáky	6	Inan
Na jej mieste bol neskôr založený kláštor sv . Nikolaja .	kláštor	6	Inan
Závidela som chalanom , tí sa majú .	chalanom	2	Anim
Sitek považuje za partnera KDH	partnera	3	Anim
A urobil na dokumente tri krížiky .	krížiky	5	Inan
Po štyroch dolároch starec zjavne pookrial .	starec	3	Anim
Fakt spomínaný oboma bádateľmi .	Fakt	0	Inan
Krk by som ti zlomil ako mrkvu .	Krk	0	Inan
Nálezy pečatí umožňujú určiť autorstvo , pravosť a čas vzniku dokumentu , dopĺňajú tak informácie o ňom .	Nálezy	0	Inan
Prišiel na preteky ako skokan .	skokan	4	Anim
Motýľ sa opäť zasmial .	Motýľ	0	Anim
Netrvalo dlho a nad jaskynkou sa zachvel list , spod ktorého vyliezol prečudesný chrobák .	chrobák	13	Anim
Nakukol pomedzi húštinu a uvidel troch tvorov v šatách namiesto kožušiny .	tvorov	6	Anim
A , prosím ťa , nalej mi ešte raz do tohto pohára !	pohára	11	Inan
Na Jazmínino prekvapenie predavač vytiahol obrovský ostrý dlhý nôž .	predavač	3	Anim
Do minúty zhorí na popol .	popol	4	Inan
Na vrchole pyramídy stojí Veľký brat .	brat	5	Anim
Vilko s Majou doleteli na lúku s koňmi .	koňmi	7	Inan
Zmienky o skúmanom fenoméne .	fenoméne	3	Inan
Večer vhupli všetky včielky do postieľok a vytiahli si deky až pod nos .	nos	12	Inan
Bronzová čaša , zdobená rúčkou s vtáčikom pripomína uctievanie vtákov u ugrofínskych národov — ak karelský poľovník zabil vtáka čakalo ho nešťastie .	poľovník	16	Anim
Čudné veci rozprávala Petronila o ľuďoch .	ľuďoch	5	Anim
Najviac ma rozptyľovalo , že mi celý deň behal po rozume ten bozk .	rozume	10	Inan
Vyvesili na tabuľu text , ale ani to nepomohlo , lebo Vilko sa z lenivosti nenaučil dobre čítať .	text	3	Inan
“ Urobil si veľkú a hlúpu chybu , priateľko . “	priateľko	8	Anim
Neviditeľní jazdci na koňoch sú vyjadrením predstavy o zlých duchoch , schopných ubližovať človeku odnesením jeho duše do podsvetia .	človeku	13	Anim
Dobre som poznal mená všetkých dobových talianskych spevákov aj všetkých futbalistov .	spevákov	7	Anim
“ Si náš hrdina , Aladin . “	hrdina	3	Anim
“ Bude z teba čertovsky dobrý boh ! “	boh	6	Anim
„ Čas , v ktorom žijem , viem , že je Tvojím darom .	Čas	1	Inan
Niekoľko dvojíc tancovalo , iní sa bavili pri stoloch a bolo tam veselo i príjemne .	stoloch	8	Inan
Toto je môj malý opičiak Abu . “	opičiak	4	Anim
“ Mimochodom , “ poznamenal chrobák , “ zabudol som sa predstaviť .	chrobák	5	Anim
Obrázkovým telefónom som zavolal kováča Kováčika a ten bez dlhých rečí koníka okoval .	koníka	11	Anim
" Ste pripravení obetovať svoje životy ? "	životy	5	Inan
S tým však moja okamžitá strata optimizmu nesúvisí , a nesúvisí ani so skutočnosťou , že predstava takého scenára bola nezmyselná .	scenára	18	Inan
Adresátom jej listov bol otec , a ten sedel vo väzení .	Adresátom	0	Anim
Vláda Slovenskej republiky prizýva spoluobčanov k spolupráci .	spoluobčanov	4	Anim
Po dlhom období dažďov vykúklo opäť slniečko .	dažďov	3	Inan
Skôr ako som prešiel okolo neho , otočil sa mi chrbtom .	chrbtom	10	Inan
Zdravotníkovi som dal meno Vehap a črty ošetrovateľa .	ošetrovateľa	7	Anim
Krtko sa rozosmial .	Krtko	0	Anim
Ide opäť o prívesky — amulety .	amulety	5	Inan
Do tejto kapitoly sme zahrnuli problematiku vzájomných vzťahov a kompetencií medzi laikmi a cirkvou .	laikmi	11	Anim
Mauglí so supmi sa smiali , keď im tiger zmizol z dohľadu .	supmi	2	Inan
“ A čo ten pouličný potkan ? “ spýtal sa Džafar .	potkan	5	Anim
Tak znie neodvolateľné proroctvo o osude jeho umenia .	osude	5	Inan
Starec ihneď pookrial .	Starec	0	Anim
Pri stene bola posteľ , na stole lampa s hlboko stiahnutým tienidlom .	stole	6	Inan
Ani družka , ani sok ho nesledujú . Čo ho núti vysedávať na konári osamoteného stromu a vyludzovať hudbu do prázdna ?	sok	4	Anim
Podľa princípu siedmich slobodných umení prvým stupňom trivia je gramatika .	stupňom	6	Inan
Baghíra ich sledoval , kým mu nezmizli z dohľadu .	dohľadu	8	Inan
V ten večer asi vedela , že je to naše posledné stretnutie .	večer	2	Inan
I . ostrihomská synoda rieši sčasti aj otázku práv a povinností opáta .	opáta	11	Anim
Winston usúdil , že nepostačí iba zmeniť zmysel prejavu Veľkého brata .	brata	10	Anim
Tak tomu hovorím názorný príklad fungovania zóny najbližšieho vývinu , o ktorej som písala minule !	vývinu	8	Inan
My sme mravce smelé , my sa nezľakneme .	mravce	2	Inan
“ Mal som iba dvoch zákazníkov , ženu a muža .	zákazníkov	5	Anim
Keď sa ku mne sklonila , že ma pobozká , zacítila som pach alkoholu .	pach	12	Inan
Telo by malo mať šiju Jenny Elfman , ramená Courtney Love , zadok Jennifer Lopez , pupok Sandry Bullock a nohy Miry Sorvino .	pupok	16	Inan
Celkové dojmy z výletu ?	dojmy	1	Inan
Dlho som sedel pred tým plným pohárom .	pohárom	6	Inan
Alfonz bez slova zmizol za záhradným plôtikom .	plôtikom	6	Inan
Smutné včielky sedeli pri raňakjách , na stole chýbal tanier s medom .	stole	7	Inan
Vláda bude venovať pozornosť aj ďalším súčastiam slovenskej zahraničnej politiky , medzi ktoré patria viaceré oblasti dvojstrannej a mnohostrannej diplomacie , otázky ľudskej dimenzie , ekonomický rozmer diplomacie , optimalizácia zahraničnej služby .	rozmer	26	Inan
V ten večer som štyri hodiny písala prácu o intimite .	večer	2	Inan
Ekonomické a inštitucionálne nástroje	nástroje	3	Inan
Po príchode „ trestnej výpravy “ však nepokoje už opadli a všetko bolo v poriadku — no príchodzích museli kolonisti živiť .	príchodzích	17	Anim
Drsný koniec srbského " partizána "	partizána	4	Anim
A odišla , stratila sa v dave .	dave	6	Inan
Lenže ten príbeh musel dopísať .	príbeh	2	Inan
V lese som krok za krôčikom snoril pod krami a pod kameňmi .	kameňmi	11	Inan
Môže ísť o toporčeky s predĺženým poriskom , ktoré boli v Škandinávií predmetom symbolizujúcim hromy vrhajúceho Thora .	hromy	14	Inan
Príčiny ochorenia úzko súvisia s nezdravým životným štýlom , svoju významnú úlohu zohrávajú alkohol , fajčenie , nedostatok pohybu , nadváha a obezita , stres , poprípade nedostatok zdravých potravín .	nedostatok	17	Inan
S chrobákmi .	chrobákmi	1	Inan
U ugrofínskych národov fungoval orol ako predok a ochranca šamanov .	ochranca	8	Anim
Ústrednou postavou poviedky aj filmu bola Delina , dedinská učiteľka .	filmu	4	Inan
“ Pozor ! “ zvolal jeden z chrobákov .	chrobákov	7	Anim
Stranu nezaujímajú konkrétne činy : my si potrpíme len na myšlienky .	činy	3	Inan
Oblečené mala nohavice a rolák .	rolák	4	Inan
Prítomnosť nálezov kačacích príveskov sa vysvetľuje tiež importom zo Škandinávie , prostredníctvom nápodoby laponských a karelských kovolejárov .	príveskov	3	Inan
Nechýbali vrúcne kontakty , dlhé lúčenie a pozvanie na ďalšie stretnutie .	kontakty	2	Inan
Má netradičnú grafickú podobu a svojimi malými rozmermi sa zmestí do každej tašky a ku každému počítaču .	počítaču	16	Inan
Jej učiteľka Kasandra hovorila o ľuďoch oveľa prívetivejšie .	ľuďoch	5	Anim
Nehodilo sa mi do " krámu " .	krámu	5	Inan
Kalich zvončeka , kde strávila noc , sa knísal vo vetre a bolo tam chladno .	zvončeka	1	Inan
Dôležitejším znakom oboch kategórií šamanov je , že úspech ich činov nezávisí od toho , akú obetu bohu prinesú , ale od toho v akom vzťahu sú oni sami s bohmi — tj . od ich schopností .	bohmi	30	Anim
Netrvalo dlho , a policajti prišli do kaviarne zatknúť zlodeja .	zlodeja	9	Anim
Ako prírodovedci sme to stále málo schopní definovať .	prírodovedci	1	Anim
Ale vlasy mu vstanú dupkom , keď si všimne niečo iné : trochu ďalej na konári , kam sa vyštveral , sedí medveď , ktorý tam vyliezol .	medveď	22	Anim
Keďže sa prvýkrát vyskytuje počas Jaroslavovho námestníctva v Novgorode , nie je vylúčená možnosť nápodoby všemocného novgorodského vodného jaštera .	jaštera	18	Anim
V nasledujúcej chvíli nastal obrovský rozruch .	rozruch	5	Inan
V jednom kuse táral o Týždni nenávisti .	kuse	2	Inan
Následky nárazu bývali rovnako kruté .	nárazu	1	Inan
Potom sa návštevník obrátil k rámu , kde bol otec .	návštevník	2	Anim
Cvrčkovia dali signál a diváci celkom zmĺkli .	diváci	4	Anim
Posledný kánon II . kolomanovskej synody o celibáte sa svojím obsahom vymyká prísnejšiemu tónu uznesení tohto cirkevného snemu .	snemu	17	Inan
Aladin pritiahol stoličky a psi na ne vyskočili .	psi	4	Anim
“ To tvrdí každý obžalovaný , “ odporoval sudca .	sudca	8	Anim
Pri slávnostných obradoch ju potom niesol jej najuznávanejší člen .	obradoch	2	Inan
Prvým výskumníkom , zaoberajúcim sa novgorodskými pečaťami bol P . Lichačev , ktorý do roku 1917 objavil šesťsto kusov .	výskumníkom	1	Anim
Vždy povstali noví a noví zadubenci , ktorí sa mu dali zviesť .	zadubenci	5	Anim
" Potkan .	Potkan	1	Anim
Bronzová čaša , zdobená rúčkou s vtáčikom pripomína uctievanie vtákov u ugrofínskych národov — ak karelský poľovník zabil vtáka čakalo ho nešťastie .	vtáčikom	6	Anim
Na zlepšenie komunikácie s verejnosťou sa zavedú pravidelné stretnutia funkcionárov polície s občanmi .	funkcionárov	9	Anim
Začiatkom týždňa sme písali ďalší test a profesor Tayerle nám ho dnes priniesol opravený .	týždňa	1	Inan
“ Dostanem najjemnejší hodváb .	hodváb	3	Inan
“ Môžem byť vaším kapitánom ? “ spýtala sa .	kapitánom	4	Anim
Keď som v dráhe zastala a šliapala vodu , zabrzdila som ostatných plavcov .	plavcov	12	Anim
Nejedno dieťa už vytklo s bolesťou svojim rodičom : Vy ste na vine , že som sa dostal na zlú cestu , lebo vy sami ste nebrali Ježiša vážne a neviedli ste ma k Nemu .	rodičom	7	Anim
Tyranizuje nás ťaživou krásou obrazov .	obrazov	4	Inan
Pinta je predsa polovica štvrtky a štyri štvrtky idú do galóna .	galóna	10	Inan
Avšak rodine malého paviána sa nepáčilo , ako sa Jane správa k ich mláďaťu a nazlostení začali dievčinu prenasledovať .	paviána	3	Anim
Spomínala na všetkých kamarátov i na to , ako mohla byť aspoň na chvíľočku kapitánom mravcov .	kapitánom	14	Anim
Na jednom z programov Českej televízie sa momentálne dá vidieť skvelá séria ľahkých , avšak nebulvárnych reportáží zo života s názvom Ta naše povaha česká .	programov	3	Inan
Nie je to môj odbor .	odbor	4	Inan
Winston dojedol chlieb so syrom .	syrom	4	Inan
Bratia Badunovci ustráchane prikývli .	Bratia	0	Anim
Vláda zlepší súčasný stav nedostatočnej ochrany slovenského spotrebiteľa a výrobkov vyrábaných na území SR .	spotrebiteľa	7	Anim
Zúril , až mu vlasy dupkom stáli .	vlasy	4	Inan
Spravované prostriedky poistencov dosahujú objem 200 mil .	poistencov	2	Anim
Ten bozk znamenal nové prísľuby .	prísľuby	4	Inan
O kulte jaštera svedčia už spomenuté rúčky čiaš .	jaštera	2	Anim
Svätoštefanská legislácia predpokladá , že veriaci budú v nedeľu chodiť do kostola .	veriaci	5	Anim
Pristáli sme u slimáka Oskara .	slimáka	3	Anim
Na Makovej lúke sa nič nedialo , a tak zamierila do lesa .	lesa	11	Inan
Celý svet vyvalí oči , keď Belu a Gastona zbadá taký pár málokde zočí , krásavci jedna balada .	krásavci	15	Anim
Vonku sa ozýval bzukot a cvrlikanie , všade poletovali motýle a slniečko krásne prehrievalo zem .	bzukot	3	Inan
Štyridsať dva takýchto odliatkov bolo poslaných do Moskvy , kde ich skúmal I . A . Ščepkin , autor prvej práce o nich .	autor	18	Anim
Primátor Komárna Štefan Pásztor po svojej sekretárke odkázal SME , že sa k problému nevyjadrí .	problému	13	Inan
V lese som krok za krôčikom snoril pod krami a pod kameňmi .	krok	3	Inan
Ľudstvo svojou usilovnosťou prispelo k zrodu dvoch svetových vojen , ba v niektorých kútoch Zeme vojny pokračujú .	zrodu	5	Inan
Kráčal som za ním po tichej chodbe nemocničného pavilónu a ani som si nevšimol , že Irma nie je s nami .	pavilónu	8	Inan
Pod jeho lakťom bol dievčí pás mäkký a teplý .	lakťom	2	Inan
Alan Smithee je meno , ktoré sa používa v titulkoch , keď ražisér z rôznych príčin nesúhlasí s uvedením vlastného mena .	ražisér	12	Anim
Možno " priateľ " nebolo správne slovo .	priateľ	2	Anim
Poletím za tebou , “ povedal Vilko , obrátil sa na bok a zaspal .	bok	11	Inan
Marginým svätcom bol taliansky spevák Gianni Morandi , mojím Angličan Tom Jones .	spevák	4	Anim
Vláda si uvedomuje obsah svojho mandátu od voličov .	voličov	7	Anim
Na Sibíri bol medveď ústredným hrdinom zvieracieho eposu .	medveď	3	Anim
“ O chvíľu príde lejak .	lejak	4	Inan
Vytvoríme kapitálotvornú vrstvu , ktorá bude zárukou blaha ľudu , presvedčivo hlásal tvorca blaha svojich prívržencov .	ľudu	8	Inan
Wilsher , blondiak s nasprostastým výrazom na tvári , ktorého takmer nepoznal , ho s úsmevom pozýval na voľné miesto pri svojom stole .	blondiak	2	Anim
Jaro nebol bohém .	bohém	2	Anim
“ Aký milý chlapec to býval . “	chlapec	3	Anim
Jazz , blues , rock , funk .	funk	6	Inan
Ľubomír Ďurovič profesor slovanských jazykov	jazykov	4	Inan
Ale ani pre myšiaka sa všetko neskončilo .	myšiaka	3	Anim
Šéf vypustil dušu vo chvíli , keď dosiahol orgazmus , a ona sa nemohla zbaviť prežitej hrôzy .	Šéf	0	Anim
Na tejto biblickej platforme stojí dnes mnoho významných svetových vedcov .	vedcov	9	Anim
Sú to zbojníci a ničomníci .	zbojníci	2	Anim
Sviečky som vložila do mosadzných svietnikov a postavila ich na stôl .	stôl	10	Inan
Ferrari a McLaren majú konkurenta - Williams	konkurenta	4	Anim
Ešte nikto nikdy Veľkého brata nevidel .	brata	4	Anim
Začínam byť vážne neznesiteľný snob .	snob	4	Anim
A po rozlúčke s ním som mal zvláštny pocit .	pocit	8	Inan
Obyčajne majú väčší objem ako klasické karimatky .	objem	3	Inan
Ale sukničku s volánikmi horko ‐ ťažko uniesla .	volánikmi	3	Inan
Jednostaj prichádzali a odchádzali všakovakí väzni : distribútori drog , zlodeji , banditi , šmelinári , opilci , prostitútky .	zlodeji	10	Anim
Po rokom 1044 sa nachádza správa o narodení Vseslava , ktorému matka na radu volchvov uviazala amulet , spôsobiaci že z chlapca vyrástol krutý a nemilosrdný človek .	chlapca	21	Anim
Hlavu si oprela o jeho rameno a príjemná vôňa jej vlasov zahnala zápach holubieho trusu .	trusu	14	Inan
S akýmsi údivom mi povedala , že som bohatý .	údivom	2	Inan
A uzlovým bodom všetkých právnych formúl , ktoré sa týkajú rozoberaných hnutí , je vzťah tohto spoločenstva k štátnej moci , t . j . stret sveta šamanistického dualizmu s predstaviteľmi kniežacej moci , zjednocujúcimi krajinu .	predstaviteľmi	30	Anim
Vlci sa zhromaždili na Veľkej skale .	Vlci	0	Anim
A bodliak Makulienku i motýľa Emanuela radšej pustil .	motýľa	4	Anim
ODCHODY A návraty ĽUBOMÍRA Ďuroviča ( I . )	návraty	2	Inan
Cieľom fiškálnej politiky vlády bude zníženie podielu verejného dlhu na hrubom domácom produkte počas volebného obdobia .	produkte	12	Inan
Tým bola narušená klasická štruktúra ruského mesta s oddeleným posadom a hradiskom .	posadom	9	Inan
Rad sa predlžoval a čoskoro poskakovala po telocvični polovica študentov .	študentov	9	Anim
Jeden postreh za všetky .	postreh	1	Inan
V istom zmysle to bol začiatok mojej manželskej nevery .	zmysle	2	Inan
Skupina kánonov I . ostrihomskej synody sa venuje stanoveniu obsahu bohoslužieb a príbuzným kultovým predpisom .	kánonov	1	Inan
Chlapec sa naskutku rozplakal .	Chlapec	0	Anim
Newspeak bol oficiálnym jazykom Oceánie , vytvorený kvôli ideologickým potrebám angsocu , teda anglického socializmu .	angsocu	10	Inan
Okolo nej , nad ňou i pod ňou boli ďalšie davy pracovníkov s nepredstaviteľným množstvom úloh .	pracovníkov	11	Anim
Prichádzali sme zozadu , a tak sme sa vyhli autobusom , autám a nápisom nad vstupom .	vstupom	15	Inan
„ Čas , v ktorom žijem , viem , že je Tvojím darom .	darom	12	Inan
Odtrhol rožtek balíčka .	rožtek	1	Inan
Tekla vychrlila niekoľko oplzlých pavúčich nadávok , ale na silného Chrabroša si netrúfla , a tak kľajúc zaliezla pod vädnúci list .	list	20	Inan
Strana , samozrejme , vyhlasovala , že oslobodila proletov z jarma .	proletov	8	Anim
Podľa toho , čo mi hovorili známi , som sa mal teraz skvele .	známi	6	Anim
V Gregorovom ponímaní by to znamenalo komendovanie Uhorska sv . Petrovi , ktorého nástupca by vládcovi krajiny udelil kráľovskú korunu .	vládcovi	15	Anim
Oslík zahol do jednej z ulíc .	Oslík	0	Anim
Mladík sa zapýril .	Mladík	0	Anim
Nastolíme po voľbách zmenu - odhalením zbohatlíkov , mafiánov , delikventov , korupčníkov a lobistov pri stálom sledovaní blaha občana .	lobistov	14	Anim
Pred domom kuny Chytráčky viali pestré slepačie perá , Alfonz vystavoval lesklú kukuricu a kliešťak Drakula voňavé krvavé klobásky .	kliešťak	14	Anim
Vláda pripraví program zameraný na ekonomický rozvoj , v rámci tohto programu vypracuje podprogramy pre jednotlivé sektory .	program	2	Inan
Ako sa princ blížil k palácu , Kráľovná zla mu postavila do cesty múr z tŕňových krov .	múr	13	Inan
Nastolíme po voľbách zmenu - odhalením zbohatlíkov , mafiánov , delikventov , korupčníkov a lobistov pri stálom sledovaní blaha občana .	korupčníkov	12	Anim
Preletela na list toho neznámeho tvora a sadla si vedľa neho .	tvora	5	Anim
Zároveň sa ale postupne menilo aj ponímanie zločinu a trestu .	zločinu	7	Inan
“ Kedykoľvek , “ odvetil Chris s úsmevom , zvrtol sa a plával k trénerovi .	úsmevom	7	Inan
Na utierke ostala svetielkujúca zelená farba a na všeobecné prekvapenie stál pred nimi pavúk Karol .	pavúk	13	Anim
Zaujal výberom tém aj ich spracovaním .	výberom	1	Inan
Dvojtvárnosť trickstera súvisí s celkovým dualizmom , prítomným v systéme prírodného polyteizmu .	polyteizmu	11	Inan
" Niektoré z nových trendov sú veľmi dômyselné .	trendov	4	Inan
Vláda predloží zákon o zdravotníckych povolaniach a zariadeniach definujúci úlohy poskytovateľov a zdravotníckych pracovníkov .	poskytovateľov	10	Anim
Čašníci ich obskakovali , akoby patrili do kráľovskej rodiny .	Čašníci	0	Anim
Plukovník Hatí sa zlostne zamračil .	Plukovník	0	Anim
“ Prosím vás pekne ! “ zvolal lúčny koník Flip .	koník	8	Anim
Pochutnával si na hurkách kliešťaka Drakulu a pritom nahlas mľaskal .	kliešťaka	4	Anim
Poprosil som čašníka , aby mi priniesol koňak , dvojitý .	čašníka	2	Anim
Neváhal a rozhádzal všetky kamene , zničil všetky znamenia .	kamene	4	Inan
Vedel , že to tak nie je , jej vzrušenie , keď mu podávala odkaz , bolo príliš skutočné .	odkaz	14	Inan
Hral v tom filme hlavného hrdinu .	hrdinu	5	Anim
Vládol tam smiech , spev a veselie .	smiech	2	Inan
Keby som tade išiel ako dieťa , určite by som mal chuť zavolať kamarátov z dvora a ísť sa tam hrať „ dole - dole “ .	kamarátov	13	Anim
Ide o akciu , ktorá je v slovenskom kontexte unikátna .	kontexte	8	Inan
Nad fotografiou bol titulok Dvaja Albánci v putách ruského Interpolu .	titulok	3	Inan
Marga odchádzala , strácala sa v dave , autobus ju viezol do ktorejsi dediny v nížine .	autobus	8	Inan
V úvode pasáže volchvi symbolizujú bielych šamanov , vysporiadávajúcich sa s čiernymi šamanmi .	šamanmi	12	Anim
Zrýchlil sa mi pulz a spomenula som si na sen , v ktorom ma bozkával .	pulz	3	Inan
Starec zrejme zabudol na predsudky , ktoré mal proti celému litru .	Starec	0	Anim
Prísny , spravodlivý a efektívny výber daní a odvodov bude jedným zo základných predpokladov znižovania ich sadzieb .	odvodov	8	Inan
Keď oheň začal slabnúť , drkotali mi zuby .	oheň	1	Inan
Podľa N . M . Tichomirova ide len o označenie ich sociálneho postavenia , my však vyslovujeme domnienku , že ide o pozostatok matriarchátu , zvlášť silného u ugrofínskych plemien .	pozostatok	22	Inan
Ukazuje sa teda , že tým stredoslovenským nárečím , ktorÉ Štúrovci povýšili na spisovný JAZYK , bol prestížny liptovský mestský jazyk .	JAZYK	14	Inan
Navrhli im , že ak chcú prežiť v nových podmienkach trhového hospodárstva , môžu predávať po tiranských chodníkoch cigarety alebo banány .	chodníkoch	17	Inan
Pritom je známe , že remeslo kováčske bolo spájané s magickými šamanskými praktikami u mnohých národov — kováč a šaman sú z jedného rodu hovorí jakutské príslovie .	kováč	17	Anim
Ale aj hlupáci a blbci vedia na seba vziať rôznu podobu .	hlupáci	2	Anim
Keď Maja začula žalostný nárek muchy , zabudla na strach pred žabami .	nárek	4	Inan
“ Ide sa na štadión .	štadión	4	Inan
“ Žobrákov nekŕmime , “ povedal sluha .	sluha	6	Anim
Je to chronologicky prvá zbierka , ktorú zostavil neznámy autor z rímskych reformných kruhov .	kruhov	13	Inan
Postupne mu však ten príval hudby vyhnal z mysle všetky špekulácie .	príval	4	Inan
Takže teraz veľmi čakám , či niekto z mienkotvorných hláv Bútorovho elektorátu urobí sebakritickú analýzu tohto svojho fatálneho politického omylu .	elektorátu	11	Inan
Pri štvrtej obrátke sa mi stužka s kľúčikom z krku vyvliekla .	kľúčikom	7	Inan
Vláda urýchli a finančne posilní zákonom regulovaný proces vysporiadania vlastníctva pôdy a pripraví komasáciu a proces definitívneho doriešenia vydávania náhradných pozemkov .	zákonom	5	Inan
Doktor zostal v rozpakoch .	Doktor	0	Anim
Posledný szabolcsský kánon , ktorý sa venuje kláštornému životu nariaďuje opátom a mníchom , aby sa nezúčastňovali na kalendových sedeniach , ale aby prijímali oblácie ich účastníkov v kláštoroch .	mníchom	12	Anim
Napokon sme z kríkov vybrali Chrisov bicykel a pomaly sme vyšli na ulicu .	bicykel	6	Inan
Chceš povedať , že Amy Wyseovej sa páči nejaký chalan ?	chalan	9	Anim
List Polikarpa igumenovi Pečorského kláštora Akindinovi .	igumenovi	2	Anim
Na stole ležala strieborná tabatierka .	stole	1	Inan
Vari dnešní otcovia národa často nevravievajú , že naša milovaná vlasť je banánová republika ?	otcovia	2	Anim
Zavedenie inštitútu manažéra súdu zníži počet funkcionárov súdov , ktorí obmedzene vykonávajú súdnictvo .	súdu	3	Inan
Keď leteli okolo sladko rozvoniavajúceho jazmínového kra , neodolali a sadli si naň .	kra	6	Inan
Musí to byť nejaký omyl .	omyl	4	Inan
Zabezpečia to baterky s pogumovaným povrchom .	povrchom	5	Inan
Vládol tam smiech , spev a veselie .	spev	4	Inan
Omar ležal rozvalený na gauči .	gauči	4	Inan
Z pskovských nálezov sú zaujímavé predovšetkým amulety — zajace , objavené v Gdovskej mohyle .	nálezov	2	Inan
“ Tak ma polej , “ povedal ľan .	ľan	7	Inan
“ Chŕŕŕŕŕ ! “ zachrčal netvor , keď sa mu šíp zaryl do chrbta .	netvor	5	Anim
Na okraji makového poľa sedel motýľ s malým oranžovým cylindrom na hlave .	okraji	1	Inan
Obrovský panter zdvihol košík a opatrne ho položil na breh .	panter	1	Anim
Hneď na úvod som urobil niečo veľmi nerozumné : dal som si dvojitý koňak .	koňak	13	Inan
Prečo sa potom letopisec zaoberá ešte akýmsi medveďom ?	letopisec	3	Anim
Zároveň sa pred mojím duševným zrakom naraz objavilo dievčatko .	zrakom	5	Inan
Do cely vošiel mladý dôstojník s chladnou tvárou .	dôstojník	4	Anim
Slovo „ idiot “ mi uviazlo v hrdle .	idiot	2	Anim
BOH JE MOC	BOH	0	Anim
Spomínala na všetkých kamarátov i na to , ako mohla byť aspoň na chvíľočku kapitánom mravcov .	kamarátov	3	Anim
Chris šiel za mnou ako prítulný psík .	psík	6	Anim
Zaujímavý je v tejto súvislosti nález z vykopávok z roku 1960 z Iľjinej ulice .	nález	5	Inan
Šľahali okolo nej , no zakaždým ju o vlások minuli .	vlások	8	Inan
Cvrčkovia dali signál a diváci celkom zmĺkli .	signál	2	Inan
Jedného dňa stretla na malinčí čudného tvora .	tvora	6	Anim
Dane a odvody	odvody	2	Inan
Prikázal dopravnej čate , aby ju premiestnila , ale keďže bola veľmi ťažká , robotníci ju občas postavili na zem .	robotníci	14	Anim
“ Ale to som predsa nechcela ! “ zvolala Lienka , keď predseda súdu vyhlásil rozsudok .	predseda	12	Anim
Nechal som televízor zapnutý a privliekol som sa k dverám bytu .	bytu	10	Inan
“ Veď Rahim povedal , že spolu urobíme obchod .	obchod	8	Inan
Cítil som sa ako vidiečan , ktorý prvýkrát prišiel do hlavného mesta .	vidiečan	4	Anim
Skvelá novinka pre fanúšikov hororej klasiky z roku 1973 .	fanúšikov	3	Anim
V noci sa voľne pohybovali dedinské psy a ja som sa ich bál na smrť .	psy	6	Inan
Vláda prehodnotí systém výkonu správy súdov , ktorý príliš zaťažuje sudcov administratívnymi činnosťami , osobitne pri štátnej správe jednotlivých súdov .	súdov	5	Inan
Ten súvisí s iným bláznom , ktorý býval v našej štvrti .	bláznom	4	Anim
Kapitoly vytvoria protiváhu hlboko miestne ukotveného archeologicko ‐ historického prehľadu a predkladajú nový zorný uhol na skúmanú tému .	uhol	14	Inan
Vysvetlila môj výrok ohľadom časopisov v konkrétnom zmysle .	časopisov	4	Inan
Prišiel na preteky ako skokan .	preteky	2	Inan
V zápale hry Maja prihrala Vilkovi , ten prudko kopol do lopty a lopta zmizla v kroví .	zápale	1	Inan
Zaviedla Aladina dnu a zavolala sluhu , ktorý ihneď priniesol mešec zlata .	sluhu	5	Anim
Winston usúdil , že nepostačí iba zmeniť zmysel prejavu Veľkého brata .	zmysel	7	Inan
Správu aktív bude v tomto systéme zabezpečovať súkromný sektor , výber správcu bude v plnej kompetencii občana .	správcu	11	Anim
A vtedy mu v mysli naskočil , akoby tam bol vždy preňho poruke , obraz istého súdruha Ogilvyho , ktorý nedávno padol v boji ako hrdina .	hrdina	25	Anim
Vlasáč bez pozdravu oddupkal do tmy .	Vlasáč	0	Anim
Ťahal voz dovrchu naložený melónmi .	voz	1	Inan
Netrvalo dlho a predsedov príklad nasledovali súčasne Sabri aj veterinárny technik .	technik	10	Anim
Jeho kláštor musel mať dobrú povesť , lebo ako lotrinský vojvoda , tak aj flámsky markgróf mu odovzdali viaceré kláštory , aby v nich obnovil rehoľný život podľa reformných princípov .	markgróf	15	Anim
V noci sa zatvárala do medailónu a patrila Profesorovi .	medailónu	5	Inan
“ Daj im pokoj ! “ skríkol Aladin .	pokoj	3	Inan
Sledované cirkevnoprávne zbierky uvádzajú v tejto súvislosti celý rad predpisov .	predpisov	9	Inan
Zabili ho spolu s ďalším odsúdencom pri pokuse o útek z väzenia .	odsúdencom	5	Anim
Sadol som si do podniku pri kine a čakal , kým príde určená hodina .	podniku	4	Inan
“ Pozri , ocko ! “ zvolala Jane .	ocko	3	Anim
Jednou z hlavných postáv eposu je mýtický kováč lllmarillen .	kováč	7	Anim
V procese obstarávania bude vláda dbať na transparentný systém nakladania s majetkom štátu .	procese	1	Inan
Pokrčila som list a zahodila ho v kuchyni do koša .	list	2	Inan
Z čiernej nočnej oblohy sa spustil lejak .	lejak	6	Inan
Vliekol som sa po Nevskom prospekte a stále som nedokázal sformulovať nijakú myšlienku .	prospekte	5	Inan
Generál zreval : “ Bojujte ako levy ! “	Generál	0	Anim
Čašník priniesol druhú whisky .	Čašník	0	Anim
Než však stačili vzlietnuť , obkolesila ich horda zelených mužíčkov .	mužíčkov	9	Anim
c / argumenty „ jazykové “ , vychádzajúce s porovnania rôznych verzií rozprávania o volchvoch .	volchvoch	14	Anim
Človek by si myslel , že som mu ponúkla sviatočný obed .	Človek	0	Anim
Nakoniec obrazovka môjho mozgu zhasla a uprostred nej zostal jeden žiariaci bod .	mozgu	3	Inan
“ Takže uličník Aladin je boháč ?	boháč	5	Anim
Ponáhľala som sa , lebo ak pozrú z okna , uvidia , ako sedíme na múre .	múre	15	Inan
V estónskej rozprávke Hromovládcové gajdy je zasa zachovaný obraz starobylého dualizmu v postavách vládcu hromov Pikneho a vrchného čerta Vanatuhiho .	hromov	14	Inan
" Pintu tekutého moku !	moku	3	Inan
Režíruje ho holandský režisér Dick Maas .	režisér	3	Anim
“ To si mi iba kožuch pošteklil . “	kožuch	5	Inan
On – Kristus je novou možnosťou orientácie , cestou znovuzrodenia , novej nádeje a lásky , ktorá hľadá tých , ktorí sú na ceste rezignácie , ubití ľudským egoizmom a hriechom .	hriechom	30	Inan
Blythe bola úžasná , odpustila mi , že som na ňu nakričala kvôli plesu .	plesu	13	Inan
“ Pero alebo mostík cez palubu ? “	mostík	3	Inan
“ Zlatúšikovia moji , “ nariekala skormútene .	Zlatúšikovia	1	Anim
Slovo „ drúk “ malo tentoraz ničivý účinok .	účinok	7	Inan
Deti sú v prevažnej miere rímokatolíci .	rímokatolíci	5	Anim
Predavač zdrapil Aladina .	Predavač	0	Anim
Alebo impotenta .	impotenta	1	Anim
Režisér mal toho akurát dosť .	Režisér	0	Anim
Herkules skočil do jaskyne smrti , aby zachránil Meginu dušu , a z mládenca sa razom stal starec na pokraji smrti .	starec	17	Anim
“ Balú , ty žiješ ! “ zvolal Mauglí a hodil sa mu okolo krku .	krku	14	Inan
Vytrhol sa z pavúčej priadze takou silou , že nič netušiaceho pavúka s ôsmimi nohami prevrátilo horeznačky .	pavúka	11	Anim
Obe upierali naňho zrak .	zrak	3	Inan
Ľudská postava vcelku s kniežacou čiapkou , alebo korunou držiacou atribúty moci .	atribúty	10	Inan
Kerchak bránil rodinu proti zákernej mačke , zatiaľ čo ostatní členovia ho pozorovali zo stromov .	stromov	14	Inan
Teplé letné dni sa skončili a mladé včielky prvý raz zažili jeseň .	dni	2	Inan
Ako sa princ blížil k palácu , Kráľovná zla mu postavila do cesty múr z tŕňových krov .	princ	2	Anim
Telefón mlčal .	Telefón	0	Inan
Sudcovia sa sa celkom priklonili na jej stranu .	Sudcovia	0	Anim
Cez Bibliu sa ako červená niť tiahne hodnota človeka .	človeka	8	Anim
Zakrátko pochopil , že sú to zlodeji , čo im ukradli med .	zlodeji	6	Anim
Z toho človeka nevravel mozog , ale hrtan .	mozog	4	Inan
Zdivočenci sa zarazili .	Zdivočenci	0	Anim
“ Začni na ostrove Idra , kde vyhľadáš Filokteta , učiteľa hrdinov . “	ostrove	3	Inan
Kým sa obliekala , v chodbe zazvonil telefón .	telefón	7	Inan
Winstona predovšetkým dráždilo , že v tom rámuse hlasov sotva počul Parsonsove slová , takže ho musel sústavne žiadať , aby svoje nezmysly opakoval .	nezmysly	22	Inan
Počula som tikanie nástenných hodín a vlastný dych .	dych	7	Inan
Princ jej priniesol nádhernú flautu zo vzácneho dreva .	Princ	0	Anim
Človek očakával , že ho zabijú .	Človek	0	Anim
Dva ostrihomské kánony ustanovujú záležitosti okolo biskupov .	kánony	2	Inan
Do toho domčeka prichádzal každý večer človek .	večer	5	Inan
Strana vyhlásila , že Oceánia nikdy nebola spojencom Euroázie .	spojencom	7	Anim
Na druhej strane všetky špinavé práce robia politickí väzni .	väzni	8	Anim
Na letisko nás prišiel čakať Sergejov priateľ .	priateľ	6	Anim
Chceš vidieť , ako urobím leoparada ? “ spýtal sa .	leoparada	5	Anim
Ide v nich napospol o reglementovanie podmienok azylu pre zlodejov , ktorí utečú do kostolov .	azylu	7	Inan
“ A teraz je na rade výcvik , “ oznámil som mu .	výcvik	6	Inan
“ Buďme priatelia , “ navrhol kráľ .	priatelia	2	Anim
Polícia včera oznámila , že Korac pri pokuse o zadržanie spáchal samovraždu .	pokuse	7	Inan
Takto som trávieval večery , márnil som čas pred televízorom .	televízorom	9	Inan
Úľ sa vzďaľoval a jej sa zdalo , akoby pod ňou utekala zem .	Úľ	0	Inan
Pramenné materiály , ktoré zachytávajú 11 . storočie sa zmieňujú o prudkom nástupe novej ideológie do všetkých oblastí života .	nástupe	12	Inan
Naschvál motýľa poslala na opačnú stranu .	motýľa	1	Anim
Začiatkom týždňa sme písali ďalší test a profesor Tayerle nám ho dnes priniesol opravený .	test	5	Inan
U ugrofínskych národov fungoval orol ako predok a ochranca šamanov .	predok	6	Anim
Dostal som strašnú chuť na makový koláčik . “	koláčik	6	Inan
Kláštory a ich opáti sú tu podriadení diecéznym biskupom , ktorých povinnosťou je kláštory často vizitovať .	biskupom	8	Anim
Postupne sa zdvíhanie a klesanie ich hrudí spomalilo a prešlo do normálneho rytmu a s príjemným pocitom bezmocnosti sa od seba oddelili .	rytmu	12	Inan
Hra na hudobné nástroje , vozy ako prostriedok na prekonávanie vzdialeností by mohli svedčiť i o narážke na potulných hudcov ‐ igricov , ktorí sú chápaní v celoeurópskom kontexte ako elementy , rušiace zabehaný poriadok .	igricov	21	Anim
Od rána do večera som pil čaj s citrónom , aby som sa čo najskôr uzdravil a mohol Lienke splniť jej sen .	večera	3	Inan
Napriek všetkému Delina nevenuje tomuto človeku pozornosť .	človeku	5	Anim
Toto že má byť najsúcejší mladík z Aquitaru ?	mladík	5	Anim
Baghíra sa popod fúzy usmial .	fúzy	3	Inan
Umožniť jazykovedcovi rozhovoriť sa o systéme v jazyku , prináša zdanlivo nebezpečenstvo , že sa vstúpi do nezaujímavého a nudného sveta .	systéme	5	Inan
Niet pochýb , v hlave mám zmätok .	zmätok	6	Inan
Zbehom a pútnikom vo filmoch a knihách trvá návrat do rodnej obce neraz celé desaťročia .	pútnikom	2	Anim
Ďalší predavač ho zasa zbil vreckom šošovice .	predavač	1	Anim
Proces optimalizácie a scivilňovania štruktúr rezortu ministerstva bude pokračovať .	rezortu	5	Inan
Mladí tancovali takmer v objatí a ja som musel chvíľu čakať .	Mladí	0	Anim
Za ním vyšla starena , ktorá sa hneď skryla pod dáždnik .	dáždnik	10	Inan
Podporením priestupnosti školského systému v oblasti prechodu žiakov na vyšší stupeň školy bez prijímacích skúšok , vláda minimalizuje podmienky na korupciu v školstve .	prechodu	6	Inan
Niečo v jej posunku mu naznačilo , že sestrička umiera .	posunku	3	Inan
Vtom sa mladík zháčil .	mladík	2	Anim
Najprv vybojovali pri brehu víťaznú vodnú bitvu .	brehu	3	Inan
Uvažovala som , akú časť pretekov teraz v duchu pláva .	pretekov	5	Inan
" Dom je obkľúčený , " povedal Winston .	Dom	1	Inan
Keď zaznela hymna , po lícach vyčerpaných hráčov sa kotúľali slzy .	hráčov	7	Anim
“ Obávam sa , že ten chlapec sa nikdy neožení .	chlapec	6	Anim
“ Volá sa Pegas , synček , a je len tvoj ! “ povedal Zeus s úsmevom .	synček	5	Anim
Pred dvermi sa objavovali košíky s prekrásnymi plodmi od výmyslu sveta .	výmyslu	9	Inan
“ Som Makulienka , “ vraví motýľovi .	motýľovi	6	Anim
A tak sa na Rusi v tomto období stretávame s uctievaním pohanských bohov v novom rúchu .	bohov	12	Anim
Srdce mu od radosti poskočilo , keď Wendy urobila posledný krôčik a zmizla .	krôčik	10	Inan
Je na dva zámky .	zámky	3	Inan
“ A reči o tvojom starkom neber vážne .	starkom	5	Anim
A dve deti , vydatú dcéru a syna študenta .	študenta	8	Anim
Keď profesor Tayerle zahlásil : “ Koniec ! “ odložila som ceruzku .	Koniec	6	Inan
Chrobáčiky ju najprv utešovali , no potom sa rozhodli , že to povedia Maji .	Chrobáčiky	0	Inan
Chvíľu trvalo , kým zbadali drozda .	drozda	5	Anim
Spomínaní suzdaľskí volchvi sa zjavujú práve v čase neúrody , aby ju pomohli zahnať .	volchvi	2	Anim
Brat kantor pre vážne osobné dôvody nemohol prísť , preto brat farár sprevádzal nábožný spev na gitare spolu s mládežníkmi , ktorí poslúžili programom a vystúpili aj s osobným vyznaním .	mládežníkmi	19	Anim
Namiesto toho som zašiel k predavačovi novín .	predavačovi	5	Anim
Pri cieli sa skrýval osiak Boris a zrkadielkom oslňoval ostatných pretekárov , len aby pomohol svojmu zmrzačenému kamarátovi zvíťaziť .	osiak	4	Anim
Podobný význam mal aj spev kohúta v čase začiatku Ježišovho utrpenia .	spev	4	Inan
List bol adresovaný mojej mame .	List	0	Inan
Naším zámerom je odstrániť najmä deformácie , ktoré zakladajú neopodstatnené nerovnosti medzi občanmi alebo zavádzajú do sociálneho systému cudzorodé prvky , akým je napríklad nesystémové včlenenie kúpeľnej starostlivosti do sociálneho poistenia .	občanmi	12	Anim
Nevlastní rodičia sa o Herkula dobre starali a vyrástol z neho milujúci syn a mladík .	rodičia	1	Anim
Nedávalo to zmysel .	zmysel	2	Inan
Chichúňala sa a s džbánom na hlave sa pobrala do osady .	džbánom	4	Inan
V skutočnosti sa vyplácali iba malé sumy a výhercovia veľkých výhier neexistovali .	výhercovia	8	Anim
Ak nevyjde , nemáme dôvod stretnúť sa .	dôvod	4	Inan
Vláda bude využívať štátne záruky iba v nevyhnutných prípadoch na prefinancovanie splatných úverov so štátnymi zárukami , ak to umožní zákon o štátnej pomoci a ak hrozí realizácia záruk z prostriedkov verejných financií .	prostriedkov	30	Inan
Naučil ju i zopár tónov a zakrátko už Jazmína zabávala hostí jednoduchou melódiou .	hostí	10	Anim
Určite bol nervózny , lebo hlas mu v tej krátkej vete preskočil do fistuly ako rozladené rádio .	hlas	5	Inan
Tá prezývka mu prischla preto , lebo sa v bazéne rútil ako rýchlik .	rýchlik	12	Inan
Kláštory a ich opáti sú tu podriadení diecéznym biskupom , ktorých povinnosťou je kláštory často vizitovať .	Kláštory	0	Inan
Sú náznaky , že po duševnej stránke prežíva veľmi pochybné obdobie .	náznaky	1	Inan
Pokým nás kryjú tieto konáre , sme v bezpečí . "	konáre	4	Inan
Dej románu sa odohráva na nej alebo pri nej .	románu	1	Inan
" okríkol agresívne hostinského .	hostinského	3	Anim
Vláda vytvorí podmienky pre uskutočnenie úspešného referenda o vstupe do EÚ , ktoré bude dokumentovať udržanie širokej podpory verejnosti tomuto historickému kroku .	vstupe	8	Inan
Otec sa práve vrátil domov .	Otec	0	Anim
Silného človeka .	človeka	1	Anim
Rovnako prirodzené bolo , že zablúdila očami k fľaši s vodkou značky Smirnoff na stole .	stole	14	Inan
Okrem zajatcov priemerný občan Oceánie nikdy nezočí občana Euroázie alebo Východoázie a zakazuje sa ovládať cudzie jazyky .	občana	7	Anim
Začul prekrásny hlas Šípkovej Ruženky , ktorý sa niesol lesom .	lesom	9	Inan
Proleti si zachovali ľudskosť .	Proleti	0	Anim
Ale dlho ho potrebovať nebudeš , “ vraví pavúk Karkoško .	pavúk	8	Anim
Ťažko by pri nich obstál nejaký anonym .	anonym	6	Anim
V tom sne najsilnejší bol pocit sebaklamu , lebo v skutočnosti vedel , čo je za tým temným múrom .	pocit	5	Inan
Jeho pani bola na počudovanie osa a mala veľmi útly driek .	útly	9	Inan
A tak sa pavúčikovia pustili priasť ľan .	pavúčikovia	3	Anim
Ako sa stretla s motýľom Emanuelom	motýľom	4	Anim
Ako sa princ blížil k palácu , Kráľovná zla mu postavila do cesty múr z tŕňových krov .	palácu	5	Inan
Raz sa podobali na rybu , potom na obra alebo na obriu včelu .	obra	8	Anim
Vláda považuje štíhlejší , funkčnejší a menej náročný verejný sektor za nevyhnutnú podmienku úspešnej správy vecí verejných .	sektor	9	Inan
Zaletela k nim , sadla na kvet a počúvala tiché zurčanie potoka .	potoka	11	Inan
Takýmito duchmi môžu byť medvede , vlky , zajace , jelene , kačky , orly , sovy a vrany .	duchmi	1	Anim
Prednosta podzemnej dráhy náhodou našiel starú čižmu , ktorá sa na tento účel výborne hodila .	účel	12	Inan
Bronzová čaša , zdobená rúčkou s vtáčikom pripomína uctievanie vtákov u ugrofínskych národov — ak karelský poľovník zabil vtáka čakalo ho nešťastie .	vtáka	18	Anim
Mal som strach z niečoho iného : zo stretnutia s Tomom .	strach	2	Inan
“ Mimozemšťania , “ zašepkal Rudko vystrašene .	Mimozemšťania	1	Anim
Vláda pripraví legislatívny rámec inštitucionálneho vzdelávania zdravotníckych pracovníkov prostredníctvom rezortu školstva s možnosťou postgraduálnej prípravy pracovníkov v zdravotníctve v školách a inštitúciách , ktoré získajú akreditáciu pre príslušný typ vzdelávania .	pracovníkov	15	Anim
Pozostáva z krátkych pasáží o jednotlivých mníchoch , v ktorých sa neopakovateľným spôsobom preplieta fantastika s reálnym videním sveta .	mníchoch	6	Anim
Položil ruku na ciferník .	ciferník	3	Inan
“ Nevydeli ste tu nejakého koňa ? “ vypytoval som sa chrobákov .	koňa	5	Anim
Medzi Ladislavovými zákonmi máme cirkevnú sankciu doloženú v prípade zabitia nevernej ženy a znásilnenia .	zákonmi	2	Inan
Chcela dva doláre .	doláre	2	Inan
Cez kombinézu cítil jej prsníky , zrelé , ale pevné .	prsníky	4	Inan
Takže nacionalisticko - sociálny populizmus Mečiarov je , povedal by som , prirodzeným plodom stáročného vývinu slovenskej spoločnosti .	populizmus	4	Inan
“ A čo sa stalo ? “ spýtala sa zvýšeným hlasom .	hlasom	10	Inan
Vždy som mával zvláštny pocit , že ten človek ma neznáša .	pocit	4	Inan
V tom majú prsty Goldsteinovi agenti !	agenti	5	Anim
Zlosyn napol luk a vystrelil .	Zlosyn	0	Anim
Ale pozor bez povrázkov !	povrázkov	3	Inan
Neďaleko jazdil na koni mladý princ .	koni	3	Anim
Keď sa o tom dozvie , usporiada slávnostný obed .	obed	8	Inan
Nečakal na myšiakove ďalšie požiadavky a dvaapolmetrovým skokom sa vzdialil .	skokom	7	Inan
“ Chvalabohu , “ vyhŕkol , len čo lapil dych .	dych	9	Inan
Obra Jumba všetci oslavovali a vymenovali za čestného občana Makovej lúky .	Obra	0	Anim
Nápis tak vcelku nadobúda podobu kríža .	kríža	5	Inan
Nepovažovalo sa za žiaduce , aby proleti mali silné politické cítenie .	proleti	6	Anim
Maja pocítila hlad .	hlad	2	Inan
Toto stieranie hraníc je veľmi príjemné , pokiaľ ide o poriadneho občana , ktorý cestuje za svojím obchodom alebo za svojou dovolenkou .	občana	11	Anim
Detektíva Steva McGarretta hral Jack Lord .	Detektíva	0	Anim
Počas výletu bolo ponechané dosť času na voľno a osobné rozhovory .	výletu	1	Inan
Vláda bude podporovať vývoj a šírenie výrobkov i služieb šetriacich životné prostredie a v rámci legitímnych trhových nástrojov hľadať možnosti podpory malým a stredným podnikateľom zvyšovať investície do „ čistej “ výroby a environmentálnych podnikateľských aktivít .	podnikateľom	24	Anim
Trestajúci boh ním vládne	boh	1	Anim
Vo Winstonovi zápasili zvláštne pocity .	pocity	4	Inan
Nikdy nebudú svoji .	svoji	2	Anim
Dej obidvoch týchto románov sa odohráva na bengálskom vidieku .	vidieku	8	Inan
Výučbu tancov povedie Jano Blaho , dôstojný nástupca Štefana Nosáľa na poste choreografa Lúčnice .	choreografa	12	Anim
Telefón zrazu prestal vyzváňať .	Telefón	0	Inan
Chris , skutočný vinník , sa tváril pokojne ako Angličan .	vinník	3	Anim
Vtom som pozrela hore a zbadala pri bazéne Chrisa .	bazéne	7	Inan
Chcem , aby si mi splnil druhé želanie , džin .	džin	9	Anim
Pod gaštanom stálo niekoľko stolov a stoličiek a za živým plotom presvitala tehlová budova hostinca .	gaštanom	1	Inan
Čakal som celé dve hodiny , ale šéf nechodil .	šéf	7	Anim
V tom sne najsilnejší bol pocit sebaklamu , lebo v skutočnosti vedel , čo je za tým temným múrom .	múrom	18	Inan
Kôň sa pásol so sklonenou hlavou a dýchal na Vilka teplo .	Kôň	0	Anim
Už dávno dostal prezývku podľa starovekého filozofa a už dávno si nikto nepamätal , ako sa skutočne volá .	filozofa	6	Anim
Teraz ma už niekoľko dní sprevádzal letmý dotyk Faikiných pŕs , dotyk jej rúk .	dotyk	7	Inan
Vláda bude pri všetkých reformách venovať osobitnú pozornosť tomu , do akej miery navrhované zmeny prispievajú k zníženiu nezamestnanosti a finančnej náročnosti pre daňovníkov a k posilňovaniu motivácie hľadať prácu .	daňovníkov	23	Anim
Viedol ma ešte asi dvadsať metrov a tam zastal .	metrov	5	Inan
Keď som sa raz vrátil zo sveta do rodného mraveniska , zhrozil som sa .	sveta	6	Inan
Sme ideozločinci .	ideozločinci	1	Anim
Hravo obopínal jednou rukou celý Júliin pružný pás .	pás	7	Inan
Tieto funkcie sú nápadne podobné funkcii kléru na starej Rusi — pri kláštoroch boli útulky pre chorých a existovali dokonca „ kláštorní lekári “ , ktorí spadali do kompetencie cirkevného práva .	kláštoroch	12	Inan
Táto výsada zahŕňa najmä , stručne povedané , právomoc uhorského panovníka zriaďovať vo svojej krajine nové diecézy a právomoc dosadzovať biskupov a ďalších vyšších cirkevných hodnostárov do svojich úradov .	panovníka	10	Anim
Bál som sa , že moji rodičia sa namiesto toho , aby ma bránili , postavia na stranu útočníka .	rodičia	6	Anim
Nemôže vziať späť ani bozk .	bozk	4	Inan
Faktom je , že náboženský fundamentalizmus prežíva svoju regeneráciu . “	Faktom	0	Inan
Gaston sa obrátil k zástupu dedinčanov , ktorí sa medzitým zhromaždili okolo neho .	dedinčanov	5	Anim
Že Mečiar , suverénny víťaz prvého kola , v druhom kole bol spektakulárne odmietnutý , je spravodlivý trest za roky jeho vládnutia .	víťaz	4	Anim
Posledný kánon II . kolomanovskej synody o celibáte sa svojím obsahom vymyká prísnejšiemu tónu uznesení tohto cirkevného snemu .	obsahom	10	Inan
Konečne sa blížil začiatok pretekov .	začiatok	3	Inan
A skrýva v sebe tajomstvo , ktoré vo mne ustavične vzbudzovalo pocit viny .	pocit	11	Inan
O ' Brienov sluha ich však oboch vpustil dnu bez jediného protestu .	sluha	3	Anim
Keď Ferdovi muži zajali celé nepriateľské vojsko , aj hlavný veliteľ otrokárov vyšiel z podzemnej chodby .	otrokárov	11	Anim
V jednom rohu podložky je ventil , po jeho otvorení pena nasáva vzduch , nafukuje sa .	rohu	2	Inan
A s pohľadom Loriných očí vo svojom vnútri .	pohľadom	2	Inan
Aktom spojenia sa s takouto bytosťou sa šaman vlastne dostáva na úroveň božských tvorcov .	šaman	7	Anim
Hľadel jej do tváre zo vzdialenosti niekoľkých krokov .	krokov	7	Inan
Porušenie tohto zákazu sa trestá odňatím ťažného zvieraťa a náradia .	zákazu	2	Inan
Uprostred pretekov som prestala plávať a šliapala som vodu až k miestu , kde sa ponoril .	pretekov	1	Inan
Od tejto chvíle si môžete ľubovoľne vytvárať fotoalbumy s neobmedzeným počtom fotiek .	fotoalbumy	7	Inan
Bratovi farárovi prajeme v tejto funkcii múdrosť , vytrvalosť a Božie vedenie .	Bratovi	0	Anim
Raz zbadala , ako pri potoku presvitá čosi červené .	potoku	5	Inan
“ Nezmysel , to by Radža neurobil . “	Nezmysel	1	Inan
Vo všeobecnosti to boli dôchodcovia s plstenými klobúkmi alebo čiapkami , ktoré ich chránili pred slnkom .	dôchodcovia	4	Anim
Rímski reformátori totiž potrebovali inštrumentárium , prostredníctvom ktorého by zdokladovali oprávnenosť svojich požiadaviek .	reformátori	1	Anim
O niekoľko dní zmenila pracovné miesto : z kravínov prešla do kancelárií na družstve , stala sa upratovačkou .	kravínov	8	Inan
Táto výsada pannonhalmského opáta mohla byť už súčasťou originálej listiny .	opáta	3	Anim
Predsa o krtkovi Gabkovi .	krtkovi	2	Anim
Prešiel som do strednej časti mosta .	mosta	5	Inan
Bieleho šamana — biskupa má na svojej strane .	šamana	1	Anim
Práve preto mal spev kohúta aj druhý význam .	kohúta	4	Anim
Z týchto vzájomných kontaktov totiž vyplývajú isté indície o tom , do akej miery mohli byť myšlienky rímskych reformátorov recipované uhorskou cirkvou a jej zákonodarstvom .	kontaktov	3	Inan
Prúd áut sa zastavil .	Prúd	0	Inan
Zvuk : Zachráňte vojaka Ryana	vojaka	3	Anim
Bol mučiteľ , bol ochranca , bol inkvizítor , bol priateľ .	ochranca	4	Anim
Napokon chytil vak a hodil mi ho na kolená .	vak	2	Inan
Zatriasli námesačníkom a prezradili mu , kto je zlodej .	námesačníkom	1	Anim
Koberec , krištáľová guľa a niekoľko pomôcok na čarovanie .	Koberec	0	Inan
Ak mám byť úprimná , ešte včera by som odušu písala ako ostatní spolužiaci .	spolužiaci	13	Anim
Boli to dvaja muži v civilnom obleku .	muži	3	Anim
Viete , koľko tu stojí 1 - izbový byt ?	byt	8	Inan
S očividným uspokojením dokázal rozprávať o náletoch vrtuľníkov na nepriateľské dediny , o procesoch s ideozločincami , o ich priznaniach a o popravách v katakombách Ministerstva lásky .	procesoch	13	Inan
Keď ju vyvreskúvali stovky hrdiel za dupania pochodujúcich nôh , zmocňovala sa človeka hrôza .	človeka	12	Anim
Zakrátko sa toho nespratníka raz a navždy zbaví !	nespratníka	3	Anim
Po analýze a vyhodnotení doterajších skúseností s pilotnými prevádzkami vláda vytvorí podmienky na jeho rozšírenie na všetky súdy .	súdy	17	Inan
Občas si spomenula na svoj roj vo včelom meste .	roj	5	Inan
Dňa 15 . 2 . 2004 sa v našom cirkevnom zbore konal výročný zborový konvent .	zbore	10	Inan
Prichádzali a záhadne odchádzali ďalší väzni .	väzni	5	Anim
“ Postavíme ti maštal , chuchlík , “ povedal som mu .	chuchlík	5	Anim
Zatriasli námesačníkom a prezradili mu , kto je zlodej .	zlodej	8	Anim
Jednou z podmienok vysoko profesionálneho výkonu zahraničnej služby je pritom realizácia kvalitnej personálnej politiky v rezorte zahraničných vecí .	rezorte	15	Inan
Do slovenských častí Uhorska sa vtedy utiahla jedna časť českých emigrovaných protestantov a tu našli v používaní svoj vlastný spisovný jazyk presne tak , ako vo svojej českej vlasti .	protestantov	11	Anim
Vláda uplatní rovnaký postup pri priznávaní štátnej pomoci a zriadi register prijímateľov štátnej pomoci a register prijímateľov iných investičných stimulov .	prijímateľov	11	Anim
Na obzore zbadala piesočný vír ako malé tornádo .	vír	4	Inan
O chvíľu prišiel k stánku chlapec v otrhaných zaplátaných šatách .	chlapec	5	Anim
Znak potom môžme vykladať ako zobrazenie vtáka s roztiahnutými krídlami a hlavou vysunutou dopredu .	Znak	0	Inan
Potom dodala známu vec s ujom a v priestore môjho mozgu zaburácalo slovo „ impotent “ .	ujom	5	Anim
Jeho hlas opäť sprísnel .	hlas	1	Inan
Fridolín bol malý hnedý chlapík so silným náprsným štítom a krátkymi krovkami .	chlapík	4	Anim
“ Aký pouličný potkan ? “ priadla Jazmína .	potkan	3	Anim
Potom sa obrátila k bratom .	bratom	4	Anim
Uprostred parku bola plošinka pre tanečníkov a vedľa nej kryté miesto pre orchester .	tanečníkov	5	Anim
Vtom Stromboliho dobrá nálada akoby zázrakom zmizla .	zázrakom	5	Inan
Naši chirurgovia dokážu zmeniť ľudí na nepoznanie .	chirurgovia	1	Anim
Prvým stupňom boli archeologické vykopávky svojou uchopiteľnosťou zhmotňujúce rozplývavé symboly starých povier a zároveň ich presne lokalizujúce .	symboly	9	Inan
Šéf nie je prítomný .	Šéf	0	Anim
Neotáľa a vylezie na strom .	strom	4	Inan
Vláda pripraví transformáciu štátnych zdravotných ústavov na inštitúcie verejného zdravotníctva so zvýraznením opatrení zameraných na zníženie , resp . vylúčenie rizika poškodenia zdravia .	ústavov	5	Inan
Títo reformne naladení klerici sa stali najbližšími pápežovými spolupracovníkmi a poradcami .	spolupracovníkmi	8	Anim
Zdvihol pohár a obrátil ho do seba .	pohár	1	Inan
Cieľom rekodifikácie trestného práva bude prísnejší postih páchateľov násilných trestných činov a moderný trestný proces , ktorý bude rýchly a efektívny .	postih	6	Inan
Umožniť jazykovedcovi rozhovoriť sa o systéme v jazyku , prináša zdanlivo nebezpečenstvo , že sa vstúpi do nezaujímavého a nudného sveta .	sveta	20	Inan
“ A nezabudnite na vrecká , kam zabalíte psom zvyšky . “	psom	8	Anim
Chlapec mu prebehol prstom po hrdle .	Chlapec	0	Anim
Vo Winstonovi zápasili zvláštne pocity .	pocity	4	Inan
Rozrývalo mi to dušu a ničilo nervy .	nervy	6	Inan
Vláda pripraví podmienky pre sústredenie kompetencií v oblasti regulácie a koordinácie elektronickej komunikácie a rozvoja informačnej spoločnosti z rôznych orgánov na jeden regulačný orgán .	orgán	23	Inan
Cítil som vôňu jeho tela , ktorá bola premiešaná so zápachom tabaku a alkoholu .	alkoholu	13	Inan
“ Počkaj , až ochutnáš Safiyinu špecialitu , “ nadšene vravel , keď sluhovia kládli na stôl ťažký strieborný podnos s polguľovitým vrchnákom .	sluhovia	13	Anim
Taktáto blízkosť funkcií vedie k ľahkej zameniteľnosti šamana za mnícha .	šamana	7	Anim
Svätoštefanský zákon pripúšťa , aby sa žena , ktorú manžel za istých okolností opustí , znovu vydala .	manžel	9	Anim
“ Je na ňom symbol bohov , “ vysvetľovala Alkmena .	bohov	5	Anim
Nakoniec som jej povedal , že má pravdu , náš nový pokus bol bláznovstvom .	pokus	11	Inan
Nepoznám nič horšie ako utáraných kamarátov .	kamarátov	5	Anim
Jednostaj prichádzali a odchádzali všakovakí väzni : distribútori drog , zlodeji , banditi , šmelinári , opilci , prostitútky .	šmelinári	14	Anim
Zobrala ďalšie dve dievčatá , ostatných nechala tak a celé popoludnie špehovali dajakého čudáka .	čudáka	13	Anim
Porota však ocenila práce slimákov Šuchtáka a Plazivca , ktorý si prekrásne vymaľovali domčeky .	domčeky	13	Inan
Ján Bakalár , zborový farár	farár	4	Anim
Špecifické skupiny nálezov , vyskytujúcich sa vo väčšom množstve , budú rozoberané v osobitnch kapitolách .	nálezov	2	Inan
Pripomínala lebku umrlca .	umrlca	2	Anim
Nechal som u nej kľúč .	kľúč	4	Inan
Koniec rebríka preťal okno a prelomil rám .	rebríka	1	Inan
Prúd mojej energie sa jej vylial na prsia .	Prúd	0	Inan
Keď Ferdovi muži zajali celé nepriateľské vojsko , aj hlavný veliteľ otrokárov vyšiel z podzemnej chodby .	muži	2	Anim
Za jasotu spoluobčanov prevzali cenu a Dr . Slimák slzil od dojatia , pretože v tejto súťaži doteraz nijaký slimák nevyhral .	spoluobčanov	2	Anim
A stiahol zlatý náprstok naspäť pod čiernu zem .	náprstok	3	Inan
Vo všeobecnosti to boli dôchodcovia s plstenými klobúkmi alebo čiapkami , ktoré ich chránili pred slnkom .	klobúkmi	7	Inan
V krátkom čase v rokoch 1989 – 1990 bol členom Generálneho presbyterstva .	členom	9	Anim
Zbadala ho na steble trávy , práve z orlíčka popíjal sladký nektár .	orlíčka	8	Inan
Ja som však neznášal huriavk , ktorý robili ľudia čakajúci v radoch .	huriavk	4	Inan
Bol v tom kus pravdy .	kus	3	Inan
Prečo sa potom letopisec zaoberá ešte akýmsi medveďom ?	medveďom	7	Anim
Nimi vysvätení kňazi teda nie sú právoplatne vysvätenými a nemôžu teda veriacim sprostredkovať dary Ducha Svätého .	veriacim	11	Anim
Symbolika fúza je v už spomenutom severoamerickom mýte spojená s vyvolaním hmly .	mýte	7	Inan
Miesto — čudská oblasť , obývaná plemenom baltskej proveniencie , predkami dnešných Estóncov .	predkami	10	Anim
Bez vyzvania im čašník priniesol ďalšie poháriky s džinom .	čašník	3	Anim
“ Tu je diera , “ zašepkala som a vybrala trs trávy , ktorý zakrýval vyčnievajúci stupienok z palmového dreva .	stupienok	16	Inan
Márne sa prezliekala , v našej izbe sa vždy našlo niečo , čo smrdelo kravínom .	kravínom	14	Inan
Abu strčil hlavu do mešca .	mešca	4	Inan
“ Hromy a blesky privej !	Hromy	1	Inan
Otec nezomrel na dajakú chorobu .	Otec	0	Anim
Roztvoril dvere a odporný kyslastý zápach zvetraného piva mu vrazil do nosa .	nosa	11	Inan
Ozval sa melodický piskot a na leknový list sa zniesol jemný priesvitný tieň .	tieň	12	Inan
Výzorom na Winstona najsilnejšie zapôsobil Rutherford .	Výzorom	0	Inan
Vtedy som si spomenul na medailón .	medailón	5	Inan
Požiadavka primeraného vzdelania klerika nepotrebuje obšírnejší komentár .	komentár	6	Inan
Za slovenskú stranu sa tradične na organizácii prehliadky podieľa Slovenský filmový ústav a Asociácia slovenských filmových klubov , ktorá prostredníctvom MK SR udeľuje na prehliadke Hlavnú cenu Zlatý debut .	ústav	11	Inan
Po prehliadke hudobných skupín sa o zábavu postarajú dídžeji .	dídžeji	8	Anim
Vtedy sa prítomným naskytol pohľad na Gimov obrovský penis .	penis	8	Inan
Môj potôčik vyrazil von , rozlial sa a ja som zostal zahalený v horúcej pare sauny .	potôčik	1	Inan
Aj reformný kánonista Anselm uvádza vo svojej zbierke viacero nariadení o konaní synod .	kánonista	2	Anim
Reformátori 11 . storočia však už dospeli k precíznejšej formulácii , ktorá , podľa nás , reprezentuje nimi presadzovanú snahu o čo najpresnejšie vymedzenie sfér vplyvu svetskej a cirkevnej moci .	Reformátori	0	Anim
Nebežal tadiaľto kôň ? “ kričal som na motýle .	kôň	2	Anim
Pacholkovia vládnucej triedy !	Pacholkovia	0	Anim
A vtedy mu v mysli naskočil , akoby tam bol vždy preňho poruke , obraz istého súdruha Ogilvyho , ktorý nedávno padol v boji ako hrdina .	súdruha	16	Anim
Keď konečne nastala správna konštelácia hviezd , Hádes vyslobodil Titanov z podzemného väzenia .	Titanov	9	Anim
“ A teraz mi zaplať ! “ zhúkol na Jazmínu predavač .	predavač	10	Anim
Vzal kôš a deku , do ktorej sme sa spolu zabalili .	kôš	1	Inan
Zvončeky už hlásili , že sa blíži nepriateľ .	nepriateľ	7	Anim
" Nechápeš , že jediným cieľom newspeaku je zúžiť rozsah myslenia ?	rozsah	9	Inan
“ Nepoznám nikoho , kto dosiahol taký vysoký počet bodov .	bodov	9	Inan
Priateľky a príbuzní ju ponechali svojmu osudu .	príbuzní	2	Anim
Mal dlhý kabát , zdvihnutý golier , okuliare so strieborným rámom , červenastú tvár a husté šedivé vlasy .	golier	5	Inan
Ešte teraz cítil pach tej vlhkej lepenky .	pach	3	Inan
Mama pochádzala z rodiny s generáciami evanjelických farárov .	farárov	7	Anim
Kufor som nemal zbalený .	Kufor	0	Inan
Minule sa môj kolega Rado Ondřejíček fejtónovým perom pustil do problému hlupákov medzi nami .	hlupákov	11	Anim
Niekto z mojich niekdajších šéfov , vedúcich kádrového oddelenia alebo veliteľov na vojenských cvičeniach .	vedúcich	6	Anim
Celý zvyšok predpoludnia sa mu pracovalo veľmi ťažko .	zvyšok	1	Inan
Jednostaj prichádzali a odchádzali všakovakí väzni : distribútori drog , zlodeji , banditi , šmelinári , opilci , prostitútky .	väzni	5	Anim
V piaty deň každého mesiaca išla Irma na poštu s príslušným kódom a priniesla domov sto dolárov .	kódom	11	Inan
Ak muža s tvárou umrlca odviedli o polnoci , bolo ráno , ak ráno , bolo popoludnie .	umrlca	4	Anim
Vláda sa bude usilovať o postupné zapájanie kapacít nášho obranného priemyslu do štruktúr európskeho obranného priemyslu .	priemyslu	15	Inan
“ Daj pokoj môjmu mláďaťu ! “ zreval .	pokoj	2	Inan
Záujemcov o šport poteší futbalový turnaj pre dospelých a jazda na koni pre deti .	koni	11	Anim
Hľadala som v zásuvke nejaký papier na poznámky , keď som zbadala formulár na udelenie finančnej podpory počas štúdia na vysokej , ktorý mi dal ešte pred niekoľkými týždňami výchovný poradca pán Hatch .	formulár	12	Inan
Vláda bude presadzovať takú reformu Ozbrojených síl Slovenskej republiky , ktorá bude najefektívnejšie zabezpečovať ochranu pred možným ohrozením nášho štátu a jeho občanov .	občanov	22	Anim
Rodičom sa však taký vývoj udalostí nepáčil a zišli sa na porade .	Rodičom	0	Anim
Otrokársky generál sa spamätal až po hodnej chvíli .	generál	1	Anim
“ Vina je jednoznačne dokázaná ! “ vyhlásil predseda súdu .	predseda	8	Anim
Navrhli im , že ak chcú prežiť v nových podmienkach trhového hospodárstva , môžu predávať po tiranských chodníkoch cigarety alebo banány .	banány	20	Inan
Chris sa zrazu nadšene zatváril a prešiel do ľavého pruhu .	pruhu	9	Inan
Mauglí so supmi sa smiali , keď im tiger zmizol z dohľadu .	tiger	8	Anim
Z nešikovného mladíka sa stal šikovný vrtký chlapík , ochotný ukázať , čo vie .	chlapík	7	Anim
Lori popíjala pomarančový džús .	džús	3	Inan
Hubert pozval všetkých na koncert pri príležitosti krásneho letného večera .	koncert	4	Inan
Vtom sa zjavil veľký modrý džin .	džin	5	Anim
Sultána odhodilo nabok .	Sultána	0	Anim
“ Tí psi sú dnes mojimi hosťami . “	psi	2	Anim
Miesto nálezu .	nálezu	1	Inan
Chcem spresniť , že v mojich očiach bol Profesor už takmer starec .	starec	11	Anim
Netvor na ňu hľadel rovnakým pohľadom .	Netvor	0	Anim
Bol som jej štvrtým tridsaťpercentníkom .	tridsaťpercentníkom	4	Anim
“ U mravcov , “ odvetila mravčia zdravotná sestrička .	mravcov	2	Inan
Brat kantor pre vážne osobné dôvody nemohol prísť , preto brat farár sprevádzal nábožný spev na gitare spolu s mládežníkmi , ktorí poslúžili programom a vystúpili aj s osobným vyznaním .	farár	11	Anim
V živote každého človeka sú okamihy a udalosti , ktoré majú zvláštnu moc .	človeka	3	Anim
Mediácii bráni násilný zásah zvonku — Janova prítomnosť , narúšajúca tak prvotnú rovinu mýtu .	zásah	3	Inan
Vtáky spievajú , proleti spievajú , Strana nespieva .	proleti	3	Anim
Rodičia zostali prekvapene stáť .	Rodičia	0	Anim
O nej a o koníkovi nikto nič nevedel .	koníkovi	4	Anim
Záujemcov o šport poteší futbalový turnaj pre dospelých a jazda na koni pre deti .	Záujemcov	0	Anim
Ako vyzerá herec snov ?	snov	3	Inan
Rudko si z listu urobil slnečník .	slnečník	5	Inan
Zo zlatej čaše popíjal víno a džin mu masíroval nohy .	džin	6	Anim
“ Ale to som predsa nechcela ! “ zvolala Lienka , keď predseda súdu vyhlásil rozsudok .	súdu	13	Inan
Plač Kalu priťahoval .	Plač	0	Inan
Títo reformne naladení klerici sa stali najbližšími pápežovými spolupracovníkmi a poradcami .	klerici	3	Anim
“ Ja som ti had ? “ zlomyseľne sa zarehotal Džafar .	had	4	Anim
Spočiatku som mala nepríjemný pocit , že sa na mňa všetci dívajú , ale trvalo to len moment .	moment	17	Inan
Napriek všetkému úsiliu sa príbuzným Sergeja Duku nepodarilo zistiť u kompetentných orgánov nijaké podrobnosti .	orgánov	11	Inan
Počkaj chvíľu ! “ zakričal škriatok .	škriatok	5	Anim
Oznamuje východ slnka a prebúdza zo spánku . .	spánku	6	Inan
Jazz , blues , rock , funk .	rock	4	Inan
Je to blbec .	blbec	2	Anim
Podstrčil mu ho redaktor z televízie , ktorá všetko nakrúcala .	redaktor	3	Anim
Symbolickú úlohu má i výzdoba koníka — krúžky s bodkou uprostred sú ďalšou z mnohých modifikácií solárnych znakov .	koníka	5	Anim
Mauglí so supmi sa smiali , keď im tiger zmizol z dohľadu .	dohľadu	11	Inan
Očakával náš príchod .	príchod	2	Inan
Ako starý priateľ tvojho nebohého otca považujem za potrebné , aby sme sa porozprávali celkom otvorene .	priateľ	2	Anim
Zmizni lebo mi odplašíš zákazníkov .	zákazníkov	4	Anim
Maja s Vilkom poprisili o kúsok smrčka a statočne ho prežúvali , len aby sa zavďačili hostiteľovi .	smrčka	6	Inan
Ako kráčal k dverám , mince v mešci príjemne zacinkali .	mešci	7	Inan
Straník žije od narodenia po smrť pod dozorom Ideopolície .	Straník	0	Anim
Poviedky typu Sexuálny nenásytník ani eseje ako Esej o vši nemali budúcnosť .	nenásytník	3	Anim
Vtedy sa rozhodli , že nadišiel čas , aby mu ukázali zlatý medailón , ktorý mal na krku , keď ho našli .	krku	17	Inan
Aj Maja so škriatkom opustili topoľ a leteli , kým nedoleteli k domu , kde sa v oknách ešte svietilo .	domu	12	Inan
Vedela , že Erik s Arielou sa zachytili o cípy jej obrovitej koruny .	cípy	9	Inan
Za ten čas sa okolo nich zhromaždila skupina zvedavcov a medzi nimi aj Flip .	zvedavcov	8	Anim
Bolo tu pododdelenie televíznych programov s inžiniermi , producentmi a s celými tímami špeciálne vybraných hercov , lebo dokázali imitovať hlasy .	inžiniermi	6	Anim
Cieľom reformy je zastaviť demograficky podmienené zvyšovanie vnútorného dlhu priebežne financovaného dôchodkového systému a zvýšiť zaangažovanosť občanov na svojej životnej úrovni v dôchodkovom veku .	občanov	16	Anim
Bol na slnku , oni v tieni .	tieni	6	Inan
Na preklenutie rozdielov vo vzdelanostnej úrovni a štruktúre sa vláda zaväzuje v prvom roku volebného obdobia k vytvoreniu univerzity pre vysokoškolskú prípravu občanov maďarskej národnosti .	občanov	22	Anim
Aj keď v noci ešte nelietala , rozprestrela krídla a opustila svoju bezpečnú dutinku v strome .	strome	15	Inan
Si drúk , povedal som tomu ksichtovi v zrkadle .	ksichtovi	6	Anim
Na rozdiel od svätoštefanskej legislácie sú tí , ktorí v nedeľu neprídu do kostola , potrestaní prísnejšie – telesným trestom .	trestom	19	Inan
“ Nehovor mi , že si mierumilovný netvor !	netvor	7	Anim
Netrvalo dlho , a policajti prišli do kaviarne zatknúť zlodeja .	policajti	4	Anim
Muž s prenikavým hlasom po jeho ľavici bezohľadne rozprával ďalej .	hlasom	3	Inan
Vláda pripraví podmienky pre sústredenie kompetencií v oblasti regulácie a koordinácie elektronickej komunikácie a rozvoja informačnej spoločnosti z rôznych orgánov na jeden regulačný orgán .	rozvoja	14	Inan
Maja s Vilkom sedeli na lesnej čistine a vymýšľali si o nich príbehy .	príbehy	12	Inan
Jeho kláštor musel mať dobrú povesť , lebo ako lotrinský vojvoda , tak aj flámsky markgróf mu odovzdali viaceré kláštory , aby v nich obnovil rehoľný život podľa reformných princípov .	kláštor	1	Inan
Pohyb z jednej skupiny do druhej je oveľa vzácnejší , než bol v kapitalizme či dokonca v predindustriálnom veku .	Pohyb	0	Inan
Nikita sám , ako je v texte uvádzané , sa neskôr stáva novgorodským biskupom .	biskupom	13	Anim
V prípade , že klerik žaluje laika , má sa spor prerokovať pred svetským sudcom .	sudcom	14	Anim
Vták opäť kývol lesklou čiernou hlavou .	Vták	0	Anim
Niečo dopadlo na posteľ za Winstonovým chrbtom .	chrbtom	6	Inan
Mladík však nebol veľmi nadšený .	Mladík	0	Anim
Netrvalo dlho a vedľa nej sa pod veľkým černicovým kríkom zjavil tučný svetlohnedý pavúk .	pavúk	13	Anim
Arielini priatelia sú bezvýznamné morské červy !	priatelia	1	Anim
Vlastne patril do početného týmu odborníkov , ktorý pripravoval jedenáste vydanie Slovníka newspeaku .	odborníkov	5	Anim
Tieto kritické postrehy Soni vyslovila pri našom poslednom prázdninovom stretnutí pred začiatkom tretieho ročníka .	ročníka	13	Inan
Na nebi ani mráčka a z blankytného neba hrialo slnko .	mráčka	3	Inan
Ako sedemnásťročný sa stal okresným zakladateľom Antisexuálnej ligy mládeže , ako devätnásťročný navrhol nový druh ručného granátu , ktorý zaradilo do výzbroje Ministerstvo mieru a ktorý už pri prvej skúške jediným výbuchom zabil tridsaťjeden euroázijských zajatcov .	granátu	16	Inan
“ Prisahám na svoj včelí život , že môj kamarát stratil pri nehode vedomie a prebral sa iba zázrakom ! “	kamarát	9	Anim
Jazmína zatajila dych .	dych	2	Inan
Mal som koníka , mal som aj koč .	koníka	2	Anim
Moja myseľ opäť postrehla akúsi súvislosť medzi autom a týmito dvoma mužmi .	mužmi	11	Anim
Profesor Eugen Jóna , ktorý sa dejinami spisovnej slovenčiny dlhé roky zaoberal , si uvedomil potrebu dať do rúk slovenskej i medzinárodnej vedeckej verejnosti dostatočne prístupný skutočný text tohto základného diela .	Profesor	0	Anim
V ten večer sa v paláci zhromaždili všetci dvorania , keď princezná Zornička tancovala s princom Filipom .	princom	15	Anim
Vláda však v tejto súvislosti zastáva názor , že NATO i naďalej zostane hlavnou inštitúciou , prostredníctvom ktorej budú európski a severoamerickí spojenci i naďalej riešiť bezpečnostné otázky transatlantického rozmeru .	spojenci	22	Anim
Vystúpenie veľkého množstva jeho bojových oddielov sa dalo chápať i ako pohanský nepokoj — prežitky predkresťanskej viery sa u Estóncov udržali neobvykle dlho .	prežitky	14	Inan
Okamžite jej padol zrak na televízor .	televízor	5	Inan
Marginým svätcom bol taliansky spevák Gianni Morandi , mojím Angličan Tom Jones .	svätcom	1	Anim
Vláda prijme strednodobý komplexný programový dokument rozvoja regiónov , zabezpečí prípravu , prerokovanie a schválenie plánovacích a programových dokumentov v oblasti regionálnej politiky s dôrazom na zlepšenie ekonomickej a sociálnej súdržnosti a prehĺbi uplatňovanie princípu partnerstva .	dôrazom	24	Inan
Tú báseň som napísal v štvrtej triede základnej školy , chcel som napodobniť jedného básnika , ktorý bol otcovým priateľom .	básnika	14	Anim
Raz som chytil muchu a vlastnoručne som ju hodil do pavučiny , ale nevidel som , že by sa objavil nejaký pavúk , ktorý by ju zožral .	pavúk	21	Anim
Tento zdanlivo hypoteticko ‐ špekulatívny prístup „ náhodného výberu “ sa bude opierať o už spomínané empirické zázemie sumy archeologických a etnografických faktov .	faktov	22	Inan
Chrobák zhovievavo pokrútil hlavou .	Chrobák	0	Anim
Inštitúciou , ktorej človek vďačí za to , že ho vo dne i v noci obklopujú dôverne informovaní špicli .	špicli	18	Anim
Rodičia zaujímali miesta naproti sebe , ja som sedával medzi nimi .	Rodičia	0	Anim
“ Nesklamem ťa , otec , “ zvolal Herkules , keď s Pegasom leteli na ostrov Idra .	ostrov	15	Inan
V prípade , že klerik žaluje laika , má sa spor prerokovať pred svetským sudcom .	laika	6	Anim
Za jasotu spoluobčanov prevzali cenu a Dr . Slimák slzil od dojatia , pretože v tejto súťaži doteraz nijaký slimák nevyhral .	jasotu	1	Inan
“ Mal som iba dvoch zákazníkov , ženu a muža .	muža	9	Anim
Dozvedel som sa to , keď som sa vrátil domov a ešte predtým urobil jeden pokus .	pokus	15	Inan
Vláda v každom prípade prijme kroky na zvýšenie motivácie rodičov a ich detí študovať , respektíve skutočne plniť povinnú školskú dochádzku .	rodičov	9	Anim
Takáto interpretácia stvorenia človeka diablom je zjednodušením .	človeka	3	Anim
Ten chlapec si doň predtým vopchal žabu .	chlapec	1	Anim
Vtom zbadal Aladin pred sebou jasnovidca .	jasnovidca	5	Anim
Začínali sa aj pochôdzky chlapa v zelenom vojenskom kabáte .	chlapa	4	Anim
" Nechápeš , že jediným cieľom newspeaku je zúžiť rozsah myslenia ?	newspeaku	6	Inan
Len spomedzi študentov náročnej školy vzídu študenti , ktorí sa dokážu presadiť v silnej konkurencii .	študentov	2	Anim
Vedela , že Chrabroš je v skutočnosti hnojival .	hnojival	7	Anim
V hmle odchádza akýsi tieň .	tieň	4	Inan
Nevlastní rodičia sa o Herkula dobre starali a vyrástol z neho milujúci syn a mladík .	mladík	14	Anim
“ Zdá sa , že sa vracia váš priateľ .	priateľ	8	Anim
Ako šesťročného ( o rok skôr , než bolo zvykom ) ho na základe zvláštnej výnimky prijali medzi Zvedov a ako deväťročný sa stal vedúcim skupiny .	vedúcim	24	Anim
“ Máš cez obed voľno ? “ spýtal sa .	obed	3	Inan
“ Bola o malom tigríkovi , však ? “	tigríkovi	4	Anim
Takto nevyzerá ani autorka článku , ani kamarátova babka .	článku	4	Inan
Nie nadarmo som v mladosti , ešte pred Tomom Jonesom , býval priaznivcom Adriana Celentana .	priaznivcom	12	Anim
Dobrovoľníci z rôznych organizácií pripravili bohatý program : divadelné , umelecké a hudobné dielne aj súťaže .	program	6	Inan
V Studiofilme sa povrávalo , že šéfa čochvíľa odvolajú ; označovali ho za liberálneho modernistu a bolo iróniou osudu , že najostrejšie na neho útočil týždenník Október .	šéfa	6	Anim
Je príznačné , že tu bol neskôr postavený chrám sv . Vlasija .	chrám	8	Inan
Za veľkými stolmi sedeli princovia a šľachtici .	šľachtici	6	Anim
“ Bude tam titulok : Slávna rekordérka fotografuje reportérov , “ povedala Blythe .	reportérov	8	Anim
Vláda však v tejto súvislosti zastáva názor , že NATO i naďalej zostane hlavnou inštitúciou , prostredníctvom ktorej budú európski a severoamerickí spojenci i naďalej riešiť bezpečnostné otázky transatlantického rozmeru .	rozmeru	29	Inan
Formulácia „ Volumus , ut episcopi habeant potestatem . . . “ implikuje interpretáciu , že biskupi , vykonávali svoj úrad z vôle panovníka , že on im udeľoval mandát na reálne pôsobenie v ich úrade .	panovníka	23	Anim
Bol tu nájdený rituálne pochovaný kôň .	kôň	5	Anim
Na nič spred začiatku šesťdesiatych rokov sa nepamätala a ( zo všetkých známych ) jediný človek , ktorý často rozprával o rokoch pred Revolúciou , bol jej starý otec .	známych	12	Anim
Soni by ho zaradila do kategórie dedinských nafúkancov .	nafúkancov	7	Anim
“ Držím ti palce , Amy , “ povedal s úsmevom , ktorý by roztopil i ľad .	palce	3	Inan
“ Takže uličník Aladin je boháč ?	uličník	2	Anim
Bolo sivé popoludnie s oblohou veštiacou sneh , keď sa človeka zmocňuje ubíjajúca otupnosť a uvoľnenie prináša len alkohol .	človeka	10	Anim
Konfirmáciou sa začína skutočný boj s hriechom , diablom a vlastným telom .	hriechom	6	Inan
Ťahal voz dovrchu naložený melónmi .	melónmi	4	Inan
Alfonz prijal s úľavou od kamarátov ponuku , že mu pomôžu pripraviť oslavu .	kamarátov	5	Anim
Kvôli nutnosti ich lepšieho uchopenia je potrebné vopred určiť , z akého hľadiska budeme pramene skúmať .	pramene	14	Inan
Keď bol ľan poriadne mokrý , krtko ho zaniesol na breh .	krtko	6	Anim
Na zvončeku za sebou uvidel Maju .	zvončeku	1	Inan
Posledný szabolcsský kánon , ktorý sa venuje kláštornému životu nariaďuje opátom a mníchom , aby sa nezúčastňovali na kalendových sedeniach , ale aby prijímali oblácie ich účastníkov v kláštoroch .	účastníkov	26	Anim
Okolo výhonkov stromu sa nachádza mriežka s kosoštvorcov .	kosoštvorcov	7	Inan
Pravdepodobne to teda bol cudzinec .	cudzinec	4	Anim
Chlapec bol voľný .	Chlapec	0	Anim
Napokon prišiel autobus .	autobus	2	Inan
Okrem zajatcov priemerný občan Oceánie nikdy nezočí občana Euroázie alebo Východoázie a zakazuje sa ovládať cudzie jazyky .	občan	3	Anim
“ Hlupák ! “ zrevala a chytila si poranenú ruku .	Hlupák	1	Anim
“ Padajme , kým nás tu zbadá správca , “ zašepkala som .	správca	7	Anim
Húf mojich postáv i muž , ktorý mi radil , aby som pohol mozgom , zmizli .	Húf	0	Inan
Zišlo mu na um , že ešte stále nepozná jej priezvisko , ani jej adresu .	um	3	Inan
Konfirmáciou sa začína skutočný boj s hriechom , diablom a vlastným telom .	diablom	8	Anim
Pevnejšie pritlačila veko košíka a odháňala Syreetinu zvedavú opičku .	košíka	3	Inan
V dňoch 18 . a 19 . 4 . 2004 bol hosťom nášho cirkevného zboru prof . Harald Binder zo Švajčiarska .	hosťom	11	Anim
Zrazu si Aladin uvedomil , že naňho so záujmom hľadí vysoký , vážny a trochu zavalitý mladík .	mladík	16	Anim
Si drúk , povedal som tomu ksichtovi v zrkadle .	drúk	1	Anim
Na jeho základe sa bude financovať tzv . solidárny balík , ktorého súčasťou bude aj financovanie siete rýchlej zdravotnej pomoci .	základe	2	Inan
Telový gel , šampón ?	gel	1	Inan
Neuspokojme sa s tým , že sme poslali svojím blízkym veľkonočný pozdrav , ale ukážme im ako vyzerá život v nádeji vzkriesenia a víťazstva v Kristu .	pozdrav	11	Inan
Náš dnešný spisovný jazyk je skutočným kompromisom medzi radikálnou normou štúrovcov a požiadavkami bernolákovcov i tradíciou českou či československou .	bernolákovcov	13	Anim
Najprv však chcela spoznať človeka .	človeka	4	Anim
Ako teda vysvetliť , že žobráci touto zónou opovrhujú ?	žobráci	5	Anim
Náš kolega Mišo Hvorecký je brandista .	brandista	5	Anim
Potrebujeme ľudí , ktorí budú ochotní počúvať svojho partnera , budú dostatočne vzdelaní na to , aby dokázali zaujať jasné stanovisko k mnohým problémom súčasnosti .	partnera	8	Anim
Brat kantor pre vážne osobné dôvody nemohol prísť , preto brat farár sprevádzal nábožný spev na gitare spolu s mládežníkmi , ktorí poslúžili programom a vystúpili aj s osobným vyznaním .	kantor	1	Anim
Kôpka hnoja .	hnoja	1	Inan
Hneď na úvod som urobil niečo veľmi nerozumné : dal som si dvojitý koňak .	úvod	2	Inan
Vtom sa vrátil chrobák Truhlík aj so svojím filmovým časopsom .	časopsom	9	Inan
Náš kolega Mišo Hvorecký je brandista .	kolega	1	Anim
Musíš Veľkého brata milovať .	brata	2	Anim
Pred voľbami bolo – v neposlednom rade v Mostoch – mnoho krásnych vzletných výkladov , prečo treba voliť Martina Bútoru .	rade	6	Inan
Druhou vrstvou bol letopis z rokov 1037 — 1039 .	letopis	3	Inan
Dvakrát sa mi pod vodou omotal okolo krku a prehodil sa na chrbát .	krku	7	Inan
“ To sú takí nešťastníci . “	nešťastníci	4	Anim
Iných stopárov som tu zatiaľ ešte nevidel .	stopárov	1	Anim
Druhou činnosťou , ktorú v Ostrihome klerikom zakázali , bolo úžerníctvo .	klerikom	6	Anim
“ Neopustím ťa ! “ zakričal princ .	princ	6	Anim
Našla osí roj , ktorý mal včelí palác zničiť .	roj	2	Inan
Podľa mojich predstáv sa vracali do pekných domov s vyhrievanými bazénmi .	bazénmi	10	Inan
Svorka sa usadí okolo kmeňa stromu .	stromu	5	Inan
Princ Filip prebehol bránou do paláca .	Princ	0	Anim
Znak potom môžme vykladať ako zobrazenie vtáka s roztiahnutými krídlami a hlavou vysunutou dopredu .	vtáka	6	Anim
Isteže , už dnes nejestvuje dôvod či opodstatnenie na páchanie ideozločinov .	dôvod	5	Inan
Pozrela som na jedálny lístok vyvesený nad pultom , potom na zem a do výkladu .	výkladu	14	Inan
Druhá brutalita marketingu je menej zjavná .	marketingu	2	Inan
Anna Malíková hovorí , že by SNS mala rozšíriť potenciál koaličných partnerov .	partnerov	11	Anim
Skúste siahnuť po nejakej knižnej novinke , zoznam nájdete v Knižnom katalógu .	zoznam	7	Inan
Posledný kánon II . kolomanovskej synody o celibáte sa svojím obsahom vymyká prísnejšiemu tónu uznesení tohto cirkevného snemu .	celibáte	7	Inan
„ Viera môže dávať človeku životnú istotu “ , mieni profesor Ďurovič .	človeku	4	Anim
Pri stanovení termínu veľkého pôstu siahli uhorskí zákonodarcovia k jeho starej východnej podobe ešte spred 7 . storočia , ktorá sa v 11 . storočí nepoužívala už ani na kresťanskom východe ani na západe .	zákonodarcovia	7	Anim
Cieľom reformy poistenia v nezamestnanosti bude posilnenie princípu zásluhovosti ( poistného princípu ) a princípu osobnej zodpovednosti občana za vlastnú pracovnú a sociálnu situáciu .	princípu	11	Inan
Bzdocha a motýľ	motýľ	2	Anim
Hefaistos kul rýchlo blesky , ktoré bohom slúžili ako zbrane .	blesky	3	Inan
Vodné vtáky teda i kačky sú späté s kultom slnca , keďže svojim jarným príletom zvestujú vzrast jeho moci .	kultom	8	Inan
Rýchlo som upratala zo stola a ponáhľala sa do svojej izby .	stola	4	Inan
Jeho obyvatelia odišli a ich odchod sledoval veľký zástup zvedavcov , obyvateľov našej štvrte .	zvedavcov	9	Anim
V súlade s európskym trendom budeme podporovať rozširovanie výmery ekologického poľnohospodárstva a výroby biopotravín .	trendom	4	Inan
Okrem poviedky Sexuálny nenásytník som dal Soni aj ďalšie texty tohto druhu .	nenásytník	3	Anim
Udalosť — popis Samojedov novgorodcom Gorjatom Rogovičom .	novgorodcom	4	Anim
Zdôrazňoval pritom výsadné postavenie apoštolom Petrom založenej rímskej cirkvi a Apoštolského stolca .	apoštolom	4	Anim
Pri ceste postávali stopári a z fľašiek popíjali osviežujúce nápoje .	nápoje	9	Inan
Pravdepodobne to teda bol cudzinec .	cudzinec	4	Anim
Za celé tie roky som ani raz neodovzdala prácu po termíne .	termíne	10	Inan
Doma Alfonz bratovi vyčítal , že mu svojím správaním urobil hanbu a vyhodil ho .	bratovi	2	Anim
“ Kedykoľvek , “ odvetil Chris s úsmevom , zvrtol sa a plával k trénerovi .	trénerovi	14	Anim
“ Držím ti palce , Amy , “ povedal s úsmevom , ktorý by roztopil i ľad .	úsmevom	10	Inan
Ordinácia je akt , ktorým kandidát svätenia ( ordinand ) získava istý stupeň svätenia .	stupeň	12	Inan
„ Môj otec bol selfmademan .	selfmademan	4	Anim
SPIELBERG PREPUSTIL KAMERAMANA	KAMERAMANA	2	Anim
Ráno našla Kasandra chrápajúceho strážcu a prázdnu komoru .	strážcu	4	Anim
Vláda vytvorí systémové legislatívne a inštitucionálne predpoklady pre riešenie medzipodnikovej zadlženosti a s ňou súvisiacich pohľadávok štátu a verejných inštitúcií .	predpoklady	6	Inan
Zároveň však Cluny urobilo veľký krok na ceste k libertas , lebo vytvorilo spoločenstvo ( zväčša ) úplne slobodných kláštorov , ktoré nepodliehali laikom .	laikom	23	Anim
Potom otočil ktorýmsi vypínačom a hlasy zmĺkli .	vypínačom	3	Inan
Publikáciu napísal známy český novinár a publicista Miloš Čermák .	novinár	4	Anim
Zúrivo odrážal nápory paniky .	nápory	2	Inan
Keď sa zobudil , ľan bol suchý .	ľan	4	Inan
Právo na prístup ku kultúrnym hodnotám je jedným z dôležitých práv všetkých občanov .	prístup	2	Inan
JEDNÉHO DŇA SA PYŠNÁ KRÁĽOVNÁ SPÝTALA svojho zázračného zrkadla : “ Povedzže mi , ktože je najkrajší v našej zemi ? “	DŇA	1	Inan
Táto správa ma omráčila a doktor ma odprevadil až dolu , k východu z budovy .	doktor	5	Anim
Proroctvo otcovho priateľa , že bude zo mňa básnik , sa nesplnilo .	priateľa	2	Anim
Na obzore sa objavil čierny bod a ja som si pomyslela , že je to nejaký chrobák .	bod	5	Inan
Systematicky podrýva súdržnosť rodiny , zato svojho vodcu označuje pomenovaním , ktoré priamo vyvoláva pocity rodinnej vernosti .	vodcu	7	Anim
Spomenula som si na mamu , ktorá pracovala na dvoch miestach , aby vládala platiť účty .	účty	15	Inan
Moje oči márne hľadali pri okne so železnými prútmi nejaký rám s oficiálnym portrétom .	rám	10	Inan
Nedokázal premôcť nápor paniky .	nápor	2	Inan
Mládež a šport	šport	2	Inan
Jeho kult mal okrem rozmeru spontánneho ľudového uctievania aj rozmer „ štátneho “ kultu a panovnícky dvor ho vedomo šíril .	rozmer	9	Inan
Schmatol jeden z Winstonových zostávajúcich predných zubov palcom a ukazovákom .	palcom	7	Inan
Napokon ďakujem za vaše modlitby za zbor i nás duchovných pastierov .	pastierov	10	Anim
On a zopár jemu podobných boli poslednými živými spojovacími článkami so zašlým kapitalizmom .	článkami	9	Inan
Človeka to bohvieako nezaujímalo , popíjal z pohára a škriabal na papier tie svoje znaky .	Človeka	0	Anim
Podobalo sa to pokusu o ťah v šachovej partii , keď už má človek mat .	ťah	5	Inan
Cieľom fiškálnej politiky vlády bude zníženie podielu verejného dlhu na hrubom domácom produkte počas volebného obdobia .	podielu	6	Inan
Vytrhal ľan a zviazal ho do snopu .	ľan	1	Inan
Pomedzi stromy zbadala chalúpku , v ktorej bývali trpaslíci .	trpaslíci	8	Anim
Len čo zmizla z dohľadu , Aladin rýchlo zbalil Abdullahove pomôcky .	dohľadu	4	Inan
Začal som chodiť po izbe s telefónom v ruke .	telefónom	6	Inan
Pri cieli sa skrýval osiak Boris a zrkadielkom oslňoval ostatných pretekárov , len aby pomohol svojmu zmrzačenému kamarátovi zvíťaziť .	pretekárov	10	Anim
Zlej víle ostávala posledná nádej — havran .	havran	6	Anim
Vláda prehodnotí systém výkonu správy súdov , ktorý príliš zaťažuje sudcov administratívnymi činnosťami , osobitne pri štátnej správe jednotlivých súdov .	sudcov	10	Anim
Čakanie na šéfa . . .	šéfa	2	Anim
Svedčilo o tom správanie mojich rodičov .	rodičov	5	Anim
Našťastie sme zastali pri obrubníku pred pizzeriou Rajské slasti a všetci náhle stratili o nás záujem , keďže snívali o pizze .	obrubníku	4	Inan
Uprostred salóna bol jedálenský stôl .	stôl	4	Inan
Nechal som televízor zapnutý a privliekol som sa k dverám bytu .	televízor	2	Inan
Na takomto mieste prelínania sa dvoch kultúr sa ľahšie uchovávajú archaické prežitky .	prežitky	11	Inan
Pri príležitosti svojho odchodu a ukončenia zimného obdobia som vyhlásil , že zaplatím koňak všetkým , ktorí budú od dvanástej až do tretej poobede v kaviarenskej časti obchodu .	koňak	13	Inan
Mgr . Ján Bakalár , zb . farár	farár	7	Anim
