Polovicu zo všetkého , čo vo mne je , mám z domu , z toho , čo sa doma povedalo , napríklad pri stole .	mám	9	Fin
Bola Ruska a ja som po nej túžil .	túžil	7	Part
Možno budeš musieť čakať .	musieť	2	Inf
“ Kráľ Louis , tak sa volám , to môže zariadiť .	volám	6	Fin
Vtedy bola zároveň jedným z hlavných nástrojov , vďaka ktorému udržiavali ľudské spoločnosti kontakt s hmotnou skutočnosťou .	udržiavali	10	Part
Bavilo ma písať kompozície a na vynikajúcom skalickom gymnáziu boli veľmi dobré podmienky pre kultúru .	písať	2	Inf
Práve sa chystala roztiahnuť krídla a vzlietnuť , keď v tieni steny zbadala strážcu .	roztiahnuť	3	Inf
Ak chcem niečo dokázať , musím sa Chrisa zriecť .	dokázať	3	Inf
Na chvíľu som sa započúval do ticha na schodišti .	započúval	4	Part
Márne sa ho pokúšam dohoniť .	dohoniť	4	Inf
“ Ubezpečujem vás , že nič nehrozí , “ kričal žene sultánov hlavný vezír Džafar .	Ubezpečujem	1	Fin
Roztiahni krídla a leť .	Roztiahni	0	Fin
Alebo prežili príliš náročnú noc .	prežili	1	Part
Nezáleží na tom , čo povieš či urobíš ; záleží jedine na tom , čo cítiš .	cítiš	15	Fin
Vtáky spievajú , proleti spievajú , Strana nespieva .	nespieva	7	Fin
Nastolíme po voľbách zmenu - odhalením zbohatlíkov , mafiánov , delikventov , korupčníkov a lobistov pri stálom sledovaní blaha občana .	Nastolíme	0	Fin
Snažil sa vyliezť po steble trávy hore , ale steblo sa pod jeho váhou nebezpečne naklonilo nabok .	Snažil	0	Part
Vyvoláva pokušenie .	Vyvoláva	0	Fin
“ Chcem sa pozrieť zblízka .	Chcem	1	Fin
Potrebujem finančnú podporu , ak chcem študovať .	Potrebujem	0	Fin
Nemá inú možnosť , musí to skúsiť .	skúsiť	6	Inf
Uznal som za vhodné požiadať ich , aby ma zobudili o pol piatej .	požiadať	4	Inf
Nezáleží na tom , kto si .	Nezáleží	0	Fin
Rýchlo vyčarila drevený kolovrátok so zradným zeleným vretenom .	vyčarila	1	Part
Sú nápadné , vyzývavé a slušné dievča sa v nich môže odviazať a vyvádzať ako divoška .	vyvádzať	13	Inf
Prijme systém finančnej podpory preventívnych projektov .	Prijme	0	Fin
Hoci mu bude chýbať , Zeus vedel , že Herkules konečne našiel svoje šťastie .	chýbať	3	Inf
To je tajomstvo , povedalo , neprezradím ho každému .	povedalo	4	Part
“ Zaplaťte , “ povedal Rýchlik , ktorý dal kolovať plaveckú čiapku .	kolovať	9	Inf
Bolo by to v poriadku , keby si sa v duchu nestiahla , len čo sa dotkneš steny .	dotkneš	16	Fin
Mauglí doširoka otvoril oči .	otvoril	2	Part
Začala som s kapitolou o zatmení a snažila sa spomenúť na to , čo som videla .	Začala	0	Part
Povedal som mu , že v tú noc som neodišiel z zürišského letiska .	neodišiel	9	Part
Musí sa predsa vrátiť ku Geppettovi !	Musí	0	Fin
Povedala mi , že pochopila , čo ma trápi .	trápi	8	Fin
“ Keby som nevedela , že máte bezpečnostný systém , “ doberala som si Chrisa , “ preliezla by som plot a skočila dnu . “	doberala	11	Part
“ Musím ti niečo povedať .	povedať	4	Inf
Vláda bude podporovať vývoj a šírenie výrobkov i služieb šetriacich životné prostredie a v rámci legitímnych trhových nástrojov hľadať možnosti podpory malým a stredným podnikateľom zvyšovať investície do „ čistej “ výroby a environmentálnych podnikateľských aktivít .	zvyšovať	25	Inf
Vláda bude využívať štátne záruky iba v nevyhnutných prípadoch na prefinancovanie splatných úverov so štátnymi zárukami , ak to umožní zákon o štátnej pomoci a ak hrozí realizácia záruk z prostriedkov verejných financií .	využívať	2	Inf
Týchto ľudí , ktorí pochádzali zo strednej triedy zamestnancov a z vyšších vrstiev robotníckej triedy , sformoval a zoradil jalový svet zmonopolizovaného priemyslu a scentralizovanej vlády .	zoradil	18	Part
Aby som sa dostal k vencu , musel som si vziať stoličku .	vziať	10	Inf
My sme mravce smelé , my sa nezľakneme .	nezľakneme	7	Fin
V každom prípade musím otvoriť oči a nesmiem veriť legendám .	otvoriť	4	Inf
Pustil fľašu z kopca , ale zgúľala sa do potoka a voda ju unášala ako lodičku .	unášala	13	Part
V tej chvíli tréner Augustus zapískal , čím dal znamenie , že dráhy treba uvoľniť na tréning .	uvoľniť	14	Inf
Najviac z nich vzniklo , resp . začínalo vznikať , v rokoch pontifikátu Gregora VII .	vznikať	8	Inf
Mama postupne napísala otcovi niekoľko listov , ale on jej neodpovedal .	neodpovedal	10	Part
Toto ministerstvo však nemuselo uspokojovať mnohoraké potreby straníkov , ale opakovať celú operáciu na nižšej úrovni pre blaho proletariátu .	uspokojovať	4	Inf
Neviem vysvetliť , prečo sme nechodili na rande ako iní .	vysvetliť	1	Inf
Keď sa začal semester , pustil som sa pod vedením profesora SommerfelTa do čítania textov .	pustil	5	Part
Čo najrýchlejšie bežal preč .	bežal	2	Part
Tentoraz mu ju však pripomenula najmä dusná horúčava toho popoludnia , keď mu na čele vyrazili kropaje potu .	pripomenula	4	Part
Vysypte do nej kuskus a vypnite oheň .	vypnite	5	Fin
“ Amy , “ zašepkal Chris , objal ma okolo krku a hladkal ma po vlasoch .	zašepkal	4	Part
Usilovne cvičila až to uši trhalo .	trhalo	5	Part
Jeho prítomnosť vnáša do útvaru už spomenuté prvky hrdinskej epiky — mýtický boj za odstránenie chaosu sa mení na ochranu štátu a viery proti cudzím pohanom .	vnáša	2	Fin
Túžil som vypiť tú vodku čo najrýchlejšie .	Túžil	0	Part
“ Zaklopal som Amy na okno .	Zaklopal	1	Part
Ustráchaní sedeli na akejsi lúke a nevedeli , kadiaľ sa ide domov .	sedeli	1	Part
Mohol vari odolať ?	odolať	2	Inf
Zavedenie inštitútu manažéra súdu zníži počet funkcionárov súdov , ktorí obmedzene vykonávajú súdnictvo .	zníži	4	Fin
A uvedomovať si , že som na tomto svete jediným Loriným zástupcom .	uvedomovať	1	Inf
Takéto oduševnenie stačilo na to , aby som sa zmenil .	zmenil	9	Part
Skryl som sa za obrovitý strom .	Skryl	0	Part
Zrazu sa zachvela zem a dievčatko skoro spadlo .	spadlo	7	Part
“ Takto vonia more ? “	vonia	2	Fin
Konkrétnym formám tohto boja za slobodu cirkvi počas reformy sa budeme venovať neskôr .	venovať	11	Inf
Bolo to , rozumie sa , pred vojnou .	rozumie	3	Fin
Napokon vstal , tackavo a hojdavo prešiel celou , hlboko ponoril ruku do vrecka na kombinéze a s rozpačitým výrazom podal mužovi s umrlčou tvárou ufúľaný kúsok chleba .	vstal	1	Part
Na zem padal teplý dážď a obyvatelia Makovej lúky sa skryli .	padal	2	Part
Boris svieti zrkadielkom do očí , končím , “ hlásil vysielačkou Vilko .	končím	6	Fin
“ Netráp sa , niečo vymyslíme , “ povedala Makulienka .	Netráp	1	Fin
" Ako vyzerá ? "	vyzerá	2	Fin
" Neviem .	Neviem	1	Fin
Vláda sprehľadní pravidlá dotačnej politiky a zároveň dokončí realizáciu schválenej licenčnej politiky .	dokončí	7	Fin
Teraz ma prenasledovatelia chytia , pomyslel si Ferdo .	chytia	3	Fin
Keď Shannon otvorila dvere , sprisahanecky ma objal okolo pliec a vliezol na zadné sedadlo .	vliezol	11	Part
Nemôžeš spať ? “	spať	1	Inf
Spratal neuveriteľné množstvo kukuričných placiek a mľaskal pritom a navyše ich zlostil híkavým smiechom .	Spratal	0	Part
Boris svieti zrkadielkom do očí , končím , “ hlásil vysielačkou Vilko .	svieti	1	Fin
“ Obávam sa , že ten chlapec sa nikdy neožení .	neožení	9	Fin
Dovtedy musí ostať v úkryte vo zvončeku .	ostať	2	Inf
Nespýtala som sa ho to .	Nespýtala	0	Part
Taniere obložte hlávkovým šalátom , na ktorý servírujte kuskus a zeleninovú zmes .	servírujte	7	Fin
Vláda bude presadzovať zásady efektívneho a civilného riadenia ozbrojených síl .	presadzovať	2	Inf
Zaviedla ma na chodbu .	Zaviedla	0	Part
Niekedy mi behajú po rozume všelijaké rozprávky .	behajú	2	Fin
Vzápätí sa však srdečne usmiala .	usmiala	4	Part
Zaviedla Aladina dnu a zavolala sluhu , ktorý ihneď priniesol mešec zlata .	zavolala	4	Part
Než však stačili vzlietnuť , obkolesila ich horda zelených mužíčkov .	vzlietnuť	3	Inf
“ Prosím vás , slečna , “ prosíkal .	Prosím	1	Fin
Miera tejto viny sa ďalej stupňuje s hlúposťami z fascikla číslo 3 .	stupňuje	5	Fin
Vláda uskutoční revíziu úradov , pripraví zmeny v pracovno - právnej legislatíve a uskutoční reorganizáciu štátnej správy .	pripraví	5	Fin
Aladina raz z Rahimovho obchodu vyhnali , keď sa Abu usiloval chvostom potiahnuť trs banánov .	potiahnuť	12	Inf
Revolúcia sa zavŕši vtedy , keď jazyk bude dokonalý .	zavŕši	2	Fin
Iných stopárov som tu zatiaľ ešte nevidel .	nevidel	6	Part
Tak tomu hovorím názorný príklad fungovania zóny najbližšieho vývinu , o ktorej som písala minule !	hovorím	2	Fin
Zrazu si Aladin uvedomil , že naňho so záujmom hľadí vysoký , vážny a trochu zavalitý mladík .	hľadí	9	Fin
Táto výsada zahŕňa najmä , stručne povedané , právomoc uhorského panovníka zriaďovať vo svojej krajine nové diecézy a právomoc dosadzovať biskupov a ďalších vyšších cirkevných hodnostárov do svojich úradov .	zriaďovať	11	Inf
Podľa nich klerici sa nielenže nesmeli opíjať , ale mali aj povinnosť brániť veriacim v prehnanom požívaní opojných nápojov .	brániť	12	Inf
A obchody , ktoré chcú predávať zaručene čerstvý , v noci upečený a nezabalený chlieb , musia ho držať v osobitných zasklených policiach , takže skôr nebalenie chlieb zdražuje .	zdražuje	28	Fin
V tom polosvite som mal všetky dôvody myslieť si , že tam trčím zbytočne , aj keď človek , na ktorého som čakal , sa nevolal Godot .	myslieť	7	Inf
Winston zapálil horák a postavil naň kanvicu s vodou .	zapálil	1	Part
“ Chcem ostať v džungli , “ hundral nahlas .	ostať	2	Inf
Bál som sa , že ma skritizuje za názov , ktorý som prevzal z jednej Čechovovej poviedky .	skritizuje	6	Fin
Vláda bude preto v tomto volebnom období osobitne dbať na schopnosť komunikácie , výcvik , vyzbrojenie , zabezpečenie strategickej prepravy a udržateľnosť špeciálnych jednotiek rýchlej reakcie .	dbať	8	Inf
“ To mi ver , “ odvetil a postrapatil Mauglímu vlasy .	odvetil	6	Part
Mohol to spôsobiť nejaký známy z rokov strávených na fakulte , napríklad niektorý dedinský nafúkanec .	spôsobiť	2	Inf
Možno budeš musieť čakať .	čakať	3	Inf
Každý zavolá Ferdu na pomoc , keď niečo potrebuje .	potrebuje	8	Fin
Táto výsada zahŕňa najmä , stručne povedané , právomoc uhorského panovníka zriaďovať vo svojej krajine nové diecézy a právomoc dosadzovať biskupov a ďalších vyšších cirkevných hodnostárov do svojich úradov .	dosadzovať	19	Inf
A premena , ktorá sa s ňou odohrala , bola ešte prekvapujúcejšia .	odohrala	7	Part
Nemohla sa dočkať , kedy preberieme moje citové záležitosti , a tak prišla k nám .	dočkať	2	Inf
Keď som sa raz vrátil zo sveta do rodného mraveniska , zhrozil som sa .	zhrozil	11	Part
Táto práca a vyznačuje chaotickosťou usporiadania materiálu .	vyznačuje	3	Fin
Maja začala zostavovať mužstvo .	zostavovať	2	Inf
Vychrlila tie otázky tak rýchlo , že som nestačila reagovať .	Vychrlila	0	Part
Chcel vzlietnuť do vzduchu , ale zamotal sa do krídel fraku .	Chcel	0	Part
“ Zachránil som ťa pred riekou , ale čo si teraz s tebou počnem ?	Zachránil	1	Part
V nasledujúcich dňoch som márne čakal , že niekto z nich mi zverí nejaký list .	zverí	12	Fin
Ktosi si všimol Marginu bledosť a zdvorilo jej uvoľnil miesto , aby si mohla sadnúť .	sadnúť	14	Inf
Odtiahla som sa .	Odtiahla	0	Part
Strhla aj mladšiu sestru a s rachotom prevrhli otcovu stoličku .	prevrhli	7	Part
Šaty , ktoré šila Flóra , sa nevydarili .	nevydarili	7	Part
Prvý deň sa deťom v škole veľmi páčilo !	páčilo	7	Part
“ Čakám na teba , “ odvetil .	Čakám	1	Fin
“ Nemôžeme čakať .	čakať	2	Inf
Neprezradila som jej , o čom sme sa rozprávali s Rickom , bála som sa , že sa nazúri , ak zistí , že som sa ich snažila dať dokopy .	zistí	21	Fin
Usadila sa na leknovom liste a začala sa umývať .	umývať	8	Inf
Okamžite vzlietla nad miesto nešťastia , kde topiace sa mravce zúfalo kričali o pomoc .	vzlietla	1	Part
“ Nazri do svojho srdca , ono ti povie , čo máš robiť . “	máš	11	Fin
Musí sa predsa vrátiť ku Geppettovi !	vrátiť	3	Inf
V izbe podo mnou spával Profesor , oddeľovala nás iba tenká dosková podlaha .	oddeľovala	7	Part
“ Mimochodom , “ poznamenal chrobák , “ zabudol som sa predstaviť .	predstaviť	11	Inf
Z nešikovného mladíka sa stal šikovný vrtký chlapík , ochotný ukázať , čo vie .	ukázať	10	Inf
“ Medvedí život sa mi páči , “ povedal Mauglí , keď sa s Balúom pokojne vznášali na vode .	páči	5	Fin
A vravím ti , že nijaké číslo .	vravím	1	Fin
Nechcela , aby sme jej nechali odkaz .	nechali	5	Part
V dome im Bibi vysvetlila , čo dáva psíkom jesť a kde majú svoje misky .	jesť	9	Inf
Toto ministerstvo však nemuselo uspokojovať mnohoraké potreby straníkov , ale opakovať celú operáciu na nižšej úrovni pre blaho proletariátu .	nemuselo	3	Part
Uršuľa sa zahnala trojzubcom .	zahnala	2	Part
Vláda sa bude usilovať o postupné zapájanie kapacít nášho obranného priemyslu do štruktúr európskeho obranného priemyslu .	usilovať	3	Inf
Vtedy mi utkveli v pamäti dátumy , mená i dôležité udalosti z minulosti , medzi ktoré bolo neskôr ľahšie dokladať nové dátumy , mená i vzťahy .	dokladať	19	Inf
Podľa Irminých pokynov – samotná Irma vybavovala všelijaké formality – ma poprosili , aby som odišiel z domu a vrátil sa podľa možnosti až večer .	odišiel	15	Part
Nemohla som tomu uveriť .	uveriť	3	Inf
Usmiala sa na Kalifa , až sa jej na lícach zjavili jamky .	Usmiala	0	Part
Poľsko bude reprezentovať Wojciech J . Has , Českú republiku Jan Švankmajer a Slovensko Štefan Uher .	reprezentovať	2	Inf
Musíš ma pustiť !	pustiť	2	Inf
“ Nemaj strachy .	Nemaj	1	Fin
Keby som tade išiel ako dieťa , určite by som mal chuť zavolať kamarátov z dvora a ísť sa tam hrať „ dole - dole “ .	hrať	20	Inf
Neskoro večer , keď bandy surových proletov vyvádzali na uliciach , vládla v meste zvláštna horúčkovitá atmosféra .	vyvádzali	7	Part
Program prehliadky nájdete tu .	nájdete	2	Fin
“ Nemá čas .	Nemá	1	Fin
Pocítila , že sa blíži explózia , a odtiahla sa .	blíži	4	Fin
“ Chyť volant , “ povedal a otočil sa k zadnému sedadlu , kde mal športový vak .	otočil	7	Part
Netrvalo dlho a vedľa nej sa pod veľkým černicovým kríkom zjavil tučný svetlohnedý pavúk .	Netrvalo	0	Part
Videla som ju zopár ráz na plaveckých pretekoch , lenže nikdy nás nikto nepredstavil .	nepredstavil	13	Part
“ Stále by ti hovorili , kam máš ísť a čo si máš obliecť . “	obliecť	13	Inf
Vláda pripraví legislatívne opatrenia , ktoré zjednodušia sankčný systém v daňovej oblasti .	pripraví	1	Fin
Po skončení vlády prvého stredovekého západného cisára totiž v krajine ochabli štátne garancie dodržiavania zákonnosti .	ochabli	10	Part
Nespýtal som sa jej na to .	Nespýtal	0	Part
Vstala a odišla .	Vstala	0	Part
Zrazu mi napadlo , že vtedy nás to zblížilo , keď bral vážne môj problém s obrátkou .	bral	11	Part
Zaspíš , kým sa dopečie , “ vyhlásila som neisto .	Zaspíš	0	Fin
Inštitút zahladenia odsúdenia by nemal mať účinok opätovného nadobudnutia " bezúhonnosti " .	mať	5	Inf
“ Ubezpečujem vás , že nič nehrozí , “ kričal žene sultánov hlavný vezír Džafar .	kričal	9	Part
“ Máš žalúdočné problémy , Amy ? “ spýtala sa Jill s predstieraným záujmom .	Máš	1	Fin
Musím vymyslieť nejakú tajnú skrýšu , kam ťa cez deň ukryjem .	vymyslieť	1	Inf
Nebude jestvovať umenie , literatúra , veda .	jestvovať	1	Inf
To ju zobudilo .	zobudilo	2	Part
Nezabudnite si ju vypočuť .	vypočuť	3	Inf
Chcela som zaplniť ticho , čo medzi nami zavládlo , a tresla som parádnu hlúposť .	zaplniť	2	Inf
Pošlem ťa do soľných baní . "	Pošlem	0	Fin
Napriek všetkému úsiliu sa príbuzným Sergeja Duku nepodarilo zistiť u kompetentných orgánov nijaké podrobnosti .	zistiť	8	Inf
“ To je legálne ? “ vykríkol ktosi a všetci sa pustili do rehotu .	pustili	11	Part
Chcem dokončiť prácu z angličtiny .	dokončiť	1	Inf
Bála som sa to povedať mame , ktorá prišla na polhodinu domov , aby sa prezliekla , kým pôjde do ďalšej práce .	povedať	4	Inf
Kvôli nutnosti ich lepšieho uchopenia je potrebné vopred určiť , z akého hľadiska budeme pramene skúmať .	určiť	8	Inf
Ako som mohla teraz odmietnuť ?	odmietnuť	4	Inf
Vláda považuje pružný trh práce schopný reagovať na hospodársky vývoj za nevyhnutnú podmienku znižovania nezamestnanosti .	reagovať	6	Inf
Potom zlezie zo stromu a uteká domov . . .	uteká	5	Fin
Má schopnosť vniknúť do môjho vnútra .	vniknúť	2	Inf
“ Zachovajte pokoj a rozvahu , “ zavelila im .	Zachovajte	1	Fin
Tvoje klapanie nám nedá spať .	spať	4	Inf
Vôbec som neveril tomu , čo sa hovorí .	neveril	2	Part
Dieťa vie čítať až vtedy , keď text pochopí .	pochopí	8	Fin
Mohla by sa ma pýtať na Lorinu svadbu a ja by som nevedel , čo jej povedať .	pýtať	4	Inf
Nemohla som si spomenúť , odkiaľ ju poznám .	spomenúť	3	Inf
Už tretíkrát sme sa mohli stretnúť na neformálnej úrovni a prebrať pálčivé problémy , s ktorými sa stretávame na chodbách našej školy .	prebrať	10	Inf
Prestala som na to myslieť .	myslieť	4	Inf
Vláda urýchli a finančne posilní zákonom regulovaný proces vysporiadania vlastníctva pôdy a pripraví komasáciu a proces definitívneho doriešenia vydávania náhradných pozemkov .	urýchli	1	Fin
Trávniky sa premenia na oceány bahna a autá uviaznu pred domami .	premenia	2	Fin
Trvalo to len chvíľu .	Trvalo	0	Part
Popáliť sa na jedinom písmene je klasický prípad , ktorý sa môže vyskytnúť v rôznych podobách .	Popáliť	0	Inf
“ A to je čo ? “ spýtal sa Mauglí .	spýtal	7	Part
Musím vydržať dovtedy , keď sa bolesť nebude dať vydržať .	Musím	0	Fin
Navrhujem poradu skončiť .	skončiť	2	Inf
A nehľaď na mňa .	nehľaď	1	Fin
Nemieni sa vzdať bez boja , tak lacno svoju kožu nepredá .	nepredá	10	Fin
V niekoľkých sekundách po prebudení sen i spomienka , ktorá ho podnietila , splynuli v jeho mysli v jedno .	podnietila	11	Part
“ Vy ten červík zjete ? “	zjete	4	Fin
Mama sa zrejme nemohla utešiť tým , že jej otcovi zostalo meno .	utešiť	4	Inf
Veď ho strhne do hlbočiny , pomyslela si Polly .	strhne	2	Fin
“ No ak to nezistí , nezabije nás , “ navrhol Bôľ .	nezistí	4	Fin
Tekla nadšene schytila husle a knísala sa za Majou .	knísala	5	Part
“ Si ten najstatočnejší a najbystrejší mladý muž , akého poznám , “ povedal vďačne .	poznám	10	Fin
Novozaložené mesto rýchlo zatláča do úzadia susedné centrum na hradisku Timerevo .	zatláča	3	Fin
Preto szabolcsská synoda schválila niekoľko kánonov , ktoré ich mali brániť pred takouto ujmou .	brániť	10	Inf
Usmiala som sa na Chrisa , a on sa uškrnul , ako keby mu naozaj odľahlo , že súhlasím .	súhlasím	18	Fin
Bol to riskantný nápad , lebo nemusel vyjsť .	vyjsť	7	Inf
Mohla by sa ma pýtať na Lorinu svadbu a ja by som nevedel , čo jej povedať .	povedať	16	Inf
Vtedy však Winston spozoroval výhonky vrbiny , ktoré vyrastali z prasklín brala pod nimi .	spozoroval	3	Part
Počula dobre ?	Počula	0	Part
Vytvoríme kapitálotvornú vrstvu , ktorá bude zárukou blaha ľudu , presvedčivo hlásal tvorca blaha svojich prívržencov .	Vytvoríme	0	Fin
Zastav to , zastav !	zastav	3	Fin
Jestvuje v pamäti .	Jestvuje	0	Fin
Ak vojde dnu , bude pred nimi v bezpečí .	vojde	1	Fin
Od tej chvíle som sa myšlienky , že tá mačka mi vidí do duše , nevedela zbaviť .	zbaviť	16	Inf
Vysvetli mi to . “	Vysvetli	0	Fin
Keď pozrela pod seba , zistila , že uviazla v pavúčej sieti .	zistila	5	Part
Tarzana to povzbudilo a prisahal : “ Budem najlepšia opica , aká kedy prišla na svet ! “	povzbudilo	2	Part
Posledný szabolcsský kánon , ktorý sa venuje kláštornému životu nariaďuje opátom a mníchom , aby sa nezúčastňovali na kalendových sedeniach , ale aby prijímali oblácie ich účastníkov v kláštoroch .	nariaďuje	9	Fin
“ Sú veľmi čistotné a hryzú iba vtedy , keď ich obliekate . “	obliekate	11	Fin
Vysvetlil mi , že mi musia položiť iba niekoľko otázok .	položiť	6	Inf
Vtom zazrela oslíka .	zazrela	1	Part
Poslušnosť nestačí .	nestačí	1	Fin
Vláda SR predloží nový zákon o rozpočtových pravidlách a pravidlách rozpočtového hospodárenia územnej samosprávy .	predloží	2	Fin
Začala som výčitkami , ale teraz pokračujem radami do nového roku .	pokračujem	6	Fin
Telefón zazvonil vo chvíli , keď som začal hľadať šach .	zazvonil	1	Part
Vláda bude hľadať spôsoby legislatívnej úpravy , aby v Národnej rade SR neboli prijímané zákony s nekrytými rozpočtovými dôsledkami .	hľadať	2	Inf
Celý dojem nie je nijako uchvacujúci až do chvíle , keď požiadate o jedálny lístok .	požiadate	11	Fin
Chris pokrútil hlavou .	pokrútil	1	Part
Zistil som však , že nie som schopný písať v humornom duchu .	písať	8	Inf
Sadol som si do podniku pri kine a čakal , kým príde určená hodina .	Sadol	0	Part
Neviem , či na mňa viac zapôsobila skutočnosť , že môjho starého otca zabili , alebo meno Hádes , ktoré náš hosť ticho precedil cez zuby .	Neviem	0	Fin
“ Ani sa nečudujem , že pre ňu nemôžete nič vymyslieť .	vymyslieť	10	Inf
Onedlho začul dupot čižiem niekde mimo cely .	začul	1	Part
A očervenel som .	očervenel	1	Part
Niektoré z nich , vydané vo francúzštine , občas dávala aj mne , pričom mi nezabudla prikázať , aby som to nikomu neprezradil .	prikázať	16	Inf
Ak sa priznám , zastrelia ťa , ak sa priznať odmietnem , aj vtedy ťa zastrelia .	zastrelia	15	Fin
Delina nemohla počuť jeho burácanie .	počuť	2	Inf
Vidím dobre ? “ vyľakal sa Ferdo .	Vidím	0	Fin
Práve pripravujem tortu na jej narodeniny .	pripravujem	1	Fin
Mám z toho večera fotku .	Mám	0	Fin
Aj keď mi jeho správanie pripadalo čudné , obdivovala som jeho odhodlanie .	pripadalo	5	Part
Mama pila doma , nikdy sa nestalo , že by sa vrátila z kravínov a razila alkoholom .	pila	1	Part
Jediný kanál s jasným obrazom vysielal pornografické scény .	vysielal	5	Part
Akýsi neomylný inštinkt mi signalizoval , že aj ona myslí na mňa .	signalizoval	4	Part
Rozvinutie tohto nariadenia nachádzame v prvom Kolomanovom zákonníku .	nachádzame	3	Fin
Nevieš napodobniť nejaké tichšie zviera ? “ spýtala sa Kala .	Nevieš	0	Fin
Potom si ľahli spať .	spať	3	Inf
Musím zbaviť Margu myšlienky na smrť .	zbaviť	1	Inf
Zaplietla sa do niečoho neznámeho , ako keby ju lapila neviditeľná nitka .	Zaplietla	0	Part
Ale kým som tak urobil , muž sa na mňa usmial .	usmial	10	Part
“ Nesklamem ťa , otec , “ zvolal Herkules , keď s Pegasom leteli na ostrov Idra .	leteli	13	Part
Celkom mi vyfučalo z hlavy , že som sa s ňou mala stretnúť v knižnici .	stretnúť	12	Inf
Najprv však chcela spoznať človeka .	spoznať	3	Inf
“ Chceš povedať , že s tým nemôžeš niečo urobiť ? “ pýtal sa zúfalý Herkules .	nemôžeš	7	Fin
“ Daj pokoj môjmu mláďaťu ! “ zreval .	Daj	1	Fin
Chlap pochopí , že vlky môžu prísť každú chvíľu .	prísť	6	Inf
Neničíme kacíra preto , že nám odporuje ; pokým nám odporuje , neničíme ho .	Neničíme	0	Fin
Asi sa budem musieť nad sebou zamyslieť .	musieť	3	Inf
Začnem podľa poradia , od fascikla s číslom 1 .	Začnem	0	Fin
“ Nezáleží ? “	Nezáleží	1	Fin
“ Tu budeš bývať ! “ skríkol na ohromeného Pinocchia .	bývať	3	Inf
Vláda Slovenskej republiky prizýva spoluobčanov k spolupráci .	prizýva	3	Fin
Očká zažmurkali .	zažmurkali	1	Part
Vláda podporí doriešenie vlastníckych vzťahov k pôde a rozvoj trhu s pôdou .	podporí	1	Fin
“ Ty si bola uňho doma ? “ prekvapene sa spýtala Blythe .	spýtala	10	Part
Abu takisto pohladkal Rahima po hlave .	pohladkal	2	Part
Ležala schúlená , otočená ku mne chrbtom .	Ležala	0	Part
" To robí táto pliaga , " povedala , strhla si šarlátovú šerpu Antisexuálnej ligy mládeže a odhodila ju na konár .	robí	2	Fin
Robili taký rámus , že sa ich rev ozýval široko ‐ ďaleko po celej džungli .	Robili	0	Part
Všimnime si teraz zaujímavú transformáciu .	Všimnime	0	Fin
Išli sme do mojej izby a mne sa podarilo zapáliť piecku .	zapáliť	9	Inf
Nemôžeš poprieť , že si plakala .	poprieť	1	Inf
Potrebujeme ľudí , ktorí budú ochotní počúvať svojho partnera , budú dostatočne vzdelaní na to , aby dokázali zaujať jasné stanovisko k mnohým problémom súčasnosti .	zaujať	18	Inf
Nerúhajme sa Bohu a nereptajme na všetko a všetkých .	Nerúhajme	0	Fin
“ Nechceš ochutnať ? “ spýtala sa bosorka .	ochutnať	2	Inf
“ Neďakujte .	Neďakujte	1	Fin
“ V Aquitare jedia červíky , otec !	jedia	3	Fin
Trávniky sa premenia na oceány bahna a autá uviaznu pred domami .	uviaznu	8	Fin
“ Ja som sa nikdy nechcel ženiť , “ hundral nespokojne Vilko , “ a ty mi zrazu podstrčíš dieťa ! “	podstrčíš	18	Fin
Utiekla z pivnice !	Utiekla	0	Part
Zabrániť nešťastiu bola konice ‐ koncov jeho povinnosť .	Zabrániť	0	Inf
Poďakovanie patrí aj posudzovateľom rukopisu – pánovi prof . PhDr . Richardovi Marsinovi , DrSc . a pánovi PhDr . Jánovi Steinhübelovi , CSc . , ktorí mi pomohli vylepšiť text svojimi cennými postrehmi .	pomohli	28	Part
Vláda bude analyzovať možnosti zavedenia rovnej dane .	analyzovať	2	Inf
Súviselo to jednak s už spomenutým rozvinutým fungovaním systému vlastníckych kostolov a kláštorov a jednak s existenciou otónsko - sálskeho ríšskeho cirkevného systému v Nemecku .	Súviselo	0	Part
Uvedomila som si , že to , čo vravela , mohlo pokojne platiť aj na Chrisa .	vravela	8	Part
“ Musíš mať fotografickú pamäť . “	mať	2	Inf
Mohol sa volať akokoľvek , nebol však Vehap .	volať	2	Inf
Nevieš napodobniť nejaké tichšie zviera ? “ spýtala sa Kala .	napodobniť	1	Inf
Po očku som sledovala , ako vkĺzol za volant .	sledovala	3	Part
Rýchlo ju prezrela a zistila , že sa na svet pýtajú šteniatka .	pýtajú	10	Fin
Ťažko sa mi dýchalo , trápilo ma určité tušenie .	trápilo	5	Part
“ Pozeraj mi do očí , keď sa s tebou rozprávam ! “ prikázal mu Káa .	rozprávam	10	Fin
Vo svojej pokore ďakuje za požehnané dni služby a pestrý život v rodine i v cirkvi .	ďakuje	3	Fin
“ Uteč , Mauglí , uteč ! “ kričal Balú .	uteč	5	Fin
“ Cvičíme . “	Cvičíme	1	Fin
Nebude jestvovať zvedavosť , radosť zo života .	jestvovať	1	Inf
Vzala Maju za ruku a odviedla ju do miestnosti , kde boli samé medové plásty .	odviedla	5	Part
Jeho odvaha akoby sa zrazu sama od seba zakalila .	zakalila	8	Part
Kňučala a ťahala ich k dverám , akoby im chcela niečo dôležité povedať .	Kňučala	0	Part
“ Veru mohla , “ odvetila makovica .	mohla	2	Part
Začínalo sa brieždiť .	brieždiť	2	Inf
Zrazu zbadal v kroví hlúčik tulákov .	zbadal	1	Part
Zovrel som jej tvár do obidvoch rúk , bol som v akomsi ošiali a cítil som zvieraciu túžbu rýchlo všetko zavŕšiť .	zavŕšiť	20	Inf
Vytvorí legislatívne podmienky pre pristúpenie SR k Dohovoru EHK OSN o prístupe k informáciám .	Vytvorí	0	Fin
Neraz som videla , ako sa máča ľan .	videla	2	Part
Jeho KLIP ‐ KLAP ! počuť široko ‐ ďaleko .	počuť	5	Inf
Hugovi životopisci nás informujú o dobrom výsledku účinkovania opáta v Uhorsku .	informujú	3	Fin
Moja trpezlivosť sa vyčerpala , keď ručičky na hodinkách stihli ukázať pol dvanástej a mne sa nikto nevenoval .	ukázať	10	Inf
“ Musíš byť statočný , ako bol Balú , “ odvetil .	odvetil	10	Part
Lavdim Lavdoshaj sa konečne rozhodol , že mi uverejní jednu poviedku v poslednom septembrovom čísle .	uverejní	8	Fin
Čo sa deje ?	deje	2	Fin
“ Nemôžem sa správať , ako ty chceš ! “ kričala som zachrípnuto .	správať	3	Inf
“ Prestaň sa krútiť !	Prestaň	1	Fin
Biblia nám na to odpovedá .	odpovedá	4	Fin
“ Neviem si ťa v uniforme predstaviť , “ povedala som .	predstaviť	6	Inf
“ Vysvetlíme mu , že ja také niečo nikdy neurobím ! “	Vysvetlíme	1	Fin
Po niekoľkých minútach mu však naskočilo ďalšie , pravdepodobnejšie vysvetlenie .	naskočilo	5	Part
Víťazoslávne na nich hľadela a pritom sa škodoradostne rehotala .	rehotala	8	Part
“ Na to sa spoľahnite ! “ začal vyjednávať chrobák Truhlík .	vyjednávať	8	Inf
Uvidíme , ako do celé dopadne .	Uvidíme	0	Fin
Našla som svojho osobného Spasiteľa , Ježiša Krista vo svetle Ježišovho evanjelia , v ňom som poznala posolstvo pokoja , lásky , radosti a šťastia .	poznala	16	Part
Niečo odkázať ?	odkázať	1	Inf
Zoskočili sme do mäkkej trávy .	Zoskočili	0	Part
Moje záhady sa vyriešili .	vyriešili	3	Part
Keď si Lori sadla do auta , sklonila sa nad volant , plecia sa jej roztriasli a ja som si zarazene uvedomil , že vzlyká .	vzlyká	24	Fin
Snažili sa zachytiť každučké jeho slovo .	zachytiť	2	Inf
Vidí priveľmi jasne a rozpráva priveľmi otvorene .	rozpráva	4	Fin
A čo je ešte horšie , zároveň ho znejasňujem .	znejasňujem	8	Fin
Vláda bude zabezpečovať realizáciu Stratégie rozvoja slovenského knihovníctva .	zabezpečovať	2	Inf
Nebudete poznať kamarátstvo , nebude mať čo vás povzbudiť .	poznať	1	Inf
Asi sa budem musieť nad sebou zamyslieť .	zamyslieť	6	Inf
Ako sa stretla s motýľom Emanuelom	stretla	2	Part
Kasandra preto vyslala včielky popoludní na pole , aby nazbierali kukuricu .	vyslala	2	Part
A ustúpil som nabok , aby mohla prejsť cez tesnú chodbičku .	prejsť	7	Inf
Všetkých , ktorí tam bývali , stihlo nešťastie .	stihlo	6	Part
“ Abu , dnes sa dobre najeme ! “ povedal Aladin .	povedal	9	Part
Chcela som jej povedať o Chrisovi , ale nedokázala som sa zdôveriť so všetkým , čo cítim .	zdôveriť	11	Inf
V každom prípade musím otvoriť oči a nesmiem veriť legendám .	veriť	8	Inf
Nedovolím to ani jednému , ani druhému .	Nedovolím	0	Fin
Vytrhal ľan a zviazal ho do snopu .	zviazal	3	Part
Máme prvé dve požiadavky na modernú baterku .	Máme	0	Fin
Medzitým som sa už naučila čítať , a keď som ich našla , hneď som si ich , samozrejme , prečítala .	prečítala	20	Part
Chrobák zhovievavo pokrútil hlavou .	pokrútil	2	Part
Bol starý , môžeme si povedať .	povedať	5	Inf
Pomaly zacielil pohľad na Winstona .	zacielil	1	Part
Primátor Komárna Štefan Pásztor po svojej sekretárke odkázal SME , že sa k problému nevyjadrí .	nevyjadrí	14	Fin
“ Musím sa učiť . “	Musím	1	Fin
Jediným uznávaným zmyslom manželstva bolo splodiť deti , ktoré mali slúžiť Strane .	slúžiť	10	Inf
Nenadarmo platí " Sýty hladnému neverí " a zároveň neexistuje žiadne porekadlo typu " Ukojený nadržanému neverí " .	platí	1	Fin
Prebehli sme okolo nich a prešmykli sa dozadu k dvojmetrovému múru .	Prebehli	0	Part
Syreeta vyvesila oznam o Abuovom úteku a kto ho nájde , dostane odmenu .	nájde	9	Fin
Touto syntézou môžme vysvetliť mnohé osobitosti hospodárskeho i politického života oblasti .	vysvetliť	3	Inf
V šalátovej mise zmiešajte olej , korenie , soľ , uhorku , cibuľu , petržlenovú vňať a bazalku .	zmiešajte	3	Fin
“ Šteklí ma .	Šteklí	1	Fin
“ Roku 1543 , “ odvetil Chris a opäť sa venoval kresbe .	venoval	10	Part
Okrem zajatcov priemerný občan Oceánie nikdy nezočí občana Euroázie alebo Východoázie a zakazuje sa ovládať cudzie jazyky .	nezočí	6	Fin
V podstate som nedúfala , že príde , no keď som ho zbadala na opačnom konci preplnenej a zadymenej telocvične , myslela som si , že sa mi marí .	príde	6	Fin
Je síce pravda , že nijaký súdruh Ogilvy nikdy neexistoval , ale zopár riadkov v tlači a niekoľko vyfabrikovaných fotografií čoskoro splodia jeho existenciu .	splodia	21	Fin
Vždy môže niektorá z tých sviní identifikovať tvoj hlas .	identifikovať	6	Inf
S nádejou pozrela na Aladina .	pozrela	2	Part
Spevák skupiny sa s deťmi rozprával a pýtal sa ich na to , čo si myslia o Bohu .	myslia	15	Fin
Chcela dva doláre .	Chcela	0	Part
Trápila sa pre ne .	Trápila	0	Part
Sadol som si k stolu , odkiaľ som mohol sledovať pohyb pred vchodom do televízie Sírius .	sledovať	9	Inf
Ide o unifikáciu .	Ide	0	Fin
Ukradomky pozrel na Kalifa .	pozrel	1	Part
A začal som chodiť hore ‐ dole po izbe .	chodiť	3	Inf
Dobrosrdečná dievčina sa mu však neustála snaží dohodiť nejakého priateľa .	dohodiť	7	Inf
Nezáleží na tom , čo povieš či urobíš ; záleží jedine na tom , čo cítiš .	povieš	5	Fin
Namiesto odpovede som ho išiel vypnúť ja .	vypnúť	5	Inf
Povedala , že už neznesie život v takomto špicľovaní .	Povedala	0	Part
Chcel som ju pohoršiť , dosiahnuť , aby odišla .	pohoršiť	3	Inf
Vláda bude podporovať vývoj a šírenie výrobkov i služieb šetriacich životné prostredie a v rámci legitímnych trhových nástrojov hľadať možnosti podpory malým a stredným podnikateľom zvyšovať investície do „ čistej “ výroby a environmentálnych podnikateľských aktivít .	hľadať	18	Inf
Neskôr som sa dozvedel , že sa volá Sergej .	volá	7	Fin
Poďakovanie patrí aj posudzovateľom rukopisu – pánovi prof . PhDr . Richardovi Marsinovi , DrSc . a pánovi PhDr . Jánovi Steinhübelovi , CSc . , ktorí mi pomohli vylepšiť text svojimi cennými postrehmi .	vylepšiť	29	Inf
Winston dojedol chlieb so syrom .	dojedol	1	Part
“ To je ono ! “ zvolal Balú .	zvolal	6	Part
Začal písať o značkách aj seriál , pretože patria neodmysliteľne k našej civilizácii .	patria	8	Fin
“ Musím rozmýšľať . “	rozmýšľať	2	Inf
Okolo hučal a bzučal najrôznejší hmyz a v stromoch na plné hrdlo vyspevovali vtáci .	hučal	1	Part
Pocítil som znechutenosť .	Pocítil	0	Part
Jej oddychovanie prezrádzalo , že opäť usína .	usína	6	Fin
No keď sa stane na brehu jazera nehoda , Polly zachraňuje !	zachraňuje	10	Fin
Myslím však , že vysoká škola má dve významné úlohy , ktoré so spomínanou rovnicou priamo nesúvisia .	nesúvisia	16	Fin
Dieťa vie čítať až vtedy , keď text pochopí .	vie	1	Fin
Ak sa neponáhľate , počkajte chvíľu . “	počkajte	4	Fin
Svoje životy zasvätili dobytiu sveta , ale vedia aj to , že vojna má sa viesť do nekonečna a nemá ju korunovať víťazstvo .	vedia	7	Fin
Spratal neuveriteľné množstvo kukuričných placiek a mľaskal pritom a navyše ich zlostil híkavým smiechom .	mľaskal	6	Part
“ Flip sa chcel do jednej hneď pustiť .	pustiť	7	Inf
Z nešikovného mladíka sa stal šikovný vrtký chlapík , ochotný ukázať , čo vie .	vie	13	Fin
Nemôžeš nikomu veriť . “	Nemôžeš	0	Fin
V niektorých ohľadoch bola oveľa kritickejšia ako Winston a oveľa menej ochotná prijímať stranícku propagandu .	prijímať	12	Inf
Dal som mu takéto meno , keď som s akousi ľahkosťou presvedčil sám seba , že toto meno najlepšie pristane môjmu hrdinovi .	pristane	19	Fin
Musím niečo urobiť , inak hrozí , že sa nezúčastním na Lorinom svadobnom obrade .	urobiť	2	Inf
Keď som si naň spomenula , zakrútila sa mi hlava .	zakrútila	6	Part
Musí sa veľa učiť a Kasandrinou úlohou bolo vychovať ju a pripraviť na život včely .	učiť	3	Inf
Mýlil som sa .	Mýlil	0	Part
Chcem spresniť , že v mojich očiach bol Profesor už takmer starec .	spresniť	1	Inf
Mne to môžeš povedať . “	povedať	3	Inf
Obyvatelia lúky sa začali zbiehať pred jej domom a chválili Klotildin spev .	zbiehať	4	Inf
Zrkadlo sa istotne mýli , pomyslela si kráľovná .	mýli	3	Fin
Ako teda vysvetliť , že žobráci touto zónou opovrhujú ?	vysvetliť	2	Inf
Koordináciu európskej politiky štátu ako súčasti zahraničnej politiky bude zabezpečovať MZV SR v úzkej spolupráci s ostatnými ústrednými orgánmi štátnej správy .	zabezpečovať	9	Inf
Chvíľu ho nechali metať sa vo vode , no potom prilákali k studni muža , čo okopával záhradku .	metať	3	Inf
Pokúšal sa jej to vysvetliť tak , aby pochopila . " Toto bol výnimočný prípad .	pochopila	8	Part
Pocítila ľútosť a pritisla ma k sebe .	pritisla	3	Part
A otočil som sa na druhý bok .	otočil	1	Part
Potrebovali sme istý čas , kým sme pochopili , že takáto pretvárka znamená zbytočné utrpenie .	pochopili	7	Part
Chcel vzlietnuť do vzduchu , ale zamotal sa do krídel fraku .	vzlietnuť	1	Inf
Odteraz sme jej rodičia , tak ju musíme niesť , “ povedala potom Vilkovi .	musíme	7	Fin
Koho som hľadal ?	hľadal	2	Part
“ Tieto zbrane ti pomôžu zvíťaziť nad zlom , “ povedali mu .	zvíťaziť	5	Inf
" A to už bolo čo ? " opýtal sa prekvapene .	opýtal	8	Part
Na všetky otázky im budú odpovedať odborníci .	odpovedať	5	Inf
Niečo tu nesedí .	nesedí	2	Fin
Winston usúdil , že nepostačí iba zmeniť zmysel prejavu Veľkého brata .	zmeniť	6	Inf
“ Nijaké záhady sa nekonajú , “ odvetil Chris .	nekonajú	4	Fin
Povedala mi , že sa milujeme naposledy .	milujeme	5	Fin
Prvý raz mám príležitosť byť so spisovateľom a filmovým scenáristom , povedala .	mám	2	Fin
“ Bola si prekrásne bábätko , “ vravela mi .	vravela	7	Part
Z obdobia 11 storočia pochádza šestnásť kusov .	pochádza	4	Fin
Túto úlohu by mali zabezpečiť názvy jednotlivých kapitol .	zabezpečiť	4	Inf
Rozčúlil sa , že ho vyrušujem po pracovnom čase .	vyrušujem	5	Fin
Išla prvá , ja za ňou a ocitli sme sa uprostred izby .	ocitli	7	Part
Sú nápadné , vyzývavé a slušné dievča sa v nich môže odviazať a vyvádzať ako divoška .	odviazať	11	Inf
Starú meravú nekompromisnosť a nekomunikatívnosť oživila idea odtrhnutia Slovenska od tisícročného Uhorska a najmä štátneho spojenia s Čechmi .	oživila	5	Part
Začala hovoriť pomaly .	hovoriť	1	Inf
Hľadal dieru .	Hľadal	0	Part
“ Super , “ povedala som , keď sme kráčali ku kabrioletu .	kráčali	9	Part
Na hrebeni sa otočil a zaparkoval autom celkom pri okraji cesty .	zaparkoval	5	Part
Zachvátila ma panika , nevládal som utekať .	utekať	6	Inf
“ Počkajte !	Počkajte	1	Fin
Rozochvel som sa a pomyslel som si , že rovnako rozochvieť sa musela aj ona .	rozochvieť	10	Inf
“ Buď ho pomôžeš nájsť , alebo ja prevezmem velenie ! “	pomôžeš	3	Fin
Ale ja som bol zmätený a nedokázal som reagovať .	reagovať	8	Inf
V každom prípade musím otvoriť oči a nesmiem veriť legendám .	nesmiem	7	Fin
Niet pochýb , že nikdy nemohlo jestvovať obdobie , keď to bolo celkom bežné .	jestvovať	6	Inf
Nezabudnite si ju vypočuť .	Nezabudnite	0	Fin
Vyspevovali sme odrhovačky , občas sme lúštili krížovky alebo sa hrali slovné hry .	hrali	10	Part
Na stoloch stáli všelijaké fľaštičky a v bankách bublali záhadné tekutiny .	stáli	2	Part
Možno som vôbec nič nepovedal .	nepovedal	4	Part
Takto ty zdravíš svojho otca ? “ spýtal sa ho Zeus .	zdravíš	2	Fin
V mnohých prípadoch to zaberie .	zaberie	4	Fin
V reformnom hnutí v 10 . a 11 . storočí musíme zreteľne odlíšiť dve základné línie – staršiu reformu monastickú a mladšiu reformu rímsku , resp . pápežskú .	odlíšiť	12	Inf
Ďalšiu polovicu som odhodil do kontajnera pri sedačke .	odhodil	3	Part
Winston to samozrejme vedel .	vedel	3	Part
Odporná extáza strachu a pomstychtivosti , túžba zabíjať , mučiť , drúzgať tváre kováčskym mlátom akoby preskočila sťa elektrický prúd na všetkých a premenila každého aj proti jeho vôli na vrieskajúceho pomätenca s pokrivenou tvárou .	drúzgať	11	Inf
Od ľaku som nevládal vyriecť slova .	vyriecť	4	Inf
Jazmína pokrútila hlavou .	pokrútila	1	Part
Nanešťastie si Tekla zaumienila , že pri tejto príležitosti predvedie huslové sólo .	zaumienila	3	Part
Mama vybehla naštvane na chodbu .	vybehla	1	Part
“ Modlíš sa ? “ vyrušil ma akýsi hlas .	Modlíš	1	Fin
Ostala však sedieť na rohožke .	sedieť	2	Inf
Páči sa mi tvoja myseľ .	Páči	0	Fin
Vláda urýchli a finančne posilní zákonom regulovaný proces vysporiadania vlastníctva pôdy a pripraví komasáciu a proces definitívneho doriešenia vydávania náhradných pozemkov .	pripraví	12	Fin
Rád by vedel , či dostali pána Charringtona .	vedel	2	Part
Po chvíli sa upokojil a začal vysvetľovať .	upokojil	3	Part
“ Mám ťa vyskúšať ? “	vyskúšať	3	Inf
Pomyslel som si , že keď ju tam zvalili a vláčili po uliciach , podarilo sa jej nejako utiecť , ako utekajú sochy , a prišla sa postaviť sem .	postaviť	27	Inf
Maja sa zasmiala .	zasmiala	2	Part
“ Nikdy nevystúpim na Olymp , “ vravel Filovi .	nevystúpim	2	Fin
“ Pravú lásku stretnete čoskoro .	stretnete	3	Fin
Ani družka , ani sok ho nesledujú . Čo ho núti vysedávať na konári osamoteného stromu a vyludzovať hudbu do prázdna ?	nesledujú	6	Fin
Marga nechcela , aby sme zobudili Irmu .	zobudili	5	Part
“ Kvak , “ zvolala na krtka žaba , “ počkaj , pomôžem ti .	počkaj	10	Fin
Tí vo väčšine prípadov velebili filmy nakrútené podľa mojich scenárov .	velebili	4	Part
Šetrí aj pani ministerka financií , ktorá stále nevylučuje ďalšie zvyšovania cien a zodpovednosť za to prenechala na vedúcich úsekov ?	nevylučuje	8	Fin
“ Si v poriadku , Amy ? “ spýtal sa potichu chlapčenský hlas , keď som sa kašlúc vynorila .	Si	1	Fin
Rímska cirkev a jej biskup na základe tohto výnimočného postavenia disponovali autoritou , ktorej bol každý povinný preukazovať absolútnu poslušnosť .	preukazovať	17	Inf
Regula metského biskupa podrobne ustanovuje i podmienky prijatia do spoločenstva kanonikov a v rámci nich predpisuje pre kandidáta povinnosť odovzdať všetok majetok kostolu , pri ktorom mieni pôsobiť .	ustanovuje	4	Fin
“ Dúfam , že získam štipendium na niektorú vysokú školu , “ vyhlásila som , ale nespomenula som , že by som chcela ísť na menšiu , no o to prestížnejšiu univerzitu .	nespomenula	16	Part
Naši neurológovia pracujú na tom už teraz .	pracujú	2	Fin
Recepčné sa podujali objednať taxík a zobudiť ma , kedy uznám za vhodné .	podujali	2	Part
“ Pri opičom more to tak býva , “ odvetil chlapec .	odvetil	9	Part
Ferdo si napravil šatku a vyšli z brány mraveniska .	napravil	2	Part
Pokúšal sa jej to vysvetliť tak , aby pochopila . " Toto bol výnimočný prípad .	vysvetliť	4	Inf
Vláda pripraví a realizuje systém ochrany slovenského spotrebiteľa a prostredníctvom legislatívy ho prispôsobí stavu , ktorý bude zodpovedať legislatíve EÚ .	pripraví	1	Fin
Potom Maja s kamarátmi pomáhala stroskotancom z vody na nové plavidlo .	pomáhala	4	Part
Opatrne som vstala , aby som ju nezobudila a išla som vypnúť televízor .	vstala	2	Part
Odkazy tohto druhu Margu obyčajne rozčuľovali .	rozčuľovali	5	Part
Skúsil to ešte raz , ale nezdvihol ju .	Skúsil	0	Part
Nerob zo seba hlupáka , povedali mi .	Nerob	0	Fin
“ Otrávte ich , utopte , roztrieskajte im hlavy .	Otrávte	1	Fin
“ Správne , “ odvetil Džafar so zlovestným úškrnom .	odvetil	4	Part
Napokon preletel cez domček slimáka Oskara a skončil na baze .	skončil	7	Part
“ Spomínaš na tú rozprávku , čo ti mama rozprávala , keď si nemohla zaspať ? “	Spomínaš	1	Fin
Pocítil , že na znak nesúhlasu pokrčila ramená .	Pocítil	0	Part
Zaletela k nim , sadla na kvet a počúvala tiché zurčanie potoka .	počúvala	8	Part
Prestal myslieť na vojnu .	myslieť	1	Inf
Winstona predovšetkým dráždilo , že v tom rámuse hlasov sotva počul Parsonsove slová , takže ho musel sústavne žiadať , aby svoje nezmysly opakoval .	žiadať	18	Inf
Prísnosť uhorských „ protialkoholických “ kánonov a aj ich početnosť svedčia o Kolomanovej snahe vykoreniť z klerických kruhov neduh nadmerného požívania alkoholu .	vykoreniť	14	Inf
Niet pochýb , v hlave mám zmätok .	Niet	0	Fin
Chytil ma za zápästie a ja som zacítila jeho mocné prsty .	zacítila	7	Part
Spýtala sa ma , či ho môže vypnúť .	vypnúť	7	Inf
Vlečiete sa ako slimáky !	Vlečiete	0	Fin
Zavedie štátnu maturitnú skúšku na stredných školách .	Zavedie	0	Fin
A Trúbeľko sa zasa radoval , že sa Ferdovi nič zlé nestalo .	radoval	4	Part
Keďže mu nechceli odpovedať na otázku , Hádes sa uchýlil k lichôtkam .	odpovedať	3	Inf
Vláda v každom prípade prijme kroky na zvýšenie motivácie rodičov a ich detí študovať , respektíve skutočne plniť povinnú školskú dochádzku .	plniť	17	Inf
Tak sa učili variť , robiť jednoduché kuchynské práce ako umývanie riadu , škrabanie zemiakov , krájanie chleba .	robiť	5	Inf
Volá sa Maja .	Volá	0	Fin
Niečo ostro cvaklo .	cvaklo	2	Part
Syme však pochopil , čo chcel povedať .	povedať	6	Inf
Najprv sme sa pomaly a opatrne zakrádali k ich domu , ale potom sme prebiehali od lampy k lampe .	zakrádali	6	Part
Ďalší predavač ho zasa zbil vreckom šošovice .	zbil	4	Part
Rozzúreného Šuchtáka vystrieda slimák Plazivec a hra pokračuje .	vystrieda	2	Fin
Čujte , čujte !	čujte	2	Fin
Stále si myslíš , že sú štyri .	myslíš	2	Fin
Vtedy som nemohol tušiť , že to mesto mi vybrala prozreteľnosť .	tušiť	3	Inf
To a všeličo iné vlastne očakáva každý veliteľ útočiaceho vojska , uvažoval Ferdo .	očakáva	5	Fin
Snehulienka jej pomohla vstať .	vstať	3	Inf
Hľadel jej do tváre zo vzdialenosti niekoľkých krokov .	Hľadel	0	Part
Napokon chytil vak a hodil mi ho na kolená .	chytil	1	Part
A tak bocian polámal ľan zobákom .	polámal	3	Part
“ Otec , on spáva s potkanmi ! “	spáva	4	Fin
Nateraz však sa O ' Brien odvrátil .	odvrátil	6	Part
“ Čo sa s tebou deje , Amy ? “ vypytoval sa ma po pretekoch tréner August a odviedol ma nabok , kým ostatní nastupovali do autobusu .	odviedol	18	Part
Za okamih boli preč a na lúčke opäť zavládol mier .	zavládol	8	Part
Hneď nás pribehla spolu odfotiť .	odfotiť	4	Inf
Tak sa učili variť , robiť jednoduché kuchynské práce ako umývanie riadu , škrabanie zemiakov , krájanie chleba .	variť	3	Inf
Predavači tu núkali všeličo od výmyslu sveta — mosadzný riad , sladké datle i čerstvé ryby .	núkali	2	Part
“ Mrzí ma to , “ vyhlásil Vilko , “ ale Kurt nie je nijaká osa ! “	Mrzí	1	Fin
Nechcela som sa s Chrisom rozísť .	rozísť	5	Inf
Lenže ten príbeh musel dopísať .	dopísať	4	Inf
Teraz mohol Hádes vyjednávať .	vyjednávať	3	Inf
V ranoarpádovských zákonníkoch nachádzame aj ustanovenia o Božích súdoch , iracionálnom dôkaznom prostriedku , ktorý sa v stredovekom súdnom konaní hojne aplikoval .	aplikoval	21	Part
Smiala som sa .	Smiala	0	Part
Winstonovi začal na chrbte vystupovať pot .	vystupovať	4	Inf
Pomôžu vám vyniesť nahor veci , povedal Cerberus a podal ten kľúč mame .	vyniesť	2	Inf
Vláda prehodnotí doterajší spôsob podpory malého a stredného podnikania s akcentom na územnú samosprávu a prihraničnú spoluprácu .	prehodnotí	1	Fin
Jeho prítomnosť vnáša do útvaru už spomenuté prvky hrdinskej epiky — mýtický boj za odstránenie chaosu sa mení na ochranu štátu a viery proti cudzím pohanom .	mení	17	Fin
Obom sa chcelo spať .	spať	3	Inf
“ Vezmi ju stadiaľ , ona odíde , a ty ostaneš . “	Vezmi	1	Fin
U dovážaných produktov zabezpečí elimináciu tých , ktoré nespĺňajú kritériá kvality a ktoré neprešli colným a daňovým vysporiadaním .	nespĺňajú	8	Fin
Voš žijúca v lone vystúpi nahor , na krk , voš z vlasov sa spustí dolu , na líce .	spustí	14	Fin
Prestal premýšľať a iba vnímal .	premýšľať	1	Inf
Tú báseň som napísal v štvrtej triede základnej školy , chcel som napodobniť jedného básnika , ktorý bol otcovým priateľom .	napodobniť	12	Inf
Zrazu ich však prerušilo hlasné a falošné vrzúkanie huslí .	prerušilo	3	Part
Vláda bude podporovať podnikanie a zlepšovať podnikateľské prostredie .	zlepšovať	5	Inf
Cestou zoťali strom — budú ho potrebovať , ako baranidlo , keď budú chcieť vyvaliť bránu .	zoťali	1	Part
Keď zbadal , že mám poloprázdny pohár , hneď mi dolial .	dolial	10	Part
Keď to povedal , položil mi nečakanú otázku .	položil	4	Part
Vždy povstali noví a noví zadubenci , ktorí sa mu dali zviesť .	zviesť	11	Inf
Našla som svojho osobného Spasiteľa , Ježiša Krista vo svetle Ježišovho evanjelia , v ňom som poznala posolstvo pokoja , lásky , radosti a šťastia .	Našla	0	Part
Keď si Lori sadla do auta , sklonila sa nad volant , plecia sa jej roztriasli a ja som si zarazene uvedomil , že vzlyká .	sadla	3	Part
Netušila som , že počúvajú , ale zrazu všetci hýrili nápadmi .	počúvajú	4	Fin
Ak nevyjde , nemáme dôvod stretnúť sa .	nevyjde	1	Fin
“ Ty mi neveríš , však ? “	neveríš	3	Fin
Nemyslite si , že nepôjdu .	Nemyslite	0	Fin
Petronila jej to právom vyčíta .	vyčíta	4	Fin
Keď Šer Chán narátal do desať , otvoril oči .	otvoril	7	Part
To každý človek uznáva , ale toto je príliš veľká záťaž na Mimobratislavčanov . “	uznáva	3	Fin
Jill a tri plavkyne z plaveckého oddielu Žralokov otvárali vo vode oči , keď som sa vyšvihla hore .	vyšvihla	16	Part
Trvalo to až do Drača .	Trvalo	0	Part
Ako vyzerá herec snov ?	vyzerá	1	Fin
Chcem jej uniknúť , zväzuje mi nohy .	zväzuje	4	Fin
Zasmial sa a ja som si uvedomila , že napätie pominulo .	pominulo	10	Part
“ Vieš , musím chvíľu popremýšľať , “ povedal Káa .	musím	3	Fin
Ak si želáte dievča , povedala , zariadime to .	zariadime	7	Fin
“ A nezabudnite na vrecká , kam zabalíte psom zvyšky . “	nezabudnite	2	Fin
Tentoraz nebola sama .	nebola	1	Part
Chcela ho odohnať , ale Tarzan jej chytil ruku .	odohnať	2	Inf
“ Keby len to ! “ zvolala hrdo Lolka .	zvolala	6	Part
Aladin zle spal .	spal	2	Part
Pretvarovala sa , rovnako ako ja .	Pretvarovala	0	Part
Musím niečo urobiť , inak hrozí , že sa nezúčastním na Lorinom svadobnom obrade .	Musím	0	Fin
Kňučala a ťahala ich k dverám , akoby im chcela niečo dôležité povedať .	povedať	12	Inf
Už štrnásť mesiacov nijaké číslo so sedmičkou na konci nevyhralo .	nevyhralo	9	Part
Chcela som jej povedať o Chrisovi , ale nedokázala som sa zdôveriť so všetkým , čo cítim .	povedať	3	Inf
“ Prepáč , Herkules .	Prepáč	1	Fin
Niekoľkokrát ho už videla z bezpečnej vzdialenosti , ale nikdy sa neodvážila k nemu priblížiť .	videla	3	Part
Žuk meškal , a hoci som sa všemožne pokúšal opäť zaspať , nedarilo sa mi to .	zaspať	10	Inf
Videl , že chce niečo povedať .	povedať	5	Inf
“ A teraz idem pohľadať to malé bezmocné úbožiatko . “	pohľadať	4	Inf
Presadni si na druhú stranu postele .	Presadni	0	Fin
Pokrčila plecami a usmiala sa .	Pokrčila	0	Part
Vláda bude presadzovať zrušenie systému maximálnych cien a zmenu kategorizácie úhrady liekov tak , aby obsahom solidárneho balíka bola v každej anatomicko - terapeutickej skupine aspoň jedna účinná látka .	presadzovať	2	Inf
Bolo by hanba predstúpiť pred žiakov v takom stave .	predstúpiť	3	Inf
Nemám z toho dobrý pocit .	Nemám	0	Fin
Dozvedel som sa a stále tomu neviem uveriť .	uveriť	7	Inf
Chcela som jej povedať o Chrisovi , ale nedokázala som sa zdôveriť so všetkým , čo cítim .	nedokázala	8	Part
Naším zámerom je odstrániť najmä deformácie , ktoré zakladajú neopodstatnené nerovnosti medzi občanmi alebo zavádzajú do sociálneho systému cudzorodé prvky , akým je napríklad nesystémové včlenenie kúpeľnej starostlivosti do sociálneho poistenia .	odstrániť	3	Inf
Môj úsmev do diaľky žiari , tvár zdobia mandľové oči .	žiari	4	Fin
Vláda zdokonalí transparentný systém financovania cirkví a náboženských spoločností .	zdokonalí	1	Fin
Radšej zomreli , akoby mali Krista zradiť a zaprieť .	zradiť	6	Inf
Nevládala som naňho pozrieť .	pozrieť	3	Inf
Malo sukničku z makových lupienkov a usmievalo sa .	Malo	0	Part
Túžil som vypiť tú vodku čo najrýchlejšie .	vypiť	2	Inf
Nechodieval k nemu nikto okrem stareny v širokých nohaviciach .	Nechodieval	0	Part
Kuber to vie , no neodváži sa odporovať .	vie	2	Fin
“ Musíte tam vletieť , “ radila Petronila s plnými ústami .	vletieť	3	Inf
“ Stavím sa , že je to bytosť z inej planéty , “ zašepkala Maja a zatiaľ čo sakamaráti skrývali za jej chrbtom , podišla bližšie a navrhla neznámemu prehliadku Makovej lúky .	Stavím	1	Fin
Vietor im prilepil tenké kombinézy na telo .	prilepil	2	Part
Bolo prirodzené , že roztiahla pery do úsmevu .	roztiahla	4	Part
Pani učiteľka sa usmievala a pousádzala ich okolo stola .	pousádzala	5	Part
Potom vzal Balú Mauglího na plecia a Baghíra kráčal za nimi .	vzal	1	Part
Pôsobil tam ako tlmočník a povedal , že keď Angličania pristáli , ich prvou požiadavkou bolo vybudovať poľné WC .	Pôsobil	0	Part
Baghíra ich sledoval , kým mu nezmizli z dohľadu .	nezmizli	6	Part
Vedela , že ho má v hrsti .	Vedela	0	Part
“ Myslím na dnešné preteky , “ zaklamala som .	Myslím	1	Fin
Zostal som stáť , ani som sa nepohol .	nepohol	7	Part
Chcela ho odohnať , ale Tarzan jej chytil ruku .	chytil	7	Part
Oznámime to slečne Kasandre a budeme žiadať náhradu škody .	žiadať	6	Inf
U citlivejších osôb to môže spôsobiť zbytočné bolesti hlavy .	spôsobiť	5	Inf
“ Nesmieš sa udrieť , nesmieš sa udrieť , nesmieš sa udrieť .	udrieť	3	Inf
Občas sa niekto chabo a dosť bezvýsledne pokúsil sfúknuť dvadsaťcentimetrové plamene .	sfúknuť	8	Inf
Stál tam v otrhaných šatách , aké nosieval , keď sa túlal po uliciach .	nosieval	7	Part
“ Preber sa , Baghíra , preber sa ! “ kričal Mauglí .	preber	6	Fin
Volám sa ľan .	Volám	0	Fin
Pri špecifikácii tohoto druhu pramenného materiálu budem vychádzať — na rozdiel od prameňov hmotných — z hľadiska časového , ohraničeného 11 storočím / bližšie pozri v kapitole „ Formulácia problému “ / .	vychádzať	7	Inf
Ani družka , ani sok ho nesledujú . Čo ho núti vysedávať na konári osamoteného stromu a vyludzovať hudbu do prázdna ?	núti	10	Fin
“ Videl som ťa v bazéne a mal som sa ti vyhnúť .	vyhnúť	11	Inf
Povedala , že sa cíti unavená a na druhý deň musí zavčasu vstávať .	vstávať	12	Inf
Chcem rozpovedať istý príbeh , a nechtiac ho zamotávam .	rozpovedať	1	Inf
Už vedela , na čo ho Barbie potrebuje .	vedela	1	Part
Zmizni lebo mi odplašíš zákazníkov .	odplašíš	3	Fin
Vtedy som prestal sledovať predstavenie v parku .	sledovať	3	Inf
Musí odpútať ich pozornosť .	odpútať	1	Inf
Najprv so mnou nechcela hovoriť .	hovoriť	4	Inf
Uvedomila som si , že to , čo vravela , mohlo pokojne platiť aj na Chrisa .	mohlo	10	Part
Avšak rodine malého paviána sa nepáčilo , ako sa Jane správa k ich mláďaťu a nazlostení začali dievčinu prenasledovať .	prenasledovať	18	Inf
Čo sa chcete dozvedieť o svojej budúcnosti , Alia ? “	dozvedieť	3	Inf
Boli to mizerné , chatrné rárohy , ale akékoľvek hrnce sa vždy ťažko zháňali .	zháňali	13	Part
“ Dám si na teba dobrý pozor ! “	Dám	1	Fin
Mlčky mi podal obálku , čo sa podobala obálke , ktorú mi zverila Liza .	zverila	12	Part
Vykročil k nemu , potom zastal ako vrastený do zeme .	zastal	5	Part
Vtom sa však stalo niečo veľmi čudné .	stalo	3	Part
Ďakujem , “ odvetila som a vymanila si studené prsty spod jeho rúk .	Ďakujem	0	Fin
Tá myšlienka mu v skutočnosti v mysli skrsla v podobe vidiny , skleného ťažidla , ktoré sa zrkadlilo na povrchu sklápacieho stola .	skrsla	7	Part
“ A reči o tvojom starkom neber vážne .	neber	6	Fin
Na jeho základe sa bude financovať zdravotná starostlivosť nad rámec tzv . solidárneho balíka .	financovať	5	Inf
Ide v nich napospol o reglementovanie podmienok azylu pre zlodejov , ktorí utečú do kostolov .	Ide	0	Fin
Spokojne som sedela na trávniku pred domom , vdychovala eukalyptovú vôňu a chladnejší vzduch i sledovala som , ako nado mnou vetrík povieva palmovými listami .	povieva	22	Fin
Netušili , čo to znamená a čoskoro sa dostali do úzkych .	Netušili	0	Part
Obrazovka načas zmĺkla .	zmĺkla	2	Part
" My sme mŕtvi , " povedal .	povedal	6	Part
Dofajčí ju po smene , ak ju dokáže nevytrúsiť .	nevytrúsiť	8	Inf
Nesmieme strácať čas . “	strácať	1	Inf
Vláda bude pri riadení verejných financií postupne posilňovať význam strednodobého rozpočtového výhľadu .	posilňovať	7	Inf
Keď sa však hlasuje v parlamente o zmluve s Vatikánom , zriadení katolíckej univerzity , SNS to podporila . "	hlasuje	3	Fin
Anjelovi cirkevného zboru v Prešove napíš :	napíš	5	Fin
Sú náznaky , že po duševnej stránke prežíva veľmi pochybné obdobie .	Sú	0	Fin
Globalizácia nevznikla sama od seba a nevznikla ani náhodou .	nevznikla	1	Part
Zodvihol pohár a opäť vystrel ramená .	Zodvihol	0	Part
Potom zlezie zo stromu a uteká domov . . .	zlezie	1	Fin
Od tej chvíle vstupuje do hry slovenská časť Uhorska .	vstupuje	3	Fin
Tešila som sa , ale zároveň mi chýbali tie chvíle , keď sme po večierkoch spolu posedeli a rozoberali každý detail .	rozoberali	18	Part
Chcem vedieť , či niekedy nájdem pravú lásku . “	Chcem	0	Fin
Prišiel očakávaný odkaz .	Prišiel	0	Part
Môžete lietať ? “ vypytoval sa ustarane Chrabroš .	lietať	1	Inf
Krtko sa rozosmial .	rozosmial	2	Part
“ Prv ako som dopovedala , zmocnili sa ma výčitky , že som mala byť inde a venovať sa učeniu .	venovať	17	Inf
Ten chlapec si doň predtým vopchal žabu .	vopchal	5	Part
Vilko visel na Maji ako ťažké bremeno .	visel	1	Part
Kým sa malý Herkules hral s Pegasom , zjavil sa Hádes , boh podsvetia .	hral	4	Part
Radža vždy odhadne charakter človeka .	odhadne	2	Fin
“ Ja som sa nikdy nechcel ženiť , “ hundral nespokojne Vilko , “ a ty mi zrazu podstrčíš dieťa ! “	ženiť	6	Inf
Ponášalo sa to na rovnicu o dvoch neznámych .	Ponášalo	0	Part
Mladík sa zapýril .	zapýril	2	Part
Začervenala som sa a zľahka som ho plesla po kolene .	Začervenala	0	Part
Našťastie sa nemusím veľmi rozpisovať , lebo Hysteria Pub má svoju webovú stránku .	rozpisovať	4	Inf
“ Prosím , poď sem , Ráma ! “	poď	3	Fin
“ Tak , čo mi na to povieš ? “ spustil na Vilka .	spustil	10	Part
Nová Koncepcia ochrany prírody a krajiny bude obsahovať racionálny systém manažmentu chránených území , prehodnotí ich cieľový stav a navrhne opatrenia a programy starostlivosti tak , aby chránené územia slúžili aj verejnosti .	obsahovať	7	Inf
Možno som sa mal správať k Irme inak .	správať	4	Inf
Zapojte sa aktívne do zborového života , príjmite pozvanie mládeže , navštevujte tento chrám , prichádzajte k Večeri Pánovej .	Zapojte	0	Fin
Ona by mala policajtom všetko vysvetliť .	vysvetliť	5	Inf
Stane sa tak počas slávnostného ceremoniálu 9 . 2 . 1999 , teda dva dni pred začiatkom MFF v Berlíne .	Stane	0	Fin
A určite si vyskúšajte tento recept : - ) .	vyskúšajte	3	Fin
Povedal si , že môžem ostať s tebou . “	môžem	4	Fin
“ Pusti mi chvost , ty tupec , “ skríkol Šer Chán .	Pusti	1	Fin
Pochopila , čo som povedal .	Pochopila	0	Part
Môžem ti pomôcť ? “ ľutovala ju Maja .	Môžem	0	Fin
Keď dohovoril , usmial sa svojím záhadným úsmevom a ustúpil nabok , aby uvoľnil cestu Lori .	usmial	3	Part
Kým sa malý Herkules hral s Pegasom , zjavil sa Hádes , boh podsvetia .	zjavil	8	Part
Namiesto veľkého podnosu niesla malú tácku , na ktorej bola len jedna šálka s kávou a jeden pohár s rakijou .	niesla	3	Part
Usadili sme sa pripravení sledovať oblohu .	sledovať	4	Inf
Pochopil som , prečo mi jej tvár pripomína niečo známe .	pripomína	7	Fin
Nerúhajme sa Bohu a nereptajme na všetko a všetkých .	nereptajme	4	Fin
Zavrela znútra dvere na školskej budove , zastrčila závoru , vzala ma za ruku a viedla za sebou .	vzala	10	Part
Pokúšala by sa presvedčiť ma , že nemá zmysel rozčuľovať sa .	presvedčiť	3	Inf
Chcel by som s tebou prebrať istú myšlienku , ktorá ma znepokojila len pred chvíľou , keď Irma odišla na letisko .	prebrať	5	Inf
Musím niečo urobiť , inak hrozí , že sa nezúčastním na Lorinom svadobnom obrade .	nezúčastním	9	Fin
Nevedel som , čo ich čaká .	čaká	5	Fin
Vidím , že začínam strácať niť .	začínam	3	Fin
Ešte mal zalepené hlasivky a nemohol rozprávať .	rozprávať	6	Inf
Veď hrdinu by nemalo nič rozptyľovať .	rozptyľovať	5	Inf
Cestou zoťali strom — budú ho potrebovať , ako baranidlo , keď budú chcieť vyvaliť bránu .	potrebovať	6	Inf
V zásade príslušnosť k týmto trom skupinám sa nededí .	nededí	8	Fin
M . N . Tichomirov fakt jednostranné vykladá len ako príčinu „ hladových vzbúr “ , Frojanov si všíma dôležitú okolnosť — volchovia sa zjavujú , aby zabezpečili blahobyt , hojnosť , úrodu .	všíma	18	Fin
Mauglí so supmi sa smiali , keď im tiger zmizol z dohľadu .	smiali	4	Part
Teraz ma prenasledovatelia chytia , pomyslel si Ferdo .	pomyslel	5	Part
Ja som však mohol odprisahať , že tie slová mi povedal N . T .	odprisahať	4	Inf
Zobrala ďalšie dve dievčatá , ostatných nechala tak a celé popoludnie špehovali dajakého čudáka .	Zobrala	0	Part
“ Som advokátka , vyhlásila pohotovo Maja , “ a pána Rudka budem zastupovať ! “	zastupovať	13	Inf
Čo iné im ostávalo , museli prestať s hašterením a začať odčerpávať vodu .	odčerpávať	11	Inf
“ Rozmliaždi ho , Džafar , “ škriekal škodoradostne Jago .	Rozmliaždi	1	Fin
ŠULAJ PÍŠE ROZPRÁVKU	PÍŠE	1	Fin
Bolo zamračené , malo pršať .	pršať	4	Inf
Ten nežiadal , aby som mu podal pomocnú ruku .	nežiadal	1	Part
Neodvážil som sa pohnúť , zdvihnúť ruky , odpovedať na Lorino objatie .	zdvihnúť	5	Inf
Počul , ako sľubuje klamať , kradnúť , falšovať , vraždiť , rozširovať drogy , prostitúciu , a pohlavné choroby , liať deťom vitriol do tváre .	liať	21	Inf
Samonafukovačky sa pýšia výbornými izolačnými schopnosťami , vysokým komfortom pri ležaní a neprepúšťaním vlhkosti .	pýšia	2	Fin
Skormútený Herkulovou tvrdohlavosťou odchádzal a nechal ho vznášať sa v oblakoch .	vznášať	7	Inf
“ Hádam mi nechceš tvrdiť , že nezáleží na výsledkoch .	nechceš	3	Fin
Zrazu sa nad ňou ktosi tichučko zasmial a akýsi hlások sa jej spýtal : “ Prečo sa bavíte so bzdochou ? “	bavíte	17	Fin
Zavalíme ľan kameňom , aby ostal vo vode .	Zavalíme	0	Fin
Postavila sa na špičky prstov a pobozkala ma .	Postavila	0	Part
Ja by som si dovolil tvrdiť , že nefungujú .	tvrdiť	5	Inf
Z tohto hľadiska meriam obdobie svojho pobytu v Čarodejníckej vile podľa intervalov , v akých otec odpovedal na mamine listy .	meriam	3	Fin
“ Zdá sa , že Mauglí ako všetci ľudia má schopnosť priťahovať nebezpečenstvo , “ povedal .	priťahovať	11	Inf
“ Vidím , že nič neviete o našom žartíku .	Vidím	1	Fin
Ľúbim ťa .	Ľúbim	0	Fin
Rozhodol sa letieť za nimi a za trest , že naňho zabudli , vzal so sebou všetkých susedov .	letieť	2	Inf
Netrvalo dlho a opäť sa ozvalo zvonenie .	Netrvalo	0	Part
Internet je médium , ktoré lezie pod kožu .	lezie	5	Fin
Svätoštefanský zákon pripúšťa , aby sa žena , ktorú manžel za istých okolností opustí , znovu vydala .	pripúšťa	2	Fin
Neviem vysvetliť , prečo sme nechodili na rande ako iní .	Neviem	0	Fin
Snehulienka práve piekla koláč .	piekla	2	Part
“ Nestrachuj sa o mňa , “ odvetil Mauglí .	Nestrachuj	1	Fin
Pustil bicykel a vbehol na rozmoknutú trávu .	vbehol	3	Part
V tomto podniku si nemôžem dovoliť luxus v podobe ďalšej whisky , ani keby som išiel dušu vypustiť .	vypustiť	17	Inf
Iste chápete , že najprv vám musím položiť zopár otázok .	položiť	7	Inf
Postavila sa teda pred televízor a zaclonila im obraz .	zaclonila	6	Part
Už sme spomenuli , že za Ladislavovej vlády prichádza k postupnej konsolidácii pomerov v krajine .	spomenuli	2	Part
Mladí tancovali takmer v objatí a ja som musel chvíľu čakať .	čakať	10	Inf
Mala som pocit , že potrebujem vypadnúť na čerstvý vzduch .	vypadnúť	6	Inf
Znak potom môžme vykladať ako zobrazenie vtáka s roztiahnutými krídlami a hlavou vysunutou dopredu .	vykladať	3	Inf
Rozbehla som sa po rovine .	Rozbehla	0	Part
Jazmína otvorila dvere .	otvorila	1	Part
Keby ste ho nenašli , leťte za slnečným svitom .	leťte	5	Fin
Potkany by ho určite napadli a zakrátko by ho obžrali na kosť .	obžrali	9	Part
Zrazu začuli vystrašený krik .	začuli	1	Part
Zároveň bude vláda zdôrazňovať a vytvárať podmienky na zvyšovanie vedomia zodpovednosti občanov za vlastnú a všeobecnú bezpečnosť .	zdôrazňovať	3	Inf
A teraz ti poviem niečo , čo ti vyrazí dych , “ začal Chris .	vyrazí	8	Fin
Spýtal som sa ho , ako sa volá , ale ono mi nechcelo povedať svoje meno .	povedať	13	Inf
V tú noc som po mnohých rokoch pocítil potrebu písať poéziu .	písať	9	Inf
Chlapče , tvoje básne páchnu potuchlinou , povedal mi .	povedal	7	Part
Takto nevyzerá ani autorka článku , ani kamarátova babka .	nevyzerá	1	Fin
Stáva sa to veľmi zriedkavo .	Stáva	0	Fin
Všetka moc , všetky zbrane , ktoré Ho chceli zlikvidovať , sú nanič .	chceli	8	Part
Nevedel som dešifrovať jej pohľad , neprečítal som v ňom nič .	dešifrovať	2	Inf
Je ťažké nenávidieť niekoho , kto si natoľko neverí , že sa opičí po druhých .	nenávidieť	2	Inf
A čo hnusné to tu rastie ?	rastie	5	Fin
“ Vítame vás , Pichuľko ! “ povedala Makulienka .	Vítame	1	Fin
Kto zažil sparné pražské popoludnie , vie veľmi dobre , čo znamená spojenie " správně vychlazená dvanáctka " .	vie	6	Fin
Ak si želáte dievča , povedala , zariadime to .	želáte	2	Fin
KDH v januári 2000 zablokovalo vstup SMK do Európskej demokratickej únie .	zablokovalo	4	Part
Musím rešpektovať Marginu požiadavku , aby som deťom nič nepovedal , a zároveň musím nájsť pre Irmu nejaké presvedčivé vysvetlenie .	Musím	0	Fin
Žiadne z nich nevykazujú nejaké reformné vplyvy .	nevykazujú	3	Fin
Prijatie novely zákona o štátnej službe umožní okrem iného zamestnanie špičkových odborníkov v ústredných štátnych orgánoch za adekvátneho mzdového ohodnotenia a odstráni nepružnosť zamestnávania v štátnej službe .	umožní	6	Fin
Kerchak bránil rodinu proti zákernej mačke , zatiaľ čo ostatní členovia ho pozorovali zo stromov .	bránil	1	Part
Stále sa mu chce škrabať , nech by bol kdekoľvek .	škrabať	4	Inf
Medzi seba a potkany musí postaviť inú ľudskú bytosť , telo inej ľudskej bytosti .	postaviť	5	Inf
Navyše sú nepoužiteľné vzhľadom na tlačiarenskú farbu , ktorá môže nepríjemne poškodiť istú chúlostivú časť tela .	poškodiť	11	Inf
Boli tu velikánske depozitáre na uskladňovanie opravených dokumentov a skryté pece na ničenie pôvodných výtlačkov .	Boli	0	Part
Po príchode „ trestnej výpravy “ však nepokoje už opadli a všetko bolo v poriadku — no príchodzích museli kolonisti živiť .	živiť	20	Inf
Prepáčte , musím vám niečo povedať .	povedať	5	Inf
Prečo lovíme zelené kravičky ?	lovíme	1	Fin
Prihláste sa do 13 . 6 . 2004	Prihláste	0	Fin
Ak má môj rod zomrieť , tak chcem zomrieť i ja , pomyslela si .	zomrieť	4	Inf
Mauglí sa však stále tvrdohlavo držal stromčeka .	držal	5	Part
Aladin sa uškrnul a podal Abdullahovi krištáľovú guľu .	uškrnul	2	Part
“ Môžeš si dať za mňa , “ povedala som .	dať	3	Inf
“ Nevydeli ste tu nejakého koňa ? “ vypytoval som sa chrobákov .	vypytoval	8	Part
Navrhli im , že ak chcú prežiť v nových podmienkach trhového hospodárstva , môžu predávať po tiranských chodníkoch cigarety alebo banány .	predávať	14	Inf
S čím som mala súhlasiť ? “ nechápala som .	súhlasiť	4	Inf
Na svoj husľový koncert pozvala celé okolie .	pozvala	4	Part
Pokým nevyprázdnili misky , ani jeden z nich už neprehovoril .	neprehovoril	9	Part
A síce , že vôbec nejde o odkaz od Ideopolície , ale od nejakej ilegálnej organizácie .	nejde	5	Fin
Prikrčená som vyliezla na vrchol strechy , chvíľu som balansovala a opatrne som zliezla na opačnú stranu .	zliezla	13	Part
Hru , ktorú hráme , nemôžeme vyhrať .	hráme	3	Fin
Mama zdvihla oči od novín a usmiala sa .	zdvihla	1	Part
Po známej zrážke s okrajom bazéna ma boleli päty a prestala som si veriť .	veriť	13	Inf
Gazdinky vyložili do okien vankúše , Kasandra zasa medové guľôčky a slečna Hopka usporiadala na čistinke rannú rozcvičku .	vyložili	1	Part
Čakal som celé dve hodiny , ale šéf nechodil .	Čakal	0	Part
Čo robíte , keď napadne čerstvý sneh ?	robíte	1	Fin
Neodvážil som sa spýtať sa jej na to .	spýtať	3	Inf
Vošiel som dnu a uľavil som si .	Vošiel	0	Part
Faika ma presvedčila o opaku .	presvedčila	2	Part
Netrvalo dlho a nad jaskynkou sa zachvel list , spod ktorého vyliezol prečudesný chrobák .	zachvel	6	Part
Maja si už netrúfla nič navrhnúť .	navrhnúť	5	Inf
Winston i dievča vytrvalo jedli .	jedli	4	Part
Začal som chodiť po izbe s telefónom v ruke .	chodiť	2	Inf
Netušila som , že počúvajú , ale zrazu všetci hýrili nápadmi .	hýrili	9	Part
Boli stále so mnou , boli vo mne .	Boli	0	Part
Kde sa vlastne začína „ Mimobratislava “ ?	začína	3	Fin
“ Prestaň sa krútiť !	krútiť	3	Inf
Namiesto toho urobila večeru , ako na zmierenie , a celú večnosť čakala , že sa vrátim .	vrátim	16	Fin
Zviera , čo obýva zámok , ja naskutku skolím .	obýva	3	Fin
“ Musíte to urobiť ešte dnes ! “ skríkla na nich Cruella .	Musíte	1	Fin
Bohužiaľ , vzali si z nich príklad všetky deti a tiež sa chceli hrať v odpadovej jame .	chceli	12	Part
To nás veľmi teší .	teší	3	Fin
“ Chodí spať ako slniečko , “ povzdychol si motýľ Emanuel .	spať	2	Inf
Čujte , čujte !	Čujte	0	Fin
Takže ak sa myšlienky zorganizovať rockový festival chytí skúsenejší organizátor , veríme , že festival , ktorému je dedina a ľudia v nej naklonení , sa bude znova konať .	konať	28	Inf
Musí to byť nejaký starý známy , uvažoval som .	Musí	0	Fin
Potom tí muži začali vychádzať z izby a ja som sa vrátil do salóna .	vychádzať	4	Inf
Podľa teba zrejme našou hlavnou úlohou je tvoriť nové slová .	tvoriť	7	Inf
Vtom mi Chris stisol ruku .	stisol	3	Part
Šľahúne boli pružné a Vilko jasal : “ To je vynikajúca trampolína ! “	jasal	5	Part
V ich rámci budeme na prvom mieste hovoriť o výnimočnom postavení uhorského kráľa voči domácej cirkvi .	hovoriť	7	Inf
Hra na hudobné nástroje , vozy ako prostriedok na prekonávanie vzdialeností by mohli svedčiť i o narážke na potulných hudcov ‐ igricov , ktorí sú chápaní v celoeurópskom kontexte ako elementy , rušiace zabehaný poriadok .	svedčiť	13	Inf
Nová Koncepcia ochrany prírody a krajiny bude obsahovať racionálny systém manažmentu chránených území , prehodnotí ich cieľový stav a navrhne opatrenia a programy starostlivosti tak , aby chránené územia slúžili aj verejnosti .	navrhne	19	Fin
Keby bola , nezdržiaval by ma , keď som sa zúfalo snažila vrátiť do izby .	vrátiť	12	Inf
“ Poznám tvojho otca veľmi dobre a viem , že sa nikdy nezmení .	Poznám	1	Fin
“ Viem , čo chceš urobiť . “	urobiť	5	Inf
Ak sa neponáhľate , počkajte chvíľu . “	neponáhľate	2	Fin
STROMBOLI NEVERIL VLASTNÝM OČIAM , keď pred sebou zbadal dreveného panáčika .	NEVERIL	1	Part
Zarazilo ma to .	Zarazilo	0	Part
Vtedy zasiahla Sofika .	zasiahla	1	Part
Keď Herkules vynášal Meg z jaskyne smrti , Hádes sa usiloval zľahčiť svoju chybu .	zľahčiť	11	Inf
Na jeho základe sa bude financovať tzv . solidárny balík , ktorého súčasťou bude aj financovanie siete rýchlej zdravotnej pomoci .	financovať	5	Inf
“ Prosím ťa , Amy .	Prosím	1	Fin
Zrýchlil sa mi pulz a spomenula som si na sen , v ktorom ma bozkával .	Zrýchlil	0	Part
“ Podľa teba nemám právo na vlastný život !	nemám	3	Fin
Vtedy sa rozhodli , že nadišiel čas , aby mu ukázali zlatý medailón , ktorý mal na krku , keď ho našli .	našli	21	Part
Celá sa triasla , sotva vládala stáť na nohách .	stáť	6	Inf
Chcem dokončiť prácu z angličtiny .	Chcem	0	Fin
Musím rešpektovať Marginu požiadavku , aby som deťom nič nepovedal , a zároveň musím nájsť pre Irmu nejaké presvedčivé vysvetlenie .	musím	13	Fin
Cítila som , že sa pohybujú , ako keby mi chceli prezradiť nejaké tajomstvo .	chceli	10	Part
“ To my poznáme , “ povedal Flaps .	povedal	6	Part
Celú noc som sa prevaľoval na posteli v hotelovej izbe a nemohol som sa zmieriť s realitou .	zmieriť	14	Inf
Aj ja som prišiel kvôli tomu , hoci som sa nemohol zbaviť stŕpnutosti .	zbaviť	11	Inf
V jej neprítomnosti som predložil rukopis tej poviedky priamo šéfovi .	predložil	4	Part
Stiahol som sa , aby mohla prejsť .	Stiahol	0	Part
Winston na chvíľu prestal čítal .	čítal	4	Inf
Cieľom Strany nebolo len to , aby medzi mužmi a ženami nevznikali vzťahy vernosti , nad ktorými nemala moc .	nevznikali	11	Part
Niektoré úmrtia tak akosi predpokladáme , ľudia sa k nim systematicky dopracovávajú .	predpokladáme	4	Fin
Neodvážili sa ho dráždiť ani decká , ani psy .	dráždiť	3	Inf
Že sa utopím ?	utopím	2	Fin
Podľa nich klerici sa nielenže nesmeli opíjať , ale mali aj povinnosť brániť veriacim v prehnanom požívaní opojných nápojov .	opíjať	6	Inf
Ja mám za úlohu robiť sprostredkovateľku .	robiť	4	Inf
Široký nôž sa pri používaní zle drží v ruke .	drží	6	Fin
Práve sa chystala roztiahnuť krídla a vzlietnuť , keď v tieni steny zbadala strážcu .	vzlietnuť	6	Inf
Ten im teda dával zabrať !	zabrať	4	Inf
Potom sa jedného dňa prízemie vyprázdnilo .	vyprázdnilo	5	Part
“ S vami sa už nemienim baviť ! “ kričal rozhorčene .	baviť	6	Inf
Zadychčaní od behu sme sa smiali .	smiali	5	Part
Dokonca mi na krk uviazala bodkovanú šatku , ktorú odvtedy stále nosím .	nosím	11	Fin
“ Môjmu kráľovskému uchu sa donieslo , že chceš ostať v džungli . “	ostať	9	Inf
Iba jej skočiť na pomoc !	skočiť	2	Inf
V piaty deň každého mesiaca išla Irma na poštu s príslušným kódom a priniesla domov sto dolárov .	išla	5	Part
Hlas trúbky rozpútal mohutný huriavk .	rozpútal	2	Part
Ona odíde prvá a po polhodine ju Winston bude nasledovať .	odíde	1	Fin
Za slovenskú stranu sa tradične na organizácii prehliadky podieľa Slovenský filmový ústav a Asociácia slovenských filmových klubov , ktorá prostredníctvom MK SR udeľuje na prehliadke Hlavnú cenu Zlatý debut .	podieľa	8	Fin
Nech ma Tom netrápi , chcel som jej povedať .	povedať	8	Inf
Ale nakoniec porozumela .	porozumela	2	Part
S očividným uspokojením dokázal rozprávať o náletoch vrtuľníkov na nepriateľské dediny , o procesoch s ideozločincami , o ich priznaniach a o popravách v katakombách Ministerstva lásky .	rozprávať	4	Inf
Pravovernosť znamená nemyslieť -- nepotrebovať myslieť .	nepotrebovať	4	Inf
Naďalej som tam stál so spustenými rukami a na Lorino objatie som neodpovedal .	stál	3	Part
Aj bez ďalšieho vysvetľovania O ' Brien vedel , ako to myslí .	myslí	11	Fin
Na obzore sa objavil čierny bod a ja som si pomyslela , že je to nejaký chrobák .	pomyslela	10	Part
“ Skúsme ich preľstiť , “ navrhol Rudko .	preľstiť	3	Inf
Zavalíme ľan kameňom , aby ostal vo vode .	ostal	5	Part
Len čo stačil dobehnúť do úkrytu , z jaskyne vytrielila svorka vĺčat .	dobehnúť	3	Inf
Horace a Jasper sedeli na starej pohovke obklopení tuctami šteniatok a pozerali televíziu .	pozerali	11	Part
Jej bledosť a mlčanie stačili , aby som okamžite pochopil , že som urobil hlúposť .	stačili	4	Part
Pre svoju krátkosť a úryvkovitosť sa nedajú podrobiť podrobnejšej analýze .	podrobiť	7	Inf
Dobre som vedela , čoho sa tá dôvera týka .	vedela	2	Part
Kolektívne postupovať nemôžeme .	postupovať	1	Inf
Pokúsime sa teraz vyčleniť takéto opozície v rozoberaných úryvkoch .	vyčleniť	3	Inf
Herkules odniesol Meginho ducha k telu .	odniesol	1	Part
Nenašiel som slová , aby som mohol odpovedať .	odpovedať	7	Inf
Žaba nemohla kričať a had ju prehltol v tichosti .	kričať	2	Inf
Väčšinou sedávame na okne za záclonou alebo v kúte izby a sledujeme ho .	sledujeme	11	Fin
“ Z nás sa nikdy nestanú piráti , “ hrdo vyhlásila Wendy .	nestanú	5	Fin
“ Nazri do svojho srdca , ono ti povie , čo máš robiť . “	povie	8	Fin
“ Myslela som , že robíš v El Rancho , “ vyhŕkla som bez rozmyslu .	vyhŕkla	11	Part
“ Vezmem ho , “ zvolala som a letela k nemu , “ určite je to pre teba . “	Vezmem	1	Fin
Na všeobecné počudovanie sa prihlásil leňoch Vilko .	prihlásil	4	Part
Nerob zo seba hlupáka , povedali mi .	povedali	5	Part
Večer bude Lauren Bacall uvádzať film Hlboký spánok .	uvádzať	4	Inf
Prepadol som sa do priepasti , kde som visel v bezváhovom stave .	Prepadol	0	Part
Obzvlášť odvtedy , čo som sa presťahovala do prízemného bytu po mojej starej tete , ktorá chovala a vykrmovala túlavé mačky z celého sídliska .	vykrmovala	18	Part
“ Nevidela si Makulienku ? “ spýtal sa jej .	Nevidela	1	Part
V sledovaných zbierkach kánonického práva nachádzame celý rad podobných ustanovení .	nachádzame	5	Fin
Hook nevedel zakryť obrovskú radosť .	zakryť	2	Inf
Pomyslel som si , že sa mi to len zdá .	Pomyslel	0	Part
V takýchto podmienkach sa moja modlitba mohla len ťažko dostať na správne miesto , napriek tomu som to skúsil .	skúsil	18	Part
A v mozgu sa mi vynorila zabudnutá scéna .	vynorila	5	Part
Toto ministerstvo však nemuselo uspokojovať mnohoraké potreby straníkov , ale opakovať celú operáciu na nižšej úrovni pre blaho proletariátu .	opakovať	10	Inf
“ Nedopustíme predsa , aby utiekli a varovali netvora , “ povedal ľuďom .	Nedopustíme	1	Fin
“ Čakali , že aspoň jeden z nás pôjde v ich šľapajach .	Čakali	1	Part
“ Hneď ťa tam odnesiem . “	odnesiem	4	Fin
Vyzeráš normálne a nevinne .	Vyzeráš	0	Fin
Komárno nechce Cyrila a Metoda na verejnom priestranstve	nechce	1	Fin
Ale dlho ho potrebovať nebudeš , “ vraví pavúk Karkoško .	potrebovať	3	Inf
Asi verili svojim po zuby ozbrojeným bojovníkom , pred ktorými sa všetci trasú .	verili	1	Part
Hlúpa tvár pod svetlými vlasmi ho vítala s rozžiareným úsmevom .	vítala	6	Part
V prvých troch kapitolách sa teda pokúsime o prieskum problematiky v celoruskom rámci , odhliadnuc od jemnejších miestnych odlišností .	pokúsime	6	Fin
Chris roztrhol jedno balenie , ale veľmi sa s ním nemaznal .	roztrhol	1	Part
Jedna ruka jej ovisla nabok , telo sa jej uvoľnilo .	uvoľnilo	9	Part
Bolo to viac , ako dúfal , že sa dopočuje .	dopočuje	9	Fin
Celý personál ministerstva postupoval rovnako .	postupoval	3	Part
“ Neuveriteľné ! “ zvolala Blythe .	zvolala	4	Part
Rozvíjajú sa jednotlivé kniežatstvá .	Rozvíjajú	0	Fin
“ Odkedy máš v hlave piliny ?	máš	2	Fin
Rovnako prekvapujúco dobre vedela rozprávať bez pohybovania perami .	rozprávať	4	Inf
Keby som ich mohla premeniť na chrobáky , obidvoch by som bez štipky milosrdenstva zabila .	premeniť	4	Inf
Na druhý deň navštívila Klotilda Teklu a začali muzicírovať .	navštívila	3	Part
Usmiala som sa .	Usmiala	0	Part
“ I mne sa raz snívalo , že budem učiť najväčšieho hrdinu všetkých čias , “ vyhlásil Fil .	učiť	9	Inf
Naši chirurgovia dokážu zmeniť ľudí na nepoznanie .	zmeniť	3	Inf
“ Čo bude stáť za to ! “ skríkla som .	stáť	3	Inf
“ Môžeš , “ odvetilo sloníča .	odvetilo	4	Part
Sedel na stoličke neprirodzene vzpriamene a jeho mocné prsia sa nadúvali a zachvievali , akoby mal čeliť nárazu vlny .	čeliť	16	Inf
" Ste pripravení obetovať svoje životy ? "	obetovať	3	Inf
Nechcem nič konkrétne .	Nechcem	0	Fin
Nenatrafili na nikoho , koho by sa mohli opýtať na cestu .	opýtať	8	Inf
Nedokázal premôcť nápor paniky .	premôcť	1	Inf
Musíte byť tolerantní , musíte pochopiť , že som nemal iné východisko .	pochopiť	5	Inf
Našťastie sme zastali pri obrubníku pred pizzeriou Rajské slasti a všetci náhle stratili o nás záujem , keďže snívali o pizze .	zastali	2	Part
Keď oheň začal slabnúť , drkotali mi zuby .	slabnúť	3	Inf
“ Cítil som , že ma čoskoro prepustí . “	Cítil	1	Part
Východ na Bielej hore mal však splniť iný cieľ , ale nepredbiehajme .	splniť	6	Inf
Ten chlapec tu býva ?	býva	3	Fin
Jedného dňa sochu odtiaľ strhol dav , ktorý rozzúrilo jej namyslené povýšenectvo .	rozzúrilo	8	Part
Nevidieť tú reláciu , povedal by som spolu s Freudom , že za všetkým je sexuálne pudenie , ale tých dvadsať minút mi otvorilo oči .	Nevidieť	0	Inf
Nebude jestvovať rozdiel medzi krásou a ošklivosťou .	jestvovať	1	Inf
“ Ja som vedel , že som niečo zabudol ! “ zvolal a neodolateľne sa usmial .	zabudol	8	Part
Neviem , čo som si vymyslel .	Neviem	0	Fin
Vláda bude klásť dôraz na prehľadnosť , výkonnosť , spoľahlivosť a efektívnosť monitorovacieho a hodnotiaceho systému .	klásť	2	Inf
Vždy som mával zvláštny pocit , že ten človek ma neznáša .	mával	2	Part
Nepekný odev môže všetko pokaziť .	pokaziť	4	Inf
Vo svojom blaženom sne Winston nevenoval nijakú pozornosť tomu , že mu nalieva pohár .	nalieva	12	Fin
Chcel som sa stretnúť s človekom číslo jeden a to ho zrejme prekvapilo .	stretnúť	3	Inf
Už sa zberala preč , ale vo dverách sa otočila .	otočila	9	Part
Ak nevyjde , nemáme dôvod stretnúť sa .	stretnúť	5	Inf
Keď som tak urobil , spamätal som sa .	spamätal	5	Part
A kým je môj pas v rukách toho muža , veci vonkoncom nevyzerajú dobre .	nevyzerajú	12	Fin
Myslíte si , že sa strana dostatočne nevenovala ekonomike ?	Myslíte	0	Fin
Keď máme čo jesť , máme všetko ostatné , čo potrebujeme .	jesť	3	Inf
Nálezy pečatí umožňujú určiť autorstvo , pravosť a čas vzniku dokumentu , dopĺňajú tak informácie o ňom .	určiť	3	Inf
Vypáči z pamäte pána Charringtona zvyšok tej riekanky .	Vypáči	0	Fin
Vyzeral akoby ho oposkladali z niekoľkých plemien psov .	Vyzeral	0	Part
Blahoželám , slečna , povedal som s predstieraným nadšením , využijúc všetky svoje herecké schopnosti .	Blahoželám	0	Fin
“ Tentoraz by sme mali hudbu vynechať a usporiadať maratónsky beh , “ navrhol Rudko a všetci nadšene súhlasili .	vynechať	6	Inf
" vykríkol .	vykríkol	1	Part
Jestvuje len jeden a jediný spôsob , ako sa zachrániť .	Jestvuje	0	Fin
Otvorila okienko , akože naňho zakričí , ale vzápätí si to rozmyslela .	zakričí	5	Fin
Vliekol som sa po Nevskom prospekte a stále som nedokázal sformulovať nijakú myšlienku .	sformulovať	10	Inf
Vláda bude presadzovať takú reformu Ozbrojených síl Slovenskej republiky , ktorá bude najefektívnejšie zabezpečovať ochranu pred možným ohrozením nášho štátu a jeho občanov .	presadzovať	2	Inf
“ Prosím , ja uznávam , že Ferdo je jednotka .	uznávam	4	Fin
Ochráni Jazmínu , nech by jej hrozilo čokoľvek .	Ochráni	0	Fin
Niektoré z nich môže spozorovať moju prítomnosť .	spozorovať	4	Inf
Spomínaní suzdaľskí volchvi sa zjavujú práve v čase neúrody , aby ju pomohli zahnať .	zahnať	13	Inf
Sú vhodné do teplého letného počasia , od jesene do jari ich použitie neodporúčam .	neodporúčam	13	Fin
Hlúpy Gim sa obyčajne zdržiaval pred vchodom do predajne chleba .	zdržiaval	4	Part
Dlho sedela na kraji lesa a pozerala , ako zlaté klasy zľahka povievajú v letnom vánku .	povievajú	12	Fin
Vyzerá trochu smiešne .	Vyzerá	0	Fin
Nebola som schopná plakať .	plakať	3	Inf
Na stenách viseli zaprášené police s prastarými knihami zaklínadiel a čarov .	viseli	2	Part
Naozaj sa snažila vyjsť mi v ústrety .	vyjsť	3	Inf
Maja sa rozhodla , že zaletí do chladného lesa , kde je ticho a tieň , aby mohla pokojne popremýšľať o všetkom , čo v noci zažila .	popremýšľať	19	Inf
“ Som smädná , “ povedala som Rickovi a bosá som vyskočila z radu .	vyskočila	11	Part
Nemal najmenšie pokušenie jej klamať .	klamať	4	Inf
A všetci tí ľudia prišli na tvoj pohreb .	prišli	4	Part
Nemohla som tú otázku zodpovedať ani pánu Tayerlemu , ani sebe .	zodpovedať	4	Inf
“ Chcete ju vidieť ? “	vidieť	3	Inf
Dôležitejším znakom oboch kategórií šamanov je , že úspech ich činov nezávisí od toho , akú obetu bohu prinesú , ale od toho v akom vzťahu sú oni sami s bohmi — tj . od ich schopností .	nezávisí	11	Fin
Uvidíte , nabudúce prídem za vami zas !	Uvidíte	0	Fin
Od rána do večera som pil čaj s citrónom , aby som sa čo najskôr uzdravil a mohol Lienke splniť jej sen .	splniť	19	Inf
“ Aká ste nevzdelaná , milá moja ! “ zvolala Lolka .	zvolala	9	Part
Winstona sa zmocnila úzkosť .	zmocnila	2	Part
Zostalo ti deväť , desať , jedenásť zubov .	Zostalo	0	Part
Vypil ďalší dúšok džinu , vzal bieleho jazdca a pokusne ním tiahol . Šach !	tiahol	11	Part
Stala si na kameň a začala vrzúkať .	Stala	0	Part
Bude tu doma .	Bude	0	Fin
Sú tam psi ? “ spýtal sa ma , kým sa vyšvihol na múr .	Sú	0	Fin
Jednoznačne ide o účelovú mystifikáciu s cieľom zmanipulovať konanie bežného občana a obrať ho o posledné základné životné istoty .	obrať	12	Inf
Nerob to ! “ zvolal Aladin .	Nerob	0	Fin
Môžem ti hovoriť Jaz ? “	Môžem	0	Fin
V procese obstarávania bude vláda dbať na transparentný systém nakladania s majetkom štátu .	dbať	5	Inf
Aj on sa medzitým prezliekol .	prezliekol	4	Part
Musí osloviť Amplefortha aj za cenu okríknutia z televíznej obrazovky .	osloviť	1	Inf
Prejav ma neprekvapil .	neprekvapil	2	Part
Keď videl , ako sa bavia , hneď sa chcel pridať .	pridať	10	Inf
Niekto zo susedov si mohol všimnúť , že som bol preč , mohol by sa ma zvedavo vypytovať , kde som bol , a to by stačilo , aby sa som sa rozčúlil .	všimnúť	5	Inf
Vláda pripraví a realizuje systém ochrany slovenského spotrebiteľa a prostredníctvom legislatívy ho prispôsobí stavu , ktorý bude zodpovedať legislatíve EÚ .	zodpovedať	17	Inf
Vtedy mohol klopať ktokoľvek , my sme neotvárali .	klopať	2	Inf
“ Mala by si sa dať dokopy s Rickom , “ radila som jej šeptom .	dať	5	Inf
“ Na oslavu tvojho úspechu , “ dodala som nepresvedčivo .	dodala	7	Part
Nemohol som sa na nič sústrediť , nevládal som zniesť nikoho pri sebe : ani Margu , ani mamu , ani Toma .	zniesť	9	Inf
Aj tak sa vybrala pod harmanček , či náhodou pod lístkom neostala nejaká kvapôčka .	vybrala	3	Part
Roztrhajte jej tvár , roztrhajte jej ju až na kosť .	Roztrhajte	0	Fin
Zlostne som kráčala preč .	kráčala	2	Part
Prikázal , aby obe uvrhli do väzenia .	Prikázal	0	Part
Ten pohľad ho tak ohúril , že zabudol na akúkoľvek opatrnosť .	zabudol	7	Part
Jej priebeh je možné zrekonštruovať zhruba takto — Pred obradom samotným bolo postavené obetisko s pôdorysom štvoruholníka so štyrmi stĺpmi v rohoch .	zrekonštruovať	4	Inf
Milí konfirmandi , dnes sa stanete dospelými členmi nášho cirkevného zboru .	stanete	5	Fin
“ Nech ti nelepí , vyhnem sa ti , ak sa vyhneš ty mne !	vyhnem	5	Fin
Keď vošiel , hluk hlasov zoslabol na polovicu .	zoslabol	5	Part
No kým si Aladin stačil odhryznúť , čosi ho zaujalo .	zaujalo	9	Part
Ale najskôr musím uzavrieť niektoré záležitosti tu v Albánsku .	uzavrieť	3	Inf
Všetka moc , všetky zbrane , ktoré Ho chceli zlikvidovať , sú nanič .	zlikvidovať	9	Inf
Známe uskromňovacie heslo " Jeme preto , aby sme žili . " nie je pravdivé .	Jeme	4	Fin
Zmĺkol som .	Zmĺkol	0	Part
V oblasti vodného hospodárstva bude vláda legislatívnymi a organizačnými opatreniami zabezpečovať racionalizáciu a efektívnosť pôdohospodárskych činností .	zabezpečovať	10	Inf
Slnečný svit , ktorý prenikal nespočetným lístím , ich ešte stále pálil na tvárach .	pálil	11	Part
Musíte byť tolerantní , musíte pochopiť , že som nemal iné východisko .	Musíte	0	Fin
Ja sa chcem oženiť z lásky .	oženiť	3	Inf
Telo by malo mať šiju Jenny Elfman , ramená Courtney Love , zadok Jennifer Lopez , pupok Sandry Bullock a nohy Miry Sorvino .	mať	3	Inf
Nehybnú princeznú nechala ležať na studenej kamennej dlážke .	ležať	3	Inf
Rozumiem AKO , nechápem PREČO .	nechápem	3	Fin
Vláda pripraví komplexnú analýzu zadlženosti verejného sektora .	pripraví	1	Fin
Uvedomila som si , že som nevhodne zareagovala , lenže ten bozk ma naozaj vyviedol z miery .	vyviedol	14	Part
“ Mám ťa vyskúšať ? “	Mám	1	Fin
Možno by jej to celkom prospelo . “	prospelo	5	Part
Musel niečo napísať .	napísať	2	Inf
Musím zbaviť Margu myšlienky na smrť .	Musím	0	Fin
Za finančnú podporu sa chcem poďakovať Ekumenickej rade cirkví , nášmu drahému zboru a „ staršej “ mládeži ECAV v Prešove , modlitebnému spoločenstvu , kamarátom z tréningu Rovesník a jednotlivcom .	poďakovať	5	Inf
Dúfala som , že sa nápadne zablyští na slnku , ale , žiaľ , v ten deň bolo zatiahnuté .	zablyští	6	Fin
Keď sa našli uprostred mladiny , obrátila sa k nemu tvárou .	našli	2	Part
“ Choď preč , daj mi pokoj ! “ skríkol , keď sa vyslobodil z hadieho chvosta a odvrátil hlavu .	daj	4	Fin
Musím s tým niečo robiť .	robiť	4	Inf
Nakoniec to nevydržal a snažil sa upratovačku na problém upozorniť .	upozorniť	9	Inf
Situáciu umožňujú skompletizovať archeologické vykopávky v Timerevskom hradisku .	skompletizovať	2	Inf
Zákon sprehľadní pravidlá pre plnenie úloh prenesených zo štátnej správy na územnú samosprávu a doplní sústavu zákonov týkajúcich sa územnej samosprávy .	doplní	14	Fin
“ Ty pokúšaš moju trpezlivosť ? “ zreval .	pokúšaš	2	Fin
Drobná žena s pieskovými vlasmi zružovela a ústa otvárala a zatvárala ako ryba na suchu .	otvárala	8	Part
“ Prestaň stínať hlavy , “ radil mu Fil .	stínať	2	Inf
Môže ísť o toporčeky s predĺženým poriskom , ktoré boli v Škandinávií predmetom symbolizujúcim hromy vrhajúceho Thora .	Môže	0	Fin
Nesmieme strácať ani chvíľočku . “	strácať	1	Inf
Pri príležitosti svojho odchodu a ukončenia zimného obdobia som vyhlásil , že zaplatím koňak všetkým , ktorí budú od dvanástej až do tretej poobede v kaviarenskej časti obchodu .	zaplatím	12	Fin
Máme spoločnú príležitosť napísať vynikajúcu kapitolu slovenských dejín .	napísať	3	Inf
Nahol sa ku mne a odhrnul mi z tváre mokré vlasy .	odhrnul	5	Part
Za jasotu spoluobčanov prevzali cenu a Dr . Slimák slzil od dojatia , pretože v tejto súťaži doteraz nijaký slimák nevyhral .	nevyhral	20	Part
Páni , oslovil som ich a pokúšal som sa pôsobiť rozvážne .	pôsobiť	9	Inf
Kala pozrela do domu a zbadala stopy po zápase .	pozrela	1	Part
“ Prisahal , že ťa zabije . “	zabije	5	Fin
Recepčné sa podujali objednať taxík a zobudiť ma , kedy uznám za vhodné .	zobudiť	6	Inf
Práve zachytil O ' Brienov pohľad .	zachytil	1	Part
Čo všetko by sa s ňou dalo robiť !	robiť	7	Inf
Grazie all ' America , ' ' kričal z pódia nadšený Benigni .	kričal	7	Part
Ak chcem niečo dokázať , musím sa Chrisa zriecť .	zriecť	8	Inf
Nezdalo sa mi však , že som ho presvedčila .	presvedčila	8	Part
Nemala som chuť rozlúčiť sa .	rozlúčiť	3	Inf
“ Zvykneš si naňho . “	Zvykneš	1	Fin
Nebežal tadiaľto kôň ? “ kričal som na motýle .	kričal	5	Part
„ Čas , v ktorom žijem , viem , že je Tvojím darom .	žijem	5	Fin
“ Poď sem , sadni si vedľa mňa . “	Poď	1	Fin
Pokiaľ mohol predvídať , jestvovali dve možnosti .	predvídať	2	Inf
Nič sa nedalo robiť .	robiť	3	Inf
Kala bábätko vybrala a v tej chvíli prestalo plakať .	vybrala	2	Part
Po hodine na mňa Chris čakal pred triedou .	čakal	5	Part
Hanbila sa tak , že chcela na mieste umrieť .	umrieť	8	Inf
V prvej časti kapitoly teda najprv načrtneme ich základný argumentačný potenciál , aby sme mohli v časti druhej pristúpiť k pokusu o vlastnú interpretáciu .	pristúpiť	18	Inf
Ďakujem , “ odvetila som a vymanila si studené prsty spod jeho rúk .	odvetila	3	Part
Zostupujúc do hĺbok duševných priepastí , ( seba ) obnažuje , bičuje ( sa ) .	bičuje	11	Fin
Podráždene meditoval o materiálnych stránkach života .	meditoval	1	Part
Však vieš , že sa tá zbierka robí od domu k domu .	vieš	1	Fin
Z okienok v plástoch vykuli rozospaté včelie hlávky .	vykuli	4	Part
Makové zrniečka v nej zašušťali , ako keď sa presýpajú myšlienky .	presýpajú	9	Fin
Emanuel s Makulienkou tak ‐ tak stačili preskočiť na najbližšie lekno .	preskočiť	7	Inf
Potom som si to rozmyslel .	rozmyslel	4	Part
“ Obviňujeme vás , že ste nám odcudzili drahocennú potravu , “ povedal prísne veliteľ a dal pokyn , aby ich zajali a postavili pred sudcu .	Obviňujeme	1	Fin
Spomínaš si na to ? "	Spomínaš	0	Fin
Napriek tomu ma niečo začalo znepokojovať .	znepokojovať	5	Inf
Zrazu sa ma zmocnilo presvedčenie , že som to zbabrala , ani kytička sedmokrások ma nemohla utešiť .	utešiť	16	Inf
“ Ani sa nečudujem , že pre ňu nemôžete nič vymyslieť .	nečudujem	3	Fin
Ale nevieš si predstaviť , kde som .	nevieš	1	Fin
Ak nemôže dostať Belu on , nedostane ju nikto , ani človek ani zviera .	nedostane	6	Fin
Zasmiala sa .	Zasmiala	0	Part
“ Určite hľadáte Fawada , obchodníka so šperkami , “ povedala , keď k nej podišli .	hľadáte	2	Fin
Mala Lizine oči .	Mala	0	Part
Chvíľu len tak posedával a hlúpo zízal na papier .	zízal	6	Part
Musím vydržať dovtedy , keď sa bolesť nebude dať vydržať .	vydržať	1	Inf
Uvedomila som si , že na mňa čaká , a rozbúchalo sa mi srdce .	rozbúchalo	10	Part
Nechcela som Chrisa znepokojiť , ale čím dlhšie tu ostaneme , tým skôr nás zbadajú .	znepokojiť	3	Inf
Všetko prebehlo v tichosti , vedenie fakulty nevydalo nijaké oficiálne vyhlásenie .	prebehlo	1	Part
Vtom sa odraz mesiaca rozbil na črepy , no zakrátko sa zasa zjavil na hladine .	zjavil	12	Part
" Ale Júliu som nezradil , " poznamenal .	poznamenal	7	Part
Telefón zrazu prestal vyzváňať .	vyzváňať	3	Inf
“ Kým nebude jeho hlava visieť na múre môjho domu , dovtedy nebudeme v bezpečí . “	visieť	5	Inf
Prvý raz vôbec mohol si tú ženu prezrieť .	prezrieť	7	Inf
Vtom sa zjavil veľký modrý džin .	zjavil	2	Part
V posledných dňoch sa dokázal sústrediť len nakrátko .	sústrediť	5	Inf
Ich sústredený pohľad nemohol neupútať moju pozornosť .	neupútať	4	Inf
V tomto omámení som si spomenul na niečo zvláštne , čo som kdesi čítal alebo počul .	čítal	13	Part
Ja som ju napriek tomu nehanebne vyzliekal očami .	vyzliekal	6	Part
Čierna tma ustupovala pred sivastým svetlom .	ustupovala	2	Part
Zachytil ma , aby som sa neudrela .	Zachytil	0	Part
“ Ak ti na mne naozaj záleží , tak mi nerob zle !	záleží	6	Fin
Ale dlho ho potrebovať nebudeš , “ vraví pavúk Karkoško .	vraví	7	Fin
Možno tu rozlíšiť viacero sfragistických typov A .	rozlíšiť	2	Inf
Ani bratanci sa sem už neodvážia prísť , priatelia k nám prestali chodiť na návštevu už dávno .	chodiť	12	Inf
Oznámila mi , že ma pozýva .	Oznámila	0	Part
Porozprával mu o svojom sne , v ktorom sa mal stať hrdinom , a požiadal učiteľa , nech mu pomôže .	Porozprával	0	Part
Okamžite som ich vytiahol .	vytiahol	3	Part
Opustil som Lori .	Opustil	0	Part
Nedal sa zastaviť , vraj si ju hneď musí vyskúšať .	vyskúšať	9	Inf
v prioritných oblastiach verejného záujmu musí byť verejný sektor schopný konkurovať súkromnému sektoru pri získavaní a udržaní kvalitných ľudských zdrojov	konkurovať	10	Inf
Možno to , čo sa potom stalo , zvalím na mesiac .	zvalím	8	Fin
Musím rešpektovať Marginu požiadavku , aby som deťom nič nepovedal , a zároveň musím nájsť pre Irmu nejaké presvedčivé vysvetlenie .	rešpektovať	1	Inf
Niet pochýb , že nikdy nemohlo jestvovať obdobie , keď to bolo celkom bežné .	Niet	0	Fin
To nás obidvoch vždy uvoľnilo , mohli sme sa správať prirodzene .	správať	9	Inf
“ Blahoželám , zázračný silák , “ povedala Meg so slzami v očiach .	Blahoželám	1	Fin
Želám vám príjemný zvyšok týždňa .	Želám	0	Fin
A ja som jej neprezradil niečo , čo ma ťažilo veľmi dlho po jej odchode .	neprezradil	4	Part
Maja sa potichu zasmiala .	zasmiala	3	Part
Páčim sa Chrisovi !	Páčim	0	Fin
Uži si trocha , prikázala som si .	Uži	0	Fin
Mama sa pobrala do kuchyne , no na polceste zastala .	pobrala	2	Part
Ako prírodovedci sme to stále málo schopní definovať .	definovať	7	Inf
Ak nenájde dievča samo , nebude to mať zmysel .	mať	7	Inf
Tak je po Jaroslavovom víťazstve položený základ novgorodských výsad , ktorí Novgorodcom garantujú ochranu pred kniežacími družiníkmi a Varjagmi / no zároveň zabezpečujú kniežaciu družinu pred ľudom / .	garantujú	12	Fin
Preto je väčšinou lepšie neplytvať energiou a vziať na vedomie cudziu paradigmu .	neplytvať	4	Inf
Nuž som sa rozhodol , prirodzene , že ten rubín zmizne z jeho vrecka a zjaví sa v mojom . “	zjaví	15	Fin
Chlapec sa naskutku rozplakal .	rozplakal	3	Part
Môj potôčik vyrazil von , rozlial sa a ja som zostal zahalený v horúcej pare sauny .	rozlial	5	Part
Mal pocit , že ho v žalúdku páli oheň .	Mal	0	Part
Zavrela oči .	Zavrela	0	Part
Brat kantor pre vážne osobné dôvody nemohol prísť , preto brat farár sprevádzal nábožný spev na gitare spolu s mládežníkmi , ktorí poslúžili programom a vystúpili aj s osobným vyznaním .	vystúpili	25	Part
Baghíra sa snažil pozbierať všetku svoju dôstojnosť .	pozbierať	3	Inf
Pri cieli sa skrýval osiak Boris a zrkadielkom oslňoval ostatných pretekárov , len aby pomohol svojmu zmrzačenému kamarátovi zvíťaziť .	zvíťaziť	18	Inf
Podporením priestupnosti školského systému v oblasti prechodu žiakov na vyšší stupeň školy bez prijímacích skúšok , vláda minimalizuje podmienky na korupciu v školstve .	minimalizuje	17	Fin
“ To by bolo niečo pre mňa , “ vravel si .	vravel	9	Part
Vytvorí podmienky pre elektronický obchod a bude posilňovať dôveru verejnosti k elektronickému obchodovaniu .	posilňovať	7	Inf
Prikázal dopravnej čate , aby ju premiestnila , ale keďže bola veľmi ťažká , robotníci ju občas postavili na zem .	Prikázal	0	Part
Zajtra určite zasa vyjde slniečko !	vyjde	3	Fin
Lori sa naklonila a natiahla ku mne tvár .	natiahla	4	Part
Neodvážil som sa pohnúť , zdvihnúť ruky , odpovedať na Lorino objatie .	pohnúť	3	Inf
“ Mhm , “ povedal Aladin , kým čítal .	čítal	8	Part
Keď ho vypije , majú ho zabiť .	vypije	2	Fin
Porušenie tohto zákazu sa trestá odňatím ťažného zvieraťa a náradia .	trestá	4	Fin
“ Hádam mi nechceš tvrdiť , že nezáleží na výsledkoch .	tvrdiť	4	Inf
Nakoniec si urobila z nosidiel trampolínu , začala skákať kotrmelce a nosidlá tak rozhojdala , že ich včielky sotva udržali .	skákať	8	Inf
Ale sukničku s volánikmi horko ‐ ťažko uniesla .	uniesla	7	Part
Napokon ďakujem za vaše modlitby za zbor i nás duchovných pastierov .	ďakujem	1	Fin
Pomyslel som si , že plače .	plače	5	Fin
Zvládnem to , “ povedala som mu .	Zvládnem	0	Fin
Nemohla som si spomenúť , odkiaľ ju poznám .	poznám	7	Fin
Skôr či neskôr sa Abdullah vráti , ale dovtedy sa na Aladina usmialo šťastie .	vráti	5	Fin
Motýľ Emanuel poletoval kdesi nad lúkami a Makulienka ostala doma sama .	poletoval	2	Part
Sama sa predsa rozhodla , že opustí družky .	rozhodla	3	Part
Reformátori 11 . storočia však už dospeli k precíznejšej formulácii , ktorá , podľa nás , reprezentuje nimi presadzovanú snahu o čo najpresnejšie vymedzenie sfér vplyvu svetskej a cirkevnej moci .	reprezentuje	16	Fin
“ Blahoželám , mami !	Blahoželám	1	Fin
Za to , že sme mohli deti a chovancov obdarovať , ďakujeme Zuzke Reiszovej , Milke Čopovej a Jankovi Pagurkovi .	obdarovať	9	Inf
O ' Brienov sluha ich však oboch vpustil dnu bez jediného protestu .	vpustil	7	Part
Okrem rekodifikácie trestného práva vláda dopracuje legislatívny zámer rekodifikácie súkromného práva a na jeho základe vypracuje dlhodobý plán postupného vypracovania nových právnych predpisov .	vypracuje	15	Fin
Vidím , že začínam strácať niť .	strácať	4	Inf
“ Pozeraj mi do očí , keď sa s tebou rozprávam ! “ prikázal mu Káa .	Pozeraj	1	Fin
Flip zvolal obyvateľov lúčky , aby sa prišli s kamarátom rozlúčiť .	rozlúčiť	10	Inf
Nezdalo sa mi však , že som ho presvedčila .	Nezdalo	0	Part
“ Ty pokúšaš moju trpezlivosť ? “ zreval .	zreval	7	Part
“ Vidím , že ťa čaká veľmi dobrá budúcnosť .	Vidím	1	Fin
Ja jeden mám .	mám	2	Fin
“ Vravel si , že ti môžem veriť ! “	veriť	7	Inf
Uchopil ju za ruku .	Uchopil	0	Part
Prešlo niekoľko dní a princezná ani len nepomyslela na návrat domov .	Prešlo	0	Part
“ Nechcela som ťa nahnevať , “ vravela som rozpačito .	nahnevať	4	Inf
Už sa zmrákalo a Katka mala slzy nakrajíčku .	zmrákalo	2	Part
Chcel som povedať tým civilistom , aby mi aspoň vysvetlili , čo odo mňa chcú .	vysvetlili	9	Part
Vari ho špehuje ?	špehuje	2	Fin
Som chorá , povedala , zomriem .	zomriem	5	Fin
Keď sa raz rozhodla piecť v takú nezvyčajnú hodinu , nikto jej v tom nezabráni .	nezabráni	14	Fin
Do Tvojej milosti ich porúčame .	porúčame	4	Fin
A tu či inde sa v úplnej tajnosti nachádzali riadiace mozgy , ktoré koordinovali toto úsilie a určovali politickú líniu : rozhodovali o tom , že tento fragment minulosti sa zachová , tento sa sfalšuje a ďalší prestane jestvovať .	jestvovať	38	Inf
Mauglí nezašiel ďaleko , keď sa zrazu ocitol na rozľahlej čistinke .	nezašiel	1	Part
Vtedy som zdvihol telefón a vytočil číslo 09 .	vytočil	5	Part
Väčšie zlá sústavne unikali ich pozornosti .	unikali	3	Part
Bude mať názov Shanghai Noon a režisérom bude debutujúci Tom Dey .	mať	1	Inf
Beztak tie pracovité mravce nemohol ani cítiť .	cítiť	6	Inf
Vyznajme Bohu svoje hriechy , potom nám Boh daruje tento pokoj skrze vieru v Ježiša Krista .	Vyznajme	0	Fin
Opatrne ju položil na zelené súkno .	položil	2	Part
Nesmie zobudiť mamu .	Nesmie	0	Fin
Nemala inú možnosť , keď jej Roger odmietol šteniatka predať .	Nemala	0	Part
Marketing deformuje naše vnímanie a chápanie pravdy .	deformuje	1	Fin
“ Začni na ostrove Idra , kde vyhľadáš Filokteta , učiteľa hrdinov . “	Začni	1	Fin
Medzitým prestalo pršať a svitlo slniečko .	pršať	2	Inf
“ Balú , vstávaj , “ prosíkal .	vstávaj	3	Fin
Vedel , že ho má vo svojej hadej moci , ktorou môže zhypnotizovať aj to najživšie zviera .	zhypnotizovať	12	Inf
Konečne nastal veľký deň a porota si obchádzala vystavené košíky .	obchádzala	7	Part
Jeho nádej opäť zhasínala .	zhasínala	3	Part
Vyrába umelé potreby , ktoré nás aktivujú , vyprázdňujú , ničia a zotročujú .	vyprázdňujú	8	Fin
Vláda sa zaväzuje naďalej garantovať občianske slobody a všestranný rozvoj ľudských práv .	zaväzuje	2	Fin
Tá si vie vždy poradiť .	poradiť	4	Inf
Vlak sa šinul svojou slimačou pomalosťou .	šinul	2	Part
Ani bratanci sa sem už neodvážia prísť , priatelia k nám prestali chodiť na návštevu už dávno .	prestali	11	Part
“ Aj ja , “ odvetil Chris a pohrával sa mi s vlasmi .	odvetil	5	Part
Chytil ma za ruku a bežali sme dolu kopcom až k svetlám .	Chytil	0	Part
Nemohol som sa na nič sústrediť , nevládal som zniesť nikoho pri sebe : ani Margu , ani mamu , ani Toma .	sústrediť	5	Inf
Dlho sedela na kraji lesa a pozerala , ako zlaté klasy zľahka povievajú v letnom vánku .	pozerala	6	Part
" Tak ty ho nenávidíš .	nenávidíš	4	Fin
Keď chcel , úplne vypol a okolie preňho neexistovalo .	neexistovalo	8	Part
Nikdy nepočula o Bratstve a odmietala veriť v jeho existenciu .	veriť	6	Inf
Chvíľu leteli , až pristáli v spustnutej záhrade , kde bola pod obrovskou smutnou vŕbou hlbočizná studňa .	pristáli	4	Part
“ Mohla by som doplniť aj najhulvátskejší ? “ dodala Aziza .	doplniť	4	Inf
“ Môžeš si dať za mňa , “ povedala som .	Môžeš	1	Fin
Kapitoly vytvoria protiváhu hlboko miestne ukotveného archeologicko ‐ historického prehľadu a predkladajú nový zorný uhol na skúmanú tému .	predkladajú	11	Fin
“ Nesmieš sa udrieť , nesmieš sa udrieť , nesmieš sa udrieť .	udrieť	11	Inf
Deti sa budú matkám odnímať už pri pôrode , ako vajce sliepke .	odnímať	4	Inf
“ Radža naozaj nikomu neublíži , “ ubezpečovala ho Jazmína .	neublíži	4	Fin
Tá myšlienka mu v skutočnosti v mysli skrsla v podobe vidiny , skleného ťažidla , ktoré sa zrkadlilo na povrchu sklápacieho stola .	zrkadlilo	17	Part
Zebríčaťu sa nesmierne páčilo , keď mu prečesávala hrivu .	prečesávala	7	Part
V jedno vetristé popoludnie zaspala pani Mandelinka uprostred obeda na stoličke a oni sa jej starali o drobizg .	zaspala	4	Part
A bolo čo vidieť aj počúvať .	vidieť	3	Inf
Nález železného kľúča od visiaceho zámku mohol súvisieť s už spomenutou ochrannou funkciou .	súvisieť	7	Inf
Poznáte to .	Poznáte	0	Fin
Uniklo mi „ ach ! “ .	Uniklo	0	Part
Neviem , čo mi to napadlo .	Neviem	0	Fin
“ Tráva horí ! “	horí	2	Fin
Meg totiž verila , že iba Fil môže odvrátiť Herkulovu porážku .	odvrátiť	8	Inf
Zmĺkla som , lebo som si spomenula , ako sa moja mama pustila do pečenia aj po dvoch šichtách .	Zmĺkla	0	Part
Podporí v rámci krajín EÚ kompatibilnosť v oblasti vzájomného uznávania dokladov o dosiahnutí určitého stupňa vzdelania .	Podporí	0	Fin
“ Čo by si chcela robiť v sobotu ? “ spýtal sa Chris a ja som na uchu zacítila jeho dych .	robiť	5	Inf
Vláda v spolupráci s predstaviteľmi územnej samosprávy vytvorí transparentný inštitucionálny a finančný návrh na kofinancovanie regionálneho rozvoja z prostriedkov štátneho rozpočtu a z fondov EÚ .	vytvorí	7	Fin
“ Musíte tam vletieť , “ radila Petronila s plnými ústami .	Musíte	1	Fin
Odporná extáza strachu a pomstychtivosti , túžba zabíjať , mučiť , drúzgať tváre kováčskym mlátom akoby preskočila sťa elektrický prúd na všetkých a premenila každého aj proti jeho vôli na vrieskajúceho pomätenca s pokrivenou tvárou .	zabíjať	7	Inf
Od toho času neznášam zvonenie budíka .	neznášam	3	Fin
Asistovali im naše sestry , ktoré v zariadení pracujú .	Asistovali	0	Part
" Pivo bolo lepšie , " poznamenal napokon .	poznamenal	6	Part
Začínam byť vážne neznesiteľný snob .	Začínam	0	Fin
Druhý a tretí riadok spolu dávajú meno Sežir .	dávajú	5	Fin
“ Hromy a blesky privej !	privej	4	Fin
Zviera síce svojím výzorom naháňalo hrôzu , no Gaston bol presvedčený , že ho aj tak zabije a Bela oľutuje deň , keď sa zaňho odmietla vydať .	vydať	26	Inf
Nemyslite si , že nepôjdu .	nepôjdu	4	Fin
Pozreli vyššie , ešte vyššie a zistili , že je to človek .	zistili	6	Part
“ Chcela som ťa uchrániť pred chybami , ktorých som sa kedysi dopustila ja .	uchrániť	4	Inf
Vzápätí pribehli mandelinčatá s boľavými bruchami , takže musela ošetriť aj ich .	ošetriť	9	Inf
Ruky ma zúfalo boleli a na krátky , ale nepríjemný okamih som nadobudla dojem , že spadnem na nesprávnu stranu .	spadnem	16	Fin
Nečakal som , že ju moje slová až tak rozosmejú .	Nečakal	0	Part
“ Takže musím zavolať tvojmu otcovi , “ povedala .	musím	2	Fin
Ako vlak , ktorý zišiel z koľají .	zišiel	4	Part
Sneh trval na tom , že musím zostať v tejto pasci .	musím	6	Fin
V Policajnom zbore sa zmení systém hodnotenia práce , ktorý bude akcentovať mieru spokojnosti občanov s činnosťou polície .	akcentovať	11	Inf
V tejto súvislosti použila výraz „ špicľovanie “ .	použila	3	Part
“ Vari si môžem niekde chvíľu odpočinúť ! “ uštipačne odvetila .	odpočinúť	6	Inf
“ Ako ste si mohli myslieť , že zvíťazíte nado mnou , nad Kráľovnou zla !	zvíťazíte	8	Fin
Okrem zajatcov priemerný občan Oceánie nikdy nezočí občana Euroázie alebo Východoázie a zakazuje sa ovládať cudzie jazyky .	ovládať	14	Inf
Nezavelil však na ústup , ale poslal dopredu ďalších zubáčov .	Nezavelil	0	Part
“ Odíď a daj mi pokoj !	Odíď	1	Fin
Trápilo ma niečo iné : musím zvíťaziť nad zvieraťom , ktoré sa vo mne prebudilo .	prebudilo	14	Part
Napokon preletel cez domček slimáka Oskara a skončil na baze .	preletel	1	Part
Nezáleží na tom , čo povieš či urobíš ; záleží jedine na tom , čo cítiš .	urobíš	7	Fin
“ Môžem si to ešte rozmyslieť ? “ spýtala sa .	Môžem	1	Fin
“ Vezmeš Mauglího do osady , “ prikázal mu Baghíra .	Vezmeš	1	Fin
Pozvala na ňu Blythe a Ricka a podávala moje obľúbené jedlá : zemiakovú kašu , pizzu , celozrnný chlieb , španielske chimichangas , makaróny so syrom a orechový koláč .	Pozvala	0	Part
Po celý čas som sa díval smerom k osvetlenému pásmu , kde sa zástup žien tlačil pred skleným priečelím obchodu .	díval	5	Part
Preto je väčšinou lepšie neplytvať energiou a vziať na vedomie cudziu paradigmu .	vziať	7	Inf
Lori zostala stáť .	stáť	2	Inf
“ Môžem byť vaším kapitánom ? “ spýtala sa .	Môžem	1	Fin
Regula metského biskupa podrobne ustanovuje i podmienky prijatia do spoločenstva kanonikov a v rámci nich predpisuje pre kandidáta povinnosť odovzdať všetok majetok kostolu , pri ktorom mieni pôsobiť .	pôsobiť	27	Inf
Ide sa vydávať .	vydávať	2	Inf
“ Hádes nás zabije , keď to zistí ! “	zabije	3	Fin
“ Vieš , minulé leto som mal fantastický džob .	Vieš	1	Fin
V Gregorovom ponímaní by to znamenalo komendovanie Uhorska sv . Petrovi , ktorého nástupca by vládcovi krajiny udelil kráľovskú korunu .	znamenalo	5	Part
Hádaj znovu . "	Hádaj	0	Fin
“ Ako to myslíš ? “ zaujímal sa škriatok .	myslíš	3	Fin
Prečo nechodím na rande ?	nechodím	1	Fin
Sklo je prirodzene náchylné rozbiť sa a plech nezaručuje odolnosť voči vlhkosti .	rozbiť	4	Inf
Počula som tikanie nástenných hodín a vlastný dych .	Počula	0	Part
Aj ja som prišiel kvôli tomu , hoci som sa nemohol zbaviť stŕpnutosti .	nemohol	10	Part
Položil mi poslednú otázku .	Položil	0	Part
“ Už letím ! “ kričí Polly .	kričí	5	Fin
Váhavo sme sa od seba odtrhli a Chris ma odprevadil k nášmu oknu .	odprevadil	9	Part
Opisuje ich neobyčajne presvedčivo , pútavo a s hlbokým porozumením .	Opisuje	0	Fin
Už tretíkrát sme sa mohli stretnúť na neformálnej úrovni a prebrať pálčivé problémy , s ktorými sa stretávame na chodbách našej školy .	stretávame	17	Fin
Na druhej strane slovo Kominterna vnuká predstavu prísne štruktúrovanej organizácie a dobre zoštylizovanej ideologickej doktríny .	vnuká	5	Fin
Kým som si to stačila uvedomiť , po tvári mi tiekli slzy a potichu som vzlykala .	uvedomiť	5	Inf
So mnou určite pôjde . “	pôjde	3	Fin
Akýsi neomylný inštinkt mi signalizoval , že aj ona myslí na mňa .	myslí	9	Fin
* Niektorým poslancom padlo zaťažko zverejniť svoje majetkové priznanie .	zverejniť	5	Inf
Výsledkom bude , že v nijakej oblasti sa nespotrebuje viac zdrojov , ako na ňu bude vyčlenených v rozpočtoch , ktoré schváli NR SR , resp . jednotlivé samosprávne orgány .	schváli	21	Fin
Keď sa Šer Chán obzrel za seba , od strachu zareval .	obzrel	4	Part
Postupne sa zdvíhanie a klesanie ich hrudí spomalilo a prešlo do normálneho rytmu a s príjemným pocitom bezmocnosti sa od seba oddelili .	prešlo	9	Part
“ Pripadá mi to najmenej nebezpečné . “	Pripadá	1	Fin
“ Chceš povedať , že s tým nemôžeš niečo urobiť ? “ pýtal sa zúfalý Herkules .	povedať	2	Inf
Musím sa priznať , že sa mi ten nápad ohromne páčil , hoci znel neuveriteľne .	Musím	0	Fin
Ja som nehľadal Istanbul ani bývalé hlavné mesto nejakej inej ríše .	nehľadal	2	Part
“ Vari si môžem niekde chvíľu odpočinúť ! “ uštipačne odvetila .	odvetila	10	Part
M . N . Tichomirov fakt jednostranné vykladá len ako príčinu „ hladových vzbúr “ , Frojanov si všíma dôležitú okolnosť — volchovia sa zjavujú , aby zabezpečili blahobyt , hojnosť , úrodu .	vykladá	7	Fin
“ Chcem sa pozrieť zblízka .	pozrieť	3	Inf
Pramenné materiály , ktoré zachytávajú 11 . storočie sa zmieňujú o prudkom nástupe novej ideológie do všetkých oblastí života .	zachytávajú	4	Fin
Baghíra zatajil dych .	zatajil	1	Part
Nespomínali moje ruské dobrodružstvo .	Nespomínali	0	Part
A poprosím ju , aby mi večer robila spoločnosť .	poprosím	1	Fin
" Niekedy to , samozrejme , neplatí .	neplatí	6	Fin
Hmotný svet existuje , jeho zákony sa nemenia .	nemenia	7	Fin
Nemohli sme k nej chodievať , ani ona nemohla chodievať k nám .	chodievať	4	Inf
“ Nemôžeš mi nič zakazovať !	Nemôžeš	1	Fin
Začala som s kapitolou o zatmení a snažila sa spomenúť na to , čo som videla .	spomenúť	9	Inf
Sergej , ktorému pohľad na zvieratá spôsoboval pôžitok , začal zo seba vyrážať akési výkriky .	spôsoboval	6	Part
Vtom zbadal Aladin pred sebou jasnovidca .	zbadal	1	Part
Maličkosť , ktorá poteší .	poteší	3	Fin
Možno o vaše poučovanie nebude vôbec stáť .	stáť	6	Inf
Bál som sa , že zloží slúchadlo , a tak som sa usiloval rýchlo niečo vymyslieť .	vymyslieť	15	Inf
Rozbehla som sa a skočila , pričom sa hladina rozbúrila ako po výbuchu .	rozbúrila	9	Part
Išla som k dverám jej izby : “ Volá Rick , “ zašepkala som .	Volá	8	Fin
Dal som mu takéto meno , keď som s akousi ľahkosťou presvedčil sám seba , že toto meno najlepšie pristane môjmu hrdinovi .	Dal	0	Part
Viete , koľko tu stojí 1 - izbový byt ?	stojí	4	Fin
Najmenšia drobnosť vás mohla prezradiť .	prezradiť	4	Inf
Vyšiel som von a chvíľu som nerozhodne postával : mám celkom odísť , alebo mám poslúchnuť chlapcovu radu a ísť do toho podniku ?	poslúchnuť	15	Inf
Poznal som naspamäť všetky Čechovove poviedky a novely , ktoré vyšli v albánčine .	vyšli	10	Part
Lenže svedomie mi nedalo , a musela som jej niečo povedať .	povedať	10	Inf
“ Zľutujte sa .	Zľutujte	1	Fin
Ako som počúval otcove husle , pred očami sa mi zjavil portrét ženy z medailónu .	zjavil	10	Part
Vysvetlil mi , že mi musia položiť iba niekoľko otázok .	musia	5	Fin
Naozaj stenám , ale ty si to , preboha , poriadne zveličil .	stenám	1	Fin
Prepáčila by mi to , aj keby vedela , že som to odkladala kvôli nočnému astronomickému klubu s Chrisom ?	vedela	7	Part
Nikoho , kto raz vybočil , neušetríme .	neušetríme	6	Fin
Terk si začala priateľa väčšmi vážiť , ale Kerchak sa zlostil .	vážiť	5	Inf
“ Ešte si to rozmyslím , “ zahučal obor , ale už sa knísal nepriateľovi v ústrety .	knísal	13	Part
Skúste siahnuť po nejakej knižnej novinke , zoznam nájdete v Knižnom katalógu .	siahnuť	1	Inf
Strana jestvuje .	jestvuje	1	Fin
My krájame vlastný chlieb	krájame	1	Fin
A všetky naraz začali vylučovať energiu .	vylučovať	4	Inf
Šikovne využil pobyt folklórnych skupín a súborov z celého Slovenska v Bratislave , ktoré sem chodili na náklady Opusu alebo rozhlasu nahrávať platne .	využil	1	Part
Sadol si na zem a povedal : “ Tak čo mám teda robiť ? “	mám	10	Fin
Na letisko nás prišiel čakať Sergejov priateľ .	čakať	4	Inf
A ak sa za týchto okolností zjavil Hádes , bolo to nedobré .	zjavil	6	Part
Mozog mi pracoval na plné obrátky , keď som zvažovala , ktorá z možností je správna a meravou rukou som úhľadne zakrúžkovávala odpovede ceruzkou , úplne vlhkou od potu .	zakrúžkovávala	21	Part
Videla som mu na očiach , že to berie vážne .	berie	8	Fin
Šírila sa z veľkého červeného kvetu s tmavozelenými listami .	Šírila	0	Part
“ Môže tu ostať do desiatej . “	ostať	3	Inf
Ja som chcela vyhrávať .	vyhrávať	3	Inf
Pomyslel som si , že sa mi to len zdá .	zdá	9	Fin
Chcela by som sa na nej odviezť , “ povedala Makulienka .	odviezť	6	Inf
Vďaka týmto skúsenostiam pre mňa teoreticky neexistovalo nijaké tajomstvo súvisiace s túžbami , ktoré nútia muža pokúšať sa o zblíženie so ženou .	pokúšať	16	Inf
“ Mhm , “ odvetila som .	odvetila	4	Part
Skry sa ! “ zvolala som a zatiahla Chrisa pod oleander .	zvolala	4	Part
Keď máme čo jesť , máme všetko ostatné , čo potrebujeme .	potrebujeme	10	Fin
Márne sa prezliekala , v našej izbe sa vždy našlo niečo , čo smrdelo kravínom .	prezliekala	2	Part
Boli štyri hodiny popoludní a opäť začalo pršať .	pršať	7	Inf
Zvláštnym , odzbrojujúco priateľským gestom , ktoré len on dokázal vyčarovať , si na nose upravil okuliare a pokračoval :	vyčarovať	10	Inf
“ Nechcú nám ublížiť , Kerchak ! “ povedal .	Nechcú	1	Fin
A obchody , ktoré chcú predávať zaručene čerstvý , v noci upečený a nezabalený chlieb , musia ho držať v osobitných zasklených policiach , takže skôr nebalenie chlieb zdražuje .	predávať	5	Inf
Túžila som ho vidieť .	vidieť	3	Inf
Decentralizačné opatrenia budú vecne aj časovo nadväzovať na fiškálnu decentralizáciu .	nadväzovať	6	Inf
Uprostred pretekov som prestala plávať a šliapala som vodu až k miestu , kde sa ponoril .	plávať	4	Inf
Ale nikto sa neodhodlal spustiť posmešky .	spustiť	4	Inf
" Koľko prstov zdvíham , Winston ? "	zdvíham	3	Fin
Dieťa spokojne ležalo a nič nenaznačovalo , že sa vlci chystajú vyjsť z jaskyne .	vyjsť	11	Inf
Osobitne by sme si chceli povšimnúť právne normy , v ktorých ide o odvádzanie desiatku klérom .	povšimnúť	5	Inf
“ Viem , “ povedala som a vystúpila z auta , “ ale ak budem myslieť len na zábavu , môžem ísť zametať chodníky . “	myslieť	15	Inf
“ To je dobre , ale dúfam , že najprv budem bohatý a mocný . “	dúfam	6	Fin
Len pred dvoma týždňami som ti chcel rozbiť hlavu dlaždicou .	rozbiť	7	Inf
Po chvíli sa upokojil a začal vysvetľovať .	vysvetľovať	6	Inf
Mama mi naznačila , že nemám otvárať .	otvárať	6	Inf
Svojím typickým gestom si O ' Brien upravil na nose okuliare .	upravil	7	Part
Musí byť pohodlný , viem , aby sa v ňom Lienke dobre sedelo a dobre pérovaný , aby nedostala kočovú chorobu .	viem	4	Fin
Mne to môžeš povedať . “	môžeš	2	Fin
Nič sa nedalo robiť .	robiť	3	Inf
Urobila som adventný veniec a zavesila na dvere .	zavesila	5	Part
Chcem poďakovať aj sestrám , ktoré sa podieľajú na upratovaní nášho chrámu .	poďakovať	1	Inf
Vyšiel som na kopec , ale nestretol som nijakého psa .	nestretol	6	Part
Cítila som , že sa pohybujú , ako keby mi chceli prezradiť nejaké tajomstvo .	prezradiť	11	Inf
Ani družka , ani sok ho nesledujú . Čo ho núti vysedávať na konári osamoteného stromu a vyludzovať hudbu do prázdna ?	vysedávať	11	Inf
“ Naozaj chceš poznať svoju budúcnosť , Aladin ? “ spýtal sa .	poznať	3	Inf
Povie niečo ?	Povie	0	Fin
S údivom pozeráme na hospodskú .	pozeráme	2	Fin
Celý týždeň som bol náchylný uveriť , že to všetko bol iba sen .	uveriť	5	Inf
Ja neviem .	neviem	1	Fin
Nechal som ju vzlykať .	vzlykať	3	Inf
Netrvalo dlho , a policajti prišli do kaviarne zatknúť zlodeja .	prišli	5	Part
Sergej , ktorému pohľad na zvieratá spôsoboval pôžitok , začal zo seba vyrážať akési výkriky .	vyrážať	12	Inf
“ Hádam niečo vymyslíme . “	vymyslíme	3	Fin
Úprimne sa snažil budovať tento náš zbor a nezištne slúžil a slúži ECAV .	budovať	3	Inf
“ Túto nosím vždy pri sebe .	nosím	2	Fin
Keby ste ho nenašli , leťte za slnečným svitom .	nenašli	3	Part
Nemala inú možnosť , keď jej Roger odmietol šteniatka predať .	predať	9	Inf
Škriatok sa zasmial .	zasmial	2	Part
Omar odvrátil zrak .	odvrátil	1	Part
O ' Briena vyparia .	vyparia	3	Fin
Zničí ich raz a navždy !	Zničí	0	Fin
Nezvoň , mama bude spať .	spať	4	Inf
Na otca sa nepamätám .	nepamätám	3	Fin
Povedala mi , že pochopila , čo ma trápi .	pochopila	4	Part
Kým svetlo stihlo zmiznúť , upozornil som naň taxikára .	zmiznúť	3	Inf
Pri tomto vyzdvihovaní cirkvi možno zreteľne rozoznať dve fázy .	rozoznať	6	Inf
Potom sa otvorili dvere a vošla mamička .	vošla	5	Part
Zhlboka sa nadýchla , poriadne si vydrhla predné nohy a ostala nehybne sedieť na liste ako prikovaná .	ostala	10	Part
Sprievod vyšiel z uličky za domom , čo znamená , že musel zomrieť niekto , kto býva v dome .	zomrieť	12	Inf
Ak chce Kalif vedieť toto , tak dobre .	chce	1	Fin
Veľkú tašku hodil do kúta a mľaskavo ho pobozkal .	hodil	2	Part
Musím rozmýšľať . “	rozmýšľať	1	Inf
Podala mi pohár a ja som vystrúhal biedny úsmev .	Podala	0	Part
Takáto túžba robiť hlúposti ma neopustila po celý deň .	robiť	2	Inf
Chceš povedať , že Amy Wyseovej sa páči nejaký chalan ?	povedať	1	Inf
Maja s Vilkom poprisili o kúsok smrčka a statočne ho prežúvali , len aby sa zavďačili hostiteľovi .	zavďačili	15	Part
Ak im dovolíme , aby na nás zaútočili zo všetkých strán , nikdy sa neubránime .	dovolíme	2	Fin
Žije šťastne , nemá povinnosti a nič jej nechýba .	Žije	0	Fin
" Hráš , vyhráš , hráš , prehráš .	prehráš	7	Fin
“ Môžeš chodiť , kam len chceš . “	chodiť	2	Inf
Má netradičnú grafickú podobu a svojimi malými rozmermi sa zmestí do každej tašky a ku každému počítaču .	zmestí	9	Fin
“ Musíte to urobiť ešte dnes ! “ skríkla na nich Cruella .	urobiť	3	Inf
Môže mu veriť ?	Môže	0	Fin
Chcela mu ukázať strom , z ktorého viseli liany .	ukázať	2	Inf
Nechal som tam Margu stáť a podišiel som k dverám .	stáť	4	Inf
“ Narušujú morálku našich detí , “ kričal do mikrofónu .	Narušujú	1	Fin
Napriek tomu som musel tvoriť .	tvoriť	4	Inf
“ Neviem , “ povedala som váhavo .	Neviem	1	Fin
Mauglího myšlienky prerušil Baghírov prísny hlas .	prerušil	2	Part
Zároveň svetská časť vládnúcej vrstvy prestáva mať záujem o monoteizmus vyjadrujúci myšlienku — jeden boh , jeden panovník .	mať	6	Inf
“ Ale mne veriť môžeš . “	veriť	3	Inf
Voš žijúca v lone vystúpi nahor , na krk , voš z vlasov sa spustí dolu , na líce .	vystúpi	4	Fin
Gaston bol presvedčený , že tentoraz nevyviazne so zdravou kožou .	nevyviazne	6	Fin
Rodičia zostali prekvapene stáť .	stáť	3	Inf
Pre Lizu by bolo katastrofou , keby som rozpovedal ostatným , čo som videl v Profesorovej izbe .	videl	13	Part
Brániť sa tomu nebudem .	Brániť	0	Inf
“ Mali by ste sa obaja hneď vydať na cestu . “	vydať	7	Inf
Mal som príležitosť poznať dievčinu , ktorá sa volala Lori , ale ona sa stratila .	poznať	3	Inf
Ja tomu len verím . Viem , že raz padnete .	padnete	9	Fin
“ Tak uspíme slniečko ! “ navrhla Makulienka .	uspíme	2	Fin
Máme pre vás slávnu správu .	Máme	0	Fin
Znova som vliezla do vody .	vliezla	2	Part
" Zoberiem tú funkciu , ak to ľudia naozaj budú chcieť , " povedal režisér .	chcieť	10	Inf
Na povrchu hlainy sa ukázali špinavé bublinky a obecenstvo tlieskalo .	tlieskalo	9	Part
Prvýkrát počas celého výsluchu som sa mu pozrel do očí .	pozrel	7	Part
Si škvrna , ktorú treba zotrieť .	zotrieť	5	Inf
“ Ak chceš , môžeme začať od začiatku , “ povedal .	chceš	2	Fin
Zažiješ neuveriteľné dobrodružstvá .	Zažiješ	0	Fin
Nevládala som naňho pozrieť .	pozrieť	3	Inf
Na druhý deň navštívila Klotilda Teklu a začali muzicírovať .	muzicírovať	8	Inf
Na dvore som hadicou napustila slnkom zohriatu vodu a začala som šampónovať auto .	šampónovať	11	Inf
Alan Smithee je meno , ktoré sa používa v titulkoch , keď ražisér z rôznych príčin nesúhlasí s uvedením vlastného mena .	nesúhlasí	16	Fin
“ Snehulienka predsa leží mŕtva v lese , “ povedala a otvorila skrinku .	leží	3	Fin
Chan si zahrá Číňana , ktorý pricestuje na Divoký západ , aby zachránil unesenú dcéru čínskeho konzula .	zachránil	12	Part
Obsiahly vlastivedný úvod ( Praefatio ) k Doležalovej gramatike napísal o generáciu starší Matej Bel .	napísal	9	Part
“ Je v šoku , nehýbe sa , “ zistili mravce .	nehýbe	5	Fin
Ešte nikto nikdy Veľkého brata nevidel .	nevidel	5	Part
“ Nijakú kobylku nepoznám , ukážeš mi ju , Vilko ? “	ukážeš	5	Fin
Je to celá svorka , oči im žiaria v tme .	žiaria	7	Fin
Teraz musí urobiť , čo jej prikáže .	urobiť	2	Inf
Radšej zomreli , akoby mali Krista zradiť a zaprieť .	zaprieť	8	Inf
Zasmiala som sa .	Zasmiala	0	Part
Keď pozrela pod seba , zistila , že uviazla v pavúčej sieti .	pozrela	1	Part
Alebo si ju stiahnite v súbore PDF na tej istej adrese .	stiahnite	3	Fin
Tu nejde o solipsizmus .	nejde	1	Fin
Stúpame po schodíkoch , ktoré jej dali meno , a mierime na Karlovo naměstí .	Stúpame	0	Fin
Prišla za mnou , objala ma a hojdala v náručí .	objala	4	Part
Tesnejšie sa pritisol k malinčiu a oko zavrel .	zavrel	7	Part
“ Volám sa . . . “	Volám	1	Fin
“ Čo na mňa tak zízate ? “ zvolal na Maju .	zízate	5	Fin
Vláda je pritom presvedčená o nevyhnutnosti zavádzať do rezortu pôdohospodárstva , pri rešpektovaní niektorých špecifík , trhové podmienky a slobodnú konkurenciu .	zavádzať	6	Inf
Miznú tak i zvyšky existencie predkresťanskej náhrady za škodu , nahradzujúce prechodne krvnú pomstu .	Miznú	0	Fin
Neodvážila sa otvoriť oči a ja som pochopil , že očakáva niečo strašné .	otvoriť	2	Inf
Trápilo ma niečo iné : musím zvíťaziť nad zvieraťom , ktoré sa vo mne prebudilo .	zvíťaziť	6	Inf
“ Mhm , “ povedal Aladin , kým čítal .	povedal	4	Part
Na úplný záver dlžím ešte jedno poďakovanie .	dlžím	3	Fin
Chcem vedieť , či niekedy nájdem pravú lásku . “	nájdem	5	Fin
Nezdalo sa mi , že veštia nejaké zásadné zmeny .	Nezdalo	0	Part
Najvyšší čas prebehnúť sa po čerstvom vzduchu !	prebehnúť	2	Inf
Biely vždy dáva mat .	dáva	2	Fin
Tayerle nám povedal , že o 00 . 08 sa mesiac začne postupne pohybovať do tieňa zeme .	pohybovať	13	Inf
“ Učme sa spolu , “ navrhol Chris .	Učme	1	Fin
Nesmie zobudiť mamu .	zobudiť	1	Inf
“ Musím ti niečo povedať .	Musím	1	Fin
Na hrebeni sa otočil a zaparkoval autom celkom pri okraji cesty .	otočil	3	Part
Vendelín sa chvíľu zdráhal , lebo mal kopu práce , no napokon sa predsa dal prehovoriť .	prehovoriť	15	Inf
Ak má môj rod zomrieť , tak chcem zomrieť i ja , pomyslela si .	zomrieť	8	Inf
Teraz sa v noci budievam zo spánku a hrdlo mi zviera úzkosť : trápi ma nočná mora , že aj ja som v dave , ktorý ženie mamu v ústrety smrti .	budievam	4	Fin
“ Mimochodom , “ poznamenal chrobák , “ zabudol som sa predstaviť .	poznamenal	4	Part
Chceš vidieť , ako urobím leoparada ? “ spýtal sa .	vidieť	1	Inf
“ Viem sa o seba sám postarať , “ povedal nahlas .	postarať	6	Inf
Teraz musím publikovať .	publikovať	2	Inf
Strašná babizňa spokojne zakrákala .	zakrákala	3	Part
V tejto kapitole budeme hovoriť o cirkevnoprávnych normách , ktoré reglementujú podmienky pre vznik , obsah a zánik manželstva .	hovoriť	4	Inf
Verila , že neurobím to čo ona .	neurobím	3	Fin
Lev IX . a jeho nástupcovia sa teda snažili cirkev už skutočne riadiť .	riadiť	12	Inf
Nepoznám nič horšie ako utáraných kamarátov .	Nepoznám	0	Fin
Ja to viem , prehovoril som po dlhom váhaní .	prehovoril	4	Part
Nikto z nich nevie nič o mojom ruskom dobrodružstve .	nevie	3	Fin
“ Počkajte , chvíľu .	Počkajte	1	Fin
Medzitým prišlo na plaváreň zopár deciek z oddielu a ich hlasy sa ozývali po vykachličkovanom priestore .	prišlo	1	Part
“ Musím ťa zaviesť do osady , “ vyhŕkol napokon Balú .	zaviesť	3	Inf
Schytil jeden z mečov a zahnal sa na Džafara .	zahnal	5	Part
Správu aktív bude v tomto systéme zabezpečovať súkromný sektor , výber správcu bude v plnej kompetencii občana .	zabezpečovať	6	Inf
V náručí niesol nákupnú tašku .	niesol	2	Part
Asi sa dopočul , že chodím s Chrisom .	chodím	5	Fin
Svätoštefanská legislácia predpokladá , že veriaci budú v nedeľu chodiť do kostola .	chodiť	9	Inf
Nemôžeš poprieť , že si plakala .	Nemôžeš	0	Fin
Vždy som mával zvláštny pocit , že ten človek ma neznáša .	neznáša	10	Fin
S hrôzou som otvoril oči : zvonil telefón .	zvonil	6	Part
Keď mravenisku hrozilo nebezpečenstvo , statočne ho bránili .	bránili	7	Part
Okrem zajatcov priemerný občan Oceánie nikdy nezočí občana Euroázie alebo Východoázie a zakazuje sa ovládať cudzie jazyky .	zakazuje	12	Fin
Ohrozené boli mestá Brazzaville a Leopoldville . Človek sa nepotreboval pozrieť na mapu , aby vedel , čo to znamená .	nepotreboval	9	Part
“ TUŠÍM MÁŠ DOBRÚ NÁLADU , “ podozrievavo povedala mama , keď som sa ponúkla , že jej umyjem auto , kým pôjde do práce .	ponúkla	14	Part
V rohu na sklápacom stole v pološere sa jasne lesklo sklené ťažidlo , ktoré tam kúpil na poslednej návšteve .	kúpil	15	Part
Dozvedel som sa to , keď som sa vrátil domov a ešte predtým urobil jeden pokus .	Dozvedel	0	Part
“ Nie je zlý , hoci lepšie mi chutí náš . “	chutí	8	Fin
“ Tak poďme privítať môjho nápadníka . “	privítať	3	Inf
Winston spustil ruky pozdĺž bokov a pomaly nabral vzduch do pľúc .	spustil	1	Part
Človek očakával , že ho zabijú .	očakával	1	Part
O výške trestu mala rozhodnúť odkvitnutá púpava .	rozhodnúť	4	Inf
Najprv so mnou nechcela hovoriť .	nechcela	3	Part
Počkaj chvíľu ! “ zakričal škriatok .	Počkaj	0	Fin
Nimi vysvätení kňazi teda nie sú právoplatne vysvätenými a nemôžu teda veriacim sprostredkovať dary Ducha Svätého .	sprostredkovať	12	Inf
A hoci tú knihu ešte nedočítal , vedel , že práve toto je konečné Goldsteinovo posolstvo .	vedel	7	Part
A uzlovým bodom všetkých právnych formúl , ktoré sa týkajú rozoberaných hnutí , je vzťah tohto spoločenstva k štátnej moci , t . j . stret sveta šamanistického dualizmu s predstaviteľmi kniežacej moci , zjednocujúcimi krajinu .	týkajú	9	Fin
Ľubomír Ďurovič do komunistickej strany nevstúpil .	nevstúpil	5	Part
My však každému ponaprávame mozog do dokonalosti , kým mu ho vystrelíme .	ponaprávame	3	Fin
Jeho kult sa spájal s kultom Poseidóna .	spájal	3	Part
Zakryte nádobu pokrievkou a nechajte vychladnúť na izbovú teplotu .	nechajte	4	Fin
Muž , ktorý zostal stáť , mi povedal to isté po anglicky .	stáť	4	Inf
Všetci sme sa podobali na postavy absurdného divadla .	podobali	3	Part
Ale oni nič nerobili ani nehovorili .	nehovorili	5	Part
Naučím ho všetko , čo viem . “	Naučím	0	Fin
“ A správaj sa slušne , srdiečko , “ zašepkala .	zašepkala	9	Part
Umožniť jazykovedcovi rozhovoriť sa o systéme v jazyku , prináša zdanlivo nebezpečenstvo , že sa vstúpi do nezaujímavého a nudného sveta .	rozhovoriť	2	Inf
“ Prestaň zúriť , Blythe , “ šepkala som do slúchadla , aby ma mama nepočula .	zúriť	2	Inf
Je to chronologicky prvá zbierka , ktorú zostavil neznámy autor z rímskych reformných kruhov .	zostavil	7	Part
Ďakujeme vám , bratia a sestry , za vaše modlitby , pomoc s potravinami , za vaše rady a inú praktickú pomoc !	Ďakujeme	0	Fin
Iba na bodliaku sa jagali veľké kvapky rosy , lebo sa báli skotúľať do trávy .	skotúľať	12	Inf
“ Čakali , že aspoň jeden z nás pôjde v ich šľapajach .	pôjde	8	Fin
To nie sú ovce , ticho som jej zašepkal do ucha .	zašepkal	8	Part
“ Už som veľká , poradím si sama .	poradím	5	Fin
V našich chlievoch niet jedinej kravy .	niet	3	Fin
“ A teraz mi zaplať ! “ zhúkol na Jazmínu predavač .	zaplať	4	Fin
Maja ju však nechala , nech rozpráva .	rozpráva	6	Fin
Vláda zabezpečí implementáciu koncepcie integrácie zdravotne postihnutých do života , aby mohli pracovať a plnohodnotne sa zúčastňovať na živote spoločnosti .	zúčastňovať	16	Inf
Naschvál motýľa poslala na opačnú stranu .	poslala	2	Part
Kvalifikovanú odpoveď na tuto otázku však budeme môcť priniesť až po dôkladnej komparácii s dobovými východnými právnymi pamiatkami .	môcť	7	Inf
“ Ako ste si mohli myslieť , že zvíťazíte nado mnou , nad Kráľovnou zla !	myslieť	5	Inf
Kolektívne postupovať nemôžeme .	postupovať	1	Inf
Takže ak sa myšlienky zorganizovať rockový festival chytí skúsenejší organizátor , veríme , že festival , ktorému je dedina a ľudia v nej naklonení , sa bude znova konať .	zorganizovať	4	Inf
Irma tak hovorievala od hnevu .	hovorievala	2	Part
Nepovedal som jej nič .	Nepovedal	0	Part
“ To všetko je veľmi pekné , ale to som nechcel počuť .	počuť	11	Inf
Čo spraví s dievčaťom , to rozhodne neskôr .	spraví	1	Fin
Môj zmätok bol úplný , keď ma vyzvala , aby som išiel dopredu .	išiel	11	Part
Chichúňali sme sa ako pojašení , prebehli sme cez trávnik a smerovali k múru .	prebehli	6	Part
Vtedy som si dovolil poznamenať , že aj ja si pamätám jej tvár .	poznamenať	4	Inf
Chcela by som sa na nej odviezť , “ povedala Makulienka .	Chcela	0	Part
Bol som šťastný ako blška , že sa jej nič nestalo .	nestalo	10	Part
“ Neviete , že vám piraňa za pár sekúd obžerie všetko mäso ? “	obžerie	9	Fin
Zničená som si prisahala , že si cez obedňajšiu prestávku zaplávam a budem trénovať obrátky dovtedy , kým ich nezvládnem .	trénovať	13	Inf
Chýbalo v ňom čokoľvek dvojzmyselné .	Chýbalo	0	Part
Terk bežala k lagúne a vytiahla Tarzana , ktorý sa poriadne napil vody .	bežala	1	Part
Vytrhal ľan a zviazal ho do snopu .	Vytrhal	0	Part
“ Počkaj , až ochutnáš Safiyinu špecialitu , “ nadšene vravel , keď sluhovia kládli na stôl ťažký strieborný podnos s polguľovitým vrchnákom .	Počkaj	1	Fin
“ Fajn , “ odvetil Chris , ale keď prechádzal okolo modelu , rozkrútil prstence Saturna .	odvetil	4	Part
Krásne Vianoce Vám prajem , priatelia .	prajem	3	Fin
Najskôr sa na hornej časti schodišťa objavila drobná starena v širokých nohaviciach .	objavila	6	Part
Prikázali mi , aby som bol na druhý deň okolo poludnia v hotelovej hale , odkiaľ pôjdeme do kostola na svadobný obrad .	pôjdeme	16	Fin
A poprosím ho , aby mi poskytol nejakú správu o Lori .	poprosím	1	Fin
Keď sa neskôr vracali domov a pozorovali hviezdy , vystrašil ich hrozný krik .	vracali	3	Part
Toto , spolu s predchádzajúcou svätoštefanskou právnou normou , dobre korešponduje s popisovaným výnimočným postavením uhorského kráľa v krajinskej cirkvi .	korešponduje	10	Fin
Piráti opäť začali spievať .	spievať	3	Inf
Hypnotizujúce oči civeli do jeho vlastných .	civeli	2	Part
Kto ste , spýtal som sa ich a cítil som , že začínam byť nervózny .	začínam	12	Fin
“ Už letím ! “ kričí Polly .	letím	2	Fin
Práve vtedy vošiel ráznym krokom guľatý pánko so špicatou briadkou .	vošiel	2	Part
Rovnako prekvapujúco dobre vedela rozprávať bez pohybovania perami .	vedela	3	Part
Vláda bude nasledovať tieto trendy .	nasledovať	2	Inf
Podišiel som k oknu .	Podišiel	0	Part
Mravce roztiahli plachtu a razom všetko stíchlo .	roztiahli	1	Part
“ Ďakujem , “ povedala Makulienka , “ ibaže neviem , čo mám robiť , aby drozd vrátil Emanuelovi cylinder . “	robiť	13	Inf
Čo sa týka vzťahov Novgorodcov a podmanených ugro ‐ fínskych plemien , formálne podriadené kmene si zachovávali značnú dávku nezávislosti .	týka	2	Fin
Usnul šepkajúc : " Zdravý rozum sa nedá zaznamenať štatisticky " a s pocitom , že táto jeho poznámka obsahuje hlbokú múdrosť .	zaznamenať	8	Inf
Usilujem sa počúvať , ale myslím pritom na Chrisa .	Usilujem	0	Fin
“ Ani ja nič nedostanem zadarmo , a teraz si tú háveď pekne odveď ! “	nedostanem	4	Fin
Mal dlhý kabát , zdvihnutý golier , okuliare so strieborným rámom , červenastú tvár a husté šedivé vlasy .	Mal	0	Part
“ Ak ti na mne naozaj záleží , tak mi nerob zle !	nerob	10	Fin
V období vzniku uhorskej cirkevnej organizácie problém , či si uhorský kráľ uzurpoval práva prináležiace Apoštolskému stolcu , ešte nehral rozhodujúcu úlohu .	uzurpoval	12	Part
Ihneď som spoznala zvuk maminho auta .	spoznala	2	Part
Cestou zoťali strom — budú ho potrebovať , ako baranidlo , keď budú chcieť vyvaliť bránu .	vyvaliť	14	Inf
Neprihovorím sa mu po taliansky .	Neprihovorím	0	Fin
Nebolo tajomstvom , že odoslané listy sa bežne otvárajú .	otvárajú	8	Fin
Zrazu začul akýsi zachrípnutý hlas .	začul	1	Part
Jestvuje len jeden a jediný spôsob , ako sa zachrániť .	zachrániť	9	Inf
Len spomedzi študentov náročnej školy vzídu študenti , ktorí sa dokážu presadiť v silnej konkurencii .	dokážu	10	Fin
“ A ďakujem , že ste tu zdržali to ľudské mláďa . “	ďakujem	2	Fin
Mestské zastupiteľstvo schválilo umiestnenie menších sôch šiestich patrónov Európy na Nádvorie Európy , ktoré je vo výstavbe .	schválilo	2	Part
Chcel vzlietnuť do vzduchu , ale zamotal sa do krídel fraku .	zamotal	6	Part
Nič lepšie robiť nemohol .	robiť	2	Inf
“ Ona si to o sebe myslí , “ zasmial sa Truhlík .	myslí	6	Fin
Snažím sa vidieť päť . "	vidieť	2	Inf
Dieťa prikývlo , akoby mu rozumelo .	rozumelo	5	Part
My vtedy vraciame sa domov	vraciame	2	Fin
Mňa zaujímame my . "	zaujímame	1	Fin
Mama sa poteší , pomyslel som si .	poteší	2	Fin
V poslednom čase ju Ministerstvo hojnosti veľmi obľubovalo .	obľubovalo	7	Part
A stiahol zlatý náprstok naspäť pod čiernu zem .	stiahol	1	Part
Ak Tichomirov vidí v povstaniach iba element sociálny , Frojanov na jeho úkor vyzdvihuje moment politický .	vyzdvihuje	13	Fin
“ Nazri do svojho srdca , ono ti povie , čo máš robiť . “	robiť	12	Inf
Zlá víla sa princovi Filipovi posmievala , no prezradila mu , že iba on môže zrušiť Zorničkinu kliatbu , ak ju pobozká .	zrušiť	15	Inf
Ja som zaujímal svoj výklenok , ona prichádzala po mne .	prichádzala	7	Part
“ Čo ? “ spýtala som sa .	spýtala	4	Part
“ Zbláznila si sa ?	Zbláznila	1	Part
Keď leteli nad potokom , vodná hladina sa pod nimi tak jagala , akoby do nej spadla hviezda .	leteli	1	Part
A obchody , ktoré chcú predávať zaručene čerstvý , v noci upečený a nezabalený chlieb , musia ho držať v osobitných zasklených policiach , takže skôr nebalenie chlieb zdražuje .	musia	16	Fin
A jeho želanie zostať v ten deň so mnou ma dojalo .	zostať	3	Inf
“ Prisahám na svoj včelí život , že môj kamarát stratil pri nehode vedomie a prebral sa iba zázrakom ! “	Prisahám	1	Fin
Baghíra sa popod fúzy usmial .	usmial	4	Part
Keď sedím pri stole aj keď som pred oltárom .	sedím	1	Fin
Myslím , že o sebe urobili veľmi pekný obraz , že aj Rómovia a deti z detského domova sa vedia správať na úrovni .	Myslím	0	Fin
Júlia tíško zapišťala , v jej hlase sa ozvalo prekvapenie .	zapišťala	2	Part
“ Letím náhodou okolo , “ zašveholila , “ a takmer som o vás zakopla . “	Letím	1	Fin
Pocítil som úprimnú potrebu plakať .	plakať	4	Inf
Nemohli sme k nej chodievať , ani ona nemohla chodievať k nám .	chodievať	9	Inf
Winston si tu nemusel objednávať nič .	objednávať	4	Inf
Keď to rozprával Maji , spozornela .	rozprával	2	Part
Potom prišli texty , ktoré som Deline nikdy neukázal .	prišli	1	Part
Sergej mi takisto povedal , že zatiaľ sa môžem ísť poprechádzať po Nevskom prospekte .	poprechádzať	10	Inf
Aladin však strčil nohu do dverí .	strčil	2	Part
S odporom hľadel na bielu masu pred sebou .	hľadel	2	Part
Po ľubečskom zjazde sa mesto napokon dostalo do Monomachových rúk .	dostalo	6	Part
Nedokážeme uspokojivo vysvetliť , prečo uhorský kráľ takto postupoval .	vysvetliť	2	Inf
Podarilo sa mu vyšklbnúť mu niekoľko pierok .	vyšklbnúť	3	Inf
„ Akže umierajú vaši ľudia , sú do neba vynášaní , akže naši , idú k našim do priepasti . . . “	umierajú	2	Fin
Nič také som neurobil .	neurobil	3	Part
Veď ho strhne do hlbočiny , pomyslela si Polly .	pomyslela	6	Part
Ale nevieš si predstaviť , kde som .	predstaviť	3	Inf
Spôsobuje mi najväčšie utrpenie .	Spôsobuje	0	Fin
Vilkova radosť z Majinej chvály sa topila ako ľad na slnku .	topila	6	Part
Vytvorí podmienky pre elektronický obchod a bude posilňovať dôveru verejnosti k elektronickému obchodovaniu .	Vytvorí	0	Fin
Zadnými nohami držal pavúka v šachu a prednými trhal sieť okolo napoly zadusenej Maji .	držal	2	Part
“ Chcete povedať , že som herec ? “ pýtal sa Pinocchio .	Chcete	1	Fin
Svorka sa vrhne za ním .	vrhne	2	Fin
Chris sa obrátil a zbadal , že naňho pozerám , akoby mi čítal myšlienky .	pozerám	8	Fin
Už sa nemôžem vrátiť .	vrátiť	3	Inf
Zastali sme na červenú a Chris sa na mňa usmial .	usmial	9	Part
Daňové zaťaženie sa bude presúvať z priamych daní na dane nepriame .	presúvať	4	Inf
Sadli si na rímsu a Maja zreteľne videla , čo sa dnu deje .	deje	12	Fin
“ Kráľ Louis , tak sa volám , to môže zariadiť .	zariadiť	10	Inf
Telefón zazvonil vo chvíli , keď som začal hľadať šach .	hľadať	8	Inf
Vendelín prikývol .	prikývol	1	Part
Chris sa držal vľavo , šiel v pruhu , ktorý rozhodne neviedol ku knižnici .	držal	2	Part
Nikdy nepočula o Bratstve a odmietala veriť v jeho existenciu .	nepočula	1	Part
“ Balú , ty žiješ ! “ zvolal Mauglí a hodil sa mu okolo krku .	Balú	1	Fin
“ Pochodujeme naprieč celým územím ! “	Pochodujeme	1	Fin
Zaľúbil som sa do nej akousi zvláštnou láskou , ktorá ma nepobádala písať verše , ako som ich písal pre Teutu .	písať	12	Inf
Žijem , slečna , povedal som .	Žijem	0	Fin
Mohla by sa ma pýtať na Lorinu svadbu a ja by som nevedel , čo jej povedať .	nevedel	12	Part
Jillina mama s otcom tam zamračení meravo sedeli , ako keby chceli silou vôle dotlačiť dcéru na stupienok víťazov .	dotlačiť	14	Inf
Do minúty zhorí na popol .	zhorí	2	Fin
Spomenul si , že sedí s drevenou bábkou , na ktorej zarobí milióny .	sedí	4	Fin
Záujemcov o šport poteší futbalový turnaj pre dospelých a jazda na koni pre deti .	poteší	3	Fin
Možno moje postavy vedia hrať šach .	hrať	4	Inf
“ Zastavte svet , nech sa prestane krútiť ! “ zvolal .	krútiť	7	Inf
Dieťa vie čítať až vtedy , keď text pochopí .	čítať	2	Inf
Vláda zvýši administratívnu kapacitu v oblasti regionálnej politiky .	zvýši	1	Fin
“ Vieš , musím chvíľu popremýšľať , “ povedal Káa .	popremýšľať	5	Inf
“ Zato by som ti mal odhryznúť hlavu , maličká ! “ zreval rozzúrený sršeň .	odhryznúť	6	Inf
Zrazu sa strhol .	strhol	2	Part
Jediný , kto mohol niečo také urobiť , bol Tom .	urobiť	6	Inf
Nemala som nijaký dôvod namietať .	namietať	4	Inf
Sedel na stoličke neprirodzene vzpriamene a jeho mocné prsia sa nadúvali a zachvievali , akoby mal čeliť nárazu vlny .	zachvievali	12	Part
Jej fyzická prítomnosť stačila , aby sa pohlo zviera , ktoré sa vo mne skrývalo .	stačila	3	Part
Potom sa mi Marga postupne prestala posmievať .	posmievať	6	Inf
Ako kráčal k dverám , mince v mešci príjemne zacinkali .	zacinkali	9	Part
" Nezabil som ju .	Nezabil	1	Part
Teraz sa chvíľu bavme o tebe . “	bavme	3	Fin
Vláda bude klásť dôraz na racionalizáciu nákladov spojených s realizáciou výkonov vo verejnom záujme v železničnej osobnej doprave a verejnej autobusovej doprave .	klásť	2	Inf
Za jeho stiahnutými mihalnicami sa pohyboval celý les prstov v akomsi tanci , vykrúcal sa a skrúcal , strácal sa jeden za druhým a znova sa objavoval .	vykrúcal	13	Part
V ten večer sa v paláci zhromaždili všetci dvorania , keď princezná Zornička tancovala s princom Filipom .	tancovala	13	Part
Tvoj biceps by som obopol palcom a ukazovákom .	obopol	4	Part
Skupina kánonov I . ostrihomskej synody sa venuje stanoveniu obsahu bohoslužieb a príbuzným kultovým predpisom .	venuje	7	Fin
Prepáčila by mi to , aj keby vedela , že som to odkladala kvôli nočnému astronomickému klubu s Chrisom ?	Prepáčila	0	Part
Volala sa Dolora .	Volala	0	Part
Neotáľa a vylezie na strom .	vylezie	2	Fin
“ Predstavujem si , ako prekonávam krajský rekord v prsiach , “ vysvetľoval mi .	Predstavujem	1	Fin
“ No , dovoľte ! “ zvolal chrobák a ukázal svaly .	dovoľte	3	Fin
Maja tomu nechcela veriť .	veriť	3	Inf
Na schodišti som mal opäť zvláštny pocit , že ma niekto sleduje , a znova som rýchlym pohybom otočil hlavu , akoby som ho chcel nečakane prekvapiť .	prekvapiť	26	Inf
Keď som chcel vypnúť televízor , na obrazovke sa objavila žena .	vypnúť	3	Inf
Musím sa na ňu vrhnúť .	vrhnúť	4	Inf
Chcel som poprosiť aj redaktorku , aby už nevyužívala repliky mojich postáv .	poprosiť	2	Inf
Veľmi sa na ňu podobáš .	podobáš	4	Fin
“ Takže týmto ťa odmietam . “	odmietam	4	Fin
“ Ty rád vyjednávaš , “ povedal Herkules .	vyjednávaš	3	Fin
Uvidíte , nabudúce prídem za vami zas !	prídem	3	Fin
Nebojme sa klásť otázky , pýtať sa a odpovede hľadať v Písme .	pýtať	5	Inf
Vyslovil som výraz „ neskutočný “ , povedal som nervózne .	povedal	7	Part
Vláda bude podporovať programy v horších pôdnych a klimatických podmienkach a orientovať sa na mimoprodukčné funkcie poľnohospodárstva a agroturistiky .	orientovať	11	Inf
Vláda vytvorí podmienky pre uskutočnenie úspešného referenda o vstupe do EÚ , ktoré bude dokumentovať udržanie širokej podpory verejnosti tomuto historickému kroku .	dokumentovať	14	Inf
Na niektorých uliciach metropoly sa matky ani na chvíľku neodvážia nechať svoje bábätká samotné .	neodvážia	9	Fin
Môj mozog zatiaľ začínal špekulovať .	špekulovať	4	Inf
“ Musíš vyslať signál , “ hovorieva mi .	vyslať	2	Inf
Počul , ako Júlia zaťala zuby . " Asi by sme sa mali rozlúčiť , " poznamenal .	rozlúčiť	13	Inf
Prečo existuje láska ?	existuje	1	Fin
Netrvalo dlho , a policajti prišli do kaviarne zatknúť zlodeja .	zatknúť	8	Inf
Rick na chvíľu prestal písať .	písať	4	Inf
A tu či inde sa v úplnej tajnosti nachádzali riadiace mozgy , ktoré koordinovali toto úsilie a určovali politickú líniu : rozhodovali o tom , že tento fragment minulosti sa zachová , tento sa sfalšuje a ďalší prestane jestvovať .	zachová	30	Fin
Odišla som preč , nechala som ho tam .	Odišla	0	Part
„ Viera môže dávať človeku životnú istotu “ , mieni profesor Ďurovič .	mieni	9	Fin
Maja sa rozhodla , že zasa zaletí do ľudského obydlia .	zaletí	6	Fin
Keď sme vychádzali z izby , že pôjdeme k autu , uvidel som vec , ktorá zvrátila ten večer nepredvídaným smerom .	vychádzali	2	Part
Dokážem dobre vytipovať nezaradených ľudí .	vytipovať	2	Inf
Za pôvodcu Otovej politiky Renovatia , ako aj jeho politiky voči krajinám ležiacim na východ od ríšskych hraníc sa pokladá Gerbert z Aurillacu .	pokladá	19	Fin
Bolo sivé popoludnie s oblohou veštiacou sneh , keď sa človeka zmocňuje ubíjajúca otupnosť a uvoľnenie prináša len alkohol .	prináša	16	Fin
Chcem rozpovedať istý príbeh , a nechtiac ho zamotávam .	Chcem	0	Fin
Potom sa v jednej zákrute objavil ďalší stôl , za ktorým sedeli ďalšie dve ženy .	sedeli	11	Part
“ Nemôžeš mi nič zakazovať !	zakazovať	4	Inf
Ako možno komunikovať s budúcnosťou ?	komunikovať	2	Inf
Rozhodol sa letieť za nimi a za trest , že naňho zabudli , vzal so sebou všetkých susedov .	vzal	13	Part
Vláda sprehľadní pravidlá dotačnej politiky a zároveň dokončí realizáciu schválenej licenčnej politiky .	sprehľadní	1	Fin
Myslela som na jeho hlboké hnedé oči .	Myslela	0	Part
Skĺzla som z dosky a ponorila sa .	Skĺzla	0	Part
Mauglí chcel Káaovi veriť .	veriť	3	Inf
Možno ich nevidel .	nevidel	2	Part
Snažil sa vyliezť po steble trávy hore , ale steblo sa pod jeho váhou nebezpečne naklonilo nabok .	vyliezť	2	Inf
Winston zdvihol šálku džinu , chvíľku naberal odvahu a potom obrátil do seba to tekuté svinstvo , ktoré malo pachuť oleja .	zdvihol	1	Part
“ Tak dobre , “ vraví .	vraví	5	Fin
Makovej lúky sa totiž chceli zmocniť lúpežné mravce .	zmocniť	5	Inf
Winston sa začal obliekať pomalými , strnulými pohybmi .	obliekať	3	Inf
Nezáleží na tom , čo povieš či urobíš ; záleží jedine na tom , čo cítiš .	Nezáleží	0	Fin
Odtrhol rožtek balíčka .	Odtrhol	0	Part
“ Samozrejme , “ povedala som a chytila ho za ruku .	chytila	7	Part
Rovnakého problému sa týka i posledný z ostrihomských kánonov , ktorý sa venuje vlastnému ordinačnému právu .	venuje	12	Fin
Tú ženu som vôbec nepoznal .	nepoznal	4	Part
“ Asi mám , “ odvetil Chris a pokračoval v kreslení .	mám	2	Fin
“ A ty si mu to veľmi neuľahčil . “	neuľahčil	7	Part
Veľký brat je zovňajšok , v ktorom sa Strana ráči ukazovať svetu .	ukazovať	10	Inf
Zhlboka sa nadýchla , poriadne si vydrhla predné nohy a ostala nehybne sedieť na liste ako prikovaná .	sedieť	12	Inf
Krman si bol vedomý , že meno Slovákov treba aj v latinčine odlišovať od všeobecného názvu slavi a vytvoril nové slovo slovacii .	odlišovať	12	Inf
Dodala , že aj ja sa jej páčim .	páčim	7	Fin
Zavolajte a rezervujte .	rezervujte	2	Fin
Mauglí pokrútil hlavou a chytil sa neďalekého stromčeka .	chytil	4	Part
“ Ja si počkám , “ odmietla .	počkám	3	Fin
Bohužiaľ , vzali si z nich príklad všetky deti a tiež sa chceli hrať v odpadovej jame .	hrať	13	Inf
Do sklenej nádoby , v ktorej varila zázračný nápoj , pridávala čarovné prísady , a pritom čítala .	pridávala	10	Part
Abu sledoval , kam pozerá , a zbadal dievča .	pozerá	4	Fin
Sú tu správy !	Sú	0	Fin
Ak chce Kalif vedieť toto , tak dobre .	vedieť	3	Inf
“ Čo mi nesieš , Emanuel ? “ vypytovalo sa slniečko .	nesieš	3	Fin
Nijaká dvojica nevstávala , že pôjde tancovať , plač toho dievčaťa pokazil atmosféru .	tancovať	6	Inf
A Vilka chceli vziať ako rukojemníka .	vziať	3	Inf
“ Zaplať ? “	Zaplať	1	Fin
Už dávno sa s nimi nehrám , ale ani vo sne by mi nenapadlo , aby som ich vyhodila .	vyhodila	18	Part
V izbe podo mnou spával Profesor , oddeľovala nás iba tenká dosková podlaha .	spával	4	Part
“ Buď ho pomôžeš nájsť , alebo ja prevezmem velenie ! “	prevezmem	8	Fin
“ Strachopud , “ nafučala sa , ale pretože bola zvedavá , spomalila .	spomalila	12	Part
“ Myslela som , že robíš v El Rancho , “ vyhŕkla som bez rozmyslu .	robíš	5	Fin
„ Viera môže dávať človeku životnú istotu “ , mieni profesor Ďurovič .	dávať	3	Inf
“ Prestaň stínať hlavy , “ radil mu Fil .	Prestaň	1	Fin
Odporná extáza strachu a pomstychtivosti , túžba zabíjať , mučiť , drúzgať tváre kováčskym mlátom akoby preskočila sťa elektrický prúd na všetkých a premenila každého aj proti jeho vôli na vrieskajúceho pomätenca s pokrivenou tvárou .	mučiť	9	Inf
Čo iné im ostávalo , museli prestať s hašterením a začať odčerpávať vodu .	prestať	6	Inf
Vláda uskutoční revíziu úradov , pripraví zmeny v pracovno - právnej legislatíve a uskutoční reorganizáciu štátnej správy .	uskutoční	1	Fin
Oznamuje východ slnka a prebúdza zo spánku . .	prebúdza	4	Fin
Zmeravela som , keď na druhý deň Chris meškal celých desať minút na hodinu astronómie .	meškal	8	Part
Je to kúsok histórie , ktorú zabudli zmeniť .	zmeniť	7	Inf
Asistovali im naše sestry , ktoré v zariadení pracujú .	pracujú	8	Fin
Stiahol som sa , aby mohla prejsť .	prejsť	6	Inf
“ A s kým by som sa mal rozprávať ? “	rozprávať	8	Inf
Každý pokus o systematizáciu tejto otázky totiž nevyhnutne naráža na kolíziu metódy vedeckého prístupu s rozumovo nedefinovateľným fenoménom náboženstva a viery .	naráža	8	Fin
“ Človek nikdy nevie , čo ako vypáli . “	nevie	3	Fin
Chcel som povedať tým civilistom , aby mi aspoň vysvetlili , čo odo mňa chcú .	povedať	2	Inf
A vyhrávam .	vyhrávam	1	Fin
Veštkyňa uprene hľadela do sklenej gule .	hľadela	2	Part
Moja mama sa mi naozaj snaží vyjsť v ústrety .	vyjsť	6	Inf
Keď videl , ako sa bavia , hneď sa chcel pridať .	videl	1	Part
“ Možno sa zajtra vrátim , keď budem mať peniaze , aby ste mi o ňom povedali viac . “	mať	8	Inf
Nedokázala som urobiť jedinú slušnú obrátku .	urobiť	2	Inf
Vláda bude realizovať opatrenia zamerané na zvýšenie efektívnosti využívania verejných zdrojov .	realizovať	2	Inf
Winston si prečítal nevhodný článok .	prečítal	2	Part
Pošli ďalej !	Pošli	0	Fin
Vo Zvedoch som robila vedúcu oddielu .	robila	3	Part
Najskôr ma začal vzrušovať dotyk jej rúk .	vzrušovať	3	Inf
“ Ricka zaujímajú vážne veci , “ namietla Blythe .	zaujímajú	2	Fin
Keď sa o tom dozvie , usporiada slávnostný obed .	usporiada	6	Fin
“ Ty nemôžeš žiť !	žiť	3	Inf
Húf mojich postáv i muž , ktorý mi radil , aby som pohol mozgom , zmizli .	radil	8	Part
Bratovi farárovi prajeme v tejto funkcii múdrosť , vytrvalosť a Božie vedenie .	prajeme	2	Fin
Niekto zo susedov si mohol všimnúť , že som bol preč , mohol by sa ma zvedavo vypytovať , kde som bol , a to by stačilo , aby sa som sa rozčúlil .	vypytovať	17	Inf
Nákladné autá ešte stále prechádzali okolo a ľudia ešte stále na ne hladovo civeli .	civeli	13	Part
“ Musím si to prečítať odznova , “ povedala som , zúfalo listujúc v učebnici .	prečítať	4	Inf
Musím vymyslieť nejakú tajnú skrýšu , kam ťa cez deň ukryjem .	Musím	0	Fin
Soni nedodržala našu dohodu , nenapísala nič .	nedodržala	1	Part
Nakukol pomedzi húštinu a uvidel troch tvorov v šatách namiesto kožušiny .	Nakukol	0	Part
Ani družka , ani sok ho nesledujú . Čo ho núti vysedávať na konári osamoteného stromu a vyludzovať hudbu do prázdna ?	vyludzovať	17	Inf
Keď videl , ako sa bavia , hneď sa chcel pridať .	bavia	5	Fin
Keď ich neskôr Fil dohonil , zúril ako pominutý .	zúril	6	Part
Nenamietam ani teraz .	Nenamietam	0	Fin
“ Musím sa učiť . “	učiť	3	Inf
Už dávno dostal prezývku podľa starovekého filozofa a už dávno si nikto nepamätal , ako sa skutočne volá .	volá	17	Fin
Sľubujem , že všetko preberieme , “ presviedčal ma Chris .	Sľubujem	0	Fin
Pre svoju krátkosť a úryvkovitosť sa nedajú podrobiť podrobnejšej analýze .	nedajú	6	Fin
Sadol si na zem a povedal : “ Tak čo mám teda robiť ? “	robiť	12	Inf
Jediným uznávaným zmyslom manželstva bolo splodiť deti , ktoré mali slúžiť Strane .	splodiť	5	Inf
“ Tu niekde mám bundu , “ zamrmlal .	mám	3	Fin
„ Nebyť toho , Slovensko by dnes neexistovalo , “ hovorí Ľubomír Ďurovič .	Nebyť	1	Inf
Ďakujte Hospodinu , lebo je dobrý , lebo naveky trvá jeho milosť .	Ďakujte	0	Fin
“ Neviem , “ pripustila Jazmína .	pripustila	4	Part
Usmiala som sa na Chrisa .	Usmiala	0	Part
“ Pusť ma !	Pusť	1	Fin
Videl , že chce niečo povedať .	chce	3	Fin
“ Ako môžete také niečo povedať ! “ vyhŕkla Maja .	povedať	5	Inf
Pritisol som ich k sebe .	Pritisol	0	Part
Dozvedel som sa a stále tomu neviem uveriť .	neviem	6	Fin
" Asi by som to vydržal , nebyť jednej veci , " povedal .	nebyť	7	Inf
Vystúpenie veľkého množstva jeho bojových oddielov sa dalo chápať i ako pohanský nepokoj — prežitky predkresťanskej viery sa u Estóncov udržali neobvykle dlho .	dalo	7	Part
Netrvalo dlho a nad jaskynkou sa zachvel list , spod ktorého vyliezol prečudesný chrobák .	vyliezol	11	Part
“ Viem , čo chceš urobiť . “	Viem	1	Fin
Podchvíľou naňho ukradomky pozriem bez toho , aby som pohla hlavou .	pozriem	3	Fin
Nôž by mal minimálne obsahovať : veľkú a malú čepeľ , otvárač na fľaše a konzervy , rydlo , výhodné je , ak obsahuje dierovač , pílku na drevo , vývrtku , pinzetu .	obsahovať	4	Inf
Maja od radosti až poskočila .	poskočila	4	Part
Nemajú čas ani myseľ na spory , ktoré by mohli vyplynúť z ich odlišných vyznaní .	vyplynúť	10	Inf
Slovenská republika sa zapojí do snáh medzinárodného spoločenstva zameraných na riešenie globálnych problémov , ako sú boj proti organizovanému zločinu , medzinárodný terorizmus , ekologické riziká .	zapojí	3	Fin
Obraciame ho , zmocňujeme sa jeho myslenia , pretvárame ho .	zmocňujeme	3	Fin
Mala som pocit , že potrebujem vypadnúť na čerstvý vzduch .	Mala	0	Part
Nebolo tajomstvom , že odoslané listy sa bežne otvárajú .	otvárajú	8	Fin
I ja mám občas dojem , že môj život riadia mamine nesplnené sny .	riadia	9	Fin
Napriek tomu ma niečo začalo znepokojovať .	začalo	4	Part
Neverím , že by sme mohli niečo zmeniť za nášho života .	zmeniť	7	Inf
Ten , ktorý pod jagavosť tém hodnú bestsellerov rozostavil pasce , v ktorých uviazol sám .	rozostavil	8	Part
Neodolala som .	Neodolala	0	Part
“ Nebyť mňa , nebol by si tu ! “	Nebyť	1	Inf
Nemal najmenšie pokušenie jej klamať .	klamať	4	Inf
Protiprávna vojna v Iraku , ktorú rozpútala nesvätá aliancia náboženských fundamentalistov , megalománov a kšeftárov , je cynickým výsmechom všetkých hodnôt , ktoré naša západná civilizácia pokladá za nedotknuteľné .	pokladá	26	Fin
Na tomto mieste spomeniem dva Sonine domnelé nedostatky .	spomeniem	3	Fin
Nečudujem sa , že výborne urobil záverečné ročníkové testy .	Nečudujem	0	Fin
Ak im dovolíme , aby na nás zaútočili zo všetkých strán , nikdy sa neubránime .	neubránime	14	Fin
“ Napríklad na nej chodiť , “ napadlo Maji a hneď si to vyskúšala .	chodiť	4	Inf
Navrhli im , že ak chcú prežiť v nových podmienkach trhového hospodárstva , môžu predávať po tiranských chodníkoch cigarety alebo banány .	prežiť	6	Inf
“ Nesmieš sa udrieť , nesmieš sa udrieť , nesmieš sa udrieť .	udrieť	7	Inf
Nedokázal premôcť nápor paniky .	Nedokázal	0	Part
Sultán si vzdychol .	vzdychol	2	Part
“ A to hovoríš ty ! “ zvolala som .	hovoríš	3	Fin
Maja sa rozhodla bojovať .	bojovať	3	Inf
Reklama nás každý deň bombarduje rôznymi výzvami , sľubuje bohatstvo , zdravie a úspech .	sľubuje	8	Fin
Táto povinnosť sa však nevzťahovala na produkty , ktoré sa jednak priamo a jednak symbolicky týkali základných prejavov kresťanského kultu .	nevzťahovala	4	Part
Ekonomická i politická moc sa dostáva z rúk starej aristokracie do rúk novej buržoázie a literatúra sa usiluje vyhovieť potrebám novej vládnúcej vrstvy .	vyhovieť	18	Inf
Prešmykla sa okolo Kasandry a vonku sa nadýchla čerstvého vzduchu .	nadýchla	7	Part
Čoskoro som však zapochybovala o svojom odhodlaní , lebo pred školou ma dobehol Chris a chytil za ruku .	dobehol	12	Part
Najzaujímavejšie bolo sledovať Profesora večer .	sledovať	2	Inf
Prikázal dopravnej čate , aby ju premiestnila , ale keďže bola veľmi ťažká , robotníci ju občas postavili na zem .	premiestnila	6	Part
“ Ešte si to rozmyslím , “ zahučal obor , ale už sa knísal nepriateľovi v ústrety .	zahučal	7	Part
Žiaľ , bol priťažký , lebo maškrtil kandizované datle .	maškrtil	6	Part
Na lúke vrcholili prípravy na dožinkovú slávnosť .	vrcholili	2	Part
Vláda bude presadzovať takú reformu Ozbrojených síl Slovenskej republiky , ktorá bude najefektívnejšie zabezpečovať ochranu pred možným ohrozením nášho štátu a jeho občanov .	zabezpečovať	13	Inf
Vláda bude požadovať zvýšenie finančnej disciplíny a tvrdé rozpočtové obmedzenie .	požadovať	2	Inf
Začiatkom 11 storočia bolo pomerne málo významným sídlom — nespomína sa napr . pri delení údelov Vladimírovým synom .	nespomína	9	Fin
Pinta je predsa polovica štvrtky a štyri štvrtky idú do galóna .	idú	8	Fin
“ Môžeš ho pustiť . “	pustiť	3	Inf
Nevdojak som sa poobzeral , či neuvidím Háda .	neuvidím	6	Fin
Nové , moderné pedagogické postupy v mnohých oblastiach zlyhávajú .	zlyhávajú	8	Fin
Musíme uznať , že rok 2004 bude významný pre 10 európskych štátov .	uznať	1	Inf
" Vybudovať civilizáciu na strachu , nenávisti a krutosti nemožno .	Vybudovať	1	Inf
Ten názov si prevzal z jednej Čechovovej poviedky , povedala mi .	prevzal	3	Part
Všetky formality vytrvalo vybavila naša kurátorka Justína Petrová , ktorá v tomto smere nepozná prekážky .	vybavila	3	Part
Poradil jej : “ Zajtra ráno na telocviku sa postav do posledného radu a potom zmizni . “	postav	9	Fin
Nemohla som pochopiť , ako to zo mňa vyletelo .	pochopiť	2	Inf
Neveríme princípom angsocu .	Neveríme	0	Fin
Napokon vstal , tackavo a hojdavo prešiel celou , hlboko ponoril ruku do vrecka na kombinéze a s rozpačitým výrazom podal mužovi s umrlčou tvárou ufúľaný kúsok chleba .	podal	20	Part
Nimi sa budeme zaoberať podrobnejšie .	zaoberať	3	Inf
“ Nejdem ! “ odvrkol Mauglí .	Nejdem	1	Fin
“ Radšej padajme . “	padajme	2	Fin
Čosi podobné nariaďujú i uhorské právne normy .	nariaďujú	2	Fin
Ja ich poznám .	poznám	2	Fin
Vláda prehodnotí systém výkonu správy súdov , ktorý príliš zaťažuje sudcov administratívnymi činnosťami , osobitne pri štátnej správe jednotlivých súdov .	prehodnotí	1	Fin
Podporíme intenzívnu ekonomickú poľnohospodársku výrobu .	Podporíme	0	Fin
“ Tá farba naozaj pripomína požiarnické auto . “	pripomína	4	Fin
Hádes nemohol pokojne spávať , kým sa nepresvedčil , že tvoj otec je mŕtvy .	spávať	3	Inf
Vždy som naznačil strelu a obe lopty som poslal do jeho protipohybu . "	naznačil	2	Part
“ Tentoraz by sme mali hudbu vynechať a usporiadať maratónsky beh , “ navrhol Rudko a všetci nadšene súhlasili .	usporiadať	8	Inf
Ja tomu len verím . Viem , že raz padnete .	Viem	5	Fin
Vláda pripraví program zameraný na ekonomický rozvoj , v rámci tohto programu vypracuje podprogramy pre jednotlivé sektory .	pripraví	1	Fin
Chceli si chvíľu odpočinúť .	odpočinúť	3	Inf
Poďakovala som sa mu , keď mi kúsok podal .	Poďakovala	0	Part
Dnes meškáš , povedala , bála som sa , že neprídeš .	neprídeš	10	Fin
Nechcem nič konkrétne .	Nechcem	0	Fin
Ale ona nezdvihla zrak .	nezdvihla	2	Part
Maja s úžasom obdivovala jeho veľké krídla s červeným vzorom .	obdivovala	3	Part
Neprezradila som jej , o čom sme sa rozprávali s Rickom , bála som sa , že sa nazúri , ak zistí , že som sa ich snažila dať dokopy .	dať	28	Inf
Počul , ako sľubuje klamať , kradnúť , falšovať , vraždiť , rozširovať drogy , prostitúciu , a pohlavné choroby , liať deťom vitriol do tváre .	vraždiť	10	Inf
“ Bude tam titulok : Slávna rekordérka fotografuje reportérov , “ povedala Blythe .	Bude	1	Fin
Od tejto chvíle si môžete ľubovoľne vytvárať fotoalbumy s neobmedzeným počtom fotiek .	vytvárať	6	Inf
Povedala mi , že užíva antikoncepčné tabletky .	Povedala	0	Part
Nemala som najmenšiu chuť rozoberať pred ním svoje zmätené pocity a zbabraný test .	rozoberať	4	Inf
" Len preto , že uprednostňujem klad pred záporom .	uprednostňujem	5	Fin
Mohli si nás všimnúť a vyjavene sa na nás dívať .	dívať	9	Inf
Vždy mu odporovala , keď povedal niečo podobné .	odporovala	2	Part
Spolu s ním ma objala aj Irma a obidvaja sa rozvzlykali .	rozvzlykali	10	Part
Povedal si , že môžem ostať s tebou . “	ostať	5	Inf
Herkules sa snažil využiť svoju neuveriteľnú silu a pomáhať .	pomáhať	8	Inf
Urazený som sa ho pokúšal presvedčiť , že neklamem .	presvedčiť	5	Inf
Obraciame ho , zmocňujeme sa jeho myslenia , pretvárame ho .	pretvárame	8	Fin
Napla svaly na nohách , vystrela plecia , pozbierala odvahu a slabo sa na mňa usmiala .	pozbierala	8	Part
Kaťa mi nedovolila pobozkať ju na pery .	pobozkať	3	Inf
“ Páliš ? “ spýtal sa opatrne bodliak .	spýtal	4	Part
Vlak bol plný proletov so sviatočnou náladou , ktorú v každom vyvolávalo letné počasie .	vyvolávalo	11	Part
Nemal som dôvod zapierať .	zapierať	3	Inf
“ Máte Baghírovo slovo , “ dodal .	Máte	1	Fin
Vystúpenie veľkého množstva jeho bojových oddielov sa dalo chápať i ako pohanský nepokoj — prežitky predkresťanskej viery sa u Estóncov udržali neobvykle dlho .	chápať	8	Inf
Brúsil si na nás zubiská a najradšej by nás zhltol ako malinu .	zhltol	9	Part
Vychrlila tie otázky tak rýchlo , že som nestačila reagovať .	reagovať	9	Inf
“ Myslím to vážne , “ povedal a začervenal sa .	začervenal	8	Part
V škole ich privítala pani učiteľka .	privítala	3	Part
Sporenie prostredníctvom individuálnych účtov vytvorí priestor , aby v budúcnosti o čase svojho odchodu do dôchodku mohol rozhodovať sám občan .	vytvorí	4	Fin
Pravovernosť znamená nemyslieť -- nepotrebovať myslieť .	nemyslieť	2	Inf
Nezískala ho ani Matica , ani občianske združenie Komorra a nedarí sa to ani gymnáziu .	nedarí	10	Fin
Škriatok , ktorý opustí kvet , má zázračnú moc .	opustí	3	Fin
A neutekala som otvoriť .	otvoriť	3	Inf
“ Nemôžem , “ čo znamenalo , že ho nemôžem pozvať dnu , a nie bozkávať sa .	bozkávať	15	Inf
Tarzanova najlepšia priateľka Terk ho prišla zachrániť .	zachrániť	6	Inf
S cieľom vyhľadávať námety pre kritiku .	vyhľadávať	2	Inf
Pretekáme s tromi dobrými plavkyňami z Octilla , a mňa tu deptá vlastná kolegyňa .	Pretekáme	0	Fin
Jednoznačne ide o účelovú mystifikáciu s cieľom zmanipulovať konanie bežného občana a obrať ho o posledné základné životné istoty .	zmanipulovať	7	Inf
Jazmína sa zhlboka nadýchla .	nadýchla	3	Part
Makovica zatriasla hlavou .	zatriasla	1	Part
Stiahli si zo seba šaty a vliezli do mohutnej mahagónovej postele .	vliezli	6	Part
Opatrne som vstala , aby som ju nezobudila a išla som vypnúť televízor .	vypnúť	11	Inf
“ Môjmu kráľovskému uchu sa donieslo , že chceš ostať v džungli . “	chceš	8	Fin
Hroby majú vedľa seba a mama ma kedysi brávala každú nedeľu so sebou zapáliť im sviečky .	zapáliť	13	Inf
Mali sme sa zaradiť na miesta , aby sme začali s tréningom .	zaradiť	3	Inf
Skry sa ! “ zvolala som a zatiahla Chrisa pod oleander .	zatiahla	7	Part
Dolorina tvár , ktorá bývala obyčajne bledá , zbledla ešte viac .	zbledla	8	Part
Bol som náchylný veriť vo veľké veci .	veriť	3	Inf
“ Chceš si to vyskúšať ?	vyskúšať	4	Inf
Neviditeľní jazdci na koňoch sú vyjadrením predstavy o zlých duchoch , schopných ubližovať človeku odnesením jeho duše do podsvetia .	ubližovať	12	Inf
Maja s Vilkom sa rozleteli za húsenicou a požiadali ju o pomoc .	rozleteli	4	Part
Prikývol a naozaj , spočiatku šiel krokom .	šiel	5	Part
Chceli zistiť , čo sa deje .	zistiť	1	Inf
Kolos , ktorý celkom ovládol svet !	ovládol	4	Part
Bez problémov našiel moje pery , akoby dôverne poznal moju tvár .	poznal	8	Part
Syreeta vyvesila oznam o Abuovom úteku a kto ho nájde , dostane odmenu .	dostane	11	Fin
" Ste pripravení vraždiť ? "	vraždiť	3	Inf
Abu zakašlal .	zakašlal	1	Part
Nado mnou sa ukladá tisícročná náplava .	ukladá	3	Fin
Strojene sa usmial .	usmial	2	Part
Nad lúkou sa zotmelo a svetojánske mušky sa museli postarať o osvetlenie ihriska .	postarať	9	Inf
“ Nádherne ti pristane k vlasom , “ dodala Blythe .	pristane	3	Fin
Prichádzali sme zozadu , a tak sme sa vyhli autobusom , autám a nápisom nad vstupom .	vyhli	8	Part
" Niekedy , " poznamenala , " pohrozia človeku niečím -- niečím , čomu nedokáže vzdorovať , na čo nedokáže ani pomyslieť .	pomyslieť	21	Inf
“ Nemôžem to počúvať ! “ zamrmlala som a pohodlne sa oprela .	Nemôžem	1	Fin
Bolesť opäť ustúpila .	ustúpila	2	Part
Jediná nádej , že ju uvidím , bola virtuálna , závisela od toho , či sa rozhodne trápiť ma vo sne .	trápiť	17	Inf
Navoskované hlavičky zápaliek chránia pred namočením .	chránia	3	Fin
“ Nikdy nevystúpim na Olymp , “ vravel Filovi .	vravel	7	Part
Položil Winstona na lôžko .	Položil	0	Part
Stala si na kameň a začala vrzúkať .	vrzúkať	6	Inf
Buď som nečakal , že mi do toho zasiahne , alebo mal vo svojom výzore i držaní tela stále čosi neprirodzené , čo ma znepokojovalo a zároveň uvádzalo do rozpakov .	znepokojovalo	24	Part
Píše Lize , pomyslel som si .	pomyslel	3	Part
“ Gól ! “ natešne kričí a pyšne sa obzerá .	kričí	5	Fin
“ Ty chceš ísť na túru ? “ spýtala som sa a pozrela na hodinky .	chceš	2	Fin
Ale mozog mi nefungoval .	nefungoval	3	Part
Neodvážil som sa jej nič povedať .	povedať	5	Inf
Dokážem dobre vytipovať nezaradených ľudí .	vytipovať	2	Inf
“ Chcete povedať , že som herec ? “ pýtal sa Pinocchio .	povedať	2	Inf
Postrehla , že má akési čudné topánky , vraj ešte nikdy predtým také topánky nevidela .	Postrehla	0	Part
Svetové ríše , silné krajiny , politické systémy vznikajú a zanikajú , nič netrvá večne .	vznikajú	8	Fin
Vláda bude zvyšovať prostriedky na vzdelávanie , aby sa postupne priblížili priemernej hodnote podielu z HDP v krajinách EÚ .	zvyšovať	2	Inf
“ Máš právo sa na mňa hnevať .	hnevať	6	Inf
Tentoraz oveľa viac sníval a vždy to boli príjemné sny .	sníval	3	Part
Vláda sa zaväzuje v praxi realizovať už schválenú dikciu Európskej charty regionálnych alebo menšinových jazykov .	realizovať	5	Inf
Akoby stratila akéhokoľvek ducha .	stratila	1	Part
Vedela , že nemôže strácať čas .	strácať	4	Inf
Všade snorí polícia !	snorí	1	Fin
“ Daj im pokoj ! “ skríkol Aladin .	Daj	1	Fin
Spomenula si na ďatla , a tak zaletela poňho .	zaletela	7	Part
Snažila sa premáhať slzy .	premáhať	2	Inf
Napriek všetkému Delina nevenuje tomuto človeku pozornosť .	nevenuje	3	Fin
Nemal som dôvod zapierať .	Nemal	0	Part
Zvedavo zdvihol hlavu a pýta sa : “ Zdá sa , že ma poznáte ?	pýta	4	Fin
Volám sa Jurko .	Volám	0	Fin
Nakoniec ma chcela privítať .	chcela	2	Part
Povedala , že sa volá Liza .	volá	4	Fin
Ostanem opäť pri ponuke Trek sportu .	Ostanem	0	Fin
Nemôžem pritom nespomenúť ešte jednu vec .	nespomenúť	2	Inf
Aha , čo to visí na šnúre ?	visí	4	Fin
Už tretíkrát sme sa mohli stretnúť na neformálnej úrovni a prebrať pálčivé problémy , s ktorými sa stretávame na chodbách našej školy .	stretnúť	5	Inf
Zostal som stáť , ani som sa nepohol .	stáť	2	Inf
Veselo sa prechádzali medzi hosťami , usmievali sa a povzbudzovali ich , aby sa u nich cítili ako doma .	prechádzali	2	Part
Až do Petrohradu som sa pokúšal spať .	spať	6	Inf
“ Ty ideš okamžite do osady , “ odvetil Baghíra .	ideš	2	Fin
Prof . H . Bindera už niekoľko rokov oslovuje biblický príbeh o vzkriesení Lazára .	oslovuje	8	Fin
Ferdo z toho usúdil , že bývalí otrokári nevedia ani písať .	písať	10	Inf
Keď však Winston opravoval pôvodný plán , znížil číslo na 57 miliónov , aby vyhovel bežným požiadavkám na prekročenie kvóty .	vyhovel	14	Part
V tom polosvite som mal všetky dôvody myslieť si , že tam trčím zbytočne , aj keď človek , na ktorého som čakal , sa nevolal Godot .	nevolal	25	Part
Keď je tak , nebudem nič oznamovať . “	oznamovať	6	Inf
Aladina raz z Rahimovho obchodu vyhnali , keď sa Abu usiloval chvostom potiahnuť trs banánov .	vyhnali	5	Part
Jazmína pozrela dolu a zbadala otca .	pozrela	1	Part
Zem sa ustavične triasla a kopček z hliny rástol a rástol .	triasla	3	Part
Pritúľte sa k sebe tantricky !	Pritúľte	0	Fin
Ako som takto táral , pochopil som , že rozprávam hlúposti .	rozprávam	9	Fin
Nevládal by bežať , nevládal by uderiť .	uderiť	6	Inf
Veľký brat je zovňajšok , v ktorom sa Strana ráči ukazovať svetu .	ráči	9	Fin
V oblasti aktívnej politiky trhu práce bude vláda presadzovať princíp návratnosti a projektového financovania .	presadzovať	8	Inf
Zviera , čo obýva zámok , ja naskutku skolím .	skolím	8	Fin
Vláda vypracuje a realizuje projekt transformácie štátnych podnikov lesného hospodárstva v pôsobnosti Ministerstva pôdohospodárstva SR na štátnu akciovú spoločnosť založenú podľa osobitného zákona .	vypracuje	1	Fin
Už sa zberala preč , ale vo dverách sa otočila .	zberala	2	Part
Počul , ako Júlia zaťala zuby . " Asi by sme sa mali rozlúčiť , " poznamenal .	Počul	0	Part
Ak sa tak stalo , mrzí ma to .	mrzí	5	Fin
Ťažko by pri nich obstál nejaký anonym .	obstál	4	Part
Myslím , že o sebe urobili veľmi pekný obraz , že aj Rómovia a deti z detského domova sa vedia správať na úrovni .	správať	20	Inf
Ak nevyjde , nemáme dôvod stretnúť sa .	nemáme	3	Fin
Vilko sa začal hneď napchávať a Maja pozorovala okolie .	napchávať	4	Inf
Máme tu teda ďalší argument pre to , aby sme kánony o celibáte z druhej kolomanovskej synody nepovažovali za prejav úplného príklonu k normám reformného pápežstva .	nepovažovali	17	Part
“ Fíha ! “ zvolala prekvapene Maja .	zvolala	4	Part
Už sme spomenuli , že za Ladislavovej vlády prichádza k postupnej konsolidácii pomerov v krajine .	prichádza	8	Fin
Nachádzala sa tam kancelária šéfa televízie Sírius .	Nachádzala	0	Part
" Nenávidím mravnú čistotu , nenávidím dobrotu !	nenávidím	5	Fin
“ Viem , čo chceš urobiť . “	chceš	4	Fin
Vláda dopracuje a predloží návrh zákona o voľbách do Európskeho parlamentu tak , aby Slovenská republika bola pripravená voliť poslancov do tohto orgánu v prvom polroku 2004 .	voliť	18	Inf
Vtedy som prestal sledovať predstavenie v parku .	prestal	2	Part
Vilko skúsil aj vyskočiť .	vyskočiť	3	Inf
Gregor VII . , aby toto presvedčenie ešte zdôraznil a aby mohol vyžadovať poslušnosť od uhorských kráľov , vytvoril konštrukciu o Štefanovom komendovaní krajiny sv . Petrovi .	vyžadovať	12	Inf
Nemohla som chápať súvislosti tejto zmeny .	Nemohla	0	Part
Zobuď sa ! “ kričal Mauglí .	Zobuď	0	Fin
“ Takže musím zavolať tvojmu otcovi , “ povedala .	zavolať	3	Inf
Súžitie etník tu teda fungovalo na princípe spoločenstiev v ktorých jednotlivé zložky popri sebe slobodne existovali a zároveň sa ovplyvňovali , miešali a splývali .	ovplyvňovali	19	Part
Usadili sme sa na pohovke a z kuchyne sme počuli tikanie hodín na rúre .	Usadili	0	Part
Veď nás Duchom Svätým a pomáhaj nám prekonávať všetko , čo v EÚ a našom svete bude slúžiť smrti a zániku .	prekonávať	7	Inf
Mohli si nás všimnúť a vyjavene sa na nás dívať .	všimnúť	3	Inf
