Lai drīkstētu organizēt preču vai pakalpojumu loteriju , komersantam , kas ražo , izplata , pārdod preces vai sniedz pakalpojumus , Izložu un azartspēļu uzraudzības inspekcijā ( IAUI ) jāsaņem loterijas atļauja .	jāsaņem	29	Nec
R. Auševs apstiprināja aizdomas , ka ieradies , lai radītu apstākļus separātistu līdera Aslana Mashadova piesaistīšanai sarunām .	radītu	9	Cnd
Turklāt pie ekonomiskās grupas faktoriem ir jāpieskaita arī tautsaimniecības attīstība un tai atbilstošas vai neatbilstošas pārmaiņas profesionālās izglītības sistēmā .	jāpieskaita	6	Nec
Kad viņa kāpj lejā pa kāpnēm ar lielu netīrumu maisu vienā un traukiem otrā rokā , tēvs ir pamodies .	kāpj	2	Ind
Es atkal iegrimstu nemaņā .	iegrimstu	2	Ind
Tā jāizņem pēc iespējas ātrāk !	jāizņem	1	Nec
Galda viesu murdoņa dūra ausīs .	dūra	3	Ind
Apstādini mani , ja vari !	Apstādini	0	Imp
Lai tādus nevajadzētu tērēt , Aivars Plinte gribot likt lietā Čehijā redzētu uzrikti .	nevajadzētu	2	Cnd
Dažādu mācību priekšmetu skolotājiem situācija ir atšķirīga , tādēļ tie ir jāanalizē atsevišķi .	jāanalizē	11	Nec
Pagaidi vien , tūlīt aicinās mani uz kafejnīcu !	Pagaidi	0	Imp
- Jā , - atbildu un iros viņai tuvāk .	iros	6	Ind
Nātans Moriss kristīgajai ticībai pievērsās 2001. gadā , bet jau 2006. gadā sāka kalpošanu " Sapurini valstis " , apceļojot dažādas pasaules valstis un sludinot cilvēkiem " Labo vēsti " .	pievērsās	4	Ind
Gada laikā nospēlēt 100 koncertus – to uzņemas tikai “ Muse ” un arī jaunās grupas , kurām vēl ir jāaug .	jāaug	20	Nec
Arī pats Čaudhri ieradās Karači , lai uzstātos demonstrantu priekšā , taču līdz manifestācijas vietai netika , jo valdošo spēku atbalstītāji sāka bloķēt ceļus , lai neielaistu pilsētā opozicionārus .	neielaistu	26	Cnd
Kad bija jāsāk apsvērt iespēja kaut kur mācīties , lai apgūtu profesiju , no drauga , kurš arī gatavojās studēt kino jomā , uzzinājis , ka Dānijā ir tāda Eiropas Kino koledža .	apgūtu	10	Cnd
Lai risinātu Latgales problēmas , LZNP gatava šos kursus un eksāmenu pretendentiem apmaksāt ar nosacījumu , ka jaunais notārs sekmīgi nokārto eksāmenu un dodas strādāt uz Latgali .	risinātu	1	Cnd
Vasarā braucam uz Sietlu , uz kurieni Lonija ģimene vēlāk pārcēlās no Denveras .	braucam	1	Ind
Hokejistu operēt bija paredzēts jau vakar turpat Bernē , lai žoklī ieliktu metāla stiprinājumu .	ieliktu	11	Cnd
Nelielo vasaras mājiņu vecāki cēla gadiem , nevis kā tagad uzslej viens un divi .	uzslej	10	Ind
Uzmanies no dīkām pļāpām ar blakus mājas iemītniekiem .	Uzmanies	0	Imp
Pirmdien visu ziemeļaustrumu štatu gubernatori tiksies ar Brazīlijas prezidentu Luisu Inasiu Lulu da Silvu , lai prasītu papildu finansējumu , kas nepieciešams galvenokārt palīdzības nodrošināšanai cietušajiem un applūdušo pilsētu infrastuktūru atjaunošanai .	prasītu	16	Cnd
Ceturtais kritērijs paredz augšupejošas pieejas īstenošanu , lemjot iejaukties vai neiejaukties kādas rīcībpolitikas īstenošanā , lai risinātu vardarbības skarto sabiedrības indivīdu pamatvajadzības .	risinātu	16	Cnd
Kad atskrien Grēta , abas joņo pa pļaviņu .	joņo	5	Ind
Viņš labprāt pastāstīs par jūs ieinteresējošo preci , organizēs degustāciju , sniegs rekomendācijas , ieteiks labu recepti .	organizēs	8	Ind
Ārste domā , ka šī paaudze vairs nemainīsies , jāaudzina jaunieši .	jāaudzina	9	Nec
Bet visā biezajā telefonu grāmatā nebija neviena paša , kas sauktos Mellers Knāgs .	sauktos	10	Cnd
Artēmijs gājis pa priekšu , bet meitene gaidīja , kamēr viņš būs nozudis aiz viesnīcas durvīm , lai pati dotos iekšā , novērojuši acīgie krievu žurnālisti .	gaidīja	7	Ind
Izsaldēsi vēl to pašu .	Izsaldēsi	0	Ind
„ Es labāk iešu dārzā , ” viņa nodomāja .	iešu	3	Ind
Ūdens līmenis Lielupē ir pietiekami augsts , lai neveidotos sastrēgumi , » spriež Armands Šilbergs .	neveidotos	8	Cnd
Mums televīzijā rāda možus un brašus puišus , kuri pilnīgā mierā , bezrūpībā un pašpaļāvībā metas aizpildīt kredīta pieprasījumus uz dažiem desmitiem gadu un par zemām pirmajām iemaksām ...	metas	15	Ind
Šis sadalījums ir būtisks , lai izprastu arī etniskās kustības cēloņus un dinamiku .	izprastu	6	Cnd
– Kaut kas neriktīgs ar to laiku , apstājies ...	apstājies	8	Imp
Veicot pedikīru pievērsiet īpašu uzmanību nagu stāvoklim .	pievērsiet	2	Imp
No rīta noņemiet kompresi , noskalojiet kājas siltā ūdenī un paberzējiet pārakmeņojušos ādu ar cietu birstīti .	noskalojiet	5	Imp
Bet , brītiņu padomājusi , iziet uz lieveņa , nomet pret klonu vispirms glāzi , tad šķīvīti nomet .	nomet	17	Ind
Aleksis iedomājās par Moniku , bet tūlīt prāts noraidīja šo ideju .	iedomājās	1	Ind
" Lai to iemācītos , nepieciešama tikai prakse , " norāda politiķis .	iemācītos	3	Cnd
Eotekls dodas brālim pretim , lai divkaujā izšķirtu jautājumu , kam būt valdniekam , un ar to glābtu pilsētu no izpostīšanas .	izšķirtu	7	Cnd
Mūsu pazīšanās ir relatīva , es drīzāk gribētu teikt , ka viņu nepazīstu , " stāsta Andris Vilks .	gribētu	7	Cnd
– Es tā negribētu teikt .	negribētu	3	Cnd
Lauka vidū vienmēr vējš plosījās , tas postīja namiņa jumtu un izpūta acis sausas un sarkanas .	plosījās	4	Ind
Lielā vēstule bija jāatver tur .	jāatver	3	Nec
Vispirms ar speciālu lāpstiņu no manikīra komplekta uzmanīgi atbīdiet kutikulu pie naga pamatnes , lai nagi brīvi elpotu .	atbīdiet	8	Imp
Un nav saprotams , kāpēc jākaitina bullis .	jākaitina	5	Nec
Tiem , kuri ir iemīlējušies , ir ārkārtīgi grūti būt šķirtiem , tie ir smagi pārdzīvojumi , dažkārt pat jāiestāsta sev , ka tu ienīsti cilvēku , kuru patiesībā mīli .	mīli	29	Ind
Viņš uzlika meitai glumu buču uz auss , un pēc tam noslaucīja lūpas ar audekla piedurkni .	uzlika	1	Ind
Atvāzusi cepeškrāsns durtiņas , viņa aizdedz gāzi un noliek priekšā gāzes plītij zemu soliņu .	aizdedz	5	Ind
Jāmeklē veidi , kā atiet .	Jāmeklē	0	Nec
Arī mūsu dienās ikvienam ir jārod sava atbilde uz šiem jautājumiem .	jārod	5	Nec
Savukārt Barontēvs paguva pierakstīt latvju dainas laikā , kad tās sāka zust no latviešu tautas atmiņas , kur tās nepierakstītas bija glabājušās gadu simtiem .	paguva	2	Ind
Pēkšņi Tu ievēro vienu nelielu kosmisko kuģi meža pļaviņā savā priekšā .	ievēro	2	Ind
Jāatļauj gājējiem pārvietoties pa ceļiem un takām , kas izveidoti aizsargājamās teritorijas apskatei .	Jāatļauj	0	Nec
Tik daudz spēka jāsakopo , lai paklausītu šai siltajai pavēlošajai balsij .	paklausītu	6	Cnd
Bet kamēr sapņoju par ārzemēm ir jāapskatās viss ko piedāvā Latvija .	jāapskatās	6	Nec
Mājās braucot , viņš tur vaļā logus un vēdina mašīnu , nesmaržojies , lūdzu , viņš saka .	vēdina	8	Ind
Lai kā Brige pretojās un neuzticējās , tomēr Rūdolfs ar pārcilvēcisku pacietību pret viņas histērijām , pašaizliedzīgu lutināšanu un milzīgu jūras neatlaidību iekodās krasta rikā , paisa , paisa un nocēla princesi no kalna , un iecēla sev klēpī .	paisa	28	Ind
Es sapratu , ka vieglāk būtu ticēt liktenim , tomēr arvien skaidrāk apzinājos , ka valda nejaušība .	apzinājos	12	Ind
Protams , arī tas veicināja tirgus piebremzēšanos .	veicināja	4	Ind
Man ir jāzina , kas notiek .	jāzina	2	Nec
Šampinjonus sagriez šķēlītēs un apcep uz pannas nelielā eļļas vai sviesta daudzumā .	sagriez	1	Ind
" Mums praksē ir bijis gadījums , kad tādā veidā kurpnieka darbnīcas īpašnieki šo problēmu atrisināja , " atceras D. Arāja .	atrisināja	15	Ind
Arī Margarita nu ir pāri , viņa ir to izdarījusi , un tūlīt aiz viņas muguras mašīnas nosvītro izdarīto .	nosvītro	17	Ind
Mums ir skaidri jāapzinās , ka izglītības sistēma ir nozīmīgs faktors , lai Latvijā nākotnē augtu iekšzemes kopprodukts , lai mēs būtu konkurētspējīgāki .	augtu	15	Cnd
Piemēram , ir iepirkumi bibliotēkās , kas varētu būt labs instruments , ja to nostabilizētu .	nostabilizētu	14	Cnd
Limbažu un Alojas novadā lielais vējš bija nolauzis kokus , kas sakrita pār ceļa braucamo daļu .	sakrita	11	Ind
Energoresursu cenas kāpj , un , lai ko arī neregulētu un neremontētu , apkure vairs nekad nebūs tik lēta kā kādreiz .	neregulētu	9	Cnd
Tās visas radīja , lai apmierinātu industriālisma vajadzības .	apmierinātu	5	Cnd
Reklāmā viņš līksmi piedāvā piedalīties akcijā " NOPĒRC SEV JAUNU SIEVASMĀTI ! "	piedāvā	3	Ind
Vizītes sākumā ministrs tiksies ar Ādažu novada domes priekšsēdētāju , domes deputātiem un administrācijas vadību , lai pārrunātu finanšu un ekonomikas jautājumus novadā pēc finanšu stabilizācijas uzsākšanas , kā arī iepazītos ar novada attīstības plāniem .	pārrunātu	17	Cnd
Nu laikam teiktu , ka viņai ir UDHS .	teiktu	2	Cnd
2. Sadzīves atkritumu apsaimniekošanas mērķis ir reglamentēt sadzīves atkritumu apsaimniekošanu Jēkabpils pilsētas pašvaldības administratīvajā teritorijā , lai aizsargātu cilvēku dzīvību un veselību , vidi , kā arī personu mantu .	aizsargātu	17	Cnd
Ja tā padomā , visa pasaules publiskās izglītības sistēma ir ilgstošs process , lai iestātos universitātē .	padomā	2	Ind
Pārskati dalībnieku sarakstu , noskaidro , vai visi ir atbildējuši uz ielūgumiem .	noskaidro	4	Imp
« Mani uzaicināja uzstāties kubā « Golden » , un es uzreiz piekritu , jo šķita , ka tur būs daudz cilvēku , kuriem patīku , kuri mani uztvers pozitīvi .	patīku	24	Ind
Vai nav briesmīgi netaisni , ka dzīvei reiz jābeidzas ?	jābeidzas	8	Nec
Ja nebūtu šī mazā pieredzējuma , viņa varbūt izplūstu garos , laimīgos stāstos , kuros identificētu savu pieredzi ar sevi pašu , un lāga klausītāja justu līdzi , pat reta asara pārslīdētu viņas tuklajam vaigam .	izplūstu	8	Cnd
Piesūciniet kokvilnas zeķes ar siltu augu eļļu un uzvelciet tās kājās , un virsū uzvelciet plastikāta maisiņus , bet uz tiem uzvelciet vēl vienu zeķu pāri .	uzvelciet	14	Imp
Mēs dzīvojām trīs skaistās istabās , kuru platība bija tik liela , ka atbilda padomju laika standartiem , kas noteica , cik kvadrātmetru dzīvojamās platības uz vienu galviņu drīkst būt .	dzīvojām	1	Ind
Mēs uzskatījām to par vienu no galvenajām lomām .	uzskatījām	1	Ind
( 4 ) Juridiskās noteiktības un pārredzamības nolūkā ir jānoskaidro Direktīvas 80 / 987 / EEK piemērošanas joma un dažas definīcijas .	jānoskaidro	9	Nec
Bodes īpašnieks Arnis Iesaliņš pārliecināts , ka domes lēmums ir pretrunā ar ceļu satiksmes noteikumiem , kuros ierobežojumi attiecas tikai uz automašīnām , kas smagākas par piecām tonnām , tāpēc uzskata , ka šis pašvaldības noteikumu punkts nav jāievēro .	jāievēro	38	Nec
Ja jums ir resni un biezi kāju nagi , kas liecina par pārlieku lielu kalcija daudzumu organismā , tos jāgriež pēc desmit minūšu ilgas turēšanas siltā ūdenī .	jāgriež	19	Nec
„ Es domāju , būs jākāpj augšā un jāsāk gatavot mājasdarbu dabasmācībā , ” viņa teica kā atvainodamās .	jāsāk	8	Nec
Līdaka ik pa laikam esot apskatījies mapītes ar domu , ka būtu jādodas šo jautājumu nokārtot , taču , piezvanot kādam žurnālistam vai kādam no Saeimas vai uzrodoties citām aktivitātēm un darbiem , par to tiek aizmirsts .	jādodas	12	Nec
Iesēžoties ieelpo , pieceļoties izelpo .	ieelpo	1	Imp
Jāpieņem arī tas , ka citi tam var nepiekrist .	Jāpieņem	0	Nec
Mums atkal jāpieņem jauni cilvēki darbā , ir vajadzīgi jauni informācijas resursi , un tas tiešām ir izdarīts .	jāpieņem	2	Nec
Kosmosa kuģim ar SKS jāsavienojas otrdien , 19. jūlijā .	jāsavienojas	4	Nec
Zēnam tas ir pirmais signāls , kā jāizklausās īstam vīrietim .	jāizklausās	7	Nec
Autors uzskata , ka veicamie uzdevumi ir jāsadala divos līmeņos :	jāsadala	7	Nec
Viņš gan pauda cerību , ka Vilks neaizies pārāk tālu no politikas , un , iespējams , paliks valdības aprindās kā konsultants un padomdevējs un pieskatīs budžeta lietu kārtību arī turpmāk .	pauda	2	Ind
Vakara krēslā slīgstošajā Dundagā mieru traucēja vairs tikai suņu rejas .	traucēja	5	Ind
Es raudu ; kurš gan neraudātu ?	neraudātu	5	Cnd
Vai nav skumji , ka cilvēkam vispirms ir jāsaslimst , lai tad aptvertu , cik brīnumaini ir dzīvot .	aptvertu	12	Cnd
Es pieeju klāt un cieši piespiežu plaukstas pie stikla , lai sasildītu to .	sasildītu	11	Cnd
Tāpat VK ir iesniegusi Jelgavas domei ieteikumus , ar kuru palīdzību tiks nodrošināts pašvaldības institucionālās sistēmas un aģentūru darbības efektivitātes izvērtējums un tiks noteiktas aģentūru darbības pārraudzības un kontroles procedūras , lai turpmāk nepieļautu līdzekļu nepamatotu izlietojumu .	nepieļautu	33	Cnd
Tomēr Helēna ievēroja , ka cēlā vīra acis , raugoties uz viņu , pildās ar neapvaldāmām , nenoslēpjamām skumjām , kas draudēja pārvērsties par daudzām stikla bumbiņām , kas tad neapturami ripotu un plīstu , ripotu un plīstu .	plīstu	37	Cnd
Piesūciniet kokvilnas zeķes ar siltu augu eļļu un uzvelciet tās kājās , un virsū uzvelciet plastikāta maisiņus , bet uz tiem uzvelciet vēl vienu zeķu pāri .	Piesūciniet	0	Imp
Sieviete gribēja , lai jūrā plīkšķētu milzīgi viļņi , kuru putainās piles brīžiem aizskartu viņas seju , lai spēcīgs vējš dzenātu tukšās gliemežu čaulas un aizpūstu viņas nemieru pāri lielajai smilšu kāpai .	dzenātu	20	Cnd
Tas ir interesants ceļš , jo cenšos pilnībā saplūst ar viņa domāšanas veidu un stilu , lai to neizjauktu , lai mani piedāvājumi nebūtu sveši .	neizjauktu	18	Cnd
Lai noskaidrotu iemeslus , nepieciešama mediķa konsultācija .	noskaidrotu	1	Cnd
Ja jūs noņemat naga nelīdzeno virskārtu , tad dariet to ar mīksto saaudzējošo nagu vīlīti , lai netraumētu naga emalju .	dariet	8	Imp
... visbeidzot un galu gala , kaut kam reiz ir bijis jātop no nekā ...	jātop	11	Nec
Ir jāvēro , vai neattīstās tā saucamā krusteniskā alerģija pret pārtiku .	jāvēro	1	Nec
Ar šo pašu pabalstu nākotnē būs jāvariē .	jāvariē	6	Nec
Pašvaldības darbinieki sadarbībā ar finanšu stabilizācijas uzraugu un Finanšu ministrijas darbiniekiem ir paveikuši lielu darbu , lai turpmāk šādu situāciju nepieļautu un nodrošinātu iedzīvotājiem stabilu un drošu vidi , " komentējot paveikto novadā , norāda finanšu ministrs Andris Vilks .	nepieļautu	20	Cnd
Ēdājiem uz pieres izspiedās sviedru lāses .	izspiedās	3	Ind
Mazās valstīs šī joma ir jādotē , un tai ir jābūt lielākā mērā valsts politikai .	jādotē	5	Nec
Nes diplomātus , smalkādas portfeļus , sportiskas pleca somas , veikalu polietilēna maisiņus , puķes ; otrās maiņas skolnieciņi stiepj smagas mugursomas , mammas velk līdzi mazus , niķīgus , dienas nogurdinātus bērneļus .	velk	24	Ind
Un es ierados Vjetnamā .	ierados	2	Ind
Pagaidām šādu eksāmenu drīkst kārtot tikai reizi gadā , taču LZNP iesniegusi valdībai Notariāta likuma grozījumus , kas paredz neierobežot eksāmena kārtošanas laiku .	drīkst	3	Ind
Tas ir jāizrunā .	jāizrunā	2	Nec
Tr tāds termins , kas pastāv , lai gan man tas ļoti nepatīk , saucas hyhrid library , tātad hibrīdbibliotēka .	saucas	14	Ind
Lai ko Sofija nedarītu , meitene spogulī darīja to pašu .	nedarītu	3	Cnd
Skumji , ka augšanas gaitā mēs sevi pieradinām ne tikai pie Zemes pievilkšanas spēka , mēs pierodam tai pašā laikā arī pie pasaules kā tādas .	pierodam	16	Ind
Es nekad nebūšu īsta priekšniece - ja svētdienā jāapmeklē futbola spēle , man nešķiet normāli dēļ tām 10 minūtēm saukt domes šoferi .	jāapmeklē	8	Nec
Beļģijā trūkstošā darbaspēka sarakstus izmanto tikai tāpēc , lai elastīgi piešķirtu darba atļaujas jauno ES dalībvalstu pilsoņiem ( kopš 2009. gada maija - tikai Rumānijas un Bulgārijas pilsoņiem ) .	piešķirtu	10	Cnd
Lai kļūtu par transportlīdzekļu vadītāju , ikvienai personai vispirms jāiziet obligātā teorētiskā apmācība autoskolā , kā arī instruktora pavadībā jāapgūst spēkrata vadīšanas prasme un iemaņas .	jāiziet	9	Nec
Latvijas Banka to paredzēja un laikus brīdināja valdību , bet tā kārtējo reizi nerīkojās saimnieciski , pretinflācijas plānu ieviesa par vēlu , stipri par vēlu .	nerīkojās	13	Ind
Tad kraties malā .	kraties	1	Imp
Reģistrējoties uz šo fakultatīvo kursu , studenti parakstīja dokumentu , kurā viņi piekrita , ka gadījumā , ja ainas būs pārāk atklātas , viņi drīkstēs atstāt auditoriju .	piekrita	12	Ind
Novērtē to , ka esmu te , nevis mājās .	Novērtē	0	Imp
Viņam nebija jārunā , bet zināt to vietu , kur ienāk trīs karaļi ?	jārunā	2	Nec
Viņu sasaistīja ar mazu ķēdīti un virsū uzlaida vaboli , kura ar kājiņām šķirstīja rūķīša bārdu .	uzlaida	7	Ind
Dorai bij jābrauc pēc Gabriela .	jābrauc	2	Nec
Tā nu Sofijai nāca klāt vēl viena problēma , kas nodarbināja viņas prātu .	nodarbināja	10	Ind
Mēs tagad tās aizliedzam , bet pašlaik šīs firmas savas reklāmas sūta uz cilvēku pastkastītēm .	aizliedzam	3	Ind
Par to , kas notiek Latvijas grāmatniecībā - ko publicējam un rakstām .	publicējam	9	Ind
Šādu uzaicinājumu pārrunāju arī ar satiksmes ministru Aivi Roni un , ņemot vērā , ka plānoto projektu realizācija ir nozīmīga Satiksmes ministrijai , saņēmu atbalstu darbībai LDz viceprezidenta amatā , lai pārstāvētu uzņēmumā arī Satiksmes ministrijas intereses .	pārstāvētu	31	Cnd
Kad pēc pusotras stundas lidmašīna paceļas , lai trauktos uz Londonu , mēs ar Paulu Bankovski un Knutu Skujenieku brālīgi padalāmies ar baldriāna tabletītēm .	trauktos	8	Cnd
Tomēr pirms vienošanās ar treneri iepazīstieties ar zirgiem .	iepazīstieties	5	Imp
Iesim , saudzīgi drošina Bērts un nezina , ko iesākt .	Iesim	0	Imp
Ļeoņidiks aiziet no viņas dzīves , lai izdarītu pašnāvību , kas ir novirze no melodrāmas žanriskajām prasībām , jo Ļeoņidiks lugas struktūrā nav ļaundaris , drīzāk – nejaušības ( liktenis ) radīts šķērslis galveno varoņu laimei .	izdarītu	7	Cnd
" Pēdējā mēneša laikā saņemam lielu interesi no tūristu grupām , kas ierodas Latvijā baudīt vasaru .	saņemam	4	Ind
Vai par to ir jāraud ?	jāraud	4	Nec
Mūsu grupa jau uzreiz sadalījās vairākās kompānijās .	sadalījās	4	Ind
Latvijas migrācijas politikai pašlaik ir jārisina virkne problēmjautājumu , kas saistās ar emigrācijas pieaugošo apjomu , kvalificētā darbaspēka deficītu , sabiedrības novecošanos , strukturālo bezdarbu un vispārējo valsts mērķi pēc iespējas ātrāk pārvarēt atpalicību no ES vidējā dzīves līmeņa .	jārisina	5	Nec
Netīrumus un sakrājušās mirušās ādas šūnas regulāri notīriet no nagu apakšas ar neasu kociņu , to ir jādara ļoti uzmanīgi , lai netraumētu naga iekšpusi .	netraumētu	22	Cnd
2006. gadā viņi uzvarēja tiesas prāvā par šī likuma grozīšanu , taču parlaments to pārstrādāja tā , ka monopols vienalga palika aklo un licencēto masieru rokās .	uzvarēja	3	Ind
Taču it kā starp citu ieminējās , ka tagad šī uzraugošā institūcija saņems un regulāri lasīs arī “ Rēzeknes Vēstis ” .	ieminējās	5	Ind
Un vai tā būtu jāsauc par nelaimi ?	jāsauc	4	Nec
2. Ja dalībvalstis izmanto 1. punktā minēto izvēli , tās nosaka laikposma ilgumu , par kuru garantiju iestādei jāapmierina neapmaksātie prasījumi .	jāapmierina	18	Nec
Nesper sunītim , viņam sāp .	Nesper	0	Imp
Mācies atslābināties un atpūsties – dzemdībās noderēs !	Mācies	0	Imp
Šobrīd pilnā sparā notiek Ziemassvētku akcija " aizej kopā ar 2052. gadu ! " , un , domājams , ar parastās Ziemassvētku depresijas atbalstu cilvēku populācija kārtējo reizi būtiski samazināsies .	aizej	7	Imp
Ja paskatītos uz izglītības sistēmu citplanētieša acīm , un vaicātu : „ Kam domāta publiskā izglītība ? ”	paskatītos	1	Cnd
Ir vēl citi rādītāji , kas jānosaka , lai izvēlētos katram cilvēkam vispiemērotākos medikamentus .	jānosaka	6	Nec
Pieraksti tos , jo vizītes satraukumā daudzas svarīgas lietas mēdz aizmirsties .	Pieraksti	0	Imp
Elektriskām iekārtām ir jābūt piestiprinātām tā , lai bērns savā darbošanās tieksmē tās nevarētu aizsniegt .	nevarētu	13	Cnd
Sieviete gribēja , lai jūrā plīkšķētu milzīgi viļņi , kuru putainās piles brīžiem aizskartu viņas seju , lai spēcīgs vējš dzenātu tukšās gliemežu čaulas un aizpūstu viņas nemieru pāri lielajai smilšu kāpai .	aizpūstu	25	Cnd
Kādu brīdi viņi trīs apraud veco sunīti , kuru aiznesa plūdi .	apraud	4	Ind
Jārod arī skaidrība , kas būs liecinieki S. Huseina prāvā .	Jārod	0	Nec
Brienot pa pļavu paralēli baisajam biezoknim , Māris drīz vien uzdūrās takai .	uzdūrās	10	Ind
Ir tā , it kā Tu pamostos no gadiem ilga Ērkšķrozītes miega .	pamostos	6	Cnd
Tāpēc katrai no dalībvalstīm jāveido žūrija piecu cilvēku sastāvā .	jāveido	4	Nec
Manuprāt , mūsu vienīgā nākotnes cerība ir pieņemt jaunu cilvēka ekoloģijas konceptu , kurā mēs sāktu pārveidot mūsu izpratni par cilvēka spēju daudzveidību .	sāktu	15	Cnd
Jūlijs pagājās atpakaļ un aizsmēķēja .	pagājās	1	Ind
1. Dalībvalstis veic pasākumus , lai apkarotu bērnu nelikumīgu aizvešanu uz ārvalstīm un aizturēšanu ārvalstīs .	apkarotu	6	Cnd
Virtuvē atkal krīt vakara saule .	krīt	2	Ind
Es negribētu , ka tieši Tu būtu starp trulajiem un vienaldzīgajiem .	negribētu	1	Cnd
A. Karpenko piebilda , ka labāka situācija būtu , ja namā ierīkotu siltummezglu , tad vismaz siltajā laikā māja netiktu pārkurināta , lai nodrošinātu silto ūdeni , jo to uzsildītu mezglā .	uzsildītu	29	Cnd
Viņa nesaņēma atbildi arī tagad , bet uz kādu pavisam īsu mirkli viņu pārņēma šaubas par to , vai jautātāja bija viņa pati vai varbūt meitene spogulī .	pārņēma	13	Ind
Mans mīļotais nezina , ka es esmu mirusi .	nezina	2	Ind
Jau 1936. gadā PSRS ieviesa virkni regulējumu , kas ietekmēja ģimeņu privāto dzīvi , tajā skaitā aizliedza abortus un radīja sarežģītu laulības šķiršanas kārtību , padarot to faktiski neiespējamu .	ieviesa	4	Ind
Šurp nāca fizikas skolotājs , lai slēgtu vaļā durvis .	slēgtu	6	Cnd
No tās neviens nav pasargāts , un tādēļ atbildība jāuzņemas ģimenei .	jāuzņemas	9	Nec
Latvijas Bankas neatkarība , ko sargā Eiropas Savienība , liek Latvijas valdībai rīkoties smalkāk .	liek	9	Ind
Šāda soļa īstenošanai būtu preventīvs raksturs , tas palielinātu drošību reģionā , lai kaimiņam nerastos " muļķīgas domas " .	palielinātu	8	Cnd
Lasi tālāk , un daži no šiem jaunumiem tevi pārsteigs	Lasi	0	Imp
Ieva lūkojās , kā tas lēnām rāpjas lejā no augstumiem — lien gar pelēki ribaino ārējo sienu kā trombs pa uzblīdušu asinsvadu , kā dzeltena acs , kas , iztraucēta apcerē , viņiem nesteidzīgi pievēršas .	lien	11	Ind
Sieviete gribēja , lai jūrā plīkšķētu milzīgi viļņi , kuru putainās piles brīžiem aizskartu viņas seju , lai spēcīgs vējš dzenātu tukšās gliemežu čaulas un aizpūstu viņas nemieru pāri lielajai smilšu kāpai .	aizskartu	13	Cnd
Otrajā ceturtdaļā Turcijas komanda ieguva 14 punktu pārsvaru ( 36 : 22 ) , tomēr spēles otrajā daļā " Real " atspēlējās un izskaņa bija ļoti sīva , taču " Fenerbahce " pārsvaru spēja nosargāt .	ieguva	4	Ind
Ja konflikta dalībnieks tiesai neuzticas , viņš nevēlēsies tai deleģēt sava konflikta risināšanu .	neuzticas	4	Ind
A. Karpenko piebilda , ka labāka situācija būtu , ja namā ierīkotu siltummezglu , tad vismaz siltajā laikā māja netiktu pārkurināta , lai nodrošinātu silto ūdeni , jo to uzsildītu mezglā .	ierīkotu	11	Cnd
Proti , iekšējā pamatojumā tiesai jāataino juridiskais siloģisms – jāatklāj lietas risinājuma loģiskā saikne ar lietas faktiskajiem apstākļiem un piemērojamo tiesību normu .	jāataino	5	Nec
Grilētās maizītes vari pārkaisīt arī ar piparmētru lapiņām , bet ogas vari aizvietot ar banāniem vai žāvētiem augļiem .	vari	2	Imp
Pievērs uzmanību metāla furnitūrai - sprādzēm , āķiem , pogām un kniedēm , jo tās veido jostas raksturu jeb stilu - klasisku , sportisku un militāru vai romantisku .	Pievērs	0	Imp
Joprojām jāpalielina bijušo iemītnieku pabalsti .	jāpalielina	1	Nec
Piemēram , ja sabiedriskā vietā nozog rokassomiņu , kurā bijusi arī pase , ir jādomā par to , vai katru reizi , kad kaut kur dodas , obligāti šis dokuments jānēsā līdzi .	jānēsā	30	Nec
Kā izkļūtu no situācijas , kā dzīvotu tālāk ?	izkļūtu	1	Cnd
Par to , kas notiek Latvijas grāmatniecībā - ko publicējam un rakstām .	rakstām	11	Ind
Pēc ticējumiem Mārtiņš reizi gadā atjāj aplūkot sētas un laukus .	atjāj	5	Ind
Kā uzskata autore , grūtākais iedvesmas periods ir izdomāt , ko darbā ielikt , lai konkrēto cilvēku raksturotu visspilgtāk .	raksturotu	17	Cnd
Citām pastniecēm esot vēl mazāki bērni , bet jārod risinājums , jo katram darbam ir savas īpatnības .	jārod	8	Nec
Tas apdraudētu ekonomikas izaugsmes potenciālu , vienotās valūtas darbību un liktu ievērojami pārskatīt pensiju un veselības pakalpojumus , kas ievērojami negatīvi ietekmētu pensionāru un nodokļu maksātāju labklājību nākotnē .	apdraudētu	1	Cnd
Tētim retu reizi mēdza nākt pa vēstulei no bankas , bet viņš jau arī nebija nekāds parasts tētis .	mēdza	3	Ind
Kuras Latvijas dziedātājas liek un ar ko liek aizrauties Ventspils mēra elpai ?	liek	3	Ind
Tāpēc plūsmu var samazināt tikai līdz tādai robežai , lai daļai iemītnieku nebūtu jāsalst .	jāsalst	13	Nec
Man patīk universitātes profesori , bet ziniet , mums nevajadzētu viņus nostādīt kā cilvēces sasniegumu virsotni .	ziniet	6	Imp
Futbolā vispirms notika spēles 16 arodskolu konkurencē , lai kvalificētos fināla astoņniekam , kur no mūspuses iekļuva gan Jelgavas Amatniecības vidusskolas un Amatu vidusskolas , gan Zaļenieku arodskolas vienības .	kvalificētos	9	Cnd
Šajā sakarībā , lai noteiktu garantiju iestādes atbildību , dalībvalstīm jāspēj noteikt , ka , ja maksātnespēja izriet no vairākiem maksātnespējas procesiem , situāciju uzskata par vienu maksātnespējas procesu .	jāspēj	10	Nec
52. Veicot amatnieka pakalpojumus un kapu kopšanas darbus , mehānismi un materiāli jānovieto tā , lai netraucētu kustību kapsētā .	jānovieto	12	Nec
Sākumā iznēsāju tikai pensijas , tagad arī pasta sūtījumus iznēsāju .	iznēsāju	1	Ind
Un vai man jākontrolē , ko tu velc vai nevelc .	jākontrolē	3	Nec
Vai valstij būtu jāpiemaksā honorāri rakstniekiem ?	jāpiemaksā	3	Nec
Nedēļas nogalē pasaules labākie kamaniņu braucēji atkal pulcēsies Siguldā , lai otro reizi jaunajā sezonā mērotos spēkiem Pasaules kausa izcīņā .	mērotos	15	Cnd
Sekss , protams , attiecībās nav galvenais , taču tas , ka nevarat vien beigt sajūsmināties par to liecina , ka labi saderat kopā .	nevarat	12	Ind
Bet paradokss ir tas , ka bibliotēku katru dienu apmeklē 4000 cilvēku , bet lasītavā vietas jāpiesaka caur internetu .	jāpiesaka	16	Nec
Necentieties arī uzreiz enerģiski ķerties klāt problēmai un risināt to , kamēr neesat uzklausījis visu , ko bērns ir vēlējies pateikt , un kamēr neesat uzzinājis , kādu palīdzību šis bērns sagaida un ir gatavs pieņemt tieši no jums .	Necentieties	0	Imp
Sestais kritērijs paredz tiesisko instrumentu īstenošanu operāciju rajonos uz vietas , paredzot primāri sniegt atbalstu vietējām tiesībsargājošajām iestādēm , lai īstenotu likuma piemērošanu un atjaunotu tiesisko kārtību .	atjaunotu	24	Cnd
Tad deviņi kilometri _ kājām , jo autobuss nekursē jau sen , – viņš paskatījās pulkstenī , pakratīja to .	paskatījās	14	Ind
Viņa juta , ka viņai kaut kā jātiek galā ar vētru , kas viņā plosījās .	jātiek	7	Nec
Ik pa laikam ūdens traukā ir jāpievieno karsts ūdens .	jāpievieno	6	Nec
Viņš bija piezemēts pragmatiķis , kurš spieda rēķināt dīzeļpīzdeļdzinēja jaudu , ienīda atomfiziku , jebkādas fizikas sasaistes ar metafiziku , bet klusībā rēķināja Dieva neesamības pierādījumu .	spieda	6	Ind
No arheoloģiskiem izrakumiem gan redzams , ka liela dzimstība neapstiprinās ( spriežot pēc māju lieluma ) , jo liels iedzīvotāju skaita pieaugums līdzinātos Āzijas dzimstības sprādzienam .	līdzinātos	22	Cnd
Ir radīti speciāli medikamenti , kas pazemina holesterīna līmeni , bet pirms to lietošanas obligāti jākonsultējas ar ārstu , jo holesterīns nav vienīgais faktors , kas veicina aterosklerozi asinsvados .	jākonsultējas	15	Nec
Bet katra sieviete vēlētos ne tikai sakoptus , skaistus nagus , bet ari satriecoši garus nagus .	vēlētos	3	Cnd
" Patlaban gatavojamies iepirkt iekārtas un iekārtojam alus darītavu .	gatavojamies	2	Ind
« ... pasaki savās lūgšanās , Mišel , ka vientulība , kaislības un ilgas iet pāri mūsu spēkiem .	pasaki	2	Imp
Speciālisti novēro upi , bet beigtas zivis tajā pagaidām nav atrastas .	novēro	1	Ind
Tr tāds termins , kas pastāv , lai gan man tas ļoti nepatīk , saucas hyhrid library , tātad hibrīdbibliotēka .	pastāv	5	Ind
Lielā pirksta nagu grieziet tikai taisnā līnijā , lai izbēgtu no tā ieaugšanas pirkstā .	grieziet	3	Imp
Man katru dienu jānostaigā vismaz divas stundas .	jānostaigā	3	Nec
65. Balsotāju sarakstus atkarībā no lapu skaita cauršuj vienā vai vairākos sējumos ( lapas caurauklo , auklas galus sasien , nostiprina ar uzlīmi , apzīmogo un paraksta , norādot vietu , datumu un cauršūto lapu skaitu sējumā ) ;	sasien	18	Ind
Rietumvalstu prese ziņo , ka Dubaijas lidostā atstātas neskaitāmas automašīnas , jo viesstrādnieki aizbēguši uz dzimteni , pametot aiz sevis visu .	ziņo	2	Ind
Nes diplomātus , smalkādas portfeļus , sportiskas pleca somas , veikalu polietilēna maisiņus , puķes ; otrās maiņas skolnieciņi stiepj smagas mugursomas , mammas velk līdzi mazus , niķīgus , dienas nogurdinātus bērneļus .	Nes	0	Ind
( 3 ) Maksātnespējas likumu izmaiņas dalībvalstīs un iekšējā tirgus attīstība nozīmē , ka šajā direktīvā ir jāpielāgo daži noteikumi .	jāpielāgo	17	Nec
Pat tas kritērijs , ko lasa un cik daudz lasa , ne vienmēr ir pielietojams .	lasa	5	Ind
Lai attīrītu ādu no atmirušajām šūnām un sagatavotu to parafīna procedūrai , pirms tam rūpīgi jāveic manikīrs un roku pīlings .	sagatavotu	7	Cnd
Mūsu uzdevums nav tikai skatīt sūdzības , mūsu darbiniekiem ir jāstaigā arī pa veikaliem un jāpārbauda , vai netiek tirgotas nedrošas rotaļlietas un elektropreces .	jāstaigā	10	Nec
Nav nekādas jēgas , ja cilvēks apzinās , ka viņš dzīvo , ja viņš neapzinās to , ka viņam būs arī jāmirst .	jāmirst	21	Nec
Tas nozīmējot , ka ūdeni vajadzēs uz dīķiem sūknēt .	nozīmējot	1	Nec
Es mostos Brīvības ielas šaurajā istabiņā uz izvelkamā krēsla .	mostos	1	Ind
Izbāzt degunu ārpus sētas , lai tad kad atgriezos paskatītos uz visu jauniem aspektiem .	paskatītos	9	Cnd
Jālaužas pa biezokni , jāsavārta drānas .	jāsavārta	4	Nec
Jāatceras , ka pēc smēķēšanas atmešanas uzlabojas arī garšas un smaržas sajūtas .	Jāatceras	0	Nec
Īstas skumjas ( svarīgi nejaukt ar neirotiskiem vai depresīviem stāvokļiem ) pārņem , kad mīļoto cilvēku zaudējam pavisam , kad viņš it kā aizslīd no mums .	aizslīd	23	Ind
Šeit skatīšu etniskās mobilizācijas teorijas uzreiz to pielietojumā manam darba jautājumam , izdarot secinājumus par to , vai tās papildina sociālo kustību teorijas , apgāž tās vai nedod neko jaunu .	apgāž	24	Ind
Pēc tām nav jābrien purvā kā pēc dzērvenēm vai jālaužas cauri dzelkšņiem , kā lasot kazenes .	jābrien	3	Nec
Tautai ir nepārprotami jāpasaka , lai par viņiem vairāk nebalso , un pēdējais laiks ir sākt kampaņu " Runā latviski ! " .	Runā	18	Imp
« Pirtī mana dvēselīte ar Dieviņu runājās .	runājās	6	Ind
7. Lai no mājdzīvnieku spalvām atbrīvotu mīkstās mēbeles , uzvelc gumijas cimdu un pārbrauc roku pār netīro dīvānu .	pārbrauc	13	Ind
Šeit skatīšu etniskās mobilizācijas teorijas uzreiz to pielietojumā manam darba jautājumam , izdarot secinājumus par to , vai tās papildina sociālo kustību teorijas , apgāž tās vai nedod neko jaunu .	skatīšu	1	Ind
Saki , ka mūs nevajag aizmirst un mēs vēl kvēlojam tumsā .	kvēlojam	9	Ind
Kā izkļūtu no situācijas , kā dzīvotu tālāk ?	dzīvotu	6	Cnd
- Es nezinu , - viņa saka , un viņas tuklie pirkstiņu kā dzīvnieciņi lodā šurp turp pa tālruņa podziņām .	lodā	14	Ind
Meklējiet kopīgus hobijus .	Meklējiet	0	Imp
Tomēr Helēna ievēroja , ka cēlā vīra acis , raugoties uz viņu , pildās ar neapvaldāmām , nenoslēpjamām skumjām , kas draudēja pārvērsties par daudzām stikla bumbiņām , kas tad neapturami ripotu un plīstu , ripotu un plīstu .	plīstu	33	Cnd
Divas reizes pēc skata pieklājīgi vīrieši uz lūgumu aprunāties ar izteiksmīgiem krievu lamuvārdiem paskaidroja , kurp jādodas ar šiem jautājumiem .	jādodas	16	Nec
Godīgi sakot , jūs bieži neesat saviesīgās vakariņās , ( Smiekli ) ja strādājat izglītība , jūs uz tām neielūdz .	strādājat	13	Ind
Ātrā plūduma vietās straume paceļ no gultnes sanešus vai pat to padziļina .	paceļ	4	Ind
Piemēram : jāatsakās no daudzu nodarījumu atzīšanas par noziedzīgiem ; nepieciešams kardināli mainīt iesīkstējušu stereotipu par sodu , jo bargi sodi kriminalizē sabiedrību .	jāatsakās	2	Nec
Jo īpaši ir jānorāda iespējamie izņēmumi , ko piešķir dalībvalstīm direktīvas noteikumu ieviešanā , un tādējādi ir jāsvītro tās pielikums .	jāsvītro	17	Nec
Žūrijas sastāvā jāiekļauj profesionāli komponisti , izpildītāji , producenti .	jāiekļauj	2	Nec
Nevajadzētu novērtēt par zemu ziņas par kādu preci , produktu vai pakalpojumu , ko patērētājs nodod citiem patērētājiem .	Nevajadzētu	0	Cnd
Pēc otrā bērna dzimšanas Kimai Kardašjanai nebija tikai jādomā , kā atgūt savu ierasto formu , bet arī jāsaskaras ar vecākā bērna greizsirdību .	jāsaskaras	18	Nec
Kad gribēsi aiziet , tu to sajutīsi .	gribēsi	1	Ind
Atvērsim acis .	Atvērsim	0	Ind
Neviens nav guvis peļņu , aizņemoties naudu , lai iegādātos drēbes , apmeklētu restorānus vai izklaidētos .	izklaidētos	15	Cnd
Daži krita no klints un nositās , citi nolēca un aizgāja , apvainojušies par vietas trūkumu .	nolēca	8	Ind
Ja ar bērzu un pīlādžu meijām Jāņu vakarā jau laikus nopušķo visus vārtus un ēku jumtus , tas šķīstīs māju no katra ļaunuma .	šķīstīs	18	Ind
Katram no šiem izstrādājumiem ir pievienota lietošanas pamācība , kurā iekļauti arī drošības noteikumi , pirms pirotehnikas izmantošanas rūpīgi jāizlasa un jāievēro .	jāievēro	21	Nec
Tātad ir jāpārliek šie akcenti un cilvēki ir jāmudina ievērot šo veselīgo dzīvesveidu .	jāpārliek	2	Nec
Viņiem izejot no istabas , viņš mātei teica : „ Pastāviet un paskatieties uz viņu ”	paskatieties	12	Imp
Deputāts Andris Bērziņš ( ZZS ) sacīja , ka policija varētu iesēsties mašīnā un veselu dienu izbraukt pa pilsētu , lai secinātu , ka , iespējams , pat katrs otrais vai trešais pārkāpj likumu .	secinātu	21	Cnd
11. Šo noteikumu 10. punktā minēto rīkojumu piecu darbdienu laikā nosūta attiecīgajai pašvaldībai .	nosūta	10	Ind
Ja šīs niķainās radības jūs ir nobaidījušas , nekrītiet izmisumā : tā notiek bieži .	nekrītiet	8	Imp
Šternkopfs ilgi sēdēja vannas istabā , mazgāja džemperi un gaidīja , ka liecinieki būs jau aizmirsuši viņa neveiklo , bet skaļi kraukšķīgo kritienu tortiljās ar mērcēm .	mazgāja	6	Ind
Šī ir diena , kad dzīvie vienosies ar mirušajiem , kad atvērsies Ēģiptes nozīmīgākais templis un pa vārtiem laukā plūdīs krāšņs gājiens .	atvērsies	11	Ind
Es meloju nekaunīgi , negaidot , lai man ticētu .	ticētu	8	Cnd
Vaicājot , vai tad komponisti savā starpā nemaz nesarunājas , abi burtiski grieza galvas prom , izliekoties , ka viens otru nemaz nepazīst .	nepazīst	22	Ind
Mācies atslābināt muskuļus un prātu , tam būs liela nozīme gan dzemdībās , gan arī vēlāk .	Mācies	0	Imp
Tāpēc M. Segliņš rosina noteikt eksāmenu saturu kā klasificējamu informāciju , par kuras izpaušanu draudētu kriminālsods .	draudētu	14	Cnd
Piedod man , ka sūtu Tev šo karti caur Sofiju .	Piedod	0	Imp
Un šajā sakarā man jāteic , ka 2014. gadā ministrijās un centrālajās valsts iestādēs nav izlietoti 3 procenti no ieplānotā finansējuma jeb 121 miljons eiro .	jāteic	4	Nec
Viņš mani vairs nemīl tik maigi kā agrāk , un pēdējā reizē - es tobrīd nezinu , ka tā ir pēdējā , - grūžas manī ar tādu kā aizturētu niknumu .	grūžas	23	Ind
Manas kājas bija iespiestas betonā , bet es sapratu , ka tās ir jāatbrīvo .	jāatbrīvo	13	Nec
Nepastāv vienots viedoklis par to , kādā stratēģiskās vadīšanas līmenī ir jāvērtē konkurētspējīgā priekšrocība .	jāvērtē	11	Nec
Bet pirms 10 vai 15 gadiem mums prasīja skaidrot saviem iedzīvotājiem , kādēļ jāveic reformas , kādēļ ir jāvelta tam nauda .	jāvelta	18	Nec
Savas organizatoriskās spējas jaunieši parādīja , veidojot Adventes laikam veltītus pasākumus , » stāsta A. Borinta .	parādīja	4	Ind
Ministrs uzsvēra , ka prezidentūra koncentrēsies uz atšķirību cēloņiem un to novēršanu , lai veicinātu dzimumu līdztiesību , darba un ģimenes dzīves saskaņošanu un mazinātu nabadzību vecumdienās .	veicinātu	14	Cnd
Tūlīt kā atbildes sveiciens tapa grāmatzīmes gan dāvinātājam , gan laipnajiem sūtījuma piegādātājiem .	tapa	4	Ind
Ja dzīvotu Amerikā , viņa būtu karsējmeitene un visi zēni beigtos nost viņas dēļ .	dzīvotu	1	Cnd
Kad Neatkarīgā sazinājās ar pārdevēju , lai precizētu notikuma vietu , tas lika doties uz Liepāju .	precizētu	7	Cnd
Jāskatās , kādas būs detaļas , kad beigsies sarunu procedūra .	Jāskatās	0	Nec
Pēc saglabātās DNS kopijas tika radīts embrijs , un augot viņš uzņēma Luīzes atmiņu impulsus ( kas , par laimi , tika saglabāti pāris mēnešus pirms negadījuma ) .	uzņēma	11	Ind
Pēc tam tev pasaka – ņemiet kameras un ejiet filmēt .	ejiet	8	Imp
Visbiežāk bērni strīdas par rotaļlietām .	strīdas	2	Ind
Mums par to ir milzīga un pamatota interese , daļēji tādēļ , ka tieši izglītībai būtu mūs jānoved pie nākotnes , ko pat nespējam aptvert .	jānoved	17	Nec
To gan nedari , teica prāts .	nedari	2	Imp
Deputāte savā " Twitter " kontā norāda , ka aizliegums attiektos arī uz " Papardes zieda " izplatītajiem materiāliem .	attiektos	10	Cnd
Un , ziniet , tā fotogrāfija no šī pasākuma , es domāju , nokļūs arī parlamentārās izmeklēšanas komisijas grāmatā , un tas izskatījās tā .	ziniet	2	Imp
Ne šiem , ne citiem aicinājumiem nesekoja mērķtiecīga , izsvērta rīcība .	nesekoja	6	Ind
Taču tāpat tiesas atsaucas uz principu , to nepaskaidrojot , vai arī piemēro principus , neatsaucoties tieši uz to .	atsaucas	3	Ind
Kur tev jāsporto ar mazajām biksiņām ?	jāsporto	2	Nec
Varbūt viņš rāda uz tēti un saka : „ Tētis lido ! ”	lido	10	Ind
Nav nozīmes , kurp dodaties .	dodaties	4	Ind
Pēteris Skudra strādā , trenē Kontinentālās hokeja līgas komandu , arī viņam noteikti nav pedagoģiskās izglītības , un , lai arī cik veiksmīgi viņš tur strādātu un trenētu , Latvijā viņš nevar darboties .	strādātu	25	Cnd
Šajā dienā māksliniece sev un faniem pasniedza vairākas dāvanas – dziesmu albumu , koncerta ierakstu , jaunu akustisku koncerta programmu , jaunu mājas lapu .	pasniedza	6	Ind
Paradoksāli , ka no pagājušā gada ažiotāžas , kas pievērsa lielu uzmanību literatūras procesam , es konstatēju , ka situācija ir labāka , nekā iepriekš biju domājis .	konstatēju	16	Ind
Māsas atzīst , ka nav nozīmes , kam viņas palīdz .	atzīst	1	Ind
Loniju es uztveru kā Dieva svētību , esmu ļoti pateicīga , ka viņš ir manā dzīvē .	uztveru	2	Ind
Tāpat cilvēki ir norūpējušies par ietekmi uz vidi , vienlaikus atzīstot , ka jaunās tehnoloģijas novērš būtiskus riskus .	novērš	15	Ind
Kad esu kopaa ar Tewi , apstaajas laiks , aizmirstas probleemas , ikdienas ruupes pamet , kaa taac astraalais kjermenis , bailes ir pat iedomaaties , ka tas kaut kad vareetu beigties .	vareetu	30	Cnd
Tikmēr 33 % norādījuši , ka vidēji reizi gadā apskata , kas uzkrājies viņu zāļu skapīšos , un 16 % aptaujāto anketās bija atzīmējuši , ka to dara vismaz reizi pusgadā .	apskata	9	Ind
Šeit gan es gribu vērst uzmanību uz Somijas piemēru , jo 1939. gadā Somijai ļoti vajadzēja , lai sabiedrotās valstis nāktu palīgā un oficiāli nosūtītu tur savus militāros kontingentus .	nāktu	20	Cnd
Sarīvējiet uz smalkās rīves ziepes un izšķīdiniet traukā , ieteicams pievienot mazliet dzeramās sodas un ožamo spirtu , tie lieliski mīkstina nagus un ādu uz kāju pirkstiem .	mīkstina	20	Ind
Izmantojot urbi , piestiprini kājiņu pievienošanai nepieciešamos stūrus .	piestiprini	3	Imp
Vai nav skumji , ka cilvēkam vispirms ir jāsaslimst , lai tad aptvertu , cik brīnumaini ir dzīvot .	jāsaslimst	8	Nec
Taču jāpatur prātā , ka katrai precei ir savs lietošanas ilgums .	jāpatur	1	Nec
Šādu pieeju atzinīgi novērtēja sers Ričards Džollijs ( Richard Jolly ) , norādot , ka subjektīvā uztvere , kas atspoguļojas sabiedrības aptaujās , ir atzīstams instruments , lai izprastu aktuālās cilvēkdrošības jomas nacionālajā līmenī .	izprastu	28	Cnd
Reklāmā viņš līksmi piedāvā piedalīties akcijā " NOPĒRC SEV JAUNU SIEVASMĀTI ! "	NOPĒRC	7	Imp
Satriekts , viņš atteicās kāpt liftā , kas pēc tam norāvās no trosēm un nogalināja cilvēkus .	norāvās	10	Ind
Nespēlē mūziku , tu nebūsi mūziķis ; nenodarbojies ar mākslu , tu nebūsi mākslinieks .	Nespēlē	0	Imp
Gribēju viņu mierināt , bet teicu , ka neprotu mierināt .	Gribēju	0	Ind
Bieži vien , lai kaut ko ātri izrēķinātu , mēs izmantojam kalkulatoru un praktiski esam atraduši no domas to izdarīt patstāvīgi .	izrēķinātu	7	Cnd
Kad ieradās Valsts policijas darbinieki , jaunietis izrādīja pretošanos un agresivitāti , bet pēc tam tika nogādāts policijā .	izrādīja	7	Ind
Viņš uzskata , ka integrētas federatīvas " Eiropas Savienotās Valstis " varētu kļūt par ietekmīgu spēku globalizētajā pasaulē , kā arī tas veicinātu Eiropas ekonomisko attīstību un ļautu labāk cīnīties pret organizēto noziedzību .	veicinātu	22	Cnd
Dārzā jāstrādā , jāstrādā un jāstrādā : jāstāda jauni kociņi , jāizzāģē zari , jāsmidzina pret dažādiem kaitēkļiem , jānovāc raža .	jāizzāģē	11	Nec
Tādēļ turpmāk intervētāju sagatavošanā jāvelta lielāka uzmanība skaidrojumiem par lingvistiskās un komunikatīvās kompetences un runas paradumu ietekmi uz dzīvesstāsta intervijas formu un saturu .	jāvelta	4	Nec
Neizpratni , kāpēc būvniecība jāattīsta tieši uz vēsturisku zaļo teritoriju rēķina , aģentūrai LETA pauda Vides aizsardzības kluba ( VAK ) pārstāve Elita Kļaviņa un rajona iedzīvotāji .	pauda	14	Ind
Ja nebūtu šī mazā pieredzējuma , viņa varbūt izplūstu garos , laimīgos stāstos , kuros identificētu savu pieredzi ar sevi pašu , un lāga klausītāja justu līdzi , pat reta asara pārslīdētu viņas tuklajam vaigam .	identificētu	15	Cnd
Andris jau safotografējis Viktoru un viņa mīluļus un grasās likt fotoaparātu somā , bet Viktors smej : " Pagaidi , pagaidi , man taču ir vēl viens dzīvnieks ! "	pagaidi	20	Imp
" Mēs esam no Eiropas pārņēmuši visus noteikumus , lai nepieļautu diskrimināciju , un neredzu šā jautājuma aktualitāti , " Neatkarīgajai saka ministre , uzsverot , ka ministram ir izvēles tiesības , iet gājienos vai neiet .	nepieļautu	10	Cnd
Asinis nodošanu R. Daudze neuztver kā varoņdarbu un nekad to tā nav uztvēris .	neuztver	4	Ind
" Pēdējā mēneša laikā saņemam lielu interesi no tūristu grupām , kas ierodas Latvijā baudīt vasaru .	ierodas	12	Ind
Vienīgi tad , ja Vilnim nebūtu spēka uzrāpties līdz augšai , viņš iemauktu roku cilpā , saliektu elkonī , un Māris viņu uzvilktu augšā .	iemauktu	12	Cnd
Latvijas migrācijas politikai pašlaik ir jārisina virkne problēmjautājumu , kas saistās ar emigrācijas pieaugošo apjomu , kvalificētā darbaspēka deficītu , sabiedrības novecošanos , strukturālo bezdarbu un vispārējo valsts mērķi pēc iespējas ātrāk pārvarēt atpalicību no ES vidējā dzīves līmeņa .	saistās	10	Ind
Lai nokārtotu visas formalitātes , būtu daudzas reizes jābraukā uz pagastu un rajonu , būtu jāmaksā visādas naudas .	jābraukā	8	Nec
Iespējams , ādas kroku kopšanai jālieto pat higiēniskās salvetes un borskābes šķīdums .	jālieto	5	Nec
Lai es pamestu savus bērnus ?	pamestu	2	Cnd
Jāpiebilst , ka žūrija bija kompetenta .	Jāpiebilst	0	Nec
« Ar visiem strīdiem mēs apstiprinājām , ka ir jāvirzās uz priekšu un valdība ceturtdien ir jāapstiprina , » Kučinskis norādīja .	jāapstiprina	16	Nec
Lai es šķaidītos uz nebēdu , lai es pasaulei gaismu rādītu .	šķaidītos	2	Cnd
Reģistrējoties uz šo fakultatīvo kursu , studenti parakstīja dokumentu , kurā viņi piekrita , ka gadījumā , ja ainas būs pārāk atklātas , viņi drīkstēs atstāt auditoriju .	parakstīja	7	Ind
Varēja dzirdēt bērnu sarunas ar vecākiem , kur bērns izteica vēlēšanos apmeklēt mākslas skolu .	Varēja	0	Ind
Sieviete pakļāvās .	pakļāvās	1	Ind
To sakot , man pat nav jāpiedomā , vai tā ir patiesība .	jāpiedomā	6	Nec
— Ja gribi strādāt ar citām metodēm , lai skolēniem ir interesanti , nevis sniegt tikai mācību grāmatā atrodamās zināšanas , tad ir daudz jāgatavojas .	jāgatavojas	24	Nec
Ģenerālsekretārs atkal pasvītroja , ka šādas idejas realizācija izslēgtu Čehoslovākiju no Austrumeiropas drošības sistēmas , kas , pēc viņa domām , bija pozitīvs moments .	izslēgtu	8	Cnd
Tāpat kā pirms septiņpadsmit gadiem , 1991. gada janvārī , sildīja ugunskuri , bet Vecrīgā nebija barikāžu , un cilvēki negaidīja X stundu .	sildīja	10	Ind
Taču , kā parādīju iepriekš , lai ietvari būtu efektīvi , tam ir jābūt atbilstošai sociālai bāzei un tiem ir jāsaskan ar potenciālo kustības dalībnieku pieredzi .	jāsaskan	20	Nec
Pamēģini noskaidrot , kā lai mēs tiekam ārā .	Pamēģini	0	Imp
Balsis skan tā , it kā es atrastos lielā flīzētā telpā .	atrastos	7	Cnd
Tāpat kā noteikti kādreiz jāaizstaigā uz Rīgas Biržu , Daugavas stadionu vai kādu laikmetīgā teātra izrādi .	jāaizstaigā	4	Nec
Un noliec zīmuli . ”	noliec	1	Imp
Mūsu uzdevums nav tikai skatīt sūdzības , mūsu darbiniekiem ir jāstaigā arī pa veikaliem un jāpārbauda , vai netiek tirgotas nedrošas rotaļlietas un elektropreces .	jāpārbauda	15	Nec
Tāpēc viņi necenšas mācīties , bet te vēl arī mācīties grūti , tālab viss pasliktinās ...	pasliktinās	14	Ind
Sofija mēģināja iztēloties , kā viņa pastiepj sveicienam roku un nosauc savu vārdu — Sinēve Amundsena , bet nē , to bija grūti iedomāties .	nosauc	10	Ind
Pirms nedēļas Irēna Pulkinena atlidoja uz dzimteni , kur pavadīs vasaras mēnešus .	pavadīs	9	Ind
Dažiem dzima līdzīga doma kā Darvinam .	dzima	1	Ind
Tādēļ pēc peldēšanās nevis enerģiski jāslaukās , bet rūpīgi jānosusinās .	jāslaukās	5	Nec
Pieaugot mēs acīmredzami zaudējam savas spējas izjust pārsteigumu par pasauli .	zaudējam	3	Ind
Dzīve turpinātos .	turpinātos	1	Cnd
Svīšanu nevajag censties nomākt , tomēr ir jāmazgājas regulāti neatkarīgi no svīšanas intensitātes .	jāmazgājas	7	Nec
Viss notika tā , kā tam bija jānotiek .	jānotiek	7	Nec
Grūbas vari arī uzsildīt un tad sajaukt ar visu kopā , bet tādā gadījumā atceries , ka piparmētras jāpiejauc tieši pirms pasniegšanas .	jāpiejauc	18	Nec
Uzzinot , ka TV3 gatavojas publiskot šo informāciju , Telešs ceturtdien iesniedza atlūgumu .	iesniedza	11	Ind
Labu brīdi viņi klusēdami cīnījās , mati sakrita ap seju , kājas slīdēja uz zaļganā ledus spoguļa , zvaigznes ziņkārīgi nolūkojās no augstumiem un arī no saviem atspulgiem zem viņu kājām .	sakrita	7	Ind
Projekts tiek vērtēts kā veiksmīgs , jo tas bija veicinājis Baltijas valstu savstarpējo militāro integrāciju un nodrošinājis nepieciešamo apmācību un personāla kvalifikāciju , lai piedalītos starptautiskajās operācijās .	piedalītos	24	Cnd
Es ļoti vēlētos , lai mūsu attiecības uzlabotos .	vēlētos	2	Cnd
Bet piekrītat , ka viss sievietes skaistums ar koptām rokām , skaistu frizūru un make-up nobālēs , ja viņa uzliks krāšņas baskājiņas un āda uz papēžiem būs nolupusi un kāju nagi būs nevīžīgi nogriezti .	piekrītat	1	Ind
Par to , ka sadarbībai nevarētu būt ne vainas , abas puses jau bija pārliecinātas pirms darbu sākšanas , jo , lai cik dīvaini tas arī nešķistu , Kubs ir uzvarējis visās Sprīdīšos organizētajās cenu aptaujās .	nešķistu	26	Cnd
Jāatzīst , ka daudzās no tām bija pausts patiess prieks par notiekošo .	Jāatzīst	0	Nec
Aicinu ikvienu , kuram nav vienaldzīgi šie jautājumi , atbalstīt jaunās māmiņas viņu aktivitātēs , jo runa ir par dārgāko , kas mums ir , — par mūsu bērniem !	Aicinu	0	Ind
AP ziņo , ka apsūdzības pusei ir jāizpēta ap 30 tonnu dokumentu un citu pierādījumu .	jāizpēta	7	Nec
( 10 ) Attiecīgi ir jāgroza Direktīva 80 / 987 / EEK .	jāgroza	5	Nec
Lai tiktu pie fotouzņēmuma retro stilā , būs jādodas uz foto salonu " Pie Bartiljona " , kas iekārtots Lielās ģildes otrajā stāvā .	tiktu	1	Cnd
Tas ir iemesls , kādēļ uzsākām digitalizācijas programmu , lai laikrakstus digitalizētu .	digitalizētu	11	Cnd
Viņš aicināja Vāciju prasīt jauna kolektīva līguma noslēgšanu Austrumeiropā , kas atvietotu PSRS un Francijas līgumu sistēmu .	atvietotu	11	Cnd
Tad tantes bija tā sakaunējušās , ka nākamajā reizē sanesa tik daudz , ka visam grozā nebija vietas , ” atceras ilggadējais zakristians .	atceras	20	Ind
Nātans Moriss kristīgajai ticībai pievērsās 2001. gadā , bet jau 2006. gadā sāka kalpošanu " Sapurini valstis " , apceļojot dažādas pasaules valstis un sludinot cilvēkiem " Labo vēsti " .	Sapurini	15	Imp
Likumdevējam rūpīgi jāseko , lai pieņemtie krimināllikumi atbilstu reālās dzīves prasībām , gan neatpaliekot , gan arī pārāk neapsteidzot tās , kļūstot par bezsatura normām .	jāseko	2	Nec
Es nezinu , vai Saeimā tiešām ir jāpieņem speciāls likums , lai skolās aizliegtu tirgot kokakolu un ēst tur šos čipsus un tā tālāk .	jāpieņem	7	Nec
Mātes sejai pārslīdēja raižu pilna izteiksme .	pārslīdēja	2	Ind
Neviens nav guvis peļņu , aizņemoties naudu , lai iegādātos drēbes , apmeklētu restorānus vai izklaidētos .	apmeklētu	12	Cnd
Prot izmantot lietošanas pamācību marķējumu , lai izvēlētos kosmētikas , mazgāšanas un tīrīšanas līdzekļus .	izvēlētos	7	Cnd
Likās , Baņuta tik ilgi tur viņas roku un skatās acīs .	Likās	0	Ind
Neesmu no tām , kura pārdomā katru žestu pirms izrādes – tēlam jāpiedzimst mirklīgi , tikai tad tas būs pa īstam .	jāpiedzimst	12	Nec
Ģenerālsekretārs pēc tam nosūta ierosināto labojumu dalībvalstīm ar lūgumu norādīt , vai tās pieprasa sasaukt dalībvalstu konferenci , lai izskatītu šos priekšlikumus un sarīkotu par tiem balsošanu .	izskatītu	19	Cnd
Pēteris Skudra strādā , trenē Kontinentālās hokeja līgas komandu , arī viņam noteikti nav pedagoģiskās izglītības , un , lai arī cik veiksmīgi viņš tur strādātu un trenētu , Latvijā viņš nevar darboties .	trenētu	27	Cnd
Stratēģiskā novērtējuma izstrādi reglamentē Novērtējuma likums un Noteikumi Nr. 157.	reglamentē	3	Ind
Tiesa , jāatzīst , ka šobrīd Latvijā vēl nav izstrādāta vienota , pabeigta un ilgtermiņa krimināltiesību politika .	jāatzīst	2	Nec
Vizītes sākumā ministrs tiksies ar Ādažu novada domes priekšsēdētāju , domes deputātiem un administrācijas vadību , lai pārrunātu finanšu un ekonomikas jautājumus novadā pēc finanšu stabilizācijas uzsākšanas , kā arī iepazītos ar novada attīstības plāniem .	iepazītos	30	Cnd
Viņas vietniece Linda Krēgere piebilst , ka ir svarīgi , lai arī mazi bērni nāktu un interesētos , jo viņi atrodas lielākajā riska grupā .	interesētos	16	Cnd
Man ir jau sešpadsmit , un es tā mostos katru rītu pirms skolas .	mostos	8	Ind
Radu un veco draugu pulks priecīgi sveica atnācēju , un pane Agata sirsnīgi pateicās par dāvanu un ziediem .	sveica	6	Ind
Kā norāda EK , ļaut publiskajiem izdevumiem saistībā ar novecošanos palielināt budžeta deficītu , nozīmētu izveidot nepanesamu parāda slogu , kas attīstās spirālveidīgi .	nozīmētu	14	Cnd
Cieta ļoti daudzi , bet jāatceras ir tas , ka vislielākie cietēji šajā ģeopolitiskajā katastrofā bija paši agresori , paši Otrā pasaules kara izraisītāji .	jāatceras	5	Nec
Tiem , kuri ir iemīlējušies , ir ārkārtīgi grūti būt šķirtiem , tie ir smagi pārdzīvojumi , dažkārt pat jāiestāsta sev , ka tu ienīsti cilvēku , kuru patiesībā mīli .	jāiestāsta	19	Nec
Tādēļ pirms katra pirkuma , kura apmaksai būtu jāizmanto kredītkartes kredīta līdzekļus , izvērtējiet – vai tiešām šī prece / pakalpojums ir nepieciešams ?	izvērtējiet	13	Imp
Taču tās ir labas ziņas uzņēmējiem , kuriem vairs nav jāpieņem darbā tie cilvēki , kuri ir pieejami , bet kuri , gadījumā ja parādās vakantās vietas , var sākt izvēlēties labākos kandidātus .	jāpieņem	10	Nec
Ja tādu nav pie rokas , derēs parastais spolīšu diegs : izveido vaļīgu cilpu , apliec ap ērces galvu ( to daļu , kas vistuvāk dzīvnieka ādai ) , cieši savelc un pavelc .	apliec	15	Imp
Ikvienam mums šis laiks saistās ar kaut ko savu .	saistās	4	Ind
Sīpolu notīra , smalki sagriež , ķiploku daiviņas notīra un izspiež caur ķiploku spiedni .	notīra	8	Ind
Pagaidām produkciju tirgojam Latgales pilsētās .	tirgojam	2	Ind
Ļaudis nav kaijas , lai bēgtu pār jūru , tiem vajag laivu .	bēgtu	5	Cnd
Pētījuma gaitā novērots , ka zemieņu upēs ar grants , oļu grunti , nav izveidojies dūņu slānis , lai arī upes ir pilnībā aizaugušas ar makrofītiem un straumes kustība vasarā nenotiek vai arī ļoti neliela .	nenotiek	30	Ind
Viens no redzamākajiem ES veicinātiem fenomeniem ir brīva darbaspēka kustība , kas Latvijas gadījumā nozīmēja strauju ietekmi uz demogrāfisko situāciju , proti , starptautiskās migrācijas neprognozēti augstu pieaugumu .	nozīmēja	14	Ind
Vīrietis mēģināja izrauties , bet tūdaļ palīgā piesteidzās arī vienības " Aras " komandieris Viktors Grabausks .	piesteidzās	7	Ind
Knuta Hamsuna Bads man ir kā tāds etalona romāns , kas , man šķiet , jāizlasa katram .	jāizlasa	15	Nec
Viņš izberzēja acis un tālumā pamanīja zemi .	pamanīja	5	Ind
Piemēram , kāda ir pacienta personīgā higiēna , gadoties , ka pirms operācijas slimnieks vispirms pamatīgi jānomazgā .	jānomazgā	16	Nec
Kad zvans ziņoja , ka beigusies pēdējā stunda , viņa devās prom no skolas pagalma tik ātri , ka Jūrunai vajadzēja skriet , lai viņu panāktu .	panāktu	25	Cnd
Sieviete gribēja , lai jūrā plīkšķētu milzīgi viļņi , kuru putainās piles brīžiem aizskartu viņas seju , lai spēcīgs vējš dzenātu tukšās gliemežu čaulas un aizpūstu viņas nemieru pāri lielajai smilšu kāpai .	plīkšķētu	5	Cnd
Viņš pēc vidusskolas aizgāja strādāt uz televīziju un arī teica , ka nav ko čammāties un jātaisa īsts kino .	jātaisa	16	Nec
Lai izvairītos no nepareizas domāšanas , pirmkārt , būtu nepieciešams izskaidrot šo divu jēdzienu nozīmi .	izvairītos	1	Cnd
Ja torņi būtu šķībi , tad tajos cilvēkiem neļautu dzīvot .	neļautu	8	Cnd
Ja visu saliek pa plauktiņiem , neapgalvošu , ka uzvarējām likumsakarīgi , tomēr nevar teikt , ka mūsu uzvara bija nepelnīta .	saliek	2	Ind
Tur ir informācija , bibliotekārs , kurš pie datora palīdz cilvēkam atrast informāciju un lasīt Šajā datorā , jo bieži ir informācija , kas drīkst būt pieejama tikai bibliotēkas telpās saistībā ar aulortiesību ierobežojumiem un tā lālāk .	palīdz	9	Ind
Emma Vedžvuda ( 1808 – 1896 ) ar brālēnu Čārlzu apprecējās 1839. gadā .	apprecējās	10	Ind
Blenderī liec visas sastāvdaļas , izņemot ledu , un sasmalcini .	liec	1	Imp
Nevarēdamas vairs izturēt komunālās šausmas , mēs ar mammu apņēmāmies darīt visu , lai tiktu laukā no tās pekles .	tiktu	14	Cnd
Netēlo varoni .	Netēlo	0	Imp
Kāpēc viņš nevarētu runāt par to , kas ir cilvēks vai kas ir pasaule un kā tā radusies ?	nevarētu	2	Cnd
Vēlētos arī turpināt padziļināti pētīt kristīgās un teoloģiskās izglītības jautājumus , veltot tiem atsevišķu monogrāfiju .	Vēlētos	0	Cnd
Intervētāji jāiepazīstina ne tikai ar intervēšanas taktiku , bet arī praktiski jāizmēģina dzīvesstāsta un dzīves vēstures intervijas veidi .	jāizmēģina	11	Nec
Krītoties skolotāju prestižam , nākas maksāt lielāku atalgojumu izglītības sistēmā strādājošajam , lai viņš nemeklētu darbu citā jomā .	nemeklētu	14	Cnd
Atgriežoties pie jautājuma par dažādiem pedagoģijas iekšējās loģikas kritērijiem , ir jānorāda , ka katrs no tiem var būt redzams vai neredzams .	jānorāda	11	Nec
Tas , ka tādu mazu mājeli var celt bez dokumentiem , man ir ļoti svarīgi , jo dzīvoju un strādāju Rīgā , bet mans lauku īpašums atrodas pusotras stundas brauciena attālumā .	strādāju	19	Ind
Maratona organizatori ir īpaši parūpējušies par to , lai bērni un vecāki pasākuma laikā justos droši .	justos	14	Cnd
Pedagogu mērķis bija lielveikala « Maxima » rīkotajā uzlīmju konkursā tās sakrāt vienam galda tenisa galdam , lai dinamiski aizpildītu starpbrīžus , taču ieguvums ir daudz lielāks .	aizpildītu	19	Cnd
Tomēr Helēna ievēroja , ka cēlā vīra acis , raugoties uz viņu , pildās ar neapvaldāmām , nenoslēpjamām skumjām , kas draudēja pārvērsties par daudzām stikla bumbiņām , kas tad neapturami ripotu un plīstu , ripotu un plīstu .	ripotu	31	Cnd
Atjaunotā valsts piedzīvoja to , kam pēc civilizācijas attīstības plāna bija jānotiek septiņdesmitajos .	jānotiek	11	Nec
Lai identificētu darbaspēka pieprasījumu , tiek veikta darbaspēka tirgus pārbaude .	identificētu	1	Cnd
Nu , mēs jau nespriežam !	nespriežam	4	Ind
Sacensības notika desmit laivu klasēs , kurās piedalījās ne tikai Igaunijas , Lietuvas un Latvijas , bet arī Krievijas sportisti .	piedalījās	7	Ind
„ Es labāk iešu dārzā , ” viņa nodomāja .	nodomāja	8	Ind
Pārskata metodoloģijas pamatā bija veiktās sabiedrības aptaujas par indivīdu galvenajiem nedrošības cēloņiem , cenšoties identificēt , kuras ir aktuālākās cilvēkdrošības jomas , kurās valdībai būtu jāuzņemas lielāka atbildība .	jāuzņemas	25	Nec
Tie darbojās tā , lai laistu caur sevi maksimālo dienas gaismas daudzumu ( Tv = 38 % ) pie paaugstināta mākoņainuma un minimālu dienas gaismas daudzumu laistu saulainā laikā ( Tv = 11 % ) .	laistu	26	Cnd
Nogrieziet nagus , piešķiriet tiem glītu formu .	piešķiriet	3	Imp
Jāsaka , ka literatūra šobrīd nav slikta .	Jāsaka	0	Nec
Cilvēkiem , kuriem bija jākustas , lai domātu . ”	jākustas	4	Nec
„ Es domāju , būs jākāpj augšā un jāsāk gatavot mājasdarbu dabasmācībā , ” viņa teica kā atvainodamās .	jākāpj	5	Nec
Es nezinu , vai Saeimā tiešām ir jāpieņem speciāls likums , lai skolās aizliegtu tirgot kokakolu un ēst tur šos čipsus un tā tālāk .	aizliegtu	13	Cnd
Ja jau SAB varas ir par daudz , tad tā kādam ir jāatdod , un nav arī grūti uzminēt - kam _ tieši .	jāatdod	12	Nec
Mēs visu dzirdējām .	dzirdējām	2	Ind
( 7 ) Darba devējam aizliegts bez attiecīgās arodbiedrības piekrišanas uzteikt darba līgumu arodbiedrības pilnvarotajai amatpersonai , kura pilda pārstāvja pienākumus , izņemot likumā noteiktos gadījumus .	pilda	18	Ind
Bet 1223. g. Dānijas vara Igaunijā sabruka , un zuda arī ordeņa cerības sadarbībai pret Albertu .	zuda	9	Ind
Sarunas beigās ārsts aizgāja , apsēdās blakus Džilianai un teica : „ Esmu noklausījies visu , ko stāstīja tava mamma , Man jāparunā ar viņu divatā . ”	jāparunā	22	Nec
Kāda formāta grāmatas jūs pats šobrīd lasāt - papīra vai no planšetēm ?	lasāt	6	Ind
Reuters ziņo , ka pēc prezidenta aizbraukšanas Portoprensā valda anarhija , ielās patrulē bruņotas bandas .	valda	8	Ind
Es vēlos , lai Tu dzīvotu ar atvērtu skatu .	dzīvotu	5	Cnd
Pirmo apskatīja tēti , taču ļaunajiem gariem nepatika viņa spēks , viņi pat bijās no tā .	bijās	13	Ind
Ja dzīvotu Amerikā , viņa būtu karsējmeitene un visi zēni beigtos nost viņas dēļ .	beigtos	10	Cnd
52. Veicot amatnieka pakalpojumus un kapu kopšanas darbus , mehānismi un materiāli jānovieto tā , lai netraucētu kustību kapsētā .	netraucētu	16	Cnd
Musulmaņu zemēs trūka kokmateriālu kuģu būvniecībai , un venēciešu tirgotāji bija naski izejmateriālu piegādātāji par spīti tam , ka šos kuģus gatavojās izmantot cīņā pret eiropiešu krusta karotājiem .	gatavojās	21	Ind
Grūbas vari arī uzsildīt un tad sajaukt ar visu kopā , bet tādā gadījumā atceries , ka piparmētras jāpiejauc tieši pirms pasniegšanas .	atceries	14	Imp
Lai vai kā , mēs ar Džilianu kādudien pusdienojām , un es vaicāju : „ Kā tu kļuvi par dejotāju ? ”	pusdienojām	8	Ind
Diena pirms Jāņiem ir Zāļu diena , kad meitām jālasa jāņuzāles , kuras izžāvē , lai vēlāk lietotu pret slimībām .	jālasa	9	Nec
Krievijas miera uzturēšanas spēku kontingents uzturas Piedņestras apgabalā vēl joprojām .	uzturas	5	Ind
To vien dzirdam , ka Latvijā iznīkst ražošana .	iznīkst	6	Ind
Viņš slimo ar hipohondriju .	slimo	1	Ind
Tilta vidū ļaudis pulkiem metas pāri autostrādei uz otru malu , kas tuvāka centram .	metas	4	Ind
— Nu lien ārā !	lien	2	Ind
Un atkal jāpadomā – vai mēs tik ļoti neesam iegrimuši skumjās , ka pat aizmirstam par tām darīt zināmu mūsu skumju objektam ?	jāpadomā	2	Nec
Tieši Valensijā ir jāēd paelja .	jāēd	3	Nec
Savukārt tukšā skatuve eksistē kā audekls , kurā no nekurienes iznirst V. Daudziņa Hermaņa iedomātas lietas un parādības – varonim tā ir subjektīva , atmiņu telpa , vienlaikus tā ir arī teātra kā mākslas veida zīme .	iznirst	10	Ind
Taču šis spriedums , kurš ir jāievēro visām Latvijas tiesām , ir pretrunā vismaz ar Satversmes 91. pantu , kas nosaka , ka visi cilvēki Latvijā ir vienlīdzīgi likuma priekšā .	jāievēro	6	Nec
Laikam jau zaglis vai blēdis nebūs — nodomāja Ieva .	nodomāja	7	Ind
Tā vietā ar siltu spēku atsāka pukstēt sirds .	atsāka	5	Ind
Jo ir dažādi teātri , dažādi atalgojumi un nav noslēpums , ka tobrīd man piedāvāja mazākus honorārus , nekā dažā operteātrī saņēma koristi .	saņēma	21	Ind
Uzticiet savas rokas tikai augsta līmeņa speciālistiem .	Uzticiet	0	Imp
Jāņu naktī dzīvoklī vai mājā jānes pīlādžu zari un istabas jākaisa ar kalmēm .	jākaisa	10	Nec
Gan sievietes , gan vīrieši baidās par to runāt , klusē , neko nedara , kamēr nereti problēma tiešām samilzt līdz grūti risināmiem apmēriem .	samilzt	19	Ind
Svētdien Latvijai no dienvidrietumiem pietuvosies ciklons , kura centrs atradīsies virs Zviedrijas dienvidiem , un ar šo ciklonu saistīta nokrišņu zona šķērsos Latviju .	pietuvosies	4	Ind
68. Saiņi jāaizzīmogo ar iecirkņa komisijas zīmogu .	jāaizzīmogo	2	Nec
Tā iznāks diezgan bieza , tādēļ ar karoti vai lāpstiņu tā būs jāizlīdzina , lai tā vienmērīgi apklāj visus ābolus .	jāizlīdzina	12	Nec
Tomēr mērenība jāievēro ne tikai saules peldēs .	jāievēro	2	Nec
Tad izkās , pievieno raugu , cukuru , visu samaisa .	samaisa	9	Ind
Kuriem bija jākustas , lai domātu .	jākustas	2	Nec
Vai tad viss ir jāregulē Saeimai ?	jāregulē	4	Nec
Protesta norisi vēroja septiņi policisti .	vēroja	2	Ind
Lai labāk ilustrētu iegūto skaitļu nozīmi , tie ir jāpaskaidro reālos un ar pētāmo jautājumu saistītos lielumos .	ilustrētu	2	Cnd
Šobrīd nav izdevies atrast pētījumus , kas parādītu , kā Latvijas vispārizglītojošo skolu tīklu varētu ietekmēt gaidāmā pašvaldību reforma , tomēr nenoliedzami tā arī atstās savu ietekmi .	parādītu	7	Cnd
bet man kādam ir jāpasaka ...	jāpasaka	4	Nec
Vai var saskaitīt , cik cilvēku bijis pie Elijas ar savām vajadzībām , un viņa katram sniegusi padomu : kas tieši jādara , uz kādu kantori jādodas tālāk , ja uz vietas līdzēt nevar .	jādodas	26	Nec
Viņai ir tikai viena iespēja sadarboties ar bērnu - mātei ir jāpakļaujas bērna pētniecības tieksmei .	jāpakļaujas	11	Nec
Šī procedūra tiek izmantota mazākumā gadījumu , jo lielākā daļa darba migrantu imigrē , lai strādātu tajās profesijās , kas ir iekļautas darbaspēka tirgus pārbaudes izņēmumu sarakstā .	strādātu	15	Cnd
Es domāju , ka viņš ir viens no tiem nedaudzajiem politiķiem , kas lieki nešķiežas ar vārdiem un atbild par savu teikto vārdu .	nešķiežas	14	Ind
Mēs zinām , ka pasaule nav nekādi joki vai acu apmāns , jo mēs staigājam pa Zemes virsu un mēs paši esam pasaules daļa .	zinām	1	Ind
Un šajā jautājumā vecākiem būtu ļoti nopietni jāseko tam , kā aukle to nodrošina un kāds ir viņas mērķis .	jāseko	7	Nec
Izbrīnu izraisa arī tas , ka šī plāna realizēšanas gadījumā būtu jāpieļauj tik dedzīgi noliegtā PSRS karaspēka ielaišana savā teritorijā .	jāpieļauj	11	Nec
Tāpēc etniskās mobilizācijas pieeja koncentrējas uz aizvainojumu formulēšanu etniskās salīdzināšanas un relatīvā zaudējuma terminos .	koncentrējas	4	Ind
Nostiprini paletes pamatni , šim nolūkam izmanto dažas papildus sloksnes vai koka brusas .	Nostiprini	0	Imp
Kā būtu , ja viņu sauktu kāda citā vārdā ?	sauktu	5	Cnd
Izsakoties par Turcijas tirgu , Maligins atzina , ka ir jārēķinās ar zināmiem ierobežojumiem .	jārēķinās	10	Nec
Jau pēc pārdesmit minūtēm Alekša automašīna ieripinājās Latvijas teritorijā .	ieripinājās	6	Ind
Viņi pārāk daudz laika velta nenozīmīgām detaļām nevis tādēļ , ka pietrūktu intelekta nozīmīgiem darbiem , bet tādēļ , ka baidās no neveiksmes .	pietrūktu	11	Cnd
Lai palutinātu ķermeņa ādu un tā nezaudētu elastību , vislabāk ieteicams izmantot sezama eļļu , kas ajūrvēdā ir pazīstama kā universāls līdzeklis gan ārīgai , gan iekšķīgai lietošanai .	nezaudētu	6	Cnd
" Es aicinu premjerministru pavēlēt atsaukt nemieru apspiešanas policijas vienības , lai atslābinātu saspīlējumu , ” teikts mēra vēstulē .	atslābinātu	12	Cnd
Baltijas valstis cenšas panākt , lai ES izstrādātu kopīgu politiku , uzskatot , ka tai ir izšķiroša nozīme laikā , kad valda bažas , ka Krievija varētu izmantot savu ietekmi enerģijas tirgū .	izstrādātu	7	Cnd
Jums ar steigu jāievēl cits , kas var tikt galā ar šiem pienākumiem , — aicināja M. Bērzlaps .	jāievēl	3	Nec
Tātad projekta realizācijai būtu nepieciešami vairāki duplikāti katram cilvēkam , kas izmaksu ziņā pārsniegtu jebkādas saprāta robežas .	pārsniegtu	13	Cnd
Viņi ir bezķermeniski , ziniet , savā ziņā burtiskā nozīmē .	ziniet	4	Imp
Mēs arī redzam , kā bērns lēkā augšā lejā savos ratiņos un plātās ar rokām : „ Vau - vau !	plātās	12	Ind
Cilvēki plūda uz Sabīnes atdusas vietu , lai čukstētu « Skuiviņš zina , Skuiviņš zina » .	čukstētu	8	Cnd
Bet viņa tik un tā peldēs .	peldēs	5	Ind
Viens pieklājīgi palūdza atnākt rīt , jo pirmdienas rītā viņam slikti strādājot galva .	palūdza	2	Ind
Uz viņas mīksti grumbainā vaiga noritēja aizkustinājuma un pārsteiguma asara , bet , būdama īsta dāma , viņa saņēmās .	noritēja	5	Ind
( Šis radījums ierokas dziļi atpakaļ truša kažokā , nogulstas uz labajiem sāniem un tā pavada visu savu mūžu . )	pavada	15	Ind
Meitene ilgi aplūko istabu , tad noliek uz rakstāmgalda pelnutrauku , atbīda krēslu , apsēžas un pamana , ka izdegusi cigarete .	apsēžas	14	Ind
Tas nozīmē , ka valdība neuzticas tautai , no jautājuma atklātas izvērtēšanas Saeimā baidās , bet ikvienām bailēm no atklātas diskusijas pamatā ir vai nu savtīgas intereses , vai arī argumentu trūkums .	neuzticas	5	Ind
Lai drīkstētu organizēt preču vai pakalpojumu loteriju , komersantam , kas ražo , izplata , pārdod preces vai sniedz pakalpojumus , Izložu un azartspēļu uzraudzības inspekcijā ( IAUI ) jāsaņem loterijas atļauja .	drīkstētu	1	Cnd
Tāpat finanšu ministrs ar pašvaldības amatpersonām pārrunās novada demogrāfijas problēmu , lai rastu risinājumu rindu uz bērnudārziem pašvaldībā , kā arī tiks iepazīstināts ar aktuālo situāciju izglītības iestāžu darbību .	rastu	12	Cnd
Taču jāatzīst , ka , apejot Tieslietu ministrijas darba grupas , Saeimā nonāk arī daudzi pietiekami nesagatavoti likumprojekti .	jāatzīst	1	Nec
Ja šodien deputāti V. Putinu amatā apstiprinās , viņam nedēļas laikā būs prezidentam jāierosina jaunā valdības struktūra un personālsastāvs .	jāierosina	13	Nec
Augstajai amatpersonai atlika vien pastarpināti uzsvērt savas bažas par pieaugošās eiro vērtības ietekmi uz ekonomiku , lai kopējās valūtas cena strauji samazinātos .	samazinātos	21	Cnd
Tādēļ pēc peldēšanās nevis enerģiski jāslaukās , bet rūpīgi jānosusinās .	jānosusinās	9	Nec
Sapnī es turēju bērnu , piespiestu sev pie krūtīm .	turēju	2	Ind
Mazie apsolīja .	apsolīja	1	Ind
Es aizsūtu īsziņu ar aicinājumu satikties , lai atdotu naudu .	atdotu	8	Cnd
Iedomājies , viņš pat peldēt nemāk .	Iedomājies	0	Imp
Darbu tik daudz , ka diennaktij jāpieliek papildus stundas ?	jāpieliek	6	Nec
Ja Vilnis nokristu , Māris viņu nevarētu izglābt .	nokristu	2	Cnd
Pirms pērc kādu produktu , pārdomā , kā tas tiks izlietots .	pārdomā	5	Imp
Artēmijs gājis pa priekšu , bet meitene gaidīja , kamēr viņš būs nozudis aiz viesnīcas durvīm , lai pati dotos iekšā , novērojuši acīgie krievu žurnālisti .	dotos	19	Cnd
( 5 ) Lai attiecīgajiem darbiniekiem nodrošinātu taisnīgu aizsardzību , maksātnespējas definīcija ir jāpiemēro jaunajām likumdošanas tendencēm dalībvalstīs un šajā jēdzienā jāiekļauj arī maksātnespējas procedūras , kas nav likvidācija .	jāpiemēro	13	Nec
Vispirms bija daudz lētas naudas , ko komercbankas izdalīja tautai – mājokļa iegādei un spekulantiem .	izdalīja	8	Ind
Gūsta vietā Madridē ieradās Angulēmas Margarita un , lai atbrīvotu brāli Francisku I , viņa lika lietā savu diplomātes un stāstnieces talantu .	atbrīvotu	9	Cnd
Saprotiet : kad izveidojas ārkārtas situācija , tad pašvaldības vadītājam nu jābrauc acīmredzot pie nozares ministra ( ja , protams , viņš tur var piekļūt pie viņa ) , nozares ministrs dodas uz Ministru kabinetu , visi spriež ...	Saprotiet	0	Imp
Pirms katras ārsta vizītes pavaicā vīram , vai viņam nav kādi jautājumi , ko arī viņš vēlētos uzzināt .	vēlētos	16	Cnd
Bet galvenais — kā mums šodien būtu jādzīvo ?	jādzīvo	7	Nec
Kam tev jārādās ?	jārādās	2	Nec
Kalvenes pamatskolā apliecina , ka savāktā makulatūra nesen aizvesta , nu skolēni sākuši gaidīt apsolīto zīmēšanas papīru .	apliecina	2	Ind
Nešaubos , ka izdzīvosim arī šogad .	izdzīvosim	3	Ind
Pīlādža zariem jāstāv istabā , kamēr lapas nokaltušas , tad tie jānobrauka , turot aiz galotnes un braukot uz resgali , jāsalauž deviņos gabalos ; tos izmētā krustām šķērsām pa istabu un sabāž gultas maisos .	sabāž	32	Ind
Nē , viņai šis tas padodas , bet , ja viņa gatavo , viņa vienlaikus runā pa tālruni , viņa runā ar bērniem , viņa krāso griestus , un taisa atvērto sirds operāciju .	gatavo	11	Ind
Jāatzīst , ka Andris ir viltīgs – viņš ievilina slazdā , aizver to ciet un uzreiz brūk virsū par nevainīgiem jautājumiem .	Jāatzīst	0	Nec
Skanēja daudzi paldies : celtnieki izteica prieku par labo sadarbību ar pansionāta vadītāju Signi Matisoni , viņa , savukārt , uzteica celtniekus .	uzteica	20	Ind
Mežs aiz automašīnas stikla pina zaļganzeltainas intrigas .	pina	4	Ind
Izskatījās , ka nācējs uz muguras nes lielu , smagu nastu .	nes	6	Ind
Es uzreiz piezvanīju meistariem , jo domāju , ka puisis blefo , lai tikai tiktu atpakaļ uz Rīgu .	tiktu	14	Cnd
Pēdējā minūtē Kazahstānas izlase nomainīja Koļesņiku pret sesto laukuma spēlētāju un iespieda Latviju tās aizsardzības zonā .	nomainīja	4	Ind
Visādā ziņā tam ir jābūt kaut kam zaļam , jo mēs taču negribētu pārbiedēt pastnieku .	negribētu	12	Cnd
Un rokas vairs tādas nepavisam neliekas pēc kāruma notiesāšanas — kārums ir barojošs ...	neliekas	5	Ind
Es tā negribēju , es saku , piedod , es vairāk tā nedarīšu .	piedod	7	Imp
Gultā viņam nav jādara pilnīgi nekas , lai es nonāktu līdz orgasmam .	nonāktu	9	Cnd
Saki , ka mēs būtu gribējuši saņemt mīlestību un atbildēt uz to , taču tagad mēs esam nomaldījušies .	Saki	0	Imp
( 5 ) Lai attiecīgajiem darbiniekiem nodrošinātu taisnīgu aizsardzību , maksātnespējas definīcija ir jāpiemēro jaunajām likumdošanas tendencēm dalībvalstīs un šajā jēdzienā jāiekļauj arī maksātnespējas procedūras , kas nav likvidācija .	jāiekļauj	21	Nec
Tomēr Helēna ievēroja , ka cēlā vīra acis , raugoties uz viņu , pildās ar neapvaldāmām , nenoslēpjamām skumjām , kas draudēja pārvērsties par daudzām stikla bumbiņām , kas tad neapturami ripotu un plīstu , ripotu un plīstu .	ripotu	35	Cnd
Lai augi visu enerģiju veltītu pākšu nobriedināšanai , kad lauka pupas ir uzziedējušas , tām nokniebj galotni .	veltītu	4	Cnd
Ar skumjām mēs subjektīvi it kā cenšamies viņam pietuvināties , noturēt to .	cenšamies	6	Ind
Lai vai kā , mēs ar Džilianu kādudien pusdienojām , un es vaicāju : „ Kā tu kļuvi par dejotāju ? ”	vaicāju	12	Ind
Tēvs izšķīra sievietes un , lai netraumētu bērnu , nolēma lūgt meitenēm doties mājās , " iepriekš stāstīja advokāts .	netraumētu	6	Cnd
Paberzējiet pēdas ar mīkstu birstīti apļveida kustībām .	Paberzējiet	0	Imp
Mani izrakstīšot no slimnīcas , bet būs jādodas uz reabilitācijas centru .	jādodas	7	Nec
Bet ir arī viena kategorija cilvēku , kas apliecina šausmas , kas ar viņiem notikušas , ko narkotikas viņu dzīvei nodarījušas .	apliecina	8	Ind
Dārzā jāstrādā , jāstrādā un jāstrādā : jāstāda jauni kociņi , jāizzāģē zari , jāsmidzina pret dažādiem kaitēkļiem , jānovāc raža .	jāsmidzina	14	Nec
Vai cilvēkam nevajadzētu būt kaut kam pārākam par mašīnu ?	nevajadzētu	2	Cnd
Šeit gan es gribu vērst uzmanību uz Somijas piemēru , jo 1939. gadā Somijai ļoti vajadzēja , lai sabiedrotās valstis nāktu palīgā un oficiāli nosūtītu tur savus militāros kontingentus .	nosūtītu	24	Cnd
Bet tūlīt pēc tam sarīkoja milzu trobeli , paziņojot , ka puikas tēvs ir Miks Džegers .	sarīkoja	4	Ind
Okaups norādīja , ka Igaunijai tuvākajās nedēļās ir jādod atbilde , vai valsts piekrīt EK uzstādītajam sodam .	piekrīt	13	Ind
17. Ārstniecības iestādes vadītājs 30 dienu laikā pēc līguma noslēgšanas ar Nacionālo veselības dienestu nosaka lietotāju , kurš ārstniecības iestādes vārdā šajos noteikumos noteiktajā apjomā apstrādā datus veselības informācijas sistēmā :	apstrādā	25	Ind
Sniegs gurkst zem kājām , sals kniebj degunā , ļoti reti garām pabrauc kāda mašīna , ielu spuldzes atrodas tālu cita no citas .	gurkst	1	Ind
Pīlādža zariem jāstāv istabā , kamēr lapas nokaltušas , tad tie jānobrauka , turot aiz galotnes un braukot uz resgali , jāsalauž deviņos gabalos ; tos izmētā krustām šķērsām pa istabu un sabāž gultas maisos .	jāstāv	2	Nec
„ Jā , jā , tas ir vauva , ” saka pie pasaules jau radušais , „ bet tagad nu gan tev ir jāsēž mierīgi ratiņos . ”	jāsēž	23	Nec
Arī līgumi ar lielveikaliem ir jāpilda precīzi , citādi jāmaksā soda naudas .	jāpilda	5	Nec
Saules sistēmas veidošanās un evolūcija ir sākusies pirms 4,6 miljardiem gadu , kad sākās milzīga molekulārā mākoņa nelielas daļas gravitācijas sabrukums .	sākās	13	Ind
Bet , ja atgriežamies pie Frankfurtes , kad tur uzcēla jauno bibliotēku vēl 60. gados , pēkšņi viņi saprata , ka kaut kas nav kārtībā , jo tā bija bibliotēka ar milzīgiem krājumiem , bet lasītavā bija 70 vietu .	atgriežamies	3	Ind
Sākotnēji ir jāsaprot , ka partnera agresija nav domāta tev personīgi , bet viņš to dara , lai jums abiem sekss būtu lielisks , bet , ja nevēlies vairs to – parādi kā jūties : apmainieties lomām .	jāsaprot	2	Nec
Patiesībā , mēs pārcēlāmies no Stratfordas uz Losandželosu .	pārcēlāmies	3	Ind
Sofija juta sirdi iepukstamies straujāk , kad viņa taisīja vaļā vēstuļu kastīti .	juta	1	Ind
Nevarētu gan teikt , ka agrāk svētki būtu bijuši klusi un mierīgi .	Nevarētu	0	Cnd
Brige piezvanīja Rūdolfam , lai viņš nāk pakaļ .	piezvanīja	1	Ind
Nu , ziniet , tā nenotiek .	ziniet	2	Imp
Kulinārijas nodaļas darbs jāvada galvenajam tehnologam , kas apvieno visus posmus , standartizē zudumus un prognozē peļņu .	jāvada	3	Nec
Nevarēsi pačurāt .	Nevarēsi	0	Ind
Pēc tam mēs kādas piecpadsmit minūtes skatāmies televizoru , tas ir kārtējais motelis , un tad viņš saka , ka esot jāsteidzas mājās .	skatāmies	6	Ind
Redzam — upes līkumā viens pie otra sasēdušies vairāki vīri un cilā makšķeru kātus .	Redzam	0	Ind
Komiteja pieņems lēmumus ar vienkāršu balsu vairākumu .	pieņems	1	Ind
Pirms došanās uz ielas , rokas jāieziež ar krēmu , lai tām būtu aizsargslānis .	jāieziež	6	Nec
Runājiet ar savu bērnu par to , kā viņš uztver dzīvi .	Runājiet	0	Imp
Bet ar teātra piedāvāto algu , kaut arī tā būs lielāka , nevar uzturēt ģimeni , kurā aug trīs bērni .	aug	17	Ind
· Aprunājieties un noskaidrojiet , vai šobrīd jūsu dzīvē , izņemot bērnu , ir vēl kādas lietas , kas abus saista kopā .	Aprunājieties	1	Imp
Nebrīnieties , ja jūtat tieksmi analizēt un salikt visu pa plauktiņiem .	jūtat	3	Ind
– Atpūties un nāc atkal pie mums .	nāc	3	Imp
Tādēļ vispirms ir jānoskaidro kāzu datums un pēc tam arī jāpajautā līgavainim , vai viņš ir apsvēris , kurā datumā organizēt vecpuišu ballīti .	jānoskaidro	3	Nec
Ko es tad darītu ?	darītu	3	Cnd
Ģenerālsekretārs pēc tam nosūta ierosināto labojumu dalībvalstīm ar lūgumu norādīt , vai tās pieprasa sasaukt dalībvalstu konferenci , lai izskatītu šos priekšlikumus un sarīkotu par tiem balsošanu .	sarīkotu	23	Cnd
Mēs iebraucam meža ceļā un skūpstāmies , viņa skūpsti sasien mani mezglā , un neatsietai man jābrauc mājās , jo mašīnā mīlēties viņš negrib .	jābrauc	16	Nec
Ella aizvainojās un apraudājās .	aizvainojās	1	Ind
Tā paaudze , kas dzimst un ir zīdaiņi tagad , tie varbūt ļoti reti redzēs grāmatas .	dzimst	4	Ind
Latvijai ir jāmācās no Kvebekas , kura , pieņemot īpašus likumus , ir panākusi to , ka savulaik angliski dominējošajās teritorijās pat tagad dažu angļu vārdu lietošana frankofoniskos uzņēmumos cilvēkam sabojā karjeru .	jāmācās	2	Nec
Jānoskatās video materiāls , " tā Šomase _ , kura nebeidz priecāties , ka Rīgas publika , kā arī maestro Pauls viņas koncerta laikā pat cēlās kājās .	Jānoskatās	0	Nec
Es precizēju : kaut arī filosofiskie jautājumi skar visus cilvēkus , ne visi kļūst par filosofiem .	precizēju	1	Ind
Kamēr lasiet grāmatu , aiciniet mazuli pārvietoties pa istabu atbilstoši grāmatā attēlotajam dzīvniekam .	aiciniet	4	Imp
Viņš apstājies pie cilvēka , kas nebaidās atklāti analizēt un kritizēt procesus , par kuriem daudzi vai nu negrib , vai baidās runāt .	nebaidās	6	Ind
No visa tā izriet , ka agresors ir jānosoda .	jānosoda	8	Nec
Visbeidzot un galu galā , kaut kam reiz ir bijis jātop no nekā .	jātop	10	Nec
Tagad - dusi saldi , Sabīne !	dusi	2	Imp
« Pāri laukumam » Jūrunai bija taisnākais ceļš , bet pa to viņa gāja vienīgi tad , ja bija sevišķi jāsteidzas uz mājām , lai paspētu , piemēram , uz kādām viesībām vai noteiktā laikā pie zobārsta .	paspētu	25	Cnd
Te gan jāmin , ka esmu relatīvi daudz pārvietojies ar auto pa rietumvalstu ceļiem - nu nesoda tur par šādiem nebūtiskiem pārkāpumiem , izņemot īpašas situācijas !	jāmin	2	Nec
Ēdiena maiņa izmainīja viņa fizisko spēku un veicināja smadzeņu pastiprinātu darbību un attīstību .	veicināja	7	Ind
Valmieras pilsētas pašvaldībā , darbojoties juridiskās nodaļas vadītāja amatā , jau 2007. gadā izveidoju un pastāvīgi pilnveidoju pašvaldībai piederošo kapitālsabiedrību pārvaldības organizatorisko sistēmu , nodrošinot arī tās juridisko virsvadību .	pilnveidoju	16	Ind
Ja viņš šo nolādēto dienasgrāmatu izlasītu , tik un tā taču saprastu , ka runa ir par viņu !	izlasītu	5	Cnd
Ir vēl citi rādītāji , kas jānosaka , lai izvēlētos katram cilvēkam vispiemērotākos medikamentus .	izvēlētos	9	Cnd
Kolēģi , mūsu Satversme nedrīkst un nevar tikt izmantota , lai grautu mūsu valsti !	grautu	11	Cnd
Daļēji izdevumi jāsedz arī iemītniekiem - viņi saņem 15 procentus no pensijas , bet pārējā nauda paliek sociālās aprūpes iestādei .	jāsedz	2	Nec
– Atpūties un nāc atkal pie mums .	Atpūties	1	Imp
Tomēr mums bērni it kā būtu šai nākotnei jāizglīto .	jāizglīto	8	Nec
Droši vien esam to pazaudējuši , un diez vai projekta ietvaros izdosies ko tādu izveidot .	izdosies	11	Ind
Viņš man mazliet palasīja morāli , kāpēc neesmu griezies pie veikala vadības ar savu pretenziju – tad tas viss tiktu atrisināts uzreiz un nebūtu jāiesaista portāla redakcija .	jāiesaista	24	Nec
Bet drīz nogura un aizmirsa , kāpēc te nākusi un kas tai jāatrod .	jāatrod	12	Nec
Kā negatīvu iezīmi etniskajos stereotipos jāmin arī tajos ietvertās prognozes attiecībā uz vērtējamās etniskās grupas locekļu rīcību , kā arī to , ka stereotipa aizsargmehānismi ignorē un apslāpē acīmredzamo , kas noliedz tajā pārvērstos faktus .	jāmin	5	Nec
Nomināciju komiteja veica " Lattelecom " padomes kandidātu kompetenču izvērtēšanu un vienojās , ka esošo padomes locekļu Gata Kokina un Jāņa Grēviņa kompetence tehnoloģiju un uzņēmumu pārvaldības jomā būtu jāpapildina , piesaistot speciālistus ar padziļinātām zināšanām finanšu pārraudzībā .	jāpapildina	29	Nec
Mēs gan nevaram īpaši mainīt savas gaitas , jo jāpieturas pie noteikta maršruta .	jāpieturas	9	Nec
Lūdzu , apsedziet mani !	apsedziet	2	Imp
Pamatojumā tiesai jāparāda , kā tā nonākusi līdz lietas risinājumam ( iekšējais pamatojums ) , un jāizskaidro , kāpēc tā devusi priekšroku vienam , nevis otram risinājumam ( ārējais pamatojums ) .	jāparāda	2	Nec
Bērns nav veļas mašīna , par kuru jāvienojas – pirksim vai nepirksim ?	jāvienojas	7	Nec
Sajauc visas mērces sastāvdaļas trauciņā , izspied citrona sulu un pārlej pāri salātiem	izspied	6	Imp
Ir īpaši jācenšas saklausīt lielpilsētas radīto fonu , kas caurauž mūsu dzīvi .	caurauž	9	Ind
Kubikos sagrieztas saknes apcep eļļā , pievieno miltus un pielej ūdeni , pievieno sēnes un vāra .	pievieno	6	Ind
Atvilknēm jābūt stabilām , tajās jāievieto priekšmeti , kas bērnu interesē , bet nesaplīst , ja bērns tos pēta vai spēlējas .	jāievieto	5	Nec
Gastons pastiepa roku , gribēdams pavērt lodziņu , tomēr roka slīdēja pār sienas tapeti un nevarēja satvert kloķi vai rūts rāmja spraugu .	pastiepa	1	Ind
Nevarētu teikt , ka atšķirība ir nozīmīga , bet varēja tiešām sajust , ka garša mazlietiņ atšķiras .	Nevarētu	0	Cnd
Mājās braucot , viņš tur vaļā logus un vēdina mašīnu , nesmaržojies , lūdzu , viņš saka .	nesmaržojies	11	Imp
Lai es šķaidītos uz nebēdu , lai es pasaulei gaismu rādītu .	rādītu	10	Cnd
Pēc tam tev pasaka – ņemiet kameras un ejiet filmēt .	pasaka	3	Ind
Mēs domājam abstrakti , mēs domājam kustībā .	domājam	5	Ind
Oktobra pirmajā svētdienā Florence nolēma , ka viņa aizbrauks uz tirgu un iepirksies , sarīkos kārtīgus svētkus vienatnē .	aizbrauks	8	Ind
Ja Milna varoņos tiek atrastas populārākās cilvēku tipu un raksturu iezīmes , tad tādas ir sastopamas arī aktieros , un rodas jautājums , kādas lomas padodas aktierim , kas dzīvē nes sevī Pūka arhetipu ?	padodas	25	Ind
Iespējams , ka pazemība senajā Izraēlā tika pārņemta kā ierēdņu tikums no apkārtējām kultūrām , kas tika piemērota Jahves reliģijai ( Jahve ienīst visus augstprātīgos un lepnos ) .	ienīst	22	Ind
Tomēr kā arhivēšanas veids , lai nodrošinātos pret dažādām katastrofām , kas var ietekmēt elektroniskos arhīvus , grāmatas pastāvēs vēl ilgi .	nodrošinātos	6	Cnd
Agrāk bija arī iecere , ka vairāk birojiem vajadzētu atrasties reģionos , kur cilvēkus konsultētu uz vietas .	konsultētu	14	Cnd
Kafiju dzert pie Māra viņa vairs nenāca , ne reizi nepaskaidrojusi , kāpēc _ , jo ne jau vienmēr šajās nedēļās viņa bija tik aizņemta .	nenāca	6	Ind
Katram no šiem izstrādājumiem ir pievienota lietošanas pamācība , kurā iekļauti arī drošības noteikumi , pirms pirotehnikas izmantošanas rūpīgi jāizlasa un jāievēro .	jāizlasa	19	Nec
Ja es ar aizturētu elpu sekoju visiem sporta raidījumiem TV , man ir jāsamierinās ar to , ka citiem sports šķiet garlaicīgs .	jāsamierinās	13	Nec
Ja vēlaties īstus pierādījumus ārpusķermeņa pieredzes esamībai , aizstaigājiet uz lielu konferenci , kurā piedalās vecākie akadēmiķi , un iegriezieties pēdējā vakara diskotēkā .	aizstaigājiet	8	Imp
Nu mums ir jābūt uzmanīgiem , lai šo dāvanu izmantotu gudri , un izvairītos no dažiem scenārijiem , par kuriem runājām .	izvairītos	13	Cnd
Līdz beidzot cilvēku pārņem skumjas .	pārņem	3	Ind
Tad ielej bļodā ūdeni un noliek dvieli .	ielej	1	Ind
Sofija juta , ka sirds iepukstējās straujāk , kad viņa izlasīja , kam šī skatu karte bija adresēta :	juta	1	Ind
Es gaidu , kamēr viņš , rupji lamādamies , atrod simtlatnieku , pieceļas kājās , asinis saskrējušas sejā no piepūles un dusmām , un tad es pasmaidu , un pagriežos , un eju .	pasmaidu	26	Ind
Ja nebūtu šī mazā pieredzējuma , viņa varbūt izplūstu garos , laimīgos stāstos , kuros identificētu savu pieredzi ar sevi pašu , un lāga klausītāja justu līdzi , pat reta asara pārslīdētu viņas tuklajam vaigam .	justu	25	Cnd
Bet izejot no telpas , viņš ieslēdza uz galda stāvošo radio .	ieslēdza	6	Ind
Ir arī grupa ar vairākiem desmitiem , iespējams , pat desmitiem tūkstošu objektu , kuri ir pietiekami lieli , lai riņķotu ap zvaigzni . [ 1 ]	riņķotu	20	Cnd
Tad viņi turpina sarunāties tāpat kā iepriekš : vai tu man nevarētu padot sviestu ?	nevarētu	11	Cnd
Mēs , kas šeit dzīvojam , esam kaut kādas sīkas būtnes , kas uzturas dziļi lejā truša kažoka biezumā .	dzīvojam	4	Ind
Topolaneks piektdienas vakarā Kijevā tikās ar Ukrainas premjerministri Jūliju Timošenko un prezidentu Viktoru Juščenko , lai meklētu risinājumu Krievijas un Ukrainas gāzes konfliktam , kas apturējis gāzes piegādes Eiropai .	meklētu	16	Cnd
Valsts policijas pārstāvji iesaka pirotehnikas preces iegādāties tikai firmās , kurām ir izsniegta atbilstoša licence .	iesaka	3	Ind
20. , 21. gadsimta traģēdiju teātrī taču vairs nav – skatītāji ( vismaz Rietumu kultūras telpā ) netic , ka eksistētu kas par cilvēku lielāks .	eksistētu	20	Cnd
Kā arī vēlētos vairāk uzmanības veltīt didaktikas jautājumiem .	vēlētos	2	Cnd
„ Liec mani mierā . ”	Liec	1	Imp
Es ļoti vēlētos , lai mūsu attiecības uzlabotos .	uzlabotos	7	Cnd
Viņa kļuva aizņemtāka un veltīja darbam daudz vairāk laika nekā pirms tam , strādājot par projektu vadītāju Rīgā .	veltīja	4	Ind
Fanija dalīja autogrāfus .	dalīja	1	Ind
Nākamais karalis visu nakti lūdzās Reimsas katedrālē , prasot Dievam spēku un gudrību , lai veiksmīgi pārvaldītu valsti .	pārvaldītu	16	Cnd
Šoruden viņš ieradās Bauskā , lai vadītu treniņu un demonstrētu , kāda meistarība ir melnās jostas 9. dana īpašniekam .	vadītu	6	Cnd
Mūsu pazīšanās ir relatīva , es drīzāk gribētu teikt , ka viņu nepazīstu , " stāsta Andris Vilks .	nepazīstu	12	Ind
Nacionālās bibliotēkas visā pasaulē turpinās pastāvēt , es teiktu , kaut kādā veidā kā muzeji .	teiktu	8	Cnd
Tik daudz spēka jāsakopo , lai paklausītu šai siltajai pavēlošajai balsij .	jāsakopo	3	Nec
Nebrīnieties , ja jūtat tieksmi analizēt un salikt visu pa plauktiņiem .	Nebrīnieties	0	Imp
Ja pacients ir depresīvs un nomākts , viss norisinās daudz ilgāk , — teic Pēteris Turkopuls .	norisinās	8	Ind
Es viņu apzeltu ar savu mīlestību , es gribu viņu visu laiku , es jūtos par vecu , lai spēlētu spēlītes , un man sagādā prieku katru brīdi atkārtot viņam , cik ļoti es viņu gribu .	apzeltu	2	Ind
Tiek pieņemts , ka abiem iesaistītajiem stājoties , parasti , vismaz daļēji reglamentētā mijiedarbē veidosies akceptētais rezultāts – skolēns iegūs tās zināšanas , kuras izglītības procesā tam būtu jāapgūst .	jāapgūst	28	Nec
Mācies pieņemt un paciest nepilnības , jo neviena mīlestība nav ideāla .	Mācies	0	Imp
„ Atvaino , bet es nesaprotu , ko tu tur runā . ”	Atvaino	1	Ind
Tas nostiprinātu opozīcijas pozīcijas , lai gan vairāki no tās līderiem šobrīd atrodas aiz restēm un Maduro kļūs aizvien grūtāk uzturēt savu kreisi populistisko režīmu , ko jau tā māc smaga ekonomiskā krīze .	nostiprinātu	1	Cnd
Jāskatās , kādas būs detaļas , kad beigsies sarunu procedūra .	beigsies	7	Ind
Es biju citāds , es neticēju un , vienlaikus rūgti un baisi apzinoties , ka varbūt jau nākamajā pusstundā miršu , mēģināju sev pateikt , kas gan ir tas , kādēļ mirt man tik ļoti negribas .	neticēju	5	Ind
Nu jau pieaudzis viņš labprāt pastaigājas pa nepazīstamām vietām dabā un pa Losandželosu regulāri brauc ar riteni .	brauc	14	Ind
Latvijā ražotos Lieldienu olu krāsojamos maisiņus pērk un lieto visa civilizētā pasaule !	lieto	8	Ind
No rīta noņemiet kompresi , noskalojiet kājas siltā ūdenī un paberzējiet pārakmeņojušos ādu ar cietu birstīti .	paberzējiet	10	Imp
Mums jāpārdomā pamatprincipi par to , kā izglītojam savus bērnus .	jāpārdomā	1	Nec
Tas apdraudētu ekonomikas izaugsmes potenciālu , vienotās valūtas darbību un liktu ievērojami pārskatīt pensiju un veselības pakalpojumus , kas ievērojami negatīvi ietekmētu pensionāru un nodokļu maksātāju labklājību nākotnē .	liktu	10	Cnd
Tāpēc , es domāju , te pat nav jābrīnās , ka SASKAŅA vairs neierodas .	jābrīnās	8	Nec
Es nejūtos vientuļa tikai tad , kad cieši klāt jūtu viņa kailo , gludo ķermeni .	nejūtos	1	Ind
Pēdējā klasē es biju tādās kā krustcelēs , kad es nevarēju saprast , ko darīt , jo mani interesēja daudz kas .	interesēja	18	Ind
„ Un beidz tā runāt . ”	beidz	2	Imp
Man patiešām nebija bail par to , ka man nebūs darba , ka man nebūs naudas , ka man būs jābrauc atpakaļ nolaistām acīm ...	jābrauc	20	Nec
Lai attīrītu ādu no atmirušajām šūnām un sagatavotu to parafīna procedūrai , pirms tam rūpīgi jāveic manikīrs un roku pīlings .	attīrītu	1	Cnd
Lauma , palīdzi taču !	palīdzi	2	Imp
Taču neviens neiedomājās , ka tieši tā tam visam jānotiek .	jānotiek	9	Nec
“ ES ir plašāk savas durvis jāatver legālajai imigrācijai , ja tā vēlas uzlabot savu ekonomiku ” , uzskata bijušais SMO vadītājs Brunsons Makkinlijs .	jāatver	6	Nec
Izmēģināsim vēl vienu domāšanas eksperimentu .	Izmēģināsim	0	Ind
Olas dauzījās gar katla sāniem un teica , lai ņemot nost .	dauzījās	1	Ind
Un cik labi dzied pats Ventspils mērs , kas , kā izrādās , ir izbijis moderno deju čempions ?	izrādās	11	Ind
Sajauc visas mērces sastāvdaļas trauciņā , izspied citrona sulu un pārlej pāri salātiem	Sajauc	0	Imp
Man nav jāpārguļ ar skatuves partneri , lai varētu nospēlēt mīlestību .	jāpārguļ	2	Nec
ieklausieties viņa stāstos par skolu , draugiem , dzīvniekiem vai brīvdienām .	ieklausieties	0	Imp
Kad viņš dažas nedēļas pēc kārtas bija uz vietas , viņš rosījās pa māju un gādāja par to , lai Sofija un māte justos omulīgi .	justos	23	Cnd
Iesēžoties ieelpo , pieceļoties izelpo .	izelpo	4	Imp
Un parasti jau nākas atzīt – lai kā _ , bet es dzīvotu tālāk .	dzīvotu	12	Cnd
Funkcionālisma perspektīva ir izstrādājusi arī izglītību raksturojošu jēdzienu kopumu , ko ir iespējams lietot , lai precīzāk identificētu analizējamos izglītības procesus .	identificētu	17	Cnd
Ir , protams , skaidrs , ka viena daļa zinātnieku – hidrobiologi – ir ārkārtīgi noraizējušies par Latvijas upju kvalitāti , jo , raugiet , diezgan daudz Latvijas upju krastos pēdējos gados ir saauguši alkšņi .	raugiet	23	Imp
Reiz izdodas viņu ievilināt kādā smalkākā restorānā pilsētas centrā , viņš mulst .	mulst	11	Ind
Maku iztukšošana apspiež tirgus pieprasījumu un bremzē ekonomikas attīstību .	apspiež	2	Ind
Viņas vietniece Linda Krēgere piebilst , ka ir svarīgi , lai arī mazi bērni nāktu un interesētos , jo viņi atrodas lielākajā riska grupā .	nāktu	14	Cnd
· Aprunājieties un noskaidrojiet , vai šobrīd jūsu dzīvē , izņemot bērnu , ir vēl kādas lietas , kas abus saista kopā .	noskaidrojiet	3	Imp
Es zvēru , ka viss mans darbs būs veltīts Latvijas tautas labumam .	zvēru	1	Ind
Lasīju par citu sasniegto , nomestajiem kilogramiem , bet pati turpināju ēst visu , kas pagadās .	pagadās	15	Ind
Vajadzētu censties produktu apstrādes procesā maksimāli saglabāt to vērtīgās īpašības , - piemēram , dārzeņus nepārvārīt , nepārcept , bet labāk sautēt vai pasniegt svaigus .	Vajadzētu	0	Cnd
Vai tiešām nevarētu izdarīt tā , lai tie , kuriem nav sava pastāvīga mājokļa , vismaz labdarības zupu varētu apēst siltā telpā pie galda ?	nevarētu	2	Cnd
Veikt šādu pētījuma prasa arī notikušās izmaiņas valsts budžeta finansēto studiju vietu skaitā .	prasa	3	Ind
Pēc neatkarības atgūšanas valsts pilsonības , valodas un izglītības politika krievvalodīgās minoritātes politiskās , sociālās un ekonomiskās tiesības un iespējas Latvijā būtiski ierobežoja .	ierobežoja	22	Ind
Lai nokārtotu visas formalitātes , būtu daudzas reizes jābraukā uz pagastu un rajonu , būtu jāmaksā visādas naudas .	nokārtotu	1	Cnd
Vajadzēja dzīvot ārkārtīgi taupīgi , tāpēc gadījās arī tā , ka mums , bērniem , knapi varēja nopirkt kurpes uz skolas sākumu .	Vajadzēja	0	Ind
Un arī nauda mums nenāk viegli , lai to izsviestu par patiesībā nevajadzīgiem papīriem .	izsviestu	9	Cnd
Neuzticēšanās bloķē sadarbību , tāpēc to parasti uzskata par nevēlamu .	bloķē	1	Ind
Debesis bija pelēkas , sauli nevarēja redzēt , vēja nebija , jūra līgojās kusli , gandrīz nemanāmi .	līgojās	12	Ind
Taču tas prasītu daudz papildu līdzekļu .	prasītu	2	Cnd
Intervētāji jāiepazīstina ne tikai ar intervēšanas taktiku , bet arī praktiski jāizmēģina dzīvesstāsta un dzīves vēstures intervijas veidi .	jāiepazīstina	1	Nec
Lai palutinātu ķermeņa ādu un tā nezaudētu elastību , vislabāk ieteicams izmantot sezama eļļu , kas ajūrvēdā ir pazīstama kā universāls līdzeklis gan ārīgai , gan iekšķīgai lietošanai .	palutinātu	1	Cnd
Mūsu izrādē daļa personāžu nebūs redzami , redzamie personāži ar viņiem sarunāsies pa telefonu .	sarunāsies	11	Ind
Tici mums , vīrieši tam nepievērš uzmanību .	Tici	0	Imp
Diena pirms Jāņiem ir Zāļu diena , kad meitām jālasa jāņuzāles , kuras izžāvē , lai vēlāk lietotu pret slimībām .	lietotu	17	Cnd
Es apgalvošu , ka visiem bērniem ir neaprakstāmi talanti .	apgalvošu	1	Ind
Tomēr šā pētījuma rezultātus nevar attiecināt uz sabiedrības attieksmi kopumā , ņemot vērā samērā niecīgo izlasi – 41 dalībnieku , kas bija pārtraucis vismaz vienu laulību vai nereģistrētu kopdzīvi , kurā ir dzimis vismaz viens bērns .	nereģistrētu	27	Cnd
Man patīk universitātes profesori , bet ziniet , mums nevajadzētu viņus nostādīt kā cilvēces sasniegumu virsotni .	nevajadzētu	9	Cnd
Es tak nevarēšu izbirstēt kā piena pudeli .	nevarēšu	2	Ind
Ja paskatītos uz izglītības sistēmu citplanētieša acīm , un vaicātu : „ Kam domāta publiskā izglītība ? ”	vaicātu	9	Cnd
Būs pensija zālēm jātērē .	jātērē	3	Nec
Depresīvie bērni bieži vien vēro skolotāja izturēšanos un atsaucīgi reaģē uz pozitīvo .	vēro	4	Ind
Ja pret valsts valodu mēs paši būtu izturējušies ar pienācīgu cieņu , krievi sen to būtu apguvuši un Godmanim nevajadzētu teikt šādus latviešu pašcieņu pazemojošus vārdus .	nevajadzētu	19	Cnd
Lēmums par padomes locekļu iecelšanu amatā vēl jāpieņem uzņēmuma dalībnieku sapulcei .	jāpieņem	7	Nec
Cits katru gadu iegādājas vairākus adventes vainadziņus , lai svecītes degtu katrā istabā .	degtu	10	Cnd
Lai tvertu Grūtupu pilnībā , viņš ir labi jāpazīst un ne katram tas ir lemts .	jāpazīst	8	Nec
Skatiet likumprojekta 5. pantu !	Skatiet	0	Imp
Vediet viņu uz deju skolu . ”	Vediet	0	Imp
Darbus pabeidzot vai beidzoties darba dienai , darba un materiālu nokraušanas vieta jāsakārto , atkritumi , nojauktie kapu pieminekļi un apmaļu paliekas obligāti jāizved no kapsētas .	jāsakārto	12	Nec
Reiz , dzirdot Merilina Mensona veco dziesmu " Suicide is painless " , es gandrīz vai devos taisnā ceļā uz Eitanāzijas pārvaldi .	devos	16	Ind
Ik reizes , klausoties Bībeles stāstu par pasaules radīšanu un Ēdenes dārzu , viņa jutās , it kā sēdētu te , savā Slēpnī , un pārlūkotu savu mazo paradīzi .	pārlūkotu	25	Cnd
Tādēļ , ja kādam uznāk pilnīgi nepamatota vēlme palasīt Aspaziju – noteikti jāpalasa Aspazija .	jāpalasa	12	Nec
Tāpēc Latvijas Reģionu apvienības frakcija atturēsies balsojumā , un es personīgi nebalsošu vispār .	nebalsošu	11	Ind
Nevajag lielā pirksta nagu griezt pārlieku īsu , tiem ir jāaizsargā pirkstu malas no beršanās pret apaviem , tādējādi aizsargājot no tulznu rašanās .	jāaizsargā	10	Nec
Sestais kritērijs paredz tiesisko instrumentu īstenošanu operāciju rajonos uz vietas , paredzot primāri sniegt atbalstu vietējām tiesībsargājošajām iestādēm , lai īstenotu likuma piemērošanu un atjaunotu tiesisko kārtību .	īstenotu	20	Cnd
Es apgalvotu , ka radošums izglītībā šobrīd ir tikpat svarīgs kā rakstpratība , un mums pret to būtu jāattiecas līdzvērtīgi .	apgalvotu	1	Cnd
Lai rokas koptu mājās , nepieciešams speciāls līdzeklis nagu valnīša noņemšanai un mīkstināšanai , un kociņš , ar ko atbīda naga valnīti .	koptu	2	Cnd
Bet atceries , tas , kurš nav ēdis , vēlas ieskatīties mencas , ne Tavās , Pēter , acīs .	atceries	1	Imp
Lai nepieļautu šādu pārkāpumu atkārtošanos , pašvaldību aģentūras tiks auditētas biežāk , " pauda Škutāne .	nepieļautu	1	Cnd
Aplokās ap kailu cisku , baksta ar ķepu un trin vaigu pret kāju , lien pie sejas , nosiekalo zīda naktskreklu uz krūtīm .	Aplokās	0	Ind
Dānija savā himnā piemin vikingu slavu , bet Nīderlande skandina par OranžasU Viljamu .	skandina	9	Ind
Dārzā jāstrādā , jāstrādā un jāstrādā : jāstāda jauni kociņi , jāizzāģē zari , jāsmidzina pret dažādiem kaitēkļiem , jānovāc raža .	jāstāda	7	Nec
2009. gadā nodarbināto skaits samazinājās visās tautsaimniecības nozarēs un gandrīz visās profesiju grupās .	samazinājās	4	Ind
Lai sniegtu savu ieguldījumu arī ES īstenotajā drošības politikā , Latvijas Jūras spēku virsnieki kopš 2011. gada piedalās pretpirātisma operācijā pie Somālijas krastiem , kura ir unikāla ar to , ka tā ir vienīgā jūras operācija pēdējos gadu desmitos .	sniegtu	1	Cnd
Es iztēlojos , kas varētu notikt vissliktākajā gadījumā un ko es tad darītu .	darītu	12	Cnd
Jūlijs izkāpa no mašīnas , savilka augšā džīnas un izstaipījās .	izkāpa	1	Ind
Bet tad , izgājis ārā , mirkli padomāju : kāpēc gan man ir jāpiekrīt , ja pašam no tā nav nekāda labuma ?	jāpiekrīt	13	Nec
Gita vēlētos iemācīties slēpot , jo to neprot un nekad nav mēģinājusi , bet ziemas priekus parasti bauda snovojot .	bauda	17	Ind
Lai izvēlētos terapijas kursu , nesteidzīgā sarunā ārsts noskaidros gan slimības simptomus , gan arī jūsu ieradumus , dzīvesveidu , iecienīto uzturu , ķermeņa īpatnības un rakstura pazīmes .	izvēlētos	1	Cnd
Piemēram , ja viņi protestē pret to , ka no kafejnīcas nāks trokšņi , var vienoties , ka saimnieks ierīkos skaņas izolāciju .	protestē	4	Ind
Pīlādža zariem jāstāv istabā , kamēr lapas nokaltušas , tad tie jānobrauka , turot aiz galotnes un braukot uz resgali , jāsalauž deviņos gabalos ; tos izmētā krustām šķērsām pa istabu un sabāž gultas maisos .	jānobrauka	11	Nec
Lai viesi pa īstam izjustu maizes burvību , viņiem vispirms ļauj pataustīt un izmēģināt uz zoba rudzu graudus , tikai tad var izgaršot maizi .	izjustu	4	Cnd
OECD apkopotā informācija apstiprina plaši izplatītus uzskatus , ka attīstības ekonomikas ir zaudējušas daļu no virzītājspēka , kas palīdzēja pasaulei pārciest attīstīto valstu nesen piedzīvoto izaugsmes tempa palēninājumu .	apstiprina	3	Ind
Kas sagaida skatītāju , ja šai „ savādajai ” kompānijai pievienot talantīgo bārmeni , atvainojiet , aktieri Sergeju Serovu ?	atvainojiet	14	Imp
Viens no senajiem grieķu filosofiem , kas dzīvoja vairāk nekā pirms diviem tūkstošiem gadu , domāja , ka filosofija radusies cilvēka izbrīna dēļ .	domāja	15	Ind
Es vairāk pretendēju uz pozīciju - patīk , nepatīk , nevis profesionālu vērtējumu .	pretendēju	2	Ind
Sofija dzīvoja kāda savrupmāju apbūves rajona viņā galā , kas iesniedzās piepilsētas mežu joslā .	iesniedzās	10	Ind
Tad , manuprāt , būtu jāsecina , spriežot pēc rezultātiem , kurš no tā ir ieguvējs , kurš izdara visu , kas jāizdara , kurš saņem visus smaidiņus , kuri ir uzvarētāji .	jāizdara	22	Nec
Bet , ja pavaicājat par viņu izglītību , viņu jūs pienaglo pie sienas .	pienaglo	10	Ind
Savukārt vēl nesen bija nosacījums , ka vīrietis jau agrā jaunībā apprecas un mūžu nodzīvo ar šo vienīgo sievieti , tāpēc daudzi nemaz nepieļāva domas par citām sievietēm .	nepieļāva	23	Ind
Piedalās : Raimonda Paula ceremonijorķestris un pats maestro Raimonds Pauls , Jānis Paukštello , Harijs Spanovskis , Andris Bērziņš .	Piedalās	0	Ind
Tāpēc tiešām es aicinātu kolēģus pārdomāt šo ideju , viņu atbalstīt šajā lasījumā , bet uz trešo lasījumu mēs iesniegsim precizējumus par minēto priekšlikumu .	aicinātu	3	Cnd
— Raža ļoti laba , domāju , novāksim 50 – 60 tonnas ābolu ( tādu , kas atbilst standartam , ko var pat importēt uz citām valstīm ) .	novāksim	7	Ind
Lielā pirksta nagu grieziet tikai taisnā līnijā , lai izbēgtu no tā ieaugšanas pirkstā .	izbēgtu	9	Cnd
Un nu Tev jāizvēlas , mīļo Sofij !	jāizvēlas	3	Nec
Lai drīkstētu organizēt preču vai pakalpojumu loteriju , komersantam , kas ražo , izplata , pārdod preces vai sniedz pakalpojumus , Izložu un azartspēļu uzraudzības inspekcijā ( IAUI ) jāsaņem loterijas atļauja .	izplata	13	Ind
Es viņu uzaicinu kā personību , kuru es pazīstu , zinu , kā viņš zīmē , un to augstu cienu .	uzaicinu	2	Ind
7. Lai no mājdzīvnieku spalvām atbrīvotu mīkstās mēbeles , uzvelc gumijas cimdu un pārbrauc roku pār netīro dīvānu .	atbrīvotu	5	Cnd
Fanija atteica , ka ar nesmukiem nabagiem viņa nedraudzējas , bet vienā veikalā šie varot pa lēto nopirkt vai vismaz pavalkāt turpat veikalā viņas vecās kleitas , kuras pašai jau ir par mazu .	atteica	1	Ind
Lai apturētu smilts pārvietošanos zemnieki un mežsaimnieki veica smiltāju nostiprināšanu un apmežošanu .	apturētu	1	Cnd
Gatis atspēko vairākus Kriša dzīves uzskatus , sastrīdas ar tēti , aizskar nacionālo jautājumu un jautājumu par okupāciju sarunā ar nepilsoņu paziņu un vairākas reizes iedomājas par to , kā kaujas ar urlām .	atspēko	1	Ind
- Nav noslēpums , ka jūs mīlat un protat novērtēt skaistumu .	protat	8	Ind
Taču šajā variācijā , kurā piesummēti somugri igauņi , jau jārunā nevis par etnisku kopību , bet gan jaunāko laiku ģeopolitisku veidojumu , kuru vieno atrašanās Baltijas jūras austrumu krastā .	jārunā	10	Nec
Vien iedomājieties šo dažādību un plašumu .	iedomājieties	1	Imp
Energoresursu cenas kāpj , un , lai ko arī neregulētu un neremontētu , apkure vairs nekad nebūs tik lēta kā kādreiz .	neremontētu	11	Cnd
Bet šodien jaunieši ar grādiem bieži vien dodas mājās , lai turpinātu spēlēt datorspēles , jo nu jums vajag maģistra grādu , kur kādreiz vajadzēja bakalaura , un doktora grādu , kur maģistra vajadzēja .	turpinātu	11	Cnd
Ja jūs dodat priekšroku veikt pedikīru mājas apstākļos , tad sākumā rūpīgi sagatavojiet kājas .	sagatavojiet	12	Imp
Ir burvīgs Džonasa Solka citāts , kurš teica : „ Ja visi kukaiņi pazustu no zemes virsas , 50 gadu laikā dzīvība uz Zemes beigtos .	pazustu	13	Cnd
Pīlādža zariem jāstāv istabā , kamēr lapas nokaltušas , tad tie jānobrauka , turot aiz galotnes un braukot uz resgali , jāsalauž deviņos gabalos ; tos izmētā krustām šķērsām pa istabu un sabāž gultas maisos .	jāsalauž	21	Nec
Tikai jāuzliek un jāpatur tajā vietā roka .	jāuzliek	1	Nec
Ja no Zemes virsas pazustu visi cilvēki , 50 gadu laikā visas dzīvības formas uzplauktu . ”	uzplauktu	14	Cnd
Es apgalvotu , ka radošums izglītībā šobrīd ir tikpat svarīgs kā rakstpratība , un mums pret to būtu jāattiecas līdzvērtīgi .	jāattiecas	18	Nec
Tagad būs drusku jāpieceļas , tu pagaidām vēl elpo mākslīgi , mēs izņemsim tev elpošanas caurulīti no elpvada , mēģini dziļi ieelpot ( izelpot ? ) tad , kad es teikšu .	mēģini	19	Imp
Viņa apskata to , it kā būtu zaudējusi saprašanu , kas tā par lietu , tad piesardzīgi pieiet pie magnetofona , notupjas pie sienas tam blakus .	notupjas	21	Ind
— Par Eiropas naudu iegādājāmies tehniku , tagad domājam realizēt glabātavas projektu , jo ir visai problemātiski saglabāt lielo ražu līdz pavasarim .	iegādājāmies	4	Ind
Tāpat PSRS radīja atbalsta sistēmu daudzbērnu mātēm , nosodīja bezatbildīgus tēvus un vīrus , nostiprināja vecāku institūcijas autoritāti [ Gavrovs , 2009 ] .	nostiprināja	14	Ind
Lai to izdarītu ideāli , būtu jānomaina visi ventiļi , kas ir dārgi , jāapzina , cik mājā ir radiatoru , un ar datoru jāizstrādā balansēšanas programma .	izdarītu	2	Cnd
Pārlej ābolus ar sagatavoto mīklu .	Pārlej	0	Imp
No kā tev jākaunas ?	jākaunas	3	Nec
Viņš ir tuvu , taču nepaspēj i pagriezties , kad Tu bliez no savas šautenes viņam tieši mugurā .	nepaspēj	5	Ind
Manuprāt , mēs nonākam pie sekojošā : Als Gors vakar runāja par ekoloģiju un revolūciju , ko aizsāka Reičela Kārsone .	aizsāka	17	Ind
Sajauc visas mērces sastāvdaļas trauciņā , izspied citrona sulu un pārlej pāri salātiem	pārlej	10	Imp
Un es biju šausmīgi laimīga tai sapnī , tu nevari iedomāties .	nevari	9	Ind
Un cēlos un gāju .	cēlos	1	Ind
Es viņu apzeltu ar savu mīlestību , es gribu viņu visu laiku , es jūtos par vecu , lai spēlētu spēlītes , un man sagādā prieku katru brīdi atkārtot viņam , cik ļoti es viņu gribu .	spēlētu	19	Cnd
Tikai vecene sekoja bērniem , pa reizēm tos iepļaukādama .	sekoja	2	Ind
Savukārt ārējā pamatojumā tiesai jāizskaidro juridiskā siloģisma premisu izvēle – jāatveido risinājuma rašanas gaitā notikušais dialogs , kurā mijiedarbojušies par lietas faktiskajiem apstākļiem un piemērojamo tiesību normu paustie viedokļi un argumenti .	jāatveido	10	Nec
Saprotu , ka šis jautājums jau ir " apzelēts " , tomēr arvien mums jautā - kādēļ laikmetā , kad grāmatas lasīsim digitalizēti , mums bija jābūvē tik liela un dārga bibliotēka ?	jābūvē	26	Nec
Lai izgatavotu šādu krūšturi , tika patērētas 685 darba stundas , bet rezultāts atsver darbu , tik grandiozs ir krūšturis .	izgatavotu	1	Cnd
Lai to izdarītu ideāli , būtu jānomaina visi ventiļi , kas ir dārgi , jāapzina , cik mājā ir radiatoru , un ar datoru jāizstrādā balansēšanas programma .	jāizstrādā	24	Nec
Bet , no sētnieku un citu kopēju viedokļa raugoties , daudz vienkāršāk būtu , ja koki straujāk un īsākā laikā atbrīvotos no savas rotas .	atbrīvotos	20	Cnd
Citā vietā , varbūt , tepat blakus dzelmei , kur straume kļūst lēnāka saneši nogulst – rodas sēklis .	nogulst	14	Ind
14. februārī Ģenerālprokuratūra rīkoja gadskārtējo virsprokuroru sanāksmi , kurā referātu ar plašu statistikas materiālu analīzi sniedza ģenerālprokurors Jānis Maizītis .	rīkoja	3	Ind
Vienlaikus A. Sietiņš apliecina , ka glābēji neatteiks palīdzību nelaimē nonākušajiem cilvēkiem , arī dzīvniekiem .	neatteiks	7	Ind
Šoruden viņš ieradās Bauskā , lai vadītu treniņu un demonstrētu , kāda meistarība ir melnās jostas 9. dana īpašniekam .	demonstrētu	9	Cnd
Sakaltētas rupjas rudzu maizes salaiek traukā , pieliek sauju piparmētru , pārlej ar verdošu ūdeni , pasedz un 24 stundas ļauj ievilkties .	pārlej	11	Ind
Lai to izdarītu ideāli , būtu jānomaina visi ventiļi , kas ir dārgi , jāapzina , cik mājā ir radiatoru , un ar datoru jāizstrādā balansēšanas programma .	jānomaina	6	Nec
Tādējādi par to vispār nevarēja pat strīdēties , atbilde bija jāatstāj fantāzijas vaļā .	jāatstāj	10	Nec
Tā es ar sevi strādāju un tad atkal varu dzīvot un smieties .	strādāju	4	Ind
Vadītājs atstāja avarējušo braucamo un nozuda mežā .	nozuda	5	Ind
Lai kā dzīvē veiktos , pārim jābūt abpusējai skaidrībai , kā viņi plāno tālāk dzīvot , kādu iedomājas kopdzīvi .	veiktos	3	Cnd
Ja jau viņi atļaujas ar krievvalodīgo masu mediju žurnālistiem runāt krieviski , tad kāda jēga viņus vairs audzināt !	atļaujas	3	Ind
Baušķenieki šajās sacensībās nestartē , jo viņu pienākums ir pasākuma norises nodrošināšana .	nestartē	3	Ind
Izceļams rīkojuma 10. punkts , kas norāda , ka jaunieši jāapgādā kā savi ģimenes locekļi un jānodrošina ar pilnu pansiju – gultas vietu , drēbēm un pārtiku .	jāapgādā	10	Nec
Piedalāmies gadatirgos un visur , kur aicina .	Piedalāmies	0	Ind
Viņam interesē lieli apjomi , lieli objekti – neviens netaisās vairumā uzpirkt dzīvokļus vecajās sērijveida mājās .	netaisās	9	Ind
Tautai ir nepārprotami jāpasaka , lai par viņiem vairāk nebalso , un pēdējais laiks ir sākt kampaņu " Runā latviski ! " .	jāpasaka	3	Nec
Izmanto akcijas .	Izmanto	0	Imp
Rezultātā darba devējam viņi jāapmāca atbilstīgi konkrētās vakances prasībām .	jāapmāca	4	Nec
Viņā krastā rūc mašīna , tajā iestiprināta vinča , kas velk gaisā izpletnī iekārušos Stefanu .	rūc	2	Ind
Lai tiktu pie fotouzņēmuma retro stilā , būs jādodas uz foto salonu " Pie Bartiljona " , kas iekārtots Lielās ģildes otrajā stāvā .	jādodas	8	Nec
Visi apkārt skrien , kaut ko dara , bet man jāsēž , un es neesmu tā pieradusi .	jāsēž	10	Nec
Viņš uzskata , ka integrētas federatīvas " Eiropas Savienotās Valstis " varētu kļūt par ietekmīgu spēku globalizētajā pasaulē , kā arī tas veicinātu Eiropas ekonomisko attīstību un ļautu labāk cīnīties pret organizēto noziedzību .	ļautu	27	Cnd
Lai pircējs arī nākamreiz izvēlētos jūsu pakalpojumus , par izdevīgu piedāvājumu jādomā jau laikus .	izvēlētos	4	Cnd
Instrumentālās nosēšanās sistēmas modernizācija lidostā izmaksās 1,63 miljonus latu .	izmaksās	5	Ind
Sarīvējiet uz smalkās rīves ziepes un izšķīdiniet traukā , ieteicams pievienot mazliet dzeramās sodas un ožamo spirtu , tie lieliski mīkstina nagus un ādu uz kāju pirkstiem .	Sarīvējiet	0	Imp
Es nekad nebūšu īsta priekšniece - ja svētdienā jāapmeklē futbola spēle , man nešķiet normāli dēļ tām 10 minūtēm saukt domes šoferi .	nešķiet	13	Ind
Es esmu pārskaitusies , es ne ar vienu nevēlos runāt , es pagriežos pret sienu un klusēju , - viņi , izrādās , iedomājušies , ka tas bijis pašnāvības mēģinājums .	nevēlos	8	Ind
Kad padomju armijai bija jāpamet Eiropa , Vācijas valdība izsludināja konkursu par ciemata izbūvi Krievijā , uz kurieni pārcelties armijniekiem .	jāpamet	4	Nec
Māmiņa drīz pieceļas no galda un aizgriežas ... bet tētis sāk lidināties pie griestiem , kamēr Tomass turpina sēdēt un skatās .	turpina	17	Ind
Šīs sezonas teātra gardēžiem , kuru favorīts ir Ķesteris , noteikti jānoskatās Dailes teātra izrādes “ Psihs ” un “ Nekrofils ” .	jānoskatās	11	Nec
Tikai jāuzliek un jāpatur tajā vietā roka .	jāpatur	3	Nec
Cīņas par godalgām finālsacensībās risinājās Saulaines Profesionālajā vidusskolā .	risinājās	4	Ind
Un šī sporta veida cienītājiem tas ir jāapzinās .	jāapzinās	7	Nec
Gadījumiem , kurus izklāstījām iepriekš , veselīgās pāru attiecībās nevajadzētu atkārtoties ikreiz , kad abu starpā ir sekss .	nevajadzētu	9	Cnd
Taču it kā starp citu ieminējās , ka tagad šī uzraugošā institūcija saņems un regulāri lasīs arī “ Rēzeknes Vēstis ” .	lasīs	15	Ind
Tāpēc , kas būtu jāstimulē valstij - jāatbalsta kaut kādas kvalitātes lietas .	jāatbalsta	7	Nec
Šai tradīcijai ir šāds skaidrojums - zāle aug līdz Jāņu vakaram , bet Jāņu dienā sāk briest , tāpēc zālēm un tējai augi jāievāc līdz Jāņu dienai .	jāievāc	23	Nec
Plašāk pievēršoties pirmajam darbības virzienam , jāuzsver , ka krimināltiesību politika tiek nostiprināta un izpaužas likumdevēja regulētās krimināllikuma normās , tādējādi politiskā griba gūst savu objektīvo izpausmi un tiek noteiktas stingras likumības un tiesiskās kārtības robežas .	jāuzsver	6	Nec
Lai izveidotu pabeigto tēlu , var noderēt nagi ar svētku dizainu , jo mūsdienīgās nail-art iespējas , kā zīmējumos tā arī materiālu izvēle ir praktiski neierobežotas .	izveidotu	1	Cnd
Bet tas , ka šī sistēma ir jāsakārto , un tas , ka pozīcija kādreiz var atrasties arī opozīcijā ...	jāsakārto	7	Nec
Tiek pieņemts , ka abiem iesaistītajiem stājoties , parasti , vismaz daļēji reglamentētā mijiedarbē veidosies akceptētais rezultāts – skolēns iegūs tās zināšanas , kuras izglītības procesā tam būtu jāapgūst .	veidosies	14	Ind
A. Karpenko piebilda , ka labāka situācija būtu , ja namā ierīkotu siltummezglu , tad vismaz siltajā laikā māja netiktu pārkurināta , lai nodrošinātu silto ūdeni , jo to uzsildītu mezglā .	nodrošinātu	23	Cnd
Tas tāpēc , lai ekonomiskāk izmantotu materiālus un kaut kādu ne pārāk svarīgu centimetru dēļ nebūtu meistaram lieki kaut kas jāzāģē , jo zinu , ka meistaru darbs ir dārgs , un arī materiāli jātaupa .	izmantotu	5	Cnd
Spīdola ir šīs Uguns un nakts galvenā varone , bet Guna Zariņa – brīnums , bez kuras šī izrāde nenotiktu .	nenotiktu	19	Cnd
Lai nerastos konflikti , vecāki parasti pērk katram bērnam savas rotaļlietas .	nerastos	1	Cnd
« Bet es diršu , atvainojiet , diršu virsū , es braukšu tāpat ārā , kur man vajag .	atvainojiet	5	Imp
Ar līdzīga rakstura problēmām saskaras arī skolas ASV , kur tiek fiksēts to skolotāju īpatsvara pieaugums , kas pamet darbu skolā samērā neilgi pēc tam , kad pabeiguši pedagoģiskās izglītības iestādi .	saskaras	4	Ind
« Darīsim visu , lai cilvēkus apmācītu un darbu rūpnīcā darītu pievilcīgu , » sola direktors .	darītu	10	Cnd
Pāvils noliecas pie grāvja .	noliecas	1	Ind
Izvairies no darbiem , kas rada muskuļu pārpūli .	Izvairies	0	Imp
Ieraugot māsu , četrgadīgā meitenīte metās māsas apskāvienos .	metās	5	Ind
Mums radikāli jāpārdomā mūsu skatījums uz intelektu .	jāpārdomā	2	Nec
Esi brīvs vīrietis , turpini kāpt kalnos ...	turpini	4	Imp
Interesantu projektu Mesa Group realizēja Krievijā .	realizēja	4	Ind
Ir tieši tāds vakars , un pa Brīvības ielu , skaņas signālam griezīgi kaucot un zibinot oranžas bākugunis , traucas ātrās palīdzības mašīna .	traucas	19	Ind
Viņš apstājies pie cilvēka , kas nebaidās atklāti analizēt un kritizēt procesus , par kuriem daudzi vai nu negrib , vai baidās runāt .	apstājies	1	Ind
Tas ir ļoti būtiski , un tas vairo uzticēšanos valstij un konkrētam cilvēkam .	vairo	7	Ind
Darbus pabeidzot vai beidzoties darba dienai , darba un materiālu nokraušanas vieta jāsakārto , atkritumi , nojauktie kapu pieminekļi un apmaļu paliekas obligāti jāizved no kapsētas .	jāizved	23	Nec
Kārlim Šadurskim ir skaidrs atbalsts nevis tāpēc , ka mēs atkal aizstāvam savu partijas biedru , bet tāpēc , ka mēs skaidri iestājamies par valstij nozīmīgām pārmaiņām , kuras beidzot nevar atlikt .	iestājamies	22	Ind
A. Sietiņš skaidro , ka šo cilvēku atbrīvošana tieši neietekmē glābēju darbu , tomēr sarežģītāk būs apkalpot dažādas ierīces .	skaidro	2	Ind
Dienas Bizness : Investīcijas pētniecībā paver uz Eiropas tirgu	paver	5	Ind
Naumaņa grāmatplaukts atspoguļo viņa personības tapšanu un plašās intereses .	atspoguļo	2	Ind
Ir jāatšķir fiziskā un grupas adresācija .	jāatšķir	1	Nec
2006. gadā viņi uzvarēja tiesas prāvā par šī likuma grozīšanu , taču parlaments to pārstrādāja tā , ka monopols vienalga palika aklo un licencēto masieru rokās .	pārstrādāja	14	Ind
Pēc latviešu tradīcijām Ziemassvētku vakarā vajag sadegt visas lampas , lai Laimīte redzētu , kur staigāt , kā arī Ziemassvētku vakarā jātur maize , sāls un uguns uz galda , tad nākamais gads būs svētīgs .	jātur	21	Nec
Pēkšņi viņai ienāca prātā , ka tētis sākumā esot vēlējies , lai viņu sauktu par Sinēvi .	sauktu	13	Cnd
Tādā gadījumā pastāvēja tikai viena vienīga iespēja : Dievs ir bijis mūžīgi .	pastāvēja	2	Ind
Jāteic , ka vienīgā nopietnā tēze par SAB darbu , kuru esam dzirdējuši no Kažociņa kunga , ir tā , ka SAB ir dots pārāk daudz varas .	Jāteic	0	Nec
Saprotu , ka šis jautājums jau ir " apzelēts " , tomēr arvien mums jautā - kādēļ laikmetā , kad grāmatas lasīsim digitalizēti , mums bija jābūvē tik liela un dārga bibliotēka ?	lasīsim	21	Ind
Sofija mēģināja iztēloties , kā viņa pastiepj sveicienam roku un nosauc savu vārdu — Sinēve Amundsena , bet nē , to bija grūti iedomāties .	pastiepj	6	Ind
It sevišķi tajā brīdī , kad kāds tev no malas pasaka — diez vai , man tad ir pretēja reakcija .	pasaka	10	Ind
Vienkārši atlieciet nodarbības un dodiet sev laiku , lai mazliet iejustos .	dodiet	4	Imp
Mūsu saruna galīgi nevedas .	nevedas	3	Ind
Dārzā jāstrādā , jāstrādā un jāstrādā : jāstāda jauni kociņi , jāizzāģē zari , jāsmidzina pret dažādiem kaitēkļiem , jānovāc raža .	jāstrādā	5	Nec
Pirms katras ārsta vizītes pavaicā vīram , vai viņam nav kādi jautājumi , ko arī viņš vēlētos uzzināt .	pavaicā	4	Ind
Lai kļūtu par transportlīdzekļu vadītāju , ikvienai personai vispirms jāiziet obligātā teorētiskā apmācība autoskolā , kā arī instruktora pavadībā jāapgūst spēkrata vadīšanas prasme un iemaņas .	jāapgūst	19	Nec
Tāpat aktieris stāstīja , ka pēc paziņojuma izteikšanas pagājušā gadā daudzi no viņa novērsušies , tomēr , lai izvairītos no neveiklām situācijām , Šīns par savu slimību cenšas pajokot .	izvairītos	18	Cnd
Pēc jaunās ēkas apmeklējuma Džovanni Polici ieradās LNB Reto grāmatu un rokrakstu nodaļā Jēkaba ielā , lai iepazītos ar bibliotēkas reto izdevumu kolekciju , kuru veido arī virkne itāļu un Itālijā izdotu grāmatu .	iepazītos	17	Cnd
Sakritība vai ne , bet šīs nodaļas vadītājs Roberts Putnis savā pirmajā darba vizītē devās tieši uz Rēzekni .	devās	14	Ind
Maldīgi domājat , ka TV ēterā strādā vien “ roboti ” , kas atrunā ziņu tekstus , problēmas būtībā nemaz neiedziļinoties .	atrunā	13	Ind
3. Pietupies , paceļot rokas priekšā .	Pietupies	1	Imp
Pievieno saberztu biezpienu , tad sodu ar miltiem , visu labi samaisa .	samaisa	11	Ind
Uzņemiet lielāku augstumu , norīkoja kontrolētājs .	Uzņemiet	0	Imp
Vēlreiz no sirds sakām lielu paldies visiem , kas noticēja , līdzdarbojās un atbalstīja šo projektu .	līdzdarbojās	11	Ind
Par to , ka sadarbībai nevarētu būt ne vainas , abas puses jau bija pārliecinātas pirms darbu sākšanas , jo , lai cik dīvaini tas arī nešķistu , Kubs ir uzvarējis visās Sprīdīšos organizētajās cenu aptaujās .	nevarētu	5	Cnd
Par bērna emocionālo saikni ar aukli būtu jārunā īpaši .	jārunā	7	Nec
Mēs zinām , ka Sudetiju apdzīvoja pamatā vācieši un Hitlers nolēma , ka šie Sudetijas vācieši ir jāaizstāv ...	jāaizstāv	17	Nec
Netīrumus un sakrājušās mirušās ādas šūnas regulāri notīriet no nagu apakšas ar neasu kociņu , to ir jādara ļoti uzmanīgi , lai netraumētu naga iekšpusi .	notīriet	7	Imp
Trauku apsedz ar drāniņu un siltumā uzraudzē .	apsedz	1	Ind
Lai nepieļautu šādu situāciju arī Latvijā , es aicinu jūs atbalstīt šo manu un Jāņa Dombravas priekšlikumu .	nepieļautu	1	Cnd
Protams , daudz kur ir jādodas tāpēc , ka to prasa amats .	jādodas	5	Nec
Šajā gadījumā par applūstošajām teritorijām nav skaidrs , kura ir tā vērtība , kas ir jāizsargā .	jāizsargā	15	Nec
Runājot par CV izmisīgu un veltīgu sūtīšanu uz visām pusēm , jāteic : kam tu skrien pakaļ , tas no tevis bēg .	jāteic	11	Nec
Pēc tam tev pasaka – ņemiet kameras un ejiet filmēt .	ņemiet	5	Imp
Izceļoties jaunām kaujām starp prokremliskajiem kaujiniekiem un Ukrainas armijas spēkiem , pagājušajā nedēļā izplēnēja centieni noorganizēt Kazahstānā tikšanos starp Krievijas , Ukrainas , Francijas un Vācijas līderiem .	izplēnēja	13	Ind
Ja nebūtu šī mazā pieredzējuma , viņa varbūt izplūstu garos , laimīgos stāstos , kuros identificētu savu pieredzi ar sevi pašu , un lāga klausītāja justu līdzi , pat reta asara pārslīdētu viņas tuklajam vaigam .	pārslīdētu	31	Cnd
Iepriekš Īres valdes priekšsēdētājs bija Deniss Gorba ( PCTVL ) , no īrnieku vidus valdē darbojās Baltā un Genādijs Kotovs , savukārt no izīrētāju vidus - Jakāns un Meikališs .	darbojās	15	Ind
– Man vispār būtu jākāpj ārā Lizumā .	jākāpj	4	Nec
( Ievēro to labi ! )	Ievēro	1	Imp
Uzziniet , kas liek straujāk pukstēt viņa sirdij .	Uzziniet	0	Imp
Skumjas neatkāpās .	neatkāpās	1	Ind
Izplūduši no ledāja , ūdeņi varenu upju veidā tecēja pa ledus atstāto teritoriju .	tecēja	8	Ind
Augstākās tiesas senatore Jautrīte Briede analizēja vispārējo tiesību principu piemērošanu administratīvajā procesā .	analizēja	5	Ind
Nekas tu nebūsi , neceri , nožēlojamais āksts !	neceri	4	Imp
Piemēram , Pilsonības un imigrācijas departamenta preses sekretārs nesen apgalvojis , ka „ PID visu laiku atgādina un uzsver , ka visiem šiem 700_000 iedzīvotāju agri vai vēlu būs jābrauc projām no Latvijas ” .	jābrauc	29	Nec
Es esmu pārskaitusies , es ne ar vienu nevēlos runāt , es pagriežos pret sienu un klusēju , - viņi , izrādās , iedomājušies , ka tas bijis pašnāvības mēģinājums .	pagriežos	12	Ind
Jālaužas pa biezokni , jāsavārta drānas .	Jālaužas	0	Nec
Turklāt nemaz nav tik daudz stadionu mēroga grupu , kurām ļoti patiktu koncertēt .	patiktu	11	Cnd
Lai tvertu Grūtupu pilnībā , viņš ir labi jāpazīst un ne katram tas ir lemts .	tvertu	1	Cnd
Katra šūna glabā sevī manas dzīves stāstu , katra grumba _ atmiņas par pagātni ...	glabā	2	Ind
Ja viss norit pareizi - jāiedegas gaismas indikatoram .	jāiedegas	5	Nec
Erdogans aicināja visas politiskas partijas sākt strādāt pie jaunas civilas konstitūcijas , kas aizvietotu 1980. gadā pieņemto pamatlikumu .	aizvietotu	13	Cnd
Andris jau safotografējis Viktoru un viņa mīluļus un grasās likt fotoaparātu somā , bet Viktors smej : " Pagaidi , pagaidi , man taču ir vēl viens dzīvnieks ! "	Pagaidi	18	Imp
Makss asi piebremzēja , lai nesabrauktu pāri ceļam ejošu suni .	piebremzēja	2	Ind
Turpmākajā izglītības attīstībā vajadzīgi vienoti standarti , lai nerastos paradoksālas situācijas , ka absolventi no reģionālajām augstskolām ir mācījušies kaut ko citu nekā rīdzinieki un otrādi .	nerastos	8	Cnd
Ja no Zemes virsas pazustu visi cilvēki , 50 gadu laikā visas dzīvības formas uzplauktu . ”	pazustu	4	Cnd
Tad , manuprāt , būtu jāsecina , spriežot pēc rezultātiem , kurš no tā ir ieguvējs , kurš izdara visu , kas jāizdara , kurš saņem visus smaidiņus , kuri ir uzvarētāji .	jāsecina	5	Nec
Arī mūsu kolektīvs cūkas medījis pastiprināti , taču skaidrs , ka visas nekad neizmedīsim .	neizmedīsim	13	Ind
Es noraidu psihologa padomus ( neciešu psihologus !!! ) , noraidu mācītāja palīdzību un lūdzu atļauju vienatnē apskatīt savu jauno ķermeni .	neciešu	5	Ind
A. Hermanis acīmredzami izmanto šo situāciju , lai sasaistītu savu darbu ar E. Smiļģa mantojuma kontekstu - precīzi prognozējot skatītāju reakciju , galvenos izrādes elementus jau pēc ieceres viņš saista ar V. Artmanes grāfieni .	sasaistītu	8	Cnd
Komentējot jaunākos EK pieņemtos priekšlikumus , kas paredz , ka Latvijai varētu būt jāuzņem 737 bēgļi , Pētersone-Godmane sacīja , ka , atšķirībā no iepriekšējā piedāvājuma , " šis jau ir pietiekami skaidrs un modificēts " .	jāuzņem	13	Nec
Valdība izvirza sev piecus uzdevumus .	izvirza	1	Ind
Pa virsu uzber kanēli un liec cepties līdz 180 grādiem sakarsētā cepeškrāsnī aptuveni 30 minūtes .	liec	5	Imp
Savukārt ārējā pamatojumā tiesai jāizskaidro juridiskā siloģisma premisu izvēle – jāatveido risinājuma rašanas gaitā notikušais dialogs , kurā mijiedarbojušies par lietas faktiskajiem apstākļiem un piemērojamo tiesību normu paustie viedokļi un argumenti .	jāizskaidro	4	Nec
Saprotiet : kad izveidojas ārkārtas situācija , tad pašvaldības vadītājam nu jābrauc acīmredzot pie nozares ministra ( ja , protams , viņš tur var piekļūt pie viņa ) , nozares ministrs dodas uz Ministru kabinetu , visi spriež ...	jābrauc	11	Nec
Ja šāds slimnieks , teiksim , bezpajumtnieks , gūst traumu un jāoperē nekavējoties , brūces dzīšanu ietekmēs gan ādas tīrība , gan viņa veselība kopumā .	jāoperē	11	Nec
Taču dzīvē panika man nav raksturīga , dzīvē es “ uzvelkos ” , ja satieku nelaipnus apsargus , policistus vai pārdevējus .	satieku	14	Ind
Neizpratni , kāpēc būvniecība jāattīsta tieši uz vēsturisku zaļo teritoriju rēķina , aģentūrai LETA pauda Vides aizsardzības kluba ( VAK ) pārstāve Elita Kļaviņa un rajona iedzīvotāji .	jāattīsta	4	Nec
Dari , ko vēlies .	Dari	0	Imp
Viņš teica : „ Uzgaidi tepat , mēs drīz būsim atpakaļ , ” un viņi izgāja un atstāja viņu vienu .	Uzgaidi	4	Imp
Pievieno arī smalki sakapātu ķiploku , citronu miziņas un spinātus .	Pievieno	0	Ind
Bērnam pirmā dzīves gada beigās parādās un pakāpeniski līdz trešajam dzīves gadam pastiprinās fiziskā aktivitāte un pētniecības tieksmes .	pastiprinās	12	Ind
Vienīgi tad , ja Vilnim nebūtu spēka uzrāpties līdz augšai , viņš iemauktu roku cilpā , saliektu elkonī , un Māris viņu uzvilktu augšā .	saliektu	16	Cnd
Ja vēlaties īstus pierādījumus ārpusķermeņa pieredzes esamībai , aizstaigājiet uz lielu konferenci , kurā piedalās vecākie akadēmiķi , un iegriezieties pēdējā vakara diskotēkā .	iegriezieties	19	Imp
Kāda cita sieviete pabaroja izsalkušos , lai gan ēdamais izrādījās negaršīgs , ar kādu asu , nepatīkamu piegaršu , jo produkti bija veci .	pabaroja	3	Ind
Pasaulē nav tādas izglītības sistēmas , kur bērniem katru dienu mācītu dejošanu , līdzvērtīgi kā mācam matemātiku .	mācītu	10	Cnd
Viņš raudāja un teica , viņš zinot , ka neprotu mierināt , un viņš mierināja mani , ka aida šim vēl neesot , tātad man nav jāsatraucas par savu veselību .	jāsatraucas	26	Nec
Es pazūdu , izšķīstu viņā , tik labi ir nebūt .	izšķīstu	3	Ind
Būs jāpieliek arvien lielākas pūles , jāpieņem mērķēti un segmentēti pasākumi , lai to mazinātu .	jāpieņem	6	Nec
Pēc tām nav jābrien purvā kā pēc dzērvenēm vai jālaužas cauri dzelkšņiem , kā lasot kazenes .	jālaužas	9	Nec
Namiņā iekrakšķējās kāpnes , sabiezēja tumsa , ēnas kļuva draudīgākas un atgādināja briesmīgus , līkus āķus .	iekrakšķējās	1	Ind
Žurnāla lapas caurauklo , auklas galus sasien , nostiprina ar uzlīmi , apzīmogo un paraksta , norādot vietu , datumu un cauršūto lapu skaitu .	nostiprina	8	Ind
( 3 ) Privātās profesionālās izglītības iestādes dibina , reorganizē un likvidē juridiskās un fiziskās personas .	reorganizē	9	Ind
Pirms tam džudists Mihails Šteinbuks izcīnīja sudrabu svara kategorijā līdz 55 kilogramiem , bet Laura Ikauniece izcīnīja trešo vietu augstlēkšanas sacensībās .	izcīnīja	16	Ind
Zināt noteikumus , lai tos apietu – šādu pieredzi deva studijas Dānijā .	apietu	5	Cnd
No rīta noņemiet kompresi , noskalojiet kājas siltā ūdenī un paberzējiet pārakmeņojušos ādu ar cietu birstīti .	noņemiet	2	Imp
Jāteic , ka Rīgas rajona vadība , ieskaitot partijas pirmo sekretāru , bija prātīga un mums simpatizēja .	Jāteic	0	Nec
Viņā krastā rūc mašīna , tajā iestiprināta vinča , kas velk gaisā izpletnī iekārušos Stefanu .	velk	10	Ind
Ja masēju nepareizi , vai varu savainot cietušo ?	masēju	1	Ind
Tikpat neiespējami ir domāt par to , ka jāmirst , tai pašā laikā nedomājot par to , cik neticami brīnumaini ir dzīvot .	jāmirst	8	Nec
« Darīsim visu , lai cilvēkus apmācītu un darbu rūpnīcā darītu pievilcīgu , » sola direktors .	apmācītu	6	Cnd
Paps vienīgais tam nepiekrita .	nepiekrita	3	Ind
Šajā gadījumā nazis domāts , lai palīdzētu kumosiņus vieglāk novietot uz dakšiņas .	palīdzētu	6	Cnd
4. Iekļauj šādu iedaļu :	Iekļauj	1	Ind
Kādreiz pastāvēja uzskats , ka pie Pārdaugavas pieminekļa pulcējas tikai pensionāri un , kad viņi aizies citā pasaulē , piemineklis pats par sevi paliks neapdzīvots un nevajadzīgs .	pastāvēja	1	Ind
Vispirms ar speciālu lāpstiņu no manikīra komplekta uzmanīgi atbīdiet kutikulu pie naga pamatnes , lai nagi brīvi elpotu .	elpotu	17	Cnd
Tā ka kādam tās ir jāglabā .	jāglabā	5	Nec
Vienmēr nāksies veidot izglītības sistēmu tā , lai izglītības sistēmā nepieciešamo kvalificēto skolotāju skaits nepārsniegtu to skolotāju skaitu , ko valsts ir spējīga algot tā , lai viņi skolu nepamestu .	nepamestu	29	Cnd
Var lietot arī speciālos attīrošos skrubjus kājām , lai noņemtu atmirušās ādas daļiņas .	noņemtu	9	Cnd
Laid viņu vaļā un brien laukā !	Laid	0	Imp
Sarīvējiet uz smalkās rīves ziepes un izšķīdiniet traukā , ieteicams pievienot mazliet dzeramās sodas un ožamo spirtu , tie lieliski mīkstina nagus un ādu uz kāju pirkstiem .	izšķīdiniet	6	Imp
Ir jānošķir idealizētie ģenealoģiju dati no vispārīgām norādēm par bērnu skaitu .	jānošķir	1	Nec
Jutu , ka no dusmām , bezpalīdzības un kauna piesarkstu .	piesarkstu	9	Ind
Parakstīšu dziesmas , » stāsta Dons .	Parakstīšu	0	Ind
Šī direktīva stājas spēkā dienā , kad to publicē Eiropas Kopienu Oficiālajā Vēstnesī .	publicē	8	Ind
Citi dāvina diplomdarbus - divi no jauniešiem , kas studēja sociālajā jomā un sabiedriskās attiecības , izvēlējās rakstīt par labdarību .	studēja	9	Ind
Tāpēc mums būs daudz vietas , lai nāktu mazākas grupas un notiktu semināri , diskusijas , tikšanās .	nāktu	7	Cnd
Tādēļ vispirms ir jānoskaidro kāzu datums un pēc tam arī jāpajautā līgavainim , vai viņš ir apsvēris , kurā datumā organizēt vecpuišu ballīti .	jāpajautā	10	Nec
1. Dalībvalstīs stājas spēkā normatīvie un administratīvie akti , kas vajadzīgi , lai līdz 2005. gada 8. oktobrim izpildītu šo direktīvu .	izpildītu	18	Cnd
Es nepārspīlētu par to galveno grāmatu vīru .	nepārspīlētu	1	Cnd
Analītiķi atzīmē , ka nevienam nav skaidrs , kādā virzienā dosies valsts ekonomika , kas pārdzīvo grūtus laikus pēc ilgstošas augsmes posma .	pārdzīvo	15	Ind
Vienmēr nāksies veidot izglītības sistēmu tā , lai izglītības sistēmā nepieciešamo kvalificēto skolotāju skaits nepārsniegtu to skolotāju skaitu , ko valsts ir spējīga algot tā , lai viņi skolu nepamestu .	nepārsniegtu	14	Cnd
Un , lai nepieļautu , ka mēs pret jums izmantotu nākotnē šo instrumentu , ko jūs vēršat pret mums , aicinu jūs tomēr varbūt apdomāt to stāvokli , kurā jūs atrodaties , un tomēr to atbalstīt .	nepieļautu	3	Cnd
Tā atskaitīsies valdei , sastāvēs no astoņiem neatkarīgiem ekspertiem un rīkotājdirektora .	sastāvēs	4	Ind
Nu mums ir jābūt uzmanīgiem , lai šo dāvanu izmantotu gudri , un izvairītos no dažiem scenārijiem , par kuriem runājām .	izmantotu	9	Cnd
Tev tikai jāatstāj zīme man vēstuļu kastē .	jāatstāj	2	Nec
Bet lieta ir tāda , ka Tev nevajadzētu būt vienai no tiem , kas pieņem pasauli par kaut ko dotu , mīļā Sofij !	nevajadzētu	7	Cnd
Viņa kopā ar vīru jau četrus gadus dzīvo ārzemēs , tāpēc krīze Latvijā viņu neietekmē .	neietekmē	14	Ind
Taču atsakoties no jebkādas ticības rakstītiem līgumiem , diplomātija zaudētu savu jēgu .	zaudētu	9	Cnd
( 12 ) Komisijai jāiesniedz Eiropas Parlamentam un Padomei ziņojums par šīs direktīvas ieviešanu un piemērošanu jo īpaši attiecībā uz jauniem nodarbinātības veidiem , kas rodas dalībvalstīs ,	jāiesniedz	4	Nec
Dievinu sajūtu , kad vīrieši , kurus apdzenu , piebrauc man klāt , paskatās uz mani un , ieraugot pie stūres meiteni , parāda neticošu sejas izteiksmi , » smejas Viola .	apdzenu	7	Ind
Lai tādus nevajadzētu tērēt , Aivars Plinte gribot likt lietā Čehijā redzētu uzrikti .	gribot	7	Nec
Ibiss stīvi blenza ekrānā , Silvestrs nodevīgi cieši pētīja kreisās rokas īkšķa nagu .	blenza	2	Ind
Un nolikto atslēgu mehānisms ir tas regulators , kurš nostāda tirgū nekustamo īpašumu reālo , nevis uzpūsto cenu , jo motivē hipotekāros kreditorus necelt izsniedzamos kredītus virs cenas , par kuru viņiem varbūt nāksies īpašumu pārdot .	motivē	20	Ind
Ja Vilnis nokristu , Māris viņu nevarētu izglābt .	nevarētu	6	Cnd
Šī ir diena , kad dzīvie vienosies ar mirušajiem , kad atvērsies Ēģiptes nozīmīgākais templis un pa vārtiem laukā plūdīs krāšņs gājiens .	plūdīs	19	Ind
Tādējādi skolotāju skaits nemainīsies atkarībā tikai atbilstošā vecuma skolēnu skaita valstī .	nemainīsies	3	Ind
Godājamie kolēģi , turiet stingru mugurkaulu !	turiet	3	Imp
Bijušā vīra argumenti bija gana pārliecinoši , lai liktu tiesnesim anulēt sava kolēģa pieņemto lēmumu un norunāt vel vienu tiesas sēdi .	liktu	8	Cnd
Viņa sejas izteiksme liecināja , ka tas ieklausās mūzikā .	ieklausās	7	Ind
« Ar visiem strīdiem mēs apstiprinājām , ka ir jāvirzās uz priekšu un valdība ceturtdien ir jāapstiprina , » Kučinskis norādīja .	jāvirzās	9	Nec
Vienkārši atlieciet nodarbības un dodiet sev laiku , lai mazliet iejustos .	iejustos	10	Cnd
Kā norāda Andžejs Viļumsons , tad , lai nodrošinātu finansējumu aizsardzības sektoram , „ Aizsardzības ministrijai bija būtiski visos stratēģiskajos plānošanas dokumentos pie prioritātēm salikt dalību starptautiskajās operācijās ” .	nodrošinātu	8	Cnd
« Patija redzēja , kā ar nitroglicerīnu piekrauts vilciens pilnā ātrumā traucas uz priekšu un draud noskriet no sliedēm .	traucas	11	Ind
Ja pēc maltītes pāri paliek kādi gatavi produkti , nemet tos laukā !	nemet	9	Imp
Interese par to , kāpēc mēs dzīvojam , nepavisam nav tikpat nejauša kā interese par pastmarku krāšanu .	dzīvojam	6	Ind
Slavenības smej , sakot , ka Kūpers pats noalgojis līdzinieku , lai kompensētu savu neierašanos festivālā .	kompensētu	12	Cnd
Tur ārpusē , smalko spalviņu galā , viņa bija ieraudzījusi pasauli tā , it kā skatītu to pirmoreiz .	skatītu	15	Cnd
Eotekls dodas brālim pretim , lai divkaujā izšķirtu jautājumu , kam būt valdniekam , un ar to glābtu pilsētu no izpostīšanas .	glābtu	17	Cnd
Paklausies baroka mūziku !	Paklausies	0	Imp
Aleksim nācās pamatīgi piepūlēt acis , lai izlasītu smalko druku .	izlasītu	7	Cnd
Šāda soļa īstenošanai būtu preventīvs raksturs , tas palielinātu drošību reģionā , lai kaimiņam nerastos " muļķīgas domas " .	nerastos	14	Cnd
Jo , lai arī bērns nemāk vel runāt , mes redzam , kā viņš uz visu norāda un ziņkāri tver pēc visām lietām , kas ir ap viņu .	nemāk	5	Ind
Sākotnēji ir jāsaprot , ka partnera agresija nav domāta tev personīgi , bet viņš to dara , lai jums abiem sekss būtu lielisks , bet , ja nevēlies vairs to – parādi kā jūties : apmainieties lomām .	parādi	31	Imp
Gita vēlētos iemācīties slēpot , jo to neprot un nekad nav mēģinājusi , bet ziemas priekus parasti bauda snovojot .	vēlētos	1	Cnd
Vakarā gājām gulēt ar tādām domām , bet , paldies Dievam , nāca rīts , kas nesa citu noskaņu , un atkal bija šī rosīgā darbība .	nesa	16	Ind
" Kolibris " turnīrs notika pēc trīsmīnusu sistēmas , kas nozīmē , ka pēc trešā zaudējuma komanda izstājas .	izstājas	17	Ind
Dārzā jāstrādā , jāstrādā un jāstrādā : jāstāda jauni kociņi , jāizzāģē zari , jāsmidzina pret dažādiem kaitēkļiem , jānovāc raža .	jānovāc	19	Nec
Sataustīju visus ieročus pret nelabo , taču mans biedrs klausījās sarunā .	Sataustīju	0	Ind
Mangoldu lapas noskalo .	noskalo	2	Ind
Visu samaisi , vislabāk – izmantojot rokas .	samaisi	1	Ind
Proti , iekšējā pamatojumā tiesai jāataino juridiskais siloģisms – jāatklāj lietas risinājuma loģiskā saikne ar lietas faktiskajiem apstākļiem un piemērojamo tiesību normu .	jāatklāj	9	Nec
Ir nepieciešami dažādu līmeņu profesionāļi , tāpēc tūrisma eksperti pieļauj , ka ne visiem obligāti būtu jābūt ar augstāko izglītību — atsevišķām vakancēm pilnīgi pietiktu ar kvalitatīvu , uz praksi orientētu profesionālo izglītību .	pietiktu	24	Cnd
Aizbraucam pēc pieciem gadiem , un mums saka - jā , senāk to un to neizdomājām .	neizdomājām	15	Ind
Ja pusaudzis ir gatavs jums uzticēties , klausieties uzmanīgi viņa teiktajā .	klausieties	7	Imp
Pirms tam gan rūpīgi izlasi derīguma termiņus un novērtē , vai varēsi izlietot produktu līdz derīguma termiņa beigām .	izlasi	4	Imp
Lai varētu kopā ar mani kaut kur aizbraukt , ja man piepeši sagribētos .	sagribētos	12	Cnd
Pārskati dalībnieku sarakstu , noskaidro , vai visi ir atbildējuši uz ielūgumiem .	Pārskati	0	Imp
Lai neizjauktu ieplānotos darbus , pārbūvējamā dzīvokļa saimnieks var mēģināt vienoties par abpusēji izdevīgiem nosacījumiem ar kaimiņiem .	neizjauktu	1	Cnd
Lai arī iedzīvotāji uzskata , ka būtu vairāk jāattīsta atjaunojamās enerģijas izmantošana , tai pašā laikā arī valda uzskats , ka jauna cietā kurināmā stacija palīdzētu dažādot izmantojamās enerģijas veidus un radīt jaunas darba vietas pilsētā .	jāattīsta	8	Nec
Visi nostājāmies un stāvējām .	nostājāmies	1	Ind
Priecīgi ierejas , paskrien nost , tad metas virsū un gāž nost no kājām .	ierejas	1	Ind
Noteikti vēlētos strādāt pie teorētiska reliģiskās izglītības modeļa veidošanas Latvijas vajadzībām .	vēlētos	1	Cnd
Lietus spirāliskiem lokiem tecēja pa viņas matiem , kas arvien vairāk saskrullējās .	tecēja	3	Ind
Kate satvēra viņu aiz rokas un ieveda kroga dziļumā .	satvēra	1	Ind
Pamatojumā tiesai jāparāda , kā tā nonākusi līdz lietas risinājumam ( iekšējais pamatojums ) , un jāizskaidro , kāpēc tā devusi priekšroku vienam , nevis otram risinājumam ( ārējais pamatojums ) .	jāizskaidro	16	Nec
Blenderī liec visas sastāvdaļas , izņemot ledu , un sasmalcini .	sasmalcini	9	Imp
Un tiešām pievērsiet uzmanību tam , no kā tiek finansēti šie pasākumi !	pievērsiet	2	Imp
Viens no spilgtākajiem politiķiem , kas aizstāv šo ideju ir bijušais Beļģijas premjerministrs Gijs Verhofstads .	aizstāv	6	Ind
3. Dalībvalstis veic visus efektīvos un piemērotos pasākumus , lai izskaustu tradicionālās ieražas , kas kaitē bērnu veselībai .	izskaustu	10	Cnd
Saki , ka mūs nevajag aizmirst un mēs vēl kvēlojam tumsā .	Saki	0	Imp
Un es zinu , ko jūs teiksiet - nav vērts domāt par bailēm , ir jādzīvo !	jādzīvo	15	Nec
Šoferis to neredzēja , jo viņam skatu aizsedza pie vārtiem augošais kuplais pīlādzis , bet es nepaspēju vārtus noķert – un tā mašīna salauza vārtus .	aizsedza	7	Ind
Turklāt tiesai jācenšas , lai nolēmumu atzītu arī sabiedrība , tādā veidā nodrošinot tam maksimālu leģitimitāti .	atzītu	6	Cnd
Domāju visādi , bet beigās izdomāju , ka tā spāņi atbalsta savus vīndarus , nevis anonīmus ārvalstu vodkas , martini un ruma ražotājus .	Domāju	0	Ind
Florence aplūkoja savas domas , aplūkoja vārdus — kā tie jocīgi pulsē un kursē pelēkajā telpā aiz aizvilktiem aizkariem .	kursē	13	Ind
Mēs iebraucam meža ceļā un skūpstāmies , viņa skūpsti sasien mani mezglā , un neatsietai man jābrauc mājās , jo mašīnā mīlēties viņš negrib .	skūpstāmies	5	Ind
“ Lai gan jāteic , ka šī slimība Latvijā ienāca no Krievijas , un , visticamāk , tieši cilvēku ienāca dēļ .	jāteic	3	Nec
Bet saprotiet : ja ir plūdi vai ugunsgrēks , tad pa to laiku viss jau sen ir beidzies , kamēr šis process ir nonācis līdz augsti godājamai Saeimai , kurā mēs nu tātad atbalstām šo vēlmi ...	saprotiet	1	Imp
Citādi ir pārāk pasīva pozīcija , tikai virtuvē brīnāmies .	brīnāmies	8	Ind
Pobedska izkāpa no taksometra lidostā .	izkāpa	1	Ind
Remonta dēļ gājēju kustība nav aizliegta , ir droša , tomēr ļaudis gribētu , lai uz tilta uziet būtu ērtāk .	gribētu	12	Cnd
Vienīgi tad , ja Vilnim nebūtu spēka uzrāpties līdz augšai , viņš iemauktu roku cilpā , saliektu elkonī , un Māris viņu uzvilktu augšā .	uzvilktu	22	Cnd
– Mūsu ģimenē vienmēr ir bijis tāds uzskats , ka ja tu sporto – tad vari ēst visu .	sporto	12	Ind
Uzzinot , ka TV3 gatavojas publiskot šo informāciju , Telešs ceturtdien iesniedza atlūgumu .	gatavojas	4	Ind
Visas kaula bruņas sadedzināju un sabēru kompostā .	sabēru	5	Ind
Tas tāpēc , lai ekonomiskāk izmantotu materiālus un kaut kādu ne pārāk svarīgu centimetru dēļ nebūtu meistaram lieki kaut kas jāzāģē , jo zinu , ka meistaru darbs ir dārgs , un arī materiāli jātaupa .	jāzāģē	20	Nec
Un tādā gadījumā šāds jautājums nemaz nerastos .	nerastos	6	Cnd
Jāatzīst , dzirdot pasāžu par mēli un dažādām Katrīnas ķermeņa vietām , es patiešām zaudēju savaldīšanos .	Jāatzīst	0	Nec
Droši vien , ja nebūtu parādījies tu , tā kļūtu par barību ķirmjiem vai lēnām sapūtu .	sapūtu	15	Cnd
Iespēja braukt bijusi arī pērn , bet tad pašiem jāsameklē finansējums .	jāsameklē	9	Nec
Starp citu , gatavojot paelju , jāatceras , ka galvenais nav sastāvdaļas , – tās atkarībā no sezonas un reģiona var mainīties .	jāatceras	6	Nec
Upe plūst , tecila griežas , mēness trin sānus , izlec pa dzirkstij , izkrīt pa zvaigznei , tilts sakumpis , uzmetis lūpu , gumst zem signāliem , elpām un riteņu dunēšanas .	trin	7	Ind
Pusaudžu gaitām tomēr jāpaseko .	jāpaseko	3	Nec
Diemžēl priekšnojauta , kas parasti mani brīdina , pasargā , līdz izsprukt sveikā , todien mulsi klusēja , varbūt pat snauda .	brīdina	6	Ind
Tad pievieno ledu un blenderē līdz vienmērīgai konsistencei .	blenderē	4	Imp
Pienāca brīdis , kad jāapzinās : vai nu slimnīca top tūdaļ , vai celtniecību turpina iepriekšējā garā – par 200_000 latiem gadā vēl vismaz desmit gadu .	jāapzinās	4	Nec
Savukārt pavasaris un vasara piekrastē , pateicoties apstākļiem , ka jūrā ūdens sasilst lēnāk nekā sauszeme , ir vēsāka .	sasilst	12	Ind
Tāpat arī Gomesas māte vairākas nedēļas nav sazvanāma , kas mākslinieces paziņām liek domāt , ka tieši Mendijai ir jārūpējas par meitas atveseļošanos .	jārūpējas	19	Nec
7. Lai no mājdzīvnieku spalvām atbrīvotu mīkstās mēbeles , uzvelc gumijas cimdu un pārbrauc roku pār netīro dīvānu .	uzvelc	9	Imp
Kā parasti , runcis Šerekāns izlīda no krūmiem , pārlēca trepju pakāpieniem un veikli ielavījās iekšā , pirms Sofija paspēja aizvērt durvis aiz sevis .	izlīda	5	Ind
Viņiem izejot no istabas , viņš mātei teica : „ Pastāviet un paskatieties uz viņu ”	Pastāviet	10	Imp
Valsts prezidenta Andra Bērziņa dzīvesbiedre Dace Seisuma kā jaunā Latvijas Audžuģimeņu biedrības ( LAB ) patronese 27. septembrī apmeklēs biedrību , lai labāk iepazītos ar tās darbu , informēja biedrības vadītāja Ilze Golvere .	iepazītos	23	Cnd
Arī pie klinšradzēm , knapi turoties , karājās cilvēki , lai tikai dzirdētu , ko teiks tempļa atklāšanā .	dzirdētu	12	Cnd
Pašvaldības darbinieki sadarbībā ar finanšu stabilizācijas uzraugu un Finanšu ministrijas darbiniekiem ir paveikuši lielu darbu , lai turpmāk šādu situāciju nepieļautu un nodrošinātu iedzīvotājiem stabilu un drošu vidi , " komentējot paveikto novadā , norāda finanšu ministrs Andris Vilks .	nodrošinātu	22	Cnd
Ja tā padomā , visa pasaules publiskās izglītības sistēma ir ilgstošs process , lai iestātos universitātē .	iestātos	14	Cnd
Vecmamma lokās un cīnās kliegdama , bet Jasmīne ātri ielaiž devu .	cīnās	3	Ind
Ja šāds slimnieks , teiksim , bezpajumtnieks , gūst traumu un jāoperē nekavējoties , brūces dzīšanu ietekmēs gan ādas tīrība , gan viņa veselība kopumā .	ietekmēs	16	Ind
Apgalvošu arī to , ka savā darbībā mēs nevienu reizi neesam konsultējušies vai jelkādā veidā nonākuši kontaktos ar kādu no Eiropas Savienības tieši šāda veida tautsaimniecības komisijām .	Apgalvošu	0	Ind
Garie , gaišbrūnie mati iekļauj gandrīz bērnišķīgu sejiņu , kas vēl nezina it neko no tā , kas tai būs jāpiedzīvo .	jāpiedzīvo	20	Nec
Pilsoniskā žurnālistika ir viss process , kur sabiedrības locekļi aktīvi vāc , ziņo , analizē un izplata ziņas un informāciju .	analizē	14	Ind
Viņa sāka soļot , uzmanīgi liekot kājas , lai nepaslīdētu slapjajā sniegā , kungs sekoja , maigi , gandrīz nepieskaroties vadīja viņu zem elkoņa .	nepaslīdētu	9	Cnd
Nespēlē mūziku , tu nebūsi mūziķis ; nenodarbojies ar mākslu , tu nebūsi mākslinieks .	nenodarbojies	7	Imp
Un , lai nepieļautu , ka mēs pret jums izmantotu nākotnē šo instrumentu , ko jūs vēršat pret mums , aicinu jūs tomēr varbūt apdomāt to stāvokli , kurā jūs atrodaties , un tomēr to atbalstīt .	izmantotu	9	Cnd
Bet , ja spēle domāta diviem vai vairākiem , tad gribot negribot bērnu dusmas un savstarpējie aizvainojumi jāaizmirst .	jāaizmirst	17	Nec
Tas stiprināja krīzes pamatakmeni .	stiprināja	1	Ind
1935. gada janvārī Baltijas valstu ārpolitikā iestājās šķietams apsīkums .	iestājās	6	Ind
Makss asi piebremzēja , lai nesabrauktu pāri ceļam ejošu suni .	nesabrauktu	5	Cnd
Jāpiekrīt , ka vēlēšanas nudien bija vēsturiskas – ne tikai tādēļ , ka pie varas nāca pirmais melnādainais prezidents , bet galvenokārt tādēļ , ka Republikāņu partija vēlēšanās zaudēja tik pārliecinoši .	Jāpiekrīt	0	Nec
Daudz nedomājis , pateicu , ka nevajadzēs , jo nevienam man nav par to jāatskaitās .	jāatskaitās	14	Nec
Un tikai tagad vagars ieraudzīja princesi , — kā jūsmīgs pavasara zieds ielija viņam krūtīs , protams , bez patikšanas , te vieta likta tikai mīlestībai .	ielija	12	Ind
Uzlejot melno tēju , ūdens jāuzvāra pilnībā .	jāuzvāra	5	Nec
Vienkārši atlieciet nodarbības un dodiet sev laiku , lai mazliet iejustos .	atlieciet	1	Imp
Kad bija jāsāk apsvērt iespēja kaut kur mācīties , lai apgūtu profesiju , no drauga , kurš arī gatavojās studēt kino jomā , uzzinājis , ka Dānijā ir tāda Eiropas Kino koledža .	jāsāk	2	Nec
Viņš dara visu , lai šie izbraucieni neiekristu ne sestdienās , ne svētdienās .	neiekristu	7	Cnd
Piesūciniet kokvilnas zeķes ar siltu augu eļļu un uzvelciet tās kājās , un virsū uzvelciet plastikāta maisiņus , bet uz tiem uzvelciet vēl vienu zeķu pāri .	uzvelciet	8	Imp
Ja galīgi negribas lasīt Aspaziju – noteikti jāpalasa Aspazija .	jāpalasa	7	Nec
Jāatzīmē , ka tikko pabeigtajos projektos " Pine Breeze " un " Mārtiņa nams 2 " praktiski visi dzīvokļi jau ir pārdoti .	Jāatzīmē	0	Nec
Uzskatu , ka viss vēl nav zaudēts , jācīnās , » tā Uģis _ Zeltiņš .	jācīnās	8	Nec
Stilizētā gaitā uznāk R. Razumas lords Henrijs , pieiet pie Vailda .	pieiet	8	Ind
Tagad būs drusku jāpieceļas , tu pagaidām vēl elpo mākslīgi , mēs izņemsim tev elpošanas caurulīti no elpvada , mēģini dziļi ieelpot ( izelpot ? ) tad , kad es teikšu .	jāpieceļas	3	Nec
Ņemiet vērā , viņi bija nosvinējuši ceturto gadadienu , jo mēnesis 16 gadu vecumā ir ilgs laiks .	Ņemiet	0	Imp
Piepildiet trauku ar ūdeni .	Piepildiet	0	Imp
Tātad ir jāpārliek šie akcenti un cilvēki ir jāmudina ievērot šo veselīgo dzīvesveidu .	jāmudina	8	Nec
Palīdziet savam mazulim izvēlēties mīļāko grāmatu par dzīvniekiem .	Palīdziet	0	Imp
Laid viņu vaļā un brien laukā !	brien	4	Imp
3. Pašreizējais no valsts budžeta finansētais studiju vietu skaits ilgtermiņa nenodrošina pedagoģisko darbinieku sastāva atjaunināšanu vispārējās izglītības sistēmai .	nenodrošina	10	Ind
Taču es negribētu izklausīties pārlieku negatīva , jo šī ir tikai daļiņa no kopējās bildes .	negribētu	2	Cnd
Izgriez pakaramos .	Izgriez	0	Imp
Manuprāt , nāktos secināt , ka visas izglītības sistēmas mērķis visā pasaulē ir ražot universitātes profesorus .	nāktos	2	Cnd
Ja jūs noņemat naga nelīdzeno virskārtu , tad dariet to ar mīksto saaudzējošo nagu vīlīti , lai netraumētu naga emalju .	netraumētu	17	Cnd
Viņa uzskrēja augšā savā istabā , nolika sev priekšā lielo cepumu kārbu , kurā glabājās daudzi skaisti akmentiņi , izbēra akmentiņus uz grīdas un ielika abas lielās aploksnes kārbā .	uzskrēja	1	Ind
Arvien grūtāk man nākas izdomāt iemeslu vakaru prombūtnei : kosmētiskais kabinets , baseins , draudzene , aerobika , bet viņš , liekas , to nepamana , viņš vispār neko nepamana .	nepamana	29	Ind
( 5 ) Lai attiecīgajiem darbiniekiem nodrošinātu taisnīgu aizsardzību , maksātnespējas definīcija ir jāpiemēro jaunajām likumdošanas tendencēm dalībvalstīs un šajā jēdzienā jāiekļauj arī maksātnespējas procedūras , kas nav likvidācija .	nodrošinātu	6	Cnd
Nogrieziet nagus , piešķiriet tiem glītu formu .	Nogrieziet	0	Imp
Būs jāpieliek arvien lielākas pūles , jāpieņem mērķēti un segmentēti pasākumi , lai to mazinātu .	jāpieliek	1	Nec
Tā kā nāve tādā gadījumā neiestājas uzreiz , tā nav acumirklīga , pašnāvniecei ir dota iespēja apdomāties , lai lūgtu pēc palīdzības , tāpēc viņas biežāk var tikt izglābtas .	lūgtu	19	Cnd
Jo īpaši ir jānorāda iespējamie izņēmumi , ko piešķir dalībvalstīm direktīvas noteikumu ieviešanā , un tādējādi ir jāsvītro tās pielikums .	jānorāda	3	Nec
Pajautājuši , vai man ir iedurts , un saņēmuši atbildi , ka nav , kārtības sargi nosprieda , ka nav noticis nekas tāds , lai viņi dotos uz notikuma vietu .	dotos	26	Cnd
Tas tāpēc , lai ekonomiskāk izmantotu materiālus un kaut kādu ne pārāk svarīgu centimetru dēļ nebūtu meistaram lieki kaut kas jāzāģē , jo zinu , ka meistaru darbs ir dārgs , un arī materiāli jātaupa .	jātaupa	34	Nec
Mums ir skaidri jāapzinās , ka izglītības sistēma ir nozīmīgs faktors , lai Latvijā nākotnē augtu iekšzemes kopprodukts , lai mēs būtu konkurētspējīgāki .	jāapzinās	3	Nec
Deviņdesmito gadu sākumā Piedņestras apgabals atdalījās no Moldovas , taču pašpasludinātā republika netika oficiāli atzīta .	atdalījās	5	Ind
Bet paradokss ir tas , ka bibliotēku katru dienu apmeklē 4000 cilvēku , bet lasītavā vietas jāpiesaka caur internetu .	apmeklē	9	Ind
Reizi pusgadā dodos uz sanatoriju un izeju visas iespējamās masāžas , lai to saspringumu noņemtu .	noņemtu	14	Cnd
Rute noģērbjas .	noģērbjas	1	Ind
Tas ir pirmais posms , kurš noslēdzas ar skolas beigšanas teorijas un arī braukšanas eksāmenu .	noslēdzas	6	Ind
Un ja vēl jāoperē .	jāoperē	3	Nec
Guļu , guļu , pamostos un pamanu , ka acis man sarkanas .	Guļu	0	Ind
Ja Tu vēlētos pārtraukt šo kursu , Tev ir pilnīga iespēja to izdarīt .	vēlētos	2	Cnd
Nagus ir jāvīlē tikai vienā virzienā – no malas uz vidu .	jāvīlē	2	Nec
Vērsieties pēc palīdzības pie ārsta vai pieredzējuša pedikīra meistara .	Vērsieties	0	Imp
Hēra aizstāv laulību un sargā laulības saišu nepārkāpjamo svētumu .	aizstāv	1	Ind
Neaizmirstiet burkānu salātiem vai sulai pievienot nedaudz taukvielu , tādējādi beta karotīns vislabāk uzsūksies organismā .	Neaizmirstiet	0	Imp
Šādā veidā Latvijā joprojām noteicošās represīvās un dārgās kriminālpolitikas nostādnes pakāpeniski un mērķtiecīgi jāaizstāj ar elastīgāku , liberālāku un sabiedrības drošībai atbilstošāku politiku .	jāaizstāj	13	Nec
Laikam nav bijis speciālistu , kas pārzinātu drošības politiku tā , ka , izmantojot šo materiālu , spētu ne tikai definēt problēmas , bet tās arī analizēt , piedāvāt iespējamos risinājumus .	pārzinātu	6	Cnd
Sākotnēji ir jāsaprot , ka partnera agresija nav domāta tev personīgi , bet viņš to dara , lai jums abiem sekss būtu lielisks , bet , ja nevēlies vairs to – parādi kā jūties : apmainieties lomām .	apmainieties	35	Imp
Pēdējā īsziņa , ko saņēmu no viņa tai vakarā , kad es paklupu , bija liec mani mieraa .	liec	15	Imp
Lai kā mums gribētos ar viņiem slēgt mūsu sagatavotus līgumus , viņi strādā ar saviem līgumiem , un tajos piegāžu neizpildes gadījumā ir jāsedz , piemēram , pat negūtā peļņa .	jāsedz	23	Nec
Ņemot vērā lielos finansu resursus , kas ir jāiesaista pedagoģisko darbinieku izglītošanā , pētījumam nepieciešamais finansējums , novēršot iespējamās kļūdas pedagoģisko darbinieku sagatavošanas plānošanā , var dot ievērojamu ekonomisko efektu .	jāiesaista	8	Nec
Tāpēc , kas būtu jāstimulē valstij - jāatbalsta kaut kādas kvalitātes lietas .	jāstimulē	4	Nec
Lai to izdarītu ideāli , būtu jānomaina visi ventiļi , kas ir dārgi , jāapzina , cik mājā ir radiatoru , un ar datoru jāizstrādā balansēšanas programma .	jāapzina	14	Nec
Likumdevējam rūpīgi jāseko , lai pieņemtie krimināllikumi atbilstu reālās dzīves prasībām , gan neatpaliekot , gan arī pārāk neapsteidzot tās , kļūstot par bezsatura normām .	atbilstu	7	Cnd
Ņem taču viņu , re , kā viņš bolās uz tevi !	Ņem	0	Imp
Arī līgumi ar lielveikaliem ir jāpilda precīzi , citādi jāmaksā soda naudas .	jāmaksā	9	Nec
B. Vītoliņa : – Es aicinātu cilvēkus būt saprātīgiem un neticēt tam , ko raksta .	aicinātu	5	Cnd
Piesūciniet kokvilnas zeķes ar siltu augu eļļu un uzvelciet tās kājās , un virsū uzvelciet plastikāta maisiņus , bet uz tiem uzvelciet vēl vienu zeķu pāri .	uzvelciet	21	Imp
Nekas nesanāks , ja jūs viņu pārtrauksiet , vērtēsiet un apstrīdēsiet .	vērtēsiet	8	Ind
Jāsecina , ka otrā , trešā un ceturtā nozīme ne vienmēr ir viegli nošķiramas , var runāt arī par to savstarpēju pārklāšanos .	Jāsecina	0	Nec
Tie darbojās tā , lai laistu caur sevi maksimālo dienas gaismas daudzumu ( Tv = 38 % ) pie paaugstināta mākoņainuma un minimālu dienas gaismas daudzumu laistu saulainā laikā ( Tv = 11 % ) .	laistu	5	Cnd
Otra māsa - Ismēne - atsakās pārkāpt Kreonta aizliegumu un palīdzēt māsai .	atsakās	5	Ind
Malā sēdošās meitenes viņiem seko .	seko	4	Ind
