Omzunun üstünden fotoğrafı görebiliyordum .	görebiliyordum	3	Sing
Recep , pantolonunu giymiş , gömlek cebinden çıkardığı sigarayı ağzına koymuştu .	giymiş	3	Sing
Oraya nasıl ulaşılacağını , nereden gidileceğini hiç bilmiyorum .	bilmiyorum	7	Sing
Ama söylediği fikir şahsi fikri , aslında genel bir görüşü kapsıyordu .	kapsıyordu	10	Sing
Çöktü koltuğa , pıtır pıtır dökülüyor gözyaşları .	Çöktü	0	Sing
Verin onu bana .	Verin	0	Plur
Ama bir ihtimal var , değil mi ? Sırf sana olan kızgınlığımı birine anlatmam halinde üzerimden bir yük kalkar , gerilimim azalır , sana daha hoşgörülü yaklaşabilirim , daha bağışlayıcı olabilirim .	olabilirim	30	Sing
Sanırım gezmediği ülke , danışmanı olmadığı kimse , bilmediği ilke kalmadı .	kalmadı	10	Sing
( Gündelik hayatlarının bir felsefesi ve ilkeleri olmadığı için her duruma , her ortama ayak uydurabiliyorlar .	uydurabiliyorlar	15	Plur
" Bankalar öyle bir izlenim yarattı ki sanki verilen hizmetler hava , su gibi ücretsiz olabilir " diyen Demiray , bundan sonra verilen hizmetlerden ücret alınacağını bildirdi .	yarattı	5	Sing
Teşvik uygulama , Sanayi Bakanlığı'na bağlansın .	bağlansın	5	Sing
Ona , Seni çok sevdiğim için seninle olamazdım , sana duyduğum sevgi çok korkuttu beni , diyemezdim .	diyemezdim	16	Sing
Nüfuslarının azalmasına paralel , kültürleri de dönüşüme uğradı .	uğradı	7	Sing
Kalmayız , dedi , koşa koşa gideriz , erikleri de senin heybene doldururuz .	doldururuz	12	Plur
O gece rüyamda ben balerin olmuştum .	olmuştum	5	Sing
Vazo almak isteyenler çoğunlukta .	isteyenler	2	Plur
Hastaneye yatırmışlar kaç defa , biraz düzelir gibi oluyor , ay geçmeden başlıyor daha beter içmeye .	yatırmışlar	1	Plur
Saime Sezginler aylarca çalışmış , kardeşinin arkadaşlarıyla saatlerce konuşmuş , kitaplar tercüme etmiş , ettirmiş ve bir uzmanın sahip olacağı teknik bilgiyi öğrenmişti .	öğrenmişti	22	Sing
Bir Aydınlık gazetesi aldı , kazayla ilgili çıkan ilk haberi okudu ve hemen telefona sarıldı .	sarıldı	14	Sing
Hem süt emsin hem de biraz daha büyüsün . demişti .	büyüsün	7	Sing
Arabesk yerine Türk Pop Müziği'ni tercih ediyorlar .	ediyorlar	6	Plur
Takipsizlik karar metni yalnızca anne ve babaya gönderilmişti .	gönderilmişti	7	Sing
Melek bana yardım edersen çocuklarla başa çıkarım , dedi üsteleyerek Memo .	çıkarım	6	Sing
Kahramanlarınızın , kadın - erkek ilişkilerine dönük yönlerinde de , kulaklarınıza inanamıyor ve duyduklarınızla düş kırıklıklarına duçar oluyorsunuz .	oluyorsunuz	17	Plur
Bakarız , dedi kadın , sonra sandalyesini biraz yan çevirdi , çalgıcıları görmek için .	Bakarız	0	Plur
İzini bulursanız , bu numaraya haber verirsiniz , dedi .	bulursanız	1	Plur
Yola düştük .	düştük	1	Plur
Acemi vücutlarının , aldıkları alkolün de etkisiyle , ancak çırpınış düzeyine ulaştırabildiği göbek dansını kesen turistlerin yerlerine oturmaları birkaç dakika bile sürmezdi .	sürmezdi	21	Sing
' Cumhuriyet'ten sapmayız Verheugen .	sapmayız	2	Plur
Ancak Batı'nın şekerle başlayan ve ağrı kesicilerle devam eden bağımlılıkları onlara da ulaşmıştı .	ulaşmıştı	12	Sing
Erkek öğretmen daha sert olur , kızlarla anlaşamaz diye düşünüyorum .	anlaşamaz	7	Sing
Elinde kağıtlar tutuyordu .	tutuyordu	2	Sing
Hastaneye yatırmışlar kaç defa , biraz düzelir gibi oluyor , ay geçmeden başlıyor daha beter içmeye .	düzelir	6	Sing
Bizimkinde , bilinmeyen bir Öteki Dünya'da aklımıza hayalimize gelmeyecek cezalara uğrama korkusu var .	gelmeyecek	8	Sing
O da pek salmadı kendini .	salmadı	3	Sing
İncecik bacaklarını birbirinin üzerine atmıştı , geniş koltuğun üzerinde rahatça oturuyordu .	atmıştı	4	Sing
Onu gözlemledim .	gözlemledim	1	Sing
Yanına annesini de alan Şıkel , " Herkes beni zaten yanlış tanıyor , ne desem boş , inanılmaz derecede bunaldım .	bunaldım	19	Sing
Çoğu , çok kere beni daha çok falan filan bulurlarmış .	bulurlarmış	9	Plur
Geçici bütçe tasarısı , Meclis'e sunuldu .	sunuldu	5	Sing
Neden onlar doğuştan anne olurlar da erkekler baba olmayı ancak öğrenerek elde edebilirler .	edebilirler	12	Plur
Yan gözle inceleniyorum bir yandan .	inceleniyorum	2	Sing
Zeynep : Yemin ederim ki kimseye bir şey söylemeyeceğim .	ederim	3	Sing
Ama göreve çağrıldı .	çağrıldı	2	Sing
Dolaşıp durma , başım dönüyor .	durma	1	Sing
Pilaki ile Piyaz yarışırlar .	yarışırlar	3	Plur
Böylece , insanlarla beraber kal ve yalnızlığı unut .	kal	4	Sing
Gece zamanı buldunuz bu kıraathaneyi .	buldunuz	2	Plur
Geldik ! diye bağırdı Kerem .	Geldik	0	Plur
İNANOĞLU , bu konuda " Evet , böyle şeyler söyledim ama artık işlerim yoluna girdi .	girdi	14	Sing
Şimdi hiçbir şeye yaramadıklarını düşünsem de , yaşayabilmek için yazmak ! Böylece , o beklemekle , aramakla , bütün bu zaman parçalarını dolduracak olan boşlukla ve sıkıntıyla dolu yaşam çizgimi belirledim sanıyorum .	belirledim	30	Sing
House Zirvesi'nde TÜSİAD Başkanı , her yıl istihdam yaratmanın yolunun , yüksek ve istikrarlı büyüme temposundan geçtiğini vurguladı .	vurguladı	17	Sing
Yine sinirlendim .	sinirlendim	1	Sing
Sana gölgede yatma dedik sıpa .	dedik	3	Plur
Evet , dayanamıyorum .	dayanamıyorum	2	Sing
Çantasını karıştırıyor , bir kalem arıyordu .	karıştırıyor	1	Sing
Bu kuruluşlar da paralarını Merkez Bankası veya muhabiri niteliğindeki Ziraat Bankası'nda açacakları hesaplarda toplayacaklar .	toplayacaklar	13	Plur
Yanlışlanabilirlik ilkesi ne yazık ki çoğu zaman yanlış yorumlanmaktadır .	yorumlanmaktadır	8	Sing
Oğlan , bir gözü Recep'te , bir yanına doğru suyun içine yattı .	yattı	11	Sing
Gerçek parçacıklar a noktasından noktasına gidebilirler .	gidebilirler	5	Plur
Geceleri kakıp , konuklara sunulacak rakı , votka , viski ne bulursam ; birer ikişer yudum kafama dikmeden , bölük pörçük uykumu bile sürdüremiyorum .	sürdüremiyorum	23	Sing
Hep uzaktan uzağa kuşatmazlar mı birbirlerini , hep araya giren anaların yatıştırmalarıyla sakinleşmez mi ortalık .	sakinleşmez	12	Sing
İşte o zaman , bu turistik yörenin olağanüstü tarihine merak duyanlar , buradaki insanların birkaç bin yıl önceki bir uygarlığın torunları olduğunu bilenler , tarihten bir sahnenin canlanmakta olduğunu sezerlerdi .	sezerlerdi	29	Plur
Biz , geçmişte ne varsa güzel olan , yanımıza aldık , kalbimize gömdük .	gömdük	12	Plur
Gelin , birlikte girelim , dedim .	Gelin	0	Plur
Silisimi beğendiği için yüz bin lira verdi , hem yine görüşürüz dedi .	görüşürüz	10	Plur
Anladım ki bu taşınma kararımdan hoşnut , doğallaştırıp sıradanlaştırmaya çalışıyor , ama nafile , ben başlayacak bu yeni beraberliğin taze heyecanını bastıracak halde değilim .	çalışıyor	9	Sing
Bilimsel Devrim'in başlangıçtaki esas etkisi , daha önce de değindiğiniz gibi ideolojik düzlemde olmuştur .	olmuştur	13	Sing
Bir o , bir ben , hiç önceden kararlaştırmadan , kendiliğinden bir o , bir ben , olup bitenleri anlatmaya başladık ... dese diye , sabırsızlana sabırsızlana dinledim onu .	dinledim	27	Sing
Ee kolay değil oğlum kaç aydır bakıyorlar alışır insan ne kadar olsa .	bakıyorlar	6	Plur
Binamıza isim bulmak diye bir mesele çıkmıştı .	çıkmıştı	6	Sing
Türkler , Çinliler , Moğollar ve Kitaylar arka arkaya saldırıp yirmibeş yıl süren bir savaş sonunda Tunguzları toparlanamayacak şekilde yıktılar .	yıktılar	19	Plur
Çevreyi araştırırlar .	araştırırlar	1	Plur
Kapattınız mı zarfı .	Kapattınız	0	Plur
Siz , sonsuza dek yürüyeceksiniz .	yürüyeceksiniz	4	Plur
Çeyrek asırdır , milyonlarca insanın ve üç kuşak nüfusun kaderini terk ve teslim ettiği liderlik kadroları güçlerini nereden alıyordu .	alıyordu	18	Sing
Kimseye zararı yoktu ha , yanlış anlama , bütün derdi kendinleydi .	anlama	6	Sing
İyi olmamdan , onu taparcasına sevmemden sıkıldı .	taparcasına	4	Sing
Dondurmacıya beklemesini söylediler .	söylediler	2	Plur
Ya da ardından mutlaka sevgi sözcükleri kullanır .	kullanır	6	Sing
Komşuların kapılarını teker teker çalıp iş istemiş .	istemiş	6	Sing
Adam başını salladı .	salladı	2	Sing
Acıyorum , içim sızlıyor o kadar .	sızlıyor	3	Sing
Mahmut , kapının aralığından başını uzatıp bana baktı .	baktı	7	Sing
Olsun , dediler , yeter ki cezan büyük olmasın , gerisi önemli değil .	dediler	2	Plur
Nereden duydum anneannemde o komşu teyzelerin konuşmalarını ?	duydum	1	Sing
Bunları biliyorsunuz .	biliyorsunuz	1	Plur
Kim tamir edecekti beni ?	edecekti	2	Sing
Muhalifleri , halkın yüzde kırk bir buçuğunun oy desteğine mazhar olmuşlarsa , bu sonuca asla razı olmuyorlar .	olmuyorlar	16	Plur
Ama onun için korkuyordum da .	korkuyordum	3	Sing
Melek her gün yüz bin lira kazansam , kış gelene kadar bir kondu alabilir miyiz ?	kazansam	6	Sing
Gerçi ben kendi kendime idare ederdim ama şu dersler yok mu , o konuda kesinlikle yardıma ihtiyacım vardı .	vardı	17	Sing
Hiç konuşmasanız da aklınızdan geçirdiğiniz her şey duyulacak .	konuşmasanız	1	Plur
Nicedir elinden düşürmediği kitabını kapattı , kaldığı sayfaya kağıt sıkıştırmayı unutmayarak .	kapattı	4	Sing
Ne okulu severdi , ne de Naci Beyi .	severdi	2	Sing
" Söz konusu meblağ sosyal yardımlaşma ve dayanışma vakıflarına gönderilmiştir .	gönderilmiştir	9	Sing
Hayır , önce yemeğini bitir , diye üsteledi anne .	üsteledi	7	Sing
Partinin bu hale gelmesine neden olanların artık yönlendirme yapmaya hakkı yoktur " diye konuştu .	olanların	5	Plur
İyi ki ordu sesini yükseltti , şimdi ne yapacaklar bakalım , deyip bekledik .	bekledik	12	Plur
Kapıyı tıklattı .	tıklattı	1	Sing
Karşıtları ya da muhalifleri iktidar şansını elde etmişlerse sütü çalkalıyor , limanı dalgalandırıyorlar .	etmişlerse	7	Plur
O kayıtsızlığıyla beni yerden yere vurdu , ben uğradığım muamele karşısında kapıldığım dehşetle kendimi yerden yere vurdum .	vurdum	16	Sing
Onun canlı olduğuna giderek daha çok inanıyorum .	inanıyorum	6	Sing
Çalsın sazlar ...	Çalsın	0	Sing
İstersen önce oraya gidelim .	İstersen	0	Sing
Görmüyorlar mıydı : Girişten mağlup başlıyor , gelişme bölümünün ortasına bile sağ salim varamıyordum ; sonucu da felaket oluyordu bu durumda tabii .	varamıyordum	13	Sing
Oturun şöyle .	Oturun	0	Plur
Diskoteği sandığı kadar ürkütücü bulmadı , belki de gençlere uyum sağlamak için ister istemez içtiği iki kadeh viski yüzünden .	bulmadı	4	Sing
Gelin , birlikte girelim , dedim .	girelim	3	Plur
Bardağı masanın üstüne koydu .	koydu	3	Sing
Çin Komünist Partisi'yle işbirliği kararı alan yankee , Avrupa'da da Hıristiyan Demokratlar'a üye olmaya hazırlanıyor .	hazırlanıyor	14	Sing
İrem sarılık olduğu için İstanbul'a gitmişlerdi " diye konuştu .	gitmişlerdi	5	Plur
Versem mi acaba ? Yanlış bir şey yapmış olmayalım ? diye sordu .	Versem	0	Sing
Kendisine saygı göstermekte kusur etmiyorlardı .	etmiyorlardı	4	Plur
Kim bilir belki bir gün , mezara girmeden ya da hapse düşmeden önce arar ve katılır .	katılır	15	Sing
Sonra da adamdan sayılıp başımıza bela olacaksınız ! diye bağırdı .	olacaksınız	6	Plur
Tutkuyu anlattın oğlum , dedi Şakir .	anlattın	1	Sing
Yedi yıl boyunca çocuk hasretiyle yanıp tutuşuyorlardı .	tutuşuyorlardı	6	Plur
İş Güvencesi , İş Kanunu ile birlikte ele alınsın , SSK primleri düşürülsün .	alınsın	8	Sing
Aradığımı Buldum Sandım .	Buldum	1	Sing
Nereye gitmiş olabilir Osman .	gitmiş	1	Sing
Çoğu konuda birbirimizi anlamıyoruz .	anlamıyoruz	3	Plur
İyice hastaydı , diyor , karnı davul gibi şişmişti .	şişmişti	8	Sing
İnsanları ikiye ayırıyor annem ( sayacağı iki kalem de olsa mutlaka parmaklarını avucuna kapatarak sayacak ; birincisi yaşayanlar ( bunlar başkalarını da yaşatıyor ) , ikincisi yaşayanları seyredenler ( bunlar da başkalarının sırtına yük oluyorlar ) .	sayacak	14	Sing
Yani ... günah çıkaralım işte .	çıkaralım	3	Plur
Keşfetmeyi severler .	severler	1	Plur
Bak ondan yakınırım ama belki de haksızım .	Bak	0	Sing
Sandık başkanlarına bir hafta seminer önerildi .	önerildi	5	Sing
Başka güne alırız doğum günümü .	alırız	2	Plur
Az kalsın kaçırıyordum ağzımdan .	kaçırıyordum	2	Sing
Böyle bir saldırıyla karşılaşan bir geyik çobanı sabah , heyecanla olanları anlatmıştı yola çıkarlarken .	anlatmıştı	11	Sing
Belki de rastlayacaksınız ona .	rastlayacaksınız	2	Plur
" Arçelik , ikibinüç yılında ihracatını yüzde otuz'un üzerinde artırarak , beşyüzelli milyon çıtırlarla çıkarmayı hedefliyor .	hedefliyor	15	Sing
Hiçlikten geliyor , görünüyor , bu görünüşe gerçeklik adı veriliyor ; sonra da bir parabol gibi kayıp gidiyordu .	veriliyor	9	Sing
Bu şekilde zor yürünüyordu tabii .	yürünüyordu	3	Sing
Annemin bahsettiği sürpriz yoksa üvey baba olmasın ?	olmasın	6	Sing
Evet , birlikte çıktılar odaya .	çıktılar	3	Plur
Gece yarısı sokaklarında dolaşıyor , zamanın geçmesini bekliyordum .	bekliyordum	7	Sing
Hey , Ömer , kalk oğlum , geç kalmışız .	kalmışız	8	Plur
Kapıyı itiyorum , zorluyorum , tam biraz açılır gibi oluyor , gene kapanıyor .	itiyorum	1	Sing
Ne kalın kafalı adamlarız ki , bir kelimesini bile hatırlamıyoruz .	hatırlamıyoruz	9	Plur
Cumhuriyet'in temel nitelikleri , Anayasa'nın değişmez ilkeleri ve değiştirilmesi teklif edilemez maddeleri yeni anayasada yer alacaktır " dedi .	alacaktır	15	Sing
İyice kollarız , dedi Katana , yoksa dalarız .	dalarız	7	Plur
Tunalıhilmi Caddesi insan ve trafiğe çıkmış arabaların gürültüsüyle arı kovanı gibi uğuldamaktaydı .	uğuldamaktaydı	11	Sing
Bir gün bir küçük kaza olur , çantanızdaki bir flaster belki de hayatınızı kurtarır .	kurtarır	13	Sing
Aramızı açamadılar .	açamadılar	1	Plur
Bense korkuyordum .	korkuyordum	1	Sing
Boş ver , dedi , bazı şeyleri unutmak gerek .	ver	1	Sing
Buna hiç şaşırmadım ben zaten herşeye razıydım .	şaşırmadım	2	Sing
Ee kolay değil oğlum kaç aydır bakıyorlar alışır insan ne kadar olsa .	alışır	7	Sing
Bazılarımız buna gerek olmadığını düşünüyordu ama çoğunluk , apartmana esprili bir ad taksak fena mı olur a yatkındı .	düşünüyordu	4	Sing
Bir tane de ben ekleyeyim : Yiyebilir miyim ? diye bayılmış .	Yiyebilir	6	Sing
Prezervatif yok mu bu markette ? diye sordun .	sordun	7	Sing
Sonra yarım saat , üç saat , bir gün , üç gün önce görüştüğünüz sekreter adaylarının umutsuzluğunu , çaresizliğini düşünürsünüz .	düşünürsünüz	19	Plur
Sıkılmadı , dedi .	Sıkılmadı	0	Sing
Neredeyse kasıklarına çekildi , sımsıkı etekliği .	çekildi	2	Sing
Nereye yönelsem arkamdan yetişiyordu , Sen kömür sobasını beceremezsin , yan odadan elektrikli zamazingoyu al , dolaptaki rakı çok soğuktur , en iyisi yattığım odanın aç kapısını , bak hemen kapının arkasında , kap gel ...	kap	33	Sing
Ali'nin o kırgın hali de yavaş yavaş dağıldı .	dağıldı	7	Sing
Günlük azığı kara ekmekle peyniri bu mağaraya koymuş .	koymuş	7	Sing
NA toplantılarında ilk kez başkalarına yöneldim .	yöneldim	5	Sing
Sezonu kapamakta inatçı bir genç sürat motoruyla göremediğim birine fiyakalar yapıyordu daireler çizerek .	yapıyordu	10	Sing
Yaşamı , bilimin ve dinin geçerli olduğu alanlar olarak ayrı kompartımanlara bölen bu formül , bilimin kapsadığı alanların genişlemesiyle yeniden zora girmiştir .	girmiştir	21	Sing
Karşıtları ya da muhalifleri iktidar şansını elde etmişlerse sütü çalkalıyor , limanı dalgalandırıyorlar .	dalgalandırıyorlar	12	Plur
Onu en iyi okullarda okuttum diyerek kendisini rahatlatma yollarını arıyordu .	okuttum	4	Sing
Olaydan bir yıl sonra ben davayı üstlendim .	üstlendim	6	Sing
Ben konuşsam .	konuşsam	1	Sing
Yeni gelen , masanın bir kenarındaki boş sandalyeye atmıştı kendini .	atmıştı	8	Sing
Hiç mi kavuşamadınız .	kavuşamadınız	2	Plur
Tanışmadınız , görsen şaşarsın , çok zeki , anlayışlı ama ...	Tanışmadınız	0	Plur
Ayırmayalım onları .	Ayırmayalım	0	Plur
Bu gece geç kaldınız , dedi adam .	kaldınız	3	Plur
Beni ziyan ettin , diyor , ziyan ettin .	ettin	7	Sing
Ve hiç kimse benim eşyamla ilgili düşüncelerimi de merak etmiyordur kuşkusuz ...	etmiyordur	9	Sing
Kamu Tek Hesabı'nın kapsamı genişletildi .	genişletildi	4	Sing
Rapor uçağın uçuş rotası ile ilgili gerekli bilgilerin verildiğini ve yer personelinin hiçbir şekilde kusurlu olmadığının da altını çiziyor ve olayın neden olacağını anlatmaya başlıyordu .	başlıyordu	24	Sing
ANAP İstanbul İl Benokan basın toplantısına Çelebi'nin yanı sıra , diğer genel başkan adayları Lütfullah Kayalar ve Ali Talip Özdemir de katıldı .	katıldı	21	Sing
Akşamları lokantada , kenar köşe bir masa kendilerine ayrılıyor , hesaptan ayrı getirdikleri balıklarla , bedava bir küçük rakıyla , ufak tefek mezelerle ucuz , güzel bir gece geçiriyorlardı .	geçiriyorlardı	28	Plur
Canı sıkılmış gibiydi .	sıkılmış	1	Sing
Yedi saatlik yolculuk boyunca - ki yetmiş kilometre kat edecektik - bir tek eve rastlamanın mümkün olmadığı bir coğrafya .	edecektik	9	Plur
Gözlem ve deneylerden türetilmiş olan hipotezler temelinde yükselen kuramlar birçok fiziksel süreci açıklamanın yanı sıra bir dizi öngörülerde de bulunmalıdır .	bulunmalıdır	19	Sing
Ben ağabeyleri olarak onların rahatını sağlamalı , onları zorluklardan kurtarmalıydım .	sağlamalı	5	Sing
Al oğlum , biraz viski iç .	Al	0	Sing
Zeynep'te en az Orhan kadar heyecanlanmıştı .	heyecanlanmıştı	5	Sing
Kızını çok beğendik .	beğendik	2	Plur
Bakın soluk soluğa kaldınız .	kaldınız	3	Plur
Bakalım daha nelere sokacak Grek burnunu ...	Bakalım	0	Plur
Keskin toplum eleştirisi , esprili ve zeki özeleştiri , bir çeşit kara mizah , bilgi düzeylerinin çok üstünde bir entelektüel performans onlarla tanışanları şaşırtır ve çarpar .	tanışanları	22	Plur
Bu kaybın , " turizm gelirlerindeki kesilme " , " petrol fiyatlarındaki artış " , " faiz oranlarındaki artış " ve " yabancı yatırımcının Türkiye'den kaçışı " gibi nedenlerden ortaya çıkması bekleniyor .	bekleniyor	31	Sing
O mu seni terk etmiş saydın , sen mi onu .	saydın	5	Sing
Hayatlarının çizgilerini , hiç değilse çemberlere teğet dokundurabilselerdi .	dokundurabilselerdi	7	Plur
Teyzemin yakınmalarına takıldı aklım .	takıldı	2	Sing
Sınıf atlamıştır yani .	atlamıştır	1	Sing
Yatırım teşvik belgesi süreleri bir yıl uzatılsın .	uzatılsın	6	Sing
Nereye yönelsem arkamdan yetişiyordu , Sen kömür sobasını beceremezsin , yan odadan elektrikli zamazingoyu al , dolaptaki rakı çok soğuktur , en iyisi yattığım odanın aç kapısını , bak hemen kapının arkasında , kap gel ...	al	14	Sing
Saatine baktı .	baktı	1	Sing
Onun arkasından öbür silici çocuklar da arabanın önüne atladılar ve birbirleriyle itişip kakışmaya başladılar .	atladılar	8	Plur
Neden sonra Katana ağaçtan süzülüp indi .	indi	5	Sing
Öyle mi dersiniz .	dersiniz	2	Plur
İşi şakaya vurdum , iyi ya , dedim , Ceza'nın cezası da bitse keşke ; kimbilir daha kaç tanker şarap içmem gerekecek .	gerekecek	21	Sing
En zıt fikirler ileri sürülüyor , kimse kimseye hakaret etmiyor , tarizde bulunmuyordu .	bulunmuyordu	12	Sing
Önce kahvelerimizi içelim de ...	içelim	2	Plur
Neyse ki üçüncü kez sorduğunda iyi bir cevap hazırlamıştım : Esinciğim evde tek kız olmasının daha iyi olduğuna karar verdik .	verdik	19	Plur
Öteki kadını nereden duydunuz .	duydunuz	3	Plur
Üniversitede hocayız desek Şüpheli kişi olacağız çünkü .	desek	2	Plur
Yanına annesini de alan Şıkel , " Herkes beni zaten yanlış tanıyor , ne desem boş , inanılmaz derecede bunaldım .	tanıyor	11	Sing
Gideceğiz , dedim .	Gideceğiz	0	Plur
Taşhan'ın kapısını itip bu yarı karanlık dünyanın içine girdim .	girdim	8	Sing
Aklığından ötürü alır bu adı .	alır	2	Sing
İsterseniz yanına dilimlenmiş hıyar .	İsterseniz	0	Plur
Ev sahibi odadan çıkınca dayanamamış .	dayanamamış	4	Sing
Çok sevineceğim .	sevineceğim	1	Sing
Lan tamam , sizi de kurtaracağım , var mı öyle kalleşlik .	kurtaracağım	5	Sing
Sinirim tuttu , ben de başladım gülmeye .	tuttu	1	Sing
Girme suya oğlum , gidiyoruz .	gidiyoruz	4	Plur
Saffet bunu görünce , yörenin daha yavaş ritimli , eski bir türküsünü çalmaya başlardı .	başlardı	13	Sing
Gidersiniz , sonra geri gidersiniz Erkekler Parkı'na .	gidersiniz	4	Plur
Benim yüküm bana yetiyor , Hülya , halimi görmüyor musun ? dedim .	görmüyor	8	Sing
Bu kadar yeter , dedi , inin de gidelim artık .	inin	6	Plur
Memur zammı geçmiş enflasyona göre yapılırsa , yıl sonu gerçekleşme beklentisine göre yüzde otuz'un altında olmayacak .	olmayacak	15	Sing
Beni görür görmez kendini yere atıp göbeğini bir açışı var ki sevdirmek için özellikle şişiriyor sanırsın .	sanırsın	15	Sing
Yani ben imkansız olduğuna hükmetmişim bir kere .	hükmetmişim	4	Sing
Beyin Takımı diye isim edindiler .	edindiler	4	Plur
Özellikle biyoloji ve jeolojinin insanın ve dünyanın kökenine ilişkin bulguları , evrenin merkezindeki durağan dünyasının sıradan bir gezegen olmasına yeni yeni kendini alıştırmaya başlamış olan Kilise'nin elinde kalan son önemli alana - Yaratılış Efsanesine - cepheden darbeler indirmiştir .	indirmiştir	37	Sing
Ünlü markaların bir yıl önceki modellerini uygun fiyatlarla Oparia Continuato'da , Magazine Montenapoleone'de bulabilirsiniz .	bulabilirsiniz	13	Plur
Buna sorun çözme diye bakamazsınız .	bakamazsınız	4	Plur
Susup durduk .	durduk	1	Plur
Nedenini anlayamadığım bu terk edilme korkusu ve kendime itiraf etmekten bile utandığım hırpalayıcı kıskançlığımla , aptalca olduğunu bile bile daha çok kadınla birlikte oluyor ve sonunda korktuğuma uğrayıp bir başka erkek için terk ediliyordum .	ediliyordum	33	Sing
Varlıklarını gerçek parçacıklar gibi duyumsatıncaya dek metafizik dünyanın öğeleri olarak alınmalıdırlar .	duyumsatıncaya	4	Sing
Almanca ve İngilizce'yi çok iyi konuşan Jouni , sık sık yurtdışı seferlerine çıkıyordu .	çıkıyordu	12	Sing
Berkeley ve yazarlarının savlarının , benzerliğine demeyeceğim , aynılığına dikkat ediniz !	ediniz	10	Plur
Bu savların hepsinin yanlışlığı ( fallacies ) gösterilmiş , idealist dizgeler yadsınmıştır ( refuted ) .	gösterilmiş	7	Sing
Rolü başkasına verdik dediler .	verdik	2	Plur
Size kalırsa nal toplayacağız " diye tepki gösterdiler .	gösterdiler	7	Plur
Eksi elli dereceye varan kış , onu son nefes aldığı günkü kadar zinde gösteriyor .	gösteriyor	13	Sing
TKP avukatları , bunun dışında , şu ana kadar yuzelli partilinin hakkında bildiri dağıtmaktan soruşturma açıldığını söylediler .	söylediler	16	Plur
Mersedes buldum mu bırakmam abi .	bırakmam	3	Sing
Peki NA üyeleri arasında hiç kayan olmuyor mu ?	olmuyor	6	Sing
Atatürk'ün maiyetinde , Muhafız Kıtasında görev yapmış bir ağabeyimizden ( Halim Tokmakçıoğlu ) dinledim .	dinledim	13	Sing
Anlatılmalı bir gün .	Anlatılmalı	0	Sing
Eee , sen tarlaya yemek götürdün , biz ne yapacağız .	götürdün	5	Sing
Ütopya biliyorsunuz , olmayan yer , düş ülkesi demektir .	biliyorsunuz	1	Plur
Hiç anlamasalar da , hiç bilmeseler de , hiç ilgilenmeseler de , neden , kadınlar bütün erkeklerin iş hayatlarını pürdikkat dinlerler .	dinlerler	20	Plur
Beni sınava mı çekiyorsunuz ?	çekiyorsunuz	3	Plur
Bu kadar gerilerden , bunca sisli puslu hatıraların arasından çekip çıkartılmak kolay olmuyor .	olmuyor	12	Sing
İkimiz de kendimizi yenik hissediyorduk , bu , ilişkimiz süreceği anlamına geliyordu .	hissediyorduk	4	Plur
Tezgahtan ve günün hayhuyundan ne kadar uzak olduğu sanılırsa sanılsın bu oda bir süre sonra tezgahı aratır oldu .	sanılırsa	8	Sing
Cumhurbaşkanı ile sürtüşen bir iktidar olmak istemiyoruz .	istemiyoruz	6	Plur
Olur , dedi Jul .	Olur	0	Sing
Ama önce , Ben buraya taşınıyorum artık , seninle birlikte yaşamaya karar verdim , diye söze başladım .	başladım	16	Sing
Kamu personeline ödenecek aylık ve ücretlerin belirlenmesinde esas alınacak katsayılar ile sözleşme tavan ücretlerini belirleme yetkisi tasarıya konmayarak bu konu Bakanlar Kurulu'na bırakıldı .	bırakıldı	22	Sing
Onunla başlayalım .	başlayalım	1	Plur
" Plan evlere dağıtılsın " .	dağıtılsın	3	Sing
Daha da kötüsü , bu gerçeği bilmeme rağmen , her seferinde elimde olmadan hep aynı şeyi yapıyordum , bunun önüne geçemiyordum .	yapıyordum	16	Sing
Kargadan korkan darı ekmez .	ekmez	3	Sing
O günün son içkilerini içiyorduk .	içiyorduk	4	Plur
Olacakları bilmiştim edasıyla başını usul usul sallıyordu .	bilmiştim	1	Sing
İnsanları korkutup caydırma .	caydırma	2	Sing
Başkalarının en iyi gizlenen sırlarına bile ulaşmanın daima bir yolu bulunurdu , ama insanın kendi sırlarına erişmesi neredeyse imkansızdı ve yazarlık bu imkansızı yaşamaktı sürekli .	bulunurdu	10	Sing
- İstemesen de gidelim .	gidelim	3	Plur
Bu atılım , insanlığı çağdaş bilim kavramının eşiğine ulaştırmış , ama Roma İmparatorluğu ve onu izleyen feodal dönemle kesintiye uğramıştır .	ulaştırmış	8	Sing
Sesler değişse bile duyguların seslere kattığı tonlamalar değişmez , ne kadar saklamak isteseler de bunu beceremezler , bir köpekten kokularını saklayamayacakları gibi benden de seslerini saklayamazlardı .	beceremezler	15	Plur
Sinek uçsa vızıltısı duyulacaktı .	duyulacaktı	3	Sing
Dışardaki çadırda Şura ekmek hazırlıyor .	hazırlıyor	4	Sing
Ama yolu bilmiyorum .	bilmiyorum	2	Sing
Philips mağazasının önünden geçmemeye özen gösteriyorum .	gösteriyorum	5	Sing
Siz istemediniz mi .	istemediniz	1	Plur
Üstümdekiler eski , ipek gömleğim sararmış ...	sararmış	5	Sing
Bunu yapamayacağını biliyordun .	biliyordun	2	Sing
Kendimi katilin yerine koyardım , onun o son anda , tetiği tam çekerken neler hissettiğini anlamaya çalışırdım .	çalışırdım	16	Sing
Sanki bir şeye üzülmüş gibiydi .	üzülmüş	3	Sing
Lokantası her gece doluyordu .	doluyordu	3	Sing
Anneciği ile birlikte bir bardak pekmezi paylaşmışlar .	paylaşmışlar	6	Plur
Bırak zırlasın .	Bırak	0	Sing
Çöktü koltuğa , pıtır pıtır dökülüyor gözyaşları .	dökülüyor	5	Sing
Ara ara aklıma takılan soruları da anlatır gibi , ona mı , kendime mi , bilmeden sordum .	anlatır	6	Sing
Başka bir kadına rastladı , dedi kadın .	rastladı	3	Sing
Ben bir dolaşıp geleceğim , dedim .	geleceğim	3	Sing
Kutup porsuğunu ( Gulo gulo l . ) bu adla anıyorlardı .	anıyorlardı	10	Plur
Esin de Özer de Uykudan Önce programı gibi dinlediler anlattıklarımı , bir yandan esniyorlardı bir yandan da gözleri sevinçle parlıyordu .	esniyorlardı	13	Plur
Kadın uyuduysa okur , dedi adam .	uyuduysa	1	Sing
Hakkı'yla ihtilale bakmak istiyorduk .	istiyorduk	3	Plur
Yattım nilüfer kayığına ...	Yattım	0	Sing
Önüme uzun boylu biri gelmemesi için duaya başladım .	başladım	7	Sing
Buraya kadar geldiniz .	geldiniz	2	Plur
Onlar çalışıyorlar ...	çalışıyorlar	1	Plur
Paşa , dalkavuk arıyor .	arıyor	3	Sing
Niye mutsuz olduklarını ise söylemezlerdi , mutsuzluklarının nedenini siz keşfetmek zorundaydınız , bunu keşfedemezseniz biraz daha düşmanlaşırlardı ; bu düşmanlık gerçek değildi , yalnızca mutsuzluklarının üstüne örtmeye çalıştıkları yakıcı bir örtüydü .	söylemezlerdi	4	Plur
Dışarıda birisi ile konuşuyordum .	konuşuyordum	3	Sing
Geyiklerin alışık olmadıkları bu durum karşısındaki olgun davranışları , hatta kızak hattının tam ortasındaki düşüşlerimde dahi bana basmamaya özen göstermeleri çarpıcıydı ; sanki aramızda bir sıcaklık doğmuştu .	doğmuştu	26	Sing
Melek her zamanki yerinde , ümitle gelene geçene flasterlerini ve kalemlerini uzatıyordu , ama nafile ; kimsenin ona aldırdığı yoktu .	gelene	6	Sing
Havaalanından yaklaşık otuz kişiyi aramış , herkesle şakalaşıp vedalaşmış .	aramış	4	Sing
Arkadaşlarına anlatmış .	anlatmış	1	Sing
Kamulaştırmalarda , inşaatın kontrolörlüğünü yapacak olan İngiliz BP'nin isteği üzerine ' uluslararası standartlar ' uygulanacak .	uygulanacak	14	Sing
Yağmur çiseliyordu .	çiseliyordu	1	Sing
Ya dayak yerseniz , ya karakola gidersiniz .	yerseniz	2	Plur
Golf de oynarlar .	oynarlar	2	Plur
Hummalı bir tartışma sürüyordu şimdi toplanmış , örtüsü silkelenmiş sofrada .	sürüyordu	3	Sing
Hülya duydu , yaramaz ama çalışkan öğrenciye kızan öğretmen gibi kararsız , dudak büktü .	duydu	1	Sing
Geçmiş ola .	ola	1	Sing
Hangi aday kazanırsa kazansın birlikte mücadeleyi sürdüreceklerini ifade eden Çelebi , ANAP'ı ayağa kaldırmak için hep birlikte çaba harcayacaklarını söyledi .	kazansın	3	Sing
Oysa yeşil değil , akik de , gitsin .	gitsin	7	Sing
Gençliğinde yazdıklarını tercih ederim .	ederim	3	Sing
Aaa , diyorlar , kimi elini saygıyla göğsüne bastırıyor kimi de , işte orada duracaksın anlamında ileri doğru uzatıyor ; büyük adamdı .	duracaksın	14	Sing
Ekonomik ve Sosyal Konsey'e işlerlik kazandırılsın .	kazandırılsın	5	Sing
Kimbilir güneşte ne güzel görünürlerdi .	görünürlerdi	4	Plur
Ve o filmden gitgide uzaklaşıyoruz .	uzaklaşıyoruz	4	Plur
Arjantin'den Yunanistan'a , darbe depremleriyle sarsılmış pek çok ülke , enkaz kaldırma çalışmaları sırasında mahkemeler kurdu .	sarsılmış	5	Sing
Sonra , patron olduğunu anımsatmak için , soymakta olduğu patatesleri bırakıp , bir çay doldurdu , masalardan birine geçti , sabahtan beri bakıla bakıla paçavra gibi olmuş gazeteyi eline aldı .	bakıla	23	Sing
Prof. Dr. Semih Koray'ın , dergimizdeki eski yazılarından derlenerek kaleme alınan makalesini dosyamızın sunuş yazısı yaptık .	yaptık	15	Plur
Hepimiz Cumhuriyet devrinde doğmuştuk .	doğmuştuk	3	Plur
Yürüdüğümüz sokak gittikçe daralıyordu .	daralıyordu	3	Sing
O zaman tamam dedi babam Karar verildi .	verildi	6	Sing
Hazine garantileri nedeniyle doğabilecek ödemeler için de üçyüzyirmialtı trilyon liralık ödenek ayrıldı .	ayrıldı	11	Sing
Biz avucumuzda darı her yere ekiyoruz " dedi .	ekiyoruz	5	Plur
Yine kafam bulanıkken , teyzemin defterinden aktarmışımdır .	aktarmışımdır	6	Sing
En zıt fikirler ileri sürülüyor , kimse kimseye hakaret etmiyor , tarizde bulunmuyordu .	sürülüyor	4	Sing
Başbakan Abdullah Gül imzasıyla dün tüm valilere gönderilen genelgede yoksullukla mücadele için ilk adım olarak Ramazan Bayramı öncesi yoksullara ulaştırılmak üzere onsekiz trilyonluk kaynak ayırdığı belirtildi .	belirtildi	25	Sing
Ama burada sorumluluk kişiye düşüyor .	düşüyor	4	Sing
Taşhan'ın duvarına yaslandı .	yaslandı	2	Sing
Erkekler bakmaya da daha az zaman harcarlar .	harcarlar	6	Plur
Boru hattının geçeceği bölgelerde sivil toplum örgütlerinin de katılımıyla teklif komisyonları kurulacak .	kurulacak	11	Sing
Dünkü Amerikalı iki paket bırakmıştı .	bırakmıştı	4	Sing
Kaçtım , kurtuldum oradan , diyordunuz , dedi .	diyordunuz	5	Plur
Kumru'nun ablası orada çalışıyor .	çalışıyor	3	Sing
Vurun yumruğu soğana .	Vurun	0	Plur
karma fonlar : Bu kategorideki fonlar ikibiniki yılını yüzde onbir'lik ortalama getiri ile kapattılar .	kapattılar	13	Plur
Nereden biliyorsunuz ki o kadın olduğunu .	biliyorsunuz	1	Plur
Beni köşeye sıkıştırırlarsa çıkaracaktım ortaya .	sıkıştırırlarsa	2	Plur
Kalkıp ardına kadar açtım pencereyi .	açtım	3	Sing
Buralarda bekledim .	bekledim	1	Sing
Varlıklarını gerçek parçacıklar gibi duyumsatıncaya dek metafizik dünyanın öğeleri olarak alınmalıdırlar .	alınmalıdırlar	10	Plur
Beni yeme be moruk , dedim , ne panayırlar kuruldu bu kasabaya , ama hiçbir zaman aslan gelmedi .	yeme	1	Sing
Sana olacağını nereden çıkarıyorsun ?	çıkarıyorsun	3	Sing
Beni çok seven eski bir hocamın yardımıyla laboratuarıma bir kadavranın gönderilmesi için gerekli izinleri almak çok zor olmadı .	olmadı	17	Sing
Benim her zaman konuştuğum adam , yanıbaşımda masasında oturuyordu .	oturuyordu	8	Sing
Aman Allahım yüz bin lira ! diye hayretle bağırdı Melek .	bağırdı	8	Sing
Artık içeriye giremiyorum .	giremiyorum	2	Sing
Henüz Türkçeye çevrilmemiş .	çevrilmemiş	2	Sing
Kendimi uyuşturucularla adım adım öldürürken bile ölmekten korkuyordum .	korkuyordum	7	Sing
Eşi ve kızı öldü ama o bilmiyor .	öldü	3	Sing
Raporları detaylı incelemek içinse zamanla yarışacaklardı ...	yarışacaklardı	5	Plur
Sonra , patron olduğunu anımsatmak için , soymakta olduğu patatesleri bırakıp , bir çay doldurdu , masalardan birine geçti , sabahtan beri bakıla bakıla paçavra gibi olmuş gazeteyi eline aldı .	doldurdu	14	Sing
Oğlan çocuğunda saça hiç dayanamazdı .	dayanamazdı	4	Sing
Sanıyorum , zaman aşımına uğradığı için benim itiraz sürem de geçmişti .	Sanıyorum	0	Sing
Sevinmez mi ?	Sevinmez	0	Sing
Kendi hayatlarının çemberlerine uzanan çizgilerde buluşamıyorlardı daha .	buluşamıyorlardı	5	Plur
Kasketini yan iliştirirdi kafasına .	iliştirirdi	2	Sing
İnanmıyor musunuz .	İnanmıyor	0	Sing
Kendi yaşam alanını güvence altında gören Papalık , bunun verdiği rahatlıkla , yakın geçmişte Darwin'le bile barışmakta bir beis görmemiştir .	barışmakta	16	Sing
Önlüğü ile iç çamaşırları sıyrılıp karnı açığa çıkmıştı .	çıkmıştı	7	Sing
Biz partide Atila Ağbiyi çok severiz .	severiz	5	Plur
Ana'nın orada olmadığını söyledikten sonra ben , buna ne inanırmış , ne de inanmazmış gibi bir tavır takındım .	inanmazmış	13	Sing
İnsanları , kuralları iyi bilirdi .	bilirdi	4	Sing
Muammer beye su getir oğlum .	getir	3	Sing
Konuşmayı sevmezdi , konuşunca da iyi konuşurdu .	sevmezdi	1	Sing
Kardeşimin kurtulacağını biliyordum " diye konuştu .	biliyordum	2	Sing
Bir köpeğin bütün kokuları birbirinden ayırdedip insanların duygularını kokularından anlamaları gibi kadınların sesini tanırdım , her tonunu bilirdim , yalnızca kulaklarımla değil bütün vücudumla duyardım onların sesini .	tanırdım	13	Sing
Ayhan , tüm gururu ve de onuru ve de mühendislik şuuru ile cevapladı .	cevapladı	12	Sing
Bana bak , geliyorum yanına ha , kalk haydi !	geliyorum	3	Sing
Hiç durmadan bu konuyu gizli gizli tartışıyoruz .	tartışıyoruz	6	Plur
Senin de bu gösteriyi izlemeni isterdim .	isterdim	5	Sing
Tahılcı Anadolu insanı , maydanozu azaltıp bulguru çoğaltmış .	çoğaltmış	7	Sing
Ama zaten buraya daha çok klasik dansı sevenler geliyor .	sevenler	7	Plur
Başka siyasetçiler , başka toplumlar , başka uluslar için anlayana ...	anlayana	9	Sing
Buldum işte .	Buldum	0	Sing
Yay sesleri dindi yavaş yavaş , uyum sağlandı .	dindi	2	Sing
Bununla da kalmadı .	kalmadı	2	Sing
Çünkü uyarıldık ...	uyarıldık	1	Plur
üç ) Çok yemiş , bayılmış .	bayılmış	5	Sing
Giremedi içeriye , dedim .	Giremedi	0	Sing
Ben dün gece siz yattıktan sonra evden kaçtım .	kaçtım	7	Sing
Tümüyle meşru yollarla yüksek rakımlı tepeye çıkmış adamı şişman ve ahaliyi pişman eyliyorlar .	eyliyorlar	12	Plur
Sessizce onayladık .	onayladık	1	Plur
" Mülklerimiz için ' gasp edildi ' diyebiliriz .	diyebiliriz	7	Plur
Mahmut Beyi aramıştım .	aramıştım	2	Sing
Aman sus , kapa almacı ...	sus	1	Sing
Genelkurmay Başkanı ve dört komutanın da bu konuda söz alarak görüş birliğini ifade ettikleri öğrenildi .	öğrenildi	14	Sing
Müşteri kelepiri de sever .	sever	3	Sing
Kim bilir belki bir gün , mezara girmeden ya da hapse düşmeden önce arar ve katılır .	arar	13	Sing
Rolü başkasına verdik dediler .	dediler	3	Plur
Çocuk annesinin kendisini tutsaklaştıran bu aşırı ilgisiyle duygusal ve ruhsal olarak gelişemeden , sorumluluk üstlenmeyi öğrenemeden büyüyordu .	büyüyordu	16	Sing
Evden mi kaçtın ? ...	kaçtın	2	Sing
Bira , o kadar , kaldıramıyorum sert içkileri .	kaldıramıyorum	5	Sing
Toplantılar , benim Ankara'da olduğum zamanlara denk getiriliyordu .	getiriliyordu	7	Sing
Hiç değilse kaliteli bir film bularak Hülya ve Selma'yı ayartabilirdim , o da olmadı .	ayartabilirdim	9	Sing
Yeni gelecek öğretmeni çok merak ediyoruz .	ediyoruz	5	Plur
Madem Suna istiyorsunuz , sırf Suna olsun diye az diretmemiştim , Söyledik ya , dedim , kulak asmadınız ki .	istiyorsunuz	2	Plur
Durun , oturun biraz .	Durun	0	Plur
Önüne gelenle yatıp kalkıyormuşum .	gelenle	1	Sing
Epey iş yaptılar .	yaptılar	2	Plur
Görürüz bakalım , yarın o arabayı kim silecek , diye tehditler savurarak uzaklaştı diğer siliciler .	uzaklaştı	12	Sing
altı yıl önce Aysun Hanım'la evlenen Ulusu , kaderinin bu denli tesadüfi çizilebileceğini bilemezdi belki .	bilemezdi	13	Sing
Hiç kafasını yerden kaldırmıyor , hiçbir sempati belirtisi göstermiyordu .	kaldırmıyor	3	Sing
İstersen önce oraya gidelim .	gidelim	3	Plur
Bazen şarkı söylerken de olur bu , arkadaşlar bilir ( arkadaşlar , yani bıyıklarına ak düşmüş emekli sarhoşlar gözlerini yumup başlarını hafifçe eğerek onaylıyorlar ) okursa hüzzam okur , herkesi kahırlandırır .	okur	27	Sing
Nasıl anlatsam bilemiyorum , ama seviniyordum .	seviniyordum	5	Sing
Anne , ne olur , ses çıkartmadan çalayım , içine kazağımı tıkarım , diye yalvardı çocuk .	tıkarım	11	Sing
Kadının eski kocası olduğunu tahmin ettiğim ; kır saçlı , lacivert takım elbiseli bir adam havuzun yanında ayakta duruyor , dalgın dalgın önündeki suyu seyrediyordu .	duruyor	18	Sing
Sana gölgede yatma dedik sıpa .	yatma	2	Sing
Sonra da bu parka düştüm işte .	düştüm	4	Sing
Bul bir fıstık kan , at evine , rahatla , derdin bu senin .	rahatla	8	Sing
Devlet bizi azınlık olarak kabul etmiyor .	etmiyor	5	Sing
Öbür bardağı da doldurdu , döke saça .	doldurdu	3	Sing
Israr etseydin bize , daha güzel bir isim önerseydin ! ..	etseydin	1	Sing
Sokağa çıkmamaya hazırlandık .	hazırlandık	2	Plur
O zaman , lise son sınıfta Fen - Edebiyat diye ayrılırdı .	ayrılırdı	10	Sing
" Bu sözleri ağlayarak dinleyen Özmen , programında çalışması için Ciguli'ye teklifte bulununca o da seve seve kabul etti .	seve	15	Sing
Kadın uyuduysa okur , dedi adam .	okur	2	Sing
Ya orayı bir daha bulamazsam ?	bulamazsam	4	Sing
Ayakta duramayacak kadar yorgun olduğumu sanıyordum , o ilk adıma kadar ...	sanıyordum	5	Sing
Felsefeye merakı onu ünlü yazar , çizer ve ressamların dünyasına sokuyor .	sokuyor	10	Sing
Ayak parmaklarından , yumruk yaptığı ellerine kadar tüm vücudunun kıtırdadığını duyumsadı .	duyumsadı	10	Sing
Sırtına yapışan kumlar , otlar bile uyandıramadığına göre çok yorgun olmalıydı .	olmalıydı	10	Sing
Bir o , bir ben , hiç önceden kararlaştırmadan , kendiliğinden bir o , bir ben , olup bitenleri anlatmaya başladık ... dese diye , sabırsızlana sabırsızlana dinledim onu .	bitenleri	18	Plur
Güneş ağaçların arkasına inerken kasabaya yollandı kamyon .	yollandı	5	Sing
Gül Abla ! dedim Sen benim bu makinemi anlamıyorsun !	anlamıyorsun	8	Sing
Telaşla ayağa fırladı , telefona koşarken kapı vuruldu .	koşarken	5	Sing
o Köye dönüş projesi başlatılacak .	dönüş	2	Sing
Tehlikeli Oyunlar'ın sonu malumdur , diye mırıldandım .	mırıldandım	6	Sing
Çıt ! Söndürdüm masa lambasını .	Söndürdüm	2	Sing
Çünkü örneğin ses ile de boşluklar mekanlaşabilir .	mekanlaşabilir	6	Sing
Ağır , babacan bir gülüşle gülüyorlar , önlerine eğdikleri başlarını ( saygıdan tabii ) ağır ağır sallıyorlar : Yazık , çok yazık , diyorlar .	sallıyorlar	16	Plur
Tutulmuşsun ona .	Tutulmuşsun	0	Sing
Bilimde bu tür mucizevi elatmalara yer olmadığı gibi , varlığı , Tanrı'ya inananlar için tehlike yaratır : diferansiyel eşitliklerinizdeki matematiksel tekillikleri daha iyi bir modelle ortadan kaldırdığınızda Tanrınız da tekillikle birlikte ortadan kalkar .	inananlar	12	Plur
Zeynep , onlara bir şekilde yardım etmeliyiz .	etmeliyiz	6	Plur
Nasıl çıkabilirim oraya .	çıkabilirim	1	Sing
Ama , hafiften titreyen sesi öyle etkiliydi ki , kendimi tutamadım , ağlamaya başladım .	tutamadım	10	Sing
Olsun , dediler , yeter ki cezan büyük olmasın , gerisi önemli değil .	Olsun	0	Sing
Çıkar şu donunu , çıkar da pantolonunu öyle giy .	Çıkar	0	Sing
Harekatın çeşitli nedenlerle ertelenmesinin kısa vade için piyasaları olumlu etkileyeceği düşünülebilir .	düşünülebilir	10	Sing
Göğüs ve karın bölgesinde geniş bir daire çizerek , Şuramda kocaman bir delik vardı .	vardı	13	Sing
Matematikte doğruluğunu kendi içinde barındıran hipotezlerden yola çıkarak bir teoremi kanıtlarsınız ve dosya kapanır .	kanıtlarsınız	10	Plur
' Hoca'nın son iddialarını ciddiye almadılar .	almadılar	5	Plur
Ben ona hep Kahve ismini yakıştırdım .	yakıştırdım	5	Sing
Eğer makineme başka birisi oturmuşsa , kıskanırım .	oturmuşsa	4	Sing
Türkiye , geçmişle ve geçmişin korkularıyla bağlarını kopardı gidiyor .	kopardı	7	Sing
Bu , dedikodu denen haz dünyasından ırak yaşayan bir püriten olsun , gidip zaman zaman ona içimizi dökelim .	dökelim	17	Plur
Evet , geri dönüyorum .	dönüyorum	3	Sing
Bu konuda Cumhurbaşkanı Ahmet Necdet Sezer'in de " Türban tartışması bitmiştir " diyerek son noktayı koyduğu belirtildi .	bitmiştir	10	Sing
Evet , buraya bir şey anlatmak için gelmiştim , dedi Kerem .	gelmiştim	7	Sing
Berkeley ve yazarlarının savlarının , benzerliğine demeyeceğim , aynılığına dikkat ediniz !	demeyeceğim	6	Sing
Yaşamın ruhunu duygularla yakalarız .	yakalarız	3	Plur
ÖDP'nin sempozyum , konser , panel gibi etkinlikleri duyurmak için bastırdığı bazı afişler de seçim yasakları kapsamında sayıldı ve polis tarafından toplatıldı .	sayıldı	17	Sing
Evlenseydiniz , bak nasıl üstüne titrer , çekip çevirirdi seni .	titrer	5	Sing
Muhalifleri , halkın yüzde kırk bir buçuğunun oy desteğine mazhar olmuşlarsa , bu sonuca asla razı olmuyorlar .	olmuşlarsa	10	Plur
Ulvi meslek öğretmenliğe sığındık .	sığındık	3	Plur
Zeynep : Giyecek , yiyecek götürelim .	götürelim	5	Plur
Bize gideceğiz , dedi .	gideceğiz	1	Plur
Elini sol cebine sokup bir fotoğraf çıkarttı , uzun uzun baktı .	çıkarttı	6	Sing
Nereye yönelsem arkamdan yetişiyordu , Sen kömür sobasını beceremezsin , yan odadan elektrikli zamazingoyu al , dolaptaki rakı çok soğuktur , en iyisi yattığım odanın aç kapısını , bak hemen kapının arkasında , kap gel ...	yönelsem	1	Sing
Neden onlar az intihar edip çok yaşarlar .	yaşarlar	6	Plur
Sevilme peşinde koşan ve sevmeyi bilemeyen iki genç , yasal ve yasal olmayan uyuşturucuların etkisiyle sevme oyunu oynayacaklar ve minik bağımlı çocuklar dünyaya getirecekler .	oynayacaklar	17	Plur
Melek üsteledi , Nerden buldun öyleyse ?	üsteledi	1	Sing
Yutmadım ama , bu seferlik geç yerine otur , demek istiyordu .	Yutmadım	0	Sing
Bitecek bu şaşkın serüven ...	Bitecek	0	Sing
Bu nedenle Güzide'yi dizide oynattım " yorumunu yaptı .	oynattım	4	Sing
İhtiyaç olabileceği düşüncesiyle evin etrafında gün boyu bekleyecek on kadar geyik seçildikten sonra diğerleri serbest bırakıldı .	bırakıldı	15	Sing
Gidelim , birlikte saldıralım .	Gidelim	0	Plur
Aydınlık gazetesinde konuştuğu muhabirler , Biz size yardımcı olalım , dediler .	dediler	10	Plur
Bunlara yeşiller diyecektim .	diyecektim	2	Sing
Çünkü savcılığın raporu çıkmıştı .	çıkmıştı	3	Sing
O geceye doğru yolculuğa çıktığından ( biraz zorlanacak tabii , onda da beyin meyin kalmamış ) dalıp gidiyor .	gidiyor	17	Sing
Yerleştir yerleştirme , devşir devşirme sınavları falan filan yok ...	devşir	3	Sing
Bir köpeğin bütün kokuları birbirinden ayırdedip insanların duygularını kokularından anlamaları gibi kadınların sesini tanırdım , her tonunu bilirdim , yalnızca kulaklarımla değil bütün vücudumla duyardım onların sesini .	bilirdim	17	Sing
Yaklaşık bir ay sonra maestro kürsüsünde kalp krizi geçirip ölecekti , Paris'te .	ölecekti	9	Sing
Bana değil de arkamda duran , dönüp baksam benim göremeyeceğim bir şeye , belki de bir aslana bakıyordu .	bakıyordu	17	Sing
Cumhurbaşkanı ile sürtüşmeyiz .	sürtüşmeyiz	2	Plur
Kanatmış mıyım ne ? Dolma gibi dudakları .	Kanatmış	0	Sing
Kristof Kolomb'un , öyle insanlık adına keşiflere çıkmış bir seyyah değil , yeni zenginlikler peşinde koşan ve tayfasına kan kusturan zalim bir kaptan olduğunu fark ediyorsunuz .	ediyorsunuz	25	Plur
Sen de ! Ablasının eğilen başı doğruldu .	doğruldu	6	Sing
Sopa yiyeceğiz , dedi Miskoye .	yiyeceğiz	1	Plur
Duvarlarla konuşmaktan bıktım .	bıktım	2	Sing
Annem onun için özel yemek kabı , özel el bezi - daha doğrusu ağız silme bezi - özel örtü , özel paspas gibi tüm eşyaları hazırlamıştı .	hazırlamıştı	25	Sing
Günümüzde ise bu ilişki bütünüyle tersine dönmüş , bilim adeta tümüyle bir üretici güç haline indirgenmiştir .	dönmüş	6	Sing
Hiç böyle düşünmemiştim , doğrusu bugüne kadar hiç böyle düşünmemiştim .	düşünmemiştim	2	Sing
Yıllarca unutamadı .	unutamadı	1	Sing
Bakanlar Kurulu , kamu personeline ödenecek aylık ve ücretlerin belirlenmesinde esas alınacak katsayılar ile sözleşme tavan ücretlerini gelecek hafta belirleyecek .	belirleyecek	19	Sing
Geçenlerde anneannemin komşuları babamın hemen evlenebileceğini , belki de başka bir kadın yüzünden evi terk ettiğini konuşuyorlardı .	konuşuyorlardı	16	Plur
Ve bir ilkokul öğrencisiyle , yirmilerindeki bir kadının aşkına hiç kimse artık hiçbir şey söyleyemeyecek .	söyleyemeyecek	14	Sing
Borsa bu seviyenin altına Irak'taki gelişmelerin hız kazanması durumunda sarkabilir .	sarkabilir	9	Sing
Hiç anlamasalar da , hiç bilmeseler de , hiç ilgilenmeseler de , neden , kadınlar bütün erkeklerin iş hayatlarını pürdikkat dinlerler .	ilgilenmeseler	9	Plur
Değil tabii .	Değil	0	Sing
Ancak o zaman tüm belgelere ulaşabilecek ve bir yön bulabileceklerdi .	bulabileceklerdi	9	Plur
İçimi çektim , sesim tahminimden daha dertli çıktı .	çektim	1	Sing
Bir o , bir ben , hiç önceden kararlaştırmadan , kendiliğinden bir o , bir ben , olup bitenleri anlatmaya başladık ... dese diye , sabırsızlana sabırsızlana dinledim onu .	sabırsızlana	26	Sing
Babasının ıslığının ne amaçla çalındığını anası da , Ramiz de , kardeşleri de , öküzler de , sarı köpek de bilirdi .	bilirdi	20	Sing
Anne iyice sağlığına kavuşunca bir de ben gidip bu adamı göreyim diye düşünmüş ve kızın peşine takılıp şehrin ucundaki eve gitmiş .	gitmiş	20	Sing
Evet , doğru , senin bu işe en uygun adam olduğundan bahsedildi ...	bahsedildi	11	Sing
Hangisini sen kazandın ki ? deyip dik dik bakmıştı yüzüme .	kazandın	2	Sing
Ancak özellikle evrenbilim ve parçacık fiziğinde bugün bu ilke ne yazık ki çiğnenmiş , bu iki bilim dalı metafizik öğelerle , hayaletlerle dolmuştur .	dolmuştur	22	Sing
Bir kadını daha çok sevip daha çok bağlandıkça , bir gün onu kaybedip yapayalnız , acılarla kalma korkusu büyüyordu ve gittikçe artan bir hızla kıskançlık uçurumundan aşağıya yuvarlanıyordum .	büyüyordu	18	Sing
Ulan hayvan , al bir kalem yaz işte , değil mi ?	al	3	Sing
Beyzadeler bizi ne sanıyorlar .	sanıyorlar	3	Plur
İşte geldik gidiyoruz , dedim , sana bir şey sormak istiyorum .	gidiyoruz	2	Plur
Üvey babasıyla yaptığı kavgadan sonra , darbukasını , birkaç parça giysisini almış , yola düşmüştü .	düşmüştü	14	Sing
Herkes bir şey yakıştırıyor .	yakıştırıyor	3	Sing
Ama eğer olacaksa sürecin uzaması ekonomik açıdan Türkiye için ciddi dezavantajlar da doğuruyor .	doğuruyor	12	Sing
Ben de bastırdım : Öğretmenim .	bastırdım	2	Sing
Cevat , Nasıl yani ? diye sordu , Selahattin de , Rahip bulup günah mı çıkaralım ? diye .	çıkaralım	15	Plur
Hiçbir mitosun ardı sıra sürüklenmiyorum .	sürüklenmiyorum	4	Sing
Kafamın yetmediği fen derslerinde düşünürdüm : Aynı hoca ağabeyime de böyle anlatmış .	düşünürdüm	4	Sing
Gel bak , sana evi göstereyim .	göstereyim	5	Sing
Üveylik konusunda senin düşüncelerine katılmıyorum .	katılmıyorum	4	Sing
içine alır , besler , büyütür , korur .	korur	7	Sing
Ama onun bir an görünebileceği bir yerden ayrı kalmaya dayanamıyorsun .	dayanamıyorsun	9	Sing
Ama çoğunun teorileri tartışılır olmaktan çıkmıştı ...	çıkmıştı	5	Sing
Ancak , bu amaçla yapılacak düzenlemelerde aksi ispat edilmedikçe mükellef beyanının doğru olarak kabul edileceği şeklinde ve benzeri hükümlere yer verilmemeli .	verilmemeli	20	Sing
Ayhan'ın hikayesini dürelim ..	dürelim	2	Plur
Cumartesi günü de Singapur'dan dönmüştü .	dönmüştü	4	Sing
Onu görmedim .	görmedim	1	Sing
Sobanın üstünde içme suyuna dönüşecek daha sonra bunlar .	dönüşecek	4	Sing
Hem daha çok küçük , sen nasıl bakacaksın Kahve'ye .	bakacaksın	7	Sing
Ben şimdi içeriye giriyorum .	giriyorum	3	Sing
Melek her gün yüz bin lira kazansam , kış gelene kadar bir kondu alabilir miyiz ?	kondu	12	Sing
- Bir yerden mi bakıp yazıyorsun .	yazıyorsun	5	Sing
İlhami büyük ama , biz iki kişi olunca onu döveriz .	döveriz	9	Plur
Koray , bilim etkinliğinin tarih içindeki serüvenini geleceğe de uzanarak analiz ederken dosyamıza güzel bir giriş de yapıyor .	yapıyor	17	Sing
Esra Özmen'in Muazzez Ersoy'u konuk ettiği programına katılan Ciguli , " Binnaz satış rekorları kırdı ama bana bir faydası olmadı .	kırdı	14	Sing
Yurdundan kopup gelen aile , büyük kentin kendine uygun bir yerinde , önce başını sokacak bir göz oda ve çevrelediği alanın odadan kopuk bir yerinde helasını yapıyordu .	yapıyordu	26	Sing
O kişi olmazsa yaşayamam ; sekssiz yaşayamam ; alkolsüz bir hayat düşünemem ; başarı için günde on altı saat çalışmam gerekir vb .	düşünemem	11	Sing
Eylemde , " ABD kuklası iktidar istemiyoruz " yazılı pankart ve kırmızı boyalarla vampir çağrışımı yaratılan ABD Başkanı George Bush'un resimleri dikkat çekti .	çekti	22	Sing
Bana da düşmez .	düşmez	2	Sing
Dört yıl depoda bekleyen ve soğuk duvarların arasında hapsedilen geçmişim , bana dünyayla arasına duvarlar ören bir masal ülkesini hatırlattı .	hatırlattı	19	Sing
İşte biz , bu toplantılarımızın kurallarını bugünlerde saptadık .	saptadık	7	Plur
" Buradaki üst düzey görüşmelerimizde turizm için ellerinden geleni yapacaklarını söylediler .	söylediler	10	Plur
İnanır mı .	İnanır	0	Sing
Yağma yok diye diklendi Memo , hepiniz havanızı alırsınız .	alırsınız	8	Plur
Kabul eder .	eder	1	Sing
Yine cevap vermesine fırsat bırakmadan , Bir erkek gibi değil yani , erkekler yalnızca sevişebilmek için yalan söyleyebilir , ama seviştikten sonra sevebilir , bundan sonra ise yalan söylemez .	sevebilir	22	Sing
Öyle sanıyorum , dedi Jul .	sanıyorum	1	Sing
Boğaz'ın suları da sabahın dinginliğine uymuş , ağır kıpırtılarla akıyordu .	akıyordu	9	Sing
Ama böyle birdenbire nasıl oldu bu iş ? Yüreğinden ve beyninden nasıl çıktınız ? İçeride mi o ? dedim .	çıktınız	12	Plur
Recep , oğlanın fiyakayla uzattığı sigarayı elinin tersiyle iteledi .	iteledi	8	Sing
Hem sonuna kadar senin arkanda olacağımı söyledim ya .	söyledim	6	Sing
nasıl anlatacağımı biliyorum , basit : üzülüyordum .	üzülüyordum	6	Sing
Gitmeden yapamıyorsun .	yapamıyorsun	1	Sing
Kuşatma olmasın .	olmasın	1	Sing
Üçümüz birden girsek , dedi Miskoye , sen konuşsan .	girsek	2	Plur
Şahin , " BDDK istese de istemese de kamuda rahatlama için emekliliği gelenleri emekli etmeyi düşünüyoruz " dedi .	gelenleri	12	Sing
Sonra Kuzey Avrupa'ya yayıldılar .	yayıldılar	3	Plur
Naci Bey , şu sayfadan şu sayfaya kadar okuyun , demiş .	okuyun	8	Plur
Meraklanıyorum ama anneme hiçbir şey soramıyorum .	Meraklanıyorum	0	Sing
Bulabilirler onu .	Bulabilirler	0	Plur
SON ANDA VAZGEÇTİ .	VAZGEÇTİ	2	Sing
Ellerimi tuttu , şefkatle gözlerime baktı : .	baktı	5	Sing
Birbirlerine de sataşıyorlar .	sataşıyorlar	2	Plur
Çalı - malı , sırık - mırık , şeker - meker derken , Ayşe kadın giriverir sahneye .	giriverir	15	Sing
Tartışmayı bir televizyon muhabirinin uçaktan " canlı yayına " geçmeye çalışması başlattı .	başlattı	11	Sing
Uçak seferlerini de artıracağız .	artıracağız	3	Plur
Hemen onunla evlenmek istemiş .	istemiş	3	Sing
Eriklerden başları dönmüştü .	dönmüştü	2	Sing
Kardeşinin eşiyle birlikte Bismil Oğuzlar Köyü İlköğretim Okulu'nda görev yaptığını anlatan ağabey Mehmet Karamutlu , " Gerçeği ona nasıl söyleriz bilmiyorum .	söyleriz	19	Plur
Yoğun siste uçak piste doğru gelirken pilota " Yaklaşma hattının solunda kaldın " uyarısı yapıldığı , bunun üzerine pilotun uçağı düzeltmeye çalıştığı , ancak sol dikmenin ( ana iniş takımı solu ) tepeye çarptığı ifade edildi .	gelirken	5	Sing
Günü birlik yaşıyor , her konjonktürden , yasal ya da yasa dışı imkandan yararlanıyorlar .	yararlanıyorlar	13	Plur
Memo bir , iki dirsek ve yumruk darbesiyle öbür çocukları uzaklaştırdı .	uzaklaştırdı	10	Sing
Sahnede dans edenler sanki insan değil de tüy gibi geldi bana .	edenler	2	Plur
Öğretmenler derlerdi ki .	derlerdi	1	Plur
SP Genel Başkanı Recai Kutan ise iktidara gelirlerse ilk yapacakları icraatın IMF ile yapılan anlaşmaları yırtıp atmak olacağını kaydetti .	gelirlerse	7	Plur
Ağabeyinizi öldürmek ya da kanın fışkırışını görmekten çok , bu düşüncenizin başkalarınca bilineceğinden korktunuz .	korktunuz	13	Plur
Hakkı'nın evine geldik .	geldik	2	Plur
Tanışmadınız , görsen şaşarsın , çok zeki , anlayışlı ama ...	şaşarsın	3	Sing
O kendi götüremez miymiş .	götüremez	2	Sing
iki milyar yüzatmışyedi milyon altıyüzdoksan bin lira olan Başbakanlık Müsteşarı'nın maaşı iki milyar ikiyüzyetmişaltı milyon yetmişdört bin beşyüz liraya çıkacak .	çıkacak	19	Sing
Ama orada gayet normal hareket eden insanların çoğu , yandaki salona geçtiğinde şoka giriyorsunuz ; Resmen hard seks yapıyorlar .	giriyorsunuz	13	Plur
Hemen yarım saat sonra bunlar olay yerine ulaşıyor .	ulaşıyor	7	Sing
Bana değil de arkamda duran , dönüp baksam benim göremeyeceğim bir şeye , belki de bir aslana bakıyordu .	baksam	7	Sing
Ya havayı katılaştırır , seferleri kaldırır , yollarını kaparlarsa .	kaparlarsa	8	Plur
Bir binbaşı , bir yüzbaşı ve üç astsubaydan oluşan bir kaza kırım heyeti çağrılıyor .	çağrılıyor	13	Sing
Şimdi ben başlıyorum .	başlıyorum	2	Sing
Oldum olası merak ettiğim bir konu vardı ; kimsenin doğru dürüst bilmediği , sormaktan çekindiği bir sır .	Oldum	0	Sing
Avukat Nusret Senem : Olayın böyle üstünkörü kapatılmaya çalışıldığı konusunda , askeri makamlarda genel bir mutabakat olduğu anlaşılıyordu .	anlaşılıyordu	17	Sing
Kendimi uyuşturucularla adım adım öldürürken bile ölmekten korkuyordum .	öldürürken	4	Sing
Madem Suna istiyorsunuz , sırf Suna olsun diye az diretmemiştim , Söyledik ya , dedim , kulak asmadınız ki .	diretmemiştim	9	Sing
Açma , sakın açma , izleniyorum .	izleniyorum	5	Sing
Sloganla çarpıcı tanıtma yapmaya çalıştım .	çalıştım	4	Sing
Kız sabah olunca rüyasını hatırlamış .	hatırlamış	4	Sing
Üniversitede hocayız desek Şüpheli kişi olacağız çünkü .	olacağız	5	Plur
Ya havayı katılaştırır , seferleri kaldırır , yollarını kaparlarsa .	katılaştırır	2	Sing
Bazen şarkı söylerken de olur bu , arkadaşlar bilir ( arkadaşlar , yani bıyıklarına ak düşmüş emekli sarhoşlar gözlerini yumup başlarını hafifçe eğerek onaylıyorlar ) okursa hüzzam okur , herkesi kahırlandırır .	onaylıyorlar	23	Plur
Çok alışmıştım Kahve'ye belki vazgeçersin almaktan , annem de alıştığı için kalır diyordum kendi kendime .	kalır	11	Sing
Kim olduğunu bilmiyorum .	bilmiyorum	2	Sing
, Bonham'a gidemem , Hülya'nın yanında kalmalıyım ; ya da arkasında , cephe gerisinde ...	gidemem	2	Sing
Kahveden çıkarak alana doğru yürüdük .	yürüdük	4	Plur
Ankara Temsilcisi Fikret Bila da , Arınç'ı arayarak , " Bir serzenişte bulunmuşsunuz , ama sözleriniz teypte böyle , isterseniz deşifresini okuyayım , dedi .	bulunmuşsunuz	12	Plur
' Grup Başkanvekilleri Salih Kapusuz , Eyüp Fatsa ve CHP Grup Başkanvekili Haluk Koç ile Büyükelçilik Konutu'nda dün sabah kahvaltıda bir araya gelen ' , milletvekilleri ile Irak'ı görüştü .	görüştü	28	Sing
Bırakın gideyim , ne olur bırakın .	bırakın	5	Plur
Oktay Sarıtop nazik bir dille kaleme aldığı eleştirisinde " Türkiye'nin en iyi gazetesi olan Milliyet'i her zaman takdir ettiğimi bilmenizi isterim " diyor .	isterim	20	Sing
Ancak , duvarların boşluğu sınırlandırması , her yapıda , özellikle evde , o hacmi mekanlaştırmaz .	mekanlaştırmaz	14	Sing
CHP'lilerin tarım ve sağlık sektörüne destek amacıyla verdiği önergeler ise " gider Başesgioğlu " olduğu gerekçesiyle kabul edilmedi .	edilmedi	17	Sing
Tanrı öldü ve biz sokağa bırakıldık .	öldü	1	Sing
Sanırım o zaman da gelmemişti .	gelmemişti	4	Sing
Aptallığıma doymayayım .	doymayayım	1	Sing
Sorumluluk taşıyan insanlarımız var ; verdikleri sözün arkasında durdular ve eserler yarattılar .	durdular	8	Plur
Orada şöyle ,bir şey dikkatimi çekti .	çekti	5	Sing
Çek şu albümü , şunu şunu , hani gidip gelip karıştırdığın , bilmem mi sanırsın , hah işte o albümü ver bakayım .	bakayım	21	Sing
Ben ağabeyleri olarak onların rahatını sağlamalı , onları zorluklardan kurtarmalıydım .	kurtarmalıydım	9	Sing
İyi ki dedem var da gündüzleri onunla konuşabiliyorum .	konuşabiliyorum	7	Sing
Ağustos güneşi epeyce yatmış olduğu halde etkisini sürdürüyordu .	sürdürüyordu	7	Sing
Hüseyin Abi gönderdi .	gönderdi	2	Sing
O da , sizin onu sevdiğiniz kadar , sizi seviyorsa , yarısını kesip size verir ( Karım böyle yapar ) .	verir	14	Sing
Görünen o ki Bitlis dosyası askeri makamlarca açılmamak üzere çoktan kapatılmıştı .	kapatılmıştı	10	Sing
Tanrı öldü ve biz sokağa bırakıldık .	bırakıldık	5	Plur
Göbeği kocaman , şişko bile denebilir neredeyse .	denebilir	5	Sing
Birkaç yıl sonra da , bir gazetede gece sekreteri olarak çalışmaya başladım .	başladım	11	Sing
Ne kaybedersiniz ?	kaybedersiniz	1	Plur
Bir mektup yazayım ona , dedi Mebrure .	yazayım	2	Sing
Yataktan kalkıp balkona çıkmış , bir sigara yakmıştı .	yakmıştı	7	Sing
İşi şakaya vurdum , iyi ya , dedim , Ceza'nın cezası da bitse keşke ; kimbilir daha kaç tanker şarap içmem gerekecek .	bitse	12	Sing
Genelkurmay Başkanı'nın eşi de aralarında Başbakan , Milli Savunma Bakanı ve kuvvet komutanlarının da bulunduğu Grossman üyelerinin eşlerini öğle yemeğinde ağırlıyor .	ağırlıyor	20	Sing
Daha sonra bu avukatla birlikte bir dosya hazırlamalısınız .	hazırlamalısınız	7	Plur
Böyle bir saldırıyla karşılaşan bir geyik çobanı sabah , heyecanla olanları anlatmıştı yola çıkarlarken .	çıkarlarken	13	Plur
Heyette yer alan CHP İzmir Milletvekili Erdal Karademir , ziyaret sırasında , üç ay önce üniversite eğitimi için Kıbrıs'a gönderdiği oğlu Utku ile buluştu .	buluştu	23	Sing
Orada olmalıyım şimdi .	olmalıyım	1	Sing
Biraz daha inandırıcı olmak için Bak mesela sadece bir tane annemiz var çünkü bir evde sadece bir tane kraliçe olabilir . dedim .	Bak	5	Sing
Orhan ümitle ona baktı , Sen bir şeyler düşünüyorsun ?	baktı	3	Sing
Eğer ilk anda şarlamazsanız , size ciddi ciddi şunu öneriyorum : Aramızdan birini tesbit edelim .	edelim	14	Plur
Anne parayı ödüyor , oğul malı getiriyor .	ödüyor	2	Sing
Bütün bu patırtılar , Sıkıntı , İhsan , Katana Muharrem gibileriyle arkadaşlık etmemden kaynaklanıyor .	kaynaklanıyor	13	Sing
Acı patlıcanı kırağı çalmaz .	çalmaz	3	Sing
Gözlerinde korku ve acı ile bize bakıyordu .	bakıyordu	6	Sing
Nasıl olup da erkeklerin tam tersine , kısa hedeflerde fantezilerini , uzun hedeflerinde mantıklarını kullanırlar .	kullanırlar	14	Plur
O nasıl her olumsuzluğa olumlu bir gözle bakıyor öyküde ?	bakıyor	7	Sing
Bir an için sokaktaki köpekler nasıl hayatta kalıyorlar diye düşündüm .	kalıyorlar	7	Plur
Hafife almayın .	almayın	1	Plur
Biliyor musun ben bu bourbon viskiyi daha çok seviyorum .	Biliyor	0	Sing
Ve fakat bu yeni gerçek , Kadıköy vapurunun karşıdan karşıya geçiş süresini hiçbir şekilde değiştirmedi .	değiştirmedi	14	Sing
Orhan kuşkuyla : Ağzımdan laf almaya çalışıyorsun değil mi ? Sonra da anneme babama yetiştir , dedi sinirli sinirli .	yetiştir	14	Sing
Yazın mektubu .	Yazın	0	Plur
Sonunda Esin Abi şimdi bizim bir köpeğimiz mi olacak ? deyince anlattıklarımın sadece bir kısmını dinlediklerini anladım .	anladım	16	Sing
Harbiyeli Gidin , evinize yatın diye talimat verdi .	Gidin	1	Plur
Yanında oturan annesinin , ağzına zorla tıkıştırdığı lokmayı bir hamlede yuttu ; parmakları darbukanın derisini okşadı ; başını çevirip , arkası dönük oturduğu sahneye baktı .	yuttu	10	Sing
Ünlü borç çorbasına katıldı .	katıldı	3	Sing
Leblebici'nin ustalığı sayesinde adam olmuştur .	olmuştur	4	Sing
Buz kesiyorum gitgide , aldırdığı yok .	kesiyorum	1	Sing
Baksanıza hoş kadın , şık kadın .	Baksanıza	0	Plur
Diyelim ki , dedi Kemal , ben sana kızgınım .	Diyelim	0	Plur
Bu arada , aynı bilim dünyasından bu konuda aykırı sesler çıkaran birkaç bilim insanına kulak verelim .	verelim	15	Plur
Bir süre kapısında bir köpek gibi süründüm .	süründüm	6	Sing
Ya reddedilirsem ! korkusu var ya .	reddedilirsem	1	Sing
Sonunda bir başka yol buldular .	buldular	4	Plur
Sakinleştirir bu beni yavaş yavaş .	Sakinleştirir	0	Sing
Soru da sormazlar .	sormazlar	2	Plur
Ailesinden kendisine büyük bir miras kalmış olan karısını , türlü numaralar çevirip Bakırköy Akıl Hastalıkları Hastanesi'ne yatırıyor .	yatırıyor	16	Sing
Kursanız bile sonunu çok başka bir biçimde bitirirsiniz .	Kursanız	0	Plur
Gerçekten de aradılar .	aradılar	2	Plur
İnsanları ikiye ayırıyor annem ( sayacağı iki kalem de olsa mutlaka parmaklarını avucuna kapatarak sayacak ; birincisi yaşayanlar ( bunlar başkalarını da yaşatıyor ) , ikincisi yaşayanları seyredenler ( bunlar da başkalarının sırtına yük oluyorlar ) .	oluyorlar	34	Plur
Uzun zamandır mı gidersiniz oraya .	gidersiniz	3	Plur
Sanırım dinsel anlatımlara benzemiyor .	benzemiyor	3	Sing
Ancak çok deneyimli bir psikiyatrist ya da psikolog bu kabuğun altındaki duygusal boşluğu sezebilir ve pek çok aydının çok dokunaklı bulduğu bu zeka parıltılarından etkilenmeden tanısını koyabilir .	koyabilir	26	Sing
Bu konudan bahsettim .	bahsettim	2	Sing
Madem iş istiyorsun gir içeri , demiş .	gir	3	Sing
Zeynep merak ve endişeyle kardeşine baktı : Orhan sen benden bir şeyler gizliyorsun ?	baktı	5	Sing
Ayrıca bunlardan birincisi , daha çok yüzyılın ilk yarısında gerçekleşmiş , ikincisi ise , yüzyılın ikinci yarısında zirvesine ulaşmıştır .	ulaşmıştır	18	Sing
Tayyip Erdoğan'ın yanında , onun yanlışlarına ortak olsaydım kesinlikle bu noktalarda bulunmazdım .	bulunmazdım	11	Sing
Ben de onu dövdüm .	dövdüm	3	Sing
Belki de inadına sokmuyor .	sokmuyor	3	Sing
Kabul eder .	eder	1	Sing
Fısıldadı : Sağ ol .	ol	3	Sing
o Eyüp Fatsa ( Grup Başkanvekili ) : Erbakan'ın ismini seçim döneminde kullanmadık .	kullanmadık	12	Plur
Ayak ayak üstüne büyüklerin önünde atılmaz , diyor .	atılmaz	5	Sing
Ara sıra temizliği aksatsa da kendisine hep siz diyen bir kızcağız .	aksatsa	3	Sing
Dolapta yeterince makarna ve margarin bulunup bulunmadığına baktık .	baktık	7	Plur
Bu gerçeklik içinde bir nesne gibi bakabiliriz ona , öznel bir nesne , bir gerçeklik görünüşü var .	bakabiliriz	6	Plur
Diz çök karşısında , okşa saçlarını , özür dile , bağış dile , ne dilersen dile it herif , ağla hatta elinden geliyorsa ...	çök	1	Sing
El vurdum basa basa .	basa	3	Sing
Sorumluluk taşıyan insanlarımız var ; verdikleri sözün arkasında durdular ve eserler yarattılar .	yarattılar	11	Plur
İşte o zaman , bu turistik yörenin olağanüstü tarihine merak duyanlar , buradaki insanların birkaç bin yıl önceki bir uygarlığın torunları olduğunu bilenler , tarihten bir sahnenin canlanmakta olduğunu sezerlerdi .	duyanlar	10	Plur
Bir taksi bulduk .	bulduk	2	Plur
içine alır , besler , büyütür , korur .	büyütür	5	Sing
Bilimsel Devrim boyunca alanını din aleyhine gittikçe genişleterek , dinin eskisine göre çok daha dar bir alana hapsedilmesine yol açan bilimin kendisi de , bugün kendi alanına hapsedilmiştir .	hapsedilmiştir	27	Sing
O arada bir inceleme yapıyorlar .	yapıyorlar	4	Plur
Saatler çaldı .	çaldı	1	Sing
Ne olacağını biz de bilmiyoruz " dedi .	bilmiyoruz	4	Plur
Öyle bir felsefe ki bu , kendi içinde bir çelişkiyi taşıyor ; varoluşla yaşamanın birbirine hiç uygun düşmeyeceğini , bu ikisi arasındaki çelişkiyi anlatıyor .	taşıyor	10	Sing
Önce hayatlarının çizgileri teğet değdi birbirine ...	değdi	4	Sing
Ama inanın , yanıtlar hep aynı olacaktır .	olacaktır	6	Sing
O sıra kapı yeniden tıkladı .	tıkladı	4	Sing
Artık duygularının , hastalıklarının ağrılarını kesecek uyuşturucu da olmadığı için neye sığınacağını bilemeyecek hale geliyor .	kesecek	5	Sing
Her gün yüz bin mi verecekler sana .	verecekler	5	Plur
Ürünlerinizin konuşulduğu bir atmosfer yaratabiliyorsanız , ürün kendi kendini satacaktır .	satacaktır	9	Sing
Hayır , sonraları hiç de sevmiyordum onu .	sevmiyordum	5	Sing
İyi ki kedi olalı bir fare tuttun , dedi Melek .	tuttun	6	Sing
Yeşil fasulye diyip geçemezsiniz .	geçemezsiniz	3	Plur
Hülya duydu , yaramaz ama çalışkan öğrenciye kızan öğretmen gibi kararsız , dudak büktü .	büktü	13	Sing
Geceyi böylece geçirebilecektik .	geçirebilecektik	2	Plur
Başbakanlık'ta yapılan toplantılarda maaş artışının tazminatlar ve sosyal yardımlarda düzenleme yapılarak gerçekleştirilmesi seçeneğinin üzerinde çalışıldığı öğrenildi .	öğrenildi	15	Sing
Bakın , gerçekleşmeye başladı .	Bakın	0	Plur
Ne işe mi yarardı .	yarardı	3	Sing
şaşılaştı gözleri .	şaşılaştı	0	Sing
Dosyamız esas olarak iki bölümden oluşuyor .	oluşuyor	5	Sing
Hostes abla kardeşinin ölümüne inanamadı .	inanamadı	4	Sing
Ne diyecektik .	diyecektik	1	Plur
Oturma odasında cam kaseye kurulur .	kurulur	4	Sing
Bu herhangi bir rahatlama sağlamıyor ki , en fazla o sorunu nasıl çözeceğime ilişkin tavsiye almış oluyorum .	sağlamıyor	4	Sing
Dosyamızın esas unsuru olan ikinci bölümde ise sona eren bin yılın en büyük bilim ve düşün devrimlerini yansıtmaya çalıştık .	çalıştık	18	Plur
Sonra , patron olduğunu anımsatmak için , soymakta olduğu patatesleri bırakıp , bir çay doldurdu , masalardan birine geçti , sabahtan beri bakıla bakıla paçavra gibi olmuş gazeteyi eline aldı .	geçti	18	Sing
Sonra , patron olduğunu anımsatmak için , soymakta olduğu patatesleri bırakıp , bir çay doldurdu , masalardan birine geçti , sabahtan beri bakıla bakıla paçavra gibi olmuş gazeteyi eline aldı .	bakıla	22	Sing
Nasılsınız ? Vurgu : Ortadan kayboldunuz , iyileştiniz mi ?	kayboldunuz	5	Plur
O kişi olmazsa yaşayamam ; sekssiz yaşayamam ; alkolsüz bir hayat düşünemem ; başarı için günde on altı saat çalışmam gerekir vb .	olmazsa	2	Sing
Ne yalan söyleyeyim biz babamı özlüyoruz .	söyleyeyim	2	Sing
Siz nedenini anlayabiliyor musunuz .	anlayabiliyor	2	Sing
Öbür bardağı da doldurdu , döke saça .	döke	5	Sing
Recep , pantolonunu giymiş , gömlek cebinden çıkardığı sigarayı ağzına koymuştu .	koymuştu	10	Sing
Gevşemiyor bir türlü ...	Gevşemiyor	0	Sing
Ama kaçtın ondan .	kaçtın	1	Sing
Yüreğim delice çarpıyor , ellerim uyuştu .	çarpıyor	2	Sing
" Yurtdışında kazan konusunda uzman bir firmayla ortaklık yapmak istiyoruz .	istiyoruz	9	Plur
Lafı ağzına tıkadım : Yahu , kızın ne kabahati var ! Anababalar münasebetsizse ...	tıkadım	2	Sing
Hiç de öyle değil , gencecik oğlunun dizi dibinden ayrılmasını göze alamıyordu , yanında olmasını istiyordu mutlaka .	istiyordu	15	Sing
Hepimiz dahi bellemişiz onu .	bellemişiz	2	Plur
Boşuna üzülüyorsun istediğin zaman gelip Kahve'yi görebilirsin .	görebilirsin	6	Sing
Sen de benim yaşıma gel , sana da alırlar göreceksin .	alırlar	8	Plur
Onların dallardan yolup yolup attığı erikleri önlüğündeki torbaya dolduruyordu .	dolduruyordu	8	Sing
İnceldiği yerden kopsun .	kopsun	2	Sing
Pencerelerde ışık olsa gidip kapıyı çalacak mıydım , emin değildim .	değildim	9	Sing
Fatih'in , gemileri Haliç'e karadan indirme planının Fatih'in kafasından çıkmadığını , Said Nursi'nin - i de arkasına Nurcu ordularını toplayıp başkente yürüme planları yapmadığını işitiyorsunuz .	işitiyorsunuz	24	Plur
Görmüyorlar mıydı : Girişten mağlup başlıyor , gelişme bölümünün ortasına bile sağ salim varamıyordum ; sonucu da felaket oluyordu bu durumda tabii .	başlıyor	5	Sing
Giir ! diye gürledi .	gürledi	3	Sing
İstersen biraz daha kalsın , biraz daha annesi baksın ona .	baksın	8	Sing
Mücadele ... diye mırıldandı adam .	mırıldandı	3	Sing
Annem hep korkmuş , çocuklarımdan biri büyük amcalarına benzer diye ; ama şimdi bakıyormuş da , benim yolum yol değilmiş .	korkmuş	2	Sing
İddialı oldukça değer kazandıklarını düşünüyorlar .	düşünüyorlar	4	Plur
İzzettin Doğan ve Alevi Bektaşi Kültürü Derneği Başkanı Ali Balkız gibi Alevi temsilcileri oturdu .	oturdu	13	Sing
Nereden biliyorsunuz ? diye hayretle sordum .	biliyorsunuz	1	Plur
Davetiye iki kişilik olduğu için ben babamla gittim .	gittim	7	Sing
O gecenin - daha doğrusu sabahın - öyküsü şöyle : Sevda'nın güzel yemekleriyle şiş midemizle Özer'lerden çıktık .	çıktık	16	Plur
Göklere çıkarıyordun .	çıkarıyordun	1	Sing
Katana içeri girdi .	girdi	2	Sing
Ne tuhaf anlattın bana bu makineyi ...	anlattın	2	Sing
Adam , argoyla karışık da olsa - ki bu , sınıfını gizlemediğini gösterdiğinden bir erdem sayılabilirdi - Necmi Bey'i aratmayan güzel cümleler kurabiliyordu .	sayılabilirdi	15	Sing
Bu usül yaygınlaşmış .	yaygınlaşmış	2	Sing
Kıskanmanın çaresizliğinden ve içimde yarattığı aşağılanma duygusundan kurtulmak ve bana kaçınılmaz gözüken o terk edilme gününun acısını daha baştan hafifletmek için , hayatıma kattığım kadınların sayısı artıyordu .	artıyordu	26	Sing
Ne kadar zengin olursan ol , diyor , seyirci olduktan sonra ( al işte Nurettin Bey ; sattı yedi , sattı yedi şimdi beş parasız , onun bunun eline bakıyor ) sıfırı tüketirsin .	sattı	20	Sing
Senaryo , çünkü bileşenleri tamamen metafizik öğelerden oluşmaktadır .	oluşmaktadır	7	Sing
Bir kere tuvaletini yapmak için sık sık dışarı çıkarmak yoktu , çünkü o zaman ayakları kirlenir ve her defasında yıkamak gerekirdi .	gerekirdi	20	Sing
Bunlar olup biterken küçük sarışın çocuk , kucağında , bacaklarının arasına sıkıştırdığı darbukaya sol eliyle hiç ses çıkarmadan , okşarcasına vuruyor , sağ eliyle de tabağındakileri ağzına tıkıştırıyordu .	okşarcasına	19	Sing
Anneme sorsan hiç özlemediğini söyler ; ama bence herkes birbirini arıyor .	arıyor	10	Sing
Vaktin varsa görüşelim .	görüşelim	2	Plur
Uyandım ve sabah rolü bana verdiklerine dair telefon alacağımı bilerek tekrar uyudum .	Uyandım	0	Sing
İnsanları ikiye ayırıyor annem ( sayacağı iki kalem de olsa mutlaka parmaklarını avucuna kapatarak sayacak ; birincisi yaşayanlar ( bunlar başkalarını da yaşatıyor ) , ikincisi yaşayanları seyredenler ( bunlar da başkalarının sırtına yük oluyorlar ) .	seyredenler	27	Plur
Ramiz yerine oturana dek de gözlüklerinin üstünden izledi .	izledi	7	Sing
Drugstore'da alışveriş yapanların yüzde 91'i ambalajın önyüzünü , yüzde 42'si arkasını , yüzde 8'i de yan yüzlerini okuyor .	okuyor	17	Sing
Ay çoktan batmıştı .	batmıştı	2	Sing
Kısmetse çarşamba günü İstanbul eğlence yaşamında buluşmak üzere hoşkalın , hep mutlu yaşayın .	yaşayın	12	Plur
Ya okula geç kalırsak .	kalırsak	3	Plur
Adam kızın annesini görür görmez kadının güzelliğine vurulmuş .	görür	3	Sing
Ali'yi üzmeden bu köpeği çok sevdiğimi ve ona sahip olabilmek için ne çok engeli aştığımı anlatmalıydım .	anlatmalıydım	15	Sing
Bırak zırlasın .	zırlasın	1	Sing
Aman , neymiş bu makine ... diye söylendi Gül Abla .	söylendi	7	Sing
Bu kuruluşların ciro büyüklüklerine göre yaklaşık elli trilyonluk bir gelir sağlanacak .	sağlanacak	10	Sing
Onlardan intikam alırım .	alırım	2	Sing
Ayhan imrenmiş .	imrenmiş	1	Sing
Bir mısır tarlasına girip boydan boya koşarak geçtiler .	geçtiler	7	Plur
İzini bulursanız , bu numaraya haber verirsiniz , dedi .	verirsiniz	6	Plur
Kalkmaya hazırlanan masadaki iki genç kadının ayaklarının oynamaya başladığını , ince hırkalarının altında omuzlarının titrediğini , parmaklarının tempo tuttuğunu gördü , sevindi .	gördü	19	Sing
Bu görüşler savcılığın aylar süren soruşturmasında da hiçbir değişikliğe uğramadan , hatta o demeçlere uydurularak bir sonuca varılıyor .	varılıyor	17	Sing
Öğle yemeğinden sonra kadavra üzerinde yapacağımız çalışmayı asistanıma anlatırken kapı çaldı .	anlatırken	8	Sing
Şimdi ; gidip günah çıkarsam - bakın , üstelik burada benim bir günahım yok aslında - , rahatlamaz mıyım ? Sana normal davranır hale gelmez miyim ? Belki .	rahatlamaz	17	Sing
Bir mektup getirmiştim Mahmut Beye .	getirmiştim	2	Sing
Hey , Ömer , kalk oğlum , geç kalmışız .	kalk	4	Sing
Sahi siz , aradığınız bu Ana'yı gördünüz mü hiç ? dedi .	gördünüz	6	Plur
Kağıt kalem bulmalıyım , bir de zarf .	bulmalıyım	2	Sing
Kursanız bile sonunu çok başka bir biçimde bitirirsiniz .	bitirirsiniz	7	Plur
Rekabet neler yaptırıyor .	yaptırıyor	2	Sing
Mutsuz ya da parçalanmış ailelerden gelen çocuklar - bir yudum mutluluk için - uyuşturucuyla ilk karşılaştıklarında ona dört elle sarılıyorlar .	sarılıyorlar	19	Plur
Kapıyı açtı , dönüp bize baktı .	baktı	5	Sing
EN SON ANNESİNİ ARADI .	ARADI	3	Sing
Siz gene de demeyin .	demeyin	3	Plur
Bu hafta okurlardan gelen umumi talep üzerine Kırmızı Türkler'in temel özelliklerini madde madde sıralıyoruz : .	sıralıyoruz	13	Plur
Gülmeyin , zor durum ...	Gülmeyin	0	Plur
Kapı hafifçe aralandı .	aralandı	2	Sing
Aslında , balıkçıların Saffet'ten memnun olmadıkları da söylenemezdi .	söylenemezdi	7	Sing
Küçük görmeyin .	görmeyin	1	Plur
Karademir , üniversite rozetini de oğlunun yakasına taktı .	taktı	7	Sing
Dünyaya yayabilsek .	yayabilsek	1	Plur
Beni niye sevdiğini hiçbir zaman anlayamamıştım , ama beni niye terk ettiğini biliyordum , bütün kadınlar beni hep aynı şekilde ve aynı nedenden terk ederlerdi zaten .	biliyordum	12	Sing
Sonra gücü , olanağı elverdiğince de , gereksinimi çerçevesinde , o bir göz odaya zamanla , mutfak , banyo , başka bir oda ekliyordu .	ekliyordu	23	Sing
Bazı geceler kulağımı kapısına dayar , dayak yerken attığı çığlıkları dinlerdim .	dayar	4	Sing
Bütün sınıf önümüzdeki hafta harçlıklarımızı harcamayıp biriktireceğiz .	biriktireceğiz	6	Plur
İstersen biraz daha kalsın , biraz daha annesi baksın ona .	İstersen	0	Sing
Sesinden tanıyordum kadınların mutsuzluğunu , sanki seslerinin özel bir kokusu oluyordu , kıyılmış tütün kıvamında , yanık gül yaprağı gibi kokuyordu sesleri , daha ilk notasında alıyordunuz kokusunu , bezgin , mesafeli ve biraz da düşmanca bir ses çıkarıyorlardı .	alıyordunuz	26	Plur
Tayyip Erdoğan'ın yanında , onun yanlışlarına ortak olsaydım kesinlikle bu noktalarda bulunmazdım " sözünün Milliyet tarafından farklı yansıtıldığını öne sürdü .	olsaydım	7	Sing
Buzluktaki içkileri de saydılar .	saydılar	3	Plur
Bazen çok para verir bana .	verir	3	Sing
Sosyal bir kurum olarak bilim , başlangıçta öncü bir rol oynarken , bugün artçı ve tabi bir konuma sıkıştırılmıştır .	sıkıştırılmıştır	18	Sing
Nasılsınız ? Vurgu : Ortadan kayboldunuz , iyileştiniz mi ?	iyileştiniz	7	Plur
İTÜ'ye girdi ..	girdi	1	Sing
O zaman , klasik şube vardı .	vardı	5	Sing
Beni terk etmekte olan sevgilimle buluşup yemek yiyecektim .	etmekte	2	Sing
İnşaat ortamına ve getireceği değişikliklere alışması için hazırlanan tanıtım filmi ile alıştırılacak ve bilgilendirilecek olan köylüler , çalışma ekiplerine hizmet satabilecekler .	satabilecekler	20	Plur
Hüseyin ile Nükhet en iyi dans eden çiftti aralarında , gerçek hayatta bir çift oluşturmasalar bile .	oluşturmasalar	14	Plur
Nasıl da zorluyor kapıyı ...	zorluyor	2	Sing
Melek kaç tane sattın ? diye yaklaştı Memo .	yaklaştı	6	Sing
Mersedes'liden kazandım ...	kazandım	1	Sing
Sesinden tanıyordum kadınların mutsuzluğunu , sanki seslerinin özel bir kokusu oluyordu , kıyılmış tütün kıvamında , yanık gül yaprağı gibi kokuyordu sesleri , daha ilk notasında alıyordunuz kokusunu , bezgin , mesafeli ve biraz da düşmanca bir ses çıkarıyorlardı .	çıkarıyorlardı	38	Plur
Sen de dört gecedir bir uğrayıp bakmadın bana , dedim .	bakmadın	6	Sing
Yaklaştım yanına .	Yaklaştım	0	Sing
Ardahan Savcısı diye bir kart bastırmış .	bastırmış	5	Sing
Siz mektubu hazırlayın , ben götürür veririm , dedim .	veririm	6	Sing
Ufaklık için de bir açıklamaya ihtiyacım olacaktı belli ki Köpek de nöbetçimiz olacak .	olacaktı	6	Sing
kavramlar değişti mi , her şey değişiyor .	değişiyor	6	Sing
Baksanıza hallerine ... diyerek Mahmut'un masasını işaret etti .	Baksanıza	0	Plur
Alışveriş merkezlerinde raf etiketinde belirtilen fiyatla kasa fiyatı arasında farklılık olması durumunda satışın tüketici lehine olan fiyat üzerinden yapılması öngörülüyor .	öngörülüyor	19	Sing
Ben yeni yedim .	yedim	2	Sing
Bir ara köpeği kimin dolaştıracağına karar veremedikleri için kavgaya bile tutuştular .	tutuştular	10	Plur
Çocuk , başını bir yandan diğer yana çevirmekle yetindi .	yetindi	8	Sing
yazarları Termodinamiğin İkinci Yasası'nın tanımını ve yorumunu yanlış yapıyorlar ! Yanlış ! Entropinin sürekli arttığını savunan Boltzmann yorumu , dizgedeki entropi üretiminin ısı akısı ve bu akıya neden olan sıcaklık gradyentinden hesaplandığını söyler .	yapıyorlar	8	Plur
Bu sorunuzu , garsonun bakışları , çevredekilerin gürültüleri yüzünden siz bile duyamadınız ; ama ben duydum .	duyamadınız	11	Plur
Bu dönemde , teori , bilimin çeşitli alanlarında , yeni kavramsal yapılanmalarla bilimi yeni düzlemlere taşımış ; geçmişin kavramsal yapılanmalarında köklü bir kopuşla bilimin önünde yeni ufuklar açmıştır .	açmıştır	27	Sing
Mazeret bildirip uçuşa gitmeyen ikinci pilotun yerine göreve çağrıldı , böylece o gece eşiyle yemeğe gitmek yerine ölüme kanat açtı .	çağrıldı	8	Sing
Ne ondan bahsedebildim , ne yaşadıklarımdan ...	bahsedebildim	2	Sing
Madem Suna istiyorsunuz , sırf Suna olsun diye az diretmemiştim , Söyledik ya , dedim , kulak asmadınız ki .	Söyledik	11	Plur
Bir yerlere yetişirler .	yetişirler	2	Plur
Bir tane de ben ekleyeyim : Yiyebilir miyim ? diye bayılmış .	bayılmış	10	Sing
Aşağıda ayrıntılarıyla değineceğiz .	değineceğiz	2	Plur
Ama bu düşünceleri neden buraya aktardığım , elbette merak edilecektir ...	edilecektir	9	Sing
Güvenemem ona , anlıyor musun beni ? Hızlı araba kullanmayı , geceyi , içkiyi ve kadınları seven , arada kadife gibi yumuşayıveren , bazen sessiz ve suskun ...	Güvenemem	0	Sing
İnsanları ikiye ayırıyor annem ( sayacağı iki kalem de olsa mutlaka parmaklarını avucuna kapatarak sayacak ; birincisi yaşayanlar ( bunlar başkalarını da yaşatıyor ) , ikincisi yaşayanları seyredenler ( bunlar da başkalarının sırtına yük oluyorlar ) .	yaşayanları	26	Plur
Şöyle anlatayım : SEVİNİYORDUM .	SEVİNİYORDUM	3	Sing
Cevap vermedim .	vermedim	1	Sing
Peki , niye hikayeleriyle üzerime geliyorlardı .	geliyorlardı	5	Plur
Melek her zamanki yerinde , ümitle gelene geçene flasterlerini ve kalemlerini uzatıyordu , ama nafile ; kimsenin ona aldırdığı yoktu .	geçene	7	Sing
Bilimde bu tür mucizevi elatmalara yer olmadığı gibi , varlığı , Tanrı'ya inananlar için tehlike yaratır : diferansiyel eşitliklerinizdeki matematiksel tekillikleri daha iyi bir modelle ortadan kaldırdığınızda Tanrınız da tekillikle birlikte ortadan kalkar .	kalkar	32	Sing
İnsanlara özgü zannettiğim bir çok özelliğin hayvanlar aleminde de geçerli olabileceğini daha önce hiç düşünmemiştim .	düşünmemiştim	14	Sing
Çin restoranlarını artırmak için otelleri teşvik ediyoruz " diye konuştu .	ediyoruz	6	Plur
Bu kadar yeter , dedi , inin de gidelim artık .	gidelim	8	Plur
Ailenin görev ( ! ) anlayışıyla yaptığı tüm fedakarlıklar da içten bir sarılmanın , doğal bir sevginin yerini tutmuyor .	tutmuyor	18	Sing
Dosyanın önümüzdeki günlerde ele alınması bekleniyor .	bekleniyor	5	Sing
Hadi koşalım .	koşalım	1	Plur
Aptalca düşüncelerinizi , ruhunuzun hasta olduğunu sandığınız yanını başkalarının duymasından , bilmesinden korktunuz yıllarca .	korktunuz	12	Plur
Tamam usta ya , girmiyorum , bir işeyip geleceğim , diye yanıtladı çocuk .	girmiyorum	4	Sing
Biz de oradan almışız .	almışız	3	Plur
Oğlunuza sarıldığınızda , aklınızdan , Ya bu ona son sarılışımsa gibi aptalca bir düşünce geçiyor .	geçiyor	14	Sing
Yüreğim delice çarpıyor , ellerim uyuştu .	uyuştu	5	Sing
Hülya , Onu seri düşün , hadi gel , dedi ve kolumdan çekti .	çekti	12	Sing
Daha doğrusu takipsizlik kararı verilmişti .	verilmişti	4	Sing
Kırmızı yandı , arabalar duruyor .	yandı	1	Sing
Bu yıl mutlaka evde büyük bir doğum günü yapacağız .	yapacağız	8	Plur
Nesrin bize kızardı , falan , konu değişirdi .	kızardı	2	Sing
Ölümü ensemde hissediyordum .	hissediyordum	2	Sing
Bu açıdan bakıldığında , sübjektif idealist dizgede evren açık sanılır .	sanılır	9	Sing
Bazılarımız buna gerek olmadığını düşünüyordu ama çoğunluk , apartmana esprili bir ad taksak fena mı olur a yatkındı .	taksak	12	Plur
Böylece kazanları Hablemitoğlu ürünümüze katma değer kazandıracağız .	kazandıracağız	6	Plur
Balıkların parasını ödeyecekler .	ödeyecekler	2	Plur
Elde kalan o güzelim göbeği de özenle soyun .	soyun	7	Plur
Biraz da telaşlandığımı itiraf etmeliyim .	etmeliyim	4	Sing
Diyarbakır'da bir inşaat firmasında proje müdürü olarak çalışan inşaat mühendisi Servet Karadağ , evlendikten sonra da eşini yanından hiç ayırmadı .	ayırmadı	19	Sing
Bu heyecana , afyona , ne bileyim ben ; eroine alışır gibi alışır insan .	alışır	12	Sing
Kapının kenarındaki duvara dayanıp bize baktı bir an .	baktı	5	Sing
Naci Bey ellerini göğsüne çaprazlayıp yüzünü buruşturarak arkasına yaslandı .	yaslandı	8	Sing
, Bonham'a gidemem , Hülya'nın yanında kalmalıyım ; ya da arkasında , cephe gerisinde ...	kalmalıyım	6	Sing
Beni tanır , gelip karşısına oturduğumu hisseder .	hisseder	6	Sing
Hiç çalışmamış .	çalışmamış	1	Sing
Dün akşam İsraille Filistin Washington'da tarihi bir barışa imza attılar .	attılar	9	Plur
çalışmak da değil , hayatla boğuşuyorlar .	boğuşuyorlar	5	Plur
Ona bir mektup yazsanız ...	yazsanız	3	Plur
İNANOĞLU , bu konuda " Evet , böyle şeyler söyledim ama artık işlerim yoluna girdi .	söyledim	9	Sing
kirk yıl önce bulunmuş değildir .	bulunmuş	3	Sing
Bugün iyice kalabalıklaşan kervan altı saatlik yolculukla kasabaya ulaşacak .	ulaşacak	8	Sing
Bugünün Türkiye'sinde yaşayanlar çözecekler Türkiye'nin sorunlarını .	çözecekler	3	Plur
Tabanımız çok farklı , bütün eğilimleri topladık .	topladık	6	Plur
Bugün yeni teknolojiler ancak bütünüyle bilimsel bilgiler temelinde üretilebilir hale gelmiştir .	üretilebilir	8	Sing
Derhal müzik koymalıyım , beni alıp götürsün , şuradan Lou Reed kasetini .	koymalıyım	2	Sing
Annem , telefonda dedeme bir doğum günü partisi düzenlediklerini söyledi , yarın dönsem iyi olurmuş ...	olurmuş	14	Sing
Bu Türkiye Kuzey Kıbrıs'tan vazgeçene kadar sürecek .	vazgeçene	4	Sing
Gözün kanlanmış , sol gözün , dedi Gül Abla .	kanlanmış	1	Sing
Kertenkelelerin değiştirdiği derileri duvar diplerinden topladığın çocukluk günlerini hatırlamıştın .	hatırlamıştın	8	Sing
İç içe , üst üste kol ve yaprak verirler .	verirler	8	Plur
Dere yatağından getirilip köpeklerin erişemeyeceği bir yükseklikteki kütük setin üstüne istiflenmiş buz bloklarından bıçağıyla kopardığı parçaları kovaya dolduruyor .	dolduruyor	17	Sing
Naci Bey elini masaya öyle bir vurdu ki , ön sırada oturan kızlar hii diye bağırıp yerlerinden sıçradılar .	vurdu	6	Sing
Öyle oyuncu öyle oyuncu ki anlatamam .	anlatamam	5	Sing
Fısıldadı : Sağ ol .	Fısıldadı	0	Sing
Masanın öbür tarafında oturan yaşlı adamın doksan yaşında olduğunu söylediler .	söylediler	9	Plur
Hülya , Onu seri düşün , hadi gel , dedi ve kolumdan çekti .	gel	7	Sing
Allah Allah , bu da nereden çıktı ? diye sormadık , şaşırmadık .	sormadık	9	Plur
Milliyet'i arayan Arınç , " Yanlışlara ortak olmam " haberindeki ifadenin rahatsızlık yarattığını , Erdoğan'ın Danimarka'dan arayarak tepki gösterdiğini belirtti .	olmam	7	Sing
Ona yardımcı olmalıyız , dedi .	olmalıyız	2	Plur
Yanılıyor muyum yoksa .	Yanılıyor	0	Sing
Çocuğun tabaktakileri bir solukta silip süpüreceğini biliyordu artık .	biliyordu	6	Sing
Tamam ! tamam ! Hadi çabuk anlat , meraktan öleceğim .	anlat	6	Sing
El kaldırmadık .	kaldırmadık	1	Plur
Hiçbir şey anlatamadım , diye acıyla inledi .	anlatamadım	2	Sing
MART'I BEKLİYORLARDI .	BEKLİYORLARDI	1	Plur
Bu ülkenin önde gelen gazetelerinin özel yayın ilkeleri arasında çok azının konuya yer ayırdığı anlaşılıyor .	anlaşılıyor	14	Sing
Buyur etmişler .	Buyur	0	Sing
Zaman içersinde o teoreme yeni aksiyomlar , türetimler girmez ; ondan yeni bilgiler , öngörüler çıkmaz .	girmez	8	Sing
Kazancını yatırıma dönüştürdü .	dönüştürdü	2	Sing
Gazetecileri , yüksek meslek standartları tutturmaya , metinlerinde insani bir anlayış düzeyi kurmaya çağırıyorum .	çağırıyorum	13	Sing
Hepimiz heyecanla yerlerimizden fırladık .	fırladık	3	Plur
Sıcak çorbalar , muhallebiler , yoğurtlar getirmişler .	getirmişler	6	Plur
Gazetelerde kaçak çocuklar var ya aynen öyle yaparım .	yaparım	7	Sing
En yakınımıza bile anlatamadığımız şeyleri ona anlatalım .	anlatalım	6	Plur
Unutmadım onu .	Unutmadım	0	Sing
Bir tane de ben ekleyeyim : Yiyebilir miyim ? diye bayılmış .	ekleyeyim	4	Sing
Konuşmayı biraz uzatır , işlerin yoğunluğundan filan söz edersiniz .	uzatır	2	Sing
Yeğenlerin Zübeyde Halayı unutmalarını hoş görmek gerekir , kolay olmuyor bu işler .	olmuyor	9	Sing
Konuşmayı sevmezdi , konuşunca da iyi konuşurdu .	konuşurdu	6	Sing
Öğle yemeğinden sonra kadavra üzerinde yapacağımız çalışmayı asistanıma anlatırken kapı çaldı .	çaldı	10	Sing
Gitmeliyim , kalkıp gitmeliyim .	Gitmeliyim	0	Sing
Hiç anlamasalar da , hiç bilmeseler de , hiç ilgilenmeseler de , neden , kadınlar bütün erkeklerin iş hayatlarını pürdikkat dinlerler .	bilmeseler	5	Plur
Nusret Senem : Bu başvurumuzda birkaç noktaya değinmişlerdi .	değinmişlerdi	7	Plur
Demek ki ; toplumların kültür ve yaşantı farklılıkları ortadan kalktıkça , yörelerdeki yapı teknolojisi benzeştikçe ve yapı endüstrisinin durumu benzeşip , malzemeler aynılaştıkça , evlerin farklılığı ortadan kalkabilir .	kalkabilir	27	Sing
Bunlar olup biterken küçük sarışın çocuk , kucağında , bacaklarının arasına sıkıştırdığı darbukaya sol eliyle hiç ses çıkarmadan , okşarcasına vuruyor , sağ eliyle de tabağındakileri ağzına tıkıştırıyordu .	vuruyor	20	Sing
Biçimli elleriyle çakmağıyla oynuyordu .	oynuyordu	3	Sing
Unakıtan hükümeti , işçilerin yasal zorunluluktan kaynaklanan ve toplusözleşmeye konulması şartıyla ödenen iki ikramiyeden ikisini ödememe konusunu değerlendirecek .	değerlendirecek	17	Sing
Anne iyice sağlığına kavuşunca bir de ben gidip bu adamı göreyim diye düşünmüş ve kızın peşine takılıp şehrin ucundaki eve gitmiş .	düşünmüş	12	Sing
Arınç kürsüde önemli açıklamalar yaparken , babayla oğlu da anfide sohbet etti .	yaparken	4	Sing
Üstelik para da kaybediyorsun .	kaybediyorsun	3	Sing
Sosyal boyutu da ihmal edemeyiz " dedi .	edemeyiz	4	Plur
Geldiğin günü çok iyi hatırlıyorum .	hatırlıyorum	4	Sing
Eski kulübeyi ise mutfak haline getirmişti .	getirmişti	5	Sing
- Artık olmaz , onu kıramam .	kıramam	5	Sing
Oysa insan bir kez anımsamaya başlarsa gizlediklerini , beyninin içine giren kurt onu kemirir , yeni korkular , daha büyük , daha dehşetli korkular , en olmayacak düşünceler , günahlar , suçlar yaratır .	kemirir	13	Sing
Orda bana bir şiir okudu , Allah taş etsin tek kelimesini anlamadım .	anlamadım	11	Sing
Kendimizi bir yoklayalım .	yoklayalım	2	Plur
Bilene rastlamadım .	Bilene	0	Sing
Ben : Azıcık pencereyi açayım mı ?	açayım	4	Sing
Anlattığına göre , Evenlerin ataları Baykal Gölü'nün dağlık ve ormanlık doğu bölgesi , Amur Nehri Havzası ve Mançurya civarında yaşıyordu .	yaşıyordu	19	Sing
Az ilerde , sokağın başında kapısı kapalı duran Taşhan beni bir mıknatıs gibi kendine çekiyordu .	çekiyordu	14	Sing
Aşık olduğumu sanıyorum .	sanıyorum	2	Sing
Kırmızı yandı , arabalar duruyor .	duruyor	4	Sing
Geceleri kakıp , konuklara sunulacak rakı , votka , viski ne bulursam ; birer ikişer yudum kafama dikmeden , bölük pörçük uykumu bile sürdüremiyorum .	bulursam	11	Sing
Hakkı , Subay Evleri'nde oturuyordu .	oturuyordu	4	Sing
Ama hiçbir zaman emin olamazsın .	olamazsın	4	Sing
Üç ocaklı demirci dükkanı deyip geçme , fayton imalatından zengin bile olmuşlar .	olmuşlar	11	Plur
Taksitli satışlarda temerrüde düşen tüketiciye sağlanan haklar genişletiliyor .	genişletiliyor	7	Sing
birlikte , barın yakınına kadar sokulabildik .	sokulabildik	5	Plur
Onun garip çekimine girmişimdir artık .	girmişimdir	3	Sing
Günümüzde ise bu ilişki bütünüyle tersine dönmüş , bilim adeta tümüyle bir üretici güç haline indirgenmiştir .	indirgenmiştir	15	Sing
Baktı olmayacak , beni yanağımdan öptü , saçlarımı okşadı .	Baktı	0	Sing
bilim dallarındaysa , gözlem veya deneylerden türetilen ilk ilkelerden , hipotez veya varsayımlardan yola çıkılır .	çıkılır	14	Sing
FDR'nin altıyüzotuzdört sefer sayılı Konya uçağının tekerleklerinin , yaklaşma hattının soluna kaydığı , ancak kaptanın uçağı düzeltme manevrası yaparken sol ana iniş takımının tepeye çarptığı ve pist başına yakın bir noktada parçalandığı ileri sürüldü .	yaparken	18	Sing
Dayım , Eee , kes şu şarkıyı , demişti de , o da dayıma , Bu şarkı değil bi defa - , marş bu marş , akıllım , diye karşılık vermişti .	vermişti	30	Sing
Ama , hafiften titreyen sesi öyle etkiliydi ki , kendimi tutamadım , ağlamaya başladım .	ağlamaya	12	Sing
Giderek doğruluğuna inandığım ifade şu olmuştur : Yaşantı , hayat tarzı , evi biçimlendirir .	biçimlendirir	13	Sing
Bunun cezasını babası askerliğinde çok çekmişti .	çekmişti	5	Sing
Şimdi , beni iyi dinleyin , dedi .	dinleyin	4	Plur
Sarı mı , beyaz mı ? Yazmamışlar .	Yazmamışlar	6	Plur
Ama sen saçlarını evde boyayan kadınlara benzemiyordun .	benzemiyordun	6	Sing
Fon hisse oranları arttıkça İMKB ve fon getirisi birbirine yaklaşıyor .	yaklaşıyor	9	Sing
Bu dönemde , teori , bilimin çeşitli alanlarında , yeni kavramsal yapılanmalarla bilimi yeni düzlemlere taşımış ; geçmişin kavramsal yapılanmalarında köklü bir kopuşla bilimin önünde yeni ufuklar açmıştır .	taşımış	15	Sing
Orda bana bir şiir okudu , Allah taş etsin tek kelimesini anlamadım .	etsin	8	Sing
Taşhan'ın kapısını itip içeriye girdim .	girdim	4	Sing
Şirket aleyhine bir tazminat davası olacaktı .	olacaktı	5	Sing
Yüzlerini , bakışlarını , sözlerini , hatta seslerini bile değiştirebilirler , ama o seslerin içindeki küçücük vurgulamaları değiştiremezlerdi .	değiştiremezlerdi	17	Plur
Bir kadını daha çok sevip daha çok bağlandıkça , bir gün onu kaybedip yapayalnız , acılarla kalma korkusu büyüyordu ve gittikçe artan bir hızla kıskançlık uçurumundan aşağıya yuvarlanıyordum .	yuvarlanıyordum	27	Sing
Bu koca yuvarlak Dünya'nın etrafında dönüyordu .	dönüyordu	5	Sing
Tek Cumhuriyet demiş , saymamış , durmuş .	durmuş	6	Sing
Yani , diyem ...	diyem	2	Sing
Komutanlar , Cumhuriyet'in temel dayanağı olan laikliği sarsacak gelişmelere ve görüntülere izin verilmemesi gerektiğini vurguladılar .	vurguladılar	14	Plur
Belgin Dorukları da gittiğimiz yere götürüyoruz .	götürüyoruz	5	Plur
Annemle babam benimle ilgilenmiyor demek istemiyorum ; ama ben onlarla daha fazla birlikte olmak istiyorum .	istemiyorum	5	Sing
Dosyanın içerisine girdikçe bu kanaatim daha da güçlendi .	güçlendi	7	Sing
Daha sonra babanızın , sizinle yalnızken öleceğinden korktunuz .	korktunuz	7	Plur
Akşamları lokantada , kenar köşe bir masa kendilerine ayrılıyor , hesaptan ayrı getirdikleri balıklarla , bedava bir küçük rakıyla , ufak tefek mezelerle ucuz , güzel bir gece geçiriyorlardı .	ayrılıyor	8	Sing
Sosyal bir kurum olarak bilim , başlangıçta öncü bir rol oynarken , bugün artçı ve tabi bir konuma sıkıştırılmıştır .	oynarken	10	Sing
Erbakan konuşmasında , " saadetin " ancak SP ile geleceğini öne sürdü .	sürdü	11	Sing
Örneğin sakız çiğnememi yasaklıyor .	yasaklıyor	3	Sing
Dönmüyor da zaten ...	Dönmüyor	0	Sing
Bu hükümet neden dağıldı .	dağıldı	3	Sing
Salonun kapısındaki görevliye davetiyelerimizi gösterdik ve içeri girdik .	gösterdik	4	Plur
Dönüp gülümsedi , bu işe bir son ver demek istiyordu .	ver	7	Sing
Ben de yeni kadınlar buluyordum , daha önceleri tanıştığım , bir - iki günlüğüne birlikte olduğum kadınları arayıp onlarla ilişkilerimi sıkılaştırıyordum .	sıkılaştırıyordum	20	Sing
ABD'nin Ankara Büyükelçisi Robert ' , Irak konusunda barışçı çözümde ısrar edeceklerini ve sorunun savaşsız bitmesini arzu ettiklerini belirterek , " Saddam giderse savaş şartları ortadan kalkar " dedi .	giderse	22	Sing
Kendiniz bulun .	bulun	1	Plur
Merak eder , açar .	eder	1	Sing
Irak tehdidi tepemizde durmasına karşın borsacıların hayalindeki hükümet formülü olan DYP CHP - koalisyonunun gerçekleşmesi durumunda borsa seçimden sonra bir ralli yapabilir .	yapabilir	21	Sing
Görmüyorlar mıydı : Girişten mağlup başlıyor , gelişme bölümünün ortasına bile sağ salim varamıyordum ; sonucu da felaket oluyordu bu durumda tabii .	Görmüyorlar	0	Plur
Ürünlerinizin konuşulduğu bir atmosfer yaratabiliyorsanız , ürün kendi kendini satacaktır .	yaratabiliyorsanız	4	Plur
Yine cevap vermesine fırsat bırakmadan , Bir erkek gibi değil yani , erkekler yalnızca sevişebilmek için yalan söyleyebilir , ama seviştikten sonra sevebilir , bundan sonra ise yalan söylemez .	söyleyebilir	17	Sing
Tek hesabın kapsamı genişliyor .	genişliyor	3	Sing
Genetikle mi , sosyal hayatımızla mı var oluruz .	oluruz	7	Plur
Anayasa paketinin tümü , kırkdört ret oyuna karşı dörtyüzotuzyedi kabul oyuyla aynen geçti .	geçti	12	Sing
Her yanım titriyor , ter içinde kaldım .	titriyor	2	Sing
Sinek uçsa vızıltısı duyulacaktı .	uçsa	1	Sing
Bilmiyorum , dedim .	Bilmiyorum	0	Sing
Hannes Alfven : Big bang bir söylencedir , haksızlık etmeyelim , belki de iyi bir söylence .	etmeyelim	9	Plur
Kalktım , sarıldım boynuna , zoraki öptürdü pembeliğini koruyan yanaklarını .	sarıldım	2	Sing
Hiçlikten geldiği için , içinde hiçliği taşıyor ; sonra gene de hiçliğe dönüşüyordu .	taşıyor	6	Sing
Artırım otuz gün önceden bildirilecek .	bildirilecek	4	Sing
Şimdi hiçbir şeye yaramadıklarını düşünsem de , yaşayabilmek için yazmak ! Böylece , o beklemekle , aramakla , bütün bu zaman parçalarını dolduracak olan boşlukla ve sıkıntıyla dolu yaşam çizgimi belirledim sanıyorum .	sanıyorum	31	Sing
Hiç evlenmemiş , tek başına yaşayan bu kadın eroin bağımlısı genç bir delikanlıyla özlemini çektiği ana - oğul ilişkisi yaşadığını söylüyor .	söylüyor	20	Sing
Çek dedik .	dedik	1	Plur
Onlara hiç anlamıyorlarmış gibi gelirken birden en can alıcı soruyu , nasıl olup da bulup sorabilirler .	sorabilirler	15	Plur
Bitti , kendiliğinden kapandı parantez .	kapandı	3	Sing
Ne kadar zengin olursan ol , diyor , seyirci olduktan sonra ( al işte Nurettin Bey ; sattı yedi , sattı yedi şimdi beş parasız , onun bunun eline bakıyor ) sıfırı tüketirsin .	bakıyor	29	Sing
Türkiye , geçmişle ve geçmişin korkularıyla bağlarını kopardı gidiyor .	gidiyor	8	Sing
Gözgöze geldik .	geldik	1	Plur
Bakın soluk soluğa kaldınız .	Bakın	0	Plur
Ona anlatmayıp da kime anlatacaktım ? Kimim kimsem yoktu , her şeyim oydu .	anlatacaktım	4	Sing
Hiçbir şey düşünemiyorum .	düşünemiyorum	2	Sing
Doğum günü yapmakta asıl amacım Tibet'i bize davet etmek .	yapmakta	2	Sing
Şimdi de yaşayacaksınız .	yaşayacaksınız	2	Plur
Ağır , babacan bir gülüşle gülüyorlar , önlerine eğdikleri başlarını ( saygıdan tabii ) ağır ağır sallıyorlar : Yazık , çok yazık , diyorlar .	gülüyorlar	5	Plur
Çayırlığa çıktılar .	çıktılar	1	Plur
Aldığım şeyin isminin önemi yoktu , geçici de olsa yeter ki deliği kapatsın .	kapatsın	12	Sing
Oh , iyi ki aradın Maryline .	aradın	4	Sing
Yay sesleri dindi yavaş yavaş , uyum sağlandı .	sağlandı	7	Sing
Ama bir türlü , Ben de yıllar önce sizin gibi diye başlayan bir cümle kuramazsınız .	kuramazsınız	14	Plur
Sen buralarda ne geziyorsun aylak aylak .	geziyorsun	3	Sing
Şangır ! Oldu işte , battı ortalık .	battı	5	Sing
Boş zamanlarımda bazen cinayetlerin işlendiği yerlerde dolaşıp çevreye bakınır , cinayet anını gözümde canlandırmaya uğraşırdım .	uğraşırdım	14	Sing
Oysa kıçlarını kaldırma zahmetine katlansalardı kendilerine bıraktığım dosyada yapacağım deneylerin üreme organlarıyla ilgili olduğunu , gönderilecek kadavranın cinsiyetinin de önemle dişi olması gerektiğini görebilirlerdi .	görebilirlerdi	23	Plur
Serhat , Öyle bir şey öneriyorsun ki Kemal , dedi , bu öyle bir çırpıda karar verilebilecek bir şey değil .	öneriyorsun	5	Sing
Yaka takmadığı için Naci Bey birkaç kez kocaman kafasına tahta cetvelle vurmuştu .	vurmuştu	11	Sing
Bir ilişki yepyeniyken nasıldır , bilirsiniz ... dedi .	bilirsiniz	5	Plur
Filmle alıştıracaklar .	alıştıracaklar	1	Plur
Botel Maliye Hesap Uzmanları Vakfı'na hazırlattığı " Türk Vergi Sistemi , Sorunlar ve Çözüm Önerileri " başlıklı raporda vergi mevzuatı bütün yönleriyle değerlendirildi .	değerlendirildi	22	Sing
Mali Barış'tan yararlanacakların hürriyeti bağlayıcı cezalarla ilgili düzenlemeler karşısında sorumlulukları devam etmeli .	etmeli	11	Sing
Doğrusu size yardım edebilmek isterdim , dedi Jul .	isterdim	4	Sing
Erkekler Parkı'ndan geliyorum .	geliyorum	2	Sing
Bazı geceler kulağımı kapısına dayar , dayak yerken attığı çığlıkları dinlerdim .	dinlerdim	10	Sing
Huzur ormanında doğdu Ortadoğu barışı .	doğdu	2	Sing
Ne ki , zamanla yoğun sıkıntıya yolaçtı , bana göre , tekdüze , coşkusuz , amaçsız yaşam ; depreşti , ölçüye sığmaz oldu içki bağımlılığım .	depreşti	18	Sing
Kazadaki adamın sinirleri kaç kişiye bağlansa bunların hepsi , aynı Politzer gibi , kazayı başından sonuna kadar yaşayacaktır .	yaşayacaktır	17	Sing
Baktım baktım yürüdüm gittim .	gittim	3	Sing
Herhalde doğru yazdım .	yazdım	2	Sing
Fransızlar rekabete aldırmıyorlar .	aldırmıyorlar	2	Plur
Biri kazanmış .	kazanmış	1	Sing
Özene bezene kurulan her eve eninde sonunda ölüm girer .	Özene	0	Sing
Hem sonra annem buna sürpriz diyebilir mi ?	diyebilir	5	Sing
O gün çaya karıştırılacak miktarı çarçabuk sağıp , soğuktan üşüyen ellerini sıvazlayarak içeri koştular .	koştular	13	Plur
Meyhanelerin , o dönemlerde , erkeklerin sayıca ağır bastığı havası , sıkıyordu beni .	sıkıyordu	11	Sing
Ramiz girip başını eğerek kapının önünde dikildi .	dikildi	6	Sing
Bizden sonra kaldırıldı .	kaldırıldı	2	Sing
Öğretmenim , diyeceğim , köpeklerden korktuğum için Miskoye ile Katana da benimle geldiler .	diyeceğim	2	Sing
Ortada böyle bir ihtimal yokken sen kendi kendine kuruntular yaratıyorsun .	yaratıyorsun	9	Sing
O sizi gene parkın içine çeker dedi Şakir .	çeker	5	Sing
Eğer ilk anda şarlamazsanız , size ciddi ciddi şunu öneriyorum : Aramızdan birini tesbit edelim .	öneriyorum	9	Sing
Yerimden fırladım , kapıyı hızla açıp Ömür Uzatma Kıraathanesi'nden dışarıya çıktım .	fırladım	1	Sing
O kadar iyisin ki özgürlüğüm kısıtlanıyor , istediğim gibi davranamıyorum .	kısıtlanıyor	5	Sing
Dolayısıyla başkaları için ev yapmak - o evi yapan mimar da olsa - o başkalarının , o ailenin yaşantısını ve hatta hayatını yönlendirmek demektir : Ne büyük bir sorumluluk , acaba altından kalkılabilinir mi ?	kalkılabilinir	32	Sing
Aslında askeri darbelerin hakkını yemeyelim .	yemeyelim	4	Plur
O zaman damda , ineklerle yatsın .	yatsın	5	Sing
Sen beni şaşırtıyorsun , dedi .	şaşırtıyorsun	2	Sing
Sezginler ne ile uğraştığını o güne kadar tam olarak bilemese de Senem başlarına gelebilecekleri tahmin edebiliyor ve bu yüzden Sezginler'i uyarma ihtiyacını hissediyordu .	hissediyordu	22	Sing
Daha sonra raporda pilotlar ve uçağın durumu ile ilgili genel bilgiler veriliyor ve uçuş sırasındaki meteorolojik şartlar belirtiliyordu .	belirtiliyordu	17	Sing
Gidiyoruz , gelin .	gelin	2	Plur
Merdiveni geri çıkarken başımı Hülya'nın sırtına yasladım .	yasladım	6	Sing
Bu saman sarısı saçların , takma kirpiklerin ve kelebek kanadı gibi boyalı dudaklarınla daha önce de arkadan vermiş olmalısın mı demişti .	olmalısın	18	Sing
Niye mutsuz olduklarını ise söylemezlerdi , mutsuzluklarının nedenini siz keşfetmek zorundaydınız , bunu keşfedemezseniz biraz daha düşmanlaşırlardı ; bu düşmanlık gerçek değildi , yalnızca mutsuzluklarının üstüne örtmeye çalıştıkları yakıcı bir örtüydü .	düşmanlaşırlardı	16	Plur
O alanda doğruyu bulmuş olan bilim dalı daha fazla ilerleyemez ; son bilgiye ulaşmıştır , kapalıdır ; yeni bilgilere , olaylara , süreçlere yer yoktur .	ilerleyemez	9	Sing
Pantolonu dizlerine kadar ıslandı .	ıslandı	3	Sing
Olası bir savaşta , Türkiye büyük zararlarla karşı karşıya kalacak .	kalacak	9	Sing
Ben kalemimi düşürdüm .	düşürdüm	2	Sing
Ya dayak yerseniz , ya karakola gidersiniz .	gidersiniz	6	Plur
Utangaç utangaç gülümsediler birbirlerine .	gülümsediler	2	Plur
Durun ! Gitmeyin ! diye bağırdı Hacı Murat .	Durun	0	Plur
Hele o zamanlar moda olan sizler sözcüğüne ben hala şaşarım .	şaşarım	9	Sing
Yürüyelim mi biraz , sakıncası yoksa ?	Yürüyelim	0	Plur
Bunu yapmayanların yöneticileri şahsen sorumlu tutulacaklar .	tutulacaklar	5	Plur
Bir romanda anlatılmaya değmeyecek kadar bildik , binlerce yıldan beri yaşanan duygulardı bunlar , ama deneyimlerim bana bir şey öğretmişti : En korkunç gerçekler , söylenmeye değmeyecek kadar basit olan bildik gerçeklerdi .	öğretmişti	19	Sing
Onun güzelliğine duyduğum hayranlıkla başlayan ilişki daha sonra kesin bir cinsel bağımlılığa dönüşmüş ve hep öyle sürmüştü , hatta bir ara artık onun güzelliğini bile fark edemez hale gelmiştim .	dönüşmüş	12	Sing
Biz çıkaramadık .	çıkaramadık	1	Plur
Ezberlediği bir kaç cümleyi robot gibi tekrarlıyordu ; Bayan lütfen bir flaster alın .	alın	12	Plur
Pencereden tramvayların son durağı olan , caddenin ötesinde , soldaki , ağaçlıklı küçük alana bakıyordum .	bakıyordum	14	Sing
Onun güzelliğine duyduğum hayranlıkla başlayan ilişki daha sonra kesin bir cinsel bağımlılığa dönüşmüş ve hep öyle sürmüştü , hatta bir ara artık onun güzelliğini bile fark edemez hale gelmiştim .	gelmiştim	28	Sing
TBMM Başkanı Bülent Arınç , önceki akşam CNN Türk'te Taha Akyol'un sunduğu " Eğrisi Doğrusu programında " Milliyet'te yirmialtı Kasım ikibiniki tarihinde " Yanlışlara Ortak Olmam " başlığıyla yayımlanan röportajındaki ifadesinin farklı yansıtıldığını iddia etti .	Olmam	25	Sing
Kısık kısık gülüyor arada bir .	gülüyor	2	Sing
Dosyanın bütün olarak ilgiyle okunacağını düşünüyoruz .	düşünüyoruz	5	Plur
Beni görür görmez kendini yere atıp göbeğini bir açışı var ki sevdirmek için özellikle şişiriyor sanırsın .	görür	1	Sing
Hadi bakalım düşelim yola . dedi babam .	düşelim	2	Plur
Çünkü diğerleri koyun sütü kullanmıyor .	kullanmıyor	4	Sing
Haberin yanındaki analizde KADEK sözcüğü geçiyor .	geçiyor	5	Sing
Size kalırsa nal toplayacağız " diye tepki gösterdiler .	toplayacağız	3	Plur
Şahin , " BDDK istese de istemese de kamuda rahatlama için emekliliği gelenleri emekli etmeyi düşünüyoruz " dedi .	düşünüyoruz	15	Plur
İbrahim hazır ola geçip kollarını iki yanına birleştirdi .	birleştirdi	7	Sing
Askerler , Anayasa çiğnendi diye rejime müdahale etmişler , sonra da Anayasayı toptan kaldırarak yeniden başka bir metin yazdırmışlardı .	etmişler	7	Plur
Kendimi , bilincimin daha rahat olacağı bir dalgınlığa bırakmaya çalıştım .	çalıştım	9	Sing
Terk ettiği bir aşığıyla konuşmuştum bir akşamüstü .	konuşmuştum	4	Sing
( Bakınız : Emre Aköz , Perihan Mağden , Cihan Demirci .	Bakınız	1	Plur
Dünya şirketi olma hedefimiz için ikibiniki senesinde önemli atılımlar yaptık .	yaptık	9	Plur
Toplantıyı evinde yapacak olan kişi , Sakarya caddesindeki iki büyük bakkaldan , ya da Bulvar üzerindeki Trakya Şarküterisi'nden peynir , salam , tarama , Rus salatası , dolma gibi şeyler alırdı .	alırdı	30	Sing
Dayım , Eee , kes şu şarkıyı , demişti de , o da dayıma , Bu şarkı değil bi defa - , marş bu marş , akıllım , diye karşılık vermişti .	kes	4	Sing
Bütün delilleri , dosyayı inceleme hakkına sahipiz hukuki olarak , fakat bu haktan mahrum edildik .	edildik	14	Plur
Şunu niçin düşünmüyorsun , diye başladı Hülya yeniden , bu insanların hemen hepsi çeşitli zamanlarda özel birtakım konularını seninle konuşurlar , sana danışırlar , senin söyleyeceklerine önem vermeye hazırdırlar .	düşünmüyorsun	2	Sing
üç ) İMKB endekslerine paralel seyir göstermeyi hedefleyen A tipi endeks fonlar : Bu kategorideki fonlar yılı İMKB'deki kayba paralel kapattılar .	kapattılar	20	Plur
" Yapılan düzenleme , suç türü ve suç tarihi ayrımı yapılmaksızın , tüm hak yasaklamaları için öngörülmüş sürekli bir uygulama niteliğinde olmayıp af yasalarına özgü olduğu biçimde , yalnızca belli tarihe kadar işlenen suçları kapsamaktadır .	kapsamaktadır	34	Sing
Ayağa kalkıp yine gerindi .	gerindi	3	Sing
Annem hep korkmuş , çocuklarımdan biri büyük amcalarına benzer diye ; ama şimdi bakıyormuş da , benim yolum yol değilmiş .	bakıyormuş	13	Sing
Bu beni çok üzdü .	üzdü	3	Sing
Hiçlikten geliyor , görünüyor , bu görünüşe gerçeklik adı veriliyor ; sonra da bir parabol gibi kayıp gidiyordu .	gidiyordu	17	Sing
Daha otuz ikisinde , acımamışlar ...	acımamışlar	4	Plur
Yaptığı nice düşüncesizlikleri başına kakmak istemedim , şunun şurasında birlikte yaşamaya başlayalı ne kadar oldu , yaparsam küstahlık olur .	yaparsam	16	Sing
Artık hiçbir şey avutamaz beni , kendimi kandırabileceğim bir şey yok .	avutamaz	3	Sing
Hayır , önce yemeğini bitir , diye üsteledi anne .	bitir	4	Sing
Anneme yeni sınıf arkadaşlarımı çağırmak istediğimi söyledim .	söyledim	6	Sing
Beş dakika sonra sor , o da tek kelimesini söyleyemiyor .	söyleyemiyor	9	Sing
Boğuluyorum , perişanım , dedi .	Boğuluyorum	0	Sing
Albümleri geriye doğru çevirdim .	çevirdim	3	Sing
Gidelim , birlikte saldıralım .	saldıralım	3	Plur
o Köye dönüş projesi başlatılacak .	başlatılacak	4	Sing
Olmuyor , tekrarlayalım ...	Olmuyor	0	Sing
Onun yüzünün yarısı gülerken yarısı ağlardı .	gülerken	3	Sing
O parktan kurtulana pek rastlamadım .	kurtulana	2	Sing
PKK Ateş Açtı başlığı ise içerde kullanılmış .	kullanılmış	6	Sing
Ama yaşamdan duygularımızla zevk alırız .	alırız	4	Plur
Ömür Uzatma Kıraathanesi'nin kapısı güm güm vuruldu .	vuruldu	6	Sing
Biz sadece Milli Görüş tabanından değil , bütün kesimlerden oy aldık .	aldık	10	Plur
Halbuki arada gidip günah çıkardın mı , kendini bir miktar yırtmış hissediyorsun , temizlenmiş hissediyorsun , aynı haltı yiyeceğini bilsen bile bir güvencen var .	çıkardın	4	Sing
Oysa insan bir kez anımsamaya başlarsa gizlediklerini , beyninin içine giren kurt onu kemirir , yeni korkular , daha büyük , daha dehşetli korkular , en olmayacak düşünceler , günahlar , suçlar yaratır .	yaratır	32	Sing
Ama düşündüm ...	düşündüm	1	Sing
Küçük bir dalga , ayaklarını örtüp , geri çekilirken ayağının altındaki kumların da denize doğru kaydığını fark etti .	çekilirken	8	Sing
O haftayı iple çektiğimi dün gibi hatırlıyorum .	hatırlıyorum	6	Sing
Kaç kez denemişti ; iki türküden sonra balıkçılar , utangaç hallerinden sıyrılıp , tarihin değil , doğanın kendilerine verdiği niteliği yeğleyerek , masalarda oturan yabancı kadınlara göz süzmeye başlıyorlardı .	denemişti	2	Sing
maddeyi değerlendirmeye ağırlık vereceğiz .	vereceğiz	3	Plur
Esin de Özer de Uykudan Önce programı gibi dinlediler anlattıklarımı , bir yandan esniyorlardı bir yandan da gözleri sevinçle parlıyordu .	dinlediler	8	Plur
Kendini niye karıştırıyordu şimdi !	karıştırıyordu	2	Sing
Bu ülkelerde , günümüzde , bilim ve din , eşit bir muameleye tabi tutulmakta , her ikisinden de kendi alanları içinde kalmaları istenmektedir .	istenmektedir	22	Sing
Beş dakika sonra sor , o da tek kelimesini söyleyemiyor .	sor	3	Sing
Makinenin renkleri ve ışıkları yoruyor gözümü , dedim .	yoruyor	4	Sing
Çünkü , sanık sandalyesinde oturan darbecilerden birisi kalkıp dinleyici sıralarına parmağını uzatsa ve sorsa .	sorsa	13	Sing
paralel bağlanabiliyor ; ama bir trafik kazasında insanların paralel bağlanabileceğini ilk kez duyuyorum .	bağlanabiliyor	1	Sing
Yetmiyor , yine favori maddesine yöneliyor .	Yetmiyor	0	Sing
Bahçesi de , ağacı , çiçeği , tavuğuyla , ona göre biçim alıyordu .	alıyordu	12	Sing
Çay ocağının yanından , dar bir merdiven yukarıya çıkıyordu .	çıkıyordu	8	Sing
Mahmutla kadın birbirlerine sarılmışlardı .	sarılmışlardı	3	Plur
Materyalizm - idealizm karşıtlığı Bilimsel Devrim'in ilk dönemlerinde çok açıktır ve yaşamın tüm alanlarını kapsamaktadır .	kapsamaktadır	14	Sing
Kadın bir an uzaklara baktı .	baktı	4	Sing
Aynada kendimi çok beğendim .	beğendim	3	Sing
Bana değil de arkamda duran , dönüp baksam benim göremeyeceğim bir şeye , belki de bir aslana bakıyordu .	göremeyeceğim	9	Sing
Hadi lan , dedi Katana , sopa yiyeceğiz Naci Beyden .	yiyeceğiz	7	Plur
Özene bezene kurulan her eve eninde sonunda ölüm girer .	bezene	1	Sing
Anlarsın ya ...	Anlarsın	0	Sing
Yine de iyi çocuklarmış , seni eve kadar getirmiş .	getirmiş	8	Sing
Kalemlerin de flasterlerin de duruyor .	duruyor	4	Sing
Esra ile bu aralar medyada görünmeni istemiyorum " dedi .	istemiyorum	6	Sing
Bir de bir laf çıkarmışlar : Senin yaptığını , Çorumlu Çorumluya yapmaz .	yapmaz	11	Sing
Mahmut Beyi arıyordum ...	arıyordum	2	Sing
Oturup sigara yaktım , telaşe halimin geçmesini bekledim .	yaktım	2	Sing
Bak , kapı zorlanıyor .	zorlanıyor	3	Sing
Geceyarısından sonra biten işimden çıktığımda , o zamanların Beyoğlu'sunda varolan , kendine özgü , sabaha kadar açık kulüplere dadandım .	dadandım	18	Sing
Öbürleri de başlarıyla onayladılar .	onayladılar	3	Plur
DENİZ Akkaya , dün akşam saatlerinde karın ağrısı şikayeti nedeniyle Amerikan Hastanesi'ne kaldırıldı .	kaldırıldı	12	Sing
Yine de raporlara ulaşmanın bu kadar kolay olmayacağını biliyorlardı .	biliyorlardı	8	Plur
Sanki ona aşıkmışsın gibi anlattın .	anlattın	4	Sing
Başlığı bulunca rahatladım , krizden kurtuldum ...	rahatladım	2	Sing
O da , benim gibi , bir kente geldi mi , kentin en canlı yerini seçer , kahvelerin de tiryakisidir .	seçer	15	Sing
CHP milletvekilleri dün akşam Devlet Konukevi'nde düzenlenen kokteylle tanıştı .	tanıştı	8	Sing
Nefes nefese kalmıştım .	kalmıştım	2	Sing
Bu savların hepsinin yanlışlığı ( fallacies ) gösterilmiş , idealist dizgeler yadsınmıştır ( refuted ) .	yadsınmıştır	11	Sing
Demedik mi .	Demedik	0	Plur
Şimdi düşünüyorum da , galiba o parkın dışında yapamayacağım ben , dedi Kerem .	düşünüyorum	1	Sing
Ben anlamıyorum .	anlamıyorum	1	Sing
Bu yüzden , çaldığı iki ağır türkünün ardından yine kıvrak bir göbek dansına , ya da bir bozlağa geçer , balıkçılar oturmayacak olurlarsa , kaş göz işaretleri yaparak , masalarına gitmeleri gerektiğini anlatırdı .	olurlarsa	22	Plur
Fotokopileri dikkatle incelediklerinde gelen raporlarda kimi sayfaların eksik olduğunu gördüler .	gördüler	9	Plur
PKK Ateş Açtı başlığı ise içerde kullanılmış .	Açtı	2	Sing
Bebelerin toplantılarındaki üslubu özlemle anıyorum .	anıyorum	4	Sing
Kapıyı itiyorum , zorluyorum , tam biraz açılır gibi oluyor , gene kapanıyor .	zorluyorum	3	Sing
Onun yerine okula , ' Adını mezar taşına değil , okula yazdır ' pankartı asıldı .	asıldı	14	Sing
Notlar tuttular .	tuttular	1	Plur
Hepsi bir sepetin içindeydi ve benim görevim , tabi eğer bu köpeği istiyorsam , bunların hepsinin yerli yerinde durmasını sağlamaktı .	istiyorsam	12	Sing
elli milyon dolara bakmıyor , yüz bin dolara bakıyor .	bakıyor	8	Sing
Onların gürültülü neşesi , duyduğum yalnızlık duygularını azaltıyordu , ama neler konuştuklarını da anlamıyordum .	anlamıyordum	13	Sing
Nereye yönelsem arkamdan yetişiyordu , Sen kömür sobasını beceremezsin , yan odadan elektrikli zamazingoyu al , dolaptaki rakı çok soğuktur , en iyisi yattığım odanın aç kapısını , bak hemen kapının arkasında , kap gel ...	yetişiyordu	3	Sing
Aptallığıma şaşırdığını belli eden bir şekilde yüzünü buruşturdu .	buruşturdu	7	Sing
Onu tanıyorsunuz o zaman , dedi .	tanıyorsunuz	1	Plur
Acıyorum , içim sızlıyor o kadar .	Acıyorum	0	Sing
Memo elindeki yüz bin liraya şaşkınlıkla bakıyordu .	bakıyordu	6	Sing
Anneme sorsan hiç özlemediğini söyler ; ama bence herkes birbirini arıyor .	sorsan	1	Sing
Bunu yapmayanların yöneticileri şahsen sorumlu tutulacaklar .	yapmayanların	1	Plur
Gündüz ayrı iş , gece ayrı iş ; can mı dayanır , diye söylendi saatine bakarken .	dayanır	10	Sing
Hem süt emsin hem de biraz daha büyüsün . demişti .	emsin	2	Sing
Bila , " Sizinle ilgili izlenimlerimi yazacağım , isterseniz , bu söylediklerinizi de yazayım , ancak teypteki ifadenizi de yazmak zorundayım " karşılığını verdi .	yazayım	13	Sing
Oradaki , kalemdeki görevlilerin kaprisiyle de karşılaştık .	karşılaştık	6	Plur
Kemal , Günah çıkarma esprisine , bir çeşit yakıt alma gibi , yıkanıp temizlenme gibi , yüzeysel , hatta bazen köklü bir tamirat gibi yaklaşmalıyız , bunu kastediyorum , dedi .	yaklaşmalıyız	24	Plur
Ne ki , zamanla yoğun sıkıntıya yolaçtı , bana göre , tekdüze , coşkusuz , amaçsız yaşam ; depreşti , ölçüye sığmaz oldu içki bağımlılığım .	yolaçtı	6	Sing
İyi ki ordu sesini yükseltti , şimdi ne yapacaklar bakalım , deyip bekledik .	yapacaklar	8	Plur
Sesler değişse bile duyguların seslere kattığı tonlamalar değişmez , ne kadar saklamak isteseler de bunu beceremezler , bir köpekten kokularını saklayamayacakları gibi benden de seslerini saklayamazlardı .	saklayamazlardı	25	Plur
Kasabanın doğal mağaralarında mayalanmaya bırakılıyor .	bırakılıyor	4	Sing
Benim arkamda bir iz kalırsa , ben siyasette ilkeli , kararlı , cesur işler yaparsam benim için en doğrusu odur .	yaparsam	14	Sing
Madde kullanımı arttıkça acı eşiği de intihara , ölüme varana kadar yükseliyor .	yükseliyor	11	Sing
Kimseye zararı yoktu ha , yanlış anlama , bütün derdi kendinleydi .	derdi	9	Sing
Tersine , giderek yavaşlıyor ve durmaya yaklaşıyordu .	yaklaşıyordu	6	Sing
Arınç da " Kastımın Erbakan'la Erdoğan'ı aynı kefeye koymak olmadığını da yazarsanız sevinirim " karşılığını verdi .	yazarsanız	11	Plur
Kendi yaşam alanını güvence altında gören Papalık , bunun verdiği rahatlıkla , yakın geçmişte Darwin'le bile barışmakta bir beis görmemiştir .	görmemiştir	19	Sing
Kapıya yürüdüm , açtım .	yürüdüm	1	Sing
Olası Irak operasyonunda Türkiye'den taleplere ilişkin son kararın alınacağı MGK öncesinde Ankara'ya gelen ABD'nin iki bakan yardımcısı yirmi milyar dolarlık paket açacak .	açacak	21	Sing
Şimdi birini oradan oraya alarak tayin edeceksiniz , öbürünü açığa alacaksınız , öbürünü sorgulayacaksınız .	alacaksınız	10	Plur
' Telefonla görüşüyoruz ' .	görüşüyoruz	2	Plur
Kız pekmezi kaptığı gibi evine koşmuş .	koşmuş	5	Sing
Kadınlar ürünleri satın almadan önce inceliyor .	inceliyor	5	Sing
Bazı bilim adamları evrenin genişlemesini tanımlayan anda ortaya çıkan matematiksel tekilliği Tanrı sandılar ve Tanrı'nın evreni o noktada yarattığını düşündüler .	düşündüler	19	Plur
Planla Kıbrıs'ın Rumların denetimi altına verildiğini , nüfus aktarımının da Rumlar lehine gelişeceğini ifade eden Linn , " Bu da Kıbrıslı Türklerin kendi ülkelerinde bağımsızlıklarının sonu olacaktır " dedi .	olacaktır	26	Sing
Müşteri neyi sever ?	sever	2	Sing
Sonra birdenbire her şeyini verir bana .	verir	4	Sing
Kapı dışarıdan vuruluyor , hafifçe itiliyor , aralanıyor , yeniden kapanıyordu .	kapanıyordu	10	Sing
Niye bayılmış imam ?	bayılmış	1	Sing
Biraz hayal kırıklığına uğramıştım aslında .	uğramıştım	3	Sing
ABD'nin Ankara Büyükelçisi Robert ' , Irak konusunda barışçı çözümde ısrar edeceklerini ve sorunun savaşsız bitmesini arzu ettiklerini belirterek , " Saddam giderse savaş şartları ortadan kalkar " dedi .	kalkar	26	Sing
Bunu nasıl daha mümkün hale getiririz diye düşünürken Amerikalı şirket aleyhine bir dava açarak belgeleri , savcılığın soruşturma belgelerini Kara Kuvvetleri'nin müşterek kanaat raporuna konu olan belgeleri oraya getirtmek mümkün olur gibi bir fikir geldi aklımıza .	getiririz	5	Plur
Sevgilinin ışıksız pencerelerine uzaktan bakarken kalbim böyle küt küt atmamıştı .	bakarken	4	Sing
Onu rakıya ayırıyorum ) .	ayırıyorum	2	Sing
Bin yıl kadar sonra da Moğol kavimlerinin saldırısı ile bugün yaşadıkları bölgeleri yurt edindiler .	edindiler	13	Plur
Şimdi bu büyük korkunuzu yaşayacaksınız .	yaşayacaksınız	4	Plur
Yeniden , Ellerini masanın üstüne koy , dedim , sesimde kölesine emreden bir efendinin sesi vardı ve o benim kölemdi .	vardı	15	Sing
Yanına annesini de alan Şıkel , " Herkes beni zaten yanlış tanıyor , ne desem boş , inanılmaz derecede bunaldım .	desem	14	Sing
Onlar krizmalarıyla yaşıyorlar .	yaşıyorlar	2	Plur
Bak şimdi birdenbire aklıma geldi .	Bak	0	Sing
Okulun açılış törenine İstanbul Emniyet Müdürü Hasan Özdemir , İstanbul Milli Eğitim Müdürü Ömer Balıbey ve Yaşar Nuri Öztürk de katıldı .	katıldı	20	Sing
Ne kaybedersin .	kaybedersin	1	Sing
Kamu Personeli Seçme Sınavı Sistemini değiştireceklerini kaydeden Şahin , şimdiye kadar sınavı kazananların haklarının saklı tutulacağını , ancak bundan böyle her yıl ihtiyaç kadar alım için yeni sınavlar yapılacağını belirtti .	kazananların	12	Plur
Kalktım , sarıldım boynuna , zoraki öptürdü pembeliğini koruyan yanaklarını .	Kalktım	0	Sing
Koşup alaca boğayı öpmüş .	öpmüş	3	Sing
Bilimsel teori , bir yandan içinde oluştuğu toplumun kavramsal yapısıyla , yani ideolojisiyle sınırlıdır ; öte yandan kendi ürettiği kavramlarla o ideolojiyi etkiler .	etkiler	22	Sing
Beni terk etmekte olan sevgilimle buluşup yemek yiyecektim .	yiyecektim	7	Sing
Bilene rastlamadım .	rastlamadım	1	Sing
Yolculuk , başka bir kentte olmak , hep karşılaştığım yeni şeyler , derinden derine izini süren heyecan dirilik yaratmıştı bende .	yaratmıştı	18	Sing
Bir yere varamadık henüz , dedim .	varamadık	2	Plur
Yine sekizonikibindokuzyuzdoksansekiz tarihli bildirisinde yazarları şunları yazıyorlar : Kısacası , maddenin yoktan varolduğu gerçeği , bugün bilim dünyasında en yaygın olarak kabul gören teori olan big bang tarafından ortaya konmuştur .	yazıyorlar	6	Plur
Birçok kez eroinden kurtulmak için yurtdışında değişik hastanelerde yatmış ama her seferinde kendisinden daha bencil olan eroine dönmüştü .	yatmış	8	Sing
Kimseyi doldurmadık .	doldurmadık	1	Plur
Ama bir ihtimal var , değil mi ? Sırf sana olan kızgınlığımı birine anlatmam halinde üzerimden bir yük kalkar , gerilimim azalır , sana daha hoşgörülü yaklaşabilirim , daha bağışlayıcı olabilirim .	yaklaşabilirim	26	Sing
Ancak onun beyninde olduğum sürede varoluyorum .	varoluyorum	5	Sing
Önce Serpil Biriçim , sonra Fikret Bila Bey'i aradım ..	aradım	8	Sing
Halam nasıl böyle büyüklerine laf çakıştıran bir çocuk yetiştirir diye şaşakalmıştık .	yetiştirir	8	Sing
İki adım yürümüştüm ki , Ceza ! diye seslendi .	yürümüştüm	2	Sing
Oğlan pantolonunu , gömleğini giyinmiş , donunu kayığın üstüne sermişti .	giyinmiş	4	Sing
Üstelik mitolojilere inanmayan birisiyse , boşluk üzerinden akacaktır onun .	akacaktır	7	Sing
Hatta siz bile denmezdi .	denmezdi	3	Sing
Seni üzmekten korkuyorum .	korkuyorum	2	Sing
Kemal : Ama öbür yolu denemedin ki .	denemedin	5	Sing
Bak , kapı zorlanıyor .	Bak	0	Sing
Tahkikat doğru yapılmıştır , yeniden ortaya dökülmesi gerekmez şeklinde .	yapılmıştır	2	Sing
İncecik bacaklarını birbirinin üzerine atmıştı , geniş koltuğun üzerinde rahatça oturuyordu .	oturuyordu	10	Sing
FDR'nin altıyüzotuzdört sefer sayılı Konya uçağının tekerleklerinin , yaklaşma hattının soluna kaydığı , ancak kaptanın uçağı düzeltme manevrası yaparken sol ana iniş takımının tepeye çarptığı ve pist başına yakın bir noktada parçalandığı ileri sürüldü .	sürüldü	33	Sing
Bulutların ardındaki güneşin ışığı , donuk bir kuzey aydınlığı yaratıyor , bana Ulusal Müzedeki bazı resimleri düşündürtüyordu .	düşündürtüyordu	16	Sing
Avrupa'da ilk beş şirket arasına girmek için büyüme planları yapan Hablemitoğlu'nun , satın alma olasılığıyla Almanya'daki iki şirketi izliyor .	izliyor	18	Sing
Hülya kolumu tutmuştu .	tutmuştu	2	Sing
Ana'nın orada olmadığını söyledikten sonra ben , buna ne inanırmış , ne de inanmazmış gibi bir tavır takındım .	takındım	17	Sing
Keskin toplum eleştirisi , esprili ve zeki özeleştiri , bir çeşit kara mizah , bilgi düzeylerinin çok üstünde bir entelektüel performans onlarla tanışanları şaşırtır ve çarpar .	şaşırtır	23	Sing
Ben de o gece kardeşlerimin yatma saati gelene kadar uzun uzun köpeğimizi anlattım onlara , ne de olsa o artık evimizin köpeğiydi .	gelene	7	Sing
Taşhan'ın loş ışığında dikkatle bakmayınca pek fark edilmiyordu bu .	edilmiyordu	7	Sing
Zamanından önce programa başlamak zorunda kalan Saffet , baktı ki olacak gibi değil , türkünün ardından hemen kıvrak bir oyun havasına geçti .	baktı	8	Sing
Nesrin bize kızardı , falan , konu değişirdi .	değişirdi	7	Sing
O anlatmak istediklerimi nasıl anlatacağımı bilmiyorum .	bilmiyorum	5	Sing
Yaka paça indirdi .	indirdi	2	Sing
Tamam ! tamam ! Hadi çabuk anlat , meraktan öleceğim .	öleceğim	9	Sing
Bu önermelerin usa yatkın olmaları , nesnel gerçekliğin herhangi bir öğesiyle örtüşüyor veya benzeşiyor olması gerekmez .	benzeşiyor	13	Sing
Arabanın altına girip gebereceksiniz .	gebereceksiniz	3	Plur
Esin de Özer de Uykudan Önce programı gibi dinlediler anlattıklarımı , bir yandan esniyorlardı bir yandan da gözleri sevinçle parlıyordu .	parlıyordu	19	Sing
Bunları yazan Su olamaz diye geçirdim aklımdan .	geçirdim	5	Sing
İyi tanıyamadık onu .	tanıyamadık	1	Plur
Duyguları öldürme eşiği hücrelerinde kayıtlı olduğu için yerine başka bir şey koysa da o şeyi de had safhada kullanıyor .	kullanıyor	18	Sing
Arsel , daha önce Koç Holding'de Enerji ve Maden Grubu Başkanlığı yapmış , Dünya Kamhi Birliği Başkan Yardımcılığı görevine seçilmişti .	seçilmişti	19	Sing
Belgin Dorukları , Sadri Alışıkları , Kırık Hayatları ve Ölümsüz Aşkları , eski resimlerde yanımıza aldık , gidiyoruz .	gidiyoruz	17	Plur
Patlıcan , zeytinyağlı , sağyağlı , salata , turşu derken gerçekten 40'ı buluyor .	buluyor	12	Sing
Sen de fena değilsin .	değilsin	3	Sing
Eniştem emekli olduktan sonra döndüler Ankara'ya , yerleştiler dişlerinden tırnaklarından ayırdıkları paralarla güç bela edindikleri kooperatif evine .	yerleştiler	7	Plur
Dolayısıyla , bilimsel teorilerin bazı kavramları oluşturup kullanabilmeleri , toplumun ideolojik düzeyinin o kavramların ortaya çıkmasına elveren bir olgunluğa ulaşmış olmasını gerektirir .	ulaşmış	19	Sing
Türban konusunu da açan komutanlar , bu konuda Anayasa Mahkemesi'nin kararı ile Cumhurbaşkanı'nın yaptığı uyarıyı anımsatarak toplumu gerecek davranışlardan kaçınılması gerektiğini anlattılar .	anlattılar	21	Plur
Şahin , " BDDK istese de istemese de kamuda rahatlama için emekliliği gelenleri emekli etmeyi düşünüyoruz " dedi .	istemese	6	Sing
Kısmetse çarşamba günü İstanbul eğlence yaşamında buluşmak üzere hoşkalın , hep mutlu yaşayın .	hoşkalın	8	Plur
" Bu tanımla , örneğin Almanya'da şirket kuran vergisini Alman hükümetine ödeyen fakat Türk vatandaşı olan kimseler yerli ama Türkiye'de yıllardan beri yerleşik bulunan bizler yabancı oluyoruz " diyen ' , teknik bir hata olabileceğine dikkat çekti .	çekti	36	Sing
Beraberce korkunç bir sahne yarattık .	yarattık	4	Plur
Aydınlık yetkilileri ellerindeki kimi belgelerden , duyumlardan bahsettiler .	bahsettiler	7	Plur
Bir an önce dönmeliyim oraya .	dönmeliyim	3	Sing
Aileye damat olarak pancar da girdi .	girdi	5	Sing
Yerleştir yerleştirme , devşir devşirme sınavları falan filan yok ...	devşirme	4	Sing
Ben bir hizmet insanıyım , söylerim , söylediğimin arkasından giderim ve bana neye mal olursa olsun ben bununla iftihar ederim .	giderim	9	Sing
Biliyordum seveceklerini .	Biliyordum	0	Sing
Çünkü , sanık sandalyesinde oturan darbecilerden birisi kalkıp dinleyici sıralarına parmağını uzatsa ve sorsa .	uzatsa	11	Sing
Yürüdüğümüz yol bitmiş , bir başka sokağa açılmıştı .	açılmıştı	7	Sing
Çek şu albümü , şunu şunu , hani gidip gelip karıştırdığın , bilmem mi sanırsın , hah işte o albümü ver bakayım .	ver	20	Sing
Babam , Ali'nin annesi Nihan teyzeden kağıt kalem isteyerek yapmamız gerekenleri tüm ayrıntılarıyla yazdı .	gerekenleri	10	Plur
Ramiz yerine oturana dek de gözlüklerinin üstünden izledi .	oturana	2	Sing
Her şeyi anlattım mı dediniz .	dediniz	4	Plur
Beş bin askerinin harekatında pirinç ve ekmek stoku yapmıyor .	yapmıyor	8	Sing
Konduramadım , teşhirci değil .	Konduramadım	0	Sing
Siz mektubu hazırlayın , ben götürür veririm , dedim .	hazırlayın	2	Plur
Girdi içeriye .	Girdi	0	Sing
Dinleniyorum bu odada .	Dinleniyorum	0	Sing
Onların ölümünden habersiz olduğunu zannediyorum .	zannediyorum	4	Sing
Bazı bilim adamları evrenin genişlemesini tanımlayan anda ortaya çıkan matematiksel tekilliği Tanrı sandılar ve Tanrı'nın evreni o noktada yarattığını düşündüler .	sandılar	12	Plur
Döndü arkasını , burnunu siler gibi yapıyor .	Döndü	0	Sing
Daha önce nerede çalışıyordunuz .	çalışıyordunuz	3	Plur
Yok abi , beyin meyin her şey bitmişti .	bitmişti	7	Sing
Perakendecilikte araştırmaları ve metodoljik çalışmalarıyla tanınan Underhill , dünyada " Why We Buy : The Science of Shopping " ( Neden satın Alıyoruz : Alışveriş Bilimi ) adlı kitabıyla tanındı .	Alıyoruz	22	Plur
Bilimin bugün içinde bulunduğu konumu daha yakından çözümlemek ve geleceğe ilişkin bazı kestirimlerde bulunabilmek için , burada sözünü ettiğimiz ilişkilerin tarih içinde izlediği gelişme çizgisini ele almak istiyoruz .	istiyoruz	27	Plur
Artık birbirimizin sinyallerini çok iyi tanıyoruz .	tanıyoruz	5	Plur
- Sen yaptın , beni yalnız bıraktın , hep başkaları oldu hayatımızda .	bıraktın	6	Sing
Aniden kaybolup gidiverdi .	gidiverdi	2	Sing
Eline geçirdiği kişiyi kendi kölesi yapmayı çok iyi bilir ; eroin tacirleri gibi ...	bilir	8	Sing
İzleyiciler bu bakışın farkında olmasalar da , Recep kahrolur , darbukasına hırsla vurmaya , tempoyu hızlandırıp Saffet'i zorlamaya başlardı .	başlardı	18	Sing
Onun yerine okula , ' Adını mezar taşına değil , okula yazdır ' pankartı asıldı .	yazdır	11	Sing
Binlerce , onlarca , yüzlerce soru sorabilirdim daha .	sorabilirdim	6	Sing
Hiçbiri , hiçbirimize sürpriz olmadı ...	olmadı	4	Sing
Gelirlerinin bir bölümünü bütçeye aktaran kuruluşlara Kıyı Emniyeti ile TPAO da eklendi .	eklendi	11	Sing
Doğum günüm yaklaşıyor .	yaklaşıyor	2	Sing
Timur , uyuşturucu kullanırken etrafımda olan biten her şeyin benimle ilgili olduğunu sanıyordum .	kullanırken	3	Sing
Çıkar şu donunu , çıkar da pantolonunu öyle giy .	giy	8	Sing
Son iki saat , gitgide daralan bir ırmağın yatağında ilerledik .	ilerledik	9	Plur
Ben onu bir an önce eve getirmek istemiştim ama veteriner İki ay dolmadan annesinden ayırmayın .	ayırmayın	14	Plur
Olmaz olur mu ? Âşıkları , hayranları ...	Olmaz	0	Sing
Ama şimdi o anlatmak istediklerimi nasıl anlatacağımı bilmiyorum .	bilmiyorum	7	Sing
Erten'e , ne de bana ulaşmış değil .	ulaşmış	5	Sing
Ama verdikleri çekleri , ' Nakit ödeme yapacağız ' diye aldılar , beş parasız kaldım .	yapacağız	7	Plur
Verebildiniz mi mektubu ? diye sordu .	Verebildiniz	0	Plur
Oldular da ...	Oldular	0	Plur
Birbirimizi biliriz .	biliriz	1	Plur
Bana ne ! Yine de dayanamadım , ondan söz açmaya can atıyor belli .	dayanamadım	5	Sing
İnsanları ikiye ayırıyor annem ( sayacağı iki kalem de olsa mutlaka parmaklarını avucuna kapatarak sayacak ; birincisi yaşayanlar ( bunlar başkalarını da yaşatıyor ) , ikincisi yaşayanları seyredenler ( bunlar da başkalarının sırtına yük oluyorlar ) .	yaşatıyor	22	Sing
Bence yeterince değil , hiç araştırmadan haber yapılmış ; okurlar yanıltılmıştır .	yanıltılmıştır	10	Sing
Bizi kıyaslayan , karşılaştıranlar bilsinler ki ... Biz , yarışta değiliz .	bilsinler	4	Plur
İnanmıyorsanız , Türkiye'nin kentlerinde ve kasabalarında bir pazar günü sokağa çıkın .	İnanmıyorsanız	0	Plur
Sözgelimi Zeynep , hiç de sandığım gibi vurdumduymaz bir anne değilmiş .	değilmiş	10	Sing
Telli sazlar akord ediliyor .	ediliyor	3	Sing
Hiç kafasını yerden kaldırmıyor , hiçbir sempati belirtisi göstermiyordu .	göstermiyordu	8	Sing
Madem Suna istiyorsunuz , sırf Suna olsun diye az diretmemiştim , Söyledik ya , dedim , kulak asmadınız ki .	asmadınız	17	Plur
Yaptığı nice düşüncesizlikleri başına kakmak istemedim , şunun şurasında birlikte yaşamaya başlayalı ne kadar oldu , yaparsam küstahlık olur .	istemedim	5	Sing
Buraya uğra , bir kadeh içtikten sonra , kentin merkezine ineriz .	ineriz	10	Plur
Onu en iyi okullarda okuttum diyerek kendisini rahatlatma yollarını arıyordu .	arıyordu	9	Sing
Fakat bu muammayı sonunda çözdüm .	çözdüm	4	Sing
O sırada , iş dönüşü yorgun ve dalgın adımlarla geçip gidenlerden bir ikisinin gözleri takılır kenardakilere .	gidenlerden	10	Plur
Tamamen yaşayanları korumaya yönelik bir rapor hazırlandı , dedi .	yaşayanları	1	Plur
Bu yıl sonbahar serin geçiyor ! ..	geçiyor	4	Sing
Bir gazetecinin toplantı sonrasında " İnceleme elemanlarına ilişkin sözleriniz maliye müfettişleri üzerinde baskı yaratır mı ? " sorusu üzerine de Hamamcıoğlu şunları söyledi : .	yaratır	13	Sing
Her gün kırmızı Mersedesi bekleyeceğim , dedi Memo heyecanla .	bekleyeceğim	4	Sing
Başkanın verdiği davette cam gibi cilalanmış döşemeler üzerinde kayıp da kırdığım sol bacağım yüzünden her gün hastaneye gidip kadavra üzerindeki çalışmayı gözüm yemiyordu .	yemiyordu	22	Sing
Şimşek gibi atağa kalkar .	kalkar	3	Sing
Zor kurtuldum oradan .	kurtuldum	1	Sing
Annem bendeki bu ani değişime çok sevindi .	sevindi	6	Sing
Ama bir ihtimal var , değil mi ? Sırf sana olan kızgınlığımı birine anlatmam halinde üzerimden bir yük kalkar , gerilimim azalır , sana daha hoşgörülü yaklaşabilirim , daha bağışlayıcı olabilirim .	azalır	21	Sing
Tersine , giderek yavaşlıyor ve durmaya yaklaşıyordu .	yavaşlıyor	3	Sing
Poynter direktörü Bob Steele , " Bence ' biz intihar haberi hiç vermiyoruz ' düşüncesi de açıkça sorgulanmalı " diyor .	sorgulanmalı	17	Sing
Yürüdüğümüz yol bitmiş , daha dar bir sokak açılmıştı önümüzde .	açılmıştı	8	Sing
Ummadığı inandırıcı soğukkanlılığım , açığa vurmasına yaradı , umut beklentisini ...	yaradı	6	Sing
Onun Protestan fondamantalizmini bir yana bırakıyorum .	bırakıyorum	5	Sing
Heyecan adrenalini yükseltiyor , bu yaşamda kalma mücadelesi içinde adaleler daha da geriliyordu .	geriliyordu	12	Sing
Elini , rengi atmış kirli beyaz , uzun donunun içine soktu , orasına burasına yapışmış kumları temizledi .	temizledi	16	Sing
Damla damlatacağım .	damlatacağım	1	Sing
Tabii aralarındaki sınıf ve kültür uçurumunu bildiğinden övgülerinde onun kadar ileri gitmiyordu .	gitmiyordu	11	Sing
Kapı dışarıdan vuruluyor , hafifçe itiliyor , aralanıyor , yeniden kapanıyordu .	itiliyor	5	Sing
Aradığımı Buldum Sandım .	Sandım	2	Sing
Üniversiteyi bitirdikten sonra ilk girdiği şirketin müdürü delikanlıya yakın ilgi gösteriyor , baba ilgisi açlığı çeken delikanlı , çocuksu bir ben merkezcilikle müdürün ilgisini bir baba ilgisi olarak algılıyordu : Değerini bilen bir baba .	algılıyordu	28	Sing
Ben böyle fedakar , yufka yürekli , candan insan tanımadım .	tanımadım	9	Sing
yönetim kurulunun sayın üyeleri kendi aralarında paralel bağlanarak , bu düşünce deneyini acaba bilim dünyasına gerçek bir deney olarak sunabilirler mi ? ( ) .	sunabilirler	19	Plur
Zekametre yok ki ölçülsün .	ölçülsün	3	Sing
Halbuki arada gidip günah çıkardın mı , kendini bir miktar yırtmış hissediyorsun , temizlenmiş hissediyorsun , aynı haltı yiyeceğini bilsen bile bir güvencen var .	temizlenmiş	13	Sing
Yolu yarılamıştık neredeyse .	yarılamıştık	1	Plur
İzleyiciler bu bakışın farkında olmasalar da , Recep kahrolur , darbukasına hırsla vurmaya , tempoyu hızlandırıp Saffet'i zorlamaya başlardı .	vurmaya	12	Sing
oniki Aralık'a kadar çıkarılması beklenen AB uyum yasalarını içeren paketin çalışmaları dün gece tamamlandı .	tamamlandı	13	Sing
Güneş bulutların arkasından çıkmak istiyor , mat bir ışık olarak aydınlığını kentin üzerine vuruyordu .	vuruyordu	13	Sing
Esin'le Özer birbirlerine baktılar Özer Prensesi ben koruyacağım ! dedi , Esin de gülümseyerek odanın ortasında dönmeye başladı yeniden : Ben bir prensesim , ben bizim evin prensesiyim . diye mırıldanarak .	baktılar	3	Plur
İzlenimlerini ertesi sabah , duru gün ışığında kaleme alması daha sağlıklı olacaktı .	olacaktı	11	Sing
Örneğin matematikte yüzyıllara dayanmış ve matematiğin gelişmesinde itici güç rolü oynamış kestirimlerin yakın geçmişte kanıtlanmış olması , bazıları tarafından matematiğin altın çağını yaşadığının bir göstergesi olarak kabul ediliyor .	kanıtlanmış	14	Sing
Bir an kafamda bir şimşek çaktı Bu evde iki tane prense ihtiyacımız var , prensesi ve evimizi koruyabilmek için dedim .	çaktı	5	Sing
Ona , Seni çok sevdiğim için seninle olamazdım , sana duyduğum sevgi çok korkuttu beni , diyemezdim .	olamazdım	7	Sing
Hayatım bir gezginin hayatına dönüşeli , bunu artık hemen anlıyorum .	anlıyorum	9	Sing
Dalgınlığıma geldi ya da üşendim , sapmadım ara yola ...	sapmadım	6	Sing
Biz kızlar Gülce'nin önerisine oy vereceğiz .	vereceğiz	5	Plur
Niye susmuştunuz ben dönüp baktığımda ! ?	susmuştunuz	1	Plur
on günde bir Diyarbakır'a giderdi .	giderdi	4	Sing
Hiç anlamasalar da , hiç bilmeseler de , hiç ilgilenmeseler de , neden , kadınlar bütün erkeklerin iş hayatlarını pürdikkat dinlerler .	anlamasalar	1	Plur
Giderdik konserlere , tiyatrolara , sinemalara .	Giderdik	0	Plur
Yok , onamıyorlarsa , bu yazının geri kalan satırlarını okumaları gerekmiyor .	onamıyorlarsa	2	Plur
Ben de mutlaka tenis öğreneceğim .	öğreneceğim	4	Sing
Geliyoruz , diyerek geldiler .	Geliyoruz	0	Plur
Ezberlediği bir kaç cümleyi robot gibi tekrarlıyordu ; Bayan lütfen bir flaster alın .	tekrarlıyordu	6	Sing
Pay çıkaracaksın kendine .	çıkaracaksın	1	Sing
Bir de bir laf çıkarmışlar : Senin yaptığını , Çorumlu Çorumluya yapmaz .	çıkarmışlar	4	Plur
Hatta aramızda birbirimize söz de verdik , ölmek var dönmek yok diye .	verdik	5	Plur
the , " Irak'ta muhtemel bir çatışmanın Türkiye ekonomisi üzerindeki etkilerini görüşeceğiz .	görüşeceğiz	11	Plur
Öğretmenim , babam tarlada çalışıyordu ...	çalışıyordu	4	Sing
Eller havaya dediler .	dediler	2	Plur
Uzak uzak ülkelerden birinde fakir bir anne ve kızı yaşarmış .	yaşarmış	9	Sing
Kızardı yanakları .	Kızardı	0	Sing
KOBİ'ler finansal yeniden yapılandırma programından yararlansın , Halkbank KOBİ bankası olsun .	yararlansın	5	Sing
Diyarbakır'da yaşanan uçak kazasında yaşamlarını yitiren insanların yolcu sorumluluk sigorta tazminatları yaş , eğitim , gelir düzeyi ve sosyal statüko gibi özelliklere göre belirlenecek .	belirlenecek	23	Sing
onsekiz havaalanında ILS bulunmuyor .	bulunmuyor	3	Sing
Tam o sırada Hülya birisiyle gelebilir ve beni görebilir diye ...	gelebilir	5	Sing
Şimdi varırız oraya , dedi Kerem .	varırız	1	Plur
Paketin salı günkü Bakanlar Kurulu toplantısında ele alınacağını ifade eden IMF , " Aynı gün ' sevk etmeye çalışacağız " dedi .	çalışacağız	18	Plur
Hadi biraz daha ileri gidelim .	gidelim	4	Plur
Bana ne ! Yine de dayanamadım , ondan söz açmaya can atıyor belli .	atıyor	11	Sing
Ne derece başarılı oldular ?	oldular	3	Plur
Senaryolar çıkışı zorlayabilir .	zorlayabilir	2	Sing
Dün gece diskoda unutmuşsun .	unutmuşsun	3	Sing
Kokteyle CHP Genel Başkanı Deniz Baykal ile çok sayıda partili katıldı .	katıldı	10	Sing
Az kalsın kaçırıyordum ağzımdan .	kalsın	1	Sing
Şimdi hiçbir şeye yaramadıklarını düşünsem de , yaşayabilmek için yazmak ! Böylece , o beklemekle , aramakla , bütün bu zaman parçalarını dolduracak olan boşlukla ve sıkıntıyla dolu yaşam çizgimi belirledim sanıyorum .	düşünsem	4	Sing
" Bu sözleri ağlayarak dinleyen Özmen , programında çalışması için Ciguli'ye teklifte bulununca o da seve seve kabul etti .	seve	16	Sing
Evlenseydiniz , bak nasıl üstüne titrer , çekip çevirirdi seni .	Evlenseydiniz	0	Plur
Yerleştir yerleştirme , devşir devşirme sınavları falan filan yok ...	Yerleştir	0	Sing
Onların gürültülü neşesi , duyduğum yalnızlık duygularını azaltıyordu , ama neler konuştuklarını da anlamıyordum .	azaltıyordu	7	Sing
- Evet , meslektaş sayılırız .	sayılırız	4	Plur
Diz çök karşısında , okşa saçlarını , özür dile , bağış dile , ne dilersen dile it herif , ağla hatta elinden geliyorsa ...	dile	11	Sing
Bir köpeğin bütün kokuları birbirinden ayırdedip insanların duygularını kokularından anlamaları gibi kadınların sesini tanırdım , her tonunu bilirdim , yalnızca kulaklarımla değil bütün vücudumla duyardım onların sesini .	duyardım	24	Sing
Pikabı vardı .	vardı	1	Sing
Bu süreç de , bir ürünün somut ve öznel niteliklerinden sıyrılıp , kendisine soyut ve nesnel bir nicelik yüklenmesiyle gerçekleştirilir .	gerçekleştirilir	19	Sing
Bu nedenlerle uçağın yerde buzlanma şartları altında olmadığı kıymetlendirilmiştir deniyordu .	kıymetlendirilmiştir	8	Sing
Onlara hiç anlamıyorlarmış gibi gelirken birden en can alıcı soruyu , nasıl olup da bulup sorabilirler .	gelirken	4	Sing
Bizi kıyaslayan , karşılaştıranlar bilsinler ki ... Biz , yarışta değiliz .	karşılaştıranlar	3	Plur
Ramiz de , Katana da her şeyin bittiğini anladılar .	anladılar	8	Plur
Yaşamı çekilmez hale getiriyorsunuz .	getiriyorsunuz	3	Plur
Gerilip gerilip atladılar .	atladılar	2	Plur
Bunlar olup biterken küçük sarışın çocuk , kucağında , bacaklarının arasına sıkıştırdığı darbukaya sol eliyle hiç ses çıkarmadan , okşarcasına vuruyor , sağ eliyle de tabağındakileri ağzına tıkıştırıyordu .	biterken	2	Sing
Kardeşinin eşiyle birlikte Bismil Oğuzlar Köyü İlköğretim Okulu'nda görev yaptığını anlatan ağabey Mehmet Karamutlu , " Gerçeği ona nasıl söyleriz bilmiyorum .	bilmiyorum	20	Sing
Konuşmayı biraz uzatır , işlerin yoğunluğundan filan söz edersiniz .	edersiniz	8	Plur
Yine cevap vermesine fırsat bırakmadan , Bir erkek gibi değil yani , erkekler yalnızca sevişebilmek için yalan söyleyebilir , ama seviştikten sonra sevebilir , bundan sonra ise yalan söylemez .	söylemez	28	Sing
binyediyüzotuzdört yılında Cloyne bişopu olan bu filozof - din adamının özdeğin varlığına karşı geliştirdiği savlar , The Dialogues of Hylas and Philonous adlı kitapta yayınlanmıştır .	yayınlanmıştır	24	Sing
Buna karşılık ben de onun mutsuzluk oyununu oynamadım .	oynamadım	7	Sing
Ama gerçeklerden ne yarar gördüm ki ? derken yaşanmamış bir hayatın acı kıvılcımları , donuk gözlerinde çakıyor .	çakıyor	16	Sing
Evlilik aşkı desek ! ..	desek	2	Plur
Dışarının parlak güneş ışığını yansıtarak çoğaltan beyazından bir anda karanlığın içinde bulduk kendimizi .	bulduk	11	Plur
Ne soracağımı anlamıştı , sor , dedi gönülsüzce .	anlamıştı	2	Sing
Oğlunuza aldığınız o kitabın arkasını okurken , kendinize , gerçek korkularınızı sordunuz , anımsayın .	anımsayın	13	Plur
Nereden biliyorsunuz ? diye sordu .	biliyorsunuz	1	Plur
Naci Bey elini masaya öyle bir vurdu ki , ön sırada oturan kızlar hii diye bağırıp yerlerinden sıçradılar .	sıçradılar	17	Plur
Kampın kasabaya yakın olmasının avantajından masadaki çilek reçelini tadarak yararlanıyoruz .	yararlanıyoruz	9	Plur
Ben susmuyordum : Hayır ! Hayır ! Tavandan üstüme kan damlıyordu .	susmuyordum	1	Sing
Ayrılıkların hüzünleriyle yeni birlikteliklerin neşesi birbirine karışıyor , aynı günde birkaç duyguyu bir - iki saat arayla yaşıyordum .	yaşıyordum	17	Sing
Hangi aday kazanırsa kazansın birlikte mücadeleyi sürdüreceklerini ifade eden Çelebi , ANAP'ı ayağa kaldırmak için hep birlikte çaba harcayacaklarını söyledi .	kazanırsa	2	Sing
" Sizin SUV aracınız , ülkenin milli güvenliği için ne yapıyor ? " .	yapıyor	10	Sing
Evlerde ise tıpkı dünkü gibi eşyalar , kürkler çuvallara dolduruluyordu .	dolduruluyordu	9	Sing
Değil mi ağabeyisi ? dedi bana dönerek .	Değil	0	Sing
Eğer sözünü ettiğiniz şey virtual parçacıklarsa ( aşağıdaki satırlarda Verschuur'dan yapılan alıntıya bakınız ) durum hala inandırıcı olmaktan uzak demektir .	bakınız	12	Plur
NA olgun bir kişiliğin göstergesi olan sabrı da öğretiyor .	öğretiyor	8	Sing
Gazetecilere uçak havada yanarak geldi yere çakıldı diyen tanıklar , anket heyetinin hazırladığı raporlara göre , farklı konuşmuşlardı .	konuşmuşlardı	17	Plur
Buna göre bakanlık soruşturmayı yenileyebilirdi .	yenileyebilirdi	4	Sing
Giriyorum içeriye , dedim .	Giriyorum	0	Sing
Adam kızın annesini görür görmez kadının güzelliğine vurulmuş .	görmez	4	Sing
Ödümü kopardın .	kopardın	1	Sing
Timur , Artık kendi yalnızlığımda tutunacak dal kalmamıştı , ruhsal çöküntümün önüne geçemiyordum , madde bana başlangıçta ihtiyacım olan şeyleri verdi : deliğimi kapattı , eksikliğimi giderdi .	kapattı	23	Sing
Bu durum aykırı da gelse , bir olgudur ve hem iyi , hem de kötü bir durumdur .	gelse	4	Sing
Şangır ! Oldu işte , battı ortalık .	Oldu	2	Sing
Çok isabet buyurdunuz .	buyurdunuz	2	Plur
Bunun üzerine askeri savcılıktan bir defa daha talepte bulunup Ankara Asliye Hukuk mahkemesindeki davanın selahiyeti açısından raporları eksiksiz görmek istediklerini belirttiler .	belirttiler	20	Plur
Ancak big bang yanlıları genellikle böyle bir davranış sergileyemiyorlar .	sergileyemiyorlar	8	Plur
Rakı sofrasının öz evlatları yeşillikleri unutmayalım .	unutmayalım	5	Plur
Ona yetişebilmek için peşinden koşuyordum .	koşuyordum	4	Sing
Lezzetini de kaybetmez .	kaybetmez	2	Sing
Neden yeni alternatifler üretilemedi .	üretilemedi	3	Sing
yüz bin dolarlık Rusya'ya yaptığı ihracatın alıcısı bulunamıyor .	bulunamıyor	7	Sing
Toplantılarda herkes açık kalple konuşuyordu .	konuşuyordu	4	Sing
Bu komisyonlar , arazilerini satın almak için köylülere sunulacak fiyat teklifini belirlemede söz sahibi olacaklar .	olacaklar	14	Plur
O ara kapı yeniden tıkladı .	tıkladı	4	Sing
Mektubun beni şaşırttı .	şaşırttı	2	Sing
Heyecanlı ve yorgun görünüyorsunuz , dedi .	görünüyorsunuz	3	Plur
Tuhaf bir kadın , diye mırıldandım .	mırıldandım	5	Sing
Aklınıza şöyle bir soru gelebilir .	gelebilir	4	Sing
Laf uzamış , saat biri geçmişti .	uzamış	1	Sing
Allah rahmet eylesin , dediler , büyük adamdı .	eylesin	2	Sing
Söyleniyor kendi kendine .	Söyleniyor	0	Sing
Benim , açın kapıyı .	açın	2	Plur
ya da belki ben böyle bir vaziyeti görürüm diye , bilemiyorum ...	görürüm	7	Sing
içine alır , besler , büyütür , korur .	alır	1	Sing
Sana açmayacağıma söz vermiştim ...	vermiştim	3	Sing
Mekan da bir deniz kenarı olmalıydı .	olmalıydı	5	Sing
Soğuk iklimi severler .	severler	2	Plur
Oğlunuza aldığınız o kitabın arkasını okurken , kendinize , gerçek korkularınızı sordunuz , anımsayın .	sordunuz	11	Plur
Kadın bakmış ev konak gibi koskocaman , ambarları yiyecek dolu , bağlarda üzümler salkım salkım , ineklerin memelerinden süt damlıyor .	damlıyor	19	Sing
Cinsel çekim ... diye mırıldandı adam .	mırıldandı	4	Sing
Hesap uzmanları hazırladı .	hazırladı	2	Sing
Adam kızın annesini görür görmez kadının güzelliğine vurulmuş .	vurulmuş	7	Sing
Dönüp gülümsedi , bu işe bir son ver demek istiyordu .	istiyordu	9	Sing
Merdiveni geri çıkarken başımı Hülya'nın sırtına yasladım .	çıkarken	2	Sing
ikibiniki sonu itibariyle tamamlanmayan projelere ikibinüç'te harcama yapılmayacak .	yapılmayacak	7	Sing
Yasal Valium , Diazem gibi haplardan eroine geçenler arasında beni en çok şaşkınlığa düşüren kişi , yetmiş yaşlarında şık giyimli bir kadın oldu .	geçenler	7	Plur
Yüzüme bakıp dudaklarını büzdü .	büzdü	3	Sing
Sezonu kapamakta inatçı bir genç sürat motoruyla göremediğim birine fiyakalar yapıyordu daireler çizerek .	kapamakta	1	Sing
Prensin adamları doğru gidip zalim üvey babayı tutuklamış .	tutuklamış	7	Sing
Örneğin matematikte yüzyıllara dayanmış ve matematiğin gelişmesinde itici güç rolü oynamış kestirimlerin yakın geçmişte kanıtlanmış olması , bazıları tarafından matematiğin altın çağını yaşadığının bir göstergesi olarak kabul ediliyor .	ediliyor	27	Sing
Yoksa cuk otururdu : Milliyetçi Cephe Başkanı ! Başka bir yakıştırma : Martaval Cumburlop Balabanı .	otururdu	2	Sing
Bazen şarkı söylerken de olur bu , arkadaşlar bilir ( arkadaşlar , yani bıyıklarına ak düşmüş emekli sarhoşlar gözlerini yumup başlarını hafifçe eğerek onaylıyorlar ) okursa hüzzam okur , herkesi kahırlandırır .	bilir	8	Sing
Kaç kez denemişti ; iki türküden sonra balıkçılar , utangaç hallerinden sıyrılıp , tarihin değil , doğanın kendilerine verdiği niteliği yeğleyerek , masalarda oturan yabancı kadınlara göz süzmeye başlıyorlardı .	başlıyorlardı	28	Plur
ikibin yılı , Bilim ve Ütopya ailesine , toplumumuza ve tüm insanlığa mutluluklar ve başarılar getirsin .	getirsin	15	Sing
Türkiye savaş alanlarında değil , kelimelerle yürütülen mücadelelerde kaybediyor .	kaybediyor	8	Sing
CHP desteğini sürdürdü , vetolu yasa yine Köşk'e gitti .	sürdürdü	2	Sing
Gerçek parçacıklar Geiger sayıcılarında click sesi üretirler .	üretirler	6	Plur
Kapıya yakın bir masada oturuyordu .	oturuyordu	4	Sing
Ben her sabah yürüyorum .	yürüyorum	3	Sing
Yok , onamıyorlarsa , bu yazının geri kalan satırlarını okumaları gerekmiyor .	gerekmiyor	10	Sing
Soruları sürekli tekrarladığınızı fark etseler bile utangaç ifadelerini bir kenara bırakıp sinirlenmez , sıkıldıklarını belli etmezler .	etmezler	15	Plur
yüzyılda bilimin gelişimini genel hatlarıyla betimlemek istersek , şu iki görüngüyü temel almamız gerekir : Birincisi , bu yüzyıl Bilimsel Devrim'in son atılımlarının gerçekleştiği yüzyıl olmuştur .	istersek	6	Plur
Kemal : Bakın , bu ideolojik bir kavrayıştır , aynı zamanda .	Bakın	2	Plur
Etrafımızdaki izleri sordum : Siegen diye yanıtladı .	yanıtladı	6	Sing
Sesler değişse bile duyguların seslere kattığı tonlamalar değişmez , ne kadar saklamak isteseler de bunu beceremezler , bir köpekten kokularını saklayamayacakları gibi benden de seslerini saklayamazlardı .	değişmez	7	Sing
Buyur etmişler .	etmişler	1	Plur
Bir ara babanızla annenizin ayrılacağından korktunuz .	korktunuz	5	Plur
Sınıfta en arka sırada otururdu Ramiz .	otururdu	4	Sing
Gitmeliyim , kalkıp gitmeliyim .	gitmeliyim	3	Sing
Ben yavrumdan nasıl ayrılırım ? Onu nerelere gönderirim ? diye adamın ayaklarına kapanmış zavallı kadın .	gönderirim	7	Sing
Kocacığım ! El sallardım işine giderken balkondan ...	sallardım	3	Sing
Kumru sabah akşam sarılıyormuş telefona .	sarılıyormuş	3	Sing
Kitabı çıktığı dönemde bazı yayın organları Underhill'i " Perakendecilerin Sherlock Holmes'ü " diye tanımladılar .	tanımladılar	13	Plur
Yüksek Seçim Kurulu'nun ( Taylor ) bu seçimi iptal etmesinin ardından dosya Adalet Bakanlığı kanalıyla Yargıtay'a yeniden iletildi .	iletildi	17	Sing
Oysa tebligat yapılmamıştı .	yapılmamıştı	2	Sing
Zamanı geldiğinde Saffet ile Recep sahnede yerlerini aldılar .	aldılar	7	Plur
Ne soracağımı anlamıştı , sor , dedi gönülsüzce .	sor	4	Sing
Kalmayız , dedi , koşa koşa gideriz , erikleri de senin heybene doldururuz .	gideriz	6	Plur
Zaten kendileri duygularını tanımadıklarını söylüyorlar .	söylüyorlar	4	Plur
Bana sarılmış .	sarılmış	1	Sing
Adam , argoyla karışık da olsa - ki bu , sınıfını gizlemediğini gösterdiğinden bir erdem sayılabilirdi - Necmi Bey'i aratmayan güzel cümleler kurabiliyordu .	kurabiliyordu	22	Sing
Yağla soğanla tencere içine kapatılmaz .	kapatılmaz	4	Sing
yirmi milyar dolarlık paketle geliyorlar .	geliyorlar	4	Plur
Çin'e tanıtım için altıyüz bin dolarlık bütçe ayırdıklarını söyleyen Akşit , " Çince seksen bin broşür bastırdık .	bastırdık	16	Plur
Yavaşça yanına yaklaştım .	yaklaştım	2	Sing
Bakın bu olabilir , dedi acıyla .	Bakın	0	Plur
Bu tevazuyu gerektiriyor .	gerektiriyor	2	Sing
Zeynep merak ve endişeyle kardeşine baktı : Orhan sen benden bir şeyler gizliyorsun ?	gizliyorsun	12	Sing
Ecevit partisinin bakanlarıyla protokolün bir tarafında otururken , diğer tarafta CHP'liler yer aldı .	otururken	6	Sing
Ama , hafiften titreyen sesi öyle etkiliydi ki , kendimi tutamadım , ağlamaya başladım .	başladım	13	Sing
Eylemde , " ABD kuklası iktidar istemiyoruz " yazılı pankart ve kırmızı boyalarla vampir çağrışımı yaratılan ABD Başkanı George Bush'un resimleri dikkat çekti .	istemiyoruz	6	Plur
Tayyip Erdoğan'ın yanında , onun yanlışlarına ortak olsaydım kesinlikle bu noktalarda bulunmazdım " sözünün Milliyet tarafından farklı yansıtıldığını öne sürdü .	bulunmazdım	11	Sing
babasına yemek götürdük , dedi Katana duyulur duyulmaz bir sesle .	götürdük	2	Plur
Konuya ilişkin ücretli işçi ile kapitalist arasındaki ilişki ne ise , kiracı ile evsahibi arasındaki ilişki de odur yargısını yıllar önce , Friedrich Engels şöyle eleştirmiş .	eleştirmiş	25	Sing
Her bakımdan ikna etmek konusunda titiz davranırsanız , karlılığınız garanti altına girer .	davranırsanız	6	Plur
Şimdi bir süredir nereye baksam Tibet'in gözlerini görüyorum .	görüyorum	7	Sing
Dönüp gülümsedi , bu işe bir son ver demek istiyordu .	gülümsedi	1	Sing
Hülya için seviniyordum .	seviniyordum	2	Sing
Geçmek bilmedi sanki .	bilmedi	1	Sing
Hiç satamadım Memo , bugün işler kesat .	satamadım	1	Sing
Kabuğunu bile korumuştur .	korumuştur	2	Sing
Aslında o anda bana kendi fikrini söylemişti ama bu genel bir düşünce tarzıydı .	söylemişti	6	Sing
Üstüne karabiber koyarlar .	koyarlar	2	Plur
Buraya uğra , bir kadeh içtikten sonra , kentin merkezine ineriz .	uğra	1	Sing
Damarlarına bir sıcaklık yayılmıştı .	yayılmıştı	3	Sing
Tamam , geliyorum .	geliyorum	2	Sing
Erkek öğretmen daha sert olur , kızlarla anlaşamaz diye düşünüyorum .	düşünüyorum	9	Sing
Sebze yeşil demek dedik .	dedik	3	Plur
O alanda doğruyu bulmuş olan bilim dalı daha fazla ilerleyemez ; son bilgiye ulaşmıştır , kapalıdır ; yeni bilgilere , olaylara , süreçlere yer yoktur .	ulaşmıştır	13	Sing
Karl Popper'ın geliştirmiş olduğu yanlışlanabilirlik ilkesi materyalist felsefenin yadsımanın yadsıması ilkesini andırmaktadır .	andırmaktadır	11	Sing
Bu dosyayı Milli Savunma Bakanlığı'na iletmelisiniz .	iletmelisiniz	5	Plur
( Hızlı ve kolay kazanılmış parayı tüketmek için aşırı bir enerji harcıyor ; para sayesinde istedikleri her şeyi yapabileceklerini sanıyorlar .	sanıyorlar	19	Plur
Çok alışmıştım Kahve'ye belki vazgeçersin almaktan , annem de alıştığı için kalır diyordum kendi kendime .	diyordum	12	Sing
Durum böyle olsaydı , ona şu kentin en canlı yeri olan alandaki kahvelerden birinde rastlardım şimdiye kadar .	rastlardım	14	Sing
Orhan kuşkuyla : Ağzımdan laf almaya çalışıyorsun değil mi ? Sonra da anneme babama yetiştir , dedi sinirli sinirli .	çalışıyorsun	6	Sing
Onun bir çocuk olmadığını , takındığı çocuksu tavırların aslında bir maske olduğunu bir tek ben biliyordum .	biliyordum	15	Sing
Bonnor : Fiziksel bir süreci betimlemeye çalışan matematiksel bir modelde ortaya çıkan tekillik genellikle kuramın çöktüğüne işaret eder .	eder	17	Sing
Kendinizi bir bağımlılıktan kurtarıp buraya geldiniz .	geldiniz	5	Plur
O , kendi açlığıyla oğlunu sevgiye boğduğunu bilmiyordu .	bilmiyordu	7	Sing
Sesler değişse bile duyguların seslere kattığı tonlamalar değişmez , ne kadar saklamak isteseler de bunu beceremezler , bir köpekten kokularını saklayamayacakları gibi benden de seslerini saklayamazlardı .	isteseler	12	Plur
Uçucu bir bulutçuk ağdı , sararmışlığıma , tuttum biteğini .	tuttum	7	Sing
Gel , dedim Celal'e .	Gel	0	Sing
Bir kuramı oluştururken kullanılan ilk ilkelerin , hipotezlerin gözlemlerden türetilmiş olması istenen bir durumdur .	türetilmiş	9	Sing
Siz dükkandan çıkıp onların arasına gireceksiniz ve yürümeye başlayacaksınız .	başlayacaksınız	8	Plur
Ayla , E , tamiratsa Celal yapıverir , dedi .	yapıverir	6	Sing
Durun , oturun biraz .	oturun	2	Plur
Keşke bu şalı ona armağan etseydim .	etseydim	5	Sing
Akgündüz'ün fezlekesi , davanın ağır ceza mahkemelerinin kapsamına girmesi nedeniyle , bünyesinde ağır ceza mahkemesi bulunan Bakırköy Adliyesi'ne gönderilecek .	gönderilecek	18	Sing
Yanında oturan annesinin , ağzına zorla tıkıştırdığı lokmayı bir hamlede yuttu ; parmakları darbukanın derisini okşadı ; başını çevirip , arkası dönük oturduğu sahneye baktı .	baktı	24	Sing
Ne derdik .	derdik	1	Plur
Güneş batarken ve eylül rüzgarları kuruyan otların üstünde belli belirsiz gezinirken buluşmalıydınız .	buluşmalıydınız	11	Plur
Bilim tarihinde , çok uzun ve zahmetli bir kolektif sürecin ürünü olan mantığı saymazsak , iki önemli teorik atılım dönemi vardır .	saymazsak	13	Plur
Yaz nasıl içinden geliyorsa .	Yaz	0	Sing
Şunu niçin düşünmüyorsun , diye başladı Hülya yeniden , bu insanların hemen hepsi çeşitli zamanlarda özel birtakım konularını seninle konuşurlar , sana danışırlar , senin söyleyeceklerine önem vermeye hazırdırlar .	konuşurlar	19	Plur
Görürüz bakalım , yarın o arabayı kim silecek , diye tehditler savurarak uzaklaştı diğer siliciler .	silecek	7	Sing
Ama verdikleri çekleri , ' Nakit ödeme yapacağız ' diye aldılar , beş parasız kaldım .	aldılar	10	Plur
Yanında oturan annesinin , ağzına zorla tıkıştırdığı lokmayı bir hamlede yuttu ; parmakları darbukanın derisini okşadı ; başını çevirip , arkası dönük oturduğu sahneye baktı .	okşadı	15	Sing
Allahım üveylerden beni koru .	koru	3	Sing
Üniversitelerdeki bilimsel çalışmalar maddenin yoktan varolduğunu ispatlarken , yoktan varetme kavramını üniversitelerin dışında tutma arayışı bilimdışı bir tavırdır ...	ispatlarken	6	Sing
Zamanından önce programa başlamak zorunda kalan Saffet , baktı ki olacak gibi değil , türkünün ardından hemen kıvrak bir oyun havasına geçti .	geçti	21	Sing
Anne , ne olur , ses çıkartmadan çalayım , içine kazağımı tıkarım , diye yalvardı çocuk .	yalvardı	14	Sing
Birbirimize bakarız .	bakarız	1	Plur
Ben yavrumdan nasıl ayrılırım ? Onu nerelere gönderirim ? diye adamın ayaklarına kapanmış zavallı kadın .	ayrılırım	3	Sing
Cami avlusundan koşarak çıktılar .	çıktılar	3	Plur
İyice kollarız , dedi Katana , yoksa dalarız .	kollarız	1	Plur
Perakende ortamı da bu karakteristiklere göre uyarlanmalıdır .	uyarlanmalıdır	6	Sing
Gidenin arkasından ağlayan partililer , gelecek başkan adaylarıyla da dirsek temasına geçti .	geçti	11	Sing
O parktan kurtulana pek rastlamadım .	rastlamadım	4	Sing
Onu tanıyanlar Bakırköy'de en yatmayacak insan diye tanımlıyor .	tanımlıyor	7	Sing
Şimdi birini oradan oraya alarak tayin edeceksiniz , öbürünü açığa alacaksınız , öbürünü sorgulayacaksınız .	sorgulayacaksınız	13	Plur
İstanbul , Ankara , İzmir , Antalya , Dalaman , Adana , Trabzon , Bodrum Milas , Bursa'da ' bulunuyor .	bulunuyor	19	Sing
Bir yudum içki , bir nefes sigaradan sonra anlatmaya başlıyor .	başlıyor	9	Sing
Onlara hiç anlamıyorlarmış gibi gelirken birden en can alıcı soruyu , nasıl olup da bulup sorabilirler .	anlamıyorlarmış	2	Plur
Sesler değişse bile duyguların seslere kattığı tonlamalar değişmez , ne kadar saklamak isteseler de bunu beceremezler , bir köpekten kokularını saklayamayacakları gibi benden de seslerini saklayamazlardı .	değişse	1	Sing
Bir an durdum .	durdum	2	Sing
Böyle durumlarda Saffet , Recep'in yüzüne küçümsemeyle bakardı .	bakardı	7	Sing
Şimdi bir süredir nereye baksam Tibet'in gözlerini görüyorum .	baksam	4	Sing
Ben onu bir an önce eve getirmek istemiştim ama veteriner İki ay dolmadan annesinden ayırmayın .	istemiştim	7	Sing
Hiçbir şey , hiçbir şey anlatamadım .	anlatamadım	5	Sing
Bulutların ardındaki güneşin ışığı , donuk bir kuzey aydınlığı yaratıyor , bana Ulusal Müzedeki bazı resimleri düşündürtüyordu .	yaratıyor	9	Sing
Halbuki arada gidip günah çıkardın mı , kendini bir miktar yırtmış hissediyorsun , temizlenmiş hissediyorsun , aynı haltı yiyeceğini bilsen bile bir güvencen var .	hissediyorsun	11	Sing
Bu fotoğrafı çektirir çektirmez İstanbul'a göçmeye karar vermişler , ama olmamış .	vermişler	7	Plur
Eniştem emekli olduktan sonra döndüler Ankara'ya , yerleştiler dişlerinden tırnaklarından ayırdıkları paralarla güç bela edindikleri kooperatif evine .	döndüler	4	Plur
Şimdi ; gidip günah çıkarsam - bakın , üstelik burada benim bir günahım yok aslında - , rahatlamaz mıyım ? Sana normal davranır hale gelmez miyim ? Belki .	çıkarsam	4	Sing
Hem hiç merak etme benim annem ona herkesten iyi bakar .	etme	3	Sing
Gürültü onları cesaretlendiriyor .	cesaretlendiriyor	2	Sing
Durumu çok iyi özetliyordu .	özetliyordu	3	Sing
Timur , Artık kendi yalnızlığımda tutunacak dal kalmamıştı , ruhsal çöküntümün önüne geçemiyordum , madde bana başlangıçta ihtiyacım olan şeyleri verdi : deliğimi kapattı , eksikliğimi giderdi .	geçemiyordum	12	Sing
Orada , denizi gören yamaçlarda , ağaçların altına uzanıyor , piknik yapıyor , sonra da sonsuzca öpüşmelere başlıyorduk .	başlıyorduk	17	Plur
Şöyle bir dolaşayım evini ...	dolaşayım	2	Sing
Yahu nasıl yaptırırız zorla ?	yaptırırız	2	Plur
Onun yüzünün yarısı gülerken yarısı ağlardı .	ağlardı	5	Sing
Oysa kıçlarını kaldırma zahmetine katlansalardı kendilerine bıraktığım dosyada yapacağım deneylerin üreme organlarıyla ilgili olduğunu , gönderilecek kadavranın cinsiyetinin de önemle dişi olması gerektiğini görebilirlerdi .	katlansalardı	4	Plur
Oturduğum yerden çevreme göz gezdiriyordum .	gezdiriyordum	4	Sing
Elim ayağım tutmuyor .	tutmuyor	2	Sing
İkili , bu birbuçuk saat zarfında dosyaların ellerine ulaşmayan parçalarını çıkarttılar .	çıkarttılar	10	Plur
Oturup sigara yaktım , telaşe halimin geçmesini bekledim .	bekledim	7	Sing
Az daha unutuyordum : Evde başka eşya da vardı .	vardı	8	Sing
Senin gitmen beni daha mutlu eder , dedi .	eder	5	Sing
Annemle babam benimle ilgilenmiyor demek istemiyorum ; ama ben onlarla daha fazla birlikte olmak istiyorum .	ilgilenmiyor	3	Sing
Güneş batarken ve eylül rüzgarları kuruyan otların üstünde belli belirsiz gezinirken buluşmalıydınız .	gezinirken	10	Sing
Ancak Irak konusunun sürekli gündemde kalıyor olması orta vadeli düşünenler için ciddi bir tehdit .	düşünenler	9	Plur
Makineler büyülüyor seni .	büyülüyor	1	Sing
Biz , geçmişte ne varsa güzel olan , yanımıza aldık , kalbimize gömdük .	aldık	9	Plur
Nesnel bir gerçekliğin ve buna ilişkin nesnel yasaların varlığının kabulü , bilginin doğruluğunun ölçütünün pratik olması ilkesini beraberinde getirir .	getirir	18	Sing
Hemen Esin'le Özen'in odasına koştum .	koştum	4	Sing
Çarpıntısı geçince yazmayı sürdürdü .	sürdürdü	3	Sing
Niçin beni rahatsız ediyorsun ufaklık ? diye homurdanmış .	homurdanmış	7	Sing
Ağar meydan okudu .	okudu	2	Sing
Hakkı , Seni bu kafayla bekar evine göndermem .	göndermem	7	Sing
Oysa bunu hak etmedik .	etmedik	3	Plur
Bakışları özlemle parkın ulu yeşil ağaçlarının dallarında , havuzdaki fıskiyenin parıltısında , kenardaki çiçek tarhlarının üstünde geziniyordu .	geziniyordu	16	Sing
Hiçbir şey anlatamadım , diye acıyla inledi .	inledi	6	Sing
Belgin Dorukları , Sadri Alışıkları , Kırık Hayatları ve Ölümsüz Aşkları , eski resimlerde yanımıza aldık , gidiyoruz .	aldık	15	Plur
Fasulye , pilakide havuçtan ve sarmısaktan takviye alır .	alır	7	Sing
Örneğin matematikte yüzyıllara dayanmış ve matematiğin gelişmesinde itici güç rolü oynamış kestirimlerin yakın geçmişte kanıtlanmış olması , bazıları tarafından matematiğin altın çağını yaşadığının bir göstergesi olarak kabul ediliyor .	dayanmış	3	Sing
Tabanları şişmiş , ayakları parçalanmış ama iş aslan ağzındaymış .	şişmiş	1	Sing
Özellikle de günümüz teknolojisinin ilerleme hızını düşününce birçok insan faktörünün geri plana itildiğini gözlemleyebiliriz .	gözlemleyebiliriz	13	Plur
Yaşlandıkça tuhaflaşıyorsun .	tuhaflaşıyorsun	1	Sing
Bunun senin için gündelik hayatın olağan bir parçası olduğunu düşün .	düşün	9	Sing
Her zamanki masasında oturuyordur .	oturuyordur	3	Sing
Kazadaki adam komaya girse , hepsi komaya girecektir .	girecektir	7	Sing
Kapıcı hergelesinin bakışını görsen , aç kurt gibi ...	görsen	3	Sing
Tamam usta ya , girmiyorum , bir işeyip geleceğim , diye yanıtladı çocuk .	geleceğim	8	Sing
Çay bahçesinde tanışmışlar .	tanışmışlar	2	Plur
Matbaadan işçiliğinden sonra somya kaynakçılığını da terk etmemi hazmedemiyordu .	hazmedemiyordu	8	Sing
Bir adama Kabak diyin .	diyin	3	Plur
Dar yollarda koşarak giden Kerem'i yakaladım .	yakaladım	5	Sing
Sonunda elde kalanın doyum mu , doyumsuzluk mu olduğuna karar veremediğin , tütsülerin savrulduğu anıt - mezarlar ...	kalanın	2	Sing
Onu tanıyanlar Bakırköy'de en yatmayacak insan diye tanımlıyor .	tanıyanlar	1	Plur
Kabloda güç birliği yaptılar .	yaptılar	3	Plur
O arada geri dönüp olanları anlatmaya çalışan Ramiz'in kafasına indirdi cetvelini .	indirdi	9	Sing
Siz bu işin üzerine fazla gitmeyin dedi .	gitmeyin	5	Plur
Şehvet ve arzu yaşanırken , eski bir kadının düşüncelere girmesi çok zordur .	yaşanırken	3	Sing
Gazi daha çok kuru leblebiyi tercih ederdi .	ederdi	6	Sing
Bir akşam üstü de başındaki o komik perukla fahişe olmadan önce ( sadece basım evinde çalışan , mürekkep kokan sevgilinle yattığın günlerde ) çalıştığın markete girdin .	girdin	25	Sing
Allah rahmet eylesin , dediler , büyük adamdı .	dediler	4	Plur
Bir birbuçuk - saat içinde çok hızlı bir şekilde incelemek zorunda kaldık .	kaldık	11	Plur
Ağbime güvenirim .	güvenirim	1	Sing
Yani bu model , bize de uygun düşüyor .	düşüyor	7	Sing
Yani şimdi o gerçekleşiyor .	gerçekleşiyor	3	Sing
Bir kadınla bir erkeğin oynayabileceği bütün oyunları oynamış , kadınlığı da erkekliği de sonuna kadar yaşamıştık .	oynamış	7	Sing
Niye mutsuz olduklarını ise söylemezlerdi , mutsuzluklarının nedenini siz keşfetmek zorundaydınız , bunu keşfedemezseniz biraz daha düşmanlaşırlardı ; bu düşmanlık gerçek değildi , yalnızca mutsuzluklarının üstüne örtmeye çalıştıkları yakıcı bir örtüydü .	keşfedemezseniz	13	Plur
Daha da kötüsü , bu gerçeği bilmeme rağmen , her seferinde elimde olmadan hep aynı şeyi yapıyordum , bunun önüne geçemiyordum .	geçemiyordum	20	Sing
Bilimsel bilgiler de teknoloji aracılığıyla bir üretici güce dönüşür .	dönüşür	8	Sing
Baktı olmayacak , beni yanağımdan öptü , saçlarımı okşadı .	öptü	5	Sing
Onun bu evde yeri yok artık , diye bağırmış .	bağırmış	8	Sing
Kapıyı kapattı .	kapattı	1	Sing
Beyan edenden az vergi alınsın .	edenden	1	Sing
Bir insanın ruhundan geliyorum ben , dedi .	geliyorum	3	Sing
Şirketin patronu olan okul arkadaşım her zaman giydiği birbirinin aynı siyah takım elbiseleri , inanılmaz derecede parlak kravatlarıyla öğlen yemeğine giderken kapıdan kafasını uzatıp Kaç ? diye soruyordu , ona o ana kadar okuyup kaydettiğim cinayetlerin sayısını söylüyordum .	söylüyordum	37	Sing
dortyuz-besyuz milyarlık bir katkı daha yapacaklar " dedi .	yapacaklar	5	Plur
Harun Yahya ve yazarlarının herbiri sanki reenkarnasyona uğramış Berkeley ! İlgili okura , Bertrand Russell'ın Türkçe'ye de çevrilmiş olan The History of Western Philosophy adlı kitabının Berkeley bölümünü okumalarını salık veririm .	veririm	30	Sing
Sözgelimi , Gümrük Birliği gibi bir yolculuğa çıkarken , çevresindeki duvarları yıkmaya çalışınca , eski eşyayla yenilerin bakışması gibi , hüzünlü ve çarpıcı yalnızlıklar yaşayan bir ülkeyi ...	çıkarken	7	Sing
Soruları sürekli tekrarladığınızı fark etseler bile utangaç ifadelerini bir kenara bırakıp sinirlenmez , sıkıldıklarını belli etmezler .	etseler	4	Plur
Birden esti aklıma .	esti	1	Sing
İnsanları ikiye ayırıyor annem ( sayacağı iki kalem de olsa mutlaka parmaklarını avucuna kapatarak sayacak ; birincisi yaşayanlar ( bunlar başkalarını da yaşatıyor ) , ikincisi yaşayanları seyredenler ( bunlar da başkalarının sırtına yük oluyorlar ) .	ayırıyor	2	Sing
Avrupalılara da kabul ettirmişlerdir .	ettirmişlerdir	3	Plur
Düşünmekten vazgeçti .	vazgeçti	1	Sing
Seben Gölü'ne ulaşmıştık artık .	ulaşmıştık	2	Plur
Ancak çok deneyimli bir psikiyatrist ya da psikolog bu kabuğun altındaki duygusal boşluğu sezebilir ve pek çok aydının çok dokunaklı bulduğu bu zeka parıltılarından etkilenmeden tanısını koyabilir .	sezebilir	13	Sing
Bazen şarkı söylerken de olur bu , arkadaşlar bilir ( arkadaşlar , yani bıyıklarına ak düşmüş emekli sarhoşlar gözlerini yumup başlarını hafifçe eğerek onaylıyorlar ) okursa hüzzam okur , herkesi kahırlandırır .	okursa	25	Sing
O geceye doğru yolculuğa çıktığından ( biraz zorlanacak tabii , onda da beyin meyin kalmamış ) dalıp gidiyor .	zorlanacak	7	Sing
Sanıyorum bütün entellektüel züppeler oradalar .	Sanıyorum	0	Sing
bir ) Lezzetine bayılmış .	bayılmış	3	Sing
Aaa , diyorlar , kimi elini saygıyla göğsüne bastırıyor kimi de , işte orada duracaksın anlamında ileri doğru uzatıyor ; büyük adamdı .	bastırıyor	8	Sing
Bakın , şu demir korkulukların ardında görünen kapılar .	Bakın	0	Plur
Hitler'in Almanya için kimi iyi şeyler yaptığına , Karl Marks'ın dört ayak üstünde çocukları sırtında gezdiren , büyümeyen bir çocuk olarak kaldığına hayretle muttali oluyorsunuz .	oluyorsunuz	24	Plur
Yoksulluk içinde olan kişileri gözetmeyi amaçlayan yardım politikasında , sadelik , titizlik ve kişiliklere saygı esasına özenle gösterilmesini eşitlik ve adalete riayet edilmesini önemli rica ederim .	ederim	25	Sing
Bir defasında laf oraya gelir gibi oldu , derhal , halledilmemiş bir başka tartışmayı açarak herkesi sürükledim .	sürükledim	16	Sing
Ses dalgalarının ulaştığı insanlar , müziğin başlayacağını anladılar ; ama Recep'in biraz önce gördüğü darbukalı çocukta daha başka şeyler oldu .	anladılar	7	Plur
Yüzlerini , bakışlarını , sözlerini , hatta seslerini bile değiştirebilirler , ama o seslerin içindeki küçücük vurgulamaları değiştiremezlerdi .	değiştirebilirler	9	Plur
Kabaklık eden adama kabak demeyin .	demeyin	4	Plur
Aşk öyküsü yazmayalım mı yani .	yazmayalım	2	Plur
Norveç'ten ithal edilen Destecioğlu cihazının maliyeti üçyüzelli bin doları ( yaklaşık beşyüzelli milyar lira ) buluyor .	buluyor	15	Sing
Siz dükkandan çıkıp onların arasına gireceksiniz ve yürümeye başlayacaksınız .	gireceksiniz	5	Plur
Maliye Bakanı adına inceleme yapıyor .	yapıyor	4	Sing
Melek kaç tane sattın ? diye yaklaştı Memo .	sattın	3	Sing
Ürkerim o an ondan .	Ürkerim	0	Sing
Drugstore'da alışveriş yapanların yüzde 91'i ambalajın önyüzünü , yüzde 42'si arkasını , yüzde 8'i de yan yüzlerini okuyor .	yapanların	2	Plur
Hiç tartışmayalım .	tartışmayalım	1	Plur
Kolayca eşelenen kuru karın altındaki otlar , kış ayları boyunca yeterli gıdayı sağlıyordu onlara .	sağlıyordu	12	Sing
Onunla konuyu enine boyuna görüştük .	görüştük	4	Plur
Kalkmaya hazırlanan masadaki iki genç kadının ayaklarının oynamaya başladığını , ince hırkalarının altında omuzlarının titrediğini , parmaklarının tempo tuttuğunu gördü , sevindi .	sevindi	21	Sing
Bu kadar çabuk da bulamaz değil mi ?	bulamaz	4	Sing
Celal'le karşısına geçtik .	geçtik	2	Plur
Kullanıyor ama kafa bulamıyordum .	Kullanıyor	0	Sing
Aşık olduğum için utanıyorum sanıyorum .	utanıyorum	3	Sing
rapor kaza günü düzenlenmişti .	düzenlenmişti	3	Sing
- Çiziyor musun yani .	Çiziyor	1	Sing
Katı , otoriter ve ilgisiz bir doktorla evli olan kadın , acısını uyuşturucu haplarla dindiriyor , yaşamındaki sevgi boşluğunu ise hayatını oğluna adayarak gidermeye çalışıyordu .	çalışıyordu	24	Sing
Daha sonra raporda pilotlar ve uçağın durumu ile ilgili genel bilgiler veriliyor ve uçuş sırasındaki meteorolojik şartlar belirtiliyordu .	veriliyor	11	Sing
Pasaport Şube Müdürlüğü'nde vekaleten görev yapan Cring Land ) , bir süre önce nişanlısıyla görüşmek üzere İstanbul'a gitmişti .	gitmişti	17	Sing
O kadar iyisin ki özgürlüğüm kısıtlanıyor , istediğim gibi davranamıyorum .	davranamıyorum	9	Sing
En yakınlarınızdan başlayarak , tanıdıklarınız , tanımadıklarınız , milyonlarca , milyarlarca insan size bu koridoru hazırladı .	hazırladı	15	Sing
Önce Tanrı'nın ve Bey'in kulu olmadığımızı öğrendik ; sonra dünyayı değiştirebileceğimizi .	öğrendik	6	Plur
Kerem bana baktı .	baktı	2	Sing
Heyecandan ara sıra nazikçe boğazlar temizlenir , dudakların üzerlerinde biriken ter damlacıkları rujların dağılmamasına özen gösterilerek hafifçe siliniverir .	temizlenir	5	Sing
Len Ti , işçilerin yeni evlerinden memnun olmadıklarını duydu .	duydu	8	Sing
Beni tanır , gelip karşısına oturduğumu hisseder .	tanır	1	Sing
Sanal parçacıklarsa bunların hiçbirini yapamazlar .	yapamazlar	4	Plur
Her seferinde suratını şaşırmış gibi buruşturup İyi , derdi .	derdi	8	Sing
Hemen oracıkta kafanı bir güzel tıraşlayıvermiştin .	tıraşlayıvermiştin	5	Sing
Oturun yerinize .	Oturun	0	Plur
Ne yalan söyleyeyim biz babamı özlüyoruz .	özlüyoruz	5	Plur
Yerimden fırladım , kapıyı hızla açıp Ömür Uzatma Kıraathanesi'nden dışarıya çıktım .	çıktım	10	Sing
Beni bulamazlar .	bulamazlar	1	Plur
Sen diye başlarlar , Atila diye devam ederler .	başlarlar	2	Plur
Eşya arasına yerleştirilmiş gazeteler saçıldı ortaya .	saçıldı	4	Sing
Bu fotoğrafı çektirir çektirmez İstanbul'a göçmeye karar vermişler , ama olmamış .	olmamış	10	Sing
Hele bunlar evlenmişlerse ...	evlenmişlerse	2	Plur
İkincisi de teknik raporun , Kara Havacılık Okulu'ndan bir albayın ve uçak şirketinden iki yetkilinin düzenlediği rapordaki bilgilerin aslında sadece enkazla ilgili olduğunu , uçağın düşüş nedeniyle ilgili olmadığını söylüyor .	söylüyor	29	Sing
Tanışmadınız , görsen şaşarsın , çok zeki , anlayışlı ama ...	görsen	2	Sing
Kurtulamamışım demek , diye mırıldandı .	mırıldandı	4	Sing
Şura'nın yaşlı babası Abanasi , sobanın başında yarı erimiş geyik etini balta ve bıçakla tencereye girebilir parçalara ayırıyor .	ayırıyor	17	Sing
Bu pazar bize katılsanıza ...	katılsanıza	3	Plur
Genelde bir erkeği mağazada ilgilendiği bölüme doğru sabırsızca hareket ederken görürsünüz .	görürsünüz	10	Plur
Konuştun mu onunla .	Konuştun	0	Sing
Lange Leidsewards Straat'da Kierkegaard okuyan kıza , kendisiyle yeniden görüşmekten sevinç duyacağımı söylemiş , ertesi gün öğleye doğru , onun oturduğu sokağın başındaki o güzel , iki katlı kahveye çağırmıştım onu .	çağırmıştım	29	Sing
Bazen şarkı söylerken de olur bu , arkadaşlar bilir ( arkadaşlar , yani bıyıklarına ak düşmüş emekli sarhoşlar gözlerini yumup başlarını hafifçe eğerek onaylıyorlar ) okursa hüzzam okur , herkesi kahırlandırır .	düşmüş	15	Sing
Boğaz'ın suları da sabahın dinginliğine uymuş , ağır kıpırtılarla akıyordu .	uymuş	5	Sing
Kapı dışarıdan vuruluyor , hafifçe itiliyor , aralanıyor , yeniden kapanıyordu .	vuruluyor	2	Sing
Kemal devam etti : Ben bunun , hem tek tek hepimiz için çok rahatlatıcı olacağından eminim hem de birbirimize yaklaşımımızı , ilişkilerimizi olumlu etkileyecektir , eminim .	etkileyecektir	23	Sing
Niçin beni rahatsız ediyorsun ufaklık ? diye homurdanmış .	ediyorsun	3	Sing
Demin övüp duruyordun patlıcanı !	duruyordun	2	Sing
Katana gururla saatine baktı .	baktı	3	Sing
ÇALIŞTIĞI şirketi suçlayan Ciguli şunları söyledi : " İkinci kaset için çağırdılar .	çağırdılar	11	Plur
Bir mücadeleyi izliyoruz işte .	izliyoruz	2	Plur
İçinde cinayet olmayan bir cinayet romanı yazmayı düşünüyordum .	düşünüyordum	7	Sing
elli milyon dolara bakmıyor , yüz bin dolara bakıyor .	bakmıyor	3	Sing
Tartışmaktan yorulmuş gibi sustuk .	sustuk	3	Plur
Bu ilişkiyi bitirelim , böyle yürütemeyeceğim , dedi .	bitirelim	2	Plur
O zamanlar toprağı bol olsun Sayın Tului Sönmez ile konuyu tartışmış ve ondan epey şey öğrenmiştim .	tartışmış	10	Sing
Kanunun 63'üncü maddesinde ikiyüzelli milyar liranın altındaki kamu ihalelerine sadece yerli isteklilerin katılması şart koşuluyor .	koşuluyor	14	Sing
KÜTÜK , yaşadıklarını şöyle anlattı : " Yapımcıyla konuşup dizide oynamak istediğimi söyledim .	söyledim	12	Sing
Gel bak , sana evi göstereyim .	Gel	0	Sing
Artık rehberimden utandığım için bağırıp kervanı durdurmasını istemiyor , hızlı planjonlarla , kızağa yeniden tırmanıyordum .	tırmanıyordum	14	Sing
Halam nasıl böyle büyüklerine laf çakıştıran bir çocuk yetiştirir diye şaşakalmıştık .	şaşakalmıştık	10	Plur
Biraz daha anlatmalıyım diye düşündüm .	düşündüm	4	Sing
Hazine tarafından dış borçlanmalar için verilebilecek garanti tutarı beşyüz milyon dolarla sınırlandırıldı .	sınırlandırıldı	11	Sing
Akçaalan Mahallesindeki ev iyiydi hoştu , ama hatta eş dost , hısım akraba hep oradaydı , ama devir değişiyordu .	değişiyordu	18	Sing
Ağzını yokluyor bir yandan .	yokluyor	1	Sing
Baktım baktım yürüdüm gittim .	yürüdüm	2	Sing
Bağımlılar her şeyin en iyisini bildiklerinden kendileri için birinden yardım istemek egolarına ters düşer .	düşer	13	Sing
Bizi kıyaslayan , karşılaştıranlar bilsinler ki ... Biz , yarışta değiliz .	değiliz	10	Plur
Bir hanımefendi sakız çiğnemez , deyip kesip atıyor .	atıyor	7	Sing
Görürüz bakalım , yarın o arabayı kim silecek , diye tehditler savurarak uzaklaştı diğer siliciler .	Görürüz	0	Plur
Kalmayız , dedi , koşa koşa gideriz , erikleri de senin heybene doldururuz .	Kalmayız	0	Plur
Biraları devirdikçe merakım azdı .	azdı	3	Sing
Bir o , bir ben , hiç önceden kararlaştırmadan , kendiliğinden bir o , bir ben , olup bitenleri anlatmaya başladık ... dese diye , sabırsızlana sabırsızlana dinledim onu .	sabırsızlana	25	Sing
Her ne kadar Amatem'de görev yapan psikiyatrist Ali Babaoğlu bu zeka pırıltılarını eleştirse de : ...	eleştirse	12	Sing
Vazgeç bu huyundan .	Vazgeç	0	Sing
Bankanın , cari faizin yüzde yirmibeş fazlası temerrüt faizi aldığını bildiren Demiray , " Çıkacak olan yasa gecikme faizini cari faizin yüzde elli fazlası ile sınırlıyor .	sınırlıyor	25	Sing
Leblebiyle kız isteyen adama da servi boylu kız verecek değiller ya .	değiller	9	Plur
Boş sokakta topuklu ayakkabıların çıkarttığı , yankılanan bir ses duyuldu .	duyuldu	9	Sing
Sezginler ne ile uğraştığını o güne kadar tam olarak bilemese de Senem başlarına gelebilecekleri tahmin edebiliyor ve bu yüzden Sezginler'i uyarma ihtiyacını hissediyordu .	edebiliyor	15	Sing
Salondan çıkarken herkesin yüzünün güldüğünü fark ettim .	çıkarken	1	Sing
Birbirimize hiç dokunmadan , ben onun ellerine o da benim gözlerime bakarak sevişirdik kalabalığın içinde .	sevişirdik	12	Plur
Hem bir şey kırk kere söylenirse olurmuş .	olurmuş	6	Sing
Gidersiniz , sonra geri gidersiniz Erkekler Parkı'na .	Gidersiniz	0	Plur
Sübjektif idealizm evreni bir algılar bütünü olarak betimler .	betimler	7	Sing
Rastgele bir odanın kapısını vurdum .	vurdum	4	Sing
Bak işte bu fotoğrafta yan yana duruyorlar .	duruyorlar	6	Plur
Sevgilinin ışıksız pencerelerine uzaktan bakarken kalbim böyle küt küt atmamıştı .	atmamıştı	9	Sing
Kimi bir şişe rakıyla öldürüyor , kimi üç gram kokainle , kimi beş gram eroinle .	öldürüyor	4	Sing
Ferda , Böyle bir konuda deneme yanılma oynanabilir mi , Selma'cım ? diye konuştu .	oynanabilir	7	Sing
Tek başımıza iktidara doğru yürüyoruz " dedi .	yürüyoruz	4	Plur
Saime Sezginler aylarca çalışmış , kardeşinin arkadaşlarıyla saatlerce konuşmuş , kitaplar tercüme etmiş , ettirmiş ve bir uzmanın sahip olacağı teknik bilgiyi öğrenmişti .	ettirmiş	14	Sing
Fırında pişer .	pişer	1	Sing
Kahveleri bende içelim .	içelim	2	Plur
Sistemli ve kalıcı her şeyden rahatsız oluyorlar .	oluyorlar	6	Plur
Yapbozun parçaları yerlerine oturuyordu .	oturuyordu	3	Sing
Annenin veya babanın hemen evleneceğini neden aklına getiriyorsun ?	getiriyorsun	7	Sing
Ama , dedi umutsuzlukla kadın , O beni düşünmediği sürece hiçbir şey yapamam ki !	yapamam	12	Sing
Bir kadınla bir erkeğin oynayabileceği bütün oyunları oynamış , kadınlığı da erkekliği de sonuna kadar yaşamıştık .	yaşamıştık	15	Plur
Hanın üst katındaki odalardan birine çıktılar , dedi .	çıktılar	5	Plur
Ona her şeyi yazdım .	yazdım	3	Sing
Bul bir fıstık kan , at evine , rahatla , derdin bu senin .	Bul	0	Sing
Bunlar , kuşkusuz insanlığın kolektif yaratıcılığının eşsiz örneklerini oluşturmakta ve bilimin geleceğine olan güvenimizi ayakta tutmaktadır .	tutmaktadır	15	Sing
Evenleri , modern dünya insanına göre daha bağımsız kılıyordu bu durum .	kılıyordu	8	Sing
ya da belki ben böyle bir vaziyeti görürüm diye , bilemiyorum ...	bilemiyorum	10	Sing
Diz çök karşısında , okşa saçlarını , özür dile , bağış dile , ne dilersen dile it herif , ağla hatta elinden geliyorsa ...	dile	15	Sing
Oraya saptık .	saptık	1	Plur
Neyse ki üçüncü kez sorduğunda iyi bir cevap hazırlamıştım : Esinciğim evde tek kız olmasının daha iyi olduğuna karar verdik .	hazırlamıştım	8	Sing
Olmuyor , tekrarlayalım ...	tekrarlayalım	2	Plur
Orada , denizi gören yamaçlarda , ağaçların altına uzanıyor , piknik yapıyor , sonra da sonsuzca öpüşmelere başlıyorduk .	uzanıyor	8	Sing
Kemal , Günah çıkarma esprisine , bir çeşit yakıt alma gibi , yıkanıp temizlenme gibi , yüzeysel , hatta bazen köklü bir tamirat gibi yaklaşmalıyız , bunu kastediyorum , dedi .	kastediyorum	27	Sing
Ama orada gayet normal hareket eden insanların çoğu , yandaki salona geçtiğinde şoka giriyorsunuz ; Resmen hard seks yapıyorlar .	yapıyorlar	18	Plur
Kerem başını kaldırmış , ona bakıyordu .	kaldırmış	2	Sing
Onları sekiz maddede tanıyalım !	tanıyalım	3	Plur
İzleyiciler bu bakışın farkında olmasalar da , Recep kahrolur , darbukasına hırsla vurmaya , tempoyu hızlandırıp Saffet'i zorlamaya başlardı .	olmasalar	4	Plur
Erkekler Parkı'nın yolunu bilmiyorum .	bilmiyorum	3	Sing
Örneğin , annelerin bebek arabalarını rahatça sürecek genişlikte koridorlar olmaması 20'li 30'lu yaşlarındaki kadın müşteri kitlesinin bu mağazayı tercih etmemesine neden olacaktır .	olacaktır	21	Sing
Onu dinlemeyip çıktım , kapıyı kapamadan , arkamdan geleceğini biliyordum .	çıktım	2	Sing
Kapıyı itiyorum , zorluyorum , tam biraz açılır gibi oluyor , gene kapanıyor .	kapanıyor	12	Sing
Hep uzaktan uzağa kuşatmazlar mı birbirlerini , hep araya giren anaların yatıştırmalarıyla sakinleşmez mi ortalık .	kuşatmazlar	3	Plur
Eğer ilk anda şarlamazsanız , size ciddi ciddi şunu öneriyorum : Aramızdan birini tesbit edelim .	şarlamazsanız	3	Plur
Ben Erbakan'ın yanında onun yanlışlarına ortak olsaydım kırk defa bakan olurdum , elli defa genel başkan olurdum .	olsaydım	6	Sing
Son zamanlarda anne , hastalanıp yataklara düşmüş .	düşmüş	6	Sing
Keskin toplum eleştirisi , esprili ve zeki özeleştiri , bir çeşit kara mizah , bilgi düzeylerinin çok üstünde bir entelektüel performans onlarla tanışanları şaşırtır ve çarpar .	çarpar	25	Sing
" Bu tanımla , örneğin Almanya'da şirket kuran vergisini Alman hükümetine ödeyen fakat Türk vatandaşı olan kimseler yerli ama Türkiye'de yıllardan beri yerleşik bulunan bizler yabancı oluyoruz " diyen ' , teknik bir hata olabileceğine dikkat çekti .	oluyoruz	26	Plur
Gerçekten de bu bin yılda önce evrenin merkezinde değil , Güneş etrafında dönen sıradan bir gezegende olduğumuzu öğrendik ; sonra sıradan bir canlı türü olduğumuzu .	öğrendik	17	Plur
Versem mi acaba ? Yanlış bir şey yapmış olmayalım ? diye sordu .	olmayalım	8	Plur
Aydınlık gazetesinde konuştuğu muhabirler , Biz size yardımcı olalım , dediler .	olalım	8	Plur
Haydi oğlum , gidiyoruz .	gidiyoruz	3	Plur
( İsim vermiyorum .	vermiyorum	2	Sing
Kimse zorlamadı beni , üç ölü zamanlar alanını ben terkedip geldim bu eve .	zorlamadı	1	Sing
Galiba gelmemiş , öyle söylediler , dedim .	söylediler	4	Plur
Emaye bobin teli üretecekler .	üretecekler	3	Plur
Bu ilişkiyi bitirelim , böyle yürütemeyeceğim , dedi .	yürütemeyeceğim	5	Sing
Leblebi deyip geçmeyin .	geçmeyin	2	Plur
Yutmadım ama , bu seferlik geç yerine otur , demek istiyordu .	otur	7	Sing
Kız kardeşim saçlarını evde kendisi boyardı .	boyardı	5	Sing
Bütün komşular ağız birliği etmişçesine , Bizde iş çok ama sana verecek para yok , diye yanıtlamışlar .	yanıtlamışlar	16	Plur
Neleri sevmediklerine gelince , müşteri , beklemeyi , kendisine gereksiz soruların sorulmasını , stokta kalmamış ürünleri , okunamayan fiyat etiketlerini ve rahatsız edici hizmeti sevmez .	sevmez	24	Sing
Tamam oğlum , haydi çık sudan , diye yineledi Recep , çocuğun pantolonuna doğru giderken .	yineledi	8	Sing
Ter içinde uyandım .	uyandım	2	Sing
Gidiyoruz , gelin .	Gidiyoruz	0	Plur
Eee , sen tarlaya yemek götürdün , biz ne yapacağız .	yapacağız	9	Plur
Döndü arkasını , burnunu siler gibi yapıyor .	siler	4	Sing
Adam , yani mandıra sahibi bakmış ki , başının etini yiyor , rezil olacak , dayalı döşeli bir daire alıp , üstüne yapmış Kumru'nun , çekmiş gitmiş ...	çekmiş	25	Sing
Ağabey , ben taşıyayım , diye atıldı çocuk darbukaya doğru .	atıldı	6	Sing
Bugün genetik şifresi çözülen canlıların tıpkılarının üretilmesi , sorunu salt yoktan var edip edememe noktasına indirgemiştir .	indirgemiştir	15	Sing
Anlattım mı .	Anlattım	0	Sing
Çek şu albümü , şunu şunu , hani gidip gelip karıştırdığın , bilmem mi sanırsın , hah işte o albümü ver bakayım .	Çek	0	Sing
Kapı aralanır gibi oluyor , büyük bir gürültü ile yeniden çarpıp kapanıyordu .	kapanıyordu	11	Sing
Az daha unutuyordum : Evde başka eşya da vardı .	unutuyordum	2	Sing
Başesgioğlu verdiği önergeyle güvenlik , savunma amaçlı hibe ve yardımlara ilişkin uygulama boşluğu doğmaması için , 2002'de mevcut olan düzenlemelerin devamı sağlandı .	sağlandı	21	Sing
Yüzeyinde bazı karaltılar vardı .	vardı	3	Sing
Harbiyeli Gidin , evinize yatın diye talimat verdi .	yatın	4	Plur
Baban sana rağmen mi astı kendini , sana bağlı olarak mı .	astı	4	Sing
Hıçkırıklarımın arasında söylediklerini dinlemeye başladım .	başladım	4	Sing
Hadi abi kapa gözünü , aç demeden açmak yok ha ! ..	kapa	2	Sing
Derhal müzik koymalıyım , beni alıp götürsün , şuradan Lou Reed kasetini .	götürsün	6	Sing
bildirilerinin hepsinde , evrim kuramına karşı geliştirilen bir sav ön plana çıkmaktadır : bir kuram , hipotez veya varsayım gözlem , deney veya bulgularla kanıtlanmadıkça doğru değildir .	çıkmaktadır	11	Sing
Durun ! Gitmeyin ! diye bağırdı Hacı Murat .	Gitmeyin	2	Plur
Üçümüz birden girsek , dedi Miskoye , sen konuşsan .	konuşsan	8	Sing
Bazen arkadaşlarla toplantıdayken de dilime takılıveriyor .	takılıveriyor	5	Sing
Kavrulmamışı da olmaz .	Kavrulmamışı	0	Sing
Kurtulup buraya gelmeyi başardım .	başardım	3	Sing
Sen de benim yaşıma gel , sana da alırlar göreceksin .	gel	4	Sing
Peki . dedi kısaca Gelin o zaman .	Gelin	4	Plur
Olayda pilot hatası olduğuna inanmıyorum " dedi .	inanmıyorum	4	Sing
Gördün mü el konulduk bile .	konulduk	3	Plur
Yine de gençlerin arasında uygunsuz bir ilişki olsa , gözünden asla kaçmazdı .	kaçmazdı	11	Sing
Bir müzikal yapalım : Hadi fıstık , ya da fındık aryaları söyledi .	yapalım	2	Plur
Şunu niçin düşünmüyorsun , diye başladı Hülya yeniden , bu insanların hemen hepsi çeşitli zamanlarda özel birtakım konularını seninle konuşurlar , sana danışırlar , senin söyleyeceklerine önem vermeye hazırdırlar .	danışırlar	22	Plur
Bu sorunuzu , garsonun bakışları , çevredekilerin gürültüleri yüzünden siz bile duyamadınız ; ama ben duydum .	duydum	15	Sing
Uzakta köşk görülüyordu .	görülüyordu	2	Sing
Özen gösterin onlara .	gösterin	1	Plur
Karşısında , pantolonu dizlerine dek ıslak , önlük torbası ham eriklerle dolu İbrahim dikiliyordu .	dikiliyordu	13	Sing
Muhabbet duyduk .	duyduk	1	Plur
Bodrum evi için bir anlamı ve güzelliği olan gumbillinin ( Bodrum evine özgü çatı parapeti köşelerinde yer alan süs elemanı ) ve beyazın , binlerce tekrardan sonra mide bulandırdığını söylemeliyim .	söylemeliyim	29	Sing
Ağustos güneşi epeyce yatmış olduğu halde etkisini sürdürüyordu .	yatmış	3	Sing
Benzetmek gerekirse , Lahana kanlı - canlı , tuttuğunu koparan bir Kuzeyli güzelidir .	gerekirse	1	Sing
Kazadaki adamın sinirleri kaç kişiye bağlansa bunların hepsi , aynı Politzer gibi , kazayı başından sonuna kadar yaşayacaktır .	bağlansa	5	Sing
Koşarak ona yaklaştı heyecanla Abi ! ...	yaklaştı	2	Sing
Zafer Piknik'te alıyordum soluğu ...	alıyordum	2	Sing
Askerler , Anayasa çiğnendi diye rejime müdahale etmişler , sonra da Anayasayı toptan kaldırarak yeniden başka bir metin yazdırmışlardı .	yazdırmışlardı	18	Plur
Gizli heyecanımı , bu heyecanın altında yatan kaygıyı sezmiş gibiydi .	sezmiş	8	Sing
Ne kadar zorlarsam zorlayayım , her biri cılız birer siluet olarak gözlerimin önünden geçip kayboluyor .	zorlarsam	2	Sing
İşte o zaman , bu turistik yörenin olağanüstü tarihine merak duyanlar , buradaki insanların birkaç bin yıl önceki bir uygarlığın torunları olduğunu bilenler , tarihten bir sahnenin canlanmakta olduğunu sezerlerdi .	bilenler	22	Plur
Patlıcan deyin .	deyin	1	Plur
Gözkulak olunması görevini üstlenmiş gibi .	üstlenmiş	3	Sing
İki hafta önce Türkiye toplumunun yeni sivil , ideolojik ve ekonomik egemenlerini ve onların yaşam tarzlarını anlatmak üzere bu köşede doğan Kozanoğlu Kırmızı Türkler Maksim'den kavramı " artık reşit oldu " diyebiliriz .	diyebiliriz	31	Plur
Rakının yanından eksik etmeyin .	etmeyin	3	Plur
bırakın ben götüreyim .	bırakın	0	Plur
Onların karşısında olmak yerine onların yerinde olmayı hayal edersiniz .	edersiniz	8	Plur
Biraz daha anlatmalıyım diye düşündüm .	anlatmalıyım	2	Sing
Annem , telefonda dedeme bir doğum günü partisi düzenlediklerini söyledi , yarın dönsem iyi olurmuş ...	dönsem	12	Sing
Babam derdi ki .	derdi	1	Sing
Bayındır Sokak'taki bekar evimden çıktım .	çıktım	4	Sing
Ama bir şey olmadı " dedi .	olmadı	3	Sing
Ağlamaya başladım .	başladım	1	Sing
Mahmut'un aklını başından alıverdi .	alıverdi	3	Sing
Siz olmasanız , ben olmasam , yani nasıl ...	olmasanız	1	Plur
Beni niye sevdiğini hiçbir zaman anlayamamıştım , ama beni niye terk ettiğini biliyordum , bütün kadınlar beni hep aynı şekilde ve aynı nedenden terk ederlerdi zaten .	ederlerdi	24	Plur
Alev için bugün yaşamak ya da ölmek bir anlam ifade etmiyor .	etmiyor	10	Sing
Diyarbakır'a gitmeden önce annesine , " Merak etme , bu küçük uçakla son görevim " dedi .	etme	7	Sing
Bu geniş coğrafyada küçük gruplar halinde yaşıyorlardı .	yaşıyorlardı	6	Plur
Bu gece ulaştırmam gerek ...	ulaştırmam	2	Sing
Yaklaşık ikiyüz geyik ağırbaşlı adımlarla süzüldü kapalı alana .	süzüldü	5	Sing
Ben saydım .	saydım	1	Sing
Ben akşama vurulacak insanların o sırada neler yaptığını merak ederek cinayet haberlerini kesip dosyalarına koyardım ; arada ilginç bir cinayet çıkarsa , kimin , nerede , nasıl öldürdüğünü yanımda taşıdığım özel cinayet defterime kendim için kaydederdim .	kaydederdim	35	Sing
sekizonikibindokuzyuzdoksansekiz tarihli bildirisinde şöyle bir düşünce deneyi yapılıyor : Politzer'in otobüs kazası örneğini ele alalım .	alalım	14	Plur
MCB'ye kimse anlam veremiyor .	veremiyor	3	Sing
Tramvaylar geçiyor , biraz önce dinmiş olan yağmurun ıslattığı kaldırımları , ara sıra elektrik tellerinde yol açtıkları kıvılcımlanmalar aydınlatıyordu .	geçiyor	1	Sing
Tayyip Erdoğan'ın yanında , onun yanlışlarına ortak olsaydım kesinlikle bu noktalarda bulunmazdım .	olsaydım	7	Sing
Bırakın gideyim , ne olur bırakın .	gideyim	1	Sing
( Bakınız : " Taşkın Türkler " , " Biraz Profilo .	Bakınız	1	Plur
Kullanıyor ama kafa bulamıyordum .	bulamıyordum	3	Sing
Beğenili bakışları üstümüzde gelip geçenin .	geçenin	4	Sing
Yani , elektron - pozitron çiftinden iki gamma fotonu da üretebilirsiniz .	üretebilirsiniz	10	Plur
Yapılacak mevzuat değişikliği ile mevzuattaki " sır " kavramı yeniden belirlenecek .	belirlenecek	10	Sing
Rus sömürgeciler Sibirya'ya adım attıklarında karşılarında savunmasız halkları bulmuşlardı .	bulmuşlardı	8	Plur
Şimdilerde yeni bir korku edindiniz .	edindiniz	4	Plur
Bu herhangi bir rahatlama sağlamıyor ki , en fazla o sorunu nasıl çözeceğime ilişkin tavsiye almış oluyorum .	oluyorum	16	Sing
Bu yüzden alışveriş bilimini yaratırken antroplojinin katkısı tartışılmaz .	yaratırken	4	Sing
İkimiz de aynı anda Taşhan'ın kapısına bir kadının yaklaştığını gördük .	gördük	9	Plur
Öyle , lodos balığı gibi kendinizi oradan oraya atarsınız .	atarsınız	8	Plur
Düşen " Konya " uçağında kabin görevlisi olan Deniz Karasu'nun hostes ablası Gaye Karasu , kardeşinin öldüğüne inanamadı .	inanamadı	17	Sing
Nereye yönelsem arkamdan yetişiyordu , Sen kömür sobasını beceremezsin , yan odadan elektrikli zamazingoyu al , dolaptaki rakı çok soğuktur , en iyisi yattığım odanın aç kapısını , bak hemen kapının arkasında , kap gel ...	gel	34	Sing
Ev , ya da ev yapmak adına , ülkemizdeki gecekondu uygulamalarından öğrenecek epey şeyimiz olduğunu düşünüyorum .	düşünüyorum	15	Sing
Güneş yeniden bulutların kalın örtüsü ardında kaybolmuştu .	kaybolmuştu	6	Sing
Bu hak verilmeliydi .	verilmeliydi	2	Sing
İlla okuyacaklar .	okuyacaklar	1	Plur
- Okuyorum .	Okuyorum	1	Sing
Çelikkale Sokağı'nda manevra kıyafetli iki Harp Okulu öğrencisi bizi durdurdu .	durdurdu	9	Sing
Ben Ceza , dedim , sırtında lanetini taşıyan adam , böyle doğmuşum ; bunda ne anamın suçu var , ne babamın .	doğmuşum	11	Sing
Çiftler muhteşem dans ediyorlar , rüya gibi .	ediyorlar	3	Plur
Esin'le Özer birbirlerine baktılar Özer Prensesi ben koruyacağım ! dedi , Esin de gülümseyerek odanın ortasında dönmeye başladı yeniden : Ben bir prensesim , ben bizim evin prensesiyim . diye mırıldanarak .	koruyacağım	7	Sing
İnanmıyorsanız , Türkiye'nin kentlerinde ve kasabalarında bir pazar günü sokağa çıkın .	çıkın	10	Plur
Arınç da " Kastımın Erbakan'la Erdoğan'ı aynı kefeye koymak olmadığını da yazarsanız sevinirim " karşılığını verdi .	sevinirim	12	Sing
DYP Trabzon İl AKP'li partililere seslenen Ağar , Tansu Çiller'i üstü kapalı şekilde eleştirmeyi sürdürdü .	sürdürdü	14	Sing
Bıktırırlar insanı .	Bıktırırlar	0	Plur
ÖDP'nin sempozyum , konser , panel gibi etkinlikleri duyurmak için bastırdığı bazı afişler de seçim yasakları kapsamında sayıldı ve polis tarafından toplatıldı .	toplatıldı	21	Sing
Anladım ki bu taşınma kararımdan hoşnut , doğallaştırıp sıradanlaştırmaya çalışıyor , ama nafile , ben başlayacak bu yeni beraberliğin taze heyecanını bastıracak halde değilim .	Anladım	0	Sing
Destek olun bana .	olun	1	Plur
Ne sandın sen beni .	sandın	1	Sing
Çekiştirmeye kalkışmadı .	kalkışmadı	1	Sing
Ne kadar zengin olursan ol , diyor , seyirci olduktan sonra ( al işte Nurettin Bey ; sattı yedi , sattı yedi şimdi beş parasız , onun bunun eline bakıyor ) sıfırı tüketirsin .	tüketirsin	32	Sing
Ne kadar zengin olursan ol , diyor , seyirci olduktan sonra ( al işte Nurettin Bey ; sattı yedi , sattı yedi şimdi beş parasız , onun bunun eline bakıyor ) sıfırı tüketirsin .	olursan	3	Sing
Arçelik olarak genelde tahminimizin üzerinde iyi bir yıl geçirdik .	geçirdik	8	Plur
Okumuyorlar efendim .	Okumuyorlar	0	Plur
Bırakamazsınız o parkı .	Bırakamazsınız	0	Plur
Açma , sakın açma , izleniyorum .	Açma	0	Sing
Zeynep : Yemin ederim ki kimseye bir şey söylemeyeceğim .	söylemeyeceğim	8	Sing
Sabah olup da saatimin zili çaldığında kuşlarla gökyüzünde bale yaparak uçuyordum .	uçuyordum	10	Sing
Halbuki arada gidip günah çıkardın mı , kendini bir miktar yırtmış hissediyorsun , temizlenmiş hissediyorsun , aynı haltı yiyeceğini bilsen bile bir güvencen var .	hissediyorsun	14	Sing
Babanız yaşlanmıştı .	yaşlanmıştı	1	Sing
Haftada beş saat Latince okurduk lise dersleri yanında .	okurduk	4	Plur
Aman sus , kapa almacı ...	kapa	3	Sing
Ne tuhaf , daha önce dikkatimi çekmemişlerdi .	çekmemişlerdi	6	Plur
İçim yandı .	yandı	1	Sing
Koray , bilim etkinliğinin tarih içindeki serüvenini geleceğe de uzanarak analiz ederken dosyamıza güzel bir giriş de yapıyor .	giriş	15	Sing
Bakma hoşnut görünmesine , aklı başka yerde .	Bakma	0	Sing
Bu yola başvurun , dedi .	başvurun	2	Plur
Önce tanıştılar .	tanıştılar	1	Plur
Tombul dizleri , masanın altından Mahmut'un dizlerine yapışmıştı .	yapışmıştı	7	Sing
Öbür bardağı da doldurdu , döke saça .	saça	6	Sing
Dil bükmüş , bize uydurmuşuz .	uydurmuşuz	4	Plur
Bu raporlardan birer fotokopi aldılar .	aldılar	4	Plur
Ama onu bir daha gören olmadı .	olmadı	5	Sing
Kırılacak kızım yavaş .	Kırılacak	0	Sing
Bilim ile din arasındaki mücadele , burjuvazi ile feodalizm arasındaki mücadelenin ideolojik plandaki yansımasını oluşturmuş ve Bilimsel Devrim , siyasal düzlemde demokratik devrimlerin yolunu açmıştır .	açmıştır	24	Sing
Olur , alayım .	alayım	2	Sing
Kimi politikacıların , ekonomistlerin , stratejistlerin siyasi , iktisadi ve sosyal kuşku dalgalarına rağmen gemi yürüyor ...	yürüyor	15	Sing
Annem parmaklarını avcuna bir bir kapatarak anlatıyor : Bir kere işe güce hiç sebat etmemiş .	anlatıyor	6	Sing
Öğleden sonra kanallar kıyısında dolaşırken , sanki uzun yıllardır buradaymışım , hep de kanallar kıyısında dolaşıp durmakla vakit tüketirmişim gibi geliyordu bana .	dolaşırken	4	Sing
Önüne gelenle yatıp kalkıyormuşum .	kalkıyormuşum	3	Sing
Bahse girebilirdim ki : i ) şu anda Kemal'in ortaya attığı fikirler bugün değilse bile yarın genel kabul görecektir .	görecektir	18	Sing
Üstünde bir atlet vardı .	vardı	3	Sing
Oysa askeri savcılığın takipsizlik kararında pervane buzlanmasından değil , motor buzlanmasından dolayı uçağın düştüğü ifade ediliyordu .	ediliyordu	15	Sing
Belki ahirette başına gelecekler değişmiyor , ama şu dünyada yaşarken daha komplekssiz , daha nazik ve daha hoşgörülü olabiliyorsun .	değişmiyor	4	Sing
Cennet bekçisi İrfan oynamayı bırakıp bir köşeye çekilmişti .	çekilmişti	7	Sing
Hep kıyasladılar bizi .	kıyasladılar	1	Plur
Aklından sil böyle düşünceleri .	sil	1	Sing
Kapıyı itiyorum , zorluyorum , tam biraz açılır gibi oluyor , gene kapanıyor .	açılır	7	Sing
Ve o bitmemiş yapı , içinde yaşandıkça evleşiyordu .	evleşiyordu	7	Sing
Usulde bir hata yoktu , başvuru reddedilmişti .	reddedilmişti	6	Sing
Adını önce İngiltere ve Amerika'da duyuran Çağlayan , Paris'te yükselen yıldızını , başkentin gözde konser salonlarından ' Salla Gaveau'daki çılgın defilesiyle ' en iyiler ' arasına yazdırdı .	yazdırdı	26	Sing
Gülce , incecik de olsa altın bilezik alabiliriz , diyor .	alabiliriz	7	Plur
Aç şimdi .	Aç	0	Sing
Ben de sakız çiğnemekle ayıp arasında bir bağlantı kuramıyorum .	kuramıyorum	8	Sing
dörtyüzotuz trilyon ciroyla Türkiye'nin en büyük yirmiüç'üncü kuruluşu olan TPAO ve ikibinbir yılı vergi rekortmeni Kıyı Emniyeti , gelirlerinin yüzde on'unu bütçeye aktaracak .	aktaracak	22	Sing
Şaka bir yana yakıştık birbirimize .	yakıştık	3	Plur
Bir süre kepenkleri inmiş dükkanların önünden yürüdüm , gece zamanı karanlık ve sessiz duran şadırvana bir göz attım .	attım	17	Sing
Aşınmış mermer merdiveni tırmandım .	tırmandım	3	Sing
Bana bak , geliyorum yanına ha , kalk haydi !	kalk	7	Sing
Gerçi ben kendi kendime idare ederdim ama şu dersler yok mu , o konuda kesinlikle yardıma ihtiyacım vardı .	ederdim	5	Sing
Eyvah ! Mantara basıyoruz galiba .	basıyoruz	3	Plur
Böyle bir acı var mı ? Ölüm şekline dua ediyoruz .	ediyoruz	9	Plur
Yandaki odanın kapısını vurdum .	vurdum	3	Sing
Ben annemden izin koparabilmek için onca dil dökmüş , onca gün sabırla beklemiştim .	dökmüş	7	Sing
Fezlekede , Almanya'daki bazı Türk vatandaşlarının " dolandırıcılık " iddiasıyla Akgündüz hakkında suç duyurusunda bulundukları belirtildi .	belirtildi	15	Sing
Bu rahat davranışlı New Yorklu kız , tedirginlikleri büyütmeye elverişli içimi sakinleştirmişti .	sakinleştirmişti	11	Sing
Tamam kapatıyorum .	kapatıyorum	1	Sing
Önce gözlerimin önüne Zübeyde'nin yeğenlerini getirmeye çalıştım .	çalıştım	6	Sing
Ayakta alkışladık .	alkışladık	1	Plur
Ve de yapabiliyorlar .	yapabiliyorlar	2	Plur
Bahse girebilirdim ki : i ) şu anda Kemal'in ortaya attığı fikirler bugün değilse bile yarın genel kabul görecektir .	girebilirdim	1	Sing
Sevilme peşinde koşan ve sevmeyi bilemeyen iki genç , yasal ve yasal olmayan uyuşturucuların etkisiyle sevme oyunu oynayacaklar ve minik bağımlı çocuklar dünyaya getirecekler .	getirecekler	23	Plur
Öyleyse ben de oturup bir üvey baba masalı yazayım .	yazayım	8	Sing
Allah Allah , bu da nereden çıktı ? diye sormadık , şaşırmadık .	şaşırmadık	11	Plur
Şimdi adımlarını daha da hızlandırmıştı .	hızlandırmıştı	4	Sing
Şimdi içeriye girip onu Mahmut'a vereceğim , dedim .	vereceğim	5	Sing
Havaalanından yaklaşık otuz kişiyi aramış , herkesle şakalaşıp vedalaşmış .	vedalaşmış	8	Sing
Gülüşüp itişiyorlar .	itişiyorlar	1	Plur
- Ben de yazdıklarımı sana gösteririm .	gösteririm	5	Sing
Ama asıl avuçları iyi tanıyordu o cetveli .	tanıyordu	4	Sing
Nasıl başlayacağımı bilemiyorum .	bilemiyorum	2	Sing
Poynter direktörü Bob Steele , " Bence ' biz intihar haberi hiç vermiyoruz ' düşüncesi de açıkça sorgulanmalı " diyor .	vermiyoruz	12	Plur
Ben , içeriye giremiyorum , dedi .	giremiyorum	3	Sing
Kadına baktım , havalıydı , hoştu .	baktım	1	Sing
Kız içeri girmedi .	girmedi	2	Sing
Bazı geceler kulağımı kapısına dayar , dayak yerken attığı çığlıkları dinlerdim .	yerken	7	Sing
Gecenin hangi saatinde eve dönsem de , yakındaki açık gece mağazasından yiyecek birşeyler alabilirdim .	dönsem	4	Sing
İnsanlar , beyinlerinde ya da genlerinde mantıkla donanmış olarak doğmazlar .	doğmazlar	9	Plur
İşte geldik gidiyoruz , dedim , sana bir şey sormak istiyorum .	geldik	1	Plur
Olur olur ...	Olur	0	Sing
Arkaya taranmış .	taranmış	1	Sing
Derken , ev sahibi beyan değiştiriyor .	değiştiriyor	5	Sing
Bir süre sessiz yürüdük .	yürüdük	3	Plur
Cebimdeki jetonları şıngırdattım .	şıngırdattım	2	Sing
Şimdi ikimiz yan yana koşar adım gecenin içinde ilerliyorduk .	ilerliyorduk	8	Plur
Yaşamöyküsünü sürdürelim .	sürdürelim	1	Plur
Bu heyecana nasıl dayanabilirim . diye mırıldandı Celal .	mırıldandı	6	Sing
