Na przemian straszą i obiecują .	straszą	2	Imp
Shimada wyznaczył więc ludzi i za chwilę wnętrze góry poczęło błyskać upiornym światłem palników i ożywiło się znów koszmarną krzątaniną .	poczęło	9	Perf
Nasilił się w październiku 2000 roku .	Nasilił	0	Perf
Turska przyznała , że jest przerażona , bo nie wyklucza , że nastolatka mogła zarazić inne osoby .	przyznała	1	Perf
Niestety później zatracił już swą skuteczność .	zatracił	2	Perf
Ponieważ na pukanie nikt nie reagował , policjanci wyważyli drzwi .	wyważyli	8	Perf
Nikt nie lubi spowiadać się u niego .	spowiadać	3	Imp
Cudem przeżyła 9-letnia dziewczynka .	przeżyła	1	Perf
Nawet kiedy sami tego żądają .	żądają	4	Imp
Preferujesz moralnośc opartą na miłosci bliźniego ?	Preferujesz	0	Imp
Ułoży się most , star przejedzie , kratownice wrócą na miejsce , zatrzemy ślady i poczekamy .	zatrzemy	12	Perf
Teraz odejdę .	odejdę	1	Perf
Za linią lasu błysnęła w słońcu blacha na wieży kościoła .	błysnęła	3	Perf
Przerażona dziewczyna pobiegła do ciotki , która mieszka za ścianą , i w sekrecie opowiedziała , co robił jej tata .	pobiegła	2	Perf
Jak kłamała .	kłamała	1	Imp
Chciała m go objąć , ale mnie odsunął .	odsunął	7	Perf
Przewidywał to i myślał , że jest gotowy , ale skwierczący żar w piersi uświadomił mu , że nigdy nie byłby na to gotowy .	Przewidywał	0	Imp
Napastnik skuł ofiarę kajdankami i zgwałcił .	skuł	1	Perf
Przyjechał em , żeby ratować Gruzję .	Przyjechał	0	Perf
Przyznam , że sam był em zdziwiony . . .	Przyznam	0	Perf
A to dlatego , że norwescy słuchacze nie cenią artystów wykreowanych przez wielkie wytwórnie .	cenią	8	Imp
Za Wankiewiczem ja sam głosował em .	głosował	4	Imp
Myślała ś o mnie .	Myślała	0	Imp
Z początkiem bieżącego roku Ministerstwo Oświaty i Wychowania podwyższyło uczniowskie stypendia .	podwyższyło	8	Perf
- Oszukali ciebie , od dwustu lat próbują oszukać naszą rodzinę .	Oszukali	1	Perf
- Ciągle nasłuchujesz ?	nasłuchujesz	2	Imp
Utworzył em to hasło , ponieważ nikt wcześniej go nie utworzył .	Utworzył	0	Perf
Przerwał na chwilę chwytając świszczący oddech .	chwytając	3	Imp
– Mama gładzi dłoń Dziadka .	gładzi	2	Imp
Odwróć go trochę na bok , już dosyć cię opaskudził .	Odwróć	0	Perf
Niech to diabli wezmą .	wezmą	3	Perf
Leci z Milwaukee do Pekinu na chiński Nowy Rok .	Leci	0	Imp
Cieszymy się , że ojciec przybył , brakuje nam ludzi .	Cieszymy	0	Imp
musztarda szybko wysycha .	wysycha	2	Imp
Polska i Izrael podpisały wczoraj umowę o zniesieniu obowiązku wizowego .	podpisały	3	Perf
Głosowali śmy za powołaniem komisji śledczej .	Głosowali	0	Imp
Od tego zależą losy SLD .	zależą	2	Imp
- Nawet po śmierci potrafisz się kurwić .	kurwić	6	Imp
Wrócił em do biura i natychmiast zadzwonił em na policję .	zadzwonił	6	Perf
Szczególne podziękowania kierujemy do rodziców naszych wychowanków .	kierujemy	2	Imp
Nieźle tam zarabia , ale niejednokrotnie chwali się drogimi rzeczami kupionymi za pieniądze , które syn tego pana zostawia na utrzymanie ojca .	chwali	6	Imp
Na czas hakafot policja zamyka ulice , żeby było gdzie tańczyć .	zamyka	4	Imp
Nie wyobrażała sobie dnia bez muzyki , ale słuchała jej w czterech ścianach , odtwarzanej z płyt .	słuchała	8	Imp
Całość realizacji miała kosztować 8 tys . euro .	kosztować	3	Imp
Bywało , że już nawet policjanci przeganiali go do domu .	przeganiali	6	Imp
Wessie je mózg , wątroba , rurką pępowiny popłyną do Poli .	Wessie	0	Perf
Książka Jarosława Gowina nie szczędzi gorzkich słów wszystkim stronom .	szczędzi	4	Imp
Ciężko dyskutować z przekonaniami .	dyskutować	1	Imp
Jest wychowankiem Sportulu Studenţesc , w którym łącznie występował przez dziewięć lat .	występował	8	Imp
Taboret upadł z dramatycznym łoskotem , a on , wierzgając nogami , zawisł niczym gotowy do wypatroszenia wieprz .	upadł	1	Perf
Wszyscy spojrzeli na mnie .	spojrzeli	1	Perf
Trudniej było się zdecydować , na co pójdę .	pójdę	7	Perf
Zgadzając się co do celu , uważamy , że metoda jego osiągnięcia nie jest dobra .	uważamy	6	Imp
Musi dbać o swoją kobietę .	Musi	0	Imp
W wyniku nieadiabatycznego ochładzania najniższych warstw troposfery powstają , ogólnie biorąc , najniższe chmury warstwowe .	powstają	7	Imp
Zaczęło się od tego , że kupili śmy koledze na urodziny tarczę i sami zaczęli śmy grać .	kupili	6	Perf
Rozrywka jest kołem zamachowym telefonii komórkowej , a MMS bardzo ją uatrakcyjnią .	uatrakcyjnią	11	Perf
Jerzyk szepnął mi .	szepnął	1	Perf
Tu latają cyklony , podejdą wyżej , będzie wiało od wyżu .	wiało	8	Imp
Zatrzymał traktor .	Zatrzymał	0	Perf
Stanisława Mackiewicza , Cata , trudno scharakteryzować .	scharakteryzować	6	Perf
Trzeba się spieszyć , bo lada moment pojawią się posłowie IV kadencji .	pojawią	7	Perf
Moneta długo szukał odpowiedniego znaku .	szukał	2	Imp
Cofnął nogę ze sprzęgła , silnik zaskoczył .	Cofnął	0	Perf
Opłaciła m telefon .	Opłaciła	0	Perf
Prawdopodobnie dopiero w sobotę zdradzi swoje zamiary .	zdradzi	4	Perf
Mieszka pod Warszawą , a w swoim pięciohektarowym gospodarstwie , oprócz dwudziestu psów , hoduje także konie i kozy .	hoduje	14	Imp
Co dzień , wychodząc ze szkoły , oglądał się jeszcze , jakby już jutro nie miał jej zobaczyć .	oglądał	7	Imp
Składem do Kołobrzegu pojechało 150 dzieci .	pojechało	3	Perf
- Niech pani się przyjrzy tekstowi mojego wystąpienia .	przyjrzy	4	Perf
Pięciu marynarzy niszczyciela poniosło śmierć a dwóch odniosło ciężkie rany .	odniosło	7	Perf
Rzecznik Białego Domu odmówił jednak ich podania , informując tylko , że dowody zostaną przekazane inspektorom ONZ w Iraku .	informując	8	Imp
Nie zajedziesz nigdy , nie odwiedzisz .	odwiedzisz	5	Perf
Rzecznik armii powiedział , iż na miejscu dokonano aresztowań .	dokonano	7	Perf
- Wybaczy pan , Profesorze . . .	Wybaczy	1	Perf
Na Zalewie Szczecińskim z trudem przedzieramy się przez gęstą krę lodową .	przedzieramy	5	Imp
Ułanów nie powstrzymała nawet wichura i są już na półmetku .	powstrzymała	2	Perf
Poseł Unii Wolności Grzegorz Schetyna uważa , że premier powinien teraz wykazać się refleksem i przedstawić pomysł na dalsze funkcjonowanie całego rządu .	wykazać	11	Perf
- Sama zatelefonuję .	zatelefonuję	2	Perf
Ale powstają rzeczy wspaniałe . . .	powstają	1	Imp
Katastrofy przewidzieć się nie da .	przewidzieć	1	Perf
W XVII wieku hikyaku , czyli kurierzy , doręczali przesyłki feudalnym władcom .	doręczali	8	Imp
Jął przeciskać się przez zaporę , czołgał się przez rumowisko , zmiażdżone wózki .	Jął	0	Perf
- Nie sypiasz od dawna , co się dzieje ?	sypiasz	2	Imp
– Puśćcie !	Puśćcie	1	Perf
Chłopak umilkł .	umilkł	1	Perf
Nie musiał się zalecać ani kokietować .	zalecać	3	Imp
Krytyka się o tym rozpisywała a on milczał .	rozpisywała	4	Imp
Malarz chwycił go mocno za ramię .	chwycił	1	Perf
Papierową śmierć zafundowali śmy już kilku osobom .	zafundowali	2	Perf
Sięgnęła do torebki .	Sięgnęła	0	Perf
Bydgoszczanin ogłosił w prasie , że poszukuje panienek do pracy w Niemczech .	ogłosił	1	Perf
Słyszymy dzwony z oddali , szczekanie psa , odgłosy zasypiającego Przymorza .	Słyszymy	0	Imp
Ciężko poranili kilkunastu policjantów .	poranili	1	Perf
Muszę to wszystko z siebie wydalić .	wydalić	5	Perf
– dzwonił ?	dzwonił	1	Imp
Turska przyznała , że jest przerażona , bo nie wyklucza , że nastolatka mogła zarazić inne osoby .	zarazić	14	Perf
Mężczyzna doznał licznych obrażeń .	doznał	1	Perf
- Bo się pierdolą .	pierdolą	3	Imp
Ukląkł em przy Mateuszu i szybko wcisnął em mu woreczek do ręki .	wcisnął	6	Perf
Pograć sobie od czasu do czasu nikomu nie zaszkodzi .	Pograć	0	Perf
Powracali tam ci dawno pożegnani .	Powracali	0	Imp
Czekać świtu .	Czekać	0	Imp
Mścić się nie będę . . .	Mścić	0	Imp
- Blondynka popatrzyła na tancerzy , którzy przy bufecie głośno rozmawiali z właścicielem knajpy .	popatrzyła	2	Perf
- Ja każdemu poradzę .	poradzę	3	Perf
Z konarów i pni wyczarowywał dziwne figury przywołujące na myśl słowiańskich bogów .	wyczarowywał	4	Imp
Nawet porządnie nie poczuła m .	poczuła	3	Perf
Malwina spojrzała na niego z odrazą , Kulesza się zaczerwienił , ale Ewa , o dziwo , parsknęła śmiechem .	parsknęła	17	Perf
- Co zechcesz .	zechcesz	2	Perf
Z wypłowiałego zdjęcia uśmiechała się azjatycka , młoda twarz pana Korzeniowskiego , wystrojonego w mundur zapięty pod szyją .	uśmiechała	3	Imp
Struś nic nie szczerzy .	szczerzy	3	Imp
Można ją wypatrzyć przez teleskop .	wypatrzyć	2	Perf
W tej sytuacji utworzono ligi międzyuczelniane .	utworzono	3	Perf
Olszak posadził pajacyka na tapczanie .	posadził	1	Perf
Sugerowała , że przed egzaminem można było kupić testy .	Sugerowała	0	Imp
I odnowi oblicze ziemi .	odnowi	1	Perf
Zwiedzili także Warszawę .	Zwiedzili	0	Perf
Trzech innych wytoczyło księdzu oddzielny proces .	wytoczyło	2	Perf
Gospodarze odpowiedzieli dwoma golami Ralfa Hauptmanna i Austriaka Tony Polstera .	odpowiedzieli	1	Perf
Teodor nie pozwolił sobie ich odebrać .	odebrać	5	Perf
Wierzą , że tym razem się uda .	uda	6	Perf
Nie przypuszczali , że któryś ośmieli się publicznie . . .	przypuszczali	1	Imp
Porucznik nie zamierzał wykładać swoich kart , a przynajmniej nie zamierzał robić tego od razu .	wykładać	3	Imp
Jędrusia przysiadła na brzegu .	przysiadła	1	Perf
Mężczyzna dotykał ciała dziewczynki w miejscach intymnych .	dotykał	1	Imp
Jak leczyć tę dolegliwość ?	leczyć	1	Imp
Radni powiatowi z Nowogródka zdecydowali wczoraj , że w rodzinnym mieście Adama Mickiewicza nie będzie polskiej szkoły .	zdecydowali	4	Perf
Dotknęła brudnego bandaża , którym owijała opornik .	owijała	5	Imp
Kompletnie pijany zjechał na lewe pobocze drogi i uderzył w drzewo .	zjechał	2	Perf
Kobiety przystrajają drzewko kolorowymi wstążkami , śpiewając przy tym tradycyjne pieśni .	przystrajają	1	Imp
Poprosił ekspedientkę o dostęp do telefonu , tłumacząc , że musi zadzwonić do swojego wspólnika .	tłumacząc	7	Imp
Zatarł ręce i pokiwał głową .	Zatarł	0	Perf
Choinka mieni się różnobarwnie , z bożonarodzeniowego bierwiona w kominku bije przytulne ciepło .	mieni	1	Imp
I zrozumieli ludzie , że tu Bóg był , i zburzyli ten sądowy dom , aby w nim nikt już więcej po Panu Jezusie nie sądził , a przed jabłonnymi drzewami postawili krzyż i on do dziś tam stoi .	sądził	25	Imp
Nawet załatwił em już sobie jedną , ale się nie odważył em .	odważył	10	Perf
Ale każdy powinien zachowywać się przyzwoicie !	zachowywać	3	Imp
Dlaczego się na to godził em ?	godził	4	Imp
Wszystko opłacę .	opłacę	1	Perf
Nie chcąc zaskoczyć krywów , starał się wywołać jak największy hałas .	zaskoczyć	2	Perf
Lubicie wyciągać z ludzi . . .	Lubicie	0	Imp
Poznaliśmy już nazirejczyków , ponieważ należał do nich Samson .	należał	5	Perf
Ta nie dopatrzyła się nieprawidłowości .	dopatrzyła	2	Perf
Wówczas koła łowieckie będą dbały , aby populacja nie rozrastała się ponad dopuszczalną .	rozrastała	9	Imp
Świadomie wybrał grę w pierwszej lidze .	wybrał	1	Perf
Bywa , że dzieci ulegają nam , podporządkowują się naszej woli .	podporządkowują	7	Imp
Odrywa dłonie i powoli zaczyna schodzić na parter , kierując kroki do kuchni .	Odrywa	0	Imp
Nad ranem z soboty na niedzielę z pędzącego pociągu wyskoczyła 17-letnia dziewczyna .	wyskoczyła	9	Perf
Rosjanie go wybrali , ale on sam siebie jeszcze nie wybrał .	wybrał	10	Perf
Kowalik i Stryjek zerwali się , drzwi do łazienki na szczęście były otwarte .	zerwali	3	Perf
Jeździł też mój kolo bankowiec .	Jeździł	0	Imp
Niemal wszystkie nici myśli kwestionującej prowadzą do Kartezjusza .	prowadzą	5	Imp
Wolała puszczać w kinach filmy kung-fu licząc , że dzięki temu ludzie przestaną myśleć o polityce .	przestaną	12	Perf
Pakistańczycy zarzucają Indiom stosowanie bomb kasetowych i bomb z napalmem .	zarzucają	1	Imp
Karolcia zaczerwieniła się i nic nie odpowiedziała .	zaczerwieniła	1	Perf
Wielu już marzy , aby w przyszłym roku zostać kantorem .	marzy	2	Imp
Wnętrze Ejakulatio błyszczało .	błyszczało	2	Imp
Może mają zamiar mnie rozwalić .	rozwalić	4	Perf
Już wrosłem w to środowisko i uważam , że potrafię pogodzić swoje sprawy .	pogodzić	10	Perf
Jak podały miejscowe rozgłośnie radiowe , wykoleiły się dwa wagoniki podziemnej kolejki .	wykoleiły	6	Perf
Około północy nadciągnął sztorm i śnieżyca .	nadciągnął	2	Perf
Wczoraj na lodowisko wylano wodę .	wylano	3	Perf
Polacy jadący w autokarze spoglądają z nietajoną dumą na wielkiego rodaka .	spoglądają	4	Imp
Przechodzień , który pomógł bitemu policjantowi , już dostaje pogróżki .	pomógł	3	Perf
Bił tak mocno , że złamał kij bejsbolowy .	Bił	0	Imp
Ojciec zajrzał przez drzwi .	zajrzał	1	Perf
- Przyjaciele chcą nas zaanektować !	zaanektować	4	Perf
Przetarł stół .	Przetarł	0	Perf
Nie wie nawet , kiedy jest sobota i kiedy wypadają żydowskie święta .	wypadają	9	Imp
Robię się czerwony i zeskakuję z okna .	Robię	0	Imp
Mógł być nadawany pośmiertnie .	Mógł	0	Imp
Wracajcie do Polski !	Wracajcie	0	Imp
Czyli oszukujesz prawowitą władzę .	oszukujesz	1	Imp
Często wykorzystujemy znajomości i dojścia zaprzyjaźnionych osób .	wykorzystujemy	1	Imp
Zdaniem fachowców urządzenie spisywało się dobrze .	spisywało	3	Imp
I przeczytaj coś o Simone de Beauvoir .	przeczytaj	1	Perf
Marta poczuła ukłucie .	poczuła	1	Perf
Wirował nad domami i zaczęło go trząść .	Wirował	0	Imp
Widownia westchnęła ze współczuciem , a Iwana to uskrzydliło .	westchnęła	1	Perf
Nadział em je na haczyk i zarzucił em .	Nadział	0	Perf
Przyjechali też strażacy z OSP z Poronina , Suchego i Kościeliska .	Przyjechali	0	Perf
Rycerzy głodno nie puszczą .	puszczą	3	Perf
Ręce mu drżały , gdy podnosił szklankę .	podnosił	5	Imp
Nadejdzie wówczas czas rozliczeń . . .	Nadejdzie	0	Perf
Przygryzając wargi z bezsilnej złości , Chmura wołał Adasia .	Przygryzając	0	Imp
Dzieci zaczepiali na katowickim dworcu PKP .	zaczepiali	1	Imp
Wolno przewrócił się na bok , wsparł się na łokciu .	wsparł	6	Perf
Siadam w kącie i usypiam , budząc się na Gare du Nord .	Siadam	0	Imp
Rodzice w różnym stopniu angażują się w wychowanie dzieci .	angażują	4	Imp
Nie znali się za życia .	znali	1	Imp
Nie kieruję się przy tym ideologią wegetariańską , choć z nią sympatyzuję .	sympatyzuję	11	Imp
Jeżeli ciasto troszeczkę rozlatuje się w oleju , oznacza to , że zostało prawidłowo przyrządzone .	rozlatuje	3	Imp
Nie próbuj go oświecać .	oświecać	3	Imp
Używają go specsłużby w ponad 40 krajach .	Używają	0	Imp
Moim zdaniem przesadzasz .	przesadzasz	2	Imp
Skończyło się .	Skończyło	0	Perf
Przestraszona Zosia schowała się za wózek .	schowała	2	Perf
Jakąś łzę pani uroniła ?	uroniła	3	Perf
Zmarłych żołnierzy francuskich i bawarskich pogrzebano na cmentarzu przykościelnym .	pogrzebano	5	Perf
- Wątpię .	Wątpię	1	Imp
Psy darły jamy , ziemia sypała się za ogonami .	sypała	5	Imp
Wieczorem zjawia się Witold .	zjawia	1	Imp
Ten ogromny magazyn przez całe wieki pozostawał niewykorzystany .	pozostawał	6	Imp
Twoje słowa trafiły na podatny grunt .	trafiły	2	Perf
Załadował na wóz wynajętych gazeciarzy i rozwiózł po mieście , każąc rozdawać list przechodniom .	każąc	10	Imp
To by mu rozwaliło żołądek .	rozwaliło	3	Perf
- Czy policjanci powinni ścigać złodzieja przyłapanego na gorącym uczynku , czy poprzestać na zabezpieczeniu mienia ?	poprzestać	12	Perf
Bywa , że dzieci ulegają nam , podporządkowują się naszej woli .	Bywa	0	Imp
PQBoot to narzędzie do zmiany partycji bootującej dla tych użytkowników , którzy tylko od czasu do czasu potrzebują skorzystać z innego systemu .	potrzebują	17	Imp
Zawalili śniegiem całą górę nierówno i musiało strzelić .	strzelić	7	Perf
Ktoś inny w złości kopie ławkę i rzuca głośno soczyste przekleństwa .	kopie	4	Imp
Czy dowiozą ?	dowiozą	1	Perf
Powoli powracał rozsądek .	powracał	1	Imp
- Czy twój bóg zapewnił cię o tym ?	zapewnił	4	Perf
Palce Szczyrbka ściskały coraz mocniej .	ściskały	2	Imp
Polonia zagrała bez trzech piłkarzy z podstawowego składu .	zagrała	1	Perf
- Pani Salach kazała śledzić każdy jej krok i informować o każdym błędzie .	kazała	3	Perf
Żółty krawat tylko mu fruwa na wietrze , kurtka rozpięta .	fruwa	4	Imp
- Ogłoszenie przetargu przeciąga się ostatnio z tego powodu .	przeciąga	3	Imp
Psy grzebały w śmietniku .	grzebały	1	Imp
spytasz się Wojtka w piątek ?	spytasz	0	Perf
Podrożały stanowiska .	Podrożały	0	Perf
Zdaje się , że wpatrywała się we mnie od dłuższego czasu .	Zdaje	0	Imp
Ja sama zaniosę .	zaniosę	2	Perf
Za stanami zniechęcenia i depresji kryją się zwykle głębsze konflikty i problemy wewnętrzne , wyniesione głównie ze środowiska rodzinnego .	kryją	5	Imp
Dzieci zgodnym chórem twierdzą , że nawet mama nigdy nie gotowała lepiej .	gotowała	10	Imp
Warnecke , wolę tego nie opisywać .	opisywać	5	Imp
Teraz zawiązał em sobie sznurkiem . . .	zawiązał	1	Perf
Bogu zawierzam i w Bogu pokładam nadzieję .	pokładam	5	Imp
Mogę się tylko domyślać , że mechanicy zabiją barana , który od rana obgryza skraj plastikowego worka , i przyniosą mi moją część .	domyślać	3	Imp
Zdążyli . . . ?	Zdążyli	0	Perf
Cofnął się jak oparzony , gdy fala obmyła mu łapy .	Cofnął	0	Perf
Bo krzyż zdążono już umieścić na ścianie katedry górującej nad miastem .	umieścić	4	Perf
Szosa zwężała się i wydłużała , drzewa uciekały .	uciekały	7	Imp
- Wrogowie czyhają na nasze ziemie !	czyhają	2	Imp
Machała m mu fartuchem , żeby lądował na łące pod lasem , ale ten chłopak chyba się przestraszył , że zawadzi o druty .	Machała	0	Imp
Ale czy się uda ?	uda	3	Perf
- Zamierzałam ją wyrzucić .	wyrzucić	3	Perf
Może w dużych ośrodkach miejskich ludzie zagłosują na Juszczenkę , ale we wsiach poparcie dla Janukowicza będzie ogromne .	zagłosują	6	Perf
Nie zrobiono nic .	zrobiono	1	Perf
Wsuwa się pod głowę leżącego , błądzi palcami po jego twarzy .	błądzi	6	Imp
- Tydzień temu koń go stratował i też tak mówił .	stratował	5	Perf
W ten sposób podbijają cenę .	podbijają	3	Imp
Idę coś zjeść .	Idę	0	Imp
- Zbądź obawy , ojcze .	Zbądź	1	Perf
- Nie dało się jej przyszyć .	przyszyć	5	Perf
Nieboszczyk ojciec zawsze nam to śpiewał i na pedałowej harmonii sobie podgrywał .	śpiewał	5	Imp
Przytul się mocno I podnieś głowę Patrząc w ich oczy Moim spokojem .	Patrząc	6	Imp
I doczekać z antykaczyńskim rządem do jesiennych wyborów .	doczekać	1	Perf
Wówczas pan Olewnik jeszcze wierzył , że nowa grupa działa sprawnie i robi wszystko , by odzyskać jego syna . . .	wierzył	4	Imp
Kierowca wrzuca wsteczny i na pełnym gazie taranuje pieszych .	taranuje	7	Imp
Trzecioligowcy strzelili kontaktowego gola , ale w ostatnim kwadransie dwie bramki dla Lecha wypracował Remień .	wypracował	13	Perf
Oznacza to , że zgadzają się one na taką praktykę .	zgadzają	4	Imp
Wolski szybko przeczytał meldunek .	przeczytał	2	Perf
Prokuratura nie przedstawiła mu zarzutów .	przedstawiła	2	Perf
Dzięki afirmowaniu niewinności pozostajesz w niewinności .	pozostajesz	3	Imp
Wiedział em , że przyjdziecie .	przyjdziecie	4	Perf
Wizytator przeprosił kierownika i udał się z powrotem do klasy szóstej .	przeprosił	1	Perf
Albo ubić faceta z wiecznie zadartym ornamencikiem w rozporku .	ubić	1	Perf
- Są to różne pojęcia i nie sądzę , aby można było je mieszać , jeśli chcemy uniknąć nieporozumień .	mieszać	13	Imp
Zmienia się też skład wspólnoty żydowskiej w stolicy .	Zmienia	0	Imp
Policjanci jedynie pouczyli kierowcę i sporządzili notatkę służbową .	sporządzili	5	Perf
Jak próbował eś sobie z nimi radzić ?	radzić	6	Imp
755 tys . zł od Ministerstwa Edukacji Narodowej zażądał starosta człuchowski .	zażądał	8	Perf
Niech pan pomyśli , jaką rodzice mieli by niespodziankę , gdyby pan ukończył siedem klas .	pomyśli	2	Perf
O tych wszystkich wydarzeniach Agnus dowiedział się z opóźnieniem , gdyż rodzice w pierwszym okresie nie chcieli przekazywać mu złych wiadomości .	przekazywać	17	Imp
Młodzi mieszkańcy Skarżyna nie widzą sprawy tak czarno .	widzą	4	Imp
Bywało bardzo różnie .	Bywało	0	Imp
Naszego Piotrusia w zasadzie od początku fascynowały cienie .	fascynowały	6	Imp
O tym , czy odejdzie , zadecyduje premier .	zadecyduje	6	Perf
Faktem jest , że nawet Hitler nie oczekiwał aż takiej reakcji Stalina .	oczekiwał	7	Imp
Nie muszę używać trybu przypuszczającego .	używać	2	Imp
otworzę kanały elektryczne i niech wlezie tam . .	wlezie	5	Perf
- Lepiej się na razie pomartwić , niż samochód stracić .	stracić	9	Perf
– za dwadzieścia minut się zbieram . .	zbieram	5	Imp
Do samolotu wolno zabrać bagaż podręczny o wadze 5 kg .	zabrać	3	Perf
Tego sen nie pokazuje .	pokazuje	3	Imp
Niewielkie zmiany odczują osoby oddające krew .	odczują	2	Perf
Mają powiadomić .	powiadomić	1	Perf
Wojciech Onyszkiewicz działa społecznie .	działa	2	Imp
Patrz przed siebie i czytaj w brodzie .	czytaj	4	Imp
Powiodła m oczami dookoła i nagle zastygła m z przerażenia .	Powiodła	0	Perf
Wsparł go Wierchowicz .	Wsparł	0	Perf
Potem podniosł em rękę .	podniosł	1	Perf
Zareagowała zaskoczeniem .	Zareagowała	0	Perf
- Wyciągnij go spod ziemi , ale muszę go mieć dzisiaj .	Wyciągnij	1	Perf
Ruszyli bez żadnych kłopotów , reflektory oświetliły drogę i pnie przydrożnych drzew .	oświetliły	6	Perf
W Krakowie symbolizowały je deski .	symbolizowały	2	Imp
To się jakoś splata w jedno .	splata	3	Imp
Z nieba leje się żar .	leje	2	Imp
Patrzył na nią bez słowa .	Patrzył	0	Imp
Dochodzenie w sprawie wypadku wszczęła Prokuratura Rejonowa w Szczytnie .	wszczęła	4	Perf
Dyrektoriat ten funkcjonował zgodnie , dopóki istniała równowaga sił w rządzie .	funkcjonował	2	Imp
Brzęcząc pustymi kuflami , weszła do środka .	Brzęcząc	0	Imp
Odwinęła się z fartucha .	Odwinęła	0	Perf
Upuścił żądło .	Upuścił	0	Perf
SDPL nie zamyka się .	zamyka	2	Imp
Przylgnął do niej z całych sił .	Przylgnął	0	Perf
Poznali śmy też nowych drugoligowców .	Poznali	0	Perf
W ciemnym miejscu chodnika do samotnie idącej dziewczyny podbiegł mężczyzna i zgwałcił ją .	podbiegł	8	Perf
Pewnie się nam przyśniło .	przyśniło	3	Perf
Szlocha , jest załamana .	Szlocha	0	Imp
Opodal przeciągnięto niedawno linię wysokiego napięcia .	przeciągnięto	1	Perf
Ciała te noszą ślady tortur .	noszą	2	Imp
Wypytywała rodaków o Warszawę , interesowała się przeżyciami Tomka w czasie wyprawy i nawet namawiała go usilnie , aby pozostał w Australii .	namawiała	14	Imp
Wycofali się .	Wycofali	0	Perf
Miliony ludzi straciło oszczędności całego życia .	straciło	2	Perf
Niewiele brakowało , by zaproponowała odstrzał niegrzecznych myśliwych polujących na kuropatwy .	brakowało	1	Imp
Z relacji świadków wynika , że 60-latek nagle upadł .	upadł	8	Perf
Wizytator pokręcił surowo głową .	pokręcił	1	Perf
Rozbieram się do snu .	Rozbieram	0	Imp
- Gramy !	Gramy	1	Imp
Po lewej mam kościół , ludzie z niego wychodzą i do niego wchodzą .	wchodzą	12	Imp
Wydawało się , że fiskus nie będzie dłużej gnębił Waldemara Gronowskiego , legnickiego piekarza , który przez ponad 10 lat rozdawał pieczywo najuboższym .	rozdawał	20	Imp
Wszystkie psy świata mogły mu w tym momencie naskoczyć .	naskoczyć	8	Perf
Przyjrzyj się fotografiom i rysunkom w podręczniku przedstawiającym przykład krajobrazu śródziemnomorskiego .	Przyjrzyj	0	Perf
Poza tym powinna być bardziej dostępna dla zainteresowanych osób , które zechcą przechować w nim ważne osobiste dokumenty .	przechować	12	Perf
Zamieszkała w budynku , w którym mieści się szkoła podstawowa i tam rozpoczęła pracę jako nauczycielka .	mieści	6	Imp
– nie mącimy na komputerze . .	mącimy	2	Imp
Stamtąd te dane przekazuje do wojewódzkich stacji epidemiologicznych .	przekazuje	3	Imp
Marta poczuła ukłucie .	poczuła	1	Perf
O tym , że dzieci przeżywają koszmar , dorośli dowiadują się najczęściej przypadkiem .	przeżywają	5	Imp
- Obejrzyj go sobie dokładnie .	Obejrzyj	1	Perf
W milczeniu spożywali zimną konsolację , szczękały sztućce , dworscy w ciemnych surdutach sprawnie zmieniali misy .	spożywali	2	Imp
Nowa ustawa zobowiąże szefów do zakupu okularów korekcyjnych dla pracowników , którzy potrzebują ich podczas wykonywania swoich zajęć .	potrzebują	12	Imp
Spotkał się ze stanowczą odmową .	Spotkał	0	Perf
Bardzo żałuje , że robił dotąd .	żałuje	1	Imp
Tymczasem ktoś wykradł rysunki kości i wysłał je do Paryża .	wysłał	6	Perf
Ale wstrząsające relacje wywołały debatę na temat stosowania przymusu przy kontroli urodzin .	wywołały	3	Perf
Ponadto można eksportować dane do pliku tekstowego z uwzględnieniem wybranych kolumn i sposobu sortowania .	eksportować	2	Imp
Nigdy się nie bał .	bał	3	Imp
Szynkarz kłaniał mu się nisko .	kłaniał	1	Imp
Stanowią one razem z rzodkiewką potrawę pełnowartościową , dając jednocześnie ciekawy efekt dekoracyjny .	dając	8	Imp
Kościół nie zobowiązuje katolików do tego , aby wierzyli w cuda .	wierzyli	8	Imp
Obowiązują wizy , odprawa paszportowa , a przy wyjeździe celnik gruntownie przeszukuje rzeczy w poszukiwaniu skarbów , których tak wiele stąd ukradziono .	Obowiązują	0	Imp
Zapalono wszystkie lampy , ustawiono ruchome wieszadła , kelnerzy w oczekiwaniu gości spacerowali po korytarzach hotelowych .	Zapalono	0	Perf
Zatkało go .	Zatkało	0	Perf
Ale po pierwsze czuł się głęboko skompromitowany , a po drugie wydawało się wątpliwe , żeby mógł jeszcze coś w tamtym środowisku osiągnąć .	wydawało	11	Imp
Biedny Wojtek wysługuje się .	wysługuje	2	Imp
Mądrzej było by ominąć go szerokim łukiem .	ominąć	3	Perf
czy ty wierzysz w świat radykalnie wegetariański ?	wierzysz	2	Imp
Dziewczyna po raz kolejny nie stawiła się na rozprawę , choć osobiście odebrała wezwanie .	odebrała	12	Perf
Specjalne karty parkingowe obowiązuja od wczoraj niepełnosprawnych kierowców .	obowiązuja	3	Imp
Zarzuty usłyszały 33 osoby .	usłyszały	1	Perf
Zrobiła to , bo skazany jest wzorowym więźniem .	Zrobiła	0	Perf
Wanna nie nasunęła mi żadnych skojarzeń , była normalną wanną .	nasunęła	2	Perf
Pawłowi M . zarzuca się również , że działał z zamiarem spowodowania ciężkiego kalectwa rzucając nożem w głowę włoskiego piłkarza Dino Baggio .	zarzuca	3	Imp
Ale i wiem , że teraz kłamiesz .	kłamiesz	6	Imp
Odświeżyć go .	Odświeżyć	0	Perf
Napadła ś na Kucyka , a to jest ich człowiek w terenie i nie dadzą go ruszyć .	ruszyć	16	Perf
Odpalił to makro , nawet nie wychodząc z trybu edycji .	Odpalił	0	Perf
Polacy na razie nie potrafią się do tego zabrać .	zabrać	8	Perf
Dunlong zamachał rękoma .	zamachał	1	Perf
Poprawkę 45 . już rozpatrzyli śmy .	rozpatrzyli	4	Perf
Przymknął oczy i trwał w zadumie nie słysząc nawet roztrzepanej gadaniny niezliczonych wróbli .	słysząc	7	Imp
- Ty spróbował eś .	spróbował	2	Perf
Maluchy i starsza młodzież spędzały tam czas po lekcjach , ucząc się i bawiąc .	bawiąc	13	Imp
Specjaliści przewidują , że cena za tonę pszenicy nie przekroczy 380 złotych .	przewidują	1	Imp
Polska historiografia powoli wybija się na normalność .	wybija	3	Imp
– Pozwólmy Michałowi Karnowskiemu .	Pozwólmy	1	Perf
o wzięło by się czyściochę . .	wzięło	1	Perf
Wszystko błyszczy , kręci się , tańczy .	błyszczy	1	Imp
Łapcie się za portfele !	Łapcie	0	Imp
Przyniosła m mu dodatkowy klucz .	Przyniosła	0	Perf
Termin ten nie może przekraczać dwóch tygodni .	przekraczać	4	Imp
Zaprosili śmy ich , ale paczek nie będzie .	Zaprosili	0	Perf
Zbigniew Brzeziński , doradca prezydenta Jimmy'ego Cartera do spraw bezpieczeństwa , zaapelował o umiar do robotników , władzy i Kościoła w Polsce .	zaapelował	11	Perf
- Mógł ofiarować Kaliszowi swoje obrazy .	ofiarować	2	Perf
Ale dzisiaj umysł mędrca od razu uleciał w stronę Ciemnej Gwiazdy .	uleciał	6	Perf
Czasem schodzisz na ziemię .	schodzisz	1	Imp
Shimada wyznaczył więc ludzi i za chwilę wnętrze góry poczęło błyskać upiornym światłem palników i ożywiło się znów koszmarną krzątaniną .	ożywiło	15	Perf
Przez tydzień włóczył się bez celu po Melbourne , wyczekiwał na rozkazy .	włóczył	2	Imp
Przejęli go demagodzy jak Gamsachurdia .	Przejęli	0	Perf
Z wnioskiem takim wystąpił naczelnik OSP Arkadiusz Pindral .	wystąpił	3	Perf
Nazajutrz Tomek osiodłał pony i razem z Dingiem wyruszył do parowu .	wyruszył	8	Perf
On się męczył , darł kartki , wyrzucał , wreszcie znalazł wersję , która wyrażała jego uczucia .	wyrażała	14	Imp
I wtedy mnie obskoczyli .	obskoczyli	3	Perf
Marchewą wstrząsnęła taka sugestia .	wstrząsnęła	1	Perf
Jej słowa wwiercają się w mózg , nie pozwalają zebrać myśli .	pozwalają	8	Imp
włożyła ś .	włożyła	0	Perf
Dziadek zamknął drzwi i przesunął korbę .	zamknął	1	Perf
Nieżyczliwi twierdzą , że wojewoda chorował inaczej .	chorował	5	Imp
Chodzę , chodzę .	Chodzę	0	Imp
- Wyśpijcie się i przyjdźcie rano .	Wyśpijcie	1	Perf
Napięta żyłka świsnęła i pękła w przeponie .	świsnęła	2	Perf
Studenci medycyny alarmują z kolei , że w przyszłym roku będą musieli zdawać egzamin dyplomowy , a nie ma jeszcze jego kryteriów .	zdawać	12	Imp
Serwisy , które go oferują , często zawierają wiele odnośników prowadzących do przykładowych , działających już stron .	zawierają	7	Imp
Słońce wyrwało się z pęt horyzontu i zaczęło uwalniać dusze z martwych ciał żołnierzy .	uwalniać	8	Imp
Ceny towarów i usług od stycznia ubiegłego roku wzrosły o 10,1 proc .	wzrosły	8	Perf
Po decyzji parlamentu zawiesiły działalność polityczną Batasuny .	zawiesiły	3	Perf
Woli produkować .	Woli	0	Imp
Dżabie odbiło się walerianą .	odbiło	1	Perf
Róża pamiętała dobrze ten dzień .	pamiętała	1	Imp
Inni nie wytrzymywali i popełniali samobójstwo .	wytrzymywali	2	Imp
Dowódca odczytywał ostatni rozkaz komendanta Armii Krajowej .	odczytywał	1	Imp
Aby pomóc przewodnikom w sporządzeniu spisu potrzebnych rzeczy , podajemy przykładowe zestawy sprzętu dla poszczególnych działów prac na kolonii .	podajemy	9	Imp
Skrzykują te , które wzbiły się za wysoko na wschodzący księżyc .	wzbiły	4	Perf
Ale oni szybko domyślają się prawdy .	domyślają	3	Imp
O piątej przyszli Hauboldowie , zrobili śmy im herbatę i było dość przyjemnie .	zrobili	5	Perf
Został em tutaj i ja .	Został	0	Perf
Nie chcę nic sugerować , ale jest tam jedna fajna , prawie bezbłędna poetka .	sugerować	3	Imp
Nie był nigdy na polowaniu , a całą sympatię rezerwował dla zwierzyny .	rezerwował	9	Imp
- Dopóki rząd i koalicja nie podejmą decyzji , dopóty każdy może wypowiadać swoje zdanie .	podejmą	6	Perf
W ogrodzie tego domu wznosiły się kiedyś pawilony obserwacyjne .	wznosiły	4	Imp
Wcisnął pan Bogucki czapkę na głowę , dopiął kufaję i wypadł z pokoju .	Wcisnął	0	Perf
Organizatorzy postarali się też o prezenty dla wykonawców .	postarali	1	Perf
Również wysokie pozycje zajęły inne polskie załogi .	zajęły	3	Perf
Zadręczy nas .	Zadręczy	0	Perf
Hari nie gościł u niego od dziesięciu lat .	gościł	2	Imp
- Musimy zebrać ludzi , którzy chcą dokończyć rozpoczęte w 1981 roku dzieło .	zebrać	2	Perf
Jakoś się pogodzimy .	pogodzimy	2	Perf
Pies przekrzywiał głowę , jakby słuchał .	słuchał	5	Imp
Jego łupem padały głównie radioodtwarzacze i głośniki .	padały	2	Imp
- Zadzwoniła m i pokojówka mi przyniosła .	Zadzwoniła	1	Perf
Złożył głowę na wysokim oparciu fotela i przymknął oczy .	Złożył	0	Perf
Przez zwały gruzów ulicami miasta przebija się z trudem wojskowy Willys .	przebija	5	Imp
Samozwańczy gliniarz posługuje się oryginalną legitymacją .	posługuje	2	Imp
Gdy we wspomnianych dwu pionach narożnikowych ktoś się kąpie , wówczas woda spływa w dół nawilgacając po drodze niżej położone mieszkania .	spływa	12	Imp
Podczas jednego harcerze zaznajomili się z działalnością organizacji młodzieżowej w Syrii .	zaznajomili	3	Perf
- Nie da się tego odczytać .	odczytać	5	Perf
Napięta żyłka świsnęła i pękła w przeponie .	pękła	4	Perf
Udzieliła m mu wyczerpujących informacji .	Udzieliła	0	Perf
– przepraszam .	przepraszam	1	Imp
Sputnik zawirował po raz ostatni , zatrzymał się i zgasł .	zawirował	1	Perf
Prosze ułożyć mi coś , żeby ludzie zębami zgrzytali , włosy darli , płakali , ale i równocześnie wroga szukali . . .	Prosze	0	Imp
Zmieniła nieco swoją pozycję na łóżku .	Zmieniła	0	Perf
Prasa francuska opublikowała sporo takich zestawień .	opublikowała	2	Perf
Wiem , co zrobię .	zrobię	3	Perf
Do tego dochodzą rachunki za telefon , wydatki na materiały piśmienne , na znaczki .	dochodzą	2	Imp
Czasem przyjeżdżają do Nataszy z Polski rodzice .	przyjeżdżają	1	Imp
Ciągnęło mnie do Grażyny .	Ciągnęło	0	Imp
Nazirejczycy nie pili wina , nie strzygli włosów , nie spożywali rytualnie nieczystych potraw i nie mogli dotykać zmarłych .	pili	2	Imp
Wsuwa się pod głowę leżącego , błądzi palcami po jego twarzy .	Wsuwa	0	Imp
- Pływał em tam w ubraniu ?	Pływał	1	Imp
Akurat wtedy , gdy kadrowicze rozpakowywali w Warszawie swój sprzęt po powrocie ze zgrupowania w Barsinghausen , w kościele w Kazimierzu zebrał się tłum wiernych , który modlił się o powodzenie naszej drużyny w zbliżających się mistrzostwach świata .	zebrał	21	Perf
Księgowe potwierdziły , że działały w porozumieniu z kilkoma członkami spółdzielni .	potwierdziły	1	Perf
Nasz system polityczny ewoluuje w kierunku dwóch wielkich bloków .	ewoluuje	3	Imp
- Możliwość odejścia Leszka Balcerowicza bardzo zaniepokoiła inwestorów .	zaniepokoiła	6	Perf
Sama ich obecność dopingowała do działania .	dopingowała	3	Imp
Szerzyła się filozofia w najszerszym znaczeniu .	Szerzyła	0	Imp
W czwartek do egzaminu ustnego z historii przystąpiło 94 maturzystów , w piątek natomiast 59 miłośników biologii popisywało się wiedzą z tej dziedziny .	przystąpiło	7	Perf
Tusk też tak początkowo myślał lokalizując Muzeum Wojny na Westerplatte .	lokalizując	5	Imp
Wydeptuję schody , duszę dzwonki .	Wydeptuję	0	Imp
Zarodniki grzybów pleśniowych wywołują przede wszystkim zapalenie śluzówek nosa z niedrożnością , polipy nosa i zatok , ale też astmę o ciężkim przebiegu .	wywołują	3	Imp
Można się oczywiście zastanawiać , co młodego Johnsona tak pchało do faszyzmu czy nazizmu .	pchało	9	Imp
Agnus kipiał , bulgotał z wściekłości , ale wciąż jeszcze siedział cicho .	kipiał	1	Imp
Za linią lasu błysnęła w słońcu blacha na wieży kościoła .	błysnęła	3	Perf
Trafia się taksówka .	Trafia	0	Imp
Kościół zalega cisza .	zalega	1	Imp
Wznowią je w styczniu przyszłego roku .	Wznowią	0	Perf
Śpią w noclegowni koło lokomotyw .	Śpią	0	Imp
Następny dzień powitał Zlot słońcem .	powitał	2	Perf
Jeszcze po południu zawieszony prezes największego polskiego ubezpieczyciela nie wiedział , czy członkowie rady podejmą jakieś decyzje w jego sprawie .	podejmą	14	Perf
Wielka Rada zbierała się już ponad dwadzieścia lat , a nigdy nie doszło na niej do głosowania . . .	zbierała	2	Imp
Trochę potrwało , nim zrozumiała .	potrwało	1	Perf
– Oni się douczą .	douczą	3	Perf
Kąpać się w tej samej wodzie ?	Kąpać	0	Imp
Po chwili znów się odzywa .	odzywa	4	Imp
Woli produkować .	produkować	1	Imp
Moi kontrkandydaci reprezentują określone partie polityczne i tylko te partie .	reprezentują	2	Imp
Myśli i to udowadnia !	udowadnia	3	Imp
Było tak zmasakrowane , że myśliwi z trudem ustalili jego płeć .	ustalili	8	Perf
Stały otworem przed jego oczyma otchłanie .	Stały	0	Imp
- dodaje gen. Biel .	dodaje	1	Imp
Rozpaczliwie jęczał .	jęczał	1	Imp
„ Bawi się ze mną .	Bawi	1	Imp
Aureliusz słuchał kątem ucha , odbierając teczkę z depozytu .	odbierając	5	Imp
Menda jesteś i naprawdę już mię wkurzasz .	wkurzasz	6	Imp
- Co pan wiezie ?	wiezie	3	Imp
Ziuta uściskała go i ucałowała w oba policzki .	ucałowała	4	Perf
Wszystkim udało się wydostać na powierzchnię , mimo że woda dostała się już do wnętrza i otwarcie drzwi było bardzo trudne .	wydostać	3	Perf
Pracownię przekazano nieodpłatnie .	przekazano	1	Perf
Nie znali się za życia .	znali	1	Imp
Zajmujemy się sobą , myślimy o swoich ambicjach , urazach .	Zajmujemy	0	Imp
– ja sunę .	sunę	2	Imp
Podejrzewam , że się z nią ożenił dla majątku .	ożenił	6	Perf
Te ostatnie dziewczyny zostawiły , ponieważ były za małe .	zostawiły	3	Perf
Czterech ludzi nie żyło prawie na pewno .	żyło	3	Imp
Później połączono go z lądem groblą .	połączono	1	Perf
Bunt dojrzewał w całej Arabii .	dojrzewał	1	Imp
Umożliwiał on odbiór słuchowy .	Umożliwiał	0	Imp
Spoglądam na Ignaca .	Spoglądam	0	Imp
Rozdają publiczne pieniądze na rzecz Kościoła katolickiego , modlą się żarliwie przed kamerami , marzą o cenzurze obyczajowej .	modlą	8	Imp
Grób Petuli zdobi wrzos .	zdobi	2	Imp
Podczas obchodu można było się przekonać , że nastąpiły gruntowne zmiany w pomieszczeniach CSiK .	nastąpiły	8	Perf
Zamierzał ją zawieść do inseminatora .	zawieść	2	Perf
Dodaje , że nie rzucił obrazem o podłogę .	rzucił	4	Perf
Hrabina odwróciła się od Mocka .	odwróciła	1	Perf
Wypytywała rodaków o Warszawę , interesowała się przeżyciami Tomka w czasie wyprawy i nawet namawiała go usilnie , aby pozostał w Australii .	Wypytywała	0	Imp
Henryk informował , że Jenny przespała granicę i nikt jej nawet nie budził .	budził	12	Imp
Kompromitowali nie tylko siebie , ale i Polskę .	Kompromitowali	0	Imp
Podczas zajęć rękodzielniczych , mimo początkowego wątpienia we własne możliwości , młodzież tworzyła ozdoby wielkanocne .	tworzyła	12	Imp
Wittgenstein nie udowodnił , że trzeba milczeć .	udowodnił	2	Perf
Indie stanowczo zaprzeczają .	zaprzeczają	2	Imp
– Talar akurat skłócił tam tych ludzi .	skłócił	3	Perf
Radni liczą na zyski z podatków .	liczą	1	Imp
Stało się jednak inaczej .	Stało	0	Perf
Pewne trudności pojawiają się , gdy zastosuje się te definicje do lodowców innych stref .	zastosuje	6	Perf
Z ciał potopionych stryjów wylęgły się tysiące myszy i wyruszyły wszystkie do Kruszwicy , prosto na dwór zbrodniarza .	wylęgły	4	Perf
Poruszał rytmicznie kolanami , unosząc lekko siedzącą na nich kobietę .	Poruszał	0	Imp
Pierwsze krople deszczu zadudniły o trumnę i zmieszały się ze święconą wodą , którą ksiądz rozpryskiwał z kropidła podobnego do królewskiego berła .	rozpryskiwał	15	Imp
Wyrównują one nierówności , jednocześnie przyklejając płytki .	Wyrównują	0	Imp
Rabi Eleazar ben Cwi nie szemrze .	szemrze	5	Imp
- Lepiej popływajmy .	popływajmy	2	Perf
Odbudujmy porozumienie ponad różnicami , tak mało istotnymi wobec rzeczywistych problemów !	Odbudujmy	0	Perf
W Europie początkowo kawę sprzedawali medycy , zalecając ją na smutki i przygnębienie .	zalecając	7	Imp
Trzeba było jednak ruszyć w dalszą drogę .	ruszyć	3	Perf
Byłoby dziwne , gdyby ta większość przekazywała opozycji przewodnictwo najważniejszych komisji .	przekazywała	6	Imp
O siódmej rano , kiedy wszyscy byli już od dawna w polu , przystępowali śmy do młocki .	przystępowali	13	Imp
Zimą , przylatując na popas do Polski , zadowala się pozostałymi na krzakach jagodami .	zadowala	8	Imp
Wciąż dzwonią do niego jakieś baby .	dzwonią	1	Imp
Rozładował ją na brzegu , a ona cisnęła naboje do wody .	cisnęła	7	Perf
Mądrzej byłoby ominąć go szerokim łukiem .	ominąć	2	Perf
Co jakiś czas wydawało mi się , że teraz już mogę coś wydrukować albo że już mi wolno wyjechać .	wydawało	3	Imp
śledztwo wykazało , że zapłon i pojemnik były produkcji zachodnioniemieckiej .	wykazało	1	Perf
Powoduje bowiem utratę białka ze skóry i krwi , podczas jej stosowania maleje masa serca i spada wskaźnik podstawowej przemiany materii .	Powoduje	0	Imp
Jean Paul nie odzywał się .	odzywał	3	Imp
Nastąpił nagły zwrot w sprawie porywaczy biznesmenów .	Nastąpił	0	Perf
Stało się oczywiste , że porozumienia są możliwe i owocne .	Stało	0	Perf
- Sądząc po ilości , nie masz już czym .	Sądząc	1	Imp
jak ty sobie to wyobrażała ś ?	wyobrażała	4	Imp
W wydanym wczoraj oświadczeniu Rada podkreśliła , że wstrzymanie wykonania koncesji , gdy jednocześnie toleruje się działalność piratów , niszczy podstawy ładu w eterze .	podkreśliła	5	Perf
Nieruchomo stojąc w powietrzu nad kwiatami lecimy .	stojąc	1	Imp
Pawłowi M . zarzuca się również , że działał z zamiarem spowodowania ciężkiego kalectwa rzucając nożem w głowę włoskiego piłkarza Dino Baggio .	rzucając	14	Imp
Ale ja nie będę się mścił . . .	mścił	5	Imp
- Kochasz mnie ?	Kochasz	1	Imp
Wyborcy zdecydowali , że powinni zasiąść w Sejmie .	zasiąść	5	Perf
- Musi odejść .	odejść	2	Perf
To ostatecznie przesądziło o południowym kierunku japońskiej ekspansji .	przesądziło	2	Perf
Ręce mu drżały , gdy podnosił szklankę .	podnosił	5	Imp
- Weź pilota , wyłącz kmiota , niech się nie miota .	miota	10	Imp
Policja od razu wszczęła dochodzenie .	wszczęła	3	Perf
Bessona Joannę d'Arc również ogląda się jak film bez dialogów .	ogląda	4	Imp
Polacy pokonali 28 zespołów z całego świata i po raz pierwszy zdobyli puchar .	pokonali	1	Perf
Na parkingu do samochodu Kosińskiego dosiadł się Osiński .	dosiadł	5	Perf
Napadła ś na Kucyka , a to jest ich człowiek w terenie i nie dadzą go ruszyć .	Napadła	0	Perf
Do poszukiwań człowieka oskarżonego o ludobójstwo i zbrodnie przeciwko ludzkości włączyli się amerykańscy i brytyjscy agenci .	włączyli	10	Perf
Od dziecka wychowywali go mędrcy .	wychowywali	2	Imp
Posadziła m nasturcje we wszystkich skrzynkach .	Posadziła	0	Perf
nie wstydzicie się tego ?	wstydzicie	1	Imp
Ale ta idylla wspomnień będzie trwała krótko .	trwała	5	Imp
Tradycyjnie też wszystkie kościoły zapełniły się podczas pasterki .	zapełniły	4	Perf
Na parkingu do samochodu Kosińskiego dosiadł się Osiński .	dosiadł	5	Perf
Znowu tańczyli śmy blisko siebie .	tańczyli	1	Imp
I zjechawszy na kolana gorzko zapłakał zapominając , że patrzą na niego ludzie .	patrzą	9	Imp
Równie dobrze przeciw płaceniu podatków oponować mógł by kupiec .	oponować	5	Imp
Przepraszam , ale pan wygłasza za długie przemówienie .	wygłasza	4	Imp
Podobny sprzęt otrzymywały od niego dzieci i w ten sposób kontaktował się z nimi .	otrzymywały	2	Imp
Wójcicki przewrócił się i uderzył głową o chodnik .	przewrócił	1	Perf
- Pogadamy sobie jeszcze i odprowadzę ją do drzwi hotelu .	odprowadzę	5	Perf
W przypadku grożących gołoledzią opadów deszczu lub śniegu , komputer włącza ogrzewanie jezdni .	włącza	10	Imp
– ale Hubertus po Niemiecku będzie prowadził ?	prowadził	6	Imp
Działacze liczą , że związek nie będzie ścigany z całą surowością .	liczą	1	Imp
Jak je spłacić ?	spłacić	2	Perf
Zeszła już na dalsze miejsca , a jej przyszłość rysuje się niewesoło .	rysuje	9	Imp
Przypuszczam , że akurat to pytanie jest , Panie Senatorze , trochę przedwczesne .	Przypuszczam	0	Imp
Nie strasz klientów .	strasz	1	Imp
Listonosz mitrężył .	mitrężył	1	Imp
Księżyc wznosi się , tak pełny , jakby miał się przelać .	wznosi	1	Imp
To ostatecznie przesądziło o południowym kierunku japońskiej ekspansji .	przesądziło	2	Perf
Niektórzy szukali ich na dalekiej mroźnej północy .	szukali	1	Imp
W okolicach Ełku i Giżycka nie pracują 3 linie .	pracują	6	Imp
Trzech mężczyzn postanowiło wczoraj wzbogacić się tanim kosztem .	wzbogacić	4	Perf
Dlaczego się przestraszyła ?	przestraszyła	2	Perf
Małżonka krewnego przezornie schowała się do skrzyni i to ją uratowało .	schowała	3	Perf
Nie ogłosił nawet programu wyborczego .	ogłosił	1	Perf
Czy doszła do Pana moja Scena Zazdrości ?	doszła	1	Perf
Przy jego pomocy można obrazować wpływ poszczególnych czynników absencji .	obrazować	4	Imp
- Mógł by ś mi takich kawałków nie opowiadać .	Mógł	1	Imp
Motorówka odbija od burty , odchodzi łukiem .	odbija	1	Imp
Sędziowie orzekli , że nie można ratować jednych , poświęcając życie innych ludzi .	ratować	6	Imp
- Mieszkamy tu wszyscy od urodzenia , lecz nigdy jej nie widzieliśmy .	Mieszkamy	1	Imp
Nagle ktoś psyknął za moimi plecami .	psyknął	2	Perf
- A CO TO ZNACZY NAPRAWDĘ ?	ZNACZY	4	Imp
Członkowie nakielskiego stowarzyszenia podczas spotkania omówili główne cele swojej działalności .	omówili	5	Perf
Ty patrz , co ty widzisz .	patrz	1	Imp
Z lodówki wyjęła niewielki dozownik wypełniony rubinową cieczą i bardzo ostrożnie wcisnęła go do otworu w pudełku .	wyjęła	2	Perf
Spała niespokojnie , często rzucała się na łóżku , zdarzało jej się nawet krzyczeć .	Spała	0	Imp
- Będziemy udawali , że śpimy .	śpimy	5	Imp
W Olsztynie pod drzwiami szpitalnymi zmarły ostatnio dwie osoby .	zmarły	5	Perf
Kończy się kolejny odcinek zmagań współczesnego Piotra .	Kończy	0	Imp
I oto w ONZ przemawia nowy prezydent Kwaśniewski .	przemawia	4	Imp
Mężczyźni pobili się .	pobili	1	Perf
- Myślisz ?	Myślisz	1	Imp
Od niego dowiem się najlepiej .	dowiem	2	Perf
Grożąc bonią wepchnęli go do citroena i odjechali .	wepchnęli	2	Perf
Pogoda psuła się .	psuła	1	Imp
Pierwsze i jedyne auto zatrzymało się przy nich dopiero po kilku kwadransach !	zatrzymało	4	Perf
Prokuratura Okręgowa w Krakowie , która prowadzi śledztwo w sprawie wycieku testów w 2000 r . , potwierdziła , że sprzedawano testy w cenach od kilkuset złotych do 15 tysięcy .	potwierdziła	17	Perf
Odwróciła się i zaczęła szybko iść w moją stronę .	Odwróciła	0	Perf
Przekazał policjantowi dziewczynę i popłynął do brzegu .	popłynął	4	Perf
Ja też sobie tak czytam posty i nie widzę takiej manii .	czytam	4	Imp
Ojciec zagaił wiec .	zagaił	1	Perf
- Czy uważa pan , że po to , by utrzymać trzeźwość , alkoholik potrzebuje AA do końca życia ?	potrzebuje	14	Imp
Weź Lolkę i idźcie na górę .	Weź	0	Perf
Za każdy samochód zabierali się od razu mechanicy , zmieniali koła , usuwali uszkodzenia powstałe w czasie forsownego treningu , wymieniali zdarte nakładki hamulcowe , regulowali silniki .	usuwali	12	Imp
- Zaraz , zaraz , już wstaję !	wstaję	6	Imp
Z każdym rokiem ruch osobowy i towarowy na przejściu granicznym w Chyżnem rośnie .	rośnie	12	Imp
Nikt mnie raczej nie bierze za jajcarza , z którym można sobie pożartować , prawda ?	pożartować	12	Perf
Pokiwał na to głową .	Pokiwał	0	Perf
Polskę reprezentowały dwie kompozycje .	reprezentowały	1	Imp
Spojrzała , czarne oczka złośliwie mignęły , znikła .	znikła	7	Perf
Kochajcie się , bądźcie parą w pytkę !	Kochajcie	0	Imp
Zabił się na miejscu .	Zabił	0	Perf
Jeszcze większe wrażenie na współczesnych sprawiał Tomasz z Akwinu , dyktując dwa albo trzy traktaty filozoficzne .	dyktując	10	Imp
- Chyba ci te czary na głowę zaszkodziły .	zaszkodziły	7	Perf
Prototypy powinny odznaczać się światowym standardem .	odznaczać	2	Imp
Dobiegł do pierwszych drzew i zniknął w gęstwinie .	Dobiegł	0	Perf
- Zatkało ich .	Zatkało	1	Perf
Lopez odchrząknął .	odchrząknął	1	Perf
Za chwilę kardynałowie i biskupi wyniosą obraz Matki Bożej Jasnogórskiej na ołtarz przed kościołem .	wyniosą	5	Perf
Lekarze reanimowali ciężko rannego .	reanimowali	1	Imp
Czy jednak nie za drogo kupili ście marszałka ?	kupili	5	Perf
Poinformował w nim , że około godz . 19 . 30 w poniedziałek wartownik wojskowy zauważył zerwane plomby i kłódki do garnizonowego składu amunicji .	Poinformował	0	Perf
Andrzej Kowerski pozostawał w jej cieniu i nie wiadomo , jak to znosił .	pozostawał	2	Imp
Obok leżał rower , którym jechała kobieta .	jechała	5	Imp
Zaatakował chłopak .	Zaatakował	0	Perf
Tym razem atrakcyjność potyczki podniesie fakt , że Hoop i Zepter reprezentują mocno zmienione oblicza .	reprezentują	11	Imp
Podszedł do aparatu i nakręcił numer .	Podszedł	0	Perf
Nawet Nagroda Nobla mu nie dorównuje !	dorównuje	5	Imp
Nie wierzył em .	wierzył	1	Imp
Islam zakazuje przemocy .	zakazuje	1	Imp
- Michał nagle stał się natarczywy i to mnie zdziwiło .	zdziwiło	9	Perf
Obydwu sprowadź natychmiast do sztabu !	sprowadź	1	Perf
Posiadam spore zbiory i wciąż poszukuję nowych .	poszukuję	5	Imp
Przebiegające pod miastem chodniki kopalni zalano wodą , a wzgórze zgniło i zapadło się w ziemię jak przydeptane .	zgniło	10	Perf
Znów go zaswędziało .	zaswędziało	2	Perf
Marek skinął głową .	skinął	1	Perf
Żeby się odbić do góry , trzeba przysiąść .	odbić	2	Perf
Jak sobie pani radzi ze stresem ?	radzi	3	Imp
– Robisz się religijny , kiedy mówisz o piłce nożnej .	Robisz	1	Imp
We wtorek ci sami uczestnicy licytacji zaproponowali 1.500 zł .	zaproponowali	6	Perf
Gdy na miejscu zjawili się policjanci z komisariatu kolejowego policji , schronisko znajdowało się w opłakanym stanie .	zjawili	3	Perf
Ale nie chciała chodzić , udawała , że nic nie rozumie .	udawała	5	Imp
Batura przygryzł wargi .	przygryzł	1	Perf
Mimo że prostowała m to w prasie , wiersz w pewnych kręgach nadal cieszy się powodzeniem .	prostowała	2	Imp
Po ukończeniu zakopiańskiej Szkoły Przemysłu Drzewnego i warszawskiej ASP osiadł w Zakopanem .	osiadł	9	Perf
- Wcale nie zwariowali śmy , tylko uważamy , że z taką nogą spacerować nie możesz .	spacerować	13	Imp
CPN szukał więc czegoś nowego .	szukał	1	Imp
Tośka zdała arytmetykę .	zdała	1	Perf
Mężczyźni zakomunikowali , że przychodzą z bardzo korzystną ofertą .	zakomunikowali	1	Perf
Obrzęk w krtani może zagrażać życiu .	zagrażać	4	Imp
Weźmie w nim udział 25 uczniów szkół podstawowych z terenu gminy .	Weźmie	0	Perf
Wypowiadamy się w sondach telewizyjnych a czasami przesyłamy także nasze opinie elektronicznie .	przesyłamy	7	Imp
Uczą się i pomagają innym .	pomagają	3	Imp
Podniosła słuchawkę telefonu i wystukała numer Filipa .	Podniosła	0	Perf
Pan nie zadawał wcześniej pytania .	zadawał	2	Imp
I wtedy obok stołu coś szurnęło .	szurnęło	5	Perf
Uczył em .	Uczył	0	Imp
– Nie przychodzicie razem z małym do Piaskownicy ?	przychodzicie	2	Imp
Ta rzuciła słuchawką .	rzuciła	1	Perf
Orzechowe oczy garncarza wpatrzyły się badawczo w twarz Kaliasa .	wpatrzyły	3	Perf
kanapy się dorobili śmy .	dorobili	2	Perf
Zośka lekko się zmieszała .	zmieszała	3	Perf
Statut określa zasady wynagradzania za użytkowanie tych wkładów .	określa	1	Imp
Przytul się mocno I podnieś głowę Patrząc w ich oczy Moim spokojem .	podnieś	4	Perf
- Chyba nie sięgną .	sięgną	3	Perf
Dużo wnoszą młodzi zawodnicy , którzy niespodziewanie świetnie wkomponowali się w zespół .	wkomponowali	8	Perf
- Spodziewał em się , że tak odpowiesz , Sarai !	odpowiesz	7	Perf
Była m w archiwum , przeglądała m gazety .	przeglądała	5	Imp
Jurek zamówił golonkę .	zamówił	1	Perf
Zanim skończył em mówić , zaatakował mnie z dwunastu stron naraz .	skończył	1	Perf
Papieros sparzył mi palce , rzucił em go w śnieg .	sparzył	1	Perf
– a długo się piecze ?	piecze	4	Imp
Wicemistrzynie Polski z Mielca nie dały pograć w Krakowie Wiśle i opuściły ostatnie miejsce w tabeli właśnie na rzecz podopiecznych Lesława Kędryny .	dały	5	Perf
Składamy hołd pokoleniom , które tworzą naszą historię , ale są też aktywnie obecne we współczesności .	Składamy	0	Imp
Padł strzał , ale to było pudło .	Padł	0	Perf
- Mogło by się tak komuś wydawać .	wydawać	6	Imp
Całą sobą obrażać zasady , które wyznaje prosty tutejszy lud .	obrażać	2	Imp
— Odpocznie od tego nieszczęścia .	Odpocznie	1	Perf
Okrążył em szkołę .	Okrążył	0	Perf
Nie orientował się też , że popełnia przestępstwo dewizowe .	orientował	1	Imp
Kosmonauci przechodzili ją jednak nieraz w czasie treningów .	przechodzili	1	Imp
I wróżą dobrą pogodę do inwestowania w akcje .	wróżą	1	Imp
Wydaje się , że o decyzji przesądziły trzy czynniki .	przesądziły	6	Perf
I montujemy z tego dziewięćdziesięciominutowy program .	montujemy	1	Imp
Następnie wycofując się , wyciągamy tułów i nogi .	wycofując	1	Imp
Tutaj przecież ich rodzina mieszkała i tu mama się urodziła .	urodziła	9	Perf
Powrót odbywał się w mrocznym milczeniu .	odbywał	1	Imp
Żałował , że to powiedział .	Żałował	0	Imp
Na wszelki wypadek weźmiemy cię za wielbłąda .	weźmiemy	3	Perf
Taksówkarz wezwał policję i pogotowie .	wezwał	1	Perf
Polska ambasada zorganizowała dla nich konferencję prasową .	zorganizowała	2	Perf
- Weź pilota , wyłącz kmiota , niech się nie miota .	wyłącz	4	Perf
Wśród oceniających zasiadły trzy blondynki .	zasiadły	2	Perf
Nie składają donosów do prokuratury , nie przejmują się całodobowym uśmiercaniem poczętych ?	przejmują	7	Imp
Niebieskie światełko zgasło .	zgasło	2	Perf
- Mogło by się tak komuś wydawać .	Mogło	1	Imp
Widoczny jest wzrost aspiracji społeczeństwa , które chce zdobywać wykształcenie .	zdobywać	8	Imp
Jeden z mężczyzn przystąpił do majstrowania przy kablach telefonicznych .	przystąpił	3	Perf
To państwo Kaczyńscy wiedzą i rządu do dymisji nie podadzą .	podadzą	9	Perf
Wkrótce też natknęli się na mężczyzn ściągających skórę z zabitego kozła .	natknęli	2	Perf
Nie widzieli się miesiąc i musiał ponownie oswoić Gosię .	oswoić	7	Perf
Może nauczysz się wreszcie , jak się takie rzeczy załatwia .	nauczysz	1	Perf
Znowu buchnął śmiech .	buchnął	1	Perf
Sięgam do kieszeni .	Sięgam	0	Imp
Jak mnie wyceniasz ?	wyceniasz	2	Imp
Mszy przewodniczył prymas Józef Glemp .	przewodniczył	1	Imp
Mateo mieszka na Elbie , gdzie latem wynajmuje turystom motorówki .	wynajmuje	7	Imp
Jutro wyjeżdżam .	wyjeżdżam	1	Imp
Żołnierze okopali się tam i celnymi strzałami odpierali atakujących .	odpierali	7	Imp
Adam szukał do nowego domu parkietu .	szukał	1	Imp
W redakcji świetnie radzono sobie beze mnie .	radzono	3	Imp
Stopniowo dół się sam zasypie śmieciami .	zasypie	4	Perf
Pestka nie przejęła się tym okrzykiem .	przejęła	2	Perf
Do budowy nowego gmina podchodziła kilkakrotnie .	podchodziła	4	Imp
I zjechawszy na kolana gorzko zapłakał zapominając , że patrzą na niego ludzie .	zjechawszy	1	Perf
Uczyniło się raptem cicho .	Uczyniło	0	Perf
Chińczycy jednak wkrótce poparli interwencję na Węgrzech , bo tam już lała się krew .	poparli	3	Perf
Co tracisz , co zyskujesz ?	tracisz	1	Imp
Ciągle nie możemy doczekać się takich czasów , kiedy rządy po prostu nie będą przeszkadzały .	doczekać	3	Perf
Bez sprzeciwu zabiera Izaaka na szczyt góry , przywiązuje do ołtarza , podnosi nóż , jest gotów do ciosu .	zabiera	2	Imp
Spojrzałem na kobietę i stwierdziłem , że po raz pierwszy jej twarz zasługiwała na uwagę .	zasługiwała	12	Imp
Kaneyasu pomyślał , że niepotrzebnie lakierowano stół .	lakierowano	5	Imp
Rządowy projekt chroni dzieci i młodzież .	chroni	2	Imp
Podbiegł em i wziął em siatkę .	Podbiegł	0	Perf
Oznacz wszystkie pola ze skarbami .	Oznacz	0	Perf
Pocałowała mnie w czoło i wyszła , zanim zdążył em coś powiedzieć .	Pocałowała	0	Perf
Proboszcz wzniósł oczy w sufit i westchnął o świętą cierpliwość .	westchnął	6	Perf
Czy ekonomiści liczą , że Balcerowicz będzie korzystał z ich rad ?	liczą	2	Imp
Prawdopodobnie wkrótce straci immunitet .	straci	2	Perf
Dla uczczenia tego zdarzenia przynoszę filiżanki .	przynoszę	4	Imp
Zdziwisz się , ale wielu głosowało za Bośnią .	głosowało	5	Imp
Przez chwilę trwała cisza .	trwała	2	Imp
Może nad ranem wróci do hali i spróbuje wydostać się przez okno .	wydostać	8	Perf
Trzecioligowcy strzelili kontaktowego gola , ale w ostatnim kwadransie dwie bramki dla Lecha wypracował Remień .	wypracował	13	Perf
– I co on wybrał ?	wybrał	4	Perf
Załadował na wóz wynajętych gazeciarzy i rozwiózł po mieście , każąc rozdawać list przechodniom .	rozwiózł	6	Perf
Po mszy świętej wyruszyła z bazyliki katedralnej i okrążyła Stary Rynek .	wyruszyła	3	Perf
Zamknął em tylko oczy , aby lepiej czuć dotyk i słyszeć własne myśli .	czuć	7	Imp
Napastnicy grozili nastolatkom , że ich pobiją .	pobiją	6	Perf
Otworzyła m oczy .	Otworzyła	0	Perf
Naścinali suchej trawy , aby urządzić sobie miękkie posłania .	Naścinali	0	Perf
Osunął mu się w rękach .	Osunął	0	Perf
- W szkole jest mniej uczniów , dlatego musiałem tym paniom podziękować .	podziękować	11	Perf
- A chciał by ś mnie nieść ?	nieść	6	Imp
Wsparł go Wierchowicz .	Wsparł	0	Perf
W jego armii służyli teraz synowie śmiałków , którymi dowodził przed laty .	służyli	3	Imp
A może pan chciał by recytować ?	recytować	5	Imp
Tylko sygnalizacja naprawdę mnie niepokoi .	niepokoi	4	Imp
Mężczyźni pozabierali wszystko i wyjechali .	wyjechali	4	Perf
Tu można by przedstawić nielichą litanię .	przedstawić	3	Perf
Do podlewania sadzonek wyśmienicie nadają się filtrowane ścieki .	nadają	4	Imp
Wtedy wracali chłopi , a wraz z nimi albo wkrótce po nich w pandższirskich wioskach pojawiali się mudżahedini .	pojawiali	15	Imp
Słuszne pytania i odpowiedzi mieszają się z podłymi .	mieszają	4	Imp
Podlaska Agencja Restrukturyzacji i Modernizacji Rolnictwa opracowała specjalną instrukcję dla parafii .	opracowała	6	Perf
Przytul się mocno I podnieś głowę Patrząc w ich oczy Moim spokojem .	Przytul	0	Perf
Po ustaleniu , że występują w tym zakresie nieprawidłowości , policjanci przystąpili do działań .	przystąpili	11	Perf
Premier Cyrankiewicz i Pierre Lauret wygłosili krótkie przemówienia .	wygłosili	5	Perf
Nie omieszkam tego tematu poruszyć .	omieszkam	1	Perf
Pana to irytuje ?	irytuje	2	Imp
Groźbą i prośbą starają się wymusić zeznanie .	wymusić	5	Perf
Podpłynął księżyc , przywarł i zaczął ssać .	Podpłynął	0	Perf
Kościół nie zobowiązuje katolików do tego , aby wierzyli w cuda .	wierzyli	8	Imp
Dlaczego złoty wczoraj tak nagle osłabł ?	osłabł	5	Perf
Jakieś światła błyszczą z prawej burty .	błyszczą	2	Imp
Znachor napawa się swą mocą .	napawa	1	Imp
Zgodnie z ustaleniami nie udzielił żadnych wywiadów ani nie wydał żadnego oświadczenia politycznego .	udzielił	4	Perf
Po jednemu wsiąkały w próżnię . . .	wsiąkały	2	Imp
To samo dotyczy leczenia , służba zdrowia praktycznie przestała istnieć .	istnieć	9	Imp
Chodorkowski podpadł władzom , bo krytykował prezydenta Putina i nie krył swoich politycznych ambicji .	krytykował	5	Imp
Strefy za parę lat zdechną śmiercią naturalną .	zdechną	4	Perf
Wczoraj , po zamknięciu lokali wyborczych , niemieckie media zapowiedziały , że pani minister ustąpi ze stanowiska .	zapowiedziały	9	Perf
Podporządkowywał em się tu .	Podporządkowywał	0	Imp
Uderzył kastetem w samochodzie , potem udusił .	udusił	6	Perf
Maria Kadłubek odebrała wydany zaocznie wyrok sądu grodzkiego .	odebrała	2	Perf
i ta mała Asia się pochorowała .	pochorowała	5	Perf
Ani my ciebie nie pobudzamy , ani ty się nie dzielisz .	dzielisz	10	Imp
Pomyliła się .	Pomyliła	0	Perf
W Unii Europejskiej budżet opracowuje się raz na 7 lat .	opracowuje	4	Imp
Iskierka zgasła , ustępując miejsca podejrzliwości .	ustępując	3	Imp
- Słowo daję , że się nie gniewam .	gniewam	7	Imp
Szef mówił , że Niemcy zebrali tam co najlepsze swoje dywizje , okrutnie umocnili sia , obwarowali i przygotowali do długiej obrony .	obwarowali	16	Perf
Jeszcze niedawno informowano , że skradziono 60 starych ksiąg , teraz okazało się , że brakuje ponad 90 pozycji .	informowano	2	Imp
Ksiądz jęknął .	jęknął	1	Perf
Przy czwartym zerwali obrady i ustawili się w kolejce , by podpisać listę obecności .	zerwali	2	Perf
Szef aż podskoczył !	podskoczył	2	Perf
Ale może się mydlę .	mydlę	3	Imp
Twierdzili , że nie oddali córki do szpitala , bo nie mogli by jej odwiedzać .	Twierdzili	0	Imp
KOKS MUSI BYĆ !	MUSI	1	Imp
Odczuła m dokuczliwą zazdrość .	Odczuła	0	Perf
" Tak chciał Bóg , żeby nasz umysł w sprawach matematycznych osiągał pewność logiczną , ale w religii osiągał ją dzięki prawdopodobieństwu nagromadzonemu . "	osiągał	18	Imp
Próbowali go powalić i zakneblować mu usta .	powalić	2	Perf
Ale wiedział , że niebawem zacznie się dziać .	dziać	7	Imp
Jasieńczyk o nią zapytał .	zapytał	3	Perf
Sierżant zajrzał w papiery .	zajrzał	1	Perf
mów dalej .	mów	0	Imp
Jeżeli zabawka się zepsuje , wyrzucimy ją .	zepsuje	3	Perf
- Czy ktoś jeszcze pragnie zabrać głos ?	pragnie	4	Imp
- Zabrali nam Młodego .	Zabrali	1	Perf
Bywało , że musiała ich odpędzać policja .	Bywało	0	Imp
Warzywa umyć i osączyć .	umyć	1	Perf
- Śpieszy ci się , Wituś .	Śpieszy	1	Imp
Chyba przyznasz , że przyjemniej obcuje się z osobami myślącymi i sympatycznymi .	przyznasz	1	Perf
Po dwóch tygodniach na jej rozkładające się zwłoki natrafił w lesie rowerzysta .	natrafił	8	Perf
Polacy pokonali 28 zespołów z całego świata i po raz pierwszy zdobyli puchar .	zdobyli	11	Perf
– prezentować w sandałach . .	prezentować	1	Imp
To alibi , które wymyślili dla siebie kurwiarze !	wymyślili	4	Perf
Mam już 80 lat , a moje zdrowie się pogarsza .	pogarsza	9	Imp
Do przyczyn nawet nie sięgną !	sięgną	4	Perf
Bawić się !	Bawić	0	Imp
Kupicie dom ?	Kupicie	0	Perf
Kolor pełni w obu rodzajach reklamy bardzo interesującą funkcję .	pełni	1	Imp
Pocałuj ją , a zobaczysz , że tylko krok dzieli cię od najważniejszego .	zobaczysz	4	Perf
- Będzie się Pan opierał na betonie ?	opierał	4	Imp
Umożliwi też uruchomienie w innych miejscowościach dodatkowych elektronicznych centrali cyfrowych .	Umożliwi	0	Perf
Wszechpolaków przybywa .	przybywa	1	Imp
Podał em dokument .	Podał	0	Perf
Zanim wiązanki kwiatów przykryły mogiłę , słowa modlitwy prowadzonej przez ks . Pawła Dorucha splatały się z wyrazami bólu i wspomnieniami przyjaciół .	splatały	14	Imp
Przestawał pić na trzy , cztery dni i znowu gdzieś ginął .	pić	1	Imp
JAJKO SIĘ NIE TŁUCZE !	TŁUCZE	3	Imp
Chłopak zerwał się z miejsca , złapał posążek i ścisnął mocno w dłoni .	ścisnął	9	Perf
A sprawa jest poważna , większość firm z udziałem kapitału zagranicznego wykazuje zerowy albo ujemny zysk .	wykazuje	11	Imp
Ogień trzaskał w ciszy , dzieci wybiegły na dwór przestraszone .	wybiegły	6	Perf
Poślij po niego , niech przyjdzie i zaświadczy .	zaświadczy	7	Perf
- Zatłukł mojego męża , a po trzech miesiącach go wypuszczono .	Zatłukł	1	Perf
– dlaczego tego już nie produkują ?	produkują	5	Imp
Do godziny drugiej po południu wszystko toczyło się normalnie .	toczyło	6	Imp
Wysyłamy panu gratis lodowy dom . "	Wysyłamy	0	Imp
Popatrz na tych młodych KZT .	Popatrz	0	Perf
Trudno przewidzieć wynik głosowania nad skróceniem tygodnia pracy .	przewidzieć	1	Perf
Skazał go na wiele niepotrzebnych cierpień .	Skazał	0	Perf
- Każdy z liderów partyjnych musi rozliczać się wobec swojego zaplecza politycznego .	rozliczać	6	Imp
Piłkarze zdołali wykorzystać zaledwie jedną jedenastkę .	wykorzystać	2	Perf
No , nie mitręż , dziewczyno .	mitręż	3	Imp
Mirek obiecał , że on będzie robił obiady w sobotę , bo przecież ja mam tyle pracy !	obiecał	1	Perf
Poruszyłem się na łóżku , które odpowiedziało sprężyście .	odpowiedziało	6	Perf
Austria i carska Rosja niszczyły je dalej systematycznie .	niszczyły	4	Imp
Margit również przykucnęła i wybierała zwierzątka .	wybierała	4	Imp
Wtedy do akcji wkroczyli rodzice Marianny Czupinki .	wkroczyli	3	Perf
Ta sprawa wstrząsnęła całą Polską .	wstrząsnęła	2	Perf
Woreczek zagrzechotał cicho .	zagrzechotał	1	Perf
Chce , by powstał na nich ośrodek sportów wodnych .	powstał	3	Perf
Publiczność przyjęła ją entuzjastycznie , ale krytycy nazwali królową kiczu .	nazwali	7	Perf
- Nie gadaj dużo , tylko bierz za sznur .	bierz	6	Imp
Nic nie zmieniamy .	zmieniamy	2	Imp
Pani z jamnikiem spytała Kuronia , czy to jego samochód .	spytała	3	Perf
Występuje stałe obniżanie się poziomów wód w rzekach i potokach .	Występuje	0	Imp
- Zabija się tylko dla jedzenia .	Zabija	1	Imp
Mam już 80 lat , a moje zdrowie się pogarsza .	pogarsza	9	Imp
Krysia pociągnęła nosem i zaśmiała się .	pociągnęła	1	Perf
- Słyszy pan te krzyki ?	Słyszy	1	Imp
Wychowała m tam 10 specjalistów chirurgii dziecięcej .	Wychowała	0	Perf
I Pan Jezus krzyż nad nimi uczynił , a oni się zamienili w trzy drzewa jabłonne .	uczynił	6	Perf
Mała lampka rozpraszała mrok , rzucając nikłe światło na błękitną tapetę .	rozpraszała	2	Imp
Docierają pracodawcy .	Docierają	0	Imp
Szczęsny nie wracał .	wracał	2	Imp
Zarządca komisaryczny przestał pełnić ją dopiero po ostatnich wyborach samorządowych .	pełnić	3	Imp
Rozmawiają o tamilskich i hinduskich filmach .	Rozmawiają	0	Imp
Na groblach wybudowano jedenaście betonowych śluz wałowych .	wybudowano	2	Perf
Ale już nie zdążyli , na pozostałym kawałku lądowały niemieckie dywizje pancerne .	lądowały	8	Imp
Izba tonęła w półmroku .	tonęła	1	Imp
Na razie żeglarze z całego świata odpoczywają i bawią się w Talinie .	bawią	8	Imp
Dojedli śniadanie , wyjęli papierosy , zapalili .	wyjęli	3	Perf
Na dachu paliła się 81-letnia kobieta .	paliła	2	Imp
Nie mogła się mylić , bo odbite od łez światło dawało wyraźny błysk .	mylić	3	Imp
Z chwilą urodzenia dziecko może żądać naprawienia szkód doznanych przed urodzeniem .	żądać	5	Imp
Zatruwa życie obywateli .	Zatruwa	0	Imp
Napijmy się .	Napijmy	0	Perf
Tak ją tu wszyscy nazywamy .	nazywamy	4	Imp
Odczuł em zaraz lekki niepokój .	Odczuł	0	Perf
Chodź , poszukamy czegoś na Trzynachę .	poszukamy	2	Perf
Żeby wrogów zwabić w zakreślone koło .	zwabić	2	Perf
- Przyrzekniesz mi .	Przyrzekniesz	1	Perf
Nie jedzmy margaryny .	jedzmy	1	Imp
Mimo to naukowcy zalecają ostrożność w rozpowszechnianiu komórek wśród dzieci i młodzieży .	zalecają	3	Imp
Obok klatek z dorosłymi ptakami krążyły dwa małe kazuary , grzebiąc w odpadkach w poszukiwaniu pożywienia .	krążyły	5	Imp
Jest niemal pewne , że miasto źle nalicza ci czynsz .	nalicza	7	Imp
Sprzeciwili się projektowi ustawy , która pozwoli na przynoszący zysk import odpadów nuklearnych .	Sprzeciwili	0	Perf
Potem mu nie dopłacili .	dopłacili	3	Perf
Przenosi obojętne spojrzenie na stronę z nekrologami , którą Gabriela przygważdża do stołu kościstym palcem .	przygważdża	10	Imp
Trzeba było przekonać prokuratora , aby wniósł sprawę z urzędu .	wniósł	6	Perf
Po paru dniach znał już wszystko i wszystkich i spędzał na górnych piętrach każdą wolną chwilę , wychodząc tylko w porze posiłków i oczywiście snu .	wychodząc	17	Imp
Karol od świtu do nocy tkwił w wejściowych drzwiach , odnotowując czerwonymi oczami moje wyjścia i powroty .	odnotowując	10	Imp
Tak jak upiekło im się po Zatoce i Afganistanie .	upiekło	2	Perf
Niosło wonią smoły i wodorostów , woda pluskała cicho o łódki przywiązane do omszałych pali .	pluskała	7	Imp
- Wybaczy pan , Profesorze . . .	Wybaczy	1	Perf
Patrzyła na mnie tak , aż zrobiło mi się nieprzyjemnie i zaczęła m żałować swoich słów .	żałować	13	Imp
Selekcjoner Jerzy Engel rozdał pamiątkowe monety , wybite z okazji zbliżających się mistrzostw świata .	rozdał	3	Perf
Chciał em należeć do harcerstwa , a w mojej szkole drużynę prowadzili akurat ci ludzie .	należeć	2	Imp
Przygrywały kapele , występowały zespoły i soliści .	występowały	3	Imp
Podczas niemieckiej okupacji spotykali śmy się , należąc do podziemnej literackiej Warszawy .	spotykali	3	Imp
Skąd wiedział , kiedy przyjedzie ?	przyjedzie	4	Perf
Patrzyły śmy na siebie bez słowa .	Patrzyły	0	Imp
Zbyt szybkie tempo życia doprowadza zwykle do zmęczenia i bałaganu .	doprowadza	4	Imp
Wyborcy zdecydowali , że powinni zasiąść w Sejmie .	zdecydowali	1	Perf
Słuchaj , Piotr był zalany , spadał ze schodów , wyskakiwał z okna .	spadał	6	Imp
- Nie może atakować i obciążać nogi .	obciążać	5	Imp
Stało się dokładnie tak , jak zaplanowały .	Stało	0	Perf
- Co robicie , by w tak świetnej kondycji dotańczyć do finału ?	dotańczyć	9	Perf
- Robisz twarożek ?	Robisz	1	Imp
Jutro czy pojutrze mamy przekroczyć koło polarne .	przekroczyć	4	Perf
Kontrolerzy nie wzięli pogróżek poważnie , bo wiedzieli z doświadczenia , że w podobnej sytuacji prawie każdy podatnik powołuje się na możnego protektora . . .	powołuje	18	Imp
Oszukasz mnie .	Oszukasz	0	Perf
Kto wiatr sieje , ten burzę zbiera .	sieje	2	Imp
Zarzucił mu Pan , że utrwala sejmokrację .	utrwala	5	Imp
- Masz , bierz .	bierz	3	Imp
Mimo operacji nie dało się go uratować .	uratować	6	Perf
Niestety zabrakło światowej sławy muzyka , przyjaciela Karola Szymanowskiego , Romana Totenberga , któremu choroba nie pozwoliła na przyjazd do Zakopanego .	pozwoliła	16	Perf
Wypadła m ze sklepu i pobiegła m na umówione miejsce .	pobiegła	5	Perf
Konia by powaliło .	powaliło	2	Perf
Yennefer opuściła głowę , spojrzała między swoje uda , nad którymi przemykały złote rybki .	przemykały	11	Imp
Ale pani Barbarze to znowu nie dogadzało .	dogadzało	6	Imp
Wykąpiemy się na golasa .	Wykąpiemy	0	Perf
Ale odmówiono wszczęcia sprawy .	odmówiono	1	Perf
- Pytał em też Mędrców , ale pokiwali tylko głowami i orzekli , że ich komputery nie są w stanie tej zagadki rozwikłać .	pokiwali	7	Perf
Co chwila oblizywał sobie pysk .	oblizywał	2	Imp
Wyszedł z kabiny , by zamknąć bramę .	zamknąć	5	Perf
Przybywały tabunami .	Przybywały	0	Imp
Przedtem włóczyli się po mieście , topniał śnieg , szumiało w rynnach , czuć było powiewy ciepła i zgnilizny , nad dachami tłukły się kłębiaste chmury .	włóczyli	1	Imp
W zeszłym roku w Cieszynie zawiązał się CKH i występował w naszej II lidze .	występował	9	Imp
Powinna to zbadać …	Powinna	0	Imp
Na centralnie umieszczonym bolcu osadzamy krążek i dopiero wtedy naklejamy na nim gotową etykietę .	naklejamy	9	Imp
Sławny pianista utracił dłonie w wypadku , ale przeszczepiono mu ręce straconego mordercy .	utracił	2	Perf
Produkcję nadzorował w Krośnie Jerzy .	nadzorował	1	Imp
- Teraz pojedziemy na szóste .	pojedziemy	2	Perf
Nie doczekał em się .	doczekał	1	Perf
Ze zrozumieniem przyjmują lekkomyślny gest .	przyjmują	2	Imp
Ale jak mogł em tak się pomylić .	pomylić	6	Perf
Z obu stron drogi zaczęto strzelać do nich z granatników i broni maszynowej .	zaczęto	4	Perf
- Cierpienie pana uszlachetnia ?	uszlachetnia	3	Imp
Nic nie wyczynia .	wyczynia	2	Imp
Margit również przykucnęła i wybierała zwierzątka .	przykucnęła	2	Perf
Otworzyła m radio i słuchała m muzyki .	słuchała	4	Imp
Kiedy RS AWS się wzmocni , ja też zrezygnuję z pewnych funkcji .	zrezygnuję	8	Perf
Potem proszono ich o wykonanie odwrotnego zadania .	proszono	1	Imp
Wynikła awantura , ale w duchu przyznano bosmanowi rację .	przyznano	6	Perf
- Nie twierdzę , że jesteśmy bez winy , ale w zasadzie zarzut ten mógł by dotyczyć strony państwowej .	dotyczyć	16	Imp
Dlaczego dała m sobie wmówić ciemnotę i sobą poniewierać ?	poniewierać	8	Imp
- Dlaczego pytasz ?	pytasz	2	Imp
Rywale prowadzili już wtedy dwoma bramkami i Polak nie zdołał zmienić losu meczu .	prowadzili	1	Imp
Długi ograniczył się do spojrzenia .	ograniczył	1	Perf
Policjanci śmieją się , odreagowując stres .	śmieją	1	Imp
Dopakowuje torbę .	Dopakowuje	0	Imp
We własnym pokoju rzuciła się na łóżko i prędko zasnęła .	rzuciła	3	Perf
Szacki wytarł usta serwetką .	wytarł	1	Perf
Mock odsalutował .	odsalutował	1	Perf
Szkoda , że nie można dysponować Heinzem Mirynkiem .	dysponować	5	Imp
Wreszcie Lem z wyjątkowym krytycyzmem oceniał sprawy polskie .	oceniał	5	Imp
Wydawała mi się bezbronna i tak strasznie niezaradna !	Wydawała	0	Imp
Syn usiłował wejść na ołtarz .	wejść	2	Perf
Połączyły siły .	Połączyły	0	Perf
Taksówka czekała z zapalonym silnikiem , a ci od pomocy drogowej wkładali jeepa na podnośnik .	wkładali	11	Imp
Podziela pan ten pogląd ?	Podziela	0	Imp
Miś Holender przysłał mu czerwone anemony i hiacynty na ostatek .	przysłał	2	Perf
Tymczasem mój lot nie ustawał i w dalszym ciągu nie wiedziałem , w jaki sposób wrócić na ziemię .	ustawał	4	Imp
Spytała m o niego mężczyznę siedzącego obok .	Spytała	0	Perf
Kobieta obracała karty z cichym szelestem .	obracała	1	Imp
Codziennie dowożą jej jedzenie i wodę .	dowożą	1	Imp
Sprawą zajmują się policjanci z 6 komisariatu na Górnej .	zajmują	1	Imp
W opowieści biblijnej uderza ścisłość historyczna w odtwarzaniu obyczajów egipskich .	uderza	3	Imp
Ja wszystko zanotuję , a żona podpisze .	zanotuję	2	Perf
Na szczęście nikt nie odniósł obrażeń .	odniósł	4	Perf
Mijała minuta za minutą , czas wlókł się w nieskończoność , a nie pojawiał się nikt .	pojawiał	13	Imp
Zamiera łono ziemi .	Zamiera	0	Imp
Doszło do kraksy .	Doszło	0	Perf
" Możesz przeprosić .	przeprosić	2	Perf
Majowe weekendy zapowiadają się naprawdę ładnie !	zapowiadają	2	Imp
Polski lud w nic nie wierzy .	wierzy	5	Imp
Gdy nikt nie reagował na dzwonek , włączyli syrenę .	włączyli	7	Perf
Zaczekasz na nas czy pójdziemy razem ?	pójdziemy	4	Perf
– Zajrzała jej w oczy spłowiałym błękitem tęczówek .	Zajrzała	1	Perf
- Wziął em się w garść i posłał em jej twarde spojrzenie .	posłał	7	Perf
Posiada Pan jedynie dyplom magistra filozofii . . .	Posiada	0	Imp
Faktyczny strajk , który jest im zabroniony , oprócz wymiernych kosztów dla tysięcy firm naraził państwo polskie na kompromitację .	naraził	14	Perf
Zdaje się , że uczył w szkołach .	uczył	4	Imp
Skąd to się wzięło ?	wzięło	3	Perf
Nie narzeka na brak pomysłów twórczych .	narzeka	1	Imp
Ten były hiszpański duchowny nigdy nie krył wrogości do Jana Pawła II .	krył	6	Imp
Zwierzenia Ani poruszyły mnie do głębi .	poruszyły	2	Perf
Można zagrać bez niego , a potem go dokręcić .	dokręcić	8	Perf
Słońce ożywiło ludzi nie ożywiając jeszcze natury .	ożywiając	4	Imp
Przewrócił em jakieś puszki , stracił em kamerę , ale świeca płonie .	Przewrócił	0	Perf
Za to w wyniku referendum mogą stracić fotele .	stracić	6	Perf
Zarazem na wszystkich studentach zaciążyłby obowiązek przedstawiania WKU dokumentów świadczących , że nadal studiują .	studiują	13	Imp
Między wami narasta konflikt , powietrze gęstnieje , znajomi pośpiesznie się żegnają .	żegnają	11	Imp
Baryshnikov automatycznie skorzystał z Rangera .	skorzystał	2	Perf
Do gabinetu weszła panna Wunsch i położyła na biurku Trentscha niebieski skoroszyt .	położyła	6	Perf
Utnij na dwie dulki i schodź , bo palić się strasznie chce .	Utnij	0	Perf
— W sprawie wywiadu moja sekretarka skontaktuje się z pańską sekretarką .	skontaktuje	6	Perf
Popędzali swoje konie , bo koniecznie chcieli dopaść upatrzonej zwierzyny .	dopaść	7	Perf
Smutno będzie porzucić starą budę .	porzucić	2	Perf
Nikt nie zatrzyma rozwoju medycyny .	zatrzyma	2	Perf
Niewielka szansa , prawdopodobnie obaj żołnierze strzelą i któryś z nich musi trafić .	strzelą	6	Perf
Byli zbyt zmęczeni , aby roztrząsać przestrogę pana Bazylego .	roztrząsać	5	Imp
Joniec i Miksa spojrzeli po sobie , obcierając oczy .	spojrzeli	3	Perf
Kiedy się ocknął , szarzało .	ocknął	2	Perf
Popatrz , jak inni poruszają ustami .	Popatrz	0	Perf
Trzeba było się zdemaskować .	zdemaskować	3	Perf
Mamy nadzieję , że Państwowa Komisja Wyborcza zainteresuje się tym trikiem .	zainteresuje	7	Perf
Bartoch zapalał się coraz bardziej i zdawało się , że o Franoszkach zapomniał .	zapalał	1	Imp
Często śniło się jej , że biegnie za oderwaną ręką i nie może jej dogonić .	dogonić	14	Perf
Jest tak , jak pan pisze .	pisze	5	Imp
Chciała m usiąść , ale nie starczyło mi sił .	usiąść	2	Perf
Powstała nawet nauka o snach , nazywana onejrologią .	Powstała	0	Perf
– Zidentyfikował z uśmiechem suknię , kupioną w salonie Coco Chanel .	Zidentyfikował	1	Perf
Wybierz dowolny chat , umów się z przyjacielem na określoną godzinę i rozmawiaj do woli .	umów	4	Perf
Usiedli obydwaj przy herbacie zaparzonej w grubych szklankach .	Usiedli	0	Perf
Dotknął drewnianej poręczy .	Dotknął	0	Perf
Jabłko obrać i zetrzeć na tarce do jarzyn .	zetrzeć	3	Perf
Biedny Drossos , sami analfabeci głosowali na niego …	głosowali	5	Imp
U ludów słowiańskich rodzina miała charakter patriarchalny , a przewodził jej ojciec .	przewodził	9	Imp
Z radia dobiegały ostatnie tony walca Brahmsa .	dobiegały	2	Imp
- Nie kradnę , nie sprzedaję narkotyków i nie morduję za pieniądze .	morduję	9	Imp
Przecież nie żyję na pustyni .	żyję	2	Imp
Westchnienia Ruskina i Prousta trafiają na podatny grunt .	trafiają	4	Imp
Powrócono do szkoleń politycznych , na których trzeba było walczyć z wszechogarniającą sennością .	Powrócono	0	Perf
Z ulicy dobiegały czyjeś kroki .	dobiegały	2	Imp
- Nauczasz prawdziwie . . .	Nauczasz	1	Imp
Noga dziecka utkwiła pomiędzy drzwiami a ścianą szybu .	utkwiła	2	Perf
Podziękowali ście ? ?	Podziękowali	0	Perf
Zarobki wszystkich nauczycieli będą rosły co rok .	rosły	4	Imp
Trudne warunki pozwolą co najwyżej wymyśleć cieplejszy korzuch .	wymyśleć	5	Perf
Przeżył , bo udał , że jest martwy .	Przeżył	0	Perf
Zresztą nawet bez Twego wyznania dalo się to odczuć .	odczuć	8	Perf
Dyrektor wymienia imprezy , które zorganizował .	wymienia	1	Imp
Oddały ster rządów lewicy .	Oddały	0	Perf
Wystarczyło paru lat , aby konkret został wyklęty .	Wystarczyło	0	Perf
Ale jak można było dopuścić do takiego mezaliansu ? ? ? ?	dopuścić	4	Perf
- Franosz telefonował , że już są .	telefonował	2	Imp
Nie wiedzą , że brak jednej maszyny ?	wiedzą	1	Imp
Do sali zjechali śmy godnie , windę znarowioną już naprawili .	zjechali	2	Perf
- Zbiórkę poprzedziła akcja informacyjna , uczniowie wiedzą , na jaki dobry cel popłyną pieniądze .	poprzedziła	2	Perf
Policjanci odwieźli delikwentów do izby wytrzeźwień .	odwieźli	1	Perf
Zakończyły się sukcesem .	Zakończyły	0	Perf
Z tej też przyczyny afirmacje i modlitwy formułuje się w czasie teraźniejszym .	formułuje	7	Imp
Spóźnili śmy się . . .	Spóźnili	0	Perf
– Mógł .	Mógł	1	Imp
My takiej nie prowadzimy , nie wykonujemy zadań publicznych dla zysku , ale dla dobra mieszkańców .	prowadzimy	3	Imp
– Spojrzała pytająco na męża , ale zbył ją milczeniem .	zbył	7	Perf
Wcale się nie ucieszył z naszego spotkania .	ucieszył	3	Perf
Do Warszawy dotarli już o gęstym zmroku .	dotarli	2	Perf
Po ślubie wynajęli mieszkanie w starej kamienicy .	wynajęli	2	Perf
Wybudujecie nową , za co ?	Wybudujecie	0	Perf
Zrobiła swoje .	Zrobiła	0	Perf
Długo się nie widzieli śmy , chyba ze dwa tygodnie .	widzieli	3	Imp
Gertruda nie miała pewnie licencji a zaczęła wykorzystywać komercyjnie .	wykorzystywać	7	Imp
Roman klęczał na posadzce i szukał pieniędzy , które mu podczas inkasowania wypadły z ręki .	szukał	5	Imp
Nie zapomnę tego pierwszego dnia .	zapomnę	1	Perf
Dziewczyna głośniej zachlipała w progu .	zachlipała	2	Perf
Pieniędzy nie odzyskano do dziś .	odzyskano	2	Perf
Nawet nie próbował się wykręcić , odmówił wprost .	wykręcić	4	Perf
Nawiedzony dom w Rajsach znają wszyscy , zarówno mieszkańcy Miejsca Piastowego , jak i krośnianie .	znają	4	Imp
W październiku podczas pierwszych tegorocznych mrozów zamarzły cztery osoby .	zamarzły	6	Perf
Czy niczego nie jada się palcami ?	jada	3	Imp
W pewnym momencie Józef Z . stwierdził , że pójdzie się zdrzemnąć .	stwierdził	6	Perf
Zaskoczyło mnie to .	Zaskoczyło	0	Perf
- Sąd obawiał się , że nie zdąży przesłuchać pana ministra .	przesłuchać	8	Perf
Na wrocławski Rynek rzeczywiście przybyły tłumy .	przybyły	4	Perf
Lustrują pod wodą całe wschodnie wybrzeże Bałtyku .	Lustrują	0	Imp
- Teraz ubieraj się już , Simonne .	ubieraj	2	Imp
Nie mam pojęcia , dlaczego ignorują fakty .	ignorują	5	Imp
Cameron będzie obserwować , jak wolno objeżdża trotuar , oglądając inne dziewczyny .	obserwować	2	Imp
- Komu zwracasz uwagę ?	zwracasz	2	Imp
W poniedziałek rano do Betlejem i Kalkilli na Zachodnim Brzegu Jordanu wjechały izraelskie czołgi .	wjechały	11	Perf
Ze stara wyciekał olej i płyn chłodzący , a przyczepa miała zdemontowany hamulec awaryjny .	wyciekał	2	Imp
Postanowił em nie wstępować nawet do ojca .	Postanowił	0	Perf
Samochód ostro zahamował , a kierowca wychylił się przez okno .	wychylił	6	Perf
Pokrzepiła mnie tym na duchu .	Pokrzepiła	0	Perf
Wypłynęli śmy , ale miał em książeczkę do nabożeństwa .	Wypłynęli	0	Perf
- Sława , Maryna i Krzysztof podbiegają i odbierają od niej paczki .	podbiegają	6	Imp
Czyżby teraz przepuściła okazję , mając tuż obok przystojnego młodego mężczyznę ?	mając	5	Imp
- Manewr z odroczeniem posiedzenia Sejmu oznacza , że bracia Kaczyńscy dążą do władzy absolutnej , do dyktatury .	dążą	11	Imp
Zapraszam wszystkich chętnych .	Zapraszam	0	Imp
- Skaczesz , rozglądasz się i wracasz .	Skaczesz	1	Imp
Tuż po publikacji rozdzwoniły się telefony z zamówieniami .	rozdzwoniły	3	Perf
Decyzja Rady Polityki Pieniężnej o obniżeniu oprocentowania powinna teoretycznie osłabić złotówkę .	osłabić	9	Perf
Bałamucić słowem i myślą .	Bałamucić	0	Imp
Każdy sąd rzetelnie dokumentuje .	dokumentuje	3	Imp
Ucieszy się , że ktoś kradnie jej książki .	Ucieszy	0	Perf
Okazało się również , że motocyklista nawet nie hamował przed uderzeniem .	hamował	8	Imp
Zaniżają lub w ogóle nie wypłacają ekwiwalentów za niewykorzystane urlopy .	Zaniżają	0	Imp
A jednak się żegnam .	żegnam	3	Imp
Nie trzeba jednak od razu spiętrzać Wisły , żeby wytwarzać energię elektryczną .	wytwarzać	9	Imp
Zgodził się , dał kilka dobrych rad i wyznaczył Polluksa na dowódcę .	Zgodził	0	Perf
Jeśli sumienie na to wam zezwala .	zezwala	5	Imp
Zranił go w głowę .	Zranił	0	Perf
Usamodzielniły się Wyry , Bojszowy , Lędziny i Bieruń .	Usamodzielniły	0	Perf
Istniała wcześniej i będzie istniała potem .	Istniała	0	Imp
Nie lubię siedzieć sama w lokalu .	siedzieć	2	Imp
Minuty ciągną się niemiłosiernie długo .	ciągną	1	Imp
Osiedla się w Kafarnaum nad jeziorem i zaczyna swoją publiczną działalność .	Osiedla	0	Imp
– ty czytasz Jackowi bajki do snu tak na fotelu ?	czytasz	2	Imp
Od lat realizuje kolejną pasję , którą jest fotografia .	realizuje	2	Imp
Owa niezapomniana chwila zawierała nieprawdopodobny ładunek patosu .	zawierała	3	Imp
Czy zamienił by ś wszystkie swoje osiągnięcia na olimpijski medal ?	zamienił	1	Perf
W jego armii służyli teraz synowie śmiałków , którymi dowodził przed laty .	dowodził	9	Imp
Bronił eksmitowanych na bruk , naprawiając błędy przyjętej przez koalicję SLD­PSL ustawy , grzmiał na globalistów i świeżych krajowych , drapieżnych kapitalistów .	grzmiał	13	Imp
Do kraju powróciły uprowadzone Polki .	powróciły	2	Perf
– Bo chyba pana Macierewicza trzymają się żarty .	trzymają	5	Imp
Wobec tego mąż delikatnie informuje o tym żonę .	informuje	4	Imp
Nagle z ciemności wyłoniło się trzech mężczyzn kryjących twarze pod kominiarkami .	wyłoniło	3	Perf
Administracja Lecha Wałęsy nie przewidziała w nim puli na nagradzanie wyróżniających się młodych Polaków .	przewidziała	4	Perf
Pod koniec gotowania dodajemy sos sojowy i na kilka minut pozostawiamy pod przykryciem .	dodajemy	3	Imp
Naprawdę rzadko się zdarza w województwie , że w jakiejś dziedzinie sięgamy po pierwsze miejsca .	zdarza	3	Imp
Gdy rozpędzał je kamień , uciekały w krzaki z pyskami wbitymi w puszki po konserwach .	uciekały	5	Imp
Pan Bielski pełni teraz publiczne funkcje . . .	pełni	2	Imp
- Szczęka mi opada .	opada	3	Imp
- Słyszę , iż nie śpisz jeszcze .	Słyszę	1	Imp
Do obozu pozostało jeszcze parę kilometrów .	pozostało	2	Perf
- Na wiosenną wodę puszczał okręciki , żeby się popisać czymś niezwykłym .	puszczał	4	Imp
Chciał ją spytać o wiele rzeczy .	spytać	2	Perf
Angus powtarzał to wszystko , nawet , jeżeli sam w coś nie wierzył .	powtarzał	1	Imp
Skowron przytrzymał go za marynarkę .	przytrzymał	1	Perf
Zmieniamy ludzi , którzy zawiedli .	zawiedli	4	Perf
Błędek może domyślał się tego niedoszłego dalszego ciągu .	domyślał	2	Imp
W jej twarzy , mokrej od łez rozmazanych i czerwonej , tężały w osłupieniu szkliste , bladoniebieskie oczy .	tężały	11	Imp
I oczywiście zaczął koncertować .	koncertować	3	Imp
Wieprzek zatrzymał się nie przestając kwiczeć .	kwiczeć	5	Imp
A kto mu każe tam żreć ? !	każe	3	Imp
Wystarczyło zrobić jeszcze krok , może dwa .	Wystarczyło	0	Perf
Kompan zawtórował mu , próbując wszystko w żart obrócić .	próbując	4	Imp
Zaprosimy cię na otwarcie , przysięgam .	przysięgam	5	Imp
Przez pierwszy tydzień leżą ukryte w wysokiej trawie , a następnie zaczynają wędrować za matką .	wędrować	12	Imp
Tego tolerować nie można !	tolerować	1	Imp
Ministerstwo Finansów zaproponowało w założeniach do przyszłorocznego budżetu radykalne oszczędności , aby zmniejszyć jego deficyt do 35 mld zł .	zaproponowało	2	Perf
Tylko w minioną sobotę w atakach terrorystycznych w Bagdadzie zginęło ponad 40 osób .	zginęło	9	Perf
Wszystko razem urzekało .	urzekało	2	Imp
Z klatki wyszedł sąsiad i w pijackim amoku rzucił się na niego z siekierą .	rzucił	8	Perf
Obudzimy Anamarię o dwunastej .	Obudzimy	0	Perf
Jeżeli rząd chce wprowadzać swoje reformatorskie projekty , musi porozumiewać się z prezydentem .	porozumiewać	9	Imp
Kasia zrezygnowała .	zrezygnowała	1	Perf
Pragnę nadmienić , że nie wszystkie marzenia i oczekiwania wywołują sny odwrotne .	nadmienić	1	Perf
IPN pierze mózgi już w przedszkolu .	pierze	1	Imp
Smolorz powtarzał to sobie kilka razy w czasie jazdy przez miasto .	powtarzał	1	Imp
Chcesz przez to powiedzieć , że Mendelejew musiał udowodnić , że istnieją nieznane pierwiastki .	istnieją	11	Imp
Najpierw strzelił w kierunku ochroniarza , na szczęście chybił .	chybił	8	Perf
Mieszkam w domu niedaleko drogi .	Mieszkam	0	Imp
Rozdzielali zwaśnione strony w ramach misji pokojowych ONZ .	Rozdzielali	0	Imp
Raz zapragnęli socjalizmu , potem zwrócili się przeciw socjalizmowi . . .	zwrócili	5	Perf
Z każdym dniem przybywa ofiar tej wojny .	przybywa	3	Imp
Ten wiersz Dominika przykleiła sobie nad biurkiem , a Jadzia dziwiła się .	dziwiła	10	Imp
Codziennie przynajmniej przez godzinę należy odbywać ćwiczenia .	odbywać	5	Imp
Deszcz omal nie doprowadził do tragedii .	doprowadził	3	Perf
Matki marzeniem jest , by córka osiadła , zaczepiła się gdzieś .	zaczepiła	8	Perf
Przeglądam dziennik swój .	Przeglądam	0	Imp
- Polska przez wiele lat korzystała z pomocy Zachodu .	korzystała	5	Imp
W Drygałach koło Białej Piskiej zatrzymany do kontroli 47-letni kierowca zionął na policjantów czosnkiem .	zionął	10	Perf
Wszystkie cztery podstawowe tezy scholastyczno - tomistycznej koncepcji Boga uległy w nowożytnej filozofii gruntownemu zakwestionowaniu .	uległy	9	Perf
Kiedy sprawa się wydała , wyleciała z hukiem ze szpitala .	wyleciała	5	Perf
W trakcie remontu zauważył go nowy właściciel mieszkania , bo z piasku wystawała ręka .	wystawała	12	Imp
Tu spędzał wolne chwilę .	spędzał	1	Imp
ruszę się .	ruszę	0	Perf
Jak zwykle pośliznął się na posadzce w przedpokoju , chłodnym i białym niczym Antarktyda we mgle .	pośliznął	2	Perf
Każdemu kazał wprzódy próby odbywać i różnych sztuk dokazywać w swojej obecności .	odbywać	4	Imp
Później łupy pojawiały się na krakowskiej giełdzie elektronicznej .	pojawiały	2	Imp
Staruszkę ze zmiażdżoną prawą stopą przewieziono do szpitala przy ulicy Cegłowskiej .	przewieziono	5	Perf
Poszła m zdawać na filozofię .	zdawać	2	Imp
Rozwijano taśmę , wbijano paliki , ustawiano płotki , a w niebie i w krzewach śpiewały ptaki .	ustawiano	6	Imp
Wuja nie uczestniczył w rozmowie przyglądając się im obu bez sympatii .	przyglądając	5	Imp
Nawet dziwiła się ciocia .	dziwiła	1	Imp
Został em Żydem .	Został	0	Perf
Zakręciła się , jakby czegoś szukała w pokoju .	Zakręciła	0	Perf
Panowie w cylindrach i w melonikach tkwili bokiem na przednich ławeczkach .	tkwili	6	Imp
Zatrzymał się na półpiętrze .	Zatrzymał	0	Perf
- Wydziela kwas salicylowy .	Wydziela	1	Imp
Na pastwisku w Uniszkach Gumowskich rolnik załadował na dwukółkę krowę .	załadował	6	Perf
Konieczność jej przeprowadzenia uznaje nawet SLD .	uznaje	3	Imp
Kiedy go wciśniemy , wycisza wszystkie dźwięki .	wciśniemy	2	Perf
Oprócz okradania opolan eseldziaki kantowały również kumpli w interesach .	kantowały	4	Imp
Wtedy napastnicy zaczęli go kopać po całym ciele .	kopać	4	Imp
- Sprawdzić , czy nie zmienił eś zdania .	Sprawdzić	1	Perf
- Nie trza , damy se sami radę !	damy	4	Perf
– Leżał na rękawicach ochronnych i też był popaprany ziemią .	Leżał	1	Imp
Zaśmiał się .	Zaśmiał	0	Perf
Wypowiedział wojnę wielu bardzo różnym środowiskom .	Wypowiedział	0	Perf
Skupieni operatorzy delikatnie manipulowali skomplikowanymi urządzeniami odbioru przekazywanej informacji .	manipulowali	3	Imp
Liczył na wściekłość .	Liczył	0	Imp
– Wyglądasz staro .	Wyglądasz	1	Imp
Jest samodzielny , codziennie dojeżdża na zajęcia 12 km z Koszalina .	dojeżdża	4	Imp
Banki akcyjne brały prowizje od swych usług i szukały zysku .	brały	2	Imp
Ta matka dba o nią , jak umie .	umie	7	Imp
Dopiero go zbadają .	zbadają	2	Perf
Zaleźć za skórę !	Zaleźć	0	Perf
Wyprowadzają one małe koźlęta na płaty śniegu i uczą je zjeżdżać na racicach .	uczą	8	Imp
Przerażona dziewczyna pobiegła do ciotki , która mieszka za ścianą , i w sekrecie opowiedziała , co robił jej tata .	opowiedziała	14	Perf
Mów , co ś załatwił .	załatwił	4	Perf
Publiczność przyjęła ją entuzjastycznie , ale krytycy nazwali królową kiczu .	przyjęła	1	Perf
Ty coś ćwiczysz ?	ćwiczysz	2	Imp
I puścił go .	puścił	1	Perf
Fenometys wciąż kręcił głową , światło lamp odbijało się na bezwłosej skórze idealnymi refleksami .	odbijało	7	Imp
Spośród nich wybierzemy trzy najlepsze .	wybierzemy	2	Perf
Azaliż wątpili ście w to ?	wątpili	1	Imp
Ich mieszkańcy do dzisiaj pamiętają wojnę z rozwydrzoną młodzieżą , wojnę o prawo do spokojnego snu , którą w końcu wygrały dla nich oddziały gestapowskiej policji .	pamiętają	4	Imp
Otwarłszy kran , jął odkorkowywać palcami pierwszą probówkę .	odkorkowywać	4	Imp
Zassał em powietrze .	Zassał	0	Perf
Ponoć nie życzyli sobie ich obecności inni dziennikarze . . .	życzyli	2	Imp
Zamiast trzystu dwudziestu ośmiu obiektów elektryfikacyjnych , załoga wybudowała trzysta sześćdziesiąt cztery .	wybudowała	8	Perf
Opodal trenowali skoki chłopcy na deskorolkach .	trenowali	1	Imp
Ci oczywiście nie zrobili mu najmniejszej krzywdy , gdyż gość był szmalowny .	zrobili	3	Perf
To pochlebia facetom .	pochlebia	1	Imp
Wojska etiopskie kontynuują ofensywę w Erytrei .	kontynuują	2	Imp
Na co chorują dziennikarze ?	chorują	2	Imp
Aparaturę filmową obsługuje instruktor terenowy PDK Czesław Fudala .	obsługuje	2	Imp
W gruncie rzeczy nie obchodziła go odpowiedź Heleny .	obchodziła	4	Imp
Trzecioligowcy strzelili kontaktowego gola , ale w ostatnim kwadransie dwie bramki dla Lecha wypracował Remień .	strzelili	1	Perf
Na skrzyżowaniach wyrastają rośli policjanci , gazeciarze wciskają przechodniom papierowe płachty i przekrzykują się nowościami z wczorajszego dnia i nocy , która właśnie minęła .	minęła	23	Perf
Ani esesmani , ani Ukraińcy nie mogą nic wyczuć z naszego zachowania .	wyczuć	8	Perf
A gdy dziewczyna przestała mnie okładać na chwilę , jednym szarpnięciem ciała próbowałem się wyrwać spod niej .	wyrwać	14	Perf
W dniu tym wystartują również bobsleiści .	wystartują	3	Perf
Cały nakład rozszedł się błyskawicznie .	rozszedł	2	Perf
Tam przygarnęła nas bardzo zacna rodzina .	przygarnęła	1	Perf
Jeździł z obstawą ?	Jeździł	0	Imp
Siedziała m przy nim , dopóki nie zasnął na naszym tapczanie , a teraz podbiegł do mnie boso .	Siedziała	0	Imp
Otworzyła m , nie sprawdzając .	Otworzyła	0	Perf
Ostatecznie rany mu opatrzyli .	opatrzyli	3	Perf
Usmaż jeszcze kiedyś faworki , błagam .	błagam	5	Imp
Państwo nie zarobi .	zarobi	2	Perf
Podczas którejś kolacji wyznał , że przez kilkanaście lat uprawiał pięściarstwo .	uprawiał	9	Imp
- Przyjaciele czyhają na naszą wolność !	czyhają	2	Imp
Ale demokrata Al Gore obiecał emerytom dopłaty państwa do leków . . .	obiecał	4	Perf
Firma skontaktowała się ze mną , przedstawiając opinię rzeczoznawcy .	skontaktowała	1	Perf
Dotychczas odwołujący się mogą pozostawać w Niemczech przez wiele miesięcy .	pozostawać	4	Imp
Krystyna Kofta ogłosiła , że przyjmuje na siebie misję walki o równouprawnienie Bożen z Krystynami i za dwa lata zaprosiła panie do Trójmiasta , by równość tę udowodnić .	przyjmuje	5	Imp
Z prawej wyskoczył cwałem ciężkozbrojny bez hełmu , schylił się , usiłując chwycić za szory zaprzęgu .	chwycić	12	Perf
Przekonamy się wkrótce .	Przekonamy	0	Perf
- Zadurzył eś się w Fantastyczce .	Zadurzył	1	Perf
- Sąd obawiał się , że nie zdąży przesłuchać pana ministra .	przesłuchać	8	Perf
Zajmowały się tym już Zofia Korczak - Blatonowa i Aniela Cieszkowska .	Zajmowały	0	Imp
Patrol saperski całą dobę dyżuruje w Kazuniu .	dyżuruje	4	Imp
Odpalił to makro , nawet nie wychodząc z trybu edycji .	wychodząc	6	Imp
Trzeba było wielokrotnie zatrzymywać się i je oczyszczać .	oczyszczać	7	Imp
– Pokazał ręką przeszklone okna penthausu .	Pokazał	1	Perf
- Spróbuję .	Spróbuję	1	Perf
Zaczął em pracować w kibucu .	pracować	2	Imp
Wirują mu musztardowe księżyce i słońca , a na samym dole żagla zjawia się łeb wieloryba o mikroskopijnych , czerwonych oczach .	zjawia	12	Imp
– ona czyta samodzielnie gazety ?	czyta	2	Imp
Poza tym zawsze proponuję lewicy , by odeszła od ideologicznej walki z prawicą i przeszła na spory o gospodarkę .	przeszła	14	Perf
Dziś Jacek kupił i zainstalował telefon bezprzewodowy .	zainstalował	4	Perf
Dla siebie zamówiła eskalopki cielęce .	zamówiła	2	Perf
Musiały jej powiedzieć , teraz .	Musiały	0	Imp
Drugiej , rozładowanej do połowy w Pruszkowie , rabusie nie tknęli .	tknęli	10	Perf
Ale dzięki temu można uratować komuś życie !	uratować	4	Perf
Dodawał też , że korzystał z jawnych źródeł .	Dodawał	0	Imp
Rozczytywał em się w Słowackim i w myślach nazywał em ją Ellenai .	nazywał	8	Imp
Parowozy zawsze fascynowały i przerażały .	fascynowały	2	Imp
Należała do mojego pokolenia , została też przez to pokolenie dobrze przyjęta .	Należała	0	Imp
Kaczmarek teraz równie stanowczo zaprzecza , by Ungier go ostrzegał .	ostrzegał	9	Imp
– Ojciec Benedykt służył tutaj ?	służył	3	Imp
Zmarł w Livorno w roku 1846 .	Zmarł	0	Perf
Morderca żony i córki trafi do szpitala psychiatrycznego , lekarze co pół roku będą sporządzać raporty dla sądu o stanie jego zdrowia .	sporządzać	14	Imp
Ludzie odeszli i zwrócili się w stronę Wiktora .	zwrócili	3	Perf
To zabrzmiało ostro .	zabrzmiało	1	Perf
Prasa podwoiła liczbę tytułów .	podwoiła	1	Perf
W słuchawce zaległa długa cisza .	zaległa	2	Perf
- Zamykaj buzię , bo ci świecący ptak do niej wleci .	Zamykaj	1	Imp
Ale wydaje mi się , że Lech , Czech i Rus musieli bardzo długo pędzić za jeleniem , dzikiem i niedźwiedziem .	pędzić	14	Imp
– Przypomina . . .	Przypomina	1	Imp
Więc stryj wciąż nieźle prosperował .	prosperował	4	Imp
- Czy chce otrzymać azyl w Danii ?	otrzymać	3	Perf
Śmiał się wesoło , nacisnął dziewuszce nos , a ona obruszyła się , grożąc palcem .	nacisnął	4	Perf
Pośliniła palec i zaczęła trzeć .	trzeć	4	Imp
Już na schodach usłyszała dźwięki dobiegające z komnaty dziadka .	usłyszała	3	Perf
Systematycznie prowadzili kontrole , zmierzające do ujawnienia różnego rodzaju piractwa .	prowadzili	1	Imp
Z czym przyjeżdżają ?	przyjeżdżają	2	Imp
- Myślała m , że ktoś w szkodę wlazł sąsiadowi .	Myślała	1	Imp
Tutaj nie odnajdą go ani Doppler , ani Georg .	odnajdą	2	Perf
- A gdzie wy garnki trzymacie ?	trzymacie	5	Imp
Ujawnił się jej pragmatyzm kobiecy ?	Ujawnił	0	Perf
Zniszczył em .	Zniszczył	0	Perf
Kto jeszcze nie przysłał swojego scenariusza ?	przysłał	3	Perf
W nocy z piątku na sobotę pili alkohol .	pili	6	Imp
Łączę się z wami .	Łączę	0	Imp
Dziewczyny mówią , że piszczała , płakała , śmiała się , przykucnęła , usiłując uspokoić drżące od wysiłku mięśnie i wtedy rzuciły się na nią . . .	przykucnęła	11	Perf
Po drodze , lekko podchmieleni , prowadzili ożywioną rozmowę .	prowadzili	6	Imp
Obstawił się własnymi ochroniarzami i policjantami .	Obstawił	0	Perf
Patrzył em , jak zasnuwały horyzont .	zasnuwały	4	Imp
Biadoli , że Trzęsionka doniesie im o naszym pijaństwie .	Biadoli	0	Imp
Przystupa odstawiła szklankę po whisky i skuliła się w fotelu , pan Cox wyglądał , jakby się właśnie obudził .	skuliła	6	Perf
Spędź godzinę z piękną dziewczyną , a wyda ci się minutą .	Spędź	0	Perf
Jeżeli człowiek silnie reaguje na różne zjawiska , może być tak odbierany .	reaguje	3	Imp
- Czy twój bóg zapewnił cię o tym ?	zapewnił	4	Perf
Zobaczył Dunaja .	Zobaczył	0	Perf
Chciał em należeć do harcerstwa , a w mojej szkole drużynę prowadzili akurat ci ludzie .	prowadzili	11	Imp
Mijały sekundy .	Mijały	0	Imp
Czym zapełnić dziurę w budżecie ?	zapełnić	1	Perf
Właścicielom wystarcza kino domowe , a bogate panie nie potrafią docenić kunsztu Anny Jaxy - Chamiec .	wystarcza	1	Imp
Manifestanci próbowali uniemożliwić policji zamykanie biur zdelegalizowanego ugrupowania .	uniemożliwić	2	Perf
Okupując wejście , czekały , co się wydarzy .	wydarzy	7	Perf
Potem nie chce mi się sprzątać łazienki .	sprzątać	5	Imp
Jestem raperem , jeżdżę rowerem .	jeżdżę	3	Imp
Przekonywał , że Wielkopolska jest przygotowana do skorzystania z unijnej oferty .	Przekonywał	0	Imp
– ja sobie to wyobraziła m inaczej .	wyobraziła	4	Perf
– Uderzyli cię w głowę ?	Uderzyli	1	Perf
Pan Korzeniowski zerwał się z krzesła , podbiegł do szafy , wysunął dolną szufladę , chwilę grzebał w papierzyskach .	podbiegł	7	Perf
Ciemne włosy , spięte w koczek , podtrzymywała złocista spinka .	podtrzymywała	7	Imp
I mimo chciwości cieszyli się w miasteczku dużym szacunkiem .	cieszyli	3	Imp
Musisz się zarejestrować !	zarejestrować	2	Perf
Sprawdzamy wyrostki kolczyste i łuki kręgów .	Sprawdzamy	0	Imp
Mało brakowało , a miłość do zajączka Kamil przypłacił by życiem .	brakowało	1	Imp
Kompan zawtórował mu , próbując wszystko w żart obrócić .	zawtórował	1	Perf
Taka sytuacja łatwo popycha do kroków desperackich .	popycha	3	Imp
Śmieszy mnie ta zabawa w barbarzyńcę , bezmyślne opróżnianie butelek pod krzyżówkę Mickiewicza z amerykańskim hamburgerem .	Śmieszy	0	Imp
Złamanie tego zakazu powinno spowodować odwołanie faceta z funkcji .	spowodować	4	Perf
W pięć minut później przypomniał sobie , że należało wpierw wytrzeć gumką uwagi na marginesach .	wytrzeć	10	Perf
W środę rano ma wyjechać .	wyjechać	4	Perf
Izrael zagroził wczoraj , że wkroczy zbrojnie na tereny Autonomii , jeśli Arafat nie zapanuje nad terrorem .	zapanuje	14	Perf
Obserwuję je drżąc .	Obserwuję	0	Imp
Ręką wyczuwam w kieszeni moje wiersze .	wyczuwam	1	Imp
– i teraz podpisywała ś ?	podpisywała	3	Imp
Kocham polskich chłopów hodujących polską brukselkę . . .	Kocham	0	Imp
Znajdziemy inny symbol .	Znajdziemy	0	Perf
Konkurs składał się z etapu ustnego i pisemnego .	składał	1	Imp
Dziękuję , że mimo trudności odwiedza mnie Pan i komentuje moje teksty .	komentuje	9	Imp
– to się w niej rozwinie . .	rozwinie	5	Perf
Wszystko się kołysze , obie jednostki płyną .	płyną	6	Imp
Ograniczenie szybkości obowiązuje tutaj od soboty z powodu rutynowych prac konserwatorskich .	obowiązuje	2	Imp
- Pojebało cię ? !	Pojebało	1	Perf
- Podeszła , postukała w dioramę .	postukała	3	Perf
Ręce jej wyraźnie drżą .	drżą	3	Imp
– Modlił się .	Modlił	1	Imp
Wtedy zaczął mordować .	mordować	2	Imp
- Polecisz .	Polecisz	1	Perf
Oni wierzą .	wierzą	1	Imp
Średnio płacąc kartą , wydawali śmy 211 złotych .	płacąc	1	Imp
Nie krzyknął em .	krzyknął	1	Perf
Dla tej ojczyzny nawet lepiej było , kiedy owi emigranci nie odwracali się za siebie , nie próbowali powrotu .	odwracali	11	Imp
Na parterze pozostanie Księgarnia Literacka .	pozostanie	2	Perf
Mimo to może nie zobaczyć już syna , bo dziadkowie uprowadzili go na Ukrainę .	uprowadzili	10	Perf
Nie odwódźcie mnie . . .	odwódźcie	1	Imp
Zdjęła kapelusz , odetchnęła z ulgą .	Zdjęła	0	Perf
Syk łosia umilkł .	umilkł	2	Perf
Pracowano przez całą noc przy świetle reflektorów .	Pracowano	0	Imp
Młode kudowianki z reguły są jeszcze na utrzymaniu rodziców , którzy ledwie wiążą koniec z końcem .	wiążą	12	Imp
Reagował jak ideowy socjalista .	Reagował	0	Imp
W święta głodowało już sześciu pracowników MZK , przedwczoraj dwóch z nich odmówiło przyjmowania płynów .	głodowało	2	Imp
Prawie nienawidziła .	nienawidziła	1	Imp
Meseńczycy , odwieczni wrogowie Sparty , zgodzili się przepuścić ich przez swoje terytorium .	zgodzili	6	Perf
- Czy chce otrzymać azyl w Danii ?	otrzymać	3	Perf
Już wówczas zaczęto go przygotowywać do przyszłej akcji na Wschodzie .	zaczęto	2	Perf
Ogromnie interesowało ich , co z tych zabiegów wyniknie .	wyniknie	8	Perf
Zwodujcie Wałęsę .	Zwodujcie	0	Perf
Żaden z generałów nie podał nazwy pocisku , ani jego charakterystyki .	podał	4	Perf
Idę coś zjeść .	zjeść	2	Perf
Wtorek przyniósł postęp , jakiego się nawet nie spodziewano .	spodziewano	8	Imp
Banki mogą żądać prowizji od kredytu .	żądać	2	Imp
Ale ramy , instytucje i aspiracje Cesarstwa narzuciły się apostołom , biskupom , kapłanom i wiernym jako odniesienie oczywiste i nieuniknione .	narzuciły	7	Perf
Na wschodzie majaczą szczyty Tynioka , Ganczerki , a tam dalej , już niewidoczna , bardziej na północ , jest Barania .	majaczą	2	Imp
Może chłopiec zasłucha się i zaśnie ? . . .	zasłucha	2	Perf
Nagrody przyznała specjalna Kapituła , pragnąc uhonorować osoby i instytucje , których działalność wniosła znaczący wkład w krzewienie tolerancji .	przyznała	1	Perf
Ratuj się , kto może .	Ratuj	0	Imp
Malował wówczas synagogę w Opatowie .	Malował	0	Imp
Mariola odstawiła torebkę na malutki stołeczek .	odstawiła	1	Perf
Ludzie wyjechali w poszukiwaniu wygody .	wyjechali	1	Perf
Oskarżano nas , że w Bielicznej sprzedali śmy prywatnemu nabywcy kilkaset hektarów wraz z cmentarzem i cerkwią .	sprzedali	6	Perf
Pan doktor wyrysował dziś naszą topolową aleję . . .	wyrysował	2	Perf
W kierunku zachodnim przewożono ich mercedesem .	przewożono	3	Imp
Niektóre sprawy trafiły nawet do kolegium .	trafiły	2	Perf
Proszowiccy strażacy wyjeżdżali w ostatnim czasie do dwóch pożarów , spowodowanych prawdopodobnie przez podpalaczy .	wyjeżdżali	2	Imp
Ognisko zgasło .	zgasło	1	Perf
Spojrzał em na kobietę i stwierdził em , że po raz pierwszy jej twarz zasługiwała na uwagę .	stwierdził	5	Perf
W ubiegłym roku udało się tę pozycję zmieścić w budżecie .	zmieścić	7	Perf
Ale się mylił .	mylił	2	Imp
I cała wspólnota modli się za niego .	modli	3	Imp
ŻYCIE przedstawiło w sądzie świadków , którzy widzieli Kwaśniewskiego w Cetniewie .	widzieli	7	Imp
Wykonano ją chałupniczo , ale nie powstydził by się ich żaden fachowiec .	powstydził	6	Perf
Poklepał chłopca po ramieniu .	Poklepał	0	Perf
W Londynie również zaciekle występowały przeciwko nim europejskie feministki .	występowały	4	Imp
Wyprostował się .	Wyprostował	0	Perf
- Nie gniewaj się , pomyśl , zrobili śmy im taką przyjemność .	gniewaj	2	Imp
Starcie między Generałem a MRP przybrało nawet formy drastyczne .	przybrało	5	Perf
Ten , porwawszy swój kord , pobiegł za nim .	porwawszy	2	Perf
Stary kładzie ręce w kieszenie i chodzi po pokoju .	kładzie	1	Imp
Ja chciał em mu prawdę wywalić .	wywalić	5	Perf
Jego młodość przemówiła do mnie .	przemówiła	2	Perf
Konferencja ideologiczna omówiła wiele interesujących spraw .	omówiła	2	Perf
Dotychczas obowiązek donoszenia WKU o studentach , którzy przerwali naukę , spoczywał na uczelniach .	przerwali	8	Perf
Spodobało się ?	Spodobało	0	Perf
Zaczynają boleć kolana .	Zaczynają	0	Imp
Przypomina tego twojego pedała ze Służewa .	Przypomina	0	Imp
Ktoś położył mu na ramiona prześcieradło .	położył	1	Perf
W Jerozolimie ludzie dyskutują .	dyskutują	3	Imp
Jest szczęśliwy , zauważa moją nową fryzurę .	zauważa	3	Imp
Ukończyły wyścig razem , trzymając się za ręce .	Ukończyły	0	Perf
Zapytał mnie w pewnym momencie , czy do niego pójdę .	Zapytał	0	Perf
Jak się wywiążą ?	wywiążą	2	Perf
Kiedy RS AWS się wzmocni , ja też zrezygnuję z pewnych funkcji .	wzmocni	4	Perf
Rzuciła smyczek . . .	Rzuciła	0	Perf
Jan Skiba odszedł w 1990 r . z resortu bez wielkiego żalu , bo zrozumiał , że jego czas już się wypełnił .	wypełnił	21	Perf
Józinek ochłonie , sprzątnie , przeprosimy się .	ochłonie	1	Perf
Zerkała na czarno - biały obraz i pogryzała słone paluszki .	pogryzała	7	Imp
tak się kroi go i tak się macza w tym sosie .	kroi	2	Imp
Po piętnastu zawiadamiamy Kowala , że coś ci się stało .	zawiadamiamy	2	Imp
Kot usiadł obok i znowu miauknął .	miauknął	5	Perf
Utnij na dwie dulki i schodź , bo palić się strasznie chce .	palić	8	Imp
Przez ostatnie 10 lat przyzwyczaili się do obecności prezydenckiej pary .	przyzwyczaili	4	Perf
Zbroimy się !	Zbroimy	0	Imp
I tutaj mnożą się problemy .	mnożą	2	Imp
Pan zanotuje sobie prywatny numer posła . . .	zanotuje	1	Perf
Pamiętasz , jak my śmy kiedyś tak rozmawiały o tym , że trzeba szukać ideału . . .	rozmawiały	7	Imp
– dej spokój .	dej	1	Perf
Uczciwie zarabiaj na chleb .	zarabiaj	1	Imp
Nakazał też wypłatę wynagrodzenia , które by otrzymywały , gdyby świadczyły pracę w poradni .	świadczyły	10	Imp
Nie dopisali również posłowie .	dopisali	1	Perf
Uśmiechnęła się tylko do siebie .	Uśmiechnęła	0	Perf
Szły dzieci przez pole minowe i wesoło machały rączkami .	machały	7	Imp
Co znów wyrwało z kręgu tej kultury wielu intelektualistów .	wyrwało	2	Perf
Jesienią Hamid też poszedł na wojnę , by pomścić brata .	poszedł	3	Perf
Zabrał ponad 30 tys . zł .	Zabrał	0	Perf
W tym roku prawdziwa zima wyprzedziła kalendarzową .	wyprzedziła	5	Perf
Wolała puszczać w kinach filmy kung-fu licząc , że dzięki temu ludzie przestaną myśleć o polityce .	puszczać	1	Imp
Grożąc skrzywdzeniem Anety , zabronili też powiadamiać policję .	zabronili	4	Perf
Odnotowano ponadto kilkanaście zachorowań .	Odnotowano	0	Perf
Przebiegające pod miastem chodniki kopalni zalano wodą , a wzgórze zgniło i zapadło się w ziemię jak przydeptane .	zgniło	10	Perf
- ROZMAWIAM , ZAWIERAM ZNAJOMOŚCI .	ZAWIERAM	3	Imp
– chcesz się przejść ?	przejść	3	Perf
To się nazywało teatr , ale to było mieszkanie cioci Lecha Emfazego .	nazywało	2	Imp
Olszyna , o której wspomniał on przed chwilą , była już niedaleko .	wspomniał	4	Perf
na nartach nie połamali się natomiast się połamali w Sylwestra . .	połamali	7	Perf
Zwracajmy szczególną uwagę na bezpieczeństwo dzieci .	Zwracajmy	0	Imp
W związku z Katyniem śmiać się głośno nie wypada .	śmiać	4	Imp
Tylko spróbuj !	spróbuj	1	Perf
Zaraz pójdę sprawdzić .	pójdę	1	Perf
Sądząc po sztućcach , może nią być danie rybne .	Sądząc	0	Imp
Po odbyciu kary Zdankiewicz znów brylował w podrzędnych knajpach .	brylował	5	Imp
Splotła silne dłonie .	Splotła	0	Perf
Zgodnie z oczekiwaniami po złoto sięgnęły ekipy gospodarzy .	sięgnęły	5	Perf
Wymknął się za kotarę z dzbankiem po wodę .	Wymknął	0	Perf
Dali wzgardę i zdradę , zapłacili zwykłą swą monetą .	zapłacili	5	Perf
Nie oglądał em się za kobietami .	oglądał	1	Imp
Wtedy stało się coś , czego nie mogli pojąć .	pojąć	8	Perf
Zaczerwieniła się , wzgardliwie odymając usta .	Zaczerwieniła	0	Perf
Wsadził ją do schowka pod schodami .	Wsadził	0	Perf
- Suutari chwycił wojownika , wyrywając mu broń z ręki .	chwycił	2	Perf
A więc może nieświadomie wyrządza mu krzywdę .	wyrządza	4	Imp
- Miasto wydzierżawiło teren bez problemów .	wydzierżawiło	2	Perf
Znów pomógł mu aspirant .	pomógł	1	Perf
Zmarszczył brwi i przez chwilę bił się z jakimiś myślami .	Zmarszczył	0	Perf
Zgodził em się ostatecznie na kolej .	Zgodził	0	Perf
Próbował ugasić ogień rękami .	ugasić	1	Perf
Po chwili drzwi się uchyliły .	uchyliły	4	Perf
Odeszli , choć mogli zapytać o to i owo w samym Betlejem .	Odeszli	0	Perf
W biurze rajdu kolejka kierowców topniała w oczach .	topniała	5	Imp
Chcieli ich reanimować , ale okazało się to zbędne .	reanimować	2	Imp
- Przez 40 lat płaciliśmy składki na służbę zdrowia , a teraz , kiedy jej na-prawdę potrzebujemy , wypinają się na nas .	potrzebujemy	16	Imp
Powołano specjalny zespół mający wyjaśnić przyczyny i okoliczności tragedii .	Powołano	0	Perf
Ponadto wykładano o spółdzielczości rolniczej i handlu rolniczym .	wykładano	1	Imp
– Rzucili się na pana ?	Rzucili	1	Perf
Tak właśnie zrobiliśmy , a tych handlarzy , którzy pracowali półlegalnie , przegonili pogranicznicy .	przegonili	12	Perf
- Mógł by m wejść do Internetu ?	wejść	4	Perf
Komisje Rady już pracują .	pracują	3	Imp
Jestem przekonany , że grzechem jest oglądać ten film i trzeba się z tego spowiadać .	spowiadać	14	Imp
Do zadania pytania zapisało się 53 posłów .	zapisało	3	Perf
Miejmy nadzieję , że ich nowa redakcja zawierać będzie wnioski autorów omawianej publikacji .	zawierać	7	Imp
Grzebał uparcie po półkach .	Grzebał	0	Imp
Oklapł , opadły mu ramiona i tylko piwny brzuszek sterczał nad paskiem spodni .	opadły	2	Perf
- Za godzinę zjawi się u państwa moja sekundantka .	zjawi	3	Perf
- Przydeptał koniec nogą i stanął , czekając na nas .	Przydeptał	1	Perf
Wasielewski wyprowadził wóz z parkingu i włączył się do ruchu .	wyprowadził	1	Perf
Podzieli ona Twoje nadzieje i zaproponuje wspólne plany .	Podzieli	0	Perf
Występujesz gdzieś teraz ?	Występujesz	0	Imp
Może nauczysz się wreszcie , jak się takie rzeczy załatwia .	załatwia	9	Imp
Czy powinnam powiadomić syna tego pana , że ona ich okrada ?	okrada	10	Imp
W gabinecie sadza na fotelu , siada obok i w obecności rodziców streszcza mu , co jej opowiedzieli .	streszcza	12	Imp
Można na tym siedzieć .	siedzieć	3	Imp
Najpierw przyśnił się młynek do kawy .	przyśnił	1	Perf
U sześciu pozostałych kandydatów dopatrzyła się nieprawidłowości .	dopatrzyła	4	Perf
Jął przeciskać się przez zaporę , czołgał się przez rumowisko , zmiażdżone wózki .	czołgał	6	Imp
Podskoczył em do drzwi , ale stanął w nich jakiś mężczyzna , tyłem do mnie , i nie mogł em nic dojrzeć .	dojrzeć	21	Perf
Zboża mniej się opłacają .	opłacają	3	Imp
Przekaż jej moje . . .	Przekaż	0	Perf
Panie , pustynią odtąd władać będziesz . . .	władać	4	Imp
Warto by zażądać wojskowego konsultanta .	zażądać	2	Perf
Nie odcinam się od przeszłości .	odcinam	1	Imp
na powodzian zbierają pieniądze .	zbierają	2	Imp
Przedtem włóczyli się po mieście , topniał śnieg , szumiało w rynnach , czuć było powiewy ciepła i zgnilizny , nad dachami tłukły się kłębiaste chmury .	szumiało	9	Imp
- Przykryj go .	Przykryj	1	Perf
Pirkka zadrżał pod wpływem przeciągu .	zadrżał	1	Perf
Bawi mnie to w jakiś ponury sposób .	Bawi	0	Imp
Kto chciał by zabrać głos ?	zabrać	3	Perf
Ktoś poprosił w radiu , by słuchacze przysyłali swoje teksty o godności .	przysyłali	7	Imp
Radny Eugeniusz Morta chciał przed głosowaniem usłyszeć silne argumenty za wydaniem tak dużej kwoty .	usłyszeć	6	Perf
Mówiły one o uniezależnieniu się Prus Książęcych od Polski .	Mówiły	0	Imp
Obstępują solenizanta , śpiewają sto lat , a maluchy wręczają kolorowe paczki .	wręczają	9	Imp
Również państwo bardzo się starało , żeby księża wzięli swoje .	starało	4	Imp
- Może spotkasz swojego starego znajomego , Szmidta .	spotkasz	2	Perf
- Wysłaliśmy ponad 500 zapytań , systematycznie przeglądamy odpowiedzi i nie natrafiliśmy jeszcze na urzędnika , na którym ciąży prawomocny wyrok sądowy .	przeglądamy	7	Imp
Mariusz Walter zadebiutował jako reżyser już w latach 60 . , szybko związał się z telewizją publiczną , w której pracował aż do lat 80 .	związał	12	Perf
Trzęsą mi się nogi .	Trzęsą	0	Imp
Szwagier pana Korzeniowskiego toporem rozrąbał świński łeb i wydobył mózg .	rozrąbał	4	Perf
- Czy księdzu wolno publicznie krytykować przełożonych ?	krytykować	5	Imp
- Nie wyobrażam sobie piękniejszej śmierci .	wyobrażam	2	Imp
Zyta milknie , Blanka opowiada o kłopotach małżeńskich .	milknie	1	Imp
PRZEGRAŁ EŚ !	PRZEGRAŁ	0	Perf
Za pomaganie funkcjonariuszom MO Konstanty odpowie teraz przed sądem .	odpowie	5	Perf
Łagodzić . . .	Łagodzić	0	Imp
Starym kawalerem zostanie i następcy zabraknie , tradycja garncarska w rodzinie Kraszewskich zaginie . . .	zaginie	12	Perf
- Ja nie spotykam się z takimi opiniami .	spotykam	3	Imp
Według stołecznych policjantów , udało mu się zgromadzić wokół siebie młodych przestępców z Pragi .	zgromadzić	7	Perf
znajomych trochę poodwiedzam .	poodwiedzam	2	Perf
Jakaś staruszka dreptała z dzbanem po wodę .	dreptała	2	Imp
Frajer odjedzie .	odjedzie	1	Perf
- Idź spać .	Idź	1	Imp
Czołgi i wozy pancerne strzegą więzienia , do którego ciężarówki wojskowe bez przerwy przywożą aresztowanych .	przywożą	13	Imp
Wlazło mu sekundował .	sekundował	2	Imp
Sołtys Ligoty Stanisław Kuźnik składa serdeczne podziękowanie wszystkim sponsorom , którzy przyczynili się do zorganizowania festynu i dzięki którym dzieci z Ligoty będą mogły pojechać na wycieczkę .	przyczynili	11	Perf
Pracowicie wyodrębnił pojęcia takie jak ból , smutek , rozpacz , cierpienie , żal .	wyodrębnił	1	Perf
Nie znoszę bezczynności .	znoszę	1	Imp
Amerykanie rzeczywiście zrobili śliczny manewr pancerny .	zrobili	2	Perf
Jego zakład działa już 11 lat .	działa	2	Imp
Gdyby udało się skompletować księgę obdarowanych , zawierałaby ona listę nazwisk tworzących znaczną część żelaznego elektoratu SLD .	skompletować	3	Perf
Uspokoiły się natychmiast , tylko jakieś drżenie czasem przebiega po nich .	Uspokoiły	0	Perf
Aż u bram Rzymu stanęli barbarzyńcy .	stanęli	4	Perf
Liczyli zdobyte łupy , oglądali własne i nieprzyjacielskie straty .	Liczyli	0	Imp
Ilia jeszcze drzemał .	drzemał	2	Imp
We wrocławskim zoo trzymamy je w kilku grupach .	trzymamy	3	Imp
Zwiększa się też ilość przestępstw popełnianych i wykrywanych na granicy .	Zwiększa	0	Imp
Potem opłukała naczynia i ustawiła na drucianej kratce , by obeschły .	opłukała	1	Perf
Nie wspominajcie o ojczyźnie , jej mitach i tradycjach .	wspominajcie	1	Imp
Po przewrocie władzę w Algierii objęła Rada Rewolucyjna .	objęła	5	Perf
Duszy nie ma , ale Kotliński nienawidzi Kościoła z całej duszy .	nienawidzi	6	Imp
Wówczas koła łowieckie będą dbały , aby populacja nie rozrastała się ponad dopuszczalną .	dbały	4	Imp
- Mana poczuła , że znowu robi się jej trochę niedobrze .	poczuła	2	Perf
Wejdźcie więc do podziemnych lochów pełnych zasadzek i niespodzianek .	Wejdźcie	0	Perf
Jeszcze sprawdza zapięcia uprzęży i sprawność swego radia .	sprawdza	1	Imp
Jedna osoba zginęła , trzy zostały ranne .	zginęła	2	Perf
- Powinna to zrobić dobrowolnie .	Powinna	1	Imp
Z Lipusza trasa powiedzie ich dalej do Sulęczyna , Sierakowic , Mirachowa i Otomina .	powiedzie	3	Perf
Skarżył się jej przecież , że w kieracie prozaicznych zajęć , wśród ludzi zajętych tylko sprawami chleba powszedniego , brak mu rozmów na poważne tematy .	Skarżył	0	Imp
Francja nie zdołała by zapłacić kontrybucji i odbudować kraju bez tej pomocy .	odbudować	7	Perf
I niestety , gdy w pewnej chwili znów się wspiął na palce , nagle zachwiał się .	zachwiał	14	Perf
– Dziennikarze wmówili sądowi i ludziom , że Róża musi wrócić do biologicznych rodziców .	wmówili	2	Perf
Obedrzeć z niej właściciela .	Obedrzeć	0	Perf
To nie znaczy , że mężczyźni kobiety wypychają .	wypychają	7	Imp
Podlewajcie kwiaty .	Podlewajcie	0	Imp
Na tej klepce bracia mocno się poślizgnęli .	poślizgnęli	6	Perf
czyżby prawda aż tak bolała ?	bolała	4	Imp
Plama pływała w zakolu , nie spłynęła nurtem .	spłynęła	6	Perf
Nie wykluczył zwolnień .	wykluczył	1	Perf
Zanim udaje im się wyjechać z miasta , mija często cały dzień .	wyjechać	4	Perf
Wyraźnie pokazują to sondaże .	pokazują	1	Imp
Na Siemiradzkiego wybrzydzali krytycy , ale publiczność uwielbiała jego obrazy .	wybrzydzali	2	Imp
Jakże naiwny był Józef , kolejny raz ufając obietnicom białych !	ufając	7	Imp
Najpierw związał się z Kongresem Liberalno - Demokratycznym .	związał	1	Perf
Idę coś zjeść .	Idę	0	Imp
Nie odwódźcie mnie . . .	odwódźcie	1	Imp
Prychają , targają uzdy .	targają	2	Imp
Z jakiego powodu tak zaskoczyło ono paleoantropologów ?	zaskoczyło	4	Perf
Historia uczy , że podziały nigdy nie budowały , a zawsze burzyły .	burzyły	11	Imp
Nikogo nie naśladuje .	naśladuje	2	Imp
- Zrezygnowali ?	Zrezygnowali	1	Perf
Składamy serdeczne podziękowania wszystkim tym , dzięki którym powstała nasza placówka .	Składamy	0	Imp
Lekarze opatrzyli stłuczenia , zwichnięcia i złamania u 14 pacjentów .	opatrzyli	1	Perf
W tym krótkim okresie okazało się , że wielu kierowców nie stosuje się do wprowadzonych ograniczeń .	stosuje	11	Imp
Ale przedtem wyceń mnie .	wyceń	2	Perf
Jego winę przejmują dzieci , wnuki .	przejmują	2	Imp
- Pisz , pisz .	Pisz	1	Imp
Badał em ten teren kilka razy .	Badał	0	Imp
Lubił wiązać to .	wiązać	1	Imp
Wiem , co zrobię .	zrobię	3	Perf
- Ja ich nie obgaduję .	obgaduję	4	Imp
Życie rodzinne , domowe , schodzi na dalszy plan .	schodzi	5	Imp
Wymierzył we mnie .	Wymierzył	0	Perf
Uczniowie klas młodszych sprzątali las w oddziale 184 pod kierunkiem stażysty , Przemysława Mazgaj .	sprzątali	3	Imp
Trzymając się framugi nacisnął klamkę .	nacisnął	3	Perf
Wcześniej o ośmiu takich maturzystach informowała OKE w Łomży .	informowała	5	Imp
Nagranie wykazało , że w przestępstwie pomagali ochroniarzowi dwaj inni młodzi mężczyźni .	wykazało	1	Perf
Nie słyszał , o czym mówili .	mówili	5	Imp
– umoczyć . .	umoczyć	1	Perf
- O , tu już przesadziła ś !	przesadziła	5	Perf
Mam prawo przypuszczać , że reakcje Polaków w takim wypadku odbiegały by od zachowania Amerykanów .	przypuszczać	2	Imp
Bawiąc się chwastami swojej simlah Manahem mrużył coraz podstępniej oczy .	mrużył	6	Imp
Na poboczu ustawiły sobie nawet specjalne siedzisko .	ustawiły	2	Perf
Zimą bywało , że nie jadła tygodniami .	bywało	1	Imp
Zabił się na miejscu .	Zabił	0	Perf
Jakiś chłopak postanowił wspiąć się na słup , by osobiście zdementować bzdury o magicznym prądzie elektrycznym .	wspiąć	3	Perf
Ta kobieta udzieliła mi kilku ważnych lekcji .	udzieliła	2	Perf
Edison z trudem uspokoił przyjaciela i pomocnika .	uspokoił	3	Perf
— Dlaczego nie osądzono komunistów ?	osądzono	3	Perf
Podporucznik Kowalik , nie mogąc znieść kuchenno - masarnianego obrządku i słodkawego zapachu krwi , ubrał się i wyszedł z domu .	znieść	5	Perf
Po jego słowach poznała , że mimo wszystko nie ma teraz czasu na żarty .	poznała	3	Perf
- Paul aż podskoczył na krześle .	podskoczył	3	Perf
Zawsze zresztą twierdziła m , że jestem męskim typem .	twierdziła	2	Imp
Pamiętasz , jak my śmy kiedyś tak rozmawiały o tym , że trzeba szukać ideału . . .	Pamiętasz	0	Imp
Światło zgasło jednak po dwóch minutach .	zgasło	1	Perf
Jadąc fordem escortem nie ustąpiła pierwszeństwa karetce pogotowia .	Jadąc	0	Imp
- Ale ty w Boga nie wierzysz .	wierzysz	6	Imp
Wyjaśnił w niej , że został wychowany w bardzo purytańskim domu , w którym wpojono mu szacunek dla takich cnót jak skromność i oszczędność .	Wyjaśnił	0	Perf
Zeszła już na dalsze miejsca , a jej przyszłość rysuje się niewesoło .	Zeszła	0	Perf
Przed rozpoczęciem zdjęć przez dwa tygodnie spotykali śmy się na próbach .	spotykali	6	Imp
Jedziemy do Havru , ten stary kozioł płaci .	płaci	7	Imp
Związki zawodowe reprezentują przecież grupy obywateli i są zobligowane do dbania o ich interesy .	reprezentują	2	Imp
Motyl , który drzemie przysiadłszy na dzwonie .	drzemie	3	Imp
Kupili jakieś zmiotki w ruskiej hurtowni i zbijają na mnie kasę .	zbijają	7	Imp
Pani Alicja w sklepie sprzedaje , mąż dowozi jej towar .	dowozi	7	Imp
Nakazał też wypłatę wynagrodzenia , które by otrzymywały , gdyby świadczyły pracę w poradni .	otrzymywały	7	Imp
czyli osiągnęła ś sukces .	osiągnęła	1	Perf
Zaczyna się zjadanie domu , niszczenie domu , nim się dom rozpadnie .	rozpadnie	11	Perf
W latach 90 . wielu duszpasterzy , kierując się potrzebą posiadania wyrazistego wroga , wskazuje z ambony na wyraźnie nazwany obóz polityczny , lożę , fundację czy partię .	kierując	7	Imp
Ta przekazała sprawę do PW w Lesznie .	przekazała	1	Perf
– zrób jeszcze herbatę .	zrób	1	Perf
Rozmawiając , zboczyli na polną drogę .	Rozmawiając	0	Imp
Obserwuję dużo młodszych kolegów , którzy ze zdziwieniem patrzą , co ja tu jeszcze robię .	patrzą	8	Imp
Patrzy , a tu we włosach łonowych roi się od weszek .	roi	7	Imp
Pozmywaj i ogarnij kuchnię .	ogarnij	2	Perf
Na gorącym oleju smażyć placki .	smażyć	3	Imp
Z wersji ucieczki policja wycofała się .	wycofała	4	Perf
Nie dopuszcza żadnej kontroli , nie uznaje żadnych norm , nie widzi żadnych granic .	uznaje	6	Imp
Przeciwnie , z takich skojarzeń kpią sobie oni w kilku utworach .	kpią	5	Imp
A może , gdybym się przemógł , potłumiłbym jej zaklęcia ?	przemógł	5	Perf
Zapytam , jakiej pomocy oczekuje .	oczekuje	4	Imp
W poczekalni uścisnęli sobie ręce , Henryk dźwignął walizę .	uścisnęli	2	Perf
Wszarz pchnął go opierając o pień w półmroku .	opierając	3	Imp
Siedzieć tu i pisać raporty ?	Siedzieć	0	Imp
Dzieci wiedzą , że te samoloty niosą wolność , ale dzieci nie mogą spać na nagich , gołych pryczach .	niosą	6	Imp
Natomiast Gorczyca pominął w ogóle sprawę milczeniem .	pominął	2	Perf
Chyba zasnął em i chyba mi się śniła .	śniła	7	Imp
Stawiał sobie wielkie problemy i plon jego pracy był wielki .	Stawiał	0	Imp
Psy darły jamy , ziemia sypała się za ogonami .	darły	1	Imp
Wieś powoli budziła się do życia .	budziła	2	Imp
Należało spróbować nawiązać łączność .	Należało	0	Imp
Może nie zdawał sobie sprawy z gry , w której uczestniczy ?	uczestniczy	10	Imp
Zarząd Telekomunikacji Polskiej ustami rzecznika prasowego , Piotra Gawrona , podkreśla , że nie jest stroną w sporze między związkami i rządem .	podkreśla	10	Imp
Wszystko wskazywało na to , że jednak tak nie było , ale należało to dokładnie sprawdzić .	wskazywało	1	Imp
Rozpadają się wraz z nami , przestają istnieć .	istnieć	7	Imp
Czasami zapominała o wielu istotnych rzeczach .	zapominała	1	Imp
Chwycił walizkę i pędem dopadł drzwi wyjściowych .	Chwycił	0	Perf
Po wakacjach planujemy też kilka spektakli wieczornych .	planujemy	2	Imp
Przy okazji zauważył , że wcale nie była skończoną pięknością , lecz tylko doprowadziła do artyzmu trudną sztukę makijażu .	doprowadziła	13	Perf
Grodzicki nie chciał się wyrzec nadziei , że odzyska syna .	odzyska	8	Perf
Na Siemiradzkiego wybrzydzali krytycy , ale publiczność uwielbiała jego obrazy .	uwielbiała	7	Imp
Słuchaj , co ci rzeknie herold !	rzeknie	4	Perf
W dobrych warunkach mnożą się bardzo szybko .	mnożą	3	Imp
Taki stosunek nie może sprzyjać należytemu rozwojowi myśli twórczej wśród pracowników Stoczni , a tym samym przynosi straty państwu .	przynosi	16	Imp
Zmarł w Livorno w roku 1846 .	Zmarł	0	Perf
Naokoło rozchodził się zapach grochówki i kiełbasek z grilla .	rozchodził	1	Imp
Ale to nie jest jednak do końca tak , będę musiał się przemóc .	przemóc	12	Perf
Z tego też powodu cieszył em się , że prawica odbija teraz TVP .	odbija	10	Imp
W rogu pokoju skrzypią klepki podłogi .	skrzypią	3	Imp
Na witrynie umieścili też nazwiska ponad 500 znanych ludzi , którzy podpisali się pod protestem przeciwko zakazowi Marszu Równości .	podpisali	11	Perf
- Jurek mnie puścił .	puścił	3	Perf
W domu wspomniała o studniówce przy niedzielnym obiedzie .	wspomniała	2	Perf
Z naszego rozeznania wynika , że sytuacja nieco się poprawiła .	poprawiła	9	Perf
Jak ustalili policjanci , podawał alkohol 16-letniej dziewczynie .	ustalili	1	Perf
Koszmar rozegrał się w nocy .	rozegrał	1	Perf
Ja stoję w bruździe i w uniesionej ręce trzymam zapalony fanarek .	trzymam	8	Imp
Robi mi się przykro , a jednocześnie ogarnia mnie złość .	ogarnia	7	Imp
Kupiła m pistolet na gaz .	Kupiła	0	Perf
Ponadto zastosował środek zapobiegawczy w postaci zakazu opuszczania kraju , zawieszenia w czynnościach służbowych oraz poręczenie majątkowe w wysokości 10 tys . zł .	zastosował	1	Perf
Relski wstydzi się dziewczyny , która jest matką jego dziecka .	wstydzi	1	Imp
W ZUS nie ukrywają , że lekarzom trudno udowodnić , iż nadużywają swych kompetencji .	nadużywają	11	Imp
- Ty mnie wcale nie słuchasz !	słuchasz	5	Imp
Kurs zakończył się egzaminem .	zakończył	1	Perf
Dziewczynka nie zgodziła się i zaczęła płakać .	płakać	6	Imp
Podczas poprzedniej wojny dowodził własnym batalionem i , jak zapewniał , miał jeńców na tuziny .	zapewniał	9	Imp
Słone przekleństwa dolatywały aż do ostatniego wozu .	dolatywały	2	Imp
Przestali bić , kiedy znieruchomiał .	bić	1	Imp
W 1935 roku brytyjski informatyk Alan Mathison Turing wymyślił abstrakcyjną maszynę .	wymyślił	8	Perf
Małżonka krewnego przezornie schowała się do skrzyni i to ją uratowało .	uratowało	10	Perf
Wypił go i otarł usta ręką .	Wypił	0	Perf
Dopiero ze składów rozwozić go będą wozacy .	rozwozić	3	Imp
Pewną ręką zamyka książkę .	zamyka	2	Imp
Ktoś krzyknął , ktoś śmiać się zaczął .	krzyknął	1	Perf
Prowadzę nadzór specjalistyczny do spraw chirurgii dziecięcej na Mazowszu .	Prowadzę	0	Imp
Pozwolisz , że pójdę na balkon ?	pójdę	3	Perf
- No zobaczysz .	zobaczysz	2	Perf
Nakryto tu silną stację nadawczą .	Nakryto	0	Perf
- Weź sobie , Madziu , kochankę , zobaczysz wtedy , jakie to cudowne uczucie .	zobaczysz	8	Perf
Wczoraj , po zamknięciu lokali wyborczych , niemieckie media zapowiedziały , że pani minister ustąpi ze stanowiska .	ustąpi	14	Perf
Wracają i pracują solidnie .	pracują	2	Imp
Nie pozwolił , przełożył naczynie do drugiej ręki .	przełożył	3	Perf
- Dostałam twój list , przyjedź , jeśli chcesz . . .	przyjedź	5	Perf
W krajach zazwyczaj triumfujących filmy o ciężkich chwilach są przypomnieniem czegoś , co zagrażało .	zagrażało	13	Imp
Wyszedł z kabiny , by zamknąć bramę .	zamknąć	5	Perf
Okupując wejście , czekały , co się wydarzy .	czekały	3	Imp
Homogeniczności ekspresji sprzyja izomorfizm faktury chóralnej .	sprzyja	2	Imp
W Etiopii 21 osób zginęło w katastrofie autobusu .	zginęło	4	Perf
Zatrzasnęła drzwi i zaalarmowała męża oraz sąsiadów , którzy wypłoszyli lamparta .	wypłoszyli	9	Perf
Zmumifikowaniu uległy tkanki miękkie .	uległy	1	Perf
Wyborcom oświadczono , że będą musieli przyjść nieco później .	przyjść	6	Perf
Gdzież ja tyle zarobię .	zarobię	3	Perf
Komtur nachylił się niżej i słuchał .	nachylił	1	Perf
Idąc czuł , że wzbudza ciekawość , ludzie stawali , patrzyli za nim .	patrzyli	10	Imp
może ktoś rozjaśnić moje wątpliwości ?	rozjaśnić	2	Perf
Z nowym rokiem weszło w życie nowe prawo dewizowe .	weszło	3	Perf
Ponadto dostali śmy kamizelki , za które żaden z nas nie zapłacił .	zapłacił	11	Perf
Czynił to tak niezręcznie , że pani Lichoniowa spostrzegła jego manewry .	Czynił	0	Imp
Nie gniewaj się . . .	gniewaj	1	Imp
Niepostrzeżenie wracamy do domu i nad ranem obwieszczamy światu odkrycie niecodziennego zjawiska .	obwieszczamy	7	Imp
Bądź wdzięczny , okazuj wdzięczność wszystkiemu , co żyje .	okazuj	3	Imp
Ale ujęli sporo .	ujęli	1	Perf
- Mieszczanie złożyli okup .	złożyli	2	Perf
Polonia zagrała bez trzech piłkarzy z podstawowego składu .	zagrała	1	Perf
Chcemy , by byli wybierani przez radnych .	Chcemy	0	Imp
Witam wszystkich grupowiczów ! ! !	Witam	0	Imp
Często chodzili do pubu , pili piwo , rozmawiali .	pili	5	Imp
Zapisał nuty , przemówił do mnie szyfrem .	Zapisał	0	Perf
Omawiali sprawę przez dłuższy czas .	Omawiali	0	Imp
– jego rozpoznała rodzina .	rozpoznała	2	Perf
Podszedł do aparatu i nakręcił numer .	nakręcił	4	Perf
- Trudno wytrzymać .	wytrzymać	2	Perf
Zatrudnia 1100 dziennikarzy i 2000 współpracowników .	Zatrudnia	0	Imp
Wrócił em na placyk .	Wrócił	0	Perf
Otwierały się przed nami największe tajemnice wszechświata .	Otwierały	0	Imp
Tłumaczę mu to , ale nie może pojąć , o co chodzi .	Tłumaczę	0	Imp
Firma skontaktowała się ze mną , przedstawiając opinię rzeczoznawcy .	przedstawiając	6	Imp
Jankowski rozstawił szklanki na stoliku .	rozstawił	1	Perf
Winien em je opieczętować .	Winien	0	Imp
W bójce użył też noża .	użył	2	Perf
Można pochwalić drużynę za walkę . "	pochwalić	1	Perf
W tej ostatniej miejscowości odbył się miniwiec lekarzy i pielęgniarek na dziedzińcu szpitala .	odbył	4	Perf
Generał za swoje publikowane w prasie artykuły nie przyjmuje honorariów .	przyjmuje	8	Imp
- A więc poznał mnie w tych łachmanach , pomimo zarostu na gębie .	poznał	3	Perf
Poleciał em .	Poleciał	0	Perf
Zimna woda tryskała na głowę , szyję i płonące uszy .	tryskała	2	Imp
Czy Dominik , broniąc się , mógł przewidzieć aż tak dramatyczne skutki ? !	broniąc	3	Imp
Zdjął i wyniósł do przedpokoju .	Zdjął	0	Perf
Pozostaje do zidentyfikowania jeszcze 38 zwłok oraz 14 worków z ludzkimi szczątkami .	Pozostaje	0	Imp
Zgodził się , dał kilka dobrych rad i wyznaczył Polluksa na dowódcę .	wyznaczył	8	Perf
Jako metal szlachetny nie wypiera wodoru z kwasów , reaguje jedynie z gorącym kwasem azotowym i siarkowym , redukując je do odpowiednich tlenków .	reaguje	9	Imp
Renowacja postumentu , na którym ponownie umieszczone zostanie popiersie , kosztować będzie 12 tys . złotych .	kosztować	10	Imp
Rozżalenia nie krył szef Sojuszu .	krył	2	Imp
miał tutaj do nas przyjechać . .	przyjechać	4	Perf
- Zakłady i instytucje państwowe działają na podstawie decyzji urzędniczych .	działają	5	Imp
Czy nasze indywidualne cele pokrywają się z celem grupy jako całości ?	pokrywają	4	Imp
Może warto odkryć Amerykę .	odkryć	2	Perf
– ależ nie przesadzaj . .	przesadzaj	3	Imp
Spłonęły papiery , stare szmaty , niepotrzebne sprzęty .	Spłonęły	0	Perf
Dymkę oczyścić i pokroić na kawałki .	oczyścić	1	Perf
– Kręci !	Kręci	1	Imp
Tomkowi roziskrzyły się oczy .	roziskrzyły	1	Perf
Nie narażę cię na niebezpieczeństwo .	narażę	1	Perf
Co jakiś czas muszę jeździć na badania kontrolne .	jeździć	4	Imp
Do GROM-u dotarło ośmiu .	dotarło	2	Perf
Opowiada uczciwie .	Opowiada	0	Imp
Specjalne brygady w maskach i odzieży ochronnej nadzorowały rzeź ptactwa i dezynfekcję bazarów , targowisk , sklepów i środków transportu .	nadzorowały	7	Imp
Dzieciak długo spał .	spał	2	Imp
Eksperyment powtarzali śmy wielokrotnie .	powtarzali	1	Imp
- Dajemy sygnał organizacjom terrorystycznym .	Dajemy	1	Imp
W jego armii służyli teraz synowie śmiałków , którymi dowodził przed laty .	służyli	3	Imp
Należy starać się odnaleźć każdego postrzałka .	starać	1	Imp
— Wielu Europejczyków wyznaje ideologię komunistyczną .	wyznaje	3	Imp
– Widownia ze zrozumieniem pokiwała głowami .	pokiwała	4	Perf
Od tego czasu gnębiony przez feudałów lud rumuński niejednokrotnie chwytał za broń .	chwytał	9	Imp
Wątpię , by kiedykolwiek u nas taki film nakręcono .	nakręcono	8	Perf
Wykorkowała jakieś dwa lata temu .	Wykorkowała	0	Perf
Nie wiem , czym to tłumaczyć ?	tłumaczyć	5	Imp
- Idę się położyć , jutro muszę raniutko wstać .	Idę	1	Imp
W 1917 r. przeprowadza się wraz z matką do Bolesławia .	przeprowadza	3	Imp
- Dziwi to pana ?	Dziwi	1	Imp
Zapanowało milczenie .	Zapanowało	0	Perf
Bardzo dobrze zaprezentował się Tomasz Robaczewski .	zaprezentował	2	Perf
Kochał Dorę , ale nie potrafił odejść od Zofii , swej żony .	Kochał	0	Imp
Jej nikt nie podskoczy , nawet w Babilonie .	podskoczy	3	Perf
Głowa zastanowiła się chwilę .	zastanowiła	1	Perf
Porucznik nie zamierzał wykładać swoich kart , a przynajmniej nie zamierzał robić tego od razu .	zamierzał	10	Imp
Baltazar obojętnie naciągnął mu spodnie .	naciągnął	2	Perf
Mężczyzna śmiał się głośno pokazując górną lewą złotą trójkę .	pokazując	4	Imp
– bo oni na wieś dzwonią . .	dzwonią	5	Imp
Zostawisz chwaścik , a jutro , pojutrze wyrośnie ożóg .	Zostawisz	0	Perf
Jednocześnie następują dynamiczne , ale dostosowane do realiów społecznych i kapitałowych przekształcenia własnościowe .	następują	1	Imp
Zbankrutować będzie można tylko raz .	Zbankrutować	0	Perf
Wieczorami spacerował wzdłuż kawiarni i zaglądał w okna pod firanki .	spacerował	1	Imp
Pisali , że przecież nas drukują .	Pisali	0	Imp
Tam , gdzie byli prześladowani przez muzułmanów , musiał wystarczyć chaczkar .	wystarczyć	9	Perf
On tu miał pełnić straż .	pełnić	3	Imp
Niemcy przynaglali , klęli .	przynaglali	1	Imp
– i on sobie sam wszystko wypisał .	wypisał	6	Perf
Wkrótce zawiniemy do Trondheim .	zawiniemy	1	Perf
Starczy mi sił .	Starczy	0	Perf
Niedobrze by było , gdyby to miasto usnęło .	usnęło	7	Perf
- Witaj , synu Arana .	Witaj	1	Imp
Na wczasy jeżdżą osoby nietrendowe .	jeżdżą	2	Imp
Gotówkę niósł w neseserze .	niósł	1	Imp
W kuchni unoszą się smakowite zapachy , pani Grażyna wyciąga z szuflady sztućce .	unoszą	2	Imp
Wiedzą , że zjadła by m ich na kolację .	zjadła	3	Perf
Ciotka odpycha go łokciem .	odpycha	1	Imp
- Nasi urzędnicy przyjrzą się drodze .	przyjrzą	3	Perf
Tam czekały już na nich armatki wodne , podstawione przez władze .	czekały	1	Imp
Poznali śmy już nazirejczyków , ponieważ należał do nich Samson .	Poznali	0	Perf
Czym latają nasze VIP-y ?	latają	1	Imp
Rannymi cywilami zaopiekowali się najpierw amerykańscy sanitariusze z personelu naziemnego .	zaopiekowali	2	Perf
– Ktoś polał drzwi do mieszkania łatwopalną substancją i podpalił .	podpalił	9	Perf
Jedenastkę przestrzelił także Kolumbijczyk Hamilton Ricard .	przestrzelił	1	Perf
Zamek popadł w ruinę .	popadł	1	Perf
Gdyby m umiała płakać , Mat , gdyby m umiała płakać .	płakać	10	Imp
Dlaczego tak go wciągały ?	wciągały	3	Imp
Zmieniamy ludzi , którzy zawiedli .	Zmieniamy	0	Imp
Robi sobie herbatę , rozlewa na ceratę , rozsypuje cukier .	rozsypuje	8	Imp
Nie mówił nic , a ona zrozumiała .	zrozumiała	6	Perf
Chcemy odwiedzić kolegów .	Chcemy	0	Imp
Przeszli kilka kroków w milczeniu .	Przeszli	0	Perf
Na tej podstawie otrzymają diety , od 1500 do 2000 złotych .	otrzymają	3	Perf
Prawie wszyscy komentatorzy dowodzą , że Orfeusz nie ponosi winy za utratę Eurydyki .	dowodzą	3	Imp
Dlaczego tak na mnie krzyczysz ?	krzyczysz	4	Imp
Na placach poczęły gromadzić się grupy przechodniów z zadartymi do góry głowami .	poczęły	2	Perf
Zapłacił , ujął dziewczynę za rękę i wyszli .	Zapłacił	0	Perf
Wzdłuż kamiennej podmurówki obszedł dom wokoło .	obszedł	3	Perf
- Pogadamy sobie jeszcze i odprowadzę ją do drzwi hotelu .	Pogadamy	1	Perf
Gdy wchodziła w życie reforma edukacji , Jerzy Buzek otwierał rok szkolny i prezentował gimbusy .	wchodziła	1	Imp
Ona o tym marzy .	marzy	3	Imp
Zawsze wie , jak ją zachwycić .	zachwycić	5	Perf
Przy kościele spoczywają powstańcy z 1831 i 1848 .	spoczywają	2	Imp
Wczoraj Grzegorz Jedamski wytoczył kolejne działo .	wytoczył	3	Perf
Kłaniając się przepraszająco , opuścili śmy z panem Adamkiem zakład pogrzebowy .	opuścili	4	Perf
– Po co go tu przysłali ?	przysłali	5	Perf
Nie wiedziała , jak udzielić mu tych rad , czuła , że śmiałby się znowu .	udzielić	4	Perf
Tak właśnie zrobili śmy , a tych handlarzy , którzy pracowali półlegalnie , przegonili pogranicznicy .	przegonili	13	Perf
Tłumaczenia pozostawiają wiele do życzenia .	pozostawiają	1	Imp
- Nie patrz tak .	patrz	2	Imp
Ja wszystko zanotuję , a żona podpisze .	podpisze	6	Perf
Po święceniach doznał , jak się zdaje , katuszy .	zdaje	6	Imp
Cieszą się , ze ktoś zdecydował się wyciągnąć do nich pomocną dłoń .	Cieszą	0	Imp
Rozumiesz mnie ?	Rozumiesz	0	Imp
Arkadiusza J . pogrążyły też zeznania taksówkarza , który zabrał oskarżonych sprzed Stodoły .	pogrążyły	3	Perf
Nagie , surowe ściany tchnęły mroźną wilgocią .	tchnęły	4	Imp
Pan hrabia nawet przez moment nie miał nas za szpiegów , inaczej nie udzielił by nam tak dogłębnych wyjaśnień .	udzielił	13	Perf
- Obrzuciła go karcącym spojrzeniem .	Obrzuciła	1	Perf
- Pokręciła głową .	Pokręciła	1	Perf
Oznacza to , że odbierze każde przychodzące wywołanie .	odbierze	4	Perf
Wyszedł i wyprostował się .	wyprostował	2	Perf
Marta opuściła mury Kliniki przedwcześnie , na własną prośbę .	opuściła	1	Perf
– Rozpakował rzeczy .	Rozpakował	1	Perf
– Teraz pan tu rozkazuje ?	rozkazuje	4	Imp
Rocznie na świecie ponad milion osób ginie w wypadkach drogowych , a ok . 40 mln odnosi rany .	ginie	6	Imp
- Oto walczę na froncie Kościoła i tam dbam o prawdziwą wiarę .	walczę	2	Imp
Myślicie skończyć do zimy ?	skończyć	1	Perf
Wśród internautów przeważają mężczyźni .	przeważają	2	Imp
Pakowali się dalej , nie reagując .	Pakowali	0	Imp
Nie przypuszczasz , że mogła się zdarzyć .	przypuszczasz	1	Imp
Studiował zaocznie prawo .	Studiował	0	Imp
Albo nie chce egzekwować tego zarządzenia .	egzekwować	3	Imp
Należało to robić dokładnie , inaczej paczki spadały przy wjeżdżaniu do windy .	spadały	7	Imp
Oczy powlekła biaława szklistość , co wzmogło tajemnicę spojrzenia .	powlekła	1	Perf
Należała do mojego pokolenia , została też przez to pokolenie dobrze przyjęta .	Należała	0	Imp
Nie pozwól , by ścigali cię na oko .	pozwól	1	Perf
Na trasie przejazdu stały tłumy oklaskując samochody , które wiozły maleństwa i ich rodzinę .	oklaskując	5	Imp
Zwiększono nakład , objętość , pojawiły się nawet honoraria .	Zwiększono	0	Perf
Czy to wam nie przeszkadza ?	przeszkadza	4	Imp
Tragiczny wypadek zdarzył się na trasie kolejowej z Piły do Chojnic .	zdarzył	2	Perf
Sprawę wyjaśnimy .	wyjaśnimy	1	Perf
Tak długo zwracaj wolność , aż poczujesz , że jest to całkowicie szczere i autentyczne .	poczujesz	6	Perf
Mentalnie posłali energię miłości .	posłali	1	Perf
Na rozwieszonej chustce do nosa ujrzał em film .	ujrzał	5	Perf
Ale miało by to sens , jeśli owoce trafiły by do niego jeszcze dzisiaj .	trafiły	8	Perf
Fluor uszkadza nerki , zmniejsza odporność na infekcje i sprzyja rozwojowi alergii .	uszkadza	1	Imp
Dwie młode istoty patrzyły sobie w oczy i nagle zaczęły się uśmiechać ku sobie radośnie .	uśmiechać	11	Imp
Kto pierwszy wstaje od stołu ?	wstaje	2	Imp
Dyrektor zapoznał Grodzickiego z katechetą , potem pożegnał się i wyszedł .	zapoznał	1	Perf
Eli chwycił wiadra i ruszył za nią kamienistą dróżką .	chwycił	1	Perf
Rozłożył ręce i uśmiechał się przepraszająco .	Rozłożył	0	Perf
Komisja Europejska chce nam zabrać pieniądze , bo Sejm do tej pory nie przyjął trzech ustaw .	zabrać	4	Perf
- Wrócił em .	Wrócił	1	Perf
Odkryto wiele nadużyć .	Odkryto	0	Perf
Rozlał , podniósł i zaczął sączyć , świdrując oczami .	Rozlał	0	Perf
Opary porannej mgły nad jeziorem znikały w złotych promieniach słońca .	znikały	5	Imp
Bardzo dobrze zaprezentował się Tomasz Robaczewski .	zaprezentował	2	Perf
Na koniec zacieramy ślady .	zacieramy	2	Imp
Nie składają donosów do prokuratury , nie przejmują się całodobowym uśmiercaniem poczętych ?	składają	1	Imp
- Dostała m twój list , przyjedź , jeśli chcesz . . .	Dostała	1	Perf
Szybkie obniżanie się tego ciężaru następuje zwykle w późniejszych stadiach rozwojowych i działalności metabolicznej grzybów .	następuje	5	Imp
Wszystkiego dowiem się we właściwym czasie .	dowiem	1	Perf
Wielu młodych opuściło te tereny , szukając pracy i wykształcenia w okolicznych miastach .	szukając	6	Imp
Wrześniowe wybory zmieniły polityczny układ parlamentu .	zmieniły	2	Perf
- Nie odchodź !	odchodź	2	Imp
Wczoraj świdnicka WSK zorganizowała konferencję prasową .	zorganizowała	3	Perf
Do dziennikarki Beaty Igielskiej zatelefonowała któregoś dnia krewna , bardzo zresztą daleka .	zatelefonowała	4	Perf
Trzeba niestety przyznać , że wielu ludzi nabiera się na takie chwyty .	nabiera	7	Imp
Według KAI zaskarżenie ustawy do sądu zapowiedziała już organizacja American Civil Liberties Union .	zapowiedziała	6	Perf
- Ja chrapię ?	chrapię	2	Imp
- Podwieźć pana ?	Podwieźć	1	Perf
W 1991 dokonano kolejnych zmian administracyjnych .	dokonano	2	Perf
ci tłumaczę .	tłumaczę	1	Imp
- Zakłady i instytucje państwowe działają na podstawie decyzji urzędniczych .	działają	5	Imp
Uspokoiły się natychmiast , tylko jakieś drżenie czasem przebiega po nich .	przebiega	8	Imp
- Gdzie przed nocą przybiję .	przybiję	4	Perf
Który naród w Europie najbardziej kocha telefony komórkowe ?	kocha	5	Imp
Imprezę obsługiwać będzie 11 tys . dziennikarzy i pracowników technicznych .	obsługiwać	1	Imp
Nie ma lekarza , który wszystkim dogodzi .	dogodzi	6	Perf
Obrazy cyfrowe składają się z połączonych ze sobą pikseli o różnych barwach lub tonach .	składają	2	Imp
Ulice zajmą pojazdy napędzane siłą ludzkich mięśni .	zajmą	1	Perf
Jest to może jedyna okoliczność , w której Francuza opuszcza na chwilę materializm .	opuszcza	9	Imp
Wykręcił się na pięcie i wybiegł na dwór z rozpaloną głową .	Wykręcił	0	Perf
Kościół zalega cisza .	zalega	1	Imp
Nakładamy rękawice ochronne , zapinamy swetry i wychodzimy na pokład .	Nakładamy	0	Imp
Czy zdążymy przed deszczem pochować pana Sierożę ?	zdążymy	1	Perf
- Pytał em też Mędrców , ale pokiwali tylko głowami i orzekli , że ich komputery nie są w stanie tej zagadki rozwikłać .	rozwikłać	22	Perf
Doświadczył tego na sobie mecenas Jan Murasz .	Doświadczył	0	Perf
– Chyba mu się nie oddała ś ?	oddała	5	Perf
Ta matka dba o nią , jak umie .	dba	2	Imp
- Wszyscy wiedzieli , że u niego można załatwić papiery .	wiedzieli	2	Imp
Opowiadała mi je nieustannie .	Opowiadała	0	Imp
– Od której ty urzędujesz tam teraz ?	urzędujesz	4	Imp
- Masz , bierz .	bierz	3	Imp
Klatkę z płazem postawili śmy na bufecie .	postawili	3	Perf
Wysiadł więc i piknął pilotem , blokując centralny zamek .	Wysiadł	0	Perf
Władysław P . miał też długi , był schorowany i zażywał duże ilości leków .	zażywał	10	Imp
- Znowu zajmujesz się jakimś morderstwem ?	zajmujesz	2	Imp
Ponoć cierpią na nią ludożercy .	cierpią	1	Imp
Pierwsze krople deszczu zadudniły o trumnę i zmieszały się ze święconą wodą , którą ksiądz rozpryskiwał z kropidła podobnego do królewskiego berła .	zadudniły	3	Perf
Panią prezes noszono na rękach .	noszono	2	Imp
Suzanne pokręciła przecząco głową .	pokręciła	1	Perf
- Powinno być łatwiej , bo Husajna nie otaczają fanatycy .	Powinno	1	Imp
Nie wyobrażała sobie dnia bez muzyki , ale słuchała jej w czterech ścianach , odtwarzanej z płyt .	wyobrażała	1	Imp
Soso namyślał się .	namyślał	1	Imp
Zasypiam , ssąc chrupką skórkę przy migoczącym w telewizji Człowieku z żelaza .	ssąc	2	Imp
Tadeuszowi wydało się , że w pewien sposób odgrodziła go także od Zanze .	odgrodziła	8	Perf
Klepał Jazończyka po ramieniu , ciągle ze śmiechem , mimo że twarz tamtego wyrażała surową powagę .	wyrażała	13	Imp
Dlaczego na Niego krzyczę ?	krzyczę	3	Imp
Wczoraj dopiął swego , chociaż musiał sporo dołożyć do umówionych wcześniej 300 tysięcy .	dołożyć	7	Perf
Przebiegające pod miastem chodniki kopalni zalano wodą , a wzgórze zgniło i zapadło się w ziemię jak przydeptane .	zapadło	12	Perf
19-letnia mieszkanka Koszalina przekonała kolegów , aby pomogli jej oszukać bank .	oszukać	9	Perf
Musieli śmy się pożegnać .	pożegnać	3	Perf
- Już się o ciebie nie martwię .	martwię	6	Imp
- Sam pan oceni .	oceni	3	Perf
Ciotka tymczasem już krzątała się w kuchni .	krzątała	3	Imp
Na pierwszy plan wjeżdża długa , biała limuzyna .	wjeżdża	3	Imp
Michał sięgnął do klamki , ale Wasielewski chwycił go za rękaw i przytrzymał .	chwycił	7	Perf
Wrócił po chwili , wycierał starannie dłonie ręcznikiem .	Wrócił	0	Perf
Potok biegł w dole .	biegł	1	Imp
Czyżby teraz przepuściła okazję , mając tuż obok przystojnego młodego mężczyznę ?	mając	5	Imp
Radny Krzysztof Krzeszowski wylicza podobne przypadki także w innych szkołach .	wylicza	3	Imp
– słuchaj .	słuchaj	1	Imp
" Zrobimy " !	Zrobimy	1	Perf
I posadzą .	posadzą	1	Perf
- Zrobił em .	Zrobił	1	Perf
CZY BRZECHWA ZNAŁ TOKARSKIEGO ?	ZNAŁ	2	Imp
Nie martw się , już przechodzę .	przechodzę	5	Imp
Truchtali spokojnie , bez pośpiechu , z przodu dostrzegli sylwetkę w zielonym mundurze , zbliżyli się powoli .	Truchtali	0	Imp
Ognista łapa przejechała po głowie Liścia , ledwie zdołał jej umknąć .	umknąć	10	Perf
Nikt go tu nie zapraszał !	zapraszał	4	Imp
Nie pisze tego , aby ci dokopać .	pisze	1	Imp
Obdarował pan ojciec klasztor , obdarował !	Obdarował	0	Perf
Nie uciekał od niej .	uciekał	1	Imp
Odpowiedź na te oba pytania musi wypaść negatywnie .	wypaść	6	Perf
Przyznał , że spodziewał się nieco lepszej postawy po młodszych od siebie zawodnikach .	Przyznał	0	Perf
– Jeden z nich zaczął napierać na mnie ciałem .	napierać	5	Imp
- Żeby było trudniej zgadnąć .	zgadnąć	4	Perf
Czym że zasłużył sie psychopata ?	zasłużył	2	Perf
Zaraz się tam wybiorą .	wybiorą	3	Perf
Kto pierwszy wstaje od stołu ?	wstaje	2	Imp
– Bo chyba pana Macierewicza trzymają się żarty .	trzymają	5	Imp
Uczula i sprzyja miażdżycy , a nawet nowotworom .	sprzyja	2	Imp
W Ciechanowie bywam regularnie od 26 lat .	bywam	2	Imp
Dwukrotnie SKO przyznało im rację .	przyznało	2	Perf
– Może coś rozpozna .	rozpozna	3	Perf
Nim Marcin odejdzie , dzieje się coś dziwnego .	odejdzie	2	Perf
Ja też zaraz skończę tu przyjmować .	przyjmować	5	Imp
Następnie rozłożyła wysoki statyw , zawiesiła na nim pudełko , przeprowadziła od niego przezroczysty przewód do igły , którą wcześniej automatyczny iniektor umieścił w żyle na przedramieniu Irka .	rozłożyła	1	Perf
- Próbowali śmy jej tutaj pomóc , ale w końcu zabrano ją do najlepszego szpitala w Kijowie .	Próbowali	1	Imp
Po zetknięciu z ziemią maszyna wybuchła , a siła eksplozji wyrzuciła dwóch słowackich mechaników i Marka Panasia .	wyrzuciła	10	Perf
A ty mogła by ś prowadzić program .	prowadzić	5	Imp
- Więc przeczy pani ?	przeczy	2	Imp
Należało spróbować nawiązać łączność .	Należało	0	Imp
Skoncentruj się na przestrzeni pomiędzy dwoma profilami .	Skoncentruj	0	Perf
Powołał do życia Centralne Biuro Śledcze .	Powołał	0	Perf
Kuba , zbliż no się do mnie , niech cię pocałuję .	pocałuję	10	Perf
Że się szydzi z personelu naziemnego .	szydzi	2	Imp
Taboret upadł z dramatycznym łoskotem , a on , wierzgając nogami , zawisł niczym gotowy do wypatroszenia wieprz .	wierzgając	9	Imp
– przebierze się za aniołka . .	przebierze	1	Perf
Wybiła trzecia .	Wybiła	0	Perf
Inne stolemy wyniosły się dawno do zamorskich krajów i ludzie przestali się już bać , że padną ofiarą ich psot .	padną	16	Perf
Gdy Dominika przyjechała po matkę , Babel dożywał swych dni .	dożywał	7	Imp
Przeżył em już rzeczy znacznie gorsze .	Przeżył	0	Perf
Zawiadomiono policję i prokuraturę .	Zawiadomiono	0	Perf
I to najwyraźniej rozwścieczyło sprawców .	rozwścieczyło	3	Perf
- Zgromadzili śmy tu najstarsze i najładniejsze kostiumy .	Zgromadzili	1	Perf
Zaprosimy cię na otwarcie , przysięgam .	Zaprosimy	0	Perf
Kiedy został em w ciszy , skupił em się raz jeszcze .	skupił	6	Perf
Coś się poruszyło .	poruszyło	2	Perf
De Gaulle w tych dniach pozyskał Francję .	pozyskał	5	Perf
Pseudokibicom ze Stalowej Woli upiekło się , choć nieźle w sobotę nabroili .	upiekło	4	Perf
- Jeszcze poczekać ?	poczekać	2	Perf
Nie znał em go przedtem , bo za moich czasów wileńskich był jeszcze sztubakiem , a potem przebywał za granicą .	przebywał	17	Imp
Używając pożyczonych magnetofonów szpulowych połączył em dźwięki suity z fragmentami poematu Wergilego .	połączył	4	Perf
Skrzypnęły drzwi .	Skrzypnęły	0	Perf
Ale się rozmyśliła .	rozmyśliła	2	Perf
Galerii handlowych świadomie nie bojkotowali , bo z nich nadal czerpali kasę .	bojkotowali	4	Imp
Kobiety w więzieniu doskonale łagodzą obyczaje .	łagodzą	4	Imp
Coś notowali , robili fotografie .	notowali	1	Imp
Dodaje , że nie rzucił obrazem o podłogę .	rzucił	4	Perf
Wieczorem nie siedź przed telewizorem .	siedź	2	Imp
Idź lepiej na podwórze , pobiegaj !	pobiegaj	5	Perf
Kobieta zaufała oszustowi i podała numery z 28 kart .	podała	4	Perf
Serca dzieci wyrastają nad rzekę .	wyrastają	2	Imp
Skrzypczak układał swoje poczynania .	układał	1	Imp
Habit zwisał luźno z jej ramion .	zwisał	1	Imp
Wśród podhalańskich Cyganów z bezwzględności słynie jego współpracownik , współoskarżony w Oświęcimiu , Stanisław Kamiński z Czarnej Góry .	słynie	5	Imp
NIK podkreśla , że w czasie prywatyzacji AWRSP następowało pogorszenie sytuacji ekonomicznej Polski .	następowało	8	Imp
Nos odgryzł syn .	odgryzł	1	Perf
Nie będzie postulowanego przez PiS samorozwiązania Sejmu , bo nie godzi się na nie Platforma Obywatelska .	godzi	10	Imp
– no źle się poczuła m .	poczuła	4	Perf
Przez godzinę z boiska wiało nudą , a piłkarze prezentowali futbol plażowy .	wiało	4	Imp
Umiera w swoim ogrodzie .	Umiera	0	Imp
- Spacerowała m , była m nad rzeką .	Spacerowała	1	Imp
– I co on wybrał ?	wybrał	4	Perf
Jeśli radni wyrażą na nią zgodę , to nowe ceny zaczną obowiązywać po dwóch tygodniach od opublikowania uchwały Rady w dzienniku urzędowym wojewody śląskiego .	wyrażą	2	Perf
To niczemu nie służy .	służy	3	Imp
Swojego domku obitego papą Wanda Kędzierska trochę się wstydzi .	wstydzi	8	Imp
Ustalili śmy ze Stachem , że jeszcze trochę pociągnę pismo dla honoru domu i odejdę .	odejdę	14	Perf
Wszystkie psy świata mogły mu w tym momencie naskoczyć .	naskoczyć	8	Perf
Przewodnictwo , ruch lodu i przesiąkanie wody przemieszczają ciepło w obrębie lodowca .	przemieszczają	7	Imp
Kiedyś uduszono jej jedynego syna Amadeusza .	uduszono	1	Perf
- Odezwał się po chwili zmartwionym głosem Tomaszewski .	Odezwał	1	Perf
Ty nigdy więcej takiego czegoś nie zrobisz .	zrobisz	6	Perf
Dawali śmy mu złoto . . .	Dawali	0	Imp
W ostrym tempie przejechali sześćdziesiąt kilometrów na szosie modlińskiej .	przejechali	3	Perf
się nazywam .	nazywam	1	Imp
Zatarł ręce i pokiwał głową .	pokiwał	3	Perf
Podskoczył em do drzwi , ale stanął w nich jakiś mężczyzna , tyłem do mnie , i nie mogł em nic dojrzeć .	Podskoczył	0	Perf
