Były drugi trener lubelskich szczypiornistek nie zdołał poprowadzić jeleniogórzanek do sukcesu .	jeleniogórzanek	8	Plur
Z kilku innych postów wynika , że to jednak nie regionalizm .	regionalizm	10	Sing
Właścicielom wystarcza kino domowe , a bogate panie nie potrafią docenić kunsztu Anny Jaxy - Chamiec .	Właścicielom	0	Plur
- Niech się pan skupi na swoich obowiązkach .	obowiązkach	7	Plur
Gdy odbywa służbę wojskową w Maroku , wielkie wrażenie robi na nim głęboka religijność wyznawców Islamu .	służbę	2	Sing
Jeńcy wojenni listy piszą . . .	Jeńcy	0	Plur
W szklarniach pozostało ich jeszcze sporo .	szklarniach	1	Plur
Poza wymienionymi , charakterystycznymi rodzajami przebiegu akumulacji w ciągu roku stwierdza się ich modyfikacje lub rodzaje pośrednie .	akumulacji	6	Sing
Poza tym boiskiem panuje chaos .	chaos	4	Sing
Pisano biografie i pamiętniki .	biografie	1	Plur
Skojarzenia nie biorą się z powietrza .	Skojarzenia	0	Plur
Struktury partyjne utrzymują głównie posłowie .	Struktury	0	Plur
- Obcokrajowiec też ma szanse ?	Obcokrajowiec	1	Sing
Brzegi chodników były zastawione ławkami .	ławkami	4	Plur
Nie jest typem działacza , ideologa , politykiera .	ideologa	5	Sing
Teraz sprawa zostanie przekazana rzecznikowi dyscyplinarnemu .	rzecznikowi	4	Sing
Wszyscy mieli przypięte kolorowe identyfikatory Orkiestry oraz specjalne puszki .	identyfikatory	4	Plur
Nawet zielona trawa budzi w niej nienawistne skojarzenia .	trawa	2	Sing
Mostek na strumieniu został przez gminę odbudowany po ostatniej powodzi .	powodzi	9	Sing
Za dawno przywykł do posłuchu .	posłuchu	4	Sing
Dla światowych producentów odzieży Polska staje się coraz ważniejszym rynkiem zbytu .	producentów	2	Plur
Nie ma nic gorszego niż deszcz i mgła .	mgła	7	Sing
Mały smyk stale spodziewał się nędznych wojennych słodyczy .	smyk	1	Sing
Wszelki mrok rozpływa się niczym mgła w promieniach porannego słońca .	promieniach	7	Plur
W czasie weekendu dorodny lampart spacerował ulicami stolicy Indii , Delhi .	ulicami	6	Plur
Już dziś boją się , że znaczna część zbiorów zgnije w kopcach .	kopcach	11	Plur
Maluje na wypełzłym jedwabiu twarze jakby oglądane przez zasłonę z gazy .	twarze	4	Plur
- Jest w pałacu .	pałacu	3	Sing
Jej mąż nigdzie nie pracował , ale nie mieli materialnych kłopotów .	kłopotów	10	Plur
Mój Piotrek uchodzi za speca w dziedzinie drewnianego budownictwa na Podhalu .	budownictwa	8	Sing
Czy pan zna inżyniera Jarzęckiego ?	inżyniera	3	Sing
Poprawiał wciąż aparat w uchu , jakby chciał lepiej usłyszeć .	uchu	4	Sing
Skoncentruj się na przestrzeni pomiędzy dwoma profilami .	profilami	6	Plur
Rocznie na świecie ponad milion osób ginie w wypadkach drogowych , a ok . 40 mln odnosi rany .	wypadkach	8	Plur
Wytargowali lepsze honorarium .	honorarium	2	Sing
Co sprawiło , że zaangażował się pan w ten ruch i tę ideologię ?	ideologię	12	Sing
Cipkę sygnowała dodatkowo autografem .	autografem	3	Sing
Jego zadaniem jest ponowne wylansowanie pojazdów tej marki w największym segmencie w Europie .	pojazdów	5	Plur
Kaźmierz oddał stryjowi latarnię ; na ziemi położył podłużny wąski przedmiot .	stryjowi	2	Sing
Przesadziłem tu z ofensywnym tonem .	tonem	4	Sing
W jego armii służyli teraz synowie śmiałków , którymi dowodził przed laty .	śmiałków	6	Plur
Znaleźli jeszcze jedną taśmę z nagraniami z rajdu .	taśmę	3	Sing
Obok wspomnianych przedmiotów ścisłych lubi biologię , przykłada się do angielskiego .	biologię	5	Sing
– Przyzwyczaił em się do jeżdżenia tramwajem .	jeżdżenia	5	Sing
Jakie rodzaje mięsa zamraża się z przeznaczeniem na zaopatrzenie rynku detalicznego ?	rodzaje	1	Plur
Poczuł em po raz kolejny przypalanie papierosami , wykręcanie rąk .	papierosami	6	Plur
W pierwszej kolejności głosować będziemy nad wnioskiem o odrzucenie projektu ustawy .	kolejności	2	Sing
Rodzą się dzieci z deformacjami organów wewnętrznych i wodogłowiem .	organów	5	Plur
W 18-ym okręgu wyleciał w powietrze burdel dla żołnierzy niemieckich .	okręgu	2	Sing
Stwierdzam , że Sejm wobec nieuzyskania bezwzględnej większości głosów poprawkę Senatu przyjął .	Senatu	10	Sing
Namierzyli ich razem z prokuratorami .	prokuratorami	4	Plur
To jeden z najdroższych sylwestrów na Mazowszu .	sylwestrów	4	Plur
Kontrolerzy obwieszczają .	Kontrolerzy	0	Plur
Ale lepsi byli tylko w gadu - gadu przed kamerą .	gadu	7	Sing
Dzieci wiedzą , że te samoloty niosą wolność , ale dzieci nie mogą spać na nagich , gołych pryczach .	samoloty	5	Plur
- Wierzę , że kandydaci do członkostwa w NATO powinni spełniać generalne kryteria demokratycznych rządów i gospodarki wolnorynkowej , włączając w to poszanowanie dla praw człowieka oraz cywilną kontrolę nad wojskiem .	rządów	14	Plur
Kapitan Bayernu trafił do siatki Koeln jeszcze raz w 68 . minucie .	Kapitan	0	Sing
Nie tylko on uległ czarowi tego zakątka .	czarowi	4	Sing
Wyjaśnia on w przystępny sposób tajniki stosowanych w programie konwencji .	tajniki	5	Plur
Napięta żyłka świsnęła i pękła w przeponie .	przeponie	6	Sing
W ręku trzymał pojemnik z jakąś cieczą .	pojemnik	3	Sing
Joaquino Navarro - Valls zapowiedział , że Stolica Apostolska w najbliższym czasie wyda w tej kwestii oświadczenie .	oświadczenie	16	Sing
Lecz łza starości raz wraz zalewała przekrwioną źrenicę .	źrenicę	7	Sing
Poczuł em się wyróżniony ponad zasługę .	zasługę	5	Sing
Zatrzymanym przedstawiano zarzuty udziału w zorganizowanej grupie przestępczej i wprowadzenia na rynek narkotyków .	Zatrzymanym	0	Plur
Prześcieradło było częściowo z materaca ściągnięte .	Prześcieradło	0	Sing
Poruszał rytmicznie kolanami , unosząc lekko siedzącą na nich kobietę .	kobietę	9	Sing
W zgodnej opinii sztabu szkoleniowego radomian , wszyscy mają równe szanse .	szanse	10	Plur
Na posłanie z ziół i kwiatów ułożono kości i pokryto je szczątkami sztandaru .	ziół	3	Plur
Po odbyciu kary Zdankiewicz znów brylował w podrzędnych knajpach .	knajpach	8	Plur
Dotknęła brudnego bandaża , którym owijała opornik .	opornik	6	Sing
Nasi szabliści walczyli słabo .	szabliści	1	Plur
Fizycznie i psychicznie znęcał się też nad konkubiną .	konkubiną	7	Sing
Wiślacy zgnietli niemiecką drużynę siłą ofensywy .	Wiślacy	0	Plur
Ważnym zadaniem jest zapewnienie warunków dla niezakłóconego funkcjonowania gospodarki i pracy urzędów .	urzędów	11	Plur
Podobno seryjni mordercy różnią się od innych ludzi chromosomalnie ?	mordercy	2	Plur
Podczas ceremonii otwarcia Spływu organizatorzy przyznali liczne odznaczenia zasłużonym kajakarzom .	kajakarzom	9	Plur
Panią prezes noszono na rękach .	Panią	0	Sing
Przewaga któregokolwiek układu skurczowego lub niedowład któregokolwiek układu rozkurczowego powoduje skurcz mięśni gładkich oskrzeli .	mięśni	11	Plur
Zdjęła kapelusz , odetchnęła z ulgą .	kapelusz	1	Sing
Wysoka liczba urodzeń hamuje także rozwój gospodarczy kraju , w którym znaczny procent mieszkańców żyje poniżej uznanego progu ubóstwa .	urodzeń	2	Plur
Syn pana Bogdana raz sam się przekonał , jak wygląda opieka nad niepełnosprawnymi na porządnym zachodnioeuropejskim poziomie .	poziomie	16	Sing
Psy grzebały w śmietniku .	śmietniku	3	Sing
Większość pampersów nie przepracowała w telewizorni nawet 12 miesięcy , więc zgodnie z obowiązującym regulaminem nie mogła uczestniczyć w nagrodach z zysku za 1994 rok .	nagrodach	19	Plur
Do atrakcyjnej pani bosman podchodzi zniecierpliwiony wczasowicz .	wczasowicz	6	Sing
Tymczasem wiadomo , że 37-letnia gwiazda jest uzależniona od alkoholu i narkotyków .	gwiazda	5	Sing
- Czy w szkołach pobliskich pracują nauczyciele z mniejszości ?	nauczyciele	6	Plur
Cukier puder podać w osobnym naczyniu .	puder	1	Sing
Masowy powrót przyniósł by doraźne korzyści budżetowi .	korzyści	5	Plur
Całej imprezie groziła katastrofa , mimo że istniała możliwość otrzymania odszkodowania z towarzystwa ubezpieczeniowego .	możliwość	8	Sing
Architekci opracowujący rysunki robocze są zazwyczaj wieloletnimi praktykami .	praktykami	7	Plur
- Medal ma dwie strony .	Medal	1	Sing
Po kolejnych 30 minutach lekarze stwierdzają śmierć kolarza .	kolarza	7	Sing
Dominować będą piosenki do tekstów Edwarda Stachury .	tekstów	4	Plur
Nie interesuje ich seks bez uczucia .	seks	3	Sing
W 2000 r . na światowych giełdach nastąpił krach , a zawyżone kursy akcji spółek internetowych spadły na łeb .	kursy	12	Plur
Akceptacja wyraża obiektywną prawdę o człowieku , a nie tylko subiektywne przeżycia jednostki .	jednostki	12	Sing
Nacisnąłem guzik , żeby wezwać wartownika .	guzik	1	Sing
- Chłopaki z lubelskiego zespołu hiphopowego noszą takie krawaty .	Chłopaki	1	Plur
Załadował na wóz wynajętych gazeciarzy i rozwiózł po mieście , każąc rozdawać list przechodniom .	wóz	2	Sing
Dzieci spędzają noce w oddziale noworodków .	noce	2	Plur
Pod nasypem leżał człowiek .	nasypem	1	Sing
Idiotka Zuzia zapomniała zrobić w banku blokadę i całą forsę zajęli na długi .	blokadę	6	Sing
Majka siedziała obok mnie na pniu przewróconej brzozy .	pniu	5	Sing
Wyczuł em , że Shadrach nie jest w najbardziej rozmownym nastroju .	nastroju	10	Sing
Ustalono to na podstawie mutacji zachodzących w wirusie .	mutacji	4	Plur
Patrzy , a tu we włosach łonowych roi się od weszek .	weszek	10	Plur
Legenda Ismaela Khana narodziła się wśród płomieni i śmierci .	Legenda	0	Sing
Adres niech dobrodziej spisze z dowodu osobistego .	dobrodziej	2	Sing
Zakup tego urządzenia pozwoli wykonywać podstawowe analizy na miejscu w Brzeziu , bez konieczności wyjazdu chorego do Gminnego Ośrodka w Kłaju .	Zakup	0	Sing
W ostrym tempie przejechali sześćdziesiąt kilometrów na szosie modlińskiej .	tempie	2	Sing
Ale już nie zdążyli , na pozostałym kawałku lądowały niemieckie dywizje pancerne .	dywizje	10	Plur
– Robisz się religijny , kiedy mówisz o piłce nożnej .	piłce	8	Sing
Ale pani wyznacza kierunek .	kierunek	3	Sing
Z pozostałymi członkami dawnego kierownictwa związanymi z Gomułką plenum obeszło się bezceremonialnie , usuwając ich w większości ze składu KC .	plenum	8	Sing
Ale tego rodzaju zabiegi mogą być wykonywane tylko przez specjalnie przeszkolone ekipy zwalczania szkodników .	zwalczania	12	Sing
W czołówce znajduje się też słynna Zielona Budka , ale firma nie jest już polska .	czołówce	1	Sing
Tutaj także zostały podmyte piwnice domów .	piwnice	4	Plur
- Słyszy pan te krzyki ?	krzyki	4	Plur
Wrzucony do grobu , nie mógł stanąć nad grobem .	grobem	8	Sing
Z jakiego powodu tak zaskoczyło ono paleoantropologów ?	paleoantropologów	6	Plur
Oficer telefonował długo .	Oficer	0	Sing
Kiedy podróżnicy przygotowywali się już do powrotu na statek , Bentley ofiarował Tomkowi na pamiątkę prawdziwy bumerang , dzidę i tarczę .	statek	8	Sing
Szukałem raczej w komediach .	komediach	3	Plur
Dostał eś ostatnio piątkę z algebry ?	algebry	5	Sing
Pani Czapkowa zaścieliła stół świeżą ceratą , podała kotlety z dzika , a po obiedzie odbyło się sympozjum .	kotlety	8	Plur
Podstawowe problemy przemysłowej produkcji i masowych zastosowań półprzewodnikowych źródeł światła niebieskiego wydają się już rozwiązane .	zastosowań	6	Plur
Ale demokrata Al Gore obiecał emerytom dopłaty państwa do leków . . .	dopłaty	6	Plur
Sztuka miała premierę w maju 2001 .	premierę	2	Sing
Rozumiem , są to szczególne złotówki .	złotówki	5	Plur
Konsjerżka , jak większość konsjerżek Portugalka , szorowała chodnik i mury ryżową szczotką .	Konsjerżka	0	Sing
Jak stawiać granice dzieciom z FAS ?	granice	2	Plur
Ale nie lubię jubileuszy i nie czuję się zramolałym jubilatem .	jubilatem	9	Sing
Ceny towarów i usług od stycznia ubiegłego roku wzrosły o 10,1 proc .	Ceny	0	Plur
Mażoretki , mające na koncie tytułu mistrzowskie w Polsce , pojechały na europejski championat do Bratysławy .	tytułu	5	Plur
Stacja Nędza wielokrotnie zmieniała swoją nazwę .	Stacja	0	Sing
Nie wprowadzono prywatnej własności ziemi , nie zniszczono feudalnego imperium dyrektorów kołchozów .	kołchozów	11	Plur
Specjaliści Paribas mówią przede wszystkim o doskonałej kondycji gospodarki amerykańskiej , która winduje kurs dolara .	kurs	13	Sing
Niektórzy z idiotów tylko onanizując się zaspokajają swoje potrzeby seksualne .	idiotów	2	Plur
Duch Boży mówi , abym szedł . . .	Duch	0	Sing
PQBoot to narzędzie do zmiany partycji bootującej dla tych użytkowników , którzy tylko od czasu do czasu potrzebują skorzystać z innego systemu .	użytkowników	9	Plur
Czarny , wilgotny otwór jamy przerażał ich .	otwór	3	Sing
W jego głosie Kloss usłyszał wahanie .	wahanie	5	Sing
Słońce prażyło niemiłosiernie , a na domiar złego wykończyły się zapasy żywności i wody .	złego	7	Sing
Wszystko by tu poszło z dymem w jednej chwili .	dymem	5	Sing
– były też komisy .	komisy	3	Plur
W zeszłym tygodniu , świadczeniobiorcy otrzymali z ZUS-u zawiadomienie o wysokości waloryzacji .	świadczeniobiorcy	4	Plur
Także w ubiegłym roku zniszczono nagrobki na cmentarzach w Gdyni i Kielcach .	cmentarzach	7	Plur
Była to jakaś specjalna lampka .	lampka	4	Sing
Starą szopę Elżbieta S . zamieniła na fabrykę narkotyków .	narkotyków	8	Plur
Przenosi obojętne spojrzenie na stronę z nekrologami , którą Gabriela przygważdża do stołu kościstym palcem .	palcem	14	Sing
Gdańscy radni podjęli uchwałę o przekazaniu miliona złotych na odbudowę kościoła św . Katarzyny .	przekazaniu	5	Sing
Gdy powstawał Pakt dla Wsi , jeździł na spotkania z rolnikami .	Wsi	4	Plur
Samorządem , który ma 100 proc . udziałów w szpitalnej spółce akcyjnej , kierują od kilkunastu miesięcy ludzie Tuska .	spółce	10	Sing
Od kilku lat w górnej szufladzie mojego biurka leży biały zeszyt .	zeszyt	10	Sing
Zostało ono zorganizowane przez Radę Konferencji Episkopatów Europy .	Episkopatów	6	Plur
- Dziękuję , nie piję kawy o tak późnej porze .	kawy	5	Sing
Błogosławieństwa nowożeńcom udzielił ks. kanonik Wesołowski .	ks.	3	Sing
Ashram w Magliano Sabina to ośrodek dla małych dzieci Sahaja Yoginów .	ośrodek	5	Sing
Zamiast nich na głębokości 3 m spoczywał trotyl uzbrojony w dwa palniki i lonty .	palniki	11	Plur
To były z filcu utoczone dzwony .	filcu	3	Sing
Mamy też nowych graczy .	graczy	3	Plur
- Nasi przyjaciele wciąż nie mogą otrząsnąć się z szoku . . .	szoku	9	Sing
W strukturze współczesnego systemu szkonictwa wyższego w Polsce państwowe i niepaństwowe uczelnie dzielimy na dwie kategorie .	uczelnie	11	Plur
Marszałek Senatu Alicja Grześkowiak zwróciła się o wyjaśnienie tej sprawy do Trybunału Konstytucyjnego .	Senatu	1	Sing
Obrazy cyfrowe składają się z połączonych ze sobą pikseli o różnych barwach lub tonach .	Obrazy	0	Plur
Drugą ręką podsuwała kierowcom listę do podpisu .	kierowcom	3	Plur
Będzie się o nią bił ; PO TRZYDZIESTU LATACH .	LATACH	8	Plur
Tylko częściowo można to wytłumaczyć względami historycznymi .	względami	5	Plur
- Słyszy pan te krzyki ?	krzyki	4	Plur
Podczas zabawy dzieci znalazły pociski karabinowe .	pociski	4	Plur
Na poszczególnych lodowcach warunki lokalne modyfikują tę zależność .	lodowcach	2	Plur
Zwolennicy Mossadegha , ministrowie , podejrzani oficerowie , działacze Tudeh są przesłuchiwani i torturowani .	oficerowie	6	Plur
Zalało perony na dworcu kolejowym .	perony	1	Plur
Sekcja zwłok wykazała , że przyczynami zgonu były zakrzepica żyły udowej , zator tętnicy płucnej i niewydolność krążeniowo - oddechowa .	tętnicy	13	Sing
Młyny kupują mąkę żytnią w Niemczech .	Młyny	0	Plur
Towarzysz jego wzywał Jezusa i jego Matkę , a tacy ludzie jak Esteban wołają te słowa tylko twarzą w twarz ze śmiercią .	śmiercią	21	Sing
W wielu miastach widzieliśmy gigantyczne kolejki .	miastach	2	Plur
Będzie musiał kupić na bazarze jakieś najprawdziwsze świadectwo maturalne .	bazarze	4	Sing
Nieruchomo stojąc w powietrzu nad kwiatami lecimy .	powietrzu	3	Sing
Zaliczmy banana do żywotnych i nie będzie wyjątku . . .	banana	1	Sing
Ale ona tylko skinęła na okrwawionego fenomulata .	fenomulata	6	Sing
No , włóż szybko koszulę !	koszulę	4	Sing
Dzięki podświetleniu widać też nasz kościołek z Traktu Brzeskiego .	kościołek	5	Sing
Dom aż pachnie od farby i mydła .	farby	4	Sing
Na obszarach łąk zielonych wstają białe smugi , a poprzez ich długie przędziwa wesoło trzepie się rzeka .	przędziwa	12	Plur
Zostaną one przekazane do Archiwum Akt Nowych w Warszawie .	Archiwum	4	Sing
Dziś już wiadomo , że powszechnie akceptowany na świecie jest model bazujący na podejściu bilansowym , koncepcji pełnej alokacji i metodzie zobowiązań .	podejściu	13	Sing
Niemiecka liga hokeja należy do jednej z najlepszych lig w Europie .	liga	1	Sing
Późna wiosna była dla księdza proboszcza najbardziej znienawidzoną porą roku .	porą	8	Sing
Odsłonili jednak tyły i kolejną bramkę zdobyli lechici .	tyły	2	Plur
Zwycięzcy gratulujemy !	Zwycięzcy	0	Sing
Społeczność ludzka funkcjonuje w strukturach zapewniających formę organizacyjną .	strukturach	4	Plur
- Przepraszam panów posłów z lewicy .	panów	2	Plur
Parlament Europejski w Strasburgu przegłosował niedawno całkowity zakaz reklamowania wyrobów tytoniowych .	wyrobów	9	Plur
Motywy jego tragicznego wypadku nie są znane .	Motywy	0	Plur
Lekarze opatrzyli stłuczenia , zwichnięcia i złamania u 14 pacjentów .	zwichnięcia	4	Plur
Detektyw precyzyjnym sztychem przeszył jego prawe ramię .	sztychem	2	Sing
Zdaje się , że wystarczy założyć sutannę , by zyskać przychylność urzędów .	sutannę	6	Sing
Szczerość przyjaciela wywołała burzę .	Szczerość	0	Sing
Teraz już nie było wątpliwości i ręce zaczęły mi drżeć .	wątpliwości	4	Plur
Kolejne inwentaryzacje dowodzą , że na półkach biblioteki brakuje kolejnych tytułów .	inwentaryzacje	1	Plur
Obu szwedzkim dyplomatom zarzucono też działalność wykraczającą poza ich oficjalny status .	status	10	Sing
Szybkie obniżanie się tego ciężaru następuje zwykle w późniejszych stadiach rozwojowych i działalności metabolicznej grzybów .	grzybów	14	Plur
Na szczęście któryś z bliżej stojących chłopaków podskoczył i podtrzymał go .	chłopaków	6	Plur
Zawrzały dusze , serca i umysły .	umysły	5	Plur
Każdy duży sklep samoobsługowy lub mięsny wyposażono w krajalnice do wędlin .	wędlin	10	Plur
Pojawia się drapanie w gardle , wysypka , nagły spadek ciśnienia , duszność , trudności w oddychaniu , bóle brzucha .	drapanie	2	Sing
Opcja ta ogranicza odpowiedzi do 145 bajtów .	Opcja	0	Sing
Zenek prosił kolegów , żeby nic nie mówili mamie , gdyby go przysypało .	mamie	8	Sing
Dzieci wiedzą , że te samoloty niosą wolność , ale dzieci nie mogą spać na nagich , gołych pryczach .	pryczach	18	Plur
Potem rozległy się jeszcze inne równie przerażające odgłosy .	odgłosy	7	Plur
Wybierz dowolny chat , umów się z przyjacielem na określoną godzinę i rozmawiaj do woli .	chat	2	Sing
Twoi pasterze błogosławią ciągnące na wojnę armaty .	pasterze	1	Plur
Demon wchodzi bez pukania . . .	pukania	3	Sing
jest na niej 250 szopek nigdy dotąd poza Betlejem niepokazywanych .	szopek	4	Plur
Wieczorami spacerował wzdłuż kawiarni i zaglądał w okna pod firanki .	firanki	9	Plur
W aptekach prawdziwe oblężenie zapanowało jeszcze w ostatnich dniach starego roku .	aptekach	1	Plur
Pełniący obecnie obowiązki szefa rosyjskiego państwa Putin był jeszcze niedawno szefem służb specjalnych .	służb	11	Plur
Nie będzie mi Prosiaczek wchodził w duszę buciorami .	buciorami	7	Plur
Pan Bielski pełni teraz publiczne funkcje . . .	funkcje	5	Plur
Wkrótce dochodzi do ich uszu daleki pomruk grzmotów .	uszu	4	Plur
Nie podali jednak szczegółów .	szczegółów	3	Plur
Chętnie zatrudniłby w ministerstwie doświadczonych ludzi z organizacji ekologicznych .	ministerstwie	3	Sing
Pod uniesionymi zasłonami rozległego łoża z trudem udało mu się dostrzec ginącą w powodzi koronek , pomarszczoną twarz pani Lamaire .	zasłonami	2	Plur
Polska strefa odpowiedzialności w Iraku obejmuje od czwartku dwie a nie trzy prowincje .	prowincje	12	Plur
Frajer odjedzie .	Frajer	0	Sing
Dziwnej kompanii , ośmielę się zauważyć .	kompanii	1	Sing
W sprasowanych autach zginęły cztery osoby .	autach	2	Plur
Wahanie trwało zbyt długo , by jakakolwiek odpowiedź mogła być wiarygodna .	Wahanie	0	Sing
W tych wynikach jesteśmy w krajowej czołówce .	czołówce	6	Sing
Przez zwały gruzów ulicami miasta przebija się z trudem wojskowy Willys .	ulicami	3	Plur
W Venezii Keneth ciągle leczył kontuzje , nie doszedł do formy .	kontuzje	5	Plur
Fenometys wciąż kręcił głową , światło lamp odbijało się na bezwłosej skórze idealnymi refleksami .	refleksami	13	Plur
Stwierdzono , że stosunkowo wysokie zarobki mają pielęgniarki bloku operacyjnego .	zarobki	5	Plur
Na wrocławski Rynek rzeczywiście przybyły tłumy .	tłumy	5	Plur
Stołki , zachęcająco odsunięte , czekały na biesiadników .	Stołki	0	Plur
Chwilami ogarniały głucha złość i bunt .	bunt	5	Sing
Zrealizował go Polak , wykorzystując literaturę rosyjską i japońskich wykonawców .	wykonawców	9	Plur
Droga do Falsztyna prowadzi przez łagodne wzgórza Pienin Spiskich .	wzgórza	6	Plur
Mateo mieszka na Elbie , gdzie latem wynajmuje turystom motorówki .	motorówki	9	Plur
Dotarł do zabudowań Ilii .	zabudowań	2	Plur
Dzięki cyfrowej telewizji satelitarnej istnieje też możliwość połączenia z Internetem czy udziału w kursach przygotowujących do matury albo egzaminu na studia .	kursach	13	Plur
- Nie zorganizowano zawodów na odpowiednim poziomie , na przykład w skokach do wody czy siatkówce , bo Zimbabwe nie spodziewa się w tych dyscyplinach osiągnięć .	zawodów	3	Plur
Związki zawodowe reprezentują przecież grupy obywateli i są zobligowane do dbania o ich interesy .	dbania	10	Sing
Nagle z ciemności wyłoniło się trzech mężczyzn kryjących twarze pod kominiarkami .	kominiarkami	10	Plur
Widzę Łzy w kącikach jego oczu .	kącikach	3	Plur
Co chwila oblizywał sobie pysk .	pysk	4	Sing
To były z pewnością Narodziny , mieli śmy na to dowód wykluczający zwątpienie .	Narodziny	4	Plur
Przedstawione powyżej podejścia , koncepcje i metody dają duży wybór w określeniu docelowego modelu alokacji .	metody	6	Plur
Usiedli obydwaj przy herbacie zaparzonej w grubych szklankach .	szklankach	7	Plur
Inwestycję wznowiono w połowie 2004 roku , a wartość zadania wynosi 5,6 miliona złotych .	miliona	12	Sing
- Sądy podchodzą do tajnych współpracowników bardzo liberalnie , nie eliminują z życia społecznego agentów .	agentów	14	Plur
- Spotkali śmy się , towarzyszu rektorze . . .	rektorze	6	Sing
Marchewki obrać i zetrzeć na tarce o dużych oczkach .	oczkach	8	Plur
Dyskrecja , takt i skromność to podstawowe pojęcia bon tonu .	tonu	9	Sing
A wieś szaleje z radości .	wieś	1	Sing
Przeciętne świadczenie emeryta , rencisty wzrośnie o 33 zł .	świadczenie	1	Sing
Zboża mniej się opłacają .	Zboża	0	Plur
Cofnął się jak oparzony , gdy fala obmyła mu łapy .	fala	6	Sing
Poirytowani posłowie - projektodawcy sprawdzili te informacje .	posłowie	1	Plur
Nie wykluczył zwolnień .	zwolnień	2	Plur
Zachowują się jak jacyś ekstremiści , niszcząc piękną tradycję .	ekstremiści	4	Plur
Oczywiście , to było konstruktywne myślenie .	myślenie	5	Sing
Sobota i niedziela to gratka dla działkowiczów , którzy będą mogli nabywać nowe odmiany warzyw , ziół , kwiatów i drzew .	odmiany	13	Plur
Małe szare oczka wpatrywały się we mnie drwiąco , wyraźnie triumfowała .	oczka	2	Plur
Laserów raczej nie ominie .	Laserów	0	Plur
- Meneli naszło się z całego osiedla .	Meneli	1	Plur
Nieopodal znajdowało się stoisko z pamiątkami .	pamiątkami	5	Plur
Wręcz przeciwnie , to samo doświadczenie człowieczeństwa jest czymś fundamentalnym , jest punktem wyjścia .	człowieczeństwa	6	Sing
– Ten komplet narzędzi służył do ćwiartowania korpusów .	ćwiartowania	6	Sing
Myślę , że tak właśnie powinni zachowywać się odpowiedzialni kandydaci .	kandydaci	9	Plur
Szef Polsatu zapowiedział , że złoży dziś do NSA wniosek o zmianę postanowienia .	Szef	0	Sing
- Zapewnia mi samorealizację i rozwój .	samorealizację	3	Sing
Był pan organizatorem takiego niestrawnego politycznie obiadu w Drawsku .	organizatorem	2	Sing
Zresztą francuzica niepotrzebnie wylicza kunsztowne potrawy , bo generał lubi tylko prostą kuchnię .	kuchnię	12	Sing
Jeśli pogoda dopisze , będziemy wykonywać te prace bez przerwy .	pogoda	1	Sing
I kłopoty przez to nasz car - batiuszka ma .	car	5	Sing
Czym jest akceptacja i co ona oznacza ?	akceptacja	2	Sing
Wielu partyjnych kolegów chętnie widziałoby go na stanowisku prezydenta Łodzi , ponieważ Marcisz ma opinię dobrego menadżera .	menadżera	16	Sing
Niestety odzewu nie było .	odzewu	1	Sing
Nieliczni cudzoziemcy otrzymali ulotki informacyjne , mapę Rzeszowa oraz gadżety .	gadżety	9	Plur
W najbliższym czasie rynek prawdopodobnie ochłonie i dojdzie do korekty .	korekty	9	Sing
Jemu zarzucono nakłanianie do aborcji .	nakłanianie	2	Sing
Etiopczycy kontynuują atak , choć pod koniec ubiegłego tygodnia władze Erytrei poinformowały o wycofaniu swych oddziałów ze wszystkich spornych terenów nadgranicznych .	atak	2	Sing
Oburzamy się , że prezydent Juszczenko stawia pomniki Banderze i pielęgnuje pamięć o nim i jego bandziorach .	bandziorach	16	Plur
Ostatnio któryś z proboszczów przegrał samochód .	proboszczów	3	Plur
Czy zamienił by ś wszystkie swoje osiągnięcia na olimpijski medal ?	osiągnięcia	6	Plur
Zaręczam wam , że ubrań nie znajdziecie .	ubrań	4	Plur
Ściany osłonowe zewnętrzne wykonano z żywic epoksydowych .	żywic	5	Plur
Miał tylko dobre porywy .	porywy	3	Plur
Uczestniczki wysłuchały wykładów doradców zawodowych i prawników , uczestniczyły w zajęciach psychologicznych , poznawały podstawy obsługi komputera i korzystania z Internetu .	Uczestniczki	0	Plur
Prawdopodobnie mają słabsze technologie .	technologie	3	Plur
Pierwsza z wymienionych sygnalizacji pojawi się u zbiegu ulic Gdyńskiej i Piaskowej w Koziegłowach .	zbiegu	7	Sing
Policja potwierdza , że zgłaszają się kolejne niedoszłe ofiary zwyrodnialca !	ofiary	8	Plur
Badania wielkości sił naciągu strun na torze przeprowadzono przez bezpośredni pomiar sił w poszczególnych strunach za pomocą przyrządu VOGT .	strun	4	Plur
Wezwał mnichów i kapłanów do współpracy .	mnichów	1	Plur
Jeszcze w ub.r . wstrzymywanie pieniędzy na nowe emisje akcji przypominało czekanie na Godota .	wstrzymywanie	4	Sing
Brzęcząc pustymi kuflami , weszła do środka .	środka	6	Sing
Akurat wtedy , gdy kadrowicze rozpakowywali w Warszawie swój sprzęt po powrocie ze zgrupowania w Barsinghausen , w kościele w Kazimierzu zebrał się tłum wiernych , który modlił się o powodzenie naszej drużyny w zbliżających się mistrzostwach świata .	mistrzostwach	36	Plur
Wódz Samoobrony ma być umoczony w molestowanie seksualne .	Samoobrony	1	Sing
W 2007 roku neurolodzy amerykańscy wyciągnęli je z muzeum i poddali badaniu rezonansem magnetycznym .	rezonansem	12	Sing
Czekolada , spożywana w umiarkowanych ilościach , może chronić nas przed chorobami serca .	ilościach	5	Plur
- Proboszcz pierwszy nadpił .	Proboszcz	1	Sing
Źródła historyczne podają , że studnia należała do zamku biskupów wrocławskich .	Źródła	0	Plur
Przerażona dziewczyna pobiegła do ciotki , która mieszka za ścianą , i w sekrecie opowiedziała , co robił jej tata .	ścianą	9	Sing
Dziś już wiadomo , że powszechnie akceptowany na świecie jest model bazujący na podejściu bilansowym , koncepcji pełnej alokacji i metodzie zobowiązań .	zobowiązań	21	Plur
Na wrocławski Rynek rzeczywiście przybyły tłumy .	tłumy	5	Plur
Takie przygody nie będą przecież powodować bólu .	bólu	6	Sing
W milczeniu spożywali zimną konsolację , szczękały sztućce , dworscy w ciemnych surdutach sprawnie zmieniali misy .	misy	15	Plur
W niedzielę świątynia jest pełna i wszyscy wierzą , że znowu będzie tutaj diecezja .	diecezja	13	Sing
Tym świadkom , którzy powiedzą całą prawdę , przestępstwo ujdzie zupełnie bezkarnie .	świadkom	1	Plur
Amerykanie patrząc zza Oceanu na Europę myślą niemal wyłącznie kategoriami strategicznymi i gospodarczymi .	Oceanu	3	Sing
Później połączono go z lądem groblą .	lądem	4	Sing
Tutaj wyraźnie widać wrażliwe , skłonne do ufności i entuzjazmu oblicze eseisty .	entuzjazmu	9	Sing
Przenosi obojętne spojrzenie na stronę z nekrologami , którą Gabriela przygważdża do stołu kościstym palcem .	nekrologami	6	Plur
To mądra zasada .	zasada	2	Sing
Megane oddał synowi , pracownikowi dydaktycznemu warszawskiej uczelni .	pracownikowi	4	Sing
W pierwszych dniach tygodnia czekają Cię ożywione spotkania z przyjaciółmi lub kolegami .	przyjaciółmi	9	Plur
Stworzenie człowieka wcale nie wymaga miłości .	Stworzenie	0	Sing
Dębski z przyjemnością zapadł w kąt kanapy .	kąt	5	Sing
Wikary Pudło odprawia je żując gumę .	gumę	5	Sing
Temu sukcesowi w znacznej mierze przysłużył się również Szymon , który wywalczył 10 z 18 zdobytych przez Polaków punktów .	sukcesowi	1	Sing
Chmury rozsunęły się na moment , odsłaniając wytarty miedziak słońca .	Chmury	0	Plur
Następnie zbiegł po jakichś schodach ; zbiegał długo .	schodach	4	Plur
Można też utworzyć na takie pliki specjalny folder na pulpicie .	folder	7	Sing
Georges Mathieux w kostiumie szermierza dźga płótno pędzlem umieszczonym na szpadzie .	szpadzie	10	Sing
Do 13 tygodni to nie dziecko , tylko płód .	płód	8	Sing
Wszelkie informacje podane poniżej dotyczą jedynie wypadków sprawdzonych .	wypadków	6	Plur
Decyzja zapadnie dzisiaj rano .	Decyzja	0	Sing
Pod uniesionymi zasłonami rozległego łoża z trudem udało mu się dostrzec ginącą w powodzi koronek , pomarszczoną twarz pani Lamaire .	koronek	14	Plur
Czy sędziowie w programie są stronniczy ?	sędziowie	1	Plur
Nie pamiętam tych dwóch córek niemieckiego majstra .	córek	4	Plur
To pochlebia facetom .	facetom	2	Plur
Znaczna koncentracja tego gazu w przyziemnej warstwie atmosfery sprzyja więc podwyższaniu temperatury powierzchni Ziemi .	atmosfery	7	Sing
ja niestety nie znam tego regulaminu .	regulaminu	5	Sing
Tym głównie Stronnictwo będzie się różniło od większości europejskich partii chadeckich , w których liberalizm gospodarczy miesza się z ideami socjaldemokratycznymi i nauką społeczną Kościoła .	ideami	19	Plur
Prezes SSN deklaruje , że w kolejnych etapach zatrudni niemal wszystkich pracowników produkcyjnych .	etapach	7	Plur
Prawnik powoli , mocno trzymając się liny , przeszedł na koniec trapu .	liny	6	Sing
Powstała nawet nauka o snach , nazywana onejrologią .	onejrologią	7	Sing
Piłkarze FC Porto zapewnili sobie wczoraj ponownie tytuł mistrzów Portugalii .	mistrzów	8	Plur
Miejscowy hydraulik ma więc duże wzięcie .	hydraulik	1	Sing
Służby ratownicze w Stalowej Woli toczyły dziś walkę z oleistą plamą na Sanie .	plamą	10	Sing
Neapolitańska policja zatrzymała czterech młodych Polaków pod zarzutem wymuszania pieniędzy i rabunku .	zarzutem	7	Sing
Z pozostałymi członkami dawnego kierownictwa związanymi z Gomułką plenum obeszło się bezceremonialnie , usuwając ich w większości ze składu KC .	kierownictwa	4	Sing
Badania wielkości sił naciągu strun na torze przeprowadzono przez bezpośredni pomiar sił w poszczególnych strunach za pomocą przyrządu VOGT .	strunach	14	Plur
- Miał zaufanie do ludzi .	zaufanie	2	Sing
Kłęby dymu z I piętra były coraz większe .	Kłęby	0	Plur
Sornicy będą nosić tradycyjne kozackie mundury .	mundury	5	Plur
On dał nam Siebie w Eucharystii .	Eucharystii	5	Sing
W poniedziałek spotkał się z wiernymi na południowej modlitwie .	wiernymi	5	Plur
Konferencja będzie miejscem wymiany poglądów , doświadczeń i wyników badań nad oddziaływaniem mediów .	badań	9	Plur
Oceniając strajk , Gawin oświadczył , że ruch towarowy praktycznie się nie odbywał , a na Śląsku stanęło wiele pociągów pasażerskich .	pociągów	19	Plur
Zaangażowała się w Teatrze Dramatycznym kierowanym wówczas przez Gustawa Holoubka .	Teatrze	3	Sing
Ale ci politycy z kolei nie gwarantują przeprowadzenia koniecznych reform gospodarczych .	reform	9	Plur
Kolor pełni w obu rodzajach reklamy bardzo interesującą funkcję .	rodzajach	4	Plur
Obietnice Boga są językiem Jego miłości do nas .	Obietnice	0	Plur
Tymczasem kolegium odroczyło swoją decyzję .	kolegium	1	Sing
- Skoro pani minister już podniosła kwestię wpływów podatkowych z rozmaitych województw i ich proporcji , myślę , że warto się nad nimi zastanowić , gdyż są one czasami dziwne i nie wiadomo , z czego wynikają .	proporcji	14	Plur
Placówka mieści się przy ulicy Dominikańskiej .	Placówka	0	Sing
Woda zalała zasiewy i drogi lądowe .	zasiewy	2	Plur
- Szokująca jest wysoka śmiertelność z powodu raka szyjki macicy .	macicy	9	Sing
Ktoś biegnie z głuchym tupotem bosych nóg .	tupotem	4	Sing
Moment bezwładności to miara bezwładności ciała w ruchu obrotowym względem określonej , ustalonej osi obrotu .	osi	13	Sing
Obserwatorzy przypominają , że producentem broni biologicznej był ZSRR .	Obserwatorzy	0	Plur
Właśnie zakończył się trzeci , diecezjalny etap konkursu .	etap	6	Sing
Dwa samochody zderzyły się dachami .	dachami	4	Plur
Ale szybki zysk bywa celem nawet najpotężniejszych magnatów finansowych , bo rynki są wolatylne .	rynki	11	Plur
U Bosmana rosły srebrzyste świerki , ale ktoś wykopał .	świerki	4	Plur
Niemal wszystkie nici myśli kwestionującej prowadzą do Kartezjusza .	nici	2	Plur
Z lodówki wyjęła niewielki dozownik wypełniony rubinową cieczą i bardzo ostrożnie wcisnęła go do otworu w pudełku .	cieczą	7	Sing
Jego pomysł spotkał się z oburzeniem i protestami lekarzy .	lekarzy	8	Plur
Koszty wyjazdu nie są małe .	Koszty	0	Plur
Zapalono wszystkie lampy , ustawiono ruchome wieszadła , kelnerzy w oczekiwaniu gości spacerowali po korytarzach hotelowych .	kelnerzy	8	Plur
– No zawsze się tam na tej architekturze ktoś zna , bo jeden budował chałupę dla siebie , a drugi gdzieś był i coś widział .	chałupę	14	Sing
Podobne warunki terenowe charakteryzują cmentarzysko w Předmostí .	cmentarzysko	4	Sing
Następnie ze skrytki pod łóżkiem w sypialni skradli saszetkę , w której było 10.000 dolarów .	sypialni	6	Sing
- Samochody stoją na ulicach , blokują przejazd , są zatoczki , ale potrzeba więcej parkingów z prawdziwego zdarzenia .	przejazd	7	Sing
Wyborcy zdecydowali , że powinni zasiąść w Sejmie .	Wyborcy	0	Plur
- Będę musiał już iść , jeszcze nie mam biletu .	biletu	9	Sing
W ten sposób Rumuni wystąpili w roli głównego mediatora pomiędzy Moskwą a Pekinem .	mediatora	8	Sing
Dzięki lekarzom , wsparciu rodziny i samozaparciu pokonał chorobę .	wsparciu	3	Sing
— Aktualnie ta ściana jest w bardzo złym stanie .	ściana	3	Sing
Świadkowie twierdzą , że przy nazwisku figuruje jego stopień .	stopień	8	Sing
Szły dzieci przez pole minowe i wesoło machały rączkami .	rączkami	8	Plur
Nowy dzierżawca wykonał niezbędne remonty i odnowienia .	remonty	4	Plur
Idę na przystanek autobusowy .	przystanek	2	Sing
Mostek na strumieniu został przez gminę odbudowany po ostatniej powodzi .	Mostek	0	Sing
Tylko niektórzy użalają się na forach internetowych nad swoim losem .	forach	5	Plur
Sprawa wywołała wielkie emocje .	emocje	3	Plur
Podróżujący pierwszą klasą będą odtąd mogli wypoczywać podczas lotu na rozkładanych podwójnych siedzeniach .	lotu	8	Sing
Elektrownie gazowe mają dać tyle prądu , ile daje elektrownia wodna w Asuanie .	Elektrownie	0	Plur
Meseńczycy , odwieczni wrogowie Sparty , zgodzili się przepuścić ich przez swoje terytorium .	wrogowie	3	Plur
Tarnobrzescy policjanci zatrzymali w pobliżu Stalowej Woli 12 nielegalnych emigrantów .	emigrantów	9	Plur
Mecz mógł zakończyć się remisem .	remisem	4	Sing
Przybysze z najnowszej fali na ogół stronią od polonijnych organizacji społecznych .	ogół	5	Sing
Podstawowe terminy powstały podczas badań lodowców w górach umiarkowanej strefy klimatycznej .	górach	7	Plur
W środę ze Szpitala Ginekologiczno - Położniczego w Opolu wypisywano 11 noworodków .	noworodków	11	Plur
Wkrótce dochodzi do ich uszu daleki pomruk grzmotów .	grzmotów	7	Plur
Opony delahaye jednostajnie szumią po asfalcie .	asfalcie	5	Sing
Jeśli resort zaakceptuje programy , będzie je finansować .	programy	3	Plur
Jego serce ledwie się ruszało .	serce	1	Sing
Jakie są reakcje ?	reakcje	2	Plur
Chart nie raczył nawet mnie obwąchać .	Chart	0	Sing
– Dziadek mi kazał .	Dziadek	1	Sing
Z pewnością młodemu człowiekowi nie pomagają zainteresowania seksualne , które koncentrują się na doznaniach fizycznych .	zainteresowania	6	Plur
Złożoność biografii Wilhelma bez wątpienia nie stanowiła tajemnicy dla jego współczesnych .	Złożoność	0	Sing
Naszym wspólnym celem jest kultura , a kultura nie ma granic .	granic	10	Plur
Czym w końcu różnią się tak naprawdę republikanie od demokratów ?	demokratów	9	Plur
Przed sądem chce też udowodnić , że miał pieniądze na podwyżki dla lekarzy .	podwyżki	10	Plur
Nie wprowadzono prywatnej własności ziemi , nie zniszczono feudalnego imperium dyrektorów kołchozów .	własności	3	Sing
Praca dla polonistek się znajdzie .	polonistek	2	Plur
Zorganizowano również dla nich warsztaty rękodzielnicze z zakresu robienia na drutach , haftowania , tkania , wykonywania makram .	warsztaty	4	Plur
Czasem okazuje się , że reklama choć efektowna nie działa .	reklama	5	Sing
Podstawowe terminy powstały podczas badań lodowców w górach umiarkowanej strefy klimatycznej .	badań	4	Plur
Homogeniczności ekspresji sprzyja izomorfizm faktury chóralnej .	faktury	4	Sing
Jasne , wesołe światło rozlało się po kątach .	kątach	7	Plur
Postawiłem samochód na podziemnym parkingu pod hotelem i wszedłem do windy .	hotelem	6	Sing
Było ciemno , płonęły znicze .	znicze	4	Plur
Nagrody przyznała specjalna Kapituła , pragnąc uhonorować osoby i instytucje , których działalność wniosła znaczący wkład w krzewienie tolerancji .	tolerancji	18	Sing
W tym roku stołeczni stróże prawa odkryli na Mazowszu już osiem takich fabryk .	stróże	4	Plur
Nigdy nie budował fantastycznych hipotez .	hipotez	4	Plur
Oficer wyszedł , rencistka odkręciła gaz .	Oficer	0	Sing
We wszystkich miastach i miasteczkach odbyły się wiece i uroczyste akademie .	miastach	2	Plur
Przełknął ślinę , patrząc trochę bezmyślnie na intruza .	intruza	7	Sing
Komputery podłączone do Sieci mogą skorzystać z okna zadań badawczych .	Sieci	3	Sing
Hodowla owiec jest do dzisiaj jedną z głównych gałęzi gospodarki tych nadal słabo zaludnionych rejonów .	gospodarki	9	Sing
Stanisław Mróz prawie nigdy nie rozstawał się z dudami .	dudami	8	Plur
Sprawdziliśmy u dealerów , jakie auta spełniają ZUS-owskie marzenia .	marzenia	8	Plur
- Przydeptał koniec nogą i stanął , czekając na nas .	nogą	3	Sing
Strażacy brnąc niemal po kolanach w wodzie wynoszą w drewnianych klatkach świnie .	wodzie	6	Sing
Brak drapaczom na Ś-W zaplecza w postaci sklepów spożywczych .	drapaczom	1	Plur
Do konkursu stanęło piętnastu traktorzystów .	konkursu	1	Sing
Słucham i uszom nie dowierzam .	uszom	2	Plur
W ten sposób mieli oni zakończyć dwuletnie studia podnoszące kwalifikacje zawodowe .	kwalifikacje	9	Plur
Pogłębiły się zmarszczki , sczerniały sińce pod oczami ; był blady i jakby przygarbiony .	sińce	5	Plur
Złożoność biografii Wilhelma bez wątpienia nie stanowiła tajemnicy dla jego współczesnych .	Złożoność	0	Sing
Wolała puszczać w kinach filmy kung-fu licząc , że dzięki temu ludzie przestaną myśleć o polityce .	kinach	3	Plur
Czy ty masz duszę i sumienie ?	sumienie	5	Sing
Trzecioligowcy strzelili kontaktowego gola , ale w ostatnim kwadransie dwie bramki dla Lecha wypracował Remień .	Trzecioligowcy	0	Plur
Już nie nosi starych butów z pourywanymi sznurówkami .	sznurówkami	7	Plur
O’Donellowie siedzieli przy ognisku .	ognisku	3	Sing
Do poszukiwań człowieka oskarżonego o ludobójstwo i zbrodnie przeciwko ludzkości włączyli się amerykańscy i brytyjscy agenci .	ludobójstwo	5	Sing
Westchnienia Ruskina i Prousta trafiają na podatny grunt .	Westchnienia	0	Plur
Występuje stałe obniżanie się poziomów wód w rzekach i potokach .	wód	5	Plur
NBP OBNIŻYŁ o 4 punkty procentowe stopę swoich kredytów .	stopę	6	Sing
Na tej klepce bracia mocno się poślizgnęli .	bracia	3	Plur
Ma też w planach rozwinięcie swojej działalności w naszym kraju .	planach	3	Plur
Eskadra bierze kurs na cel .	kurs	2	Sing
W dwie godziny później Ania i Norbert siedzieli w fotelach w pokoju gościnnym przy łóżku Karoliny .	fotelach	9	Plur
- Co powiedzą robotnicy ?	robotnicy	3	Plur
- Bał by m się popadania w nastroje mesjanistyczne .	popadania	5	Sing
Zakurzoną perukę otrzepał o kolano .	perukę	1	Sing
Akceptacja wyraża obiektywną prawdę o człowieku , a nie tylko subiektywne przeżycia jednostki .	Akceptacja	0	Sing
Daje on młodym ludziom szansę wykazania się umiejętnościami organizatorskimi .	szansę	4	Sing
- Czy policjanci powinni ścigać złodzieja przyłapanego na gorącym uczynku , czy poprzestać na zabezpieczeniu mienia ?	złodzieja	5	Sing
Dziewczyny mówią , że piszczała , płakała , śmiała się , przykucnęła , usiłując uspokoić drżące od wysiłku mięśnie i wtedy rzuciły się na nią . . .	mięśnie	18	Plur
Organizatorzy postarali się też o prezenty dla wykonawców .	prezenty	5	Plur
Jeszcze wczoraj Francja miała zarządzić blokadę kont Osamy bin Ladena oraz 26 innych osób i organizacji znajdujących się na amerykańskiej liście terrorystów .	kont	6	Plur
Fluor uszkadza nerki , zmniejsza odporność na infekcje i sprzyja rozwojowi alergii .	infekcje	7	Plur
Wszechświat rozszeża się coraz szybciej .	Wszechświat	0	Sing
Nadleśnictwa z terenu powiatu tucholskiego odwołały zakaz wstępu do lasu .	wstępu	7	Sing
Już trzykrotnie odwoływali się do Samorządowego Kolegium Odwoławczego , by unieważnić decyzję o warunkach zabudowy wydaną przez Wydział Architektury .	Kolegium	6	Sing
– domki ro jednorodzinne i ogródki działkowe tam są .	domki	1	Plur
Białe policyjne motocykle są doskonale oznakowane .	motocykle	2	Plur
Ewentualna ratyfikacja Konkordatu przed przyjęciem nowej konstytucji zaważyłaby zapewne na jej ostatecznym brzmieniu , odbierając Konstytucji RP charakter nowoczesnej ustawy zasadniczej demokratycznego państwa .	Konkordatu	2	Sing
Rodzice nie będą już mogli wmawiać swoim pociechom , że przynosi je bocian bądź znaleziono je w kapuście .	pociechom	7	Plur
Normalny obywatel nie chodzi z takim radiotelefonem .	radiotelefonem	6	Sing
Pierwszy cios , który później okazał się śmiertelny , został zadany metalowym krzesłem w tył głowy .	tył	14	Sing
Obcowanie z karłami deformuje kręgosłup .	Obcowanie	0	Sing
Początki Myszyńca sięgają 1650 .	Początki	0	Plur
Rok funkcjonowania wyższych szczebli samorządów nie upoważnia jeszcze do ocen .	szczebli	3	Plur
- Venderk to prawnik .	prawnik	3	Sing
I padł , wykorzystując impet ciosu .	impet	4	Sing
Gdańscy radni podjęli uchwałę o przekazaniu miliona złotych na odbudowę kościoła św . Katarzyny .	radni	1	Plur
– Twoja twarz z profilu jest półksiężycem .	profilu	4	Sing
Zapach kawy przeważał nad odorem spalonego tłuszczu z kuchni i chloraminy z toalet .	kawy	1	Sing
Szybsze topnienie brzegów lodowca kompensowane jest przez zwiększone opady w środku kontynentu .	brzegów	2	Plur
Załogi z niepokojem śledzą ciche chmury nadchodzące z południa .	Załogi	0	Plur
Przez zwały gruzów ulicami miasta przebija się z trudem wojskowy Willys .	ulicami	3	Plur
Za to mięso przyprawi szczyptą lulka .	lulka	5	Sing
Palce Szczyrbka ściskały coraz mocniej .	Palce	0	Plur
Mam ochotę na blondyna .	blondyna	3	Sing
Nakazał też zdemontowanie istniejących terminali .	zdemontowanie	2	Sing
Nie ma takiego tematu .	tematu	3	Sing
" Wartość modlitwy nie zależy od nas .	modlitwy	2	Sing
Przekupnie w bazarowych zaułkach opowiadali , że upadek rządu jest bliski i nieuchronny , a ministrowie i generałowie knują spiski albo pakują walizy i szykują się do ucieczki za granicę .	ucieczki	27	Sing
Widzę na stole także jego dzieło .	dzieło	5	Sing
We wtorek ci sami uczestnicy licytacji zaproponowali 1.500 zł .	licytacji	5	Sing
Ulubieniec publiczności doskonale wywiązał się z tego zadania .	Ulubieniec	0	Sing
Udzielenie bowiem pracownikowi urlopu bezpłatnego nie oznacza rozwiązania umowy o pracę z danym zakładem .	Udzielenie	0	Sing
Chłopiec nalewa do drugiego kieliszka .	kieliszka	4	Sing
Codziennie przybywa nowych terenów .	terenów	3	Plur
Są bardzo niebezpieczne , ich wybuch spowodowałby falę uderzeniową o promieniu do jednego kilometra .	promieniu	10	Sing
Następny dzień powitał Zlot słońcem .	Zlot	3	Sing
Jestem matką w zupełnie innym wymiarze .	wymiarze	5	Sing
I mam prawo do prywatności . . .	prywatności	4	Sing
- Medal ma dwie strony .	Medal	1	Sing
Terroryści wyciągnęli broń i strzelali w powietrze .	powietrze	6	Sing
Tym razem chodzi o Straż Miejską z Obornik .	Straż	4	Sing
- To nie jest konkurs dla wirtuozów .	wirtuozów	6	Plur
Zarządca komisaryczny przestał pełnić ją dopiero po ostatnich wyborach samorządowych .	Zarządca	0	Sing
Oczywiście , nie znaczy to , że tolerancja równa się bezczynnej akceptacji .	akceptacji	11	Sing
Ta specjednostka nosi bowiem imię legendarnych skoczków spadochronowych Armii Krajowej .	specjednostka	1	Sing
Trudno też spotkać krajalnice do serów twardych .	krajalnice	3	Plur
Uderzał rękami w głowę , drapał twarz .	rękami	1	Plur
- Poszedł pod kościół .	kościół	3	Sing
W ten sposób samorząd chce odzyskać od skarbu państwa pieniądze na niedoszacowaną subwencję na ubiegły rok .	subwencję	12	Sing
Za chwilę zjawią się kapłanki , a ja , jako bezbożnica , zostanę zelżona i wyrzucona stąd na zbity pysk .	bezbożnica	10	Sing
Szefowie Masterlink zauważyli , że chociaż nie mają pracownika obok siebie , jego efektywność wzrosła .	Szefowie	0	Plur
Radni Malborka podjęli uchwałę w sprawie nowych stawek za wodę i odprowadzane ścieki .	ścieki	12	Plur
Talent dramatopisarski Kisielewskiego wypowiedział się w zasadzie w tych dwóch sztukach młodzieńczych .	sztukach	10	Plur
Gdyby kierownictwo ZUS zdecydowało się na Mercedesa lub BMW , to koszt jednego samochodu przekroczyłby 200 tys . nowych złotych .	kierownictwo	1	Sing
Są już pierwsze ofiary w ludziach .	ofiary	3	Plur
Gotówkę niósł w neseserze .	Gotówkę	0	Sing
Tom Spencer posiadał przy sobie pisma pornograficzne i kasety video dla homoseksualistów oraz marihuanę .	marihuanę	13	Sing
Można nawet powiedzieć , że z eskalacji protestów czerpie pewne korzyści .	korzyści	10	Plur
Najważniejszą zaletą będzie koordynacja wszystkich podsystemów komunikacyjnych z koleją podmiejska , a także motoryzacją indywidualną oraz komunikacją rowerową .	koordynacja	3	Sing
Najbardziej popularne są mercedesy , audi , golfy i BMW .	mercedesy	3	Plur
Przed tygodniem rzesze ostrzeszowian odprowadziły go na miejsce wiecznego spoczynku .	ostrzeszowian	3	Plur
To ich największy walor , umiejętność , to ich przeznaczenie .	walor	3	Sing
Jak pani widzi misję swojego szefa ?	misję	3	Sing
Policja i prokuratura rozkładają ręce .	prokuratura	2	Sing
Lubi dobrą muzykę i piesze górskie wycieczki .	wycieczki	6	Plur
Na dole jest moja prywatna plaża .	plaża	5	Sing
Podkreśla się , ze był on najlepszym rozgrywającym ligi i ojcem dominacji Chicago Fire w rozgrywkach grupowych .	dominacji	11	Sing
Przeciskając się Czerwin natrafił na trzy granaty na przedpiersiu któregoś stanowiska .	granaty	6	Plur
Człowiek staje się wyleniałym tygrysem .	tygrysem	4	Sing
Niebo było pokryte białymi barankami .	barankami	4	Plur
Podzieli ona Twoje nadzieje i zaproponuje wspólne plany .	nadzieje	3	Plur
Hodowla owiec jest do dzisiaj jedną z głównych gałęzi gospodarki tych nadal słabo zaludnionych rejonów .	rejonów	14	Plur
Tadeusz Okoniewski pisał też do samych palotynek .	palotynek	6	Plur
Odrywa dłonie i powoli zaczyna schodzić na parter , kierując kroki do kuchni .	kroki	10	Plur
Celnicy podejmują decyzje o bardzo dużych kwotach .	kwotach	6	Plur
Zapisywał em także postanowienia na przyszłość .	postanowienia	3	Plur
Między miniaturowym arcydziełem a banalną grafomanią wyrasta obszar kompletnej pustki .	grafomanią	5	Sing
Tymczasem polska motoryzacja nie ma żadnej przyszłości poza prostym składaniem zestawów samochodowych , a planowana operacja ma zabezpieczyć interesy banków .	składaniem	9	Sing
Jaki jest pana stosunek do eksperymentów genetycznych , dzięki którym zdaniem wielu specjalistów będzie można leczyć najcięższe schorzenia ?	schorzenia	17	Plur
Deszcze spowodowały znaczne zakłócenia w komunikacji kolejowej i lotniczej na południu kraju .	komunikacji	5	Sing
Goście podeszli do słupa , obejrzeli się .	Goście	0	Plur
Malwina spojrzała na niego z odrazą , Kulesza się zaczerwienił , ale Ewa , o dziwo , parsknęła śmiechem .	odrazą	5	Sing
Kobieta otworzyła drzwi , wpuściła do środka czarnowłosego mężczyznę .	mężczyznę	8	Sing
Huntington nie przyjmuje zatem argumentu o globalnej sekularyzacji .	sekularyzacji	7	Sing
W jakich uwarunkowaniach będziesz za to płacił ?	uwarunkowaniach	2	Plur
Miejsce każdego dobrego Polaka jest teraz w Polsce .	Miejsce	0	Sing
Nie wspominajcie o ojczyźnie , jej mitach i tradycjach .	mitach	6	Plur
Na zakończonym wczoraj w Paryżu kongresie FPK przyjęto 1080 głosami przeciw 43 centrowy program szefa partii Roberta Hue .	głosami	9	Plur
Proboszcz parafii wyjaśniał podczas świątecznych kazań , że w tym roku parafię czekają dwie duże uroczystości .	parafię	11	Sing
Ludzie wyjechali w poszukiwaniu wygody .	wygody	4	Sing
Nie wstąpi jego stopa junacka w strzemiona ojcowe .	strzemiona	6	Plur
Właściciel psa przyznał się do bicia .	Właściciel	0	Sing
Moda na École de Paris niewątpliwie zasłużenie dowartościowała to środowisko artystyczne , ale w przypadku niektórych nazwisk także przewartościowała .	środowisko	9	Sing
Mężczyzna doznał licznych obrażeń .	obrażeń	3	Plur
Komisja oceniła , że Milczanowski i funkcjonariusze urzędu popełnili przestępstwo .	funkcjonariusze	6	Plur
Panie pośle , czy wolno dawać łapówki ?	łapówki	6	Plur
W latach 90 . wielu duszpasterzy , kierując się potrzebą posiadania wyrazistego wroga , wskazuje z ambony na wyraźnie nazwany obóz polityczny , lożę , fundację czy partię .	obóz	20	Sing
Wykaz obejmował 33 rasy psów wymagających rejestracji i szkolenia .	psów	4	Plur
Sprawność podczas akcji i umiejętności ratowników oceniali sędziowie .	Sprawność	0	Sing
Wypraszam sobie takie porównania .	porównania	3	Plur
Głosić takie wywrotowe poglądy przed takim audytorium !	audytorium	6	Sing
Wypowiedział wojnę wielu bardzo różnym środowiskom .	środowiskom	5	Plur
Braków wtenczas nawet poeci nie wypuszczali .	Braków	0	Plur
Stylistyka Opla Astry wkrótce po jego prezentacji była dość nowoczesna , ale teraz w porównaniu z najnowszymi autami wygląda dość konserwatywnie .	Opla	1	Sing
Równolegle z kilkoma innymi inwestycjami w Tucholi rozpoczęły się prace związane z budową nawierzchni asfaltowej na podbudowie z gruzobetonu na ulicy Mickiewicza .	podbudowie	16	Sing
Nie wspominajcie o ojczyźnie , jej mitach i tradycjach .	tradycjach	8	Plur
- W budownictwie jest straszna bryndza .	budownictwie	2	Sing
Najciekawsza rozmowa zaczęła się przypadkiem na jednym z rautów .	rautów	8	Plur
- Stadion opanowali Chińczycy .	Stadion	1	Sing
- Do jakich jeszcze wspomnień chętnie Pan wraca ?	wspomnień	4	Plur
Kuglarze i prestidigitatorzy zdemaskowali swoje sztuczki .	prestidigitatorzy	2	Plur
Kilka lat temu ofiarą wandali padły mogiły na Cmentarzu na Powązkach w Warszawie .	wandali	4	Plur
Przed drzwiami sali rozpraw siedzieli uzbrojeni antyterroryści .	rozpraw	3	Plur
Gdy zrozumiał , że Zachód mylnie pojmuje religię hinduską jako politeizm , zaczął szukać głębszych warstw i analogii .	politeizm	10	Sing
Adam szukał do nowego domu parkietu .	parkietu	5	Sing
Przymykali śmy oko na jego wybryki , ale zaczął przeginać .	wybryki	5	Plur
Przygotowane składniki wymieszać z serkiem i przyprawami .	przyprawami	6	Plur
Na ekranie TV , na zatrzymanej stop-klatce Jurka Kilera idą napisy końcowe programu .	napisy	10	Plur
Obrazy cyfrowe składają się z połączonych ze sobą pikseli o różnych barwach lub tonach .	Obrazy	0	Plur
Laboratorium badań serologicznych pozostało w gestii leszczyńskiego szpitala .	badań	1	Plur
Przybysze z najnowszej fali na ogół stronią od polonijnych organizacji społecznych .	Przybysze	0	Plur
Jako metal szlachetny nie wypiera wodoru z kwasów , reaguje jedynie z gorącym kwasem azotowym i siarkowym , redukując je do odpowiednich tlenków .	tlenków	22	Plur
Błyskawicznie usunąłem plastikowe kliny i wyjąłem szybę z ramy .	kliny	3	Plur
Porozumienie to podpisano bez wstępnego konsultowania się z rządem .	Porozumienie	0	Sing
Hutnictwo polskie współpracuje z hutnictwem ZSRR , NRD , Czechosłowacji i Bułgarii .	Hutnictwo	0	Sing
Śpiewa ją na koncertach , bo publika , nie zawsze trzeźwa , domaga się .	koncertach	3	Plur
Spirytus jest rozlewany do kartoników litrowych , półlitrowych i ćwiartek .	kartoników	4	Plur
Uważa się , że od bhang pochodzi nazwa tradycyjnego indyjskiego tańca bhangra .	bhang	5	Sing
Udzielenie bowiem pracownikowi urlopu bezpłatnego nie oznacza rozwiązania umowy o pracę z danym zakładem .	pracownikowi	2	Sing
Wtedy wyciąga zawieruszony w pomiętej pościeli telefon komórkowy , by wszystkie je po kolei załatwić .	pościeli	5	Sing
Odrobina zazdrości utrzyma miłość w dobrej formie .	zazdrości	1	Sing
Czy chcę ich oboje z Cezarem obrazić , zapytała .	oboje	3	Plur
Trzecioligowcy strzelili kontaktowego gola , ale w ostatnim kwadransie dwie bramki dla Lecha wypracował Remień .	kwadransie	8	Sing
Część z nich wyjechała z nagrodami .	nagrodami	5	Plur
- Uważasz , że tylko dlatego jestem artystką , że mi się dobrze płaci ?	artystką	7	Sing
Potrawy były oceniane przez 110 niezależnych sędziów .	sędziów	6	Plur
Wychyliła m się z półki , spojrzała m w dół .	półki	4	Sing
W okolicach Ełku i Giżycka nie pracują 3 linie .	okolicach	1	Plur
Dopiero ze składów rozwozić go będą wozacy .	składów	2	Plur
Disco polo to piosenki .	Disco	0	Sing
Urzędniczka przysunęła mi telefon mimo tych niedołężnych wyjaśnień .	Urzędniczka	0	Sing
Liberec przygotował już sześć autokarów .	autokarów	4	Plur
Zbigniew Brzeziński , doradca prezydenta Jimmy'ego Cartera do spraw bezpieczeństwa , zaapelował o umiar do robotników , władzy i Kościoła w Polsce .	umiar	13	Sing
A to dlatego , że norwescy słuchacze nie cenią artystów wykreowanych przez wielkie wytwórnie .	słuchacze	6	Plur
Do zwykłego koła wystarczy sam sznurek .	koła	2	Sing
Chłopiec nie odpowiadał na wołania .	wołania	4	Plur
Jest lekarzem w klasztorze albertynów .	lekarzem	1	Sing
Trąba zaś staje się w tych sprawach podstawowym kierunkowskazem .	Trąba	0	Sing
Zarazem na wszystkich studentach zaciążyłby obowiązek przedstawiania WKU dokumentów świadczących , że nadal studiują .	studentach	3	Plur
Pani Czapkowa zaścieliła stół świeżą ceratą , podała kotlety z dzika , a po obiedzie odbyło się sympozjum .	dzika	10	Sing
On też miał we Lwowie kancelarię prawniczą .	kancelarię	5	Sing
Jednak po dokładnych oględzinach straż pożarna odkryła ofiarę pożaru .	ofiarę	7	Sing
– Ja tylko chcę się zobaczyć z więźniarką Gertrudą von Mogmitz .	więźniarką	7	Sing
Na miejscu uczy się wymowy nazw stacji metra .	wymowy	4	Sing
Plecy dziewczyn były czarne .	Plecy	0	Plur
Policjanci odwieźli delikwentów do izby wytrzeźwień .	delikwentów	2	Plur
25 lat temu zaginął w Bieszczadach w tajemniczych okolicznościach Witold Gontaszewski .	okolicznościach	8	Plur
Tylko w czterech państwach w Europie pojawiły się sieci DCS .	państwach	3	Plur
To jest najkompletniejszy zbiór .	zbiór	3	Sing
W lasach pasły się krowy i owce , czasem ozwał się poryk niedźwiedzia lub gniewne parsknięcie rysia .	parsknięcie	15	Sing
Luksusowego forda explorera nieznani sprawcy skradli wczoraj w Warszawie generałowi rosyjskiej milicji .	generałowi	9	Sing
Nawet o tym nie śniła m , przeznaczenie , znaczenie , zna-czenie .	zna-czenie	11	Sing
Był tylko z mamą .	mamą	3	Sing
W czasie weekendu dorodny lampart spacerował ulicami stolicy Indii , Delhi .	lampart	4	Sing
Mieli śmy już za sobą wzniesienie i za zakrętem opadającej łagodnie drogi wyłonił się skraj cmentarza .	skraj	14	Sing
I szedł em przez te stygnące odchody coraz bardziej markotny , a przygnębienia przybywało mi z każdym krokiem .	przygnębienia	12	Sing
Dla mnie to bujda na resorach .	resorach	5	Plur
To również efekt poddawania takich produktów szybkiej obróbce termicznej .	obróbce	7	Sing
Wyprowadzają one małe koźlęta na płaty śniegu i uczą je zjeżdżać na racicach .	racicach	12	Plur
Złem jest jego uprawianie .	Złem	0	Sing
Czasami zapominała o wielu istotnych rzeczach .	rzeczach	5	Plur
- Ależ takie usługi są obowiązkowe i nie ma tu żadnej dyskusji .	usługi	3	Plur
Mogła m sprawdzić dokładnie ten link przed napisaniem posta .	posta	8	Sing
Były już trzy kółka ze starszych robotników .	kółka	3	Plur
Nagle usłyszałem strzał , wpadłem do warsztatu i zastałem trupa .	warsztatu	6	Sing
O klasztornym piekle , zgotowanym przez trzy potwory w habitach , pisaliśmy w kwietniu br .	habitach	9	Plur
Dziś w biznesowej działalności wspiera młodzieńca mamusia .	mamusia	6	Sing
- Wwozisz do Polski kapitał , bierzesz adwokata , który w krótkim czasie załatwia wszystkie prawne problemy .	problemy	16	Plur
Teraz można je pokazywać po godz. 23 .	godz.	5	Sing
Delfina w herbie ma Szkoła Policealna Pracowników Służb Socjalnych w Poznaniu .	herbie	2	Sing
Sama wymyśliła m przepis na moje najukochańsze ciasto .	przepis	3	Sing
Drużynowymi finałami zakończona została w poniedziałek rywalizacja pływaków o medale i dolarowe premie w Igrzyskach Dobrej Woli .	finałami	1	Plur
Senat wprowadził pięć poprawek do nowelizacji Kodeksu postępowania w sprawach o wykroczenia .	wykroczenia	11	Plur
- Do sypialni Polaków coraz częściej wchodzą istoty posiadające zdolność przenikania przez ściany .	sypialni	2	Plur
Drugi pod względem kapitalizacji giełdowej Wielkopolski Bank Kredytowy osiągnął bardzo dobrą miesięczną dynamikę zysków wynoszącą 81,4 proc .	zysków	13	Plur
Chodorkowski podpadł władzom , bo krytykował prezydenta Putina i nie krył swoich politycznych ambicji .	władzom	2	Plur
Podczas pogrzebów nie biją dzwony .	pogrzebów	1	Plur
- Dlaczego fundusz ma dwie rady nadzorcze i dwa zarządy ?	fundusz	2	Sing
Ci z dołu łapią ich za nogawki , żeby ściągnąć do swojego poziomu .	nogawki	6	Plur
Na torze pod Kielcami odbyty się pierwsze wyścigi samochodowe .	wyścigi	7	Plur
Aby udowodnić winę osobie opalającej zabronionymi materiałami , należałoby przeprowadzić specjalistyczne badania wydobywającego się z komina dymu .	osobie	3	Sing
Czy jednak orzeczenie sądu położy kres plotkom . . . ?	plotkom	6	Plur
Motocyklista zmarł po przewiezieniu go do szpitala .	przewiezieniu	3	Sing
Oto wybiera się sierota z całą gromadą kopać na hrabiowskich redlinach .	redlinach	10	Plur
Istnieją też miasta , dla których nigdy nie ustaje karnawał .	karnawał	9	Sing
- Katolik nie musi wierzyć w cuda ?	Katolik	1	Sing
Z oficjalnym żądaniem wobec MKOl , złożonym na piśmie , wystąpił Narodowy Komitet Olimpijski KRLD , domagając się od naczelnej władzy sportowej rewizji listy triumfatorów olimpijskich .	triumfatorów	24	Plur
Zatrudnia zaledwie 60 urzędników , wśród nich tylko czterech księży .	urzędników	3	Plur
Grupa ponad 30 działaczy samorządowych , spółdzielców i bankierów na czterech pięciodniowych sesjach ma poznać francuskie rozwiązania dotyczące budownictwa czynszowego .	Grupa	0	Sing
Mam nadzieję , że za Dziurowiczem pójdą następni .	następni	7	Plur
Rany odniosła także jeszcze jedna bawiąca wówczas w lokalu ukraińska niewiasta .	lokalu	8	Sing
Uczucia decydują o przyszłości i sekwencji wydarzeń .	Uczucia	0	Plur
W tej sytuacji wiele przedziałów w pociągach nad morze , w góry i na Mazury zajmują koloniści .	koloniści	16	Plur
Drugim ważnym wydarzeniem był run na giełdę firm poszukujących kapitału .	run	4	Sing
Resztę dopowiedzą polityczni konkurenci .	konkurenci	3	Plur
- Ja zawsze jestem z drużyną , gramy do jednej bramki .	bramki	10	Sing
Ale ci politycy z kolei nie gwarantują przeprowadzenia koniecznych reform gospodarczych .	politycy	2	Plur
Może w dużych ośrodkach miejskich ludzie zagłosują na Juszczenkę , ale we wsiach poparcie dla Janukowicza będzie ogromne .	ośrodkach	3	Plur
Przekazuj zasady prostym językiem .	językiem	3	Sing
Dodatkowym zyskiem będzie stworzenie nowych miejsc pracy .	zyskiem	1	Sing
Szwecja wymaga także odrobaczenia kota na 10 dni przed wyjazdem .	odrobaczenia	3	Sing
Nie przemierza go kondukt , nie biją dzwony .	dzwony	7	Plur
- Wóz się chybnie i zlecą .	Wóz	1	Sing
Był sparaliżowany , stracił mowę i pamięć .	mowę	4	Sing
Adiunkt notuje uwagi z kontroli , następuje krótka konsultacja naukowa .	konsultacja	8	Sing
Spirytus jest rozlewany do kartoników litrowych , półlitrowych i ćwiartek .	Spirytus	0	Sing
Jego kompan uważnie obserwuje teren .	kompan	1	Sing
Jeszcze po południu zawieszony prezes największego polskiego ubezpieczyciela nie wiedział , czy członkowie rady podejmą jakieś decyzje w jego sprawie .	prezes	4	Sing
Kryteria do odstrzału selekcyjnego są zróżnicowane w zależności od rejonu siedliska .	siedliska	10	Sing
Zagroda zaraz by cię wsadził za kratki .	kratki	6	Plur
Na ganek wyszła starsza pani , ubrana w niemodną sukienkę z koronkowym kołnierzykiem i mankietami .	mankietami	14	Plur
- W Krzyczkach leży jeszcze kilkadziesiąt zakopanych psów .	psów	7	Plur
Z dziedzińca koszar pułkownik Ahlberg obserwował przez lornetkę aeroplan .	pułkownik	3	Sing
W ucho się zamienić .	ucho	1	Sing
Głos zabrał towarzysz Korntopf od nauki .	towarzysz	2	Sing
Pociski te przebijają najgrubsze pancerze .	Pociski	0	Plur
Mimo że Amerykanie uznali operację za udaną , z rejonu walk zdołało wymknąć się wielu partyzantów .	walk	10	Plur
Potem ból stał się tak silny , że przesłonił wszystko ciemnością pozbawioną woni i dźwięków .	ciemnością	10	Sing
Nie lubiły tylko pijaków , szczekały , kiedy opierali się o płot .	pijaków	3	Plur
Na razie żeglarze z całego świata odpoczywają i bawią się w Talinie .	żeglarze	2	Plur
Po paru dniach znał już wszystko i wszystkich i spędzał na górnych piętrach każdą wolną chwilę , wychodząc tylko w porze posiłków i oczywiście snu .	piętrach	12	Plur
Może w styczniu zaproszę cię na chrzciny .	chrzciny	6	Plur
W Bachantkach taka gra zaczynała się od wejścia kobiet , ich zebranie nie było zebraniem teatralnym .	Bachantkach	1	Plur
Ogarnęła ją niepewność i rozgoryczenie .	rozgoryczenie	4	Sing
Ale to nie tylko zadanie związku , bo kolosalne znaczenie ma też jakość hal .	hal	13	Plur
Decyzje w tej sprawie podjęły Mostostal Warszawa , Elektrim , Polifarb i Okocim .	Decyzje	0	Plur
Kiedy papamobil zbliżał się do pomnika , wierni zaczęli bić brawo .	papamobil	1	Sing
– dobrze napij się limoniady .	limoniady	4	Sing
Dowodów nie mam .	Dowodów	0	Plur
Pozdrawiam wszystkich dyskutantów .	dyskutantów	2	Plur
W latach sześćdziesiątych , już jako sztygar oddziałowy , pamiętam odbiory przygotowywanych do rozruchu ścian dokonywane przez dyrektora Śniegonia .	ścian	14	Plur
Po jej najwybitniejszych przedstawicielach na cenowe szczyty dostali się liczni malarze , których zasługi artystyczne , poza tworzeniem dekoracyjnych i sprawnych technicznie obrazów , są raczej mizerne .	obrazów	22	Plur
Na miejscu specjalna ekipa zbadała pozostałości po eksplozji .	pozostałości	5	Plur
Na zakończenie przedstawiona zostanie syntetycznie współzależność sztuki ruchu z innymi rodzajami sztuk .	sztuk	11	Plur
Bąk uniósł się na łokciach , podparł pięściami brodę .	brodę	8	Sing
Jesteś sierotą z potencjałem .	sierotą	1	Sing
Dzieci się uczą na pamięć długości rzek , głębokości jezior . . .	rzek	6	Plur
Samoobrona i PSL znalazły się poniżej progu wyborczego .	progu	6	Sing
Jej mąż nigdzie nie pracował , ale nie mieli materialnych kłopotów .	kłopotów	10	Plur
Kobieta prawidłowo , po pasach , przechodziła przez jezdnię .	pasach	4	Plur
Podrzuciłem kluczyki w dłoni .	kluczyki	1	Plur
Pora na nastolatki .	nastolatki	2	Plur
Bądź wyczulony na poczucie godności .	godności	4	Sing
Stowarzyszenie na Rzecz Praw i Wolności liczy ok . tysiąca członków .	Praw	3	Plur
Zacisnął em palce na szorstkim płótnie i wyczuł em obłe kształty pocisków .	palce	2	Plur
Nie znał em go przedtem , bo za moich czasów wileńskich był jeszcze sztubakiem , a potem przebywał za granicą .	sztubakiem	13	Sing
Patrzy , a tu we włosach łonowych roi się od weszek .	weszek	10	Plur
Taka ustawa obowiązuje już od ubiegłego roku , ale dopiero wczoraj szef MSW podpisał odpowiednie rozporządzenie .	rozporządzenie	15	Sing
Po przewrocie władzę w Algierii objęła Rada Rewolucyjna .	przewrocie	1	Sing
Słuchawka leżała odłożona na stoliku obok czyjejś niedopitej herbaty .	herbaty	8	Sing
Każdy z nas robi błędy . . .	błędy	4	Plur
Ażeby takim przykrym kolizyom zaradzić , puszczamy w świat ten oto podręcznik .	kolizyom	3	Plur
– grenat to będzie granat .	grenat	1	Sing
- Przyjeżdżają i od progu mówią , że cały obszar kupują .	progu	4	Sing
– Ten komplet narzędzi służył do ćwiartowania korpusów .	korpusów	7	Plur
O zaliczeniu maszyny , urządzenia lub aparatu do odpowiedniej podgrupy decyduje jej przeznaczenie oraz konstrukcja i wyposażenie .	konstrukcja	14	Sing
Wygrała m cię do ostatka .	ostatka	4	Sing
Dozorca i drugi mężczyzna , stojący obok , wzięli kobietę pod ręce i wyprowadzili na korytarz .	kobietę	9	Sing
Ale dzieciaki i tak odbijają piłki o ściany pod oknami .	oknami	9	Plur
Prawdopodobnie odbywało się ono przez podanie wieńca z grochowin .	grochowin	8	Plur
W jego siedzibie znajdowało się centrum festiwalowe , tam grane były najważniejsze spektakle .	siedzibie	2	Sing
Ponadto badania te świadczą , że koncentraty alkoholowe różnych roślin są dobrym środkiem zapobiegawczym przeciw grypie .	środkiem	12	Sing
Rodzice wciąż pracują .	Rodzice	0	Plur
W bocznych nawach kościelnych stoją półki z książkami .	nawach	2	Plur
Mnóstwo siedzib ludzkich staje pod wodą .	siedzib	1	Plur
— Są ludzie , którzy starają się wprowadzać pewne udogodnienia .	udogodnienia	9	Plur
W ZUS nie ukrywają , że lekarzom trudno udowodnić , iż nadużywają swych kompetencji .	lekarzom	6	Plur
Kojarzysz mi się z egzotyczną czarownicą .	czarownicą	5	Sing
Czy do wszystkich potraw używa się sztućców ?	potraw	3	Plur
Ostatnio sprzedano cztery pod elektrownie wiatrowe .	elektrownie	4	Plur
Jest to istotne , zwłaszcza dla internautów korzystających z modemów .	internautów	6	Plur
Podczas pogrzebów nie biją dzwony .	dzwony	4	Plur
Może być attache kulturalny na Hawajach .	attache	2	Sing
W tle widać zarys bawarskiego tronu z atrybutami władzy królewskiej .	władzy	8	Sing
Powodem był ulatniający się z nieszczelnej instalacji gaz .	gaz	7	Sing
Pracownię przekazano nieodpłatnie .	Pracownię	0	Sing
KOKS MUSI BYĆ !	KOKS	0	Sing
Antyterroryści spuścili się po linach ze śmigłowca wprost pod drzwi gangstera .	Antyterroryści	0	Plur
W ostatniej sekundzie uniknął zderzenia z mercedesem .	mercedesem	6	Sing
Przez tereny parku wiodą 44 szlaki turystyczne piesze i 10 narciarskich .	tereny	1	Plur
- Rozsądek nakazywałby zabrać go ze sobą .	Rozsądek	1	Sing
Był czasem sporów i namiętności .	namiętności	4	Plur
Most w Kuligach na rzece Jegrzni znajduje się w fatalnym stanie i grozi zawaleniem .	rzece	4	Sing
Ministerstwo Finansów zaproponowało w założeniach do przyszłorocznego budżetu radykalne oszczędności , aby zmniejszyć jego deficyt do 35 mld zł .	założeniach	4	Plur
Niedziela Palmowa na Kociewiu różniła się zresztą od obchodów w innych częściach Polski .	obchodów	8	Plur
Zatrzymał doktorwagena przed samym wejściem , przywiązał lejce do barierki przy krawężniku , pogłaskał konia po chrapach i wszedł do królestwa Polizeiwachtmeistra Starkego .	lejce	7	Plur
no daj tę trutkę . .	trutkę	3	Sing
Dotyczy to na przykład usług telekomunikacyjnych , transportowych , ubezpieczeniowych , finansowych .	usług	4	Plur
Opracował program dydaktyczny wychowania seksualnego , którego realizacja została ostatnio wstrzymana .	realizacja	7	Sing
Jego anegdoty traktowały o najrozmaitszych księżach dziwakach , których w okolicy nie brakło , a których przygody tchnęły często humorem z epoki Seweryna Soplicy czy nawet Paska .	epoki	21	Sing
Tam weterynarz przeprowadził sekcję , z której jasno wynika , że pies padł z powodu wysokiej temperatury .	sekcję	3	Sing
Kim jest strażnik łowiecki ?	strażnik	2	Sing
Proboszcz parafii wyjaśniał podczas świątecznych kazań , że w tym roku parafię czekają dwie duże uroczystości .	kazań	5	Plur
Ostatecznie mogł em przyjść z donosem wcześniej i nie wchodzić w to tak głęboko .	donosem	5	Sing
Dalej autor artykułu sugestywnie opisuje , jak na ów obszar spada potężna rakieta z głowicą wodorową , powodując kolosalną eksplozję .	eksplozję	19	Sing
Złotą Statuetkę pierwszy niekomunistyczny premier w powojennej Polsce odebrał w sobotę podczas Wielkiej Gali Polskiego Biznesu .	Statuetkę	1	Sing
Kiedy rysuje , odlewa wielkie postaci w brązie i tworzy delikatne maski z żywicy , nigdy nie zatrzymuje się na jednym egzemplarzu .	egzemplarzu	21	Sing
Ten okres minnesangu zakończył się w ostatniej dekadzie XII wieku , gdy naśladownictwa ustąpiły nowym tematom i formom wypracowanym przez miejscowych poetów .	poetów	21	Plur
Raz zapragnęli socjalizmu , potem zwrócili się przeciw socjalizmowi . . .	socjalizmowi	8	Sing
W skład Grupy wchodzą firmy i ludzie powiązani z interesami postkomunistów .	postkomunistów	10	Plur
Współpracownicy uważają go za artystę niezwykle wrażliwego na krytykę .	krytykę	8	Sing
Nie piszą o nim podręczniki , tradycja nie przekazuje jego zasług potomnym .	potomnym	11	Plur
Cały kraj był zdławiony tym okropnym cieniem .	kraj	1	Sing
- Na pniu sprzedałem kilkaset egzemplarzy .	pniu	2	Sing
Zakłada ona , że obywatele polscy będą mogli przebywać w Izraelu bez wizy do trzech miesięcy i że takie samo prawo w odniesieniu do pobytu w Polsce będą mieli obywatele Izraela .	pobytu	24	Sing
Innym razem pojechała z Kaharem do portu Xiamen na południu Chin , gdzie kupili trzy japońskie magnetowidy .	magnetowidy	16	Plur
I pewnie będzie grzanie dłoni przy ognisku .	grzanie	3	Sing
Żelazny kolos Żugajowi nie nabił nawet guza .	kolos	1	Sing
Zimą bywało , że nie jadła tygodniami .	tygodniami	6	Plur
Całość w formie tekstowej zostanie opublikowana po autoryzacji .	Całość	0	Sing
- Weź te ręce , gówniarzu !	gówniarzu	5	Sing
W poniedziałek ustalony został ostateczny podział funkcji w radzie nadzorczej tucholskiej Spółdzielni Mieszkaniowej .	radzie	8	Sing
- Nie mogę jednak zawieść swoich pacjentów .	pacjentów	6	Plur
To pleban kawęczyński jechał dwukonnym wózkiem do miasta .	pleban	1	Sing
Magazyn pozwoli firmie na zaspokojenie potrzeb rynku poprzez zapewnienie odpowiednich zapasów ogumienia .	zaspokojenie	4	Sing
W przypadku kręgowców naszej strefy klimatycznej były by to zależności zbyt uproszczone .	kręgowców	2	Plur
Wracajcie pod szyb po ludzi , siekiery i kilofy .	kilofy	8	Plur
- Stadion opanowali Chińczycy .	Stadion	1	Sing
Policjanci i prokuratorzy potwierdzają , że ostatnio liczba wyłudzeń VAT-u i subwencji lawinowo wzrosła .	wyłudzeń	8	Plur
Więźniowie dostają przepustki .	przepustki	2	Plur
- Na stole rozłożył odbitki kserograficzne stron Rocznika Statystycznego .	odbitki	4	Plur
Ale Europa Zachodnia jest bardzo łagodna i tolerancyjna wobec zbrodniarzy komunistycznych .	zbrodniarzy	9	Plur
Nie budzi go huk przejeżdżającego pociągu ani blask słońca , kiedy odpływa kolejny obłok .	obłok	13	Sing
Czy wybór między czołowymi producentami nart jest istotny dla wyniku , czy to tylko kwestia pieniędzy ?	nart	5	Plur
Polski samolot M-28 rozbił się i eksplodował kilka sekund po starcie z lotniska w Puerto Cabello , 200 km na zachód od Caracas .	samolot	1	Sing
A teraz ma krowę piwoszkę .	piwoszkę	4	Sing
Na walizki nikt nawet nie spojrzał .	walizki	1	Plur
A dlaczego małżeństwo z Szymonem miało by kolidować z tymi planami ?	planami	10	Plur
Juniorską reprezentację w najbliższym czasie czekają półfinały ME w Essen .	reprezentację	1	Sing
Wtedy bandyci atakują chłopaka .	bandyci	1	Plur
Duchy lubią takie miasteczka .	miasteczka	3	Plur
Wykonany z asferycznych soczewek ze szkła fluorytowego , pozwala na uzyskanie bardzo dobrej jakości obrazu .	jakości	13	Sing
Mówią , że kobieta wcale nie była w ciąży .	ciąży	8	Sing
Mendel żyje w dostatku , ale rozpacza .	dostatku	3	Sing
Wtedy dziewczynka zdjęła spodnie i kurtkę , a także buty .	buty	9	Plur
Giną więc wozy , których właściciele nie ubezpieczają ze względu na wysokie stawki .	właściciele	5	Plur
– i co miał eś na egzaminie ?	egzaminie	6	Sing
Premier nazwał pieniądze przeznaczone na utrzymanie Kancelarii Prezydenta i swojej wartościami .	wartościami	10	Plur
Wśród wielu przysmaków polskiej kuchni ryba morska zajmuje coraz ważniejszą pozycję .	ryba	5	Sing
Ruszyli bez żadnych kłopotów , reflektory oświetliły drogę i pnie przydrożnych drzew .	pnie	9	Plur
Samolot Ignacego odrywał się od ziemi , a Dominika i Adaś nie mogli oderwać się od siebie i intensywność ich spotkań rosła kosztem ostrożności .	Samolot	0	Sing
W czwartek do egzaminu ustnego z historii przystąpiło 94 maturzystów , w piątek natomiast 59 miłośników biologii popisywało się wiedzą z tej dziedziny .	biologii	16	Sing
Parowozy zawsze fascynowały i przerażały .	Parowozy	0	Plur
Czuł em jego mięśnie napięte pod skórą , twarde jak drewno .	mięśnie	3	Plur
Polskę reprezentowały dwie kompozycje .	kompozycje	3	Plur
W półfinałach rozegrano mecze systemem pucharowym , a zwycięzcy awansowali do finałów .	systemem	4	Sing
Po obu stronach muszą kisnąć jakieś mokradła , co oddychają mgłami .	mgłami	10	Plur
Kątem oka widział matkę , wierzchem dłoni ocierającą łzy .	wierzchem	5	Sing
Burmistrz , Zbigniew Grzesiak , wyjaśnił , że są trudności w porozumieniu się z Urzędem Rejonowym .	trudności	9	Plur
Mamy do wyremontowania wiele instalacji wodno - kanalizacyjnych w gimnazjach .	wyremontowania	2	Sing
W szkołach średnich wszyscy czekają na rozporządzenie .	szkołach	1	Plur
Komputerowy montaż grafiki nie jest domeną zastrzeżoną wyłącznie dla profesjonalistów .	profesjonalistów	9	Plur
- Nie zorganizowano zawodów na odpowiednim poziomie , na przykład w skokach do wody czy siatkówce , bo Zimbabwe nie spodziewa się w tych dyscyplinach osiągnięć .	osiągnięć	25	Plur
Przeprowadził wówczas kilka niebłahych akcji , tu zrelacjonowanych z detalami . . .	detalami	9	Plur
Inny facet postanowił , że postawi stację z gazem do samochodów przy ul. Warszawskiej .	gazem	8	Sing
Celników z rzepińskiej Izby Celnej wspierali funkcjonariusze z Poznania i Krakowa .	funkcjonariusze	6	Plur
Prawdopodobnie w toalecie przestępcy zaopatrzyli się w granaty i pistolet .	przestępcy	3	Plur
Coś poruszyło się z tyłu , za ramieniem dziesiętnika .	dziesiętnika	8	Sing
Skąd wziąć 750 obrazów ?	obrazów	3	Plur
Na klatce schodowej domu u zbiegu Alei Jerozolimskich i Nowego Światu skoczył z wysokości trzeciego piętra .	Alei	6	Plur
Przebiegające pod miastem chodniki kopalni zalano wodą , a wzgórze zgniło i zapadło się w ziemię jak przydeptane .	chodniki	3	Plur
Mimo że Amerykanie uznali operację za udaną , z rejonu walk zdołało wymknąć się wielu partyzantów .	partyzantów	15	Plur
Razem ze mną miał być przyjęty inny kandydat , który jednak w ostatniej chwili zrezygnował .	kandydat	7	Sing
Przesadził em tu z ofensywnym tonem .	tonem	5	Sing
Hill startował z pole position , ale już na pierwszych metrach wyprzedził go kolega z zespołu David Coulthard .	zespołu	15	Sing
Niezadowolenie wyrazili również jej koledzy z SDP .	Niezadowolenie	0	Sing
Nic nie zapowiada takiego scenariusza .	scenariusza	4	Sing
Mam najnowsze zestawy osób nagrodzonych .	zestawy	2	Plur
Czy ich gospodynie nie prasują im na starość bielizny ?	gospodynie	2	Plur
Ekspozycja zawiera kilkaset zdjęć przedstawiających życie codzienne ludzi w NRD .	Ekspozycja	0	Sing
Zorganizowano również dla nich warsztaty rękodzielnicze z zakresu robienia na drutach , haftowania , tkania , wykonywania makram .	makram	17	Plur
Książki są polifoniczne , ekspansywne , kontrowersyjne .	Książki	0	Plur
Na placach poczęły gromadzić się grupy przechodniów z zadartymi do góry głowami .	przechodniów	6	Plur
Odrobina zazdrości utrzyma miłość w dobrej formie .	zazdrości	1	Sing
Daktyle sparzyć , drobno pokroić i dodać z pozostałym masłem do kuskusu .	Daktyle	0	Plur
W sprasowanych autach zginęły cztery osoby .	autach	2	Plur
Państwu to się opłaci .	Państwu	0	Sing
Przekupnie w bazarowych zaułkach opowiadali , że upadek rządu jest bliski i nieuchronny , a ministrowie i generałowie knują spiski albo pakują walizy i szykują się do ucieczki za granicę .	Przekupnie	0	Plur
Nowość polegała na tym , że nauczyciele chrześcijańscy wykazywali , iż w osobie Jezusa Chrystusa wypełniły się wszystkie przepowiednie proroków .	Nowość	0	Sing
Gospodarze odpowiedzieli dwoma golami Ralfa Hauptmanna i Austriaka Tony Polstera .	golami	3	Plur
43-letni młodszy brygadier dmuchnął w alkomat .	brygadier	2	Sing
I doczekać z antykaczyńskim rządem do jesiennych wyborów .	rządem	4	Sing
Najcudowniejsze cnoty staną się wadami , jeśli w nich zabraknie ufności .	wadami	4	Plur
Steve zaklina się , że po każdym dyżurze szykuje ekstra posiłek czworonożnemu ratownikowi .	posiłek	10	Sing
- Muszę przynieść więcej gałęzi .	gałęzi	4	Plur
Rozpalą nimi pierwszą watrę przy szałasie .	szałasie	5	Sing
Zginęło wtedy dwóch pilotów .	pilotów	3	Plur
- W Janowie to była dziecinada .	dziecinada	5	Sing
Na placu Wolności wisiało jeszcze wtedy kilka plakatów , zachęcających do głosowania na Tadeusza Zwiefkę .	plakatów	7	Plur
Ciała te noszą ślady tortur .	Ciała	0	Plur
Można nawet powiedzieć , że z eskalacji protestów czerpie pewne korzyści .	eskalacji	6	Sing
Słone przekleństwa dolatywały aż do ostatniego wozu .	przekleństwa	1	Plur
Tegoroczną nowością raportu jest skala krajowego seksu wirtualnego .	nowością	1	Sing
Wazopresyna jest szybko unieczynniana przez peptydy osocza .	peptydy	5	Plur
Niestety , ładowarki nie otrzymał .	ładowarki	2	Sing
Warany cieszą się dużym zainteresowaniem kolekcjonerów , gdyż nie można ich kupić legalnie .	kolekcjonerów	5	Plur
Posługując się nim z szermierczą precyzją i taneczną lekkością , można grać na barwnych strunach duszy .	strunach	14	Plur
Dziewczynę bolało kolano .	Dziewczynę	0	Sing
Marzę o pożarze . . .	pożarze	2	Sing
Mówić on będzie dzisiaj o sytuacji religijnej i nowych ruchach w Europie .	ruchach	9	Plur
Wstępne wyniki dochodzenia będą znane w styczniu przyszłego roku .	styczniu	6	Sing
Kryteria do odstrzału selekcyjnego są zróżnicowane w zależności od rejonu siedliska .	Kryteria	0	Plur
Po kompromitującym czynie , logiczna jest likwidacja świadków , to typowy sposób postępowania wszystkich szanujących się gangsterów .	gangsterów	16	Plur
HIV jednak pochodzi od małp .	małp	4	Plur
Na każdej tabletce było logo dolara .	tabletce	2	Sing
Współpracownicy uważają go za artystę niezwykle wrażliwego na krytykę .	Współpracownicy	0	Plur
- Ty ś widział w kinie ?	kinie	5	Sing
Odbudujmy porozumienie ponad różnicami , tak mało istotnymi wobec rzeczywistych problemów !	różnicami	3	Plur
Jak dotąd , ani Państwowe Koleje Linowe , ani straż miejska , ani policja nie potrafiły poradzić sobie z konikami .	konikami	19	Plur
Ale wstrząsające relacje wywołały debatę na temat stosowania przymusu przy kontroli urodzin .	przymusu	8	Sing
Z dziedzińca koszar pułkownik Ahlberg obserwował przez lornetkę aeroplan .	dziedzińca	1	Sing
Z kolejnej po jabłkach , wiśniach i porzeczkach klęski urodzaju cieszą się konsumenci .	porzeczkach	7	Plur
Aktor mamrocze coś niewyraźnie pod nosem , ale ma mikrofon i widz go zrozumie .	mikrofon	9	Sing
Do tego momentu Polak miał wyraźną przewagę .	przewagę	6	Sing
Kamienny młot człowieka uderzał w furii we włochatą pierś zwierzęcą .	pierś	8	Sing
Doznały jedynie stłuczeń kończyn i po opatrzeniu ran w szpitalu w Broumovie zostały zwolnione .	stłuczeń	2	Plur
Drugim ważnym wydarzeniem był run na giełdę firm poszukujących kapitału .	kapitału	9	Sing
Najciekawsza rozmowa zaczęła się przypadkiem na jednym z rautów .	przypadkiem	4	Sing
Czyżby jakieś złe moce zawisły nie tylko nad publicznymi mediami , ale również nad Warszawiakami ?	mediami	9	Plur
Dyskrecja , takt i skromność to podstawowe pojęcia bon tonu .	takt	2	Sing
- Pozwólmy mu trochę pomyśleć nad swoimi manierami .	manierami	7	Plur
Posadziła m nasturcje we wszystkich skrzynkach .	skrzynkach	5	Plur
Selekcjoner Jerzy Engel rozdał pamiątkowe monety , wybite z okazji zbliżających się mistrzostw świata .	monety	5	Plur
Trzech sprytnych chłopców szukało nawet syrenki w przedszkolnym akwarium .	syrenki	5	Sing
Dlaczego został w Osiedlu ?	Osiedlu	3	Sing
– tabletek nie wzięła m ze sobą .	tabletek	1	Plur
Zarobki wszystkich nauczycieli będą rosły co rok .	Zarobki	0	Plur
Dotknięta wojennymi ciężarami buntowała się i odmawiała odrabiania pańszczyzny .	ciężarami	2	Plur
Kiedyś w Poznaniu spotkałem się z moimi polskimi krewnymi .	krewnymi	8	Plur
Jestem raperem , jeżdżę rowerem .	rowerem	4	Sing
Po powrocie do domu stwierdziłem , że nie stać mnie na zakup .	zakup	11	Sing
Statut określa zasady wynagradzania za użytkowanie tych wkładów .	Statut	0	Sing
TOPR-owcy ostrzegają przed bardzo trudnymi warunkami panującymi na szlakach .	warunkami	5	Plur
Lokal ten otrzymał nowe pomieszczenia dla kuchni i podręcznych magazynów , oraz szatnię .	magazynów	9	Plur
W kolejnych rzędach stali niewidomi , część z psami - przewodnikami , a także niesłyszący i niemi .	niesłyszący	14	Plur
Tomasz Gudzowaty poluje kamerą na lwy , gepardy , lamparty .	gepardy	7	Plur
W dusznej od papierosowego dymu izbie tłoczono się okropnie .	dymu	4	Sing
Tassilo de Tresckow zajechał go i ciął mieczem .	de	1	Sing
Ulubieniec publiczności doskonale wywiązał się z tego zadania .	publiczności	1	Sing
Ten dialog został odtworzony w śledztwie bez trudu .	trudu	7	Sing
Szynkarz kłaniał mu się nisko .	Szynkarz	0	Sing
Cmentarz przecina już kilka alejek z kostki betonowej .	alejek	4	Plur
I dostał prawą pięścią w zęby , tak , że ujrzał wielką jasność .	jasność	12	Sing
Pomysł powstał podczas uzupełniania ksiąg parafialnych , które były skrupulatnie sprawdzane podczas duszpasterskich wizytacji .	wizytacji	13	Plur
Helena przeżyła swój kryzys w drugiej klasie liceum .	kryzys	3	Sing
Fascynująca jest też rola badań kosmicznych w tej dyscyplinie .	badań	4	Plur
Równie dobrze mógł by m być chyba biologiem , geometrą .	geometrą	9	Sing
Wessie je mózg , wątroba , rurką pępowiny popłyną do Poli .	rurką	6	Sing
Rok funkcjonowania wyższych szczebli samorządów nie upoważnia jeszcze do ocen .	ocen	9	Plur
Porozumienie zostało podpisane pod koniec 1997 roku w Waszyngtonie .	Porozumienie	0	Sing
Chwilę manipulował przełącznikami i nagle w głośniku odezwał się wysoki , dźwięczny ton .	przełącznikami	2	Plur
Uroczystości weselne zaczynały się od wtorku .	Uroczystości	0	Plur
Nowoczesną motorówkę do patrolowania Wisły ukradziono policjantom z Torunia .	patrolowania	3	Sing
Duszy nie ma , ale Kotliński nienawidzi Kościoła z całej duszy .	Duszy	0	Sing
A ogrzewania wyłączyć nie możemy , bo to zaszkodzi świeżo zakonserwowanym freskom w obu synagogach .	freskom	11	Plur
W czwartek do egzaminu ustnego z historii przystąpiło 94 maturzystów , w piątek natomiast 59 miłośników biologii popisywało się wiedzą z tej dziedziny .	dziedziny	22	Sing
Młode kudowianki z reguły są jeszcze na utrzymaniu rodziców , którzy ledwie wiążą koniec z końcem .	utrzymaniu	7	Sing
Wczoraj zatrzymali go funkcjonariusze z Biura Spraw Wewnętrznych w Gdańsku .	funkcjonariusze	3	Plur
Przedtem włóczyli się po mieście , topniał śnieg , szumiało w rynnach , czuć było powiewy ciepła i zgnilizny , nad dachami tłukły się kłębiaste chmury .	dachami	21	Plur
Był na ostatnich derbach .	derbach	3	Plur
Wszystko się kołysze , obie jednostki płyną .	jednostki	5	Plur
Zimą , przylatując na popas do Polski , zadowala się pozostałymi na krzakach jagodami .	jagodami	13	Plur
W półfinałach rozegrano mecze systemem pucharowym , a zwycięzcy awansowali do finałów .	finałów	11	Plur
Jest tu 16 jezior , łącznie z 4 jeziorami na obrzeżu , znajdującymi się już poza administracyjną granicą WPN .	jeziorami	8	Plur
Wszystkie pokoje wyposażone w szafy wnękowe są już gotowe .	szafy	4	Plur
Gdzieś zadzwonił dzwon .	dzwon	2	Sing
Najpierw samodzielność uzyskał Zakład Naprawy Autobusów w Biskupicach , wcześniej stanowiący integralną część MPK .	Zakład	3	Sing
- Zakłady i instytucje państwowe działają na podstawie decyzji urzędniczych .	instytucje	3	Plur
I na schodach też słyszała m tylko jej kroki .	kroki	8	Plur
Kilka dni temu na oddział trafiła prątkująca absolwentka gimnazjum .	gimnazjum	8	Sing
Oprócz słuchania Steczkowskiej delegaci zajmowali się dyskusją o strajku generalnym .	delegaci	3	Plur
Pomagają okłady z rumianku .	okłady	1	Plur
Ogłoszone wczoraj dane Narodowego Banku Polskiego , dotyczące wielkości deficytu na rachunku obrotów bieżących , zaskoczyły ekonomistów .	obrotów	12	Plur
9 mln emerytów i rencistów czeka na marcową waloryzację świadczeń .	świadczeń	9	Plur
Dotychczas za kratkami znalazło się sześciu egzaminatorów i pośredników .	pośredników	8	Plur
Tłumaczenia pozostawiają wiele do życzenia .	Tłumaczenia	0	Plur
Później strzałami w powietrze sterroryzował kasjerkę i zmusił ją do wydania pieniędzy .	strzałami	1	Plur
Siedzieć tu i pisać raporty ?	raporty	4	Plur
Najciekawsza stała się klasa markowa aut o pojemności do 650 cm .	aut	5	Plur
Powierzchnię morza pruły statki , oczekujące pojawienia się ostatniego członu rakiety .	statki	3	Plur
Puste mieszkania stały się rajem dla pijaków i meneli .	pijaków	6	Plur
Usmaż jeszcze kiedyś faworki , błagam .	faworki	3	Plur
Uzywa Pan terminów , których pan nie zdefiniował .	terminów	2	Plur
Podpłynął księżyc , przywarł i zaczął ssać .	księżyc	1	Sing
Kwiaty otrzymali nauczyciele , którzy przed laty kształcili kolejarskich specjalistów .	Kwiaty	0	Plur
Parafowanie umowy nie poprawiło szans wyborczych AWS , ale sprawa ta dalej jest wykorzystywana do celów politycznych .	celów	15	Plur
Proszę o uważną lekturę .	lekturę	3	Sing
Jednak fabryka Schindlera ma konkurencję .	fabryka	1	Sing
We wtorek posłowie przyszli po te informacje .	posłowie	2	Plur
Lżejsze podpórki chwytał po dwie i prawie biegnąc rzucał je na platformę .	podpórki	1	Plur
Mechanicy zajęli się już samochodem Gorczycy .	Mechanicy	0	Plur
Tymczasem polska motoryzacja nie ma żadnej przyszłości poza prostym składaniem zestawów samochodowych , a planowana operacja ma zabezpieczyć interesy banków .	zestawów	10	Plur
Pani nauczycielka kazała zawiadomić o tym rodziców .	nauczycielka	1	Sing
Towarzystwo oddelegowało kilku rzeczoznawców do pełnienia dyżurów i udzielania porad konsumentom .	dyżurów	6	Plur
Na przyszłe dożynki wybiera się do Warszawy .	dożynki	2	Plur
Wysunięte pretensje pod adresem autorów słownika nie zmienią językowej rzeczywistości .	rzeczywistości	9	Sing
Zdaje się , że uczył w szkołach .	szkołach	6	Plur
Kuskus przygotować według przepisu na opakowaniu , dodając 2 łyżki masła i szczyptę soli .	łyżki	9	Plur
O zawilgoceniu gruntu i budynków informowali jedynie archeolodzy prowadzący wykopaliska na starówce .	budynków	4	Plur
Sprawdzamy wyrostki kolczyste i łuki kręgów .	wyrostki	1	Plur
Opanowało ją swoiste zniewolenie , niemoc przeciwstawienia się .	niemoc	5	Sing
Megane oddał synowi , pracownikowi dydaktycznemu warszawskiej uczelni .	Megane	0	Sing
Półwysep Jukatan to kilkadziesiąt obszarów archeologicznych .	obszarów	4	Plur
- Ostatnio powiedział Pan , że Trybunał zachował się w sprawie konkordatu jak Piłat .	konkordatu	11	Sing
Zwolennicy Mossadegha , ministrowie , podejrzani oficerowie , działacze Tudeh są przesłuchiwani i torturowani .	działacze	8	Plur
Informacje na temat historii zen i różnych szkół znajdzie Czytelnik w chronologicznym zestawieniu najważniejszych wydarzeń z historii zen w Chinach i Japonii .	zen	4	Sing
Kapitalizm polityczny ma dwa oblicza .	oblicza	4	Plur
Ustalili ponadto , że w przestępczym autobiznesie działa ponad 1500 osób .	autobiznesie	6	Sing
Kimże jest Fornalska , by umieszczać ją w Encyklopedii ?	Encyklopedii	8	Sing
Całą energię i myśli oddaję pracy .	energię	1	Sing
Adasia ogarnął niepokój .	niepokój	2	Sing
Skup wolnorynkowy zbóż zaczyna się w sierpniu .	Skup	0	Sing
Budowa jest w stanie surowym .	Budowa	0	Sing
Czasem cisnę spust , a ten diabeł uprze się i nie wystrzeli .	spust	2	Sing
Będzie kierował on towarzystwem do 2007 roku .	towarzystwem	3	Sing
Zgodnie z nim , dyrektorzy wojewódzkich kolumn złożą do końca lutego w Ministerstwie Zdrowia programy restrukturyzacji zakładów .	kolumn	6	Plur
Są bardzo niebezpieczne , ich wybuch spowodowałby falę uderzeniową o promieniu do jednego kilometra .	kilometra	13	Sing
Wiedźma odwróciła się ku niemu z mozołem , wkładając w ten drobny ruch wszystkie swoje siły .	Wiedźma	0	Sing
W kłamstwie czy w prawdzie , nie znam nic lepszego niż życie .	kłamstwie	1	Sing
Sesję zorganizował Zakład Słowianoznawstwa PAN .	Sesję	0	Sing
Nie wspomniał , że idzie o zatrudnienie w lokalu nocnym Turka .	lokalu	8	Sing
Ten kierownik to ma chyba fioła .	fioła	5	Sing
Tiry wyjechały z Warszawy tydzień temu .	Tiry	0	Plur
– Zawrzyj pokój z samą sobą .	pokój	2	Sing
Oprócz wiśni i czereśni zawierają go truskawki i winogrona oraz orzechy włoskie .	winogrona	8	Plur
Czy nie obawia się pani odpływu dewiz z banków krajowych ?	banków	8	Plur
Wiem , że w ich sercach bije tętno całej ludzkości .	sercach	5	Plur
Komisja przekształciła się w rodzaj seminarium , gdzie bibliotekarki pogłębiały swą wiedzę o dziecku i książce .	bibliotekarki	8	Plur
Agnieszka jest odurzona szczęściem .	szczęściem	3	Sing
Jest najwyższym mężczyzną w oddziałach Agencji Restrukturyzacji i Modernizacji Rolnictwa w Polsce .	mężczyzną	2	Sing
Wzbudza to niepokój inwestorów zagranicznych i krajowych , a także wyborców .	wyborców	10	Plur
Może masz wstrząśnienie mózgu ?	wstrząśnienie	2	Sing
Tym razem milicjanci interweniowali natychmiast .	milicjanci	2	Plur
W marzeniach sennych główną rolę grają symbole .	symbole	6	Plur
Truchtali spokojnie , bez pośpiechu , z przodu dostrzegli sylwetkę w zielonym mundurze , zbliżyli się powoli .	sylwetkę	9	Sing
Batura poczerwieniał z upokorzenia i gniewu .	upokorzenia	3	Sing
Rządy Leszka Millera dużo dały wielu ludziom .	Rządy	0	Plur
Tematem tegorocznego Forum była fotografia otworkowa .	Tematem	0	Sing
Ugryzienia osy , pszczoły , trzmiela i szerszenia mogą być niebezpieczne .	pszczoły	3	Sing
Dach przypomina fale morskie , które często zdobią japońskie drzeworyty .	drzeworyty	9	Plur
Na tej klepce bracia mocno się poślizgnęli .	bracia	3	Plur
Salony na parterze udostępniono publiczności i pełniły one rolę muzeum .	publiczności	4	Sing
Na diagramie Hertzsprunga - Russella olbrzymy znajdują się ponad ciągiem głównym .	ciągiem	9	Sing
Jeszcze gorzej przedstawia się sytuacja z pracą laboratoriów w przedsiębiorstwach budowlano - montażowych .	laboratoriów	7	Plur
Na szczęście voyagerom wyznaczono cele .	cele	4	Plur
Przykręca knot i dmucha w płomień lampy .	knot	1	Sing
Na dużym talerzu uformować kopczyk z kuskusu i posypać go ozdobnie cynamonem .	kuskusu	6	Sing
Ma osobowość gwiazdy .	osobowość	1	Sing
Mam przynieść wypełnioną deklarację członkowską oraz partyjną ankietę .	deklarację	3	Sing
Gdyby z takiego nierozsądnego myślenia wyrastało się jak z dziecięcych ubrań , nie było by większego problemu .	ubrań	10	Plur
Zna ich szczegóły .	szczegóły	2	Plur
Ilu prezesów pani przetrzymała ?	prezesów	1	Plur
Początek przedstawienia to bardzo delikatny moment wchodzenia w fikcję .	fikcję	8	Sing
Jak poinformował Cesar Fraga z Uniwersytetu w Buenos Aires , przeprowadzone tam badania wykazały , że czekolada wzmacnia antyutleniacze znajdujące się we krwi , zwiększając odporność na zaburzenia serca i naczyń wieńcowych .	naczyń	30	Plur
Pokazano jej lichą zagrodę , naprzeciw wiejskiego cmentarza .	cmentarza	7	Sing
Opiekun dzieciaków sądził , że w górach jest już wiosna .	górach	6	Plur
To utrudnia zakładanie rodziny .	zakładanie	2	Sing
W agencji zastał em piekło .	agencji	1	Sing
Zamknęła drzwi wejściowe i wróciła do salonu .	salonu	6	Sing
Częstuje herbatą i własnego wypieku ciasteczkami .	wypieku	4	Sing
Nad każdym , nawet najkrótszym tekstem medytuję .	tekstem	5	Sing
Symbolizują zmienną fortunę i uzasadniają nawoływania do stoickiego znoszenia dopustów losu albo chrześcijańskiej ufności w Bogu .	fortunę	2	Sing
Rodziny osób pochowanych na cmentarzu w York domagają się ich usunięcia .	Rodziny	0	Plur
Tym razem atrakcyjność potyczki podniesie fakt , że Hoop i Zepter reprezentują mocno zmienione oblicza .	potyczki	3	Sing
To jest taka miłość na odległość ?	odległość	5	Sing
- Namierzyli ciebie , odsłuchają treść rozmowy .	treść	5	Sing
Występuje stałe obniżanie się poziomów wód w rzekach i potokach .	obniżanie	2	Sing
Marta dyskretnie przyglądała się trójce młodych ludzi , którzy teraz opiekują się Polą .	trójce	4	Sing
Zjechali i zaczęła się sakramencka mordęga .	mordęga	5	Sing
W wakacje był em kilka razy u Wronka , jednak barykadę zobaczył em pierwszy raz .	barykadę	10	Sing
Cofnął się jak oparzony , gdy fala obmyła mu łapy .	fala	6	Sing
W Niemczech płaci sie rolnikom za nieuprawianie ziemi .	rolnikom	4	Plur
- Jakie znaczenie dla śledztwa ma odkrycie dokonane w archiwach w Łomży , o którym niedawno poinformowała prof . Daria Nałęcz ?	archiwach	9	Plur
Rany odniosła także jeszcze jedna bawiąca wówczas w lokalu ukraińska niewiasta .	niewiasta	10	Sing
Sylwetki mechaników wchłonęło po chwili czarne wnętrze hangaru .	wnętrze	6	Sing
Podopieczni trenera Mirko Jozica obecnie przebywają na zgrupowaniu w Austrii .	Podopieczni	0	Plur
- My tu o wzniosłych rzeczach mówimy .	rzeczach	5	Plur
Poza wymienionymi , charakterystycznymi rodzajami przebiegu akumulacji w ciągu roku stwierdza się ich modyfikacje lub rodzaje pośrednie .	rodzajami	4	Plur
- Zwolnili zakładników !	zakładników	2	Plur
Ojciec chciał , żeby m został inżynierem .	inżynierem	6	Sing
Ograniczenie szybkości obowiązuje tutaj od soboty z powodu rutynowych prac konserwatorskich .	soboty	5	Sing
Kwaśniewski znów okaże się sympatycznym facetem .	facetem	5	Sing
Szumiał wiatr w gołych gałęziach drzew .	gałęziach	4	Plur
20-letni żołnierz z jednej z kołobrzeskich jednostek wojskowych zastrzelił się na warcie w nocy z soboty na niedzielę .	żołnierz	1	Sing
W sidła oszustów - pośredników oferujących pracę Polacy wpadają także w Hiszpanii .	sidła	1	Plur
Tymczasem komandor zatrzaśnięty w samochodzie wydzwaniał z telefonu komórkowego do znajomych .	komandor	1	Sing
Sprawność podczas akcji i umiejętności ratowników oceniali sędziowie .	sędziowie	7	Plur
Mężczyźni zakomunikowali , że przychodzą z bardzo korzystną ofertą .	ofertą	8	Sing
Podkreśla , że duże znaczenie ma także klasa gleby .	gleby	8	Sing
Pozostaje do zidentyfikowania jeszcze 38 zwłok oraz 14 worków z ludzkimi szczątkami .	worków	8	Plur
Zmniejszył szanse elekcyjne Marka Borowskiego .	szanse	1	Plur
Za co lekarze domagają się tak wielkich sum ?	sum	7	Plur
Zwycięskie drużyny otrzymają nagrody pieniężne .	drużyny	1	Plur
Ze ścian mrugają kolorowe neony świąteczne w kształcie choinek , bombek i dzwonków .	neony	4	Plur
Są to rurki szklane cylindryczne o zwężonym końcu .	rurki	2	Plur
- Musimy zebrać ludzi , którzy chcą dokończyć rozpoczęte w 1981 roku dzieło .	dzieło	12	Sing
- A te szacunki były publikowane ?	szacunki	3	Plur
Ręce mu drżały , gdy podnosił szklankę .	Ręce	0	Plur
Małgorzata chodziła w letniej sukience na ciepłym wietrze .	sukience	4	Sing
Wiatrak też macha .	Wiatrak	0	Sing
Sznur tirów przecina niemal cały Wrocław , ma dziesięć kilometrów długości , stoi w nim kilkaset ciężarowek .	ciężarowek	16	Plur
Gotówkę niósł w neseserze .	Gotówkę	0	Sing
Poruszał rytmicznie kolanami , unosząc lekko siedzącą na nich kobietę .	kolanami	2	Plur
Oni myśleli , że byłam nówka i Miszka mnie rozdziewiczył .	nówka	5	Sing
Zostaną one przekazane do Archiwum Akt Nowych w Warszawie .	Akt	5	Plur
Wodzi oczyma po stojących postaciach .	postaciach	4	Plur
Jeszcze sprawdza zapięcia uprzęży i sprawność swego radia .	uprzęży	3	Sing
W takie wieczory milkły rozmowy .	wieczory	2	Plur
Niezwyciężony lęk przed dziwem w każdym momencie serca przychodniów przeszywał .	lęk	1	Sing
Obydwu sprowadź natychmiast do sztabu !	sztabu	4	Sing
Doświadczenia z dzieciństwa spędzonego w rodzinie alkoholowej u wielu mężczyzn i kobiet owocują w dorosłym życiu utrwalonymi schematami odczuwania , zachowania i myślenia .	Doświadczenia	0	Plur
Wczoraj , po zamknięciu lokali wyborczych , niemieckie media zapowiedziały , że pani minister ustąpi ze stanowiska .	zamknięciu	3	Sing
Równocześnie wznoszono nowoczesne dzielnice mieszkaniowe .	dzielnice	3	Plur
Jeszcze wczoraj Francja miała zarządzić blokadę kont Osamy bin Ladena oraz 26 innych osób i organizacji znajdujących się na amerykańskiej liście terrorystów .	terrorystów	21	Plur
Możesz więc odczuwać silne emocje .	emocje	4	Plur
Kapitana drużyny jeszcze nie ma .	Kapitana	0	Sing
Nerwy ludziom puszczają , często dochodzi do utarczek słownych .	utarczek	7	Plur
Postulaty protestujących zarząd miasta uznał za bezzasadne .	Postulaty	0	Plur
Swoją propozycję zgłosił też SLD .	propozycję	1	Sing
Jest to maszyna transportowa .	maszyna	2	Sing
Rozegrano dwa wyścigi .	wyścigi	2	Plur
Z ważnych powodów sąd może na żądanie poszkodowanego przyznać mu zamiast renty lub jej części odszkodowanie jednorazowe .	żądanie	6	Sing
Szefowie 13 central związkowych nie wykluczają , że wcześniej może dojść do innych form protestów .	central	2	Plur
Kłęby dymu z I piętra były coraz większe .	piętra	4	Sing
IV Zjazd Absolwentów Liceum Ogólnokształcącego odbył się w sobotę w Tucholi .	Absolwentów	2	Plur
Magister podreptał ukosem przez podwórzec , nikły , żałosny w swej czarnej sukni .	podwórzec	4	Sing
Użyto gazów łzawiących i ogłuszających granatów .	granatów	5	Plur
On się męczył , darł kartki , wyrzucał , wreszcie znalazł wersję , która wyrażała jego uczucia .	wersję	11	Sing
Teraz podwyżce nic już nie stało na przeszkodzie .	przeszkodzie	7	Sing
To była stara tradycja .	tradycja	3	Sing
Ludzie uważają , że do kłopotów z uzyskaniem zgody przyczynili się inwestorzy starający się o pozwolenie na budowę małego osiedla na działce sąsiadującej z ogródkami mieszkańców .	inwestorzy	11	Plur
To naturalna rzecz a nie promocja osobista .	promocja	5	Sing
Dzięki wysiłkowi lekarzy udało się uratować mu życie .	wysiłkowi	1	Sing
Na kontynencie afrykańskim dominują ssaki .	ssaki	4	Plur
Najpierw samodzielność uzyskał Zakład Naprawy Autobusów w Biskupicach , wcześniej stanowiący integralną część MPK .	Autobusów	5	Plur
– Czy można cię prosić do tańca ?	tańca	6	Sing
Zwykły mieszkaniec kraju ma się leczyć ziołami , które zaleca tradycyjna medycyna koreańska .	ziołami	6	Plur
Tymczasem miednice wypełnione podrobami przenoszono do kuchni .	miednice	1	Plur
Piłkarze krakowskiej Wisły sprawili wspaniały prezent wszystkim sympatykom futbolu w Polsce .	Piłkarze	0	Plur
Przy jego pomocy można obrazować wpływ poszczególnych czynników absencji .	czynników	7	Plur
Tym głównie Stronnictwo będzie się różniło od większości europejskich partii chadeckich , w których liberalizm gospodarczy miesza się z ideami socjaldemokratycznymi i nauką społeczną Kościoła .	nauką	22	Sing
– to była pani pierwsza praca ?	praca	5	Sing
Napięta żyłka świsnęła i pękła w przeponie .	żyłka	1	Sing
Pogoda psuła się .	Pogoda	0	Sing
Szmigielski działa też w komisji ogródków działkowych , komisji mieszkaniowej i radzie osiedla ; ma biuro w piwnicy .	ogródków	5	Plur
Ich głównym tematem był park i konie .	tematem	2	Sing
Dratewkę pani Joasia wyrwała z bestialskich łap pewnego szewca , którego niech piekło pochłonie .	piekło	12	Sing
Podręczniki powinny uwzględniać zasadę równych praw kobiet i mężczyzn .	zasadę	3	Sing
Kobiety mogą poruszać się poza domem wyłącznie w towarzystwie krewnego płci męskiej .	towarzystwie	8	Sing
Mieszkał em w domu polskich księży , niedaleko osobliwej piramidy , grobowca Cestiusza .	piramidy	9	Sing
Jeszcze przed obcięciem uposażeń , krakowscy rajcy planowali wydać taką właśnie sumę na remont trzech komisariatów oraz zakup 9 samochodów dla policji i 4 dla straży miejskiej .	sumę	11	Sing
Prawdopodobnie niesprawna instalacja elektryczna była przyczyną tragicznego pożaru w mieszkaniu przy ulicy Słupeckiej w Gdyni .	instalacja	2	Sing
W poniedziałek tamtejsze giełdy były zamknięte z powodu święta .	święta	8	Sing
Idę płakać nad moim losem .	losem	4	Sing
- Wielu z nich rzeczywiście nawiązuje do debaty w mediach , ale niech ich wiarygodność ocenia prokurator .	mediach	9	Plur
W niedzielę rano rozpoczęła się zapowiadana przez władze macedońskie ofensywa przeciwko albańskim separatystom działającym na północy kraju .	ofensywa	9	Sing
Ja nie mam takich uprawnień i nie uczestniczę w przesłuchaniach .	uprawnień	4	Plur
W dokumentach dowódcy szczycą się tym , że stłumili bunt bez użycia broni .	dokumentach	1	Plur
Dzięki filmowi album sprzedał się w milionowym nakładzie w Ameryce i w Niemczech , miał szanse na złoto także w Polsce .	złoto	17	Sing
Nie uważam , żeby na przykład Marksa szczególnie kompromitował romans ze służącą .	służącą	11	Sing
Doświadczenia laboratoryjne wykazały , że gąsienice motyli monarchów , karmione transgeniczną żywnością , miały kłopoty ze zdrowiem .	żywnością	11	Sing
Dzięki temu pracownicy bardzo szybko ustalili , kto może być odpowiedzialny za zdarzające się coraz częściej w firmie tajemnicze manka .	manka	19	Plur
- Ma dość ciemną skórę , ale chyba nie jest Murzynem ?	skórę	4	Sing
Wywiercili dziury w ścianie .	dziury	1	Plur
Poszukiwania przy użyciu śmigłowca trwały całą niedzielę .	użyciu	2	Sing
Tomasz Zombie wszedł w towarzystwie strażnika .	towarzystwie	4	Sing
W całej Europie myślistwo to hobby , za które się płaci !	myślistwo	3	Sing
W LIZBONIE zakończyła się 66 sesja Rady Europy na szczeblu ministrów spraw zagranicznych 21 państw kapitalistycznych naszego kontynentu .	sesja	5	Sing
- Witam mojego kochanego autora !	autora	4	Sing
Pestka nie przejęła się tym okrzykiem .	okrzykiem	5	Sing
Nadal będzie dodatnia temperatura , na wybrzeżu około 5 stopni .	wybrzeżu	6	Sing
Dochodzę do wniosku , że w Sejmie to nie są przedstawiciele narodu , a gromada głupców handlujących między sobą stanowiskami .	głupców	15	Plur
- Zbiórkę poprzedziła akcja informacyjna , uczniowie wiedzą , na jaki dobry cel popłyną pieniądze .	uczniowie	6	Plur
Homogeniczności ekspresji sprzyja izomorfizm faktury chóralnej .	izomorfizm	3	Sing
Przebrzmiała już wiadomość zaczęła powracać , jakby m cofał taśmę magnetofonową i wysłuchiwał fatalnego technicznie nagrania .	nagrania	15	Sing
Ofiarę udusili paskiem i dobili kamieniami .	paskiem	2	Sing
Zmumifikowaniu uległy tkanki miękkie .	tkanki	2	Plur
We wszystkich miastach i miasteczkach odbyły się wiece i uroczyste akademie .	akademie	10	Plur
- My tu o wzniosłych rzeczach mówimy .	rzeczach	5	Plur
- Jurdy zaraz tu będą .	Jurdy	1	Plur
Składa się na ń obecnie pięć pierwszych ksiąg Biblii .	ksiąg	7	Plur
Pomysł powstał podczas uzupełniania ksiąg parafialnych , które były skrupulatnie sprawdzane podczas duszpasterskich wizytacji .	uzupełniania	3	Sing
Czy to może być port lotniczy ?	port	4	Sing
Idiotka Zuzia zapomniała zrobić w banku blokadę i całą forsę zajęli na długi .	banku	5	Sing
Wzrasta popularność psychologii i psychiatrii .	psychiatrii	4	Sing
- Zdaje się , że oni zamierzają urządzić komedię sądową .	komedię	8	Sing
Na polach Domatowa i Polchowa usypano wysokie mogiły .	mogiły	7	Plur
Woziły im posiłki na wózkach .	wózkach	4	Plur
Zanim wiązanki kwiatów przykryły mogiłę , słowa modlitwy prowadzonej przez ks . Pawła Dorucha splatały się z wyrazami bólu i wspomnieniami przyjaciół .	wspomnieniami	20	Plur
Ubrani w białe koszule uczniowie ustawiają się na zbiórce w parku naprzeciwko gimnazjum .	gimnazjum	12	Sing
Pani Młoda wystąpiła w białej , włoskiej kreacji .	kreacji	7	Sing
Wysoka liczba urodzeń hamuje także rozwój gospodarczy kraju , w którym znaczny procent mieszkańców żyje poniżej uznanego progu ubóstwa .	progu	17	Sing
- Nikt się nie rozłazi , panie kapralu !	kapralu	7	Sing
Po długo obowiązującym zakazie , znowu do Japonii przybyli katoliccy misjonarze .	misjonarze	10	Plur
Ale kiedy wymagało by to przekroczenia granic prawa , Bill powstrzymał się z pomocą .	granic	6	Plur
Radni Malborka podjęli uchwałę w sprawie nowych stawek za wodę i odprowadzane ścieki .	stawek	7	Plur
Wydaje mi się , że na tym odcinku Krupówek wykonano kanalizację zbyt wąskimi rurami .	rurami	13	Plur
Dla tej ojczyzny nawet lepiej było , kiedy owi emigranci nie odwracali się za siebie , nie próbowali powrotu .	emigranci	9	Plur
Na nasz rozum z Polmosu najzwyczajniej wyprowadzono 2 mln euro .	euro	9	Plur
Podobno mamy zamiar budować tuńczykowce .	tuńczykowce	4	Plur
Do spraw o pobicia i gwałty doszedł pozew rozwodowy żony .	pobicia	3	Plur
Orzechy i migdały zemleć , wymieszać z cukrem oraz 3 łyżkami masła na gładką masę i połączyć z kuskusem .	łyżkami	10	Plur
Był człowiekiem o wielkiej kulturze osobistej .	kulturze	4	Sing
Bywa , że w ciągu godziny kawałek drewna zamienia się w rzeźbę , a innym razem potrzebuje kilku dni , by coś stworzyć .	drewna	7	Sing
Teraz wiedziała , że takie maski mają egipskie mumie .	maski	5	Plur
W siedzibie kłodzkiego starostwa powiatowego dowiaduję się , że Średzińskiego nie lubią tu , bo to postkomuch , a powiatem rządzi egzotyczna koalicja złożona z platformersów i byłych pisowców .	starostwa	3	Sing
Manifestanci próbowali uniemożliwić policji zamykanie biur zdelegalizowanego ugrupowania .	Manifestanci	0	Plur
- Każdy z liderów partyjnych musi rozliczać się wobec swojego zaplecza politycznego .	zaplecza	10	Sing
Samoobrona i PSL znalazły się poniżej progu wyborczego .	Samoobrona	0	Sing
Osadza się na odzieży oraz trwałych nieprzepuszczalnych powierzchniach takich jak beton czy asfalt .	powierzchniach	7	Plur
– żywotność jest większa . .	żywotność	1	Sing
Z konarów i pni wyczarowywał dziwne figury przywołujące na myśl słowiańskich bogów .	pni	3	Plur
Niosło wonią smoły i wodorostów , woda pluskała cicho o łódki przywiązane do omszałych pali .	pali	14	Plur
Udawał wesołość , aby dodać odwagi zatrwożonemu mizeractwu .	wesołość	1	Sing
Czuł em wonny zapach po uchyleniu wieka skrzynki .	skrzynki	7	Sing
Rzecznik Praw Obywatelskich wystąpił w obronie inwalidów wojennych i wojskowych , którym wprowadzono obowiązek płacenia za pobyt w sanatoriach uzdrowiskowych .	płacenia	14	Sing
Z rodziną bawili się w ciuciubabkę .	ciuciubabkę	5	Sing
Ochroniarz oddał do napastników kilka strzałów .	strzałów	5	Plur
Stowarzyszenie na Rzecz Praw i Wolności liczy ok . tysiąca członków .	tysiąca	9	Sing
Posiada ok. 150 ciekawych i zróżnicowanych egzemplarzy .	egzemplarzy	6	Plur
Trafił do Tary , ale zgodnie z umową nadal miano przyjeżdżać po jego krew .	umową	7	Sing
Krzysiek musiał wziąć kredyt z banku .	kredyt	3	Sing
Prawdopodobnie wkrótce straci immunitet .	immunitet	3	Sing
Nauczyciel szybko uporał się z zakupami i , nie powracając już do poprzedniego tematu , z widoczną ulgą pożegnał chałupniczkę .	zakupami	5	Plur
Lekarz krzywi się .	Lekarz	0	Sing
Przy kościele spoczywają powstańcy z 1831 i 1848 .	powstańcy	3	Plur
Z początkiem bieżącego roku Ministerstwo Oświaty i Wychowania podwyższyło uczniowskie stypendia .	początkiem	1	Sing
Siostrzyczki emanowały szlachetnością i pobożnością .	Siostrzyczki	0	Plur
Wiślana smuga wtopiła się w szarość horyzontu .	szarość	5	Sing
Dopiero po miesiącu mógł założyć specjalny procesor i uczyć się nowych dźwięków .	dźwięków	11	Plur
Nie było kandydatek ?	kandydatek	2	Plur
Z innych danych wynika , że z 37 masowców , które zatonęły w okresie od stycznia 1992 do marca 1996 , większość stanowiły statki tanich bander .	bander	25	Plur
Firma świętowała w ten sposób swoje 85-lecie .	85-lecie	6	Sing
Geje robią wokół siebie szum , żeby tylko się wypromować .	Geje	0	Plur
Internetowego pirata złapała łódzka policja .	pirata	1	Sing
Nie był nigdy na polowaniu , a całą sympatię rezerwował dla zwierzyny .	zwierzyny	11	Sing
Kontrast ten może nawet świadczyć o jakiejś obojętności czy martwocie religijnej panującej w czasach proroka .	Kontrast	0	Sing
Jak wygląda przepiórka ?	przepiórka	2	Sing
Nigdy nie mieszkał em w żadnym schronisku .	schronisku	6	Sing
Obecnie dzierżawi ponad 8 tys . km łączy cyfrowych .	łączy	7	Plur
Rzadko je to uszczęśliwia , często się buntują i wtedy cała rodzina ma problemy .	problemy	13	Plur
I tam wszędzie są kierownicy i zastępcy . . .	zastępcy	6	Plur
Jednocześnie sąd zdecydował o odebraniu mu pozostałych dwóch koni .	odebraniu	4	Sing
Dzieli wizja kierowania partią .	partią	3	Sing
Niby napisał Poskromienie złośnicy , ale co zrobić z Miarką za miarkę ?	Poskromienie	2	Sing
Mają zapewnić przychylność świata .	przychylność	2	Sing
Takie przygody nie będą przecież powodować bólu .	przygody	1	Plur
Pokój 240 naparł silnie na dziennikarzy i prawem fizyki wywalił ich z przepełnionego namiotu .	dziennikarzy	5	Plur
Haubica jest rodzajem działa artyleryjskiego o dużym kalibrze .	rodzajem	2	Sing
Wiatr zmienia kierunek , aby im towarzyszyć i chwytać ich słowa .	kierunek	2	Sing
Musimy wypracować nowy polityczny model społeczeństwa .	model	4	Sing
Chodziło o wyliczenie przyczyn bezrobocia na wsi .	bezrobocia	4	Sing
– Twoja twarz z profilu jest półksiężycem .	półksiężycem	6	Sing
Gospodarze odpowiedzieli dwoma golami Ralfa Hauptmanna i Austriaka Tony Polstera .	Gospodarze	0	Plur
Mam dwustronicowy artukuł , z którego muszę napisać recenzję .	recenzję	8	Sing
- To wypracowuje się na codziennych , mozolnych próbach .	próbach	8	Plur
Położył dłonie na jej ramionach .	ramionach	4	Plur
Miejmy nadzieję , że ich nowa redakcja zawierać będzie wnioski autorów omawianej publikacji .	redakcja	6	Sing
Płatki owsiane zalać wodą do napęcznienia .	Płatki	0	Plur
Kierowca , 29-letni Daniel Marciniak , odbiera telefon .	Kierowca	0	Sing
Czasem krzyżowały się statki .	statki	3	Plur
Dlaczego kobiety miały by nie podnosić ciężarów ?	ciężarów	6	Plur
Marta opuściła mury Kliniki przedwcześnie , na własną prośbę .	Kliniki	3	Sing
Współczesne trendy cywilizacyjne sprzyjają siłom zła , lecz dobro nie odpuszcza .	siłom	4	Plur
- Zdałem maturę , jestem studentem AWF w Katowicach . . .	maturę	2	Sing
- Czy to prawda , że ty , Manahemie , posiadasz miecz Hyrkana ?	miecz	11	Sing
Każdy okaz jest wielką ptasią indywidualnością .	indywidualnością	5	Sing
Przyjrzyj się fotografiom i rysunkom w podręczniku przedstawiającym przykład krajobrazu śródziemnomorskiego .	rysunkom	4	Plur
Zimą , przylatując na popas do Polski , zadowala się pozostałymi na krzakach jagodami .	krzakach	12	Plur
Dzielenie się władzą to zawsze prima aprilis .	Dzielenie	0	Sing
Rozdali kilofy i łomy .	kilofy	1	Plur
Nasze spółdzielnie produkcyjne powstały dzięki przykładowi kołchozów radzieckich .	spółdzielnie	1	Plur
Analogiczny obraz zróżnicowań społecznych ukazują dane o wieku menarchy dziewcząt .	dziewcząt	9	Plur
Jeden hotel musiał być oddany po wygaśnięciu dzierżawy , drugi sprzedano , aby pokryć dług w Funduszu Społecznym Żołnierza .	wygaśnięciu	6	Sing
Na razie nie wiadomo , kto miał by zastąpić aelowców .	aelowców	9	Plur
Do pierwsze kolizji doszło przy ulicy Kolejowej w Szydłowcu .	kolizji	2	Sing
Za chwilę w ciemnościach rozlega się łoskot zasuwającego się opornie betonu .	ciemnościach	3	Plur
Zmierzch stał się coraz ciemniejszy , na niebie ukazały się pierwsze gwiazdy .	gwiazdy	11	Plur
– gdzie jest pralka ?	pralka	3	Sing
- Czy w zaświatach dalej puszczasz się z żydowskimi demonami ?	zaświatach	3	Plur
Parlament Europejski w Strasburgu przegłosował niedawno całkowity zakaz reklamowania wyrobów tytoniowych .	Parlament	0	Sing
Śpią w noclegowni koło lokomotyw .	noclegowni	2	Sing
Wybuch poważnie uszkodził luksusowe auto , ucierpiały też cztery inne samochody stojące na placu .	placu	13	Sing
Rozmaite padliny wieszano na Sienkiewiczu , ale ja w jego obronie zawsze staję .	padliny	1	Plur
A potem będę składać apelację .	apelację	4	Sing
Zarzucał nas wiadomościami o długiej zimie .	wiadomościami	2	Plur
Analogiczny obraz zróżnicowań społecznych ukazują dane o wieku menarchy dziewcząt .	menarchy	8	Sing
Burmistrz Wiesław Śniecikowski gwarantuje , że w tym roku fajerwerki będą bardzo efektowne .	fajerwerki	9	Plur
Jakże mało zostało by na drogi , zieleń , tereny dla dzieci , sklepy .	sklepy	13	Plur
Drżeli i bledli , z ust oratorów dobywał się bełkot .	bełkot	9	Sing
Leczenie podtrzymujące za pomocą steroidów jest oczywiście gorszym rozwiązaniem niż leczenie polegające na usunięciu przyczyny .	usunięciu	13	Sing
Zgłoszenia przyjmowane są do 1 października 2007 roku .	Zgłoszenia	0	Plur
Na pozostałym oleju podsmażyć mięso z roztartym na miazgę czosnkiem .	oleju	2	Sing
Ich angielska interpretacja jest bardzo zróżnicowana .	interpretacja	2	Sing
Najpierw związał się z Kongresem Liberalno - Demokratycznym .	Kongresem	4	Sing
Czynił to tak niezręcznie , że pani Lichoniowa spostrzegła jego manewry .	manewry	10	Plur
Innej alternatywy nie ma , a wszelkie marzenia o samodzielnej roli quasi-mocarstwowej Polski są tylko rojeniami fantastów .	marzenia	7	Plur
Lekarze opatrzyli stłuczenia , zwichnięcia i złamania u 14 pacjentów .	złamania	6	Plur
Przyda ci się , idą przymrozki .	przymrozki	5	Plur
Mogła m sprawdzić dokładnie ten link przed napisaniem posta .	napisaniem	7	Sing
Jeśli w młodości nie przyzwyczaimy organizmu do tego życiodajnego płynu , organizm przestanie wytwarzać laktozę , enzym niezbędny do trawienia cukru mlecznego .	enzym	16	Sing
Shimada wyznaczył więc ludzi i za chwilę wnętrze góry poczęło błyskać upiornym światłem palników i ożywiło się znów koszmarną krzątaniną .	palników	13	Plur
Hill startował z pole position , ale już na pierwszych metrach wyprzedził go kolega z zespołu David Coulthard .	position	4	Sing
Żeby sie ten nasz obchód trzymał kupy .	kupy	6	Sing
Orkiestry murzyńskie grają ragtime'y , tłum cheerleaderek tworzy radosny , falujący szpaler .	szpaler	11	Sing
W święta głodowało już sześciu pracowników MZK , przedwczoraj dwóch z nich odmówiło przyjmowania płynów .	płynów	14	Plur
Czy wszystkie drabiny należą do drabów ?	drabiny	2	Plur
Wczoraj ciśnienie wynosiło ponad 1000 hektopaskali .	hektopaskali	5	Plur
Pierwsze i drugie miejsce zajęły słowackie dziewczęta , ubrane w getry i krótkie falbankowe spódniczki .	getry	10	Plur
Przepraszam , nawet po pouczeniu pana marszałka zacznę od kilku zdań wstępu .	wstępu	11	Sing
Arkadiusza J . pogrążyły też zeznania taksówkarza , który zabrał oskarżonych sprzed Stodoły .	taksówkarza	6	Sing
Dlaczego nie bywa z głowami sardynek ?	sardynek	5	Plur
Naczelnik ulicznych rzeźników wykrzywił twarz .	rzeźników	2	Plur
Pożeracz Chmur przełknął ostatni kęs i oblizał palce .	palce	7	Plur
Upragnioną miłość zanurzył eś w najpodlejszym , cuchnącym bagnie .	bagnie	8	Sing
Na dodatek pod koniec dekady zaczęło rosnąć bezrobocie , zwłaszcza wśród kobiet i młodzieży .	młodzieży	13	Sing
Leżał w jej stroju .	stroju	3	Sing
Martwiłem się także relacjami z rodziną .	relacjami	3	Plur
Rozpoczyna się teraz emocjonujący wyścig ze zbliżającą się burzą .	burzą	8	Sing
Spaceruję sobie wzrokiem po ścianach , suficie , meblach i przedmiotach .	meblach	8	Plur
Spódnica może być za krótka albo za długa . . .	Spódnica	0	Sing
Wiadomo tylko , że puram to w wiekszości języków indyjskich miasto lub osiedle .	puram	4	Sing
Spodziewa się Pan , że wyższy wzrost gospodarczy przyniesie wyższe dochody z podatków ?	podatków	12	Plur
Potem trzeba będzie zdobywać kolejne szczyty politycznych sukcesów .	szczyty	5	Plur
- Odważna staję się na scenie , pod wpływem muzyki .	wpływem	8	Sing
Porad rolnikom udziela w nim Janina Zielińska .	rolnikom	1	Plur
Przeszedł budynek stacyjny .	budynek	1	Sing
W 2000 r . na światowych giełdach nastąpił krach , a zawyżone kursy akcji spółek internetowych spadły na łeb .	łeb	18	Sing
Nad wszystkim czuwać będzie trzech lekarzy i personel pielęgniarski .	personel	7	Sing
Miał oczy przymknięte , blada twarz była bez wyrazu , jakby zabierał się do wysłuchania banalnej spowiedzi .	wysłuchania	14	Sing
Dla stolicy to chyba nieszczególna wizytówka .	wizytówka	5	Sing
Zgodnie z podjętymi na wtorkowym spotkaniu ustaleniami , targi eksporterów oraz wystawy turystyczne odbędą się w przyszłym roku .	targi	8	Plur
Ciała 7 turystów nie zostały jeszcze zidentyfikowane .	turystów	2	Plur
W bieżącym sezonie ma ogromną szansę przełamać tę barierę .	sezonie	2	Sing
- Według konstytucji wasz Wałęsa nie ma takich uprawnień jak prezydent Białorusi .	uprawnień	8	Plur
Na ul. Kolumny zginął wczoraj pod ciężarówką mężczyzna w średnim wieku .	ciężarówką	6	Sing
Ręce jej wyraźnie drżą .	Ręce	0	Plur
W tej kwestii konkurenci różnią się zdecydowanie .	kwestii	2	Sing
Może w styczniu zaproszę cię na chrzciny .	chrzciny	6	Plur
Z lodówki wyjęła niewielki dozownik wypełniony rubinową cieczą i bardzo ostrożnie wcisnęła go do otworu w pudełku .	dozownik	4	Sing
Nie mają oni atrakcyjnej oferty dla ludzi XXI wieku , więc boją się konkurencji katolicyzmu .	konkurencji	13	Sing
Trzeba ratować dobytek !	dobytek	2	Sing
Tylko mięczak sobie nie poradzi .	mięczak	1	Sing
Dla światowych producentów odzieży Polska staje się coraz ważniejszym rynkiem zbytu .	rynkiem	9	Sing
Podziela pan ten pogląd ?	pogląd	3	Sing
W państwach europejskich , takich jak Szwecja , które mają dużo imigrantów z tego regionu , zwyczaj zwalczany jest z całą surowością prawa .	regionu	14	Sing
Jej facet jest zmęczony pracą , pomidorówką oraz żoną .	pomidorówką	6	Sing
Górnicze związki zawodowe domagają się , wbrew stanowisku resortu gospodarki , wypłaty nagród z ubiegłorocznych zysków spółek węglowych .	związki	1	Plur
Dymkę oczyścić i pokroić na kawałki .	kawałki	5	Plur
Traktuje Beatę jak córkę , służy radą i wsparciem psychicznym .	wsparciem	8	Sing
Do niczego nie przyznała się podczas badań .	badań	6	Plur
Oprócz laureatów wzięli udział w tym spotkaniu liczni działacze naszej organizacji , redaktorzy naczelni , przedstawiciele szeregu wydawnictw .	laureatów	1	Plur
Przeciętne świadczenie emeryta , rencisty wzrośnie o 33 zł .	emeryta	2	Sing
Wszyscy trzej byli pisarzami .	pisarzami	3	Plur
Zaprojektowano specjalną okazałą szafę z 205 boksami .	boksami	6	Plur
Na ostatniej sesji Rady Gminy w Dobrej Szczecińskiej nadano nazw nowym ulicom .	ulicom	11	Plur
Żadna straż nie upora się z lepiankami .	lepiankami	6	Plur
- Wojna wzbudziła we mnie ogromny lęk .	lęk	6	Sing
Ten wszechstronny , nowoczesny obiekt jest wyposażony w profesjonalny sprzęt pożarniczy .	obiekt	4	Sing
Wykonanie całej inwestycji zlecono Przedsiębiorstwu Budowy Dróg i Mostów ze Świecia .	Wykonanie	0	Sing
Ponieważ skóra w tym miejscu wiotczeje najszybciej , zacznij używać kremu pod oczy , który działa trochę silniej .	kremu	10	Sing
– Robię to tylko z nudów .	nudów	5	Plur
Na tej podstawie otrzymają diety , od 1500 do 2000 złotych .	diety	4	Plur
Kiermasze te zapowiadały Wielki Tydzień , który charakteryzował się postem i wyrzeczeniami .	Kiermasze	0	Plur
Postanowienie może być wydane na posiedzeniu niejawnym .	posiedzeniu	5	Sing
Deszcze spowodowały znaczne zakłócenia w komunikacji kolejowej i lotniczej na południu kraju .	zakłócenia	3	Plur
Książę Andrzej Poniatowski , porucznik armii francuskiej , odwiedził Polskę w roku 1919 jako członek francuskiej misji wojskowej .	Książę	0	Sing
Brakuje również sportowego sukcesu , zgodnego z oczekiwaniami kibiców i sympatyków Klubu .	oczekiwaniami	7	Plur
Odrywa dłonie i powoli zaczyna schodzić na parter , kierując kroki do kuchni .	parter	7	Sing
Dymek w tym czasie ekspanderem przymocował otwartą klapę .	ekspanderem	4	Sing
Smażyli ryby złowione w strumieniu .	ryby	1	Plur
Często jednak dociekliwość pracowników straży powoduje , że za kratki trafiają groźni przestępcy .	dociekliwość	2	Sing
Spojrzał des Noyers na zegar gdański , stojący w rogu komnaty .	zegar	4	Sing
My katolicy chodzimy w niedzielę do kościołów .	katolicy	1	Plur
Wkrótce potem wszyscy stali się niewolnikami .	niewolnikami	5	Plur
W lesie zające występują raczej na pobrzeżach , w głąb idą tylko w silne mrozy .	zające	2	Plur
Analiza spektrometryczna wykazała , że jego skład izotopowy jest typowy dla procesów reaktorowych , a nie wybuchu jądrowego .	wybuchu	16	Sing
W fabryce robota posuwała się szybko .	fabryce	1	Sing
Dotychczas lokatorzy budynków , w których zainstalowane są gazomierze , płacili za gaz co dwa miesiące .	budynków	2	Plur
Dzieci były zachwycone prezentami od Michała .	prezentami	3	Plur
Kongresy Międzynarodówki poruszały zawsze ważne problemy , istotne dla życia politycznego i społecznego danego okresu .	Kongresy	0	Plur
Raptus , lubi być w centrum uwagi .	Raptus	0	Sing
Można wpisać kilka losów w jedno życie albo rozbić jedno życie w parę fabuł .	fabuł	13	Plur
Powstało z komitetów na rzecz referendum w sprawie karania za aborcję .	komitetów	2	Plur
Górnicy i hutnicy kują naszą potęgę .	hutnicy	2	Plur
Kłamią , skurwysyny .	skurwysyny	2	Plur
Przygryzając wargi z bezsilnej złości , Chmura wołał Adasia .	złości	4	Sing
To alibi , które wymyślili dla siebie kurwiarze !	alibi	1	Sing
Czułem jego mięśnie napięte pod skórą , twarde jak drewno .	mięśnie	2	Plur
W Typinie , małej wiosce pod Tomaszowem Lubelskim , wrze .	wiosce	4	Sing
Jeszcze w poniedziałek prosił o pomoc wojskową sąsiednie republiki kaukaskie i Rosję .	republiki	8	Plur
O zawilgoceniu gruntu i budynków informowali jedynie archeolodzy prowadzący wykopaliska na starówce .	zawilgoceniu	1	Sing
Górnictwo robi to na własne życzenie .	życzenie	5	Sing
Prace regulacyjne doprowadziły by do zniszczenia siedliska bobrów i do przepędzenia ich w nieznane .	Prace	0	Plur
Początek przedstawienia to bardzo delikatny moment wchodzenia w fikcję .	Początek	0	Sing
Jeśli to jest absolutnie niemożliwe , znaczy to , że twój charakter jest czymś pośrednim pomiędzy dwoma opisanymi w rozwiązaniu przy odpowiednich numerach .	numerach	22	Plur
Dla uczczenia tego zdarzenia przynoszę filiżanki .	filiżanki	5	Plur
Pod szczytnymi hasłami kryją się głównie ambicje polityczne i ogromna hipokryzja .	ambicje	6	Plur
Nikt poza bratem i ojcem nie wiedział .	bratem	2	Sing
Do tej pory zebrali około 50 sztuk .	sztuk	6	Plur
Temu sukcesowi w znacznej mierze przysłużył się również Szymon , który wywalczył 10 z 18 zdobytych przez Polaków punktów .	mierze	4	Sing
W ten sposób wzrasta częstotliwość sygnałów .	częstotliwość	4	Sing
Auto zostało całkowicie zniszczone , a kierowcę strażacy wydobyli za pomocą narzędzi hydraulicznych .	kierowcę	6	Sing
Oprócz absolwentów przybyli także dawni dyrektorzy i nauczyciele Nowodworka .	nauczyciele	7	Plur
A za drzwiami czekali bandyci .	bandyci	4	Plur
Wjeżdżamy między niechlujne zabudowania Płaszowa .	zabudowania	3	Plur
Śpią w noclegowni koło lokomotyw .	lokomotyw	4	Plur
Ale ciągle go gdzieś gnało , stawiał sobie nowe wyzwania .	wyzwania	9	Plur
Z innych danych wynika , że z 37 masowców , które zatonęły w okresie od stycznia 1992 do marca 1996 , większość stanowiły statki tanich bander .	statki	23	Plur
Jest to duże urządzenie , ale dzięki wprowadzonym ostatnio znacznym usprawnieniom łatwe jest jego obsługiwanie .	urządzenie	3	Sing
Po przewiezieniu do Jeleniej Góry prokurator postawił mu zarzuty żądania i przyjęcia korzyści majątkowych .	korzyści	12	Plur
Wysoka liczba urodzeń hamuje także rozwój gospodarczy kraju , w którym znaczny procent mieszkańców żyje poniżej uznanego progu ubóstwa .	procent	12	Sing
Na kartce należy wypisać plusy i minusy ?	kartce	1	Sing
Ludzie uważają , że do kłopotów z uzyskaniem zgody przyczynili się inwestorzy starający się o pozwolenie na budowę małego osiedla na działce sąsiadującej z ogródkami mieszkańców .	ogródkami	24	Plur
Chłopiec przebywa w greckim przytułku prowadzonym przez organizację o złej reputacji .	reputacji	10	Sing
Wśród poplenerowych prac królują grafiki i szkice .	szkice	6	Plur
W czasie obławy policjantom z Pieniężna udało się zatrzymać dwóch kłusowników .	policjantom	3	Plur
Chodzi o to , żeby demonstracje odbywały się w spokoju , żeby w minimalnym stopniu zakłócały życie innych ludzi i żeby nie było polską normą bicie policjantów , okupowanie budynków , wyrywanie znaków drogowych czy niszczenie samochodów .	znaków	32	Plur
I zrozumieli ludzie , że tu Bóg był , i zburzyli ten sądowy dom , aby w nim nikt już więcej po Panu Jezusie nie sądził , a przed jabłonnymi drzewami postawili krzyż i on do dziś tam stoi .	drzewami	30	Plur
Opodal trenowali skoki chłopcy na deskorolkach .	deskorolkach	5	Plur
Powoduje bowiem utratę białka ze skóry i krwi , podczas jej stosowania maleje masa serca i spada wskaźnik podstawowej przemiany materii .	wskaźnik	17	Sing
Czy już kiedyś były w siłowni ? . . .	siłowni	5	Sing
Nie składają donosów do prokuratury , nie przejmują się całodobowym uśmiercaniem poczętych ?	donosów	2	Plur
Patrzył na firankę , lecz tak roztargnionym wzrokiem , że nie zauważył , jak wydyma się od wiatru .	wiatru	17	Sing
- Czy grozi nam czarny scenariusz rozwoju sytuacji gospodarczej ?	rozwoju	6	Sing
Często jednak dociekliwość pracowników straży powoduje , że za kratki trafiają groźni przestępcy .	przestępcy	12	Plur
Przegląd najistotniejszych badań alokacji podatku dochodowego zamieszczono w następnym punkcie niniejszego rozdziału .	Przegląd	0	Sing
Baszmaczkina sam niegdyś postawił em w dzienniku obok kopisty Bartleby z noweli Melville'a .	dzienniku	6	Sing
Z innych danych wynika , że z 37 masowców , które zatonęły w okresie od stycznia 1992 do marca 1996 , większość stanowiły statki tanich bander .	masowców	8	Plur
I ma w dodatku zorganizowane oparcie w ZNP .	dodatku	3	Sing
Ideą konkursu jest propagowanie kultury polskiej na Wschodzie .	propagowanie	3	Sing
W Fundacji można też uzyskać wyczerpujące informacje na temat fachowej opieki nad kotami domowymi .	Fundacji	1	Sing
Bracia Kaczyńscy chcą w tej chwili albo koalicji na swoich warunkach , albo przyspieszonych wyborów .	Bracia	0	Plur
Barwy te składają się na addytywny model barw .	Barwy	0	Plur
Związany z kapistami , wielokrotnie jednak przekraczał wyznaczone przez nich malarskie granice .	kapistami	2	Plur
Ale cięższą przeprawę mieli ci dziennikarze , którzy szli do centrum prasowego , by stamtąd jechać dalej autokarami .	autokarami	17	Plur
Jeden z mężczyzn przystąpił do majstrowania przy kablach telefonicznych .	kablach	7	Plur
Kierowcy udało się wyskoczyć przed zderzeniem .	Kierowcy	0	Sing
Negocjuje z wojskowymi .	wojskowymi	2	Plur
Witam , Poszukuję jakiegoś opracowania na temat początków rozwoju przemysłu w Białymstoku .	opracowania	4	Sing
Dotychczas lokatorzy budynków , w których zainstalowane są gazomierze , płacili za gaz co dwa miesiące .	lokatorzy	1	Plur
Angelika przystąpi do komunii w kościele w Dytmarowie .	komunii	3	Sing
Faceci wyglądają na prawdziwych twardzieli .	twardzieli	4	Plur
Przesłuchanie odbędzie się w poniedziałek .	Przesłuchanie	0	Sing
Po jednemu wsiąkały w próżnię . . .	próżnię	4	Sing
Na kolację , oprócz gulaszu , był chleb i masło , a do masła dodano nóż .	gulaszu	4	Sing
Aktor mamrocze coś niewyraźnie pod nosem , ale ma mikrofon i widz go zrozumie .	widz	11	Sing
Zimą bywało , że nie jadła tygodniami .	Zimą	0	Sing
Pogańskie zwyczaje zapalania światełek przerodziły się we wspaniałe festyny światła w szaleńcze przedświąteczne dni .	festyny	8	Plur
Mogli by w nich uczestniczyć kandydaci Unii Wolności oraz Wałęsa i Olszewski , jeśli tylko zechcą i będą mieli poparcie 15 parlamentarzystów i 300 radnych .	parlamentarzystów	21	Plur
- Tonący i brzytwy się chwyta .	brzytwy	3	Sing
Czy mogę być normalny , skoro przez lata byłem aktorem w policyjnym pornosie ?	pornosie	12	Sing
Powoduje wysokie bezrobocie i sprawia , że państwo zadłuża się na bardzo wysoki procent .	procent	13	Sing
Wykorzystując przerwę w popołudniowych grach , Agassi i Graf zrobili sobie małą sesję treningową .	grach	4	Plur
Miał tylko dobre porywy .	porywy	3	Plur
Przecież , jak podają gazety , sieć kin objazdowych stale się powiększa .	kin	7	Plur
Dratewkę pani Joasia wyrwała z bestialskich łap pewnego szewca , którego niech piekło pochłonie .	szewca	8	Sing
Przypuśćmy , że stoi ono w związku z postępującą chorobą .	chorobą	9	Sing
Rozbili śmy na jezdni dwa świeże jaja .	jezdni	3	Sing
Od sierpnia strzelił Pan dla Borussii 12 goli .	goli	7	Plur
W Betlejem zupełnie utracili ducha dociekliwości , z punktu widzenia intelektualisty zachowali się nadzwyczaj pokornie .	intelektualisty	10	Sing
Na tę okoliczność policja nie badała przygodnego pasażera .	pasażera	7	Sing
Brzegi chodników były zastawione ławkami .	chodników	1	Plur
Z lodówki wyjęła niewielki dozownik wypełniony rubinową cieczą i bardzo ostrożnie wcisnęła go do otworu w pudełku .	lodówki	1	Sing
Bez ceregieli zostawiła go na korytarzu i odeszła z obojętną miną .	ceregieli	1	Plur
Kanibal znalazł urnę z prochami .	Kanibal	0	Sing
Wsparł się na łokciu i wyjrzał na polankę .	polankę	7	Sing
- Zbądź obawy , ojcze .	ojcze	4	Sing
Pracodawca musi też płacić wszelkie podatki i ubezpieczenia .	podatki	5	Plur
- Opublikował em te dokumenty z pełną świadomością .	świadomością	7	Sing
Komornicy wywlekli gadacza .	gadacza	2	Sing
" Obywatelu Bukowiński , proponujemy wam repatriację do Polskiej Republiki Ludowej " .	Obywatelu	1	Sing
Sanitariusz wyciągnął ze skrzyni dwa gumowe fartuchy .	Sanitariusz	0	Sing
Było przestronnie , panowała spokojna , sympatyczna atmosfera .	atmosfera	7	Sing
Nie skupia się na przedmiotach , raczej otacza się przedmiotami .	przedmiotach	4	Plur
- Chłopaki z lubelskiego zespołu hiphopowego noszą takie krawaty .	krawaty	8	Plur
Do dziennikarki Beaty Igielskiej zatelefonowała któregoś dnia krewna , bardzo zresztą daleka .	krewna	7	Sing
Ciemność odgrodziła ich od sąsiedztwa niepożądanych oczów .	oczów	6	Plur
Na odgłos kroków Stefan wyłącza radio .	odgłos	1	Sing
Taki stosunek nie może sprzyjać należytemu rozwojowi myśli twórczej wśród pracowników Stoczni , a tym samym przynosi straty państwu .	Stoczni	11	Sing
Polonii aura nie przeszkadzała w odniesieniu wysokiego zwycięstwa .	odniesieniu	5	Sing
Chodzi o inwestycje w dziesięciu gminach z rejonu Gór Świętokrzyskich .	gminach	5	Plur
Spotkał się ze stanowczą odmową .	odmową	4	Sing
W piątek i sobotę tylko w Chicago zmarło na skutek gorąca dalszych 26 osób .	gorąca	10	Sing
Odebrać bogactwa wszystkim bogaczom i uczynić je własnością powszechną .	bogactwa	1	Plur
- Zaskoczyli śmy szkopów i zwiewają !	szkopów	3	Plur
Tata musiał pojechać do domu .	Tata	0	Sing
Trwa dobra passa piłkarzy mieszkowickiego Mieszka .	passa	2	Sing
- Każdy hałas wywołuje lęk .	lęk	4	Sing
Kiedy wieczorem po raz kolejny przegryzał całą historię , oprócz żalu i rozczarowania odkrył w sobie także uczucie ulgi .	rozczarowania	12	Sing
To zwierzę wyróżnia się umiejętnością niesienia pomocy .	umiejętnością	4	Sing
Wśród podhalańskich Cyganów z bezwzględności słynie jego współpracownik , współoskarżony w Oświęcimiu , Stanisław Kamiński z Czarnej Góry .	współoskarżony	9	Sing
Może wolał przemilczeć tragedię .	tragedię	3	Sing
Jeśli odczuwasz zbyt silną potrzebę izolacji , samotności , nie pozwól na zamknięcie się w swoich myślach , obawach i wyobrażeniach .	obawach	18	Plur
Kolejne inwentaryzacje dowodzą , że na półkach biblioteki brakuje kolejnych tytułów .	tytułów	10	Plur
Policja przypuszcza , że najnowszy ładunek został porzucony przez spłoszonego niedoświadczonego terrorystę .	ładunek	5	Sing
A już na pewno z racji tej uczoności w 1456 roku dostał katedrę teologii , na której pozostał do końca dni swoich .	katedrę	12	Sing
Po wypiciu wódki i wina również inni schodzili na dół , bo widział em na schodach i pana Jaworka , i pana Napiórkowskiego .	wódki	2	Sing
Podpułkownik Krabel zarządził strzelanie na garnizonowej strzelnicy .	strzelnicy	6	Sing
Sprawą włamania do domu wokalistki Blue Cafe zajęli się policjanci z komisariatu przy ul . Ciesielskiej .	włamania	1	Sing
Ani złotówka nie trafia do stoczniowców .	stoczniowców	5	Plur
Nie wie nawet , kiedy jest sobota i kiedy wypadają żydowskie święta .	sobota	6	Sing
– Leżał na rękawicach ochronnych i też był popaprany ziemią .	ziemią	9	Sing
82 proc . respondentów CBOS uważa , że różnica zarobków w Polsce jest zbyt duża .	zarobków	9	Plur
Powstał rynek pracy dla przewodników , tropicieli i strażników .	strażników	8	Plur
A moja miesięczna pensja to czterysta peso , czyli dwadzieścia dolarów .	peso	6	Plur
" Przysyła ci świeżą partię " .	partię	4	Sing
Odpowiednie dane wynoszą 1410 i 820 mm .	mm	6	Plur
Całe starostwo spiskie od 1591 do 1745 roku należało do Lubomirskich .	starostwo	1	Sing
Według prognoz , Wisła będzie jeszcze przybierać .	prognoz	1	Plur
Na nizinach najczęściej można obserwować ten rodzaj opadów wiosną .	opadów	7	Plur
Nieprawidłowości wykrył prezes spółdzielni , zarządził właśnie kontrolę .	Nieprawidłowości	0	Plur
- To zwykła ludzka zazdrość .	zazdrość	4	Sing
Wieczorem przyjechała Grażyna Celińska z dziećmi i razem zjedli śmy kolację .	kolację	10	Sing
Sporządzając mi drinka , Pućka kończy wcześniej rozpoczętą kwestię .	drinka	2	Sing
Mój Boże , już sama nazwa łaskotała jej wyobraźnię .	wyobraźnię	8	Sing
Zarzucił mu Pan , że utrwala sejmokrację .	sejmokrację	6	Sing
Z urzędów i różnych instytucji ginie nawet papier toaletowy .	urzędów	1	Plur
Zaangażowano mnie w celu udowodnienia , że Mojka miał wspólników w Banku Prowincjonalnym .	wspólników	9	Plur
Myślę , że są to po prostu dobre kompozycje i świetne teksty .	kompozycje	8	Plur
Skóra wokół poczerwieniała , a w kącikach ust pojawił się grymas skrywanego bólu .	kącikach	6	Plur
Aspirant przerzucił kilka kartek w notesie .	kartek	3	Plur
Rano staje w kolejce do kasy .	kasy	5	Sing
Studiują tutaj Łukasz Kruczek , Grzegorz Śliwka , Krystian Długopolski , teraz obok mnie studentem został Tomek Pochwała .	studentem	14	Sing
Organizatorzy przygotowali także wiele imprez towarzyszących .	Organizatorzy	0	Plur
Korespondenci budapesztańskich gazet donoszą , że wielu miejscowych Węgrów wyjechało do krewnych na wieś albo uciekło na Węgry .	Korespondenci	0	Plur
Przewodnictwo , ruch lodu i przesiąkanie wody przemieszczają ciepło w obrębie lodowca .	lodowca	11	Sing
Cofnęło ich tylko dwa kilometry na południe .	kilometry	4	Plur
Sytuacja jest bardzo kłopotliwa " .	Sytuacja	0	Sing
Mikroświat wciąż kusił swymi tajemnicami .	Mikroświat	0	Sing
Szukał em raczej w komediach .	komediach	4	Plur
Po odparciu ataku i ujęciu 10 terrorystów zawrócono konwój do bazy w Al Kut .	terrorystów	6	Plur
Osadza się na odzieży oraz trwałych nieprzepuszczalnych powierzchniach takich jak beton czy asfalt .	beton	10	Sing
Kiedy dziecko nie wróciło do domu , rodzina samodzielnie rozpoczęła poszukiwania .	poszukiwania	10	Plur
Jemiołuszka na przykład w ciepłych porach roku jest amatorką much łapiącą w locie owady .	owady	13	Plur
I fiat palio weekend został zatrzymany .	fiat	1	Sing
Zresztą nawet bez Twego wyznania dalo się to odczuć .	wyznania	4	Sing
Przewodniczącym , po raz kolejny , wybrano Zbigniewa Wiktora , wykładowcę akademickiego z Wrocławia .	Przewodniczącym	0	Sing
Panie Prezesie , w ten sposób nie pomoże Pan ani Pana ugrupowaniu , ani działkowcom .	działkowcom	14	Plur
Poirytowani posłowie - projektodawcy sprawdzili te informacje .	projektodawcy	3	Plur
Wieczorem wymykają się z hoteliku , by spojrzeć na ulubioną maszynę i pocałować ją na dobranoc .	dobranoc	15	Sing
To jedyne logiczne wyjaśnienie , o ile tu można mówić tu o logice .	logice	12	Sing
Zapłaciła ponad 1300 dolarów , na szczęście za oceanem znalazła pracę .	oceanem	8	Sing
Przed tygodniem rzesze ostrzeszowian odprowadziły go na miejsce wiecznego spoczynku .	spoczynku	9	Sing
Tematyka prac twórcy z Jarantowic jest różnorodna i w poważnym stopniu zależy od zapotrzebowania , od zamówień odbiorców .	zamówień	16	Plur
Kręciło się tu kilku żołnierzy i dwóch sanitariuszy , nie było lekarza .	sanitariuszy	7	Plur
Czy jednak orzeczenie sądu położy kres plotkom . . . ?	plotkom	6	Plur
Pisarze są na ustach wszystkich .	ustach	3	Plur
Na klatce schodowej domu u zbiegu Alei Jerozolimskich i Nowego Światu skoczył z wysokości trzeciego piętra .	zbiegu	5	Sing
Rowerzysta zajechał jej drogę .	Rowerzysta	0	Sing
Administracja Lecha Wałęsy nie przewidziała w nim puli na nagradzanie wyróżniających się młodych Polaków .	Administracja	0	Sing
Zamek chętnie zwiedzają cudzoziemcy .	cudzoziemcy	3	Plur
Tomasz Gudzowaty poluje kamerą na lwy , gepardy , lamparty .	lamparty	9	Plur
- Obrzuciła go karcącym spojrzeniem .	spojrzeniem	4	Sing
Właśnie to zagęszczenie chyba spowodowało , że w krótkim czasie koszatniczki w Wiedniu wyginęły .	zagęszczenie	2	Sing
Dłużej żyjący Polacy będą oczywiście mieli wpływ na wiele procesów gospodarczych .	procesów	9	Plur
Wtedy też powiadomiono straż pożarną .	straż	3	Sing
I dostał prawą pięścią w zęby , tak , że ujrzał wielką jasność .	pięścią	3	Sing
Tymczasem miednice wypełnione podrobami przenoszono do kuchni .	podrobami	3	Plur
Wprost na podłodze rozpościerał się siennik , a na nim leżał człowiek .	siennik	5	Sing
- Czy polscy kierowcy zawodowi rzeczywiście są profesjonalistami ?	profesjonalistami	7	Plur
Bez pardonu wpychały rzeczy do kieszeni i toreb .	toreb	7	Plur
- Fokusy są ważnym elementem planowania kampanii reklamowych .	Fokusy	1	Plur
Nasze spółdzielnie produkcyjne powstały dzięki przykładowi kołchozów radzieckich .	kołchozów	6	Plur
Cały prawy błotnik wraz ze światłami został na haku .	haku	8	Sing
Rodzice ze wzruszeniem prezentowali dziennikarzom swoje maleństwa i dziękowali za pomoc .	Rodzice	0	Plur
Czy nastąpiła jakaś zmiana we włoskiej rzeczywistości , a może to ogólniejsza tendencja przemian w kulturze ?	przemian	13	Plur
Jego odejście od lewaków do religijnych ortodoksów spowodowało , rzecz jasna , szyderstwa i krytykę , ale wbrew powszechnym oczekiwaniom nie został odrzucony przez media .	ortodoksów	6	Plur
Zdaniem fachowców urządzenie spisywało się dobrze .	fachowców	1	Plur
To była elektryczna maszynka do golenia .	maszynka	3	Sing
Żyje dzięki komuś , kto rozumiał to hasło .	hasło	7	Sing
Zdjąć te cholerne obrazki po właścicielu .	właścicielu	5	Sing
Dzieło skradziono przedwczoraj z Biblioteki Polskiej Akademii Nauk w Krakowie .	Dzieło	0	Sing
Gospodarstwo Stanisławy Sowy , Irki Paulako i Moniki Niebrzydowskiej rozszerza się powoli poza obręb zabudowań gospodarskich .	Gospodarstwo	0	Sing
Według legend , w studni głębokiej na ponad 30 metrów znajdują się wejścia do lochów i tajnych chodników łączących posiadłości właścicieli zamku .	lochów	14	Plur
Stanowczo odradza się naśladowanie ich przez turystów , ponieważ dla człowieka wejście na leżący na zboczu płat śniegu kończy się tragicznie .	naśladowanie	3	Sing
W jego armii służyli teraz synowie śmiałków , którymi dowodził przed laty .	śmiałków	6	Plur
Mundurowi nie chcą zdradzać parametrów technicznych maszyn , by nie ułatwiać życia drogowym piratom .	parametrów	4	Plur
W tym roku inkasenci Zakładu Gazowniczego w Białymstoku będą wystawiać rachunki za gaz w blokach co trzy miesiące .	blokach	14	Plur
Z 13 do 27 zwiększa się w Łodzi liczba opiekunów , przeprowadzających dzieci idące na lekcje przez najruchliwsze jezdnie i skrzyżowania .	opiekunów	9	Plur
Rodzice kondorka trochę się pospieszyli .	kondorka	1	Sing
Robiły śmy kanapki , stroiły śmy półmiski .	półmiski	6	Plur
Wyszedł po chwili z tej balowej sali , ustawił nas w rzędzie , według instrumentów , skrzypce , altówka , klarnet , trąbka , puzon , perkusja i ja , saksofon .	perkusja	26	Sing
Motorówka odbija od burty , odchodzi łukiem .	burty	3	Sing
Z wykrzywioną z wysiłku twarzą leżał na plecach na ławce do wyciskania .	plecach	7	Plur
Fluor uszkadza nerki , zmniejsza odporność na infekcje i sprzyja rozwojowi alergii .	nerki	2	Plur
Gdy na miejscu zjawili się policjanci z komisariatu kolejowego policji , schronisko znajdowało się w opłakanym stanie .	komisariatu	7	Sing
Ich odrobienie przekraczało siły jednego pokolenia .	odrobienie	1	Sing
Po spełnieniu toastu świeżo upieczeni małżonkowie rzucają za siebie kieliszki .	małżonkowie	5	Plur
Jeśli weźmiemy pod uwagę sprawność i wydajność akumulatorów wanadowych , projekt wydaje się zupełnie realny .	sprawność	4	Sing
Dżabie odbiło się walerianą .	walerianą	3	Sing
W poniedziałek naczelnik Jerzy Żemełko był na urlopie .	urlopie	7	Sing
Świadek zeznawał by w procesach pozostałych członków gangu .	procesach	4	Plur
W 1989 roku Humphrey zaczął pracować w rezydencji premierów Wielkiej Brytanii w charakterze niezłomnego pogromcy myszy i szczurów .	szczurów	17	Plur
Stała oparta o balustradę i patrzyła na wodę .	balustradę	3	Sing
Przybywają dwa dodatkowe radiowozy .	radiowozy	3	Plur
Sejm tworzy prawa , a prokuratura ma ich pilnować .	prokuratura	5	Sing
Wziął em lodowaty prysznic , po śniadaniu wyłączył em telefony i w ciszy gabinetu nastawił em w pamięci taśmę mojego życia .	taśmę	18	Sing
Jego anegdoty traktowały o najrozmaitszych księżach dziwakach , których w okolicy nie brakło , a których przygody tchnęły często humorem z epoki Seweryna Soplicy czy nawet Paska .	humorem	19	Sing
Wybrali stertę gnojownika w zagrodzie ofiary .	stertę	1	Sing
Kamienny młot człowieka uderzał w furii we włochatą pierś zwierzęcą .	furii	5	Sing
Prezes OSP Stanisław Kocot wyjaśniał , że będą to nowoczesne , otwierane za pomocą pilota bramy , które znacznie ułatwią strażakom wyjazdy do akcji .	strażakom	20	Plur
Człowieka po prostu ogarnia przerażenie .	Człowieka	0	Sing
Kobieta , bez uprzedzenia , nie przyszła wczoraj do pracy , a w mieszkaniu świeciło się światło .	uprzedzenia	3	Sing
Przysiadł na oparciu fotela , objął mnie ramieniem .	oparciu	2	Sing
Mimo to może nie zobaczyć już syna , bo dziadkowie uprowadzili go na Ukrainę .	dziadkowie	9	Plur
Z bólem musiałem się wycofać z obietnic podwyżek .	podwyżek	7	Plur
W Betlejem zupełnie utracili ducha dociekliwości , z punktu widzenia intelektualisty zachowali się nadzwyczaj pokornie .	intelektualisty	10	Sing
Ażeby takim przykrym kolizyom zaradzić , puszczamy w świat ten oto podręcznik .	podręcznik	11	Sing
Dzisiaj jeszcze nie może , niestety , zaproponować kontraktu , ale następnym razem będę miał pełną jasność .	kontraktu	8	Sing
- Chłopaki z lubelskiego zespołu hiphopowego noszą takie krawaty .	zespołu	4	Sing
Gramoli się wolno poprzez gałęzie olch .	olch	5	Plur
Bilet kosztuje siedem złotych dwadzieścia groszy .	groszy	5	Plur
Kilkaset wagonów z ładunkami przychodzi codziennie na stację kolejową w Lublinie .	wagonów	1	Plur
Nieliczni cudzoziemcy otrzymali ulotki informacyjne , mapę Rzeszowa oraz gadżety .	cudzoziemcy	1	Plur
Sporządzono listę przedmiotów , które zrabowali z mieszkania brutalni przestępcy .	listę	1	Sing
Dopiero dzisiaj w trędowatej kaplicy rozdzielili się na kata i ofiarę .	kaplicy	4	Sing
- Sąsiedzi zaalarmowali mnie w środku nocy .	Sąsiedzi	1	Plur
Otworzyła szerzej drzwi wpuszczając wszystkich do środka .	środka	6	Sing
W pobliżu granicy Kosowa z Albanią zginęło w walkach z serbskimi żołnierzami co najmniej ośmiu albańskich separatystów .	separatystów	16	Plur
Była nietykalna , bo chroniła ją karta nauczyciela .	karta	6	Sing
I od tamtej pory czekam , żeby wskazal PAn róznice .	PAn	8	Sing
Wszystkim udało się wydostać na powierzchnię , mimo że woda dostała się już do wnętrza i otwarcie drzwi było bardzo trudne .	powierzchnię	5	Sing
Wymóg obywatelstwa i miejsca stałego zamieszkania to posunięcia antydemokratyczne .	posunięcia	7	Plur
Podróżnik podzielił się ze słuchaczami wrażeniami ze swego samotnego rejsu .	słuchaczami	4	Plur
Ponadto wykładano o spółdzielczości rolniczej i handlu rolniczym .	spółdzielczości	3	Sing
Jaką kwotę łącznie wypłacono ?	kwotę	1	Sing
A ona nie doczeka się pochwały i może popadać w kolejne frustracje .	frustracje	11	Plur
Wyciągnął Władysława przed bar i zaczął kłótnię .	kłótnię	6	Sing
- Wasza gazeta od dawna robi świetne przewodniki dla poszukujących pracy w Irlandii .	przewodniki	7	Plur
Szczerość przyjaciela wywołała burzę .	burzę	3	Sing
W następnym oknie będzie można samodzielnie skonfigurować menu bootmanagera .	menu	7	Sing
Ale dwa razy do roku kumulują się we mnie smutki , niezrealizowane sprawy i ogarnia mnie przygnębienie .	smutki	9	Plur
Wyrok nie zapadł , bo w trakcie procesu sąsiad zmarł .	sąsiad	8	Sing
W kolejnych rzędach stali niewidomi , część z psami - przewodnikami , a także niesłyszący i niemi .	niewidomi	4	Plur
Związkowcom udało się przedłużyć okres przejściowy dla nauczycieli mianowanych , którzy nie mają odpowiednich kwalifikacji .	nauczycieli	7	Plur
W bramie spotkał podporucznika Samczyca .	bramie	1	Sing
- Szczęka mi opada .	Szczęka	1	Sing
Polska i Izrael podpisały wczoraj umowę o zniesieniu obowiązku wizowego .	zniesieniu	7	Sing
Szwedzi , biedny naród , nie znają zapachu piekarni , świeżego , prawdziwego chlebka .	piekarni	8	Sing
Kiedy wdychasz powietrze , czuj to .	powietrze	2	Sing
Prezes PiS-u piątkowym wystąpieniem tę opinię potwierdził .	wystąpieniem	3	Sing
W tej sprawie jest wiele niewiadomych .	niewiadomych	5	Plur
W półfinałach rozegrano mecze systemem pucharowym , a zwycięzcy awansowali do finałów .	półfinałach	1	Plur
Także w ubiegłym roku zniszczono nagrobki na cmentarzach w Gdyni i Kielcach .	nagrobki	5	Plur
Kiedy wreszcie natrafił na schody i znalazł się na ulicy , kolegów przed pałacem już nie było ; najwidoczniej nie mogąc się go doczekać udali się bez niego na miasto .	pałacem	13	Sing
Może po przeczytaniu tego artykułu więcej kotów znajdzie swe domy ?	kotów	6	Plur
Jeszcze przed obcięciem uposażeń , krakowscy rajcy planowali wydać taką właśnie sumę na remont trzech komisariatów oraz zakup 9 samochodów dla policji i 4 dla straży miejskiej .	samochodów	19	Plur
A co ma być jej spoiwem i siłą napędową ?	spoiwem	5	Sing
Według Zofii Staśkiewicz z Dworu Artusa , artyści bardzo chętnie godzą się na koncerty w Toruniu .	Dworu	4	Sing
Cały teren splantowano , a niedługo zostanie wykonane nowe ogrodzenie .	teren	1	Sing
Wsadził ją do schowka pod schodami .	schodami	5	Plur
Wielokrotnie słuchałem komentarzy osób , które po raz pierwszy zetknęły się z tymi obrazami .	obrazami	13	Plur
Do tej pory zebrali około 50 sztuk .	sztuk	6	Plur
Przez następne stulecia przylgnęła do niej raczej sława rozpustnicy i zdrajczyni .	zdrajczyni	10	Sing
Widoczny jest wzrost aspiracji społeczeństwa , które chce zdobywać wykształcenie .	aspiracji	3	Plur
Jakie rodzaje mięsa zamraża się z przeznaczeniem na zaopatrzenie rynku detalicznego ?	mięsa	2	Sing
O ziemię zastukały ciężkie buty .	buty	4	Plur
Pani wójt ten plebiscyt wygrała .	plebiscyt	3	Sing
Rozpędzonej karuzeli stanowisk nie zatrzymała minister Piwnik , choć przez pierwsze pół roku urzędowania wstrzymywała się ona z ruchami kadrowymi .	urzędowania	13	Sing
Fotoreporterzy utrwalili polityka w pozie modlitwy lub zadumy nad grobem dziewczynki .	grobem	9	Sing
Skończyła makijaż i zaczęła przeglądać ciuchy .	ciuchy	5	Plur
– Nastawił płytę .	płytę	2	Sing
Ale ta idylla wspomnień będzie trwała krótko .	wspomnień	3	Plur
Niemiecka liga hokeja należy do jednej z najlepszych lig w Europie .	lig	8	Plur
Miał kochającą rodzinę , swoje pasje i marzenia .	marzenia	7	Plur
Po drodze nachyla się ku lampie stojącej na stole .	lampie	5	Sing
Jest to przydatne , gdy na jednej stronie umieszczamy kilka formularzy .	formularzy	10	Plur
Idea Rajskiego Cerbera bardzo mi się podoba .	Cerbera	2	Sing
Pistol poprawiał krawat , a Fanga wręczał kluczyki .	kluczyki	7	Plur
Częściej chodzi do fryzjera .	fryzjera	3	Sing
Po kilku godzinach wycofuje oskarżenia .	oskarżenia	4	Plur
A jednak w końcówce nie zabrakło emocji .	końcówce	3	Sing
Przyklęknął przy kupce .	kupce	2	Sing
Dżabie chrupnęło w kościach .	kościach	3	Plur
Weźmy na przykład pomnik w centrum wsi .	przykład	2	Sing
W pańskim wieku , na pańskim stanowisku torturować kobietę !	stanowisku	6	Sing
Komputerowy montaż grafiki nie jest domeną zastrzeżoną wyłącznie dla profesjonalistów .	montaż	1	Sing
Tam weterynarz przeprowadził sekcję , z której jasno wynika , że pies padł z powodu wysokiej temperatury .	temperatury	16	Sing
W tych miastach znaczne wpływy zdobyła sobie wiara protestancka .	miastach	2	Plur
Może ja piszę sonety prorocze ?	sonety	3	Plur
Ocean wtargnął w głąb lądu i nie odpłynął cały , tworząc jeziora rozmiaru mórz , bo głęboka płyta litosferycznego płaszcza Kwinty uległa zgnieceniu , a wody zapełniły powstałe na powierzchni depresje .	płyta	17	Sing
- W każdym państwie jesienią dochodzi do politycznego napięcia , ponieważ ustawa budżetowa zawsze wywołuje emocje .	państwie	3	Sing
Związkowcom udało się przedłużyć okres przejściowy dla nauczycieli mianowanych , którzy nie mają odpowiednich kwalifikacji .	Związkowcom	0	Plur
Ci faceci mogą ich zabrać .	faceci	1	Plur
Wściekłość pokrył pobłażliwym uśmiechem .	Wściekłość	0	Sing
- Blondynka popatrzyła na tancerzy , którzy przy bufecie głośno rozmawiali z właścicielem knajpy .	tancerzy	4	Plur
Poznał kosmetyczkę i przybory toaletowe .	kosmetyczkę	1	Sing
Jedno ucho kopnął niechcący w kąt .	kąt	5	Sing
Jego twórczość dotyczyła głównie drugiej wojny światowej .	twórczość	1	Sing
Kiedy wznosić toasty ?	toasty	2	Plur
W wielkim domu znajdziesz dwie malowane brody .	brody	6	Plur
Tropiłeś mnie bez ustanku , aż znalazłeś !	ustanku	3	Sing
Czy doszła do Pana moja Scena Zazdrości ?	Zazdrości	6	Sing
Zarodniki grzybów pleśniowych wywołują przede wszystkim zapalenie śluzówek nosa z niedrożnością , polipy nosa i zatok , ale też astmę o ciężkim przebiegu .	zatok	15	Plur
Kto jeszcze nie przysłał swojego scenariusza ?	scenariusza	5	Sing
Zimna woda tryskała na głowę , szyję i płonące uszy .	uszy	9	Plur
System ten nie działa skutecznie .	System	0	Sing
( Przepisuję z karty po włosku dla większej autentyczności ) .	autentyczności	8	Sing
Sobota również nie przyniosła rozstrzygnięć .	Sobota	0	Sing
Mniej zapłacimy za transakcje związane z nieruchomościami .	transakcje	3	Plur
Czasem starczyło wstać i wskazać palcem , inni natychmiast chwytali za drągi .	drągi	11	Plur
A tak nazywały się serwowane tam alkohole .	alkohole	6	Plur
Czy nasze indywidualne cele pokrywają się z celem grupy jako całości ?	cele	3	Plur
Napastnik skuł ofiarę kajdankami i zgwałcił .	kajdankami	3	Plur
Drzewa z wolna znikają .	Drzewa	0	Plur
Zdjęła materiał z palca i wsadziła do kieszeni kurtki .	materiał	1	Sing
Polityk przebywał tam krótko .	Polityk	0	Sing
Ptaki te chętnie korzystają z pokarmu wykładanego dla parkowych łabędzi .	łabędzi	9	Plur
Podczas pokazu zwiedzający mają możliwość zobaczenia wielu ras myszy .	ras	7	Plur
Niedawno urodziły mu się bliźniaki .	bliźniaki	4	Plur
Postulaty protestujących zarząd miasta uznał za bezzasadne .	Postulaty	0	Plur
Rozejrzała się wokół siebie , ale pokój był pusty .	pokój	6	Sing
W połowie maja laweciarze zorganizowali protest na przejściach granicznych .	przejściach	7	Plur
Jej reakcja nie zmieniła żądań nastolatek .	nastolatek	5	Plur
– Leżał na rękawicach ochronnych i też był popaprany ziemią .	rękawicach	3	Plur
Redukcja zatrudnienia obejmie przede wszystkim pracowników administracji i obsługi produkcji .	administracji	6	Sing
Wszechpolaków przybywa .	Wszechpolaków	0	Plur
Antyterroryści spuścili się po linach ze śmigłowca wprost pod drzwi gangstera .	gangstera	10	Sing
W niezwykłym spektaklu Partice'a Chfreau zabrakło głównej bohaterki .	bohaterki	7	Sing
Słuchacze poznają wiele elementów prawa , psychologii , socjologii , polityki społecznej , informatyki .	Słuchacze	0	Plur
Maturzyści - internauci zdający na pisemnym egzaminie język polski i historię najczęściej typują tematy związane z przełomem wieków .	Maturzyści	0	Plur
Jest cieślą , zna się na tym .	cieślą	1	Sing
Zdaniem dyrekcji nie można zlokalizować magazynów poza obszarem fabryki , gdyż zwiększyło by to koszty produkcji .	magazynów	5	Plur
Zaprojektowano specjalną okazałą szafę z 205 boksami .	szafę	3	Sing
Zacisnął em palce na szorstkim płótnie i wyczuł em obłe kształty pocisków .	kształty	10	Plur
Dla uczczenia tego zdarzenia przynoszę filiżanki .	uczczenia	1	Sing
Pomysłodawcą zmian w ordynacji samorządowej była Samoobrona .	Pomysłodawcą	0	Sing
Okna bloków zdawały się umarłe .	Okna	0	Plur
Specjalne brygady w maskach i odzieży ochronnej nadzorowały rzeź ptactwa i dezynfekcję bazarów , targowisk , sklepów i środków transportu .	bazarów	12	Plur
O zaliczeniu maszyny , urządzenia lub aparatu do odpowiedniej podgrupy decyduje jej przeznaczenie oraz konstrukcja i wyposażenie .	wyposażenie	16	Sing
Teraz wołają o kapitalizm , choć wcale go nie znają .	kapitalizm	3	Sing
Oprócz wiśni i czereśni zawierają go truskawki i winogrona oraz orzechy włoskie .	orzechy	10	Plur
Zdarzenie z kamykiem nie wychodziło mu z głowy .	Zdarzenie	0	Sing
Rodzina jej uważała , że urodzenie nieślubnego dziecka okryje ich hańbą .	urodzenie	5	Sing
Na szczęście , polichlorek winylu jest już stosowany na znacznie mniejszą skalę , a wyroby z niego są wyraźnie oznakowane .	polichlorek	3	Sing
Gdy myśleliście o swoim rodzicielstwie , obiecywaliście sobie nie popełnić ich błędów .	błędów	11	Plur
Tylko w czterech państwach w Europie pojawiły się sieci DCS .	państwach	3	Plur
Georges Mathieux w kostiumie szermierza dźga płótno pędzlem umieszczonym na szpadzie .	szermierza	4	Sing
Co lubią maturzyści ?	maturzyści	2	Plur
Nad Odrą stoi obrońca .	obrońca	3	Sing
i dotarli śmy do tkaniny i dzianiny .	dzianiny	6	Sing
Mnóstwo siedzib ludzkich staje pod wodą .	Mnóstwo	0	Sing
Chyba schodziły z niego te ostatnie kreski .	kreski	6	Plur
Prawdopodobnie wkrótce straci immunitet .	immunitet	3	Sing
Oddaję się niecnym praktykom .	praktykom	3	Plur
W krajach zazwyczaj triumfujących filmy o ciężkich chwilach są przypomnieniem czegoś , co zagrażało .	chwilach	7	Plur
Były to imiona , daty , incipit jakiejś antyfony .	antyfony	8	Sing
Odezwało się tyle osób o wielkich sercach !	sercach	6	Plur
Wszystko zależy od chwili , dnia , może nastroju .	nastroju	8	Sing
Miała tam miejsce próba zamachu na Ojca Świętego .	próba	3	Sing
W rozdrażnieniu Pierre chwycił go silnie zębami .	zębami	6	Plur
Stawiał sobie wielkie problemy i plon jego pracy był wielki .	problemy	3	Plur
Reformy ograniczono do totalnej prywatyzacji , która przyjęła raczej ramy wyprzedaży majątku narodowego .	ramy	9	Plur
Kilkuletnia inicjatywa organizowania zajęć w czasie ferii w Miejskim Ośrodku Kultury realizowana była także w tym roku .	ferii	6	Plur
Gdy Cahirowi czupryna nieco mocniej przyschnie do czerepu , powędrujemy ku Toussaint .	czupryna	2	Sing
Na skrzyżowaniach wyrastają rośli policjanci , gazeciarze wciskają przechodniom papierowe płachty i przekrzykują się nowościami z wczorajszego dnia i nocy , która właśnie minęła .	skrzyżowaniach	1	Plur
Znów się zawahała , ale nie miała przecież nic do ukrycia .	ukrycia	10	Sing
Przyklękli pobożnie i weszli na stopnie ołtarza .	stopnie	5	Plur
A odkąd Kaziński wydał wojnę właścicielom psów , jest jeszcze trudniej .	właścicielom	5	Plur
Czy gdzieś było gniazdko elektryczne ?	gniazdko	3	Sing
O wrocławskim spotkaniu prezydentów Kwaśniewskiego i Chiraca oraz kanclerza Schrödera informowały wszystkie media .	prezydentów	3	Plur
Dostojny gość zwiedzi ponadto stolicę , Kraków oraz Gdańsk .	stolicę	4	Sing
Lokalne władze AWS wykluczyły prezydenta ze swoich szeregów .	szeregów	7	Plur
W innych spotkaniach towarzyskich uzyskano następujące wyniki .	spotkaniach	2	Plur
Zeznania te potwierdzili pozostali członkowie załogi karetki .	Zeznania	0	Plur
Później łupy pojawiały się na krakowskiej giełdzie elektronicznej .	łupy	1	Plur
Pomagają okłady z rumianku .	okłady	1	Plur
Budapeszteńska giełda ma i inne poważne problemy .	problemy	6	Plur
Znajomość karate pomińmy . . .	Znajomość	0	Sing
Kierowcy pozostałych samochodów mieli liczne otarcia naskórka , które lekarz pogotowia opatrzył na miejscu .	Kierowcy	0	Plur
– bo oni na wieś dzwonią . .	wieś	4	Sing
Taka forma publikacji wynikała po części z objętości publikowanego materiału , ale trzeba przyznać , że kierowaliśmy się przede wszystkim wygodą użytkowania .	publikacji	2	Sing
To jest raczej cytat . . . . . . .	cytat	3	Sing
Na ścianach wisiały pamiątkowe fotografie i adresy gratulacyjne .	ścianach	1	Plur
– a co tam kombinujesz z tym rondelkiem ?	rondelkiem	7	Sing
Rozszerzone źrenice skierował na moją twarz , ale pod nimi była pustka .	źrenice	1	Plur
Więc boję się ulotności snów .	snów	4	Plur
- W iluż miastach w okresie letnim odbywa się tyle bezpłatnych występów artystycznych .	występów	11	Plur
Dyrektor wymienia imprezy , które zorganizował .	imprezy	2	Plur
Owoc dojrzały nie wyda nasion , kiść uschnie .	nasion	4	Plur
Obstawimy łoże tabliczkami . . .	tabliczkami	2	Plur
Skupieni operatorzy delikatnie manipulowali skomplikowanymi urządzeniami odbioru przekazywanej informacji .	urządzeniami	5	Plur
Partyjni stratedzy planują więc przedsięwzięcia z myślą o wyborach dalszych , tych pojutrze .	stratedzy	1	Plur
Adamiec zatrzymał się i próbował zabrać od góralki swoją walizkę , ale stara nie chciała mu oddać .	góralki	7	Sing
Wprowadzenie dyszy i nadmuchu gazu zmienia kształt plazmy i podnosi maksymalną temperaturę .	nadmuchu	3	Sing
Ale na ryby nie jest dobry .	ryby	2	Plur
Psychiatra przysuwa krzesło do leżanki i siada obok Bartodzieja z notesem w ręku .	notesem	10	Sing
Oczywiście , przecież nie stawiamy przecinków w zdaniu pojedynczym .	przecinków	5	Plur
- Jeżeli ćwiczący źle dobiorą rakiety , piloci nie zniszczą przeciwnika .	piloci	7	Plur
– Zidentyfikował z uśmiechem suknię , kupioną w salonie Coco Chanel .	suknię	4	Sing
Sędzia Rymarz przyznał , że telewizja miała prawo zatrzymać kasety Bubla .	Sędzia	0	Sing
Mankamentem był jedynie brak krzeseł .	krzeseł	4	Plur
Był czasem sporów i namiętności .	sporów	2	Plur
W 1993 roku , jeżeli zostanie utrzymana dyscyplina finansowa , prognoza CUP może okazać się realna .	dyscyplina	7	Sing
- Franciszek spojrzał z politowaniem na obie .	politowaniem	4	Sing
Na kostce drżało całe ciało zawodników .	kostce	1	Sing
Uczniowie klas młodszych sprzątali las w oddziale 184 pod kierunkiem stażysty , Przemysława Mazgaj .	stażysty	10	Sing
Leki na obniżenie temperatury nie działały , a sytuacja , według słów Havlovej , w nocy z poniedziałku na wtorek stała się krytyczna .	Leki	0	Plur
- Dotarliśmy do mapek , na których na miejscu naszych domów jest biała plama !	mapek	3	Plur
Konkurentów mu nie brakuje .	Konkurentów	0	Plur
Warto zwrócić uwagę na to , by worek do śpiwora był ściągany na co najmniej dwóch wysokościach .	śpiwora	9	Sing
Zakup tego urządzenia pozwoli wykonywać podstawowe analizy na miejscu w Brzeziu , bez konieczności wyjazdu chorego do Gminnego Ośrodka w Kłaju .	analizy	6	Plur
- Ale ginu pan się napije ?	ginu	2	Sing
Ekonomiści dodają , że motorem owego progresu jest , mimo wysokiego kursu złotego , eksport .	progresu	6	Sing
Cieszy fakt , że Royal Canin tak bardzo dba o koty i chce dzielić się swą wiedzą i doświadczeniem z ich miłośnikami .	wiedzą	16	Sing
- Liczne przykłady coraz bardziej wyrafinowanych działań terrorystycznych na świecie uświadamiają społeczeństwu potrzebę ochrony przed tego typu zagrożeniami .	potrzebę	12	Sing
Podczas ceremonii otwarcia Spływu organizatorzy przyznali liczne odznaczenia zasłużonym kajakarzom .	odznaczenia	7	Plur
Położenie geopolityczne i ropa sprawiają , że tu krzyżują się interesy wielu państw , w tym Rosji , USA i Turcji .	Położenie	0	Sing
W wyniku nieadiabatycznego ochładzania najniższych warstw troposfery powstają , ogólnie biorąc , najniższe chmury warstwowe .	warstw	5	Plur
- Dotarliśmy do mapek , na których na miejscu naszych domów jest biała plama !	plama	13	Sing
Godzinami , chmurni , łazili po mieście , ciągała go po galeriach , muzeach , teatrach .	muzeach	13	Plur
Sporo osób po moim kierunku pracowało później w bankach , ministerstwach , również w sejmie .	ministerstwach	10	Plur
Dziwnie było iść białymi korytarzami , nie wiedząc , dokąd prowadzą .	korytarzami	4	Plur
Wynajmujemy pokój prywatny w biurze obsługi turystów .	pokój	1	Sing
Ostatnią decyzją Adamsa , podjętą przed opuszczeniem Białego Domu , było podpisanie nominacji dla Johna Marshalla na prezesa Sądu Najwyższego .	Sądu	18	Sing
Tempo zajęć programowych wzrasta .	Tempo	0	Sing
Orzeczenie separacji nie oznacza , że w przyszłości nie można wystąpić o rozwód .	Orzeczenie	0	Sing
Wiece i akademie odbyły się również w Sofii , Damaszku , Kabulu , Surabai i innych miastach .	akademie	2	Plur
Dach przypomina fale morskie , które często zdobią japońskie drzeworyty .	fale	2	Plur
Po końcowym gwizdku arbitra w ekipie gości zapanowała zrozumiała euforia .	arbitra	3	Sing
Położenie geopolityczne i ropa sprawiają , że tu krzyżują się interesy wielu państw , w tym Rosji , USA i Turcji .	ropa	3	Sing
Za dobrze opowiada bajki .	bajki	3	Plur
Odpowiedział em grymasem .	grymasem	2	Sing
Wyprodukowaliśmy 21.255.035 m tkanin .	tkanin	3	Plur
Nowy gadżet wymaga od właściciela kwiatków , czekoladek , randek w barach karaoke i miłosnych liścików .	barach	11	Plur
– Korepetycje jej dajesz ?	Korepetycje	1	Plur
Pan konsul obiecał , że poruszy natychmiast tę sprawę z attaché wojskowym , generałem brygady .	attaché	10	Sing
Myślała m , że w polskim zakładzie pracy przykazania amerykańskich psychologów budzą tylko uśmiech .	psychologów	10	Plur
Trwają przygotowania do likwidacji Zakładu Naprawy Tramwajów w zajezdni przy ul . Gajowej .	likwidacji	3	Sing
Towarzystwo Naukowe KUL pełni w Polsce rolę zbliżoną do Katolickiej Akademii Nauk .	Towarzystwo	0	Sing
Poznaliśmy też nowych drugoligowców .	drugoligowców	3	Plur
Rozrywka jest kołem zamachowym telefonii komórkowej , a MMS bardzo ją uatrakcyjnią .	Rozrywka	0	Sing
Poza wymienionymi , charakterystycznymi rodzajami przebiegu akumulacji w ciągu roku stwierdza się ich modyfikacje lub rodzaje pośrednie .	rodzaje	15	Plur
Jego hobby to książki , podróże , grafika komputerowa .	podróże	5	Plur
Z ich opinią liczono się nie tylko w redakcji , ale również w środowiskach literackich i teatralnych .	środowiskach	13	Plur
Za to w wyniku referendum mogą stracić fotele .	fotele	7	Plur
Cela była wesoła , to byli komuniści przyzwyczajeni do defensywy .	defensywy	9	Sing
Dziecko krzywdzone potrzebuje wszechstronnej pomocy .	Dziecko	0	Sing
Petronakt nie zgodził się z umorzeniem i złożył na nie zażalenie .	umorzeniem	5	Sing
Romantycznym bohaterom odpowiada szatańska wersja pieśni .	bohaterom	1	Plur
- Mieszczanie złożyli okup .	Mieszczanie	1	Plur
Obowiązują wizy , odprawa paszportowa , a przy wyjeździe celnik gruntownie przeszukuje rzeczy w poszukiwaniu skarbów , których tak wiele stąd ukradziono .	wizy	1	Plur
Zeznania te potwierdzili pozostali członkowie załogi karetki .	Zeznania	0	Plur
Jednocześnie zmienia się jego skład chemiczny i ubytek ciężaru właściwego .	ubytek	7	Sing
Za linią lasu błysnęła w słońcu blacha na wieży kościoła .	linią	1	Sing
Ciałem szarpią suche torsje .	Ciałem	0	Sing
Tutaj wyraźnie widać wrażliwe , skłonne do ufności i entuzjazmu oblicze eseisty .	eseisty	11	Sing
Całowała go drobnymi , szybkimi pocałunkami .	pocałunkami	5	Plur
Zrobienie takiego wzoru zajmie kilka godzin .	wzoru	2	Sing
Radny Eugeniusz Morta chciał przed głosowaniem usłyszeć silne argumenty za wydaniem tak dużej kwoty .	głosowaniem	5	Sing
Wyschły źródła .	źródła	1	Plur
Rezolucja wypowiada się przeciwko istnieniu narodowych sił nuklearnych , ale nie przeciwko samej broni nuklearnej .	Rezolucja	0	Sing
Posłowie sekretarze zajęli miejsca .	sekretarze	1	Plur
Rekord należy do Wojciecha Zabłockiego , który uczestniczył we wszystkich turniejach .	turniejach	10	Plur
Robi takie miny za ich plecami , że cała sala ma teatr .	miny	2	Plur
Ten okres minnesangu zakończył się w ostatniej dekadzie XII wieku , gdy naśladownictwa ustąpiły nowym tematom i formom wypracowanym przez miejscowych poetów .	minnesangu	2	Sing
Nadejdzie wówczas czas rozliczeń . . .	rozliczeń	3	Plur
20 osób ewakuowano w nocy z czwartku na piątek z domu przy ul. Wawrzyniaka .	czwartku	6	Sing
Dolną część garderoby osłaniamy papierowymi ręcznikami , aby nie pobrudzić jej później jajkami .	ręcznikami	5	Plur
Rzecznik Białego Domu odmówił jednak ich podania , informując tylko , że dowody zostaną przekazane inspektorom ONZ w Iraku .	Domu	2	Sing
Na skrzyżowaniach wyrastają rośli policjanci , gazeciarze wciskają przechodniom papierowe płachty i przekrzykują się nowościami z wczorajszego dnia i nocy , która właśnie minęła .	płachty	10	Plur
Nad pozostałymi obszarami dominują układy wyżowe .	obszarami	2	Plur
W pewnym momencie neoprezbiter klęka twarzą do wiernych , wyciąga ku nim ręce i prosi o modlitwę .	wiernych	7	Plur
Otwiera to pole dla różnych szalbierzy .	szalbierzy	5	Plur
Dodany został nowy § 3 .	§	3	Sing
– Dziennikarze wmówili sądowi i ludziom , że Róża musi wrócić do biologicznych rodziców .	Dziennikarze	1	Plur
Uczy się wykorzystania odpowiednich narzędzi .	narzędzi	4	Plur
- Zrobiono mi tym wielkie świństwo , bo po waszym artykule ludzie się ze mnie śmieją .	świństwo	5	Sing
Bo koledzy starsi o rok , dwa mogli stracić dziewictwo jeszcze w komunizmie .	dziewictwo	9	Sing
Zgromadzili się gapie .	gapie	2	Plur
Na szczęście pościel , którą na nich położono , była miękka i ciepła .	pościel	2	Sing
Jej reakcja nie zmieniła żądań nastolatek .	żądań	4	Plur
W Egipcie sporo jest Polaków ; handlowców , inżynierów .	handlowców	6	Plur
Pięcioletnia dziewczynka , porwana wczoraj przez 65-letniego mężczyznę w Chorzowie na Śląsku , odzyskała wieczorem przytomność .	dziewczynka	1	Sing
Dzisiejsza konfrontacja z łódzkimi zespołami , które mają pierwszoligowe aspiracje , zapowiada się niezwykle ciekawie .	zespołami	4	Plur
W oknach domku pojawiły się długie lufy erkaemów i pepeszek .	lufy	6	Plur
Sylwetka Golfa w porównaniu z agresywnymi liniami Focusa wygląda spokojnie , ale jego bryła może być uznana za ponadczasową .	liniami	6	Plur
Postęp techniczny dosięgnął także brytyjskich amatorów herbaty .	herbaty	6	Sing
Pierwszy numer wyjdzie przed świętami .	świętami	4	Plur
Były drugi trener lubelskich szczypiornistek nie zdołał poprowadzić jeleniogórzanek do sukcesu .	szczypiornistek	4	Plur
Tutaj jedynie pokrótce opiszemy ten standard i nieco uzupełnimy zaprezentowane w wymienionych artykułach informacje .	standard	5	Sing
Zwierzę polubiło piwko i bez kufla nie daje się wydoić .	kufla	5	Sing
Twoi Duchowni twierdzą , że siedzibą Szatana są nasze podbrzusza .	siedzibą	5	Sing
Sesja była jawna .	Sesja	0	Sing
Cały prawy błotnik wraz ze światłami został na haku .	światłami	5	Plur
- A skąd bierze adresy tych pań ?	adresy	4	Plur
W jego moskiewskim salonie bywała śmietanka przedrewolucyjnej Rosji .	śmietanka	5	Sing
Tenisiści stołowi Energetyka Opoki Trzebinia znają już terminy spotkań barażowych o I ligę , w których ich rywalem będzie zwycięzca II ligi łódzko - świętokrzyskiej Start Brzezina .	terminy	7	Plur
– Przyzwyczaił em się do jeżdżenia tramwajem .	tramwajem	6	Sing
Miliony ludzi straciło oszczędności całego życia .	oszczędności	3	Plur
Cukier puder podać w osobnym naczyniu .	naczyniu	5	Sing
Mogła sobie w nim utłuc rokokowym samojebem dziecko z krwi , spermy i chromosomów śliny .	śliny	14	Sing
Także w ubiegłym roku zniszczono nagrobki na cmentarzach w Gdyni i Kielcach .	cmentarzach	7	Plur
Płeć piękna zwycięża !	Płeć	0	Sing
Widać też wpływy malarstwa starogreckiego i bizantyjskiego .	wpływy	2	Plur
Poinformował w nim , że około godz . 19 . 30 w poniedziałek wartownik wojskowy zauważył zerwane plomby i kłódki do garnizonowego składu amunicji .	składu	22	Sing
Razem spędzili święta .	święta	2	Plur
Na pewno marzł w zimie .	zimie	4	Sing
W naszym przedziale walały się nawet dwa piękne wolne miejsca siedzące .	przedziale	2	Sing
– Osoba mojego kontrkandydata z racji jego pracy zawodowej była na pewno bardziej znana w gminie .	kontrkandydata	3	Sing
RADA BEZPIECZEŃSTWA omawia skargę Zambii z powodu powtarzających się aktów agresji ze strony rasistowskiej RPA .	aktów	9	Plur
Sześć skarg pacjentów bada prokuratura .	skarg	1	Plur
A teraz , przez tę ciążę , jesteśmy uziemieni .	ciążę	5	Sing
Pod szczytnymi hasłami kryją się głównie ambicje polityczne i ogromna hipokryzja .	hasłami	2	Plur
Zajęcia teatralne i plastyczne , konkursy , zabawy , filmy i wycieczki przyciągnęły nowych uczestników .	konkursy	5	Plur
W dyskusji zgłoszono wniosek o odrzucenie projektu uchwały w sprawie założeń polityki pieniężnej na 1995 r .	założeń	10	Plur
Nie skupia się na przedmiotach , raczej otacza się przedmiotami .	przedmiotach	4	Plur
Przychodzimy , aby szczątek ostatni od zagłady uchronić .	szczątek	3	Sing
Zakończyły się ligowe rozgrywki drużynowych mistrzostw Polski w zapasach .	zapasach	8	Plur
Przy końcu alei stał świeżo wkopany słup , pomalowany na jasnoniebieski kolor .	słup	6	Sing
Stanisław Mróz prawie nigdy nie rozstawał się z dudami .	dudami	8	Plur
Ksiądz Korniłowicz odmawiał brewiarz , chodząc tutaj po ścieżkach .	ścieżkach	8	Plur
Jednak do dziś ta sugestia pozostaje wysoce spekulatywna .	sugestia	4	Sing
Odtąd w naszych zabawach już zawsze ja była m Siwym .	zabawach	3	Plur
Wszystko rozegra się w zaciszu ministerialnych gabinetów .	gabinetów	6	Plur
Siostrzyczki emanowały szlachetnością i pobożnością .	szlachetnością	2	Sing
W weekend na zachodnich przejściach granicznych trwały wzmożone kontrole .	przejściach	4	Plur
O szczegóły poprosimy porucznika Achselringa .	szczegóły	1	Plur
Woły stąpały ospale , skrzypiały jarzma .	Woły	0	Plur
Kaźmierz oddał stryjowi latarnię ; na ziemi położył podłużny wąski przedmiot .	przedmiot	10	Sing
Odnosi się to zwłaszcza do sprawozdawczości statystycznej .	sprawozdawczości	5	Sing
Wciąż nawiązywał em nowe znajomości .	znajomości	4	Plur
W czasie obławy policjantom z Pieniężna udało się zatrzymać dwóch kłusowników .	obławy	2	Sing
Wtedy będzie mogła z radością oddać się rowerowym szaleństwom .	szaleństwom	8	Plur
Trzeszczą cekaemy i tną powietrze .	cekaemy	1	Plur
Na dużym talerzu uformować kopczyk z kuskusu i posypać go ozdobnie cynamonem .	cynamonem	11	Sing
Powołano specjalny zespół mający wyjaśnić przyczyny i okoliczności tragedii .	okoliczności	7	Plur
Będziemy to miejsce polecać naszym dzieciom .	dzieciom	5	Plur
Gdy wchodziła w życie reforma edukacji , Jerzy Buzek otwierał rok szkolny i prezentował gimbusy .	gimbusy	14	Plur
Z bólem musiałem się wycofać z obietnic podwyżek .	obietnic	6	Plur
Ma teraz zajęcia ze studentami .	studentami	4	Plur
Pan Kozłowski sprzedawał dolary na tą cegielnię . . .	dolary	3	Plur
Zanieczyszczenia cytoplazmatyczne i błonowe są również groźne , stanowiąc prawdopodobne źródło zarówno aktywności proteolitycznej , jak i białek cytoplazmatycznych w puli niehistonowej .	puli	20	Sing
Za granicą sprzedawane są nasiona w mieszankach i pojedynczych kolorach .	mieszankach	6	Plur
Prace metaloplastyczne w kościele wykonywał Władysław Gąsienica Makowski .	Prace	0	Plur
Ajataka wzruszyła ramionami i pociągnęła mnie do windy .	windy	7	Sing
Lampa gaśnie .	Lampa	0	Sing
Jeszcze gorzej spisali się floreciści , zajmując piąte miejsce .	floreciści	4	Plur
W próbie tej potrzebujemy pocieszającej pomocy .	próbie	1	Sing
Kierowcy udało się wyskoczyć przed zderzeniem .	zderzeniem	5	Sing
Dobroczynne działanie wina potwierdzają plantatorzy .	plantatorzy	4	Plur
Prosze ułożyć mi coś , żeby ludzie zębami zgrzytali , włosy darli , płakali , ale i równocześnie wroga szukali . . .	zębami	7	Plur
Ale hodowcy stworzyli nowe , bardziej atrakcyjne odmiany o cechach uniwersalnych .	odmiany	7	Plur
Od tygodnia wieś huczy od plotek i domysłów .	domysłów	7	Plur
– Rodzice i twój brat wrócili do domu .	Rodzice	1	Plur
Biblioteki kościelne zostały także obdarowane kolekcjami .	kolekcjami	5	Plur
W Polsce uruchomiła już dwie fabryki , w Grójcu oraz koło Wałbrzycha .	fabryki	5	Plur
Robimy przeciąg i rozbieramy się .	przeciąg	1	Sing
Uczniowie są tym przedsięwzięciem bardzo zainteresowani .	Uczniowie	0	Plur
A wieś szaleje z radości .	radości	4	Sing
Takie stanowisko może się jednak słusznie wydawać nazbyt łatwą dymisją rozumu .	dymisją	9	Sing
Na ul . Kolumny zginął wczoraj pod ciężarówką mężczyzna w średnim wieku .	ciężarówką	7	Sing
Lech Kaczyński w czasie kampanii wspiął się na szczyty .	szczyty	8	Plur
Do pupy polecam maść robioną w aptece .	maść	3	Sing
Równie interesujące były programy przygotowane przez uczniów z pozostałych miejscowości .	programy	3	Plur
Szefowie 13 central związkowych nie wykluczają , że wcześniej może dojść do innych form protestów .	Szefowie	0	Plur
Głównym jego prześladowcą był malarz , majster Gileta .	malarz	4	Sing
Wierzchołki drzew kołysały się coraz mocniej .	Wierzchołki	0	Plur
W metodzie Cieszyńskiej najważniejsza jest rozmowa .	metodzie	1	Sing
Że zawsze musiał eś mieć socjusza .	socjusza	5	Sing
Orzechy i migdały zemleć , wymieszać z cukrem oraz 3 łyżkami masła na gładką masę i połączyć z kuskusem .	kuskusem	18	Sing
Przyjechało wielu ciekawskich , ale też kupujących .	kupujących	6	Plur
Specjalne brygady w maskach i odzieży ochronnej nadzorowały rzeź ptactwa i dezynfekcję bazarów , targowisk , sklepów i środków transportu .	brygady	1	Plur
W strukturze współczesnego systemu szkonictwa wyższego w Polsce państwowe i niepaństwowe uczelnie dzielimy na dwie kategorie .	szkonictwa	4	Sing
Jestem przekonany , że grzechem jest oglądać ten film i trzeba się z tego spowiadać .	grzechem	4	Sing
Uważają nas za moskalofilów , takich zaprzańców antyukraińskich , podczas gdy sami deklarują ukraiński patriotyzm .	moskalofilów	3	Plur
Obrazy cyfrowe składają się z połączonych ze sobą pikseli o różnych barwach lub tonach .	pikseli	8	Plur
Chodzi mi o gotowanie jaja .	gotowanie	3	Sing
Ufundowanie muzeum dla zbiorów Jasieńskiego było naturalnym odruchem obywatela , miłośnika sztuki .	obywatela	8	Sing
Usłyszała m kilka taktów renesansowych .	taktów	3	Plur
Siedział odchylony za swoim biurkiem z taką miną , jakby dowodził całą policją , Interpolem i FBI na dodatek i delektował się kawą .	miną	7	Sing
Po 100 latach były w dobrym stanie , bez widocznych zniszczeń zewnętrznych .	zniszczeń	10	Plur
Otrzymasz zasiłek i ubezpieczenie zdrowotne .	zasiłek	1	Sing
Wspólne działania dały efekty .	efekty	3	Plur
- Sierżant stuknął służbiście obcasami i zasalutował .	obcasami	4	Plur
Akceptacja wyraża obiektywną prawdę o człowieku , a nie tylko subiektywne przeżycia jednostki .	jednostki	12	Sing
Spośród trzystu ochotników Polluks wybrał stu najlepiej znających się na morzu .	morzu	10	Sing
Łukasz zatrzymał przejeżdżającą taksówkę .	taksówkę	3	Sing
Dorasta do 3 m wysokości i średnicy .	średnicy	6	Sing
Taka jest czasem droga do poezji , do liryki , do wyrażania Niewyrażalnego .	liryki	8	Sing
Za pomocą kamer przemysłowych inżynierowie obserwowali próby przekazu prowadzone na parkiecie w dyskotece .	inżynierowie	4	Plur
Przedstawione powyżej podejścia , koncepcje i metody dają duży wybór w określeniu docelowego modelu alokacji .	podejścia	2	Plur
W tej lecznicy usunięto pacjentce martwą ciążę , a także macicę i fragment jelita .	lecznicy	2	Sing
Akurat wtedy , gdy kadrowicze rozpakowywali w Warszawie swój sprzęt po powrocie ze zgrupowania w Barsinghausen , w kościele w Kazimierzu zebrał się tłum wiernych , który modlił się o powodzenie naszej drużyny w zbliżających się mistrzostwach świata .	powodzenie	30	Sing
Ciekawostkę stanowi fakt , że dwa górne rzędy wibrysów mogą poruszać się niezależnie od dwóch dolnych rzędów .	rzędów	16	Plur
Oznacza to , że nie mają gwarancji Skarbu Państwa dla depozytów , czyli naszych oszczędności .	gwarancji	6	Plur
Przez następne stulecia przylgnęła do niej raczej sława rozpustnicy i zdrajczyni .	stulecia	2	Plur
Michał poprosił tylko o gorącą herbatę z cytryną , nie chciał częstować się wigilijnymi potrawami .	potrawami	14	Plur
Pod koniec gotowania dodajemy gomasio i natkę pietruszki .	gotowania	2	Sing
Poznali śmy już nazirejczyków , ponieważ należał do nich Samson .	nazirejczyków	3	Plur
Taka forma publikacji wynikała po części z objętości publikowanego materiału , ale trzeba przyznać , że kierowaliśmy się przede wszystkim wygodą użytkowania .	materiału	9	Sing
Reguły I tygodnia odnoszą się do nieprzyjaciela , którym jest ciało .	Reguły	0	Plur
Wysoka liczba urodzeń hamuje także rozwój gospodarczy kraju , w którym znaczny procent mieszkańców żyje poniżej uznanego progu ubóstwa .	rozwój	5	Sing
Artystka zażądała czarnej kotary i profesjonalnego oświetlenia .	oświetlenia	6	Sing
Do poszukiwań człowieka oskarżonego o ludobójstwo i zbrodnie przeciwko ludzkości włączyli się amerykańscy i brytyjscy agenci .	zbrodnie	7	Plur
Oficer wyszedł , rencistka odkręciła gaz .	rencistka	3	Sing
Na stole czekała na nich polska czysta wódka i kieliszki .	kieliszki	9	Plur
- W spadku po odchodzącej ekipie nowy rząd otrzymuje olbrzymi deficyt w bilansie handlowym .	ekipie	5	Sing
normalnie pensję mają też przecież . .	pensję	1	Sing
Poznali śmy się w okolicznościach osobliwych .	okolicznościach	4	Plur
W skrajnych , parodystyczno - humorystycznych wersjach mówi się o walce kryptokomunistów i masonów , antysemitów i pseudoeuropejczyków .	masonów	13	Plur
- Tylko mu lodów nie daję .	lodów	3	Plur
zatrzymano kilku kłusowników .	kłusowników	2	Plur
Wędkarstwo jest sportem .	sportem	2	Sing
Znajdą się tam także pomieszczenia rehabilitacyjne z basenem , salami gimnastycznymi i salami masażu .	basenem	7	Sing
Niech żyje lepsze jutro swobodnych ludów ! "	ludów	5	Plur
Wykaz obejmował 33 rasy psów wymagających rejestracji i szkolenia .	rasy	3	Plur
Suchocka nie jest osamotniona w swej walce z prokuratorami .	prokuratorami	8	Plur
Lubuscy policjanci rozbili grupę zajmującą się włamaniami do kościołów i kradzieżami figur oraz przedmiotów kultu religijnego .	kościołów	8	Plur
– Zamierzam rozmawiać i dzielę się z panią różnymi wrażeniami .	wrażeniami	9	Plur
Rodzice w różnym stopniu angażują się w wychowanie dzieci .	Rodzice	0	Plur
Pierwsze krople deszczu zadudniły o trumnę i zmieszały się ze święconą wodą , którą ksiądz rozpryskiwał z kropidła podobnego do królewskiego berła .	kropidła	17	Sing
Wielu wywiadów nie udzielam .	wywiadów	1	Plur
Oczywiście do zerwania zmówin dochodziło .	zmówin	3	Plur
Uchwała rady powinna być podjęta w ciągu miesiąca od dnia doręczenia wniosku Naczelnej Rady Aptekarskiej .	Uchwała	0	Sing
Dziecko przez kilka godzin było w śpiączce .	śpiączce	6	Sing
Wczoraj odniosła m do radia dwa opowiadania .	opowiadania	6	Plur
Grożąc bonią wepchnęli go do citroena i odjechali .	bonią	1	Plur
Jego towarzysze patrzyli w inną stronę .	towarzysze	1	Plur
Zamieniłem się z nim , bo chciał posłuchać przysięgi gladiatorów .	gladiatorów	9	Plur
Na diagramie Hertzsprunga - Russella olbrzymy znajdują się ponad ciągiem głównym .	olbrzymy	5	Plur
NIK podkreśla , że w czasie prywatyzacji AWRSP następowało pogorszenie sytuacji ekonomicznej Polski .	prywatyzacji	6	Sing
Czy mózg jest w stanie zrozumieć mózg ?	mózg	6	Sing
Nagrody i poczęstunek był dla wszystkich , a najlepsi zawodnicy otrzymali ponadto puchary .	puchary	12	Plur
W samej Warszawie w Internecie swoje auta eksponuje już kilkadziesiąt komisów .	komisów	10	Plur
Nie posiadają ich , niestety , mniejsze sklepy , stoiska na targowiskach ani też sklepiki wiejskie .	targowiskach	11	Plur
Tu są zasady , których trzeba przestrzegać .	zasady	2	Plur
Razem z mętami w Bornem Sulinowie pojawiły się klechy .	mętami	2	Plur
Dlatego zajął się Kołem Młodych i młodzież przyjęła jego patronat z pełną aprobatą .	młodzież	6	Sing
W wyposażeniu podstawowym znajduje się również ABS .	wyposażeniu	1	Sing
