Mama postupne napísala otcovi niekoľko listov , ale on jej neodpovedal .	neodpovedal	10	Perf
Po niekoľkých pokusoch Aziza pochopila .	pochopila	4	Perf
Nič som nevidel .	nevidel	2	Imp
Veril som mu .	Veril	0	Imp
Mohla by sa ma pýtať na Lorinu svadbu a ja by som nevedel , čo jej povedať .	povedať	16	Perf
Keď sme vychádzali z izby , že pôjdeme k autu , uvidel som vec , ktorá zvrátila ten večer nepredvídaným smerom .	vychádzali	2	Imp
Šaty , ktoré šila Flóra , sa nevydarili .	šila	3	Imp
Zišiel zo stolčeka .	Zišiel	0	Perf
Marga sa posadila na posteli .	posadila	2	Perf
“ Veru je , “ povedal Aladin .	povedal	5	Perf
Ležala som na doske a pozerala naňho .	pozerala	5	Imp
" Asi by som to vydržal , nebyť jednej veci , " povedal .	povedal	12	Perf
Nastúpila doň akási dievčina .	Nastúpila	0	Perf
Šetrí aj pani ministerka financií , ktorá stále nevylučuje ďalšie zvyšovania cien a zodpovednosť za to prenechala na vedúcich úsekov ?	nevylučuje	8	Imp
A neutekala som otvoriť .	otvoriť	3	Perf
Gaston bol presvedčený , že tentoraz nevyviazne so zdravou kožou .	nevyviazne	6	Perf
Až potom zašiel mesiac za mraky .	zašiel	2	Perf
Vláda sa zaväzuje v praxi realizovať už schválenú dikciu Európskej charty regionálnych alebo menšinových jazykov .	zaväzuje	2	Imp
Videla som mu na očiach , že to berie vážne .	berie	8	Imp
Dnes tu však mali návštevu , sedeli na terase a jedli lahodne rozvoniavajúci ovocný koláč .	sedeli	6	Imp
Polovicu zo všetkého , čo vo mne je , mám z domu , z toho , čo sa doma povedalo , napríklad pri stole .	povedalo	19	Perf
Rozprávala , akoby jej vynechávalo srdce .	Rozprávala	0	Imp
“ Musíme ho rozveseliť , “ pošepla Maja Vilkovi .	pošepla	6	Perf
Ak sa raz oldspeak nahradí , posledné puto s minulosťou sa pretne .	pretne	11	Perf
Potlačila som zívnutie .	Potlačila	0	Perf
Nemôžem pritom nespomenúť ešte jednu vec .	Nemôžem	0	Imp
Mám kŕčové žily a päť umelých zubov . "	Mám	0	Imp
Keď zástup Japoncov odišiel , v uchu sa mi opäť rozozvučal smútočný motív trúby .	rozozvučal	10	Perf
Mauglí nevinne pokrútil hlavou .	pokrútil	2	Perf
Celú noc som ani oko nezažmúril , spal som iba chvíľu nadránom .	nezažmúril	5	Perf
Teší ma , “ jachtala som .	Teší	0	Imp
Po skončení vlády prvého stredovekého západného cisára totiž v krajine ochabli štátne garancie dodržiavania zákonnosti .	ochabli	10	Perf
Povedala , že by sme mali odísť bez rozlúčky , nechcela , aby sme nechali Irme odkaz , kam ideme , a ja som pozbieral odvahu .	pozbieral	24	Perf
To nie sú ovce , ticho som jej zašepkal do ucha .	zašepkal	8	Perf
Vláda uskutoční revíziu úradov , pripraví zmeny v pracovno - právnej legislatíve a uskutoční reorganizáciu štátnej správy .	uskutoční	13	Perf
“ Ja viem , odkiaľ je , “ povedala Jazmína .	viem	2	Imp
Z balkóna utiekla , až keď som k odháňacím pohybom pridala aj hlasité zvukové efekty .	pridala	10	Perf
Ekonomická i politická moc sa dostáva z rúk starej aristokracie do rúk novej buržoázie a literatúra sa usiluje vyhovieť potrebám novej vládnúcej vrstvy .	vyhovieť	18	Perf
Poľsko bude reprezentovať Wojciech J . Has , Českú republiku Jan Švankmajer a Slovensko Štefan Uher .	reprezentovať	2	Imp
Vtom sa však stalo niečo veľmi čudné .	stalo	3	Perf
Rozoberané nepokoje sa odohrávajú v Beloozere , Novgorode , Suzdali , roku 1091 sa objavuje volchv i v Rostove .	odohrávajú	3	Imp
Usadili sme sa pripravení sledovať oblohu .	sledovať	4	Imp
Pripomínal jej trochu Teklu a chcela rýchlo odletieť .	odletieť	7	Perf
Povedala mi , že užíva antikoncepčné tabletky .	Povedala	0	Perf
Ťarbavo sa pohyboval po javisku a nevedel sa naučiť úlohu .	pohyboval	2	Imp
Čo bolo v listoch posielaných nahor , nikdy som sa nedozvedel .	nedozvedel	10	Perf
Aladin pritiahol stoličky a psi na ne vyskočili .	vyskočili	7	Perf
Spokojne som sedela na trávniku pred domom , vdychovala eukalyptovú vôňu a chladnejší vzduch i sledovala som , ako nado mnou vetrík povieva palmovými listami .	povieva	22	Imp
Na chrbte cítil , ako ich zraky priťahuje jeho belasá uniforma .	priťahuje	7	Imp
“ Chcem ti niečo ukázať .	Chcem	1	Imp
Keď však Winston opravoval pôvodný plán , znížil číslo na 57 miliónov , aby vyhovel bežným požiadavkám na prekročenie kvóty .	opravoval	3	Imp
Mama pila doma , nikdy sa nestalo , že by sa vrátila z kravínov a razila alkoholom .	pila	1	Imp
Okolo hučal a bzučal najrôznejší hmyz a v stromoch na plné hrdlo vyspevovali vtáci .	bzučal	3	Imp
Možno tu rozlíšiť viacero sfragistických typov A .	rozlíšiť	2	Perf
Zabudla na cigaretu , ktorá jej zhorela , a pozorne ho počúvala .	Zabudla	0	Perf
Vždy hulákaj s davom , to je moja zásada .	hulákaj	1	Imp
“ Maj sa , princ Ali Abubu ! “ kričal za ním Džafar .	Maj	1	Imp
Znamenalo to , že mama ma nepustí do školy .	nepustí	6	Perf
Chcel som poprosiť aj redaktorku , aby už nevyužívala repliky mojich postáv .	Chcel	0	Imp
Dievčatko pozrelo hore .	pozrelo	1	Perf
“ O chvíľu príde lejak .	príde	3	Perf
“ Pozor ! “ zvolal jeden z chrobákov .	zvolal	4	Perf
Vietor im prilepil tenké kombinézy na telo .	prilepil	2	Perf
Najprv som sa rozprávala s ostatnými dievčatami , tváriac sa , že si ju nevšímam .	rozprávala	3	Imp
Cítila som na pokožke nežný dotyk jeho prstov .	Cítila	0	Imp
“ Čo sa s tebou deje , Amy ? “ vypytoval sa ma po pretekoch tréner August a odviedol ma nabok , kým ostatní nastupovali do autobusu .	vypytoval	10	Imp
V obrovských presýpacích hodinách princeznú Jazmínu zatiaľ zasypával piesok .	zasypával	7	Imp
A povedal som jej , že je inteligentné dievča .	povedal	1	Perf
Keď sme sa v pološere prechádzali na korze , všimol som si akúsi ženu .	prechádzali	5	Imp
Žiaľ , bol priťažký , lebo maškrtil kandizované datle .	maškrtil	6	Imp
Nepripisoval som mu význam .	Nepripisoval	0	Imp
V podstate som nedúfala , že príde , no keď som ho zbadala na opačnom konci preplnenej a zadymenej telocvične , myslela som si , že sa mi marí .	nedúfala	3	Imp
“ Ako môžete také niečo povedať ! “ vyhŕkla Maja .	môžete	2	Imp
V prípade , ak si poslanci odsúhlasia platených sekretárov , môže sa stať , že " Ringom Čechom " budú poslanci a efekt bude mať sekretár .	mať	24	Imp
Približovala sa k nemu zohnutá , popolavo sivá postava , ktorá pripomínala kostlivca .	pripomínala	11	Imp
Vtrhli do panského domu ako roj sršňov až sa Maja s Rudkom hanbili .	Vtrhli	0	Perf
“ Ďakujem , “ povedala Makulienka , “ ibaže neviem , čo mám robiť , aby drozd vrátil Emanuelovi cylinder . “	Ďakujem	1	Imp
Jeho kláštor musel mať dobrú povesť , lebo ako lotrinský vojvoda , tak aj flámsky markgróf mu odovzdali viaceré kláštory , aby v nich obnovil rehoľný život podľa reformných princípov .	mať	3	Imp
Jej telo akoby doňho prelievalo časť svojej mladosti a elánu .	prelievalo	4	Imp
Zrazu sa konár zlomil a chlapec spadol do vody .	zlomil	3	Perf
Po chvíli však medzi nami zavládlo napäté ticho a obaja sme sa otočili k oknu .	zavládlo	5	Perf
Nemôžu sa .	Nemôžu	0	Imp
“ Ja som vedel , že som niečo zabudol ! “ zvolal a neodolateľne sa usmial .	zabudol	8	Perf
Slovenská republika sa zapojí do snáh medzinárodného spoločenstva zameraných na riešenie globálnych problémov , ako sú boj proti organizovanému zločinu , medzinárodný terorizmus , ekologické riziká .	zapojí	3	Perf
" Ľutujem , " podotkol Winston .	podotkol	4	Perf
Mala na sebe obnosené , no zato pestré šaty .	Mala	0	Imp
V utorok píšeme test z astronómie .	píšeme	2	Imp
Bližšie pozri Dodatok . Ponoril pero do atramentu a potom chvíľu váhal .	Ponoril	4	Perf
“ Ja som navine ! “ hrdo zvolal Tarzan .	zvolal	7	Perf
Ty si ten problém , pomyslela som si .	pomyslela	5	Perf
S úsmevom vstal a oprašoval si zodraté , vyblednuté levisky .	oprašoval	4	Imp
Stalo sa to len včera večer a Rick sa určite pred chalanmi nevyťahoval , ako vlažne som ho odbila .	nevyťahoval	12	Imp
Usmiala som sa na Chrisa , a on sa uškrnul , ako keby mu naozaj odľahlo , že súhlasím .	odľahlo	15	Perf
Omráčené murény princa napokon pustili .	pustili	4	Perf
Dal som mu takéto meno , keď som s akousi ľahkosťou presvedčil sám seba , že toto meno najlepšie pristane môjmu hrdinovi .	Dal	0	Imp
" Ale Júliu som nezradil , " poznamenal .	poznamenal	7	Perf
Na chvíľu Winston ignoroval ciferník .	ignoroval	3	Imp
A už miešala v kotli vriacu tekutinu .	miešala	2	Imp
Zomrel roku 1226 .	Zomrel	0	Perf
Predavači tu núkali všeličo od výmyslu sveta — mosadzný riad , sladké datle i čerstvé ryby .	núkali	2	Imp
Nijaká dvojica nevstávala , že pôjde tancovať , plač toho dievčaťa pokazil atmosféru .	pokazil	11	Perf
Rozumieš tomu ? "	Rozumieš	0	Imp
Do toho , do toho , do toho , povzbudzovala som sa v duchu , cítiac , ako mi pulzuje celé telo .	povzbudzovala	9	Imp
Robili taký rámus , že sa ich rev ozýval široko ‐ ďaleko po celej džungli .	ozýval	8	Imp
Keď sme vychádzali z izby , že pôjdeme k autu , uvidel som vec , ktorá zvrátila ten večer nepredvídaným smerom .	pôjdeme	7	Imp
Mediácii bráni násilný zásah zvonku — Janova prítomnosť , narúšajúca tak prvotnú rovinu mýtu .	bráni	1	Imp
Brúsil si na nás zubiská a najradšej by nás zhltol ako malinu .	Brúsil	0	Imp
Ak mu nepomôžeš , zomrie ! “	zomrie	4	Perf
Videla som to na tebe ! “	Videla	0	Imp
V piaty deň každého mesiaca išla Irma na poštu s príslušným kódom a priniesla domov sto dolárov .	išla	5	Imp
V prvých troch kapitolách sa teda pokúsime o prieskum problematiky v celoruskom rámci , odhliadnuc od jemnejších miestnych odlišností .	odhliadnuc	14	Perf
Spočiatku som sa úspešne tváril , že ma zaujíma výlučne predstavenie .	zaujíma	8	Imp
Pomyslel som si , že žartuje .	žartuje	5	Imp
Parsonsa odviedli .	odviedli	1	Perf
Abu takisto pohladkal Rahima po hlave .	pohladkal	2	Perf
Zhlboka sa nadýchla , poriadne si vydrhla predné nohy a ostala nehybne sedieť na liste ako prikovaná .	ostala	10	Perf
Pocítil som úprimnú potrebu plakať .	plakať	4	Imp
Trápilo ma niečo iné : musím zvíťaziť nad zvieraťom , ktoré sa vo mne prebudilo .	prebudilo	14	Perf
Ani družka , ani sok ho nesledujú . Čo ho núti vysedávať na konári osamoteného stromu a vyludzovať hudbu do prázdna ?	vyludzovať	17	Imp
Mal hlboký vážny hlas .	Mal	0	Imp
Cítila som , že sa červenám .	červenám	5	Imp
Na chvíľu ožiarilo murény oslnivé hrôzostrašné svetlo , no po chvíli sa rozprskli na tisíc márnych kusov .	ožiarilo	2	Perf
“ Bola si prekrásne bábätko , “ vravela mi .	vravela	7	Imp
Prvý , druhý , tretí aj štvrý odkaz mi nechala Blythe a zneli čoraz rozčúlenejšie .	nechala	9	Perf
“ Chcela som ťa uchrániť pred chybami , ktorých som sa kedysi dopustila ja .	dopustila	12	Perf
Bude pokračovať v napĺňaní národného programu , prijme nové opatrenia v legislatívnej , inštitucionálnej aj organizačnej oblasti .	prijme	7	Perf
“ To nemyslíte vážne ! “ rozhorčene zvolal Hanibal .	nemyslíte	2	Imp
Kolektívne postupovať nemôžeme .	nemôžeme	2	Imp
“ Viem , si o tom presvedčená , “ povedala mama .	Viem	1	Imp
Tu je prirodzené , že človek dostane vši .	dostane	6	Perf
Čoskoro som však zapochybovala o svojom odhodlaní , lebo pred školou ma dobehol Chris a chytil za ruku .	zapochybovala	3	Perf
“ Myslíte tamtoho ? “ spýtal sa .	Myslíte	1	Imp
Ale ona mi nepripomínala nijakú herečku .	nepripomínala	3	Imp
Podišiel som k oknu , že sa spýtam svojich postáv , čo si o tom myslia .	myslia	15	Imp
Raz Makulienka vraví : “ Niečo by som chcela . “	chcela	8	Imp
Nemala názov .	Nemala	0	Imp
Unavene klesla na zem a tíško nariekala .	nariekala	6	Imp
V sledovaných cirkevnoprávnych zbierkach sme pendanty k uhorským úpravám nenašli .	nenašli	9	Perf
Iskra podozrenia voči ošetrovateľovi , ktorá vo mne vzbĺkla , okamžite zhasla .	zhasla	11	Perf
Čarodejnica odhrnula vejúci plášť a dobré víly onemeli od hrôzy , keď zbadali Zorničku .	onemeli	7	Perf
“ Odíď ! “ povedal pokojne .	Odíď	1	Perf
Modlime sa a pomáhajme im na ich ceste , aby sa aj ich srdce zapálilo víťazstvom lásky , pravdy , nádeje a života .	Modlime	0	Imp
Nechávala ich tam , ale v šatách prinášala domov zápach kravína .	prinášala	7	Imp
Daňové zaťaženie sa bude presúvať z priamych daní na dane nepriame .	presúvať	4	Imp
Včielky sa držali za ruky .	držali	2	Imp
Netrvalo dlho a vedľa nej sa pod veľkým černicovým kríkom zjavil tučný svetlohnedý pavúk .	Netrvalo	0	Imp
Dvakrát sa mi pod vodou omotal okolo krku a prehodil sa na chrbát .	prehodil	9	Perf
Pomyslel som si , že to musí byť nejaký omyl .	Pomyslel	0	Perf
Chcel vzlietnuť do vzduchu , ale zamotal sa do krídel fraku .	zamotal	6	Perf
Hanbila sa tak , že chcela na mieste umrieť .	umrieť	8	Perf
Obrátila som sa v očakávaní , že to bol prelud .	Obrátila	0	Perf
I keď sa Maja ukrutne bála , nesmierne sa rozčúlila .	bála	5	Imp
Ktosi si všimol Marginu bledosť a zdvorilo jej uvoľnil miesto , aby si mohla sadnúť .	mohla	13	Imp
Maja s Vilkom poprisili o kúsok smrčka a statočne ho prežúvali , len aby sa zavďačili hostiteľovi .	prežúvali	10	Imp
V zápale hry Maja prihrala Vilkovi , ten prudko kopol do lopty a lopta zmizla v kroví .	prihrala	4	Perf
Zrazu si Aladin uvedomil , že naňho so záujmom hľadí vysoký , vážny a trochu zavalitý mladík .	hľadí	9	Imp
“ Ty tu bývaš ? “ spýtala sa .	spýtala	6	Perf
Dal som mu takéto meno , keď som s akousi ľahkosťou presvedčil sám seba , že toto meno najlepšie pristane môjmu hrdinovi .	presvedčil	11	Perf
Neotáľa a vylezie na strom .	Neotáľa	0	Imp
Hádes nemohol pokojne spávať , kým sa nepresvedčil , že tvoj otec je mŕtvy .	spávať	3	Imp
Túžil som publikovať v časopise Október .	Túžil	0	Imp
Na niektorých uliciach metropoly sa matky ani na chvíľku neodvážia nechať svoje bábätká samotné .	neodvážia	9	Perf
Naklonil som sa .	Naklonil	0	Perf
Doteraz sa ešte nikto o ňu tak veľmi nebál .	nebál	8	Imp
Cez Bibliu sa ako červená niť tiahne hodnota človeka .	tiahne	6	Imp
Marga neverila jej klamstvám , ja som ich prijímal .	prijímal	8	Imp
Je celkom možné , že ho pri odchode hliadka chytí ; možno už teraz naňho vonku čakajú .	chytí	9	Perf
Po poslednej hodine , ktorá sa skončila o tretej , som bežala na plaváreň .	bežala	11	Imp
Ja ta pôjdem inokade .	pôjdem	2	Imp
K tejto problematike patria podľa nášho názoru i právne normy , ktoré upravujú niektoré procesné záležitosti .	upravujú	12	Imp
Zrazu sa zavlnila tráva .	zavlnila	2	Perf
Spočiatku nevidel nič .	nevidel	1	Imp
Zvedavo zdvihol hlavu a pýta sa : “ Zdá sa , že ma poznáte ?	zdvihol	1	Perf
Už dávno dostal prezývku podľa starovekého filozofa a už dávno si nikto nepamätal , ako sa skutočne volá .	volá	17	Imp
Prstom zalovil v hrnci a nabral si porciu kaše .	zalovil	1	Perf
Bála som sa , že ho tak ľahko znovu nezavriem .	Bála	0	Imp
Teatrálne si vzdychla .	vzdychla	2	Perf
Človek nikdy nevie , na čo natrafí .	natrafí	6	Perf
O kom to chrobáky rozprávali ?	rozprávali	4	Imp
Všetci sme sa podobali na postavy absurdného divadla .	podobali	3	Imp
“ Takto vonia more ? “	vonia	2	Imp
Vendelín prikývol .	prikývol	1	Perf
Musím vydržať dovtedy , keď sa bolesť nebude dať vydržať .	vydržať	9	Perf
Nevieme , kde v tú noc odišiel .	Nevieme	0	Imp
Nanešťastie si Tekla zaumienila , že pri tejto príležitosti predvedie huslové sólo .	predvedie	9	Perf
Nijaká dvojica nevstávala , že pôjde tancovať , plač toho dievčaťa pokazil atmosféru .	tancovať	6	Imp
Igelitku s pivom položila na stôl .	položila	3	Perf
A zajatcov pekne pribúdalo .	pribúdalo	3	Imp
“ Ale to som predsa nechcela ! “ zvolala Lienka , keď predseda súdu vyhlásil rozsudok .	nechcela	5	Imp
Preto je väčšinou lepšie neplytvať energiou a vziať na vedomie cudziu paradigmu .	neplytvať	4	Imp
V niekoľkých sekundách po prebudení sen i spomienka , ktorá ho podnietila , splynuli v jeho mysli v jedno .	podnietila	11	Perf
Videla som , ako zabočil na našu ulicu .	Videla	0	Imp
“ Hádam niečo vymyslíme . “	vymyslíme	3	Perf
Navrhli im , že ak chcú prežiť v nových podmienkach trhového hospodárstva , môžu predávať po tiranských chodníkoch cigarety alebo banány .	chcú	5	Imp
Keď sme asi hodinu kráčali po ceste pre vozy , mama odbočovala ku kravínom a ja som išla ďalej do školy .	išla	17	Imp
Privrel oči .	Privrel	0	Perf
Prikrčená som vyliezla na vrchol strechy , chvíľu som balansovala a opatrne som zliezla na opačnú stranu .	zliezla	13	Perf
Ochráni Jazmínu , nech by jej hrozilo čokoľvek .	hrozilo	6	Imp
Biele lístočky kvetu sa jemne odhrnuli a zjavila sa malá rúčka .	odhrnuli	5	Perf
Vzápätí za ním s krikom vybehla i Bibina slúžka : “ Zastavte ho .	vybehla	5	Perf
Povedala mi , že pochopila , čo ma trápi .	trápi	8	Imp
Odvliekla princa na svoj zámok a uvrhla ho do temnice .	uvrhla	6	Perf
Otvoril som ju .	Otvoril	0	Perf
Vybral som z neho pokrčený oblek .	Vybral	0	Perf
“ Modlíš sa ? “ vyrušil ma akýsi hlas .	Modlíš	1	Imp
Po očku som sledovala , ako vkĺzol za volant .	sledovala	3	Imp
To vie Boh sám , človek je na ceste do večnosti alebo do zahynutia .	vie	1	Imp
Najdivokejšie vrieskali školopovinné deti .	vrieskali	1	Imp
Ocitla sa v spleti úzkych uličiek , ktoré sa ponášali ako vajce vajcu .	ponášali	9	Imp
Zrazu však vyšľahli obrovské plamene a vyrazili princovi štít z ruky .	vyrazili	6	Perf
Počul , ako sľubuje klamať , kradnúť , falšovať , vraždiť , rozširovať drogy , prostitúciu , a pohlavné choroby , liať deťom vitriol do tváre .	liať	21	Imp
Musí ma dostať z mŕtvolného stavu .	Musí	0	Imp
Ten koník za mnou naskutku priklusal .	priklusal	5	Perf
Panterov nápad však zabral .	zabral	3	Perf
Dr . Hanesová nastolila niekoľko veľmi aktuálnych problémov , s ktorými sa borí nejedna cirkevná škola na Slovensku .	borí	12	Imp
Široký nôž sa pri používaní zle drží v ruke .	drží	6	Imp
Ľúbim ťa .	Ľúbim	0	Imp
Zjavilo sa mi vo sne a mne stále znie v ušiach jeho hlas .	znie	8	Imp
Zrazu vdýchla sladučkú jemnú vôňu a pustila sa za ňou .	pustila	6	Perf
Spočiatku som ničomu nerozumel .	nerozumel	3	Imp
Viem ich takmer naspamäť .	Viem	0	Imp
Celý svet vyvalí oči , keď Belu a Gastona zbadá taký pár málokde zočí , krásavci jedna balada .	zbadá	9	Perf
" Ja len , že je vojna , " poznamenal Parsons .	poznamenal	9	Perf
Nilus bol skôr predstaviteľom východného typu mnícha , v osobe ktorého sa spájala vysoká miera asketizmu s rovnako vysokou úrovňou vzdelanosti a kvality duchovného života .	spájala	12	Imp
Neviem , či na mňa viac zapôsobila skutočnosť , že môjho starého otca zabili , alebo meno Hádes , ktoré náš hosť ticho precedil cez zuby .	Neviem	0	Imp
Odtiaľ som cez neveľké dvere , ktoré sme na noc zatvárali znútra hákom , vyšiel do dvora .	zatvárali	10	Imp
Stáli pred obrazovkou .	Stáli	0	Imp
Márne sa ho pokúšam dohoniť .	pokúšam	3	Imp
Objímal kmeň a hrdo zdvihol bradu .	Objímal	0	Imp
“ Všetci ? “ zakričal Rýchlik .	zakričal	4	Perf
Umožniť jazykovedcovi rozhovoriť sa o systéme v jazyku , prináša zdanlivo nebezpečenstvo , že sa vstúpi do nezaujímavého a nudného sveta .	prináša	9	Imp
Maja zastala a nedbajúc na svoje druhé miesto , začala ho hľadať .	zastala	1	Perf
Najprv si myslel , že to vybaví podobrotky .	myslel	2	Imp
Síce sme nevyhrali , ale verím , že aj to príde .	nevyhrali	2	Perf
Napriek všetkému úsiliu sa príbuzným Sergeja Duku nepodarilo zistiť u kompetentných orgánov nijaké podrobnosti .	zistiť	8	Perf
Nebojte sa , “ zakričala Polly .	zakričala	4	Perf
Strana vyhlásila , že Oceánia nikdy nebola spojencom Euroázie .	vyhlásila	1	Perf
Madonna po úspechu albumu Ray of Light odriekla herecké ponuky .	odriekla	7	Perf
Z kuchyne som vzala dva vínové poháre a veľkú fľašu malinovky .	vzala	3	Perf
Zakrátko sa toho nespratníka raz a navždy zbaví !	zbaví	7	Perf
“ Letím náhodou okolo , “ zašveholila , “ a takmer som o vás zakopla . “	zakopla	14	Perf
Ako sa stretla s motýľom Emanuelom	stretla	2	Perf
V tejto súvislosti použila výraz „ špicľovanie “ .	použila	3	Perf
Stalo sa niečo zvláštne , “ povedala som po chvíli .	Stalo	0	Perf
Marga odchádzala , strácala sa v dave , autobus ju viezol do ktorejsi dediny v nížine .	strácala	3	Imp
“ Vyzeráš , akoby si tu mysľou ani nebola . “	Vyzeráš	1	Imp
Mama zdvihla hlavu a ja som uvidela jej vystrašenú tvár .	zdvihla	1	Perf
Bežala za veliteľom mravcov a prosila ho , aby vyhlásil po Flipovi pátranie .	Bežala	0	Imp
Podala Aladinovi mincu .	Podala	0	Perf
Abu naňho neveriacky pozrel .	pozrel	3	Perf
U citlivejších osôb to môže spôsobiť zbytočné bolesti hlavy .	spôsobiť	5	Perf
Chcem rozpovedať istý príbeh , a nechtiac ho zamotávam .	Chcem	0	Imp
Veľa včiel opustilo mesto s novou kráľovnou , aby niekde vo veľkom šírom svete založili nové včelstvo .	založili	14	Perf
Jeho hlas opäť sprísnel .	sprísnel	3	Perf
“ Veď je to ľudské mláďa ! “ zvolal .	zvolal	8	Perf
Keď som mal vši , nikam som necestoval , nechodieval som domov .	necestoval	7	Imp
Maja s Rudkom sa práve vracali domov , keď sa strhol vietor .	strhol	10	Perf
Zostal som sedieť v kresle , aj keď sa dvere otvorili a do miestnosti vošli dvaja muži , nové tváre .	Zostal	0	Perf
V tejto kapitole budeme hovoriť o cirkevnoprávnych normách , ktoré reglementujú podmienky pre vznik , obsah a zánik manželstva .	hovoriť	4	Imp
Keď búrka ustala , zistili , že pristáli na púšti .	ustala	2	Perf
„ Nebyť toho , Slovensko by dnes neexistovalo , “ hovorí Ľubomír Ďurovič .	neexistovalo	7	Imp
Skryl som sa za obrovitý strom .	Skryl	0	Perf
Ktože by stál o takú úbožiačku , rada jej zakývam na rozlúčku .	stál	2	Imp
Pocitom , ktorý tam prevládal , bola číra zvedavosť .	prevládal	4	Imp
Keď leteli okolo sladko rozvoniavajúceho jazmínového kra , neodolali a sadli si naň .	leteli	1	Imp
Keď sa Peter raz topil na mori , Ježiš mu podal ruku a zachránil ho .	zachránil	13	Perf
“ Nevrť sa toľko ! “ hnevala sa Kasandra .	Nevrť	1	Imp
A bolo čo vidieť aj počúvať .	vidieť	3	Imp
Vláda sa zaväzuje v praxi realizovať už schválenú dikciu Európskej charty regionálnych alebo menšinových jazykov .	realizovať	5	Perf
“ Môžeme vám nejako pomôcť ? “ zdvorilo sa vypytovala Maja .	Môžeme	1	Imp
Všetci si posadali a začali hodovať .	posadali	2	Perf
Nechcela som , aby niekde zablúdil .	Nechcela	0	Imp
Chvíľu stála a pozerala sa naňho , potom nahmatala zips na jeho kombinéze .	nahmatala	8	Perf
A vtedy mu v mysli naskočil , akoby tam bol vždy preňho poruke , obraz istého súdruha Ogilvyho , ktorý nedávno padol v boji ako hrdina .	padol	21	Perf
Žiadne údaje o prípadných ďalších tunajších aktivitách Leva IX . , napríklad o snahách presadzovť refory , k dispozícii nemáme .	presadzovť	14	Imp
Tešila som sa , ale zároveň mi chýbali tie chvíle , keď sme po večierkoch spolu posedeli a rozoberali každý detail .	Tešila	0	Imp
A Vilka chceli vziať ako rukojemníka .	chceli	2	Imp
“ Poďme najprv do Bula , “ navrhla .	Poďme	1	Imp
Ak sa tak stalo , mrzí ma to .	mrzí	5	Imp
S ťažkým srdcom sa Herkules lúčil s rodičmi a oni ho s ťažkým srdcom púšťali .	lúčil	5	Imp
Natiahla sa k zásuvke na mojej strane a prehŕňala sa v nej , až kým nenašla škatuľku cigariet .	Natiahla	0	Perf
Napokon chytil vak a hodil mi ho na kolená .	chytil	1	Perf
Pozrela som na ňu a napravila som si zelenú košeľu , ktorú som si dala na rande .	Pozrela	0	Perf
“ Musíš byť statočný , ako bol Balú , “ odvetil .	odvetil	10	Perf
Je ťažké nenávidieť niekoho , kto si natoľko neverí , že sa opičí po druhých .	opičí	12	Imp
Tvoj biceps by som obopol palcom a ukazovákom .	obopol	4	Perf
Keď zaznela hymna , po lícach vyčerpaných hráčov sa kotúľali slzy .	kotúľali	9	Imp
Konečne nastal veľký deň a porota si obchádzala vystavené košíky .	nastal	1	Perf
Mlčky som sedela v autobuse , keď sme sa viezli na preteky .	sedela	2	Imp
Strana vyzýva jedinca , aby poprel svedectvo vlastných očí a uší .	vyzýva	1	Imp
Videla som , že Chrisovi síce odľahlo , no po chvíli sa zasa tváril vážne .	odľahlo	6	Perf
Vyšiel a žalostne zaplakal .	zaplakal	3	Perf
“ Ako môžem byť múdra , keď ustavične meliete , “ odvrkla Maja .	odvrkla	11	Perf
Nestrácal som čas a priložil som oko k škáre v podlahovej doske .	Nestrácal	0	Imp
Sama sa predsa rozhodla , že opustí družky .	rozhodla	3	Perf
Jazmína zdvihla hlavu a uvidela , že princ Omar tuho spí .	uvidela	4	Perf
Zhrozený Pinocchio lomcoval tyčami klietky .	lomcoval	2	Imp
Ponúka nám niečo , čo nepotrebujeme .	nepotrebujeme	5	Imp
Dvakrát sa mi pod vodou omotal okolo krku a prehodil sa na chrbát .	omotal	5	Perf
“ Nastavme si rovnako hodinky , “ povedal Chris .	povedal	7	Perf
Neuspokojme sa s tým , že sme poslali svojím blízkym veľkonočný pozdrav , ale ukážme im ako vyzerá život v nádeji vzkriesenia a víťazstva v Kristu .	ukážme	14	Perf
Keď zistil , že je obkľúčený a má sa vzdať , zabil sa ručným granátom .	zistil	1	Perf
Vtom sa otvorili dvere a vošiel dnu lykožrút Fridolín .	vošiel	5	Perf
Ani v ten deň , ani neskôr som nepovedal kamarátom o návšteve , ktorá k nám prišla .	nepovedal	8	Perf
Tak ako ty , aj ja verím v existenciu záhrobného sveta .	verím	6	Imp
“ Vravel si , že ti môžem veriť ! “	veriť	7	Imp
Obrázkovým telefónom som zavolal kováča Kováčika a ten bez dlhých rečí koníka okoval .	zavolal	3	Perf
“ Blahoželám , mami !	Blahoželám	1	Imp
Herkulovi sa na tvári zračilo záhadné odhodlanie .	zračilo	4	Imp
Tuším mi to lichotilo .	lichotilo	3	Imp
Namiesto odpovede som ho išiel vypnúť ja .	išiel	4	Imp
A hoci tú knihu ešte nedočítal , vedel , že práve toto je konečné Goldsteinovo posolstvo .	nedočítal	5	Perf
Rád by som v tomto poďakovaní spomenul všetkých , ktorí akoukoľvek radou či pomocou prispeli ku zrodu predkladanej publikácie .	spomenul	6	Perf
Poznal som aj ich kapsy a tašky .	Poznal	0	Imp
Deti sa budú matkám odnímať už pri pôrode , ako vajce sliepke .	odnímať	4	Imp
Vtedy sa naraz ukázalo , že komunistická strana s jej zločineckými spôsobmi skrachovala .	ukázalo	3	Perf
Zostávali mi teda poviedky .	Zostávali	0	Imp
Mlčky mi podal obálku , čo sa podobala obálke , ktorú mi zverila Liza .	podal	2	Perf
Oprel sa dozadu a zavrel oči .	zavrel	4	Perf
Začínam byť vážne neznesiteľný snob .	Začínam	0	Imp
Najbližšie číslo časopisu Patmos pripravíme ku koncu školského roku .	pripravíme	4	Perf
Jeho kláštor musel mať dobrú povesť , lebo ako lotrinský vojvoda , tak aj flámsky markgróf mu odovzdali viaceré kláštory , aby v nich obnovil rehoľný život podľa reformných princípov .	obnovil	24	Perf
Nereagoval som .	Nereagoval	0	Imp
Povedal som jej , nech si sadne , ale ona sa zdráhala .	zdráhala	11	Imp
V tej chvíli tréner Augustus zapískal , čím dal znamenie , že dráhy treba uvoľniť na tréning .	zapískal	5	Perf
Kalif kývol rukou .	kývol	1	Perf
Ako zažala lúčne svetielko	zažala	1	Perf
A zhrýzala ma žiarlivosť .	zhrýzala	1	Imp
Zmiluj sa nad nimi a veď a ochraňuj ich aj v ďalšie dni života .	veď	5	Imp
Formulácia „ Volumus , ut episcopi habeant potestatem . . . “ implikuje interpretáciu , že biskupi , vykonávali svoj úrad z vôle panovníka , že on im udeľoval mandát na reálne pôsobenie v ich úrade .	udeľoval	28	Imp
Bála som sa , že keby som naznačila , po čom túžim , mama by si našla aj tretie zamestnanie .	túžim	11	Imp
Mauglí natešene vykríkol , vyskočil medveďovi na brucho a pritúlil sa k nemu .	pritúlil	9	Perf
Tak sa učili variť , robiť jednoduché kuchynské práce ako umývanie riadu , škrabanie zemiakov , krájanie chleba .	variť	3	Imp
Toto ministerstvo však nemuselo uspokojovať mnohoraké potreby straníkov , ale opakovať celú operáciu na nižšej úrovni pre blaho proletariátu .	opakovať	10	Imp
Nesmieme strácať čas . “	Nesmieme	0	Imp
“ Zajtra nás čaká dlhá cesta . “	čaká	3	Imp
Winston si odkryl tvár .	odkryl	2	Perf
Mlčky sme sedeli a dívali sa , ako medená žiara pomaly bledne .	sedeli	2	Imp
Ale oni nič nerobili ani nehovorili .	nerobili	3	Imp
Môžem ti hovoriť Jaz ? “	Môžem	0	Imp
Skĺzol nižšie a vystrčil hlavu .	Skĺzol	0	Perf
Musíš Veľkého brata milovať .	Musíš	0	Imp
Potom hudba stíchla , a keď Maja znovu otvorila oči , uvidela cvrčka , ako odlieta do jasnej mesačnej noci .	stíchla	2	Perf
Zobuď sa ! “ kričal Mauglí .	kričal	4	Imp
Rozvírená voda ich vynášala na hladinu .	vynášala	3	Imp
Neúnavný hlas ďalej vyspevoval :	vyspevoval	3	Imp
Pri analýze skúmaného javu v práci sme použili viac vrstiev v úvode spomenutých prvkov .	použili	7	Perf
Nestalo sa to prvý raz .	Nestalo	0	Perf
“ Tam je , “ zašepkal .	zašepkal	5	Perf
Na hrebeni sa otočil a zaparkoval autom celkom pri okraji cesty .	otočil	3	Perf
A predovšetkým , nedovoľujeme mŕtvym , aby povstali proti nám .	nedovoľujeme	3	Imp
Zachvel som sa .	Zachvel	0	Perf
“ Neviete , že vám piraňa za pár sekúd obžerie všetko mäso ? “	obžerie	9	Perf
Bol starý , môžeme si povedať .	povedať	5	Perf
Slnečný svit , ktorý prenikal nespočetným lístím , ich ešte stále pálil na tvárach .	prenikal	4	Imp
Trošku sa pritom začervenal .	začervenal	3	Perf
Prikázali mi , aby som bol na druhý deň okolo poludnia v hotelovej hale , odkiaľ pôjdeme do kostola na svadobný obrad .	Prikázali	0	Perf
Pozrela som naňho a šťastne sa usmiala .	Pozrela	0	Perf
Celú noc som sa prevaľoval na posteli v hotelovej izbe a nemohol som sa zmieriť s realitou .	zmieriť	14	Perf
Odborná porota vyberie najlepší film z kategórie režisérskych debutov a v tejto kategórii svojho favorita vyberie aj publikum .	vyberie	2	Perf
Vážka sa polichotene usmiala .	usmiala	3	Perf
Odporná extáza strachu a pomstychtivosti , túžba zabíjať , mučiť , drúzgať tváre kováčskym mlátom akoby preskočila sťa elektrický prúd na všetkých a premenila každého aj proti jeho vôli na vrieskajúceho pomätenca s pokrivenou tvárou .	zabíjať	7	Imp
Ako vyzerajú ?	vyzerajú	1	Imp
A s pocitom viny za svoju neposlušnosť som sa na ňu po celý čas díval .	díval	14	Imp
Ako som vychádzala zo školy , zbadala so , že sedí na trávniku pri zastávke môjho autobusu .	vychádzala	2	Imp
Na chodbe som nepočul nijaké zvuky .	nepočul	3	Imp
" Zoberiem tú funkciu , ak to ľudia naozaj budú chcieť , " povedal režisér .	chcieť	10	Imp
" Tak ty ho nenávidíš .	nenávidíš	4	Imp
Samozrejme , že som mu nepovedala , že mám domáce väzenie .	nepovedala	5	Perf
Na manifestáciách vždy nesiem jednu časť transparentu .	nesiem	3	Imp
“ Skúsme ich preľstiť , “ navrhol Rudko .	Skúsme	1	Perf
Ako vlak , ktorý zišiel z koľají .	zišiel	4	Perf
Niečo ostro cvaklo .	cvaklo	2	Perf
Keď Maja váhavo pokrútila hlavou , Petronila sa nahlas zasmiala .	pokrútila	3	Perf
Nie , táto zvláštna myšlienka nikdy Winstonovi na um nezišla .	nezišla	9	Perf
Zasmiala som sa , keď vychrlila tie otázky .	vychrlila	5	Perf
Musíš Veľkého brata milovať .	milovať	3	Imp
Zaujalo ma to ! “ povedala so smiechom Jazmína .	Zaujalo	0	Perf
Volám sa Jurko .	Volám	0	Imp
“ Je na ňom symbol bohov , “ vysvetľovala Alkmena .	vysvetľovala	8	Imp
Zaznel zvonec a všetko stíchlo .	Zaznel	0	Perf
Vo Zvedoch som robila vedúcu oddielu .	robila	3	Imp
Musím niečo urobiť , inak hrozí , že sa nezúčastním na Lorinom svadobnom obrade .	Musím	0	Imp
Nechal som televízor zapnutý a privliekol som sa k dverám bytu .	privliekol	5	Perf
Nikoho , kto raz vybočil , neušetríme .	neušetríme	6	Perf
“ Čo vlastne robíš ? “ vypytovali sa ďalej .	robíš	3	Imp
Nikto z nich nevie nič o mojom ruskom dobrodružstve .	nevie	3	Imp
Avšak rodine malého paviána sa nepáčilo , ako sa Jane správa k ich mláďaťu a nazlostení začali dievčinu prenasledovať .	prenasledovať	18	Imp
Maja vážne pozrela na svoju učiteľku .	pozrela	2	Perf
“ Viem , “ povedala som a vystúpila z auta , “ ale ak budem myslieť len na zábavu , môžem ísť zametať chodníky . “	myslieť	15	Imp
Vtedy si uvedomil , že Meg po celý čas donášala Hádesovi .	donášala	9	Imp
Hermes práve spokojne podriemkaval na oblaku , keď ho prebudil hrozný rachot .	prebudil	9	Perf
Našťastie sme zastali pri obrubníku pred pizzeriou Rajské slasti a všetci náhle stratili o nás záujem , keďže snívali o pizze .	snívali	18	Imp
Povedala mi , že pochopila , čo ma trápi .	pochopila	4	Perf
“ Si ten najstatočnejší a najbystrejší mladý muž , akého poznám , “ povedal vďačne .	povedal	13	Perf
Barbie ich s úsmevom sledovala .	sledovala	4	Imp
Stále sa mu chce škrabať , nech by bol kdekoľvek .	škrabať	4	Imp
Netrvalo dlho a obaja lavínu skyprili , takže sa párik cvrčkov ľahko dostal von .	skyprili	5	Perf
Tarzana urazilo , že sa Kerchak hnevá a utiekol do džungle .	urazilo	1	Perf
Nikdy nepočula o Bratstve a odmietala veriť v jeho existenciu .	nepočula	1	Imp
Oči jej vystúpili z jamiek a z vyškerených úst vypadali všetky zuby okrem jedného .	vypadali	9	Perf
Na takomto mieste prelínania sa dvoch kultúr sa ľahšie uchovávajú archaické prežitky .	uchovávajú	9	Imp
Nachádzala sa tam kancelária šéfa televízie Sírius .	Nachádzala	0	Imp
Nenadarmo platí " Sýty hladnému neverí " a zároveň neexistuje žiadne porekadlo typu " Ukojený nadržanému neverí " .	platí	1	Imp
Odporná extáza strachu a pomstychtivosti , túžba zabíjať , mučiť , drúzgať tváre kováčskym mlátom akoby preskočila sťa elektrický prúd na všetkých a premenila každého aj proti jeho vôli na vrieskajúceho pomätenca s pokrivenou tvárou .	premenila	23	Perf
Hľadala som niečo , čo mamu uspí .	Hľadala	0	Imp
Hermes práve spokojne podriemkaval na oblaku , keď ho prebudil hrozný rachot .	podriemkaval	3	Imp
“ Keď napríklad zavrem oči , vidím teba , Amy . “	zavrem	3	Perf
“ Môžem si to ešte rozmyslieť ? “ spýtala sa .	spýtala	8	Perf
Veľmi som chcela , aby ostali spolu , no cítila som sa pri nich trochu navyše .	ostali	5	Perf
Keď sa zobudil , ľan bol suchý .	zobudil	2	Perf
Na dvore som hadicou napustila slnkom zohriatu vodu a začala som šampónovať auto .	šampónovať	11	Imp
Prišiel na to niekto iný : Zelené oči .	Prišiel	0	Perf
Z Odilonovho listu Štefanovi I . sa dozvedáme , že clunyjský opát a prvý uhorský kráľ boli vo vzájomnom styku už pred odoslaním tohto listu vzniknuvšieho medzi rokmi 1031 – 1038 .	dozvedáme	7	Imp
Čo to tára ?	tára	2	Imp
Na schodišti som mal opäť zvláštny pocit , že ma niekto sleduje , a znova som rýchlym pohybom otočil hlavu , akoby som ho chcel nečakane prekvapiť .	otočil	18	Perf
My však každému ponaprávame mozog do dokonalosti , kým mu ho vystrelíme .	ponaprávame	3	Perf
Najprv zavládlo neprirodzené ticho .	zavládlo	1	Perf
Milí konfirmandi , dnes sa stanete dospelými členmi nášho cirkevného zboru .	stanete	5	Perf
Terapia nezabrala .	nezabrala	1	Perf
Zvončeky už hlásili , že sa blíži nepriateľ .	hlásili	2	Imp
Nemohla som si spomenúť , odkiaľ ju poznám .	poznám	7	Perf
Postav ho na okrúhly stôl .	Postav	0	Perf
Ale ony medzitým zmizli , pohltila ich temnota .	pohltila	5	Perf
Recepčné sa podujali objednať taxík a zobudiť ma , kedy uznám za vhodné .	podujali	2	Perf
Podľa teba zrejme našou hlavnou úlohou je tvoriť nové slová .	tvoriť	7	Imp
Prvý deň sa deťom v škole veľmi páčilo !	páčilo	7	Imp
Čoskoro som však zapochybovala o svojom odhodlaní , lebo pred školou ma dobehol Chris a chytil za ruku .	dobehol	12	Perf
Keď chcel , úplne vypol a okolie preňho neexistovalo .	vypol	4	Perf
Naozaj stenám , ale ty si to , preboha , poriadne zveličil .	zveličil	11	Perf
Zrakom som hľadala náš dom , ale všimla som si , že Chris sa na mňa díva .	díva	16	Imp
“ Pozor ! “ varovne skríkla Bela .	skríkla	5	Perf
Keď sa ku mne sklonila , že ma pobozká , zacítila som pach alkoholu .	zacítila	10	Perf
Skôr ako som prešiel okolo neho , otočil sa mi chrbtom .	otočil	7	Perf
Za jeho stiahnutými mihalnicami sa pohyboval celý les prstov v akomsi tanci , vykrúcal sa a skrúcal , strácal sa jeden za druhým a znova sa objavoval .	strácal	18	Imp
Boli tu velikánske depozitáre na uskladňovanie opravených dokumentov a skryté pece na ničenie pôvodných výtlačkov .	Boli	0	Imp
Chcela by som sa na nej odviezť , “ povedala Makulienka .	Chcela	0	Imp
Winstona bolestne bodlo pri srdci .	bodlo	2	Perf
Moja myseľ opäť postrehla akúsi súvislosť medzi autom a týmito dvoma mužmi .	postrehla	3	Perf
Keď vystúpila z pásma žltkastého svitu a na chvíľu zastala na rozhraní medzi svetlom a temnotou , nemyslel som na to , že ide priamo ku mne , aby napravila chybnú interpretáciu vecí , ktorú vyprodukoval môj mozog .	zastala	9	Perf
Škoda , že Tayerle je taký nezáživný profesor , pretože astronómia , ktorú sme tento týždeň preberali , mi pripadala nesmierne zaujímavá .	pripadala	19	Imp
Potom sa vrhol do vody a rozpleštil sa na člne , až ma od smiechu rozbolelo brucho .	vrhol	2	Perf
“ PÄŤ TELEFONÁTOV ! “ zvolala som , keď som zbadala , že doma v chodbe bliká svetielko na odkazovači .	zbadala	10	Perf
Winston si kvokol vedľa nej .	kvokol	2	Perf
Ako kráčal k dverám , mince v mešci príjemne zacinkali .	zacinkali	9	Perf
Deti sa veľmi tešili , keď Lulu kŕmila mláďatká .	tešili	3	Imp
" Nezabil som ju .	Nezabil	1	Perf
Ich obvinenia ma trápili .	trápili	3	Imp
Len čo bola Maja preč , schytil Vilko palicu .	schytil	6	Perf
Myslím , že o sebe urobili veľmi pekný obraz , že aj Rómovia a deti z detského domova sa vedia správať na úrovni .	Myslím	0	Imp
“ Ona si to o sebe myslí , “ zasmial sa Truhlík .	myslí	6	Imp
Nechala dole pred domom auto .	Nechala	0	Perf
Aladin pritiahol stoličky a psi na ne vyskočili .	pritiahol	1	Perf
Vstal som a otočil som sa mu chrbtom .	otočil	3	Perf
Raz som chytil muchu a vlastnoručne som ju hodil do pavučiny , ale nevidel som , že by sa objavil nejaký pavúk , ktorý by ju zožral .	hodil	8	Perf
Roztočil som laso a chytil stonožku do slučky .	Roztočil	0	Perf
Veronika sa najprv urazila , ale keď jej Ferdo vysvetlil , že rehotanie je taká zvláštna psia choroba , trochu sa upokojila .	urazila	3	Perf
Nemohla som chápať súvislosti tejto zmeny .	chápať	2	Imp
" Hráš , vyhráš , hráš , prehráš .	Hráš	1	Imp
“ A ty si mu to veľmi neuľahčil . “	neuľahčil	7	Perf
Svedčilo o tom správanie mojich rodičov .	Svedčilo	0	Imp
Prešiel som s ňou vchodom a cez dvor do suterénnej kuchyne .	Prešiel	0	Perf
To Maju naštvalo .	naštvalo	2	Perf
Ale tým sa táto záležitosť neskončila .	neskončila	5	Perf
Ktosi si všimol Marginu bledosť a zdvorilo jej uvoľnil miesto , aby si mohla sadnúť .	sadnúť	14	Perf
Hneď sa vybral za Matúšom do prasačieho chlieva a pozval ho k sebe na celých osem dní !	vybral	2	Perf
“ Nechcú nám ublížiť , Kerchak ! “ povedal .	Nechcú	1	Imp
Tesnejšie sa pritisol k malinčiu a oko zavrel .	zavrel	7	Perf
Káa opäť preglgol .	preglgol	2	Perf
Toto mi vysvetľovala aj stará mama z otcovej strany , povedala .	vysvetľovala	2	Imp
“ Sú ukrutne drahé , “ povedala som ľútostivo a pohladila mäkkú látku .	pohladila	10	Perf
Uvedomila som si , že ma nepočúval .	Uvedomila	0	Perf
“ Radža naozaj nikomu neublíži , “ ubezpečovala ho Jazmína .	ubezpečovala	7	Imp
Nepovažovalo sa za žiaduce , aby proleti mali silné politické cítenie .	Nepovažovalo	0	Imp
Bála som sa to povedať mame , ktorá prišla na polhodinu domov , aby sa prezliekla , kým pôjde do ďalšej práce .	povedať	4	Perf
Boli to mizerné , chatrné rárohy , ale akékoľvek hrnce sa vždy ťažko zháňali .	zháňali	13	Imp
“ Som advokátka , vyhlásila pohotovo Maja , “ a pána Rudka budem zastupovať ! “	vyhlásila	4	Perf
Chceš vidieť , ako urobím leoparada ? “ spýtal sa .	spýtal	8	Perf
Regula metského biskupa podrobne ustanovuje i podmienky prijatia do spoločenstva kanonikov a v rámci nich predpisuje pre kandidáta povinnosť odovzdať všetok majetok kostolu , pri ktorom mieni pôsobiť .	predpisuje	15	Imp
“ Tak predsa ste sa bozkávali ! “ zvolala .	zvolala	8	Perf
Keďže mu nechceli odpovedať na otázku , Hádes sa uchýlil k lichôtkam .	nechceli	2	Imp
Mauglí so supmi sa smiali , keď im tiger zmizol z dohľadu .	smiali	4	Imp
Našla som svojho osobného Spasiteľa , Ježiša Krista vo svetle Ježišovho evanjelia , v ňom som poznala posolstvo pokoja , lásky , radosti a šťastia .	Našla	0	Perf
NA DRUHÝ DEŇ RÁNO som sa prebudila do skutočnosti .	prebudila	6	Perf
Táto povinnosť sa však nevzťahovala na produkty , ktoré sa jednak priamo a jednak symbolicky týkali základných prejavov kresťanského kultu .	nevzťahovala	4	Imp
V jednom kuse táral o Týždni nenávisti .	táral	3	Imp
Preglgla som .	Preglgla	0	Perf
Čujte , čujte !	čujte	2	Imp
“ Otec , on spáva s potkanmi ! “	spáva	4	Imp
V tej chvíli Makulienka celkom stratila srdce .	stratila	5	Perf
“ Pravú lásku stretnete čoskoro .	stretnete	3	Perf
Jazmína sa prekvapene poobzerala okolo seba .	poobzerala	3	Perf
Takže ak sa myšlienky zorganizovať rockový festival chytí skúsenejší organizátor , veríme , že festival , ktorému je dedina a ľudia v nej naklonení , sa bude znova konať .	konať	28	Imp
Winston i dievča vytrvalo jedli .	jedli	4	Imp
Boris svieti zrkadielkom do očí , končím , “ hlásil vysielačkou Vilko .	končím	6	Imp
Vysvetlil mi , že mi musia položiť iba niekoľko otázok .	položiť	6	Perf
Často mi vyčítali , že som neskutočne neľudský .	vyčítali	2	Imp
O chvíľu sa tam zjavila i Kala .	zjavila	4	Perf
Aladin si vzdychol , odľahlo mu , že mal tentoraz šťastie .	odľahlo	4	Perf
Čašníci ich obskakovali , akoby patrili do kráľovskej rodiny .	patrili	5	Imp
“ Tu niekde mám bundu , “ zamrmlal .	mám	3	Imp
Keď sa napokon obzrela , škriatka už nebolo .	obzrela	3	Perf
u Martina nemám čo do zvonca .	nemám	2	Imp
Prikývla som a tuhšie ma privinul .	Prikývla	0	Perf
Odteraz sme jej rodičia , tak ju musíme niesť , “ povedala potom Vilkovi .	niesť	8	Imp
Ako sedemnásťročný sa stal okresným zakladateľom Antisexuálnej ligy mládeže , ako devätnásťročný navrhol nový druh ručného granátu , ktorý zaradilo do výzbroje Ministerstvo mieru a ktorý už pri prvej skúške jediným výbuchom zabil tridsaťjeden euroázijských zajatcov .	zaradilo	19	Perf
Kráčal ďalej .	Kráčal	0	Imp
A tu či inde sa v úplnej tajnosti nachádzali riadiace mozgy , ktoré koordinovali toto úsilie a určovali politickú líniu : rozhodovali o tom , že tento fragment minulosti sa zachová , tento sa sfalšuje a ďalší prestane jestvovať .	rozhodovali	21	Imp
Navrhneme zmeny , ktoré sú nevyhnutné pre vybudovanie moderného sociálneho systému .	Navrhneme	0	Perf
Kto si o Snehulienke rozum trúsi , ten rozletí sa na márne kusy !	trúsi	5	Imp
Hladko som vkĺzla pod vodu a vynorila sa na hladine .	vkĺzla	2	Perf
O ' Brienov sluha ich však oboch vpustil dnu bez jediného protestu .	vpustil	7	Perf
Keď dedinskí nafúkanci z môjho ročníka uverejnili na jeho stránkach nejakú báseň , naparovali sa celý mesiac .	uverejnili	6	Perf
Veľmi sa za to hanbím . “	hanbím	4	Imp
Chris na mňa spoza knihy pozrel .	pozrel	5	Perf
Vybral som peniaze a podal som mu ich .	podal	4	Perf
“ Rick ! “ skríkla som a vyjavene naňho pozrela .	skríkla	4	Perf
Rodičia zaujímali miesta naproti sebe , ja som sedával medzi nimi .	zaujímali	1	Imp
Želám príjemný víkend .	Želám	0	Imp
Mne to môžeš povedať . “	môžeš	2	Imp
Krk by som ti zlomil ako mrkvu .	zlomil	4	Perf
V takýchto mrákotách zaznel v ktoromsi kúte môjho mozgu pohrebný motív vzdialenej trúby .	zaznel	3	Perf
Keď krtko Bonifác vykukol druhý raz , vraví : “ Toto som našiel riadne hlboko ! “	vraví	7	Imp
Najskôr som sa zarazil .	zarazil	3	Perf
“ Je tu veľa žiab ? “ spýtala sa vystrašene Maja .	spýtala	7	Perf
Máme spoločnú príležitosť napísať vynikajúcu kapitolu slovenských dejín .	napísať	3	Perf
A tu či inde sa v úplnej tajnosti nachádzali riadiace mozgy , ktoré koordinovali toto úsilie a určovali politickú líniu : rozhodovali o tom , že tento fragment minulosti sa zachová , tento sa sfalšuje a ďalší prestane jestvovať .	sfalšuje	34	Perf
“ Dúfam , že získam štipendium na niektorú vysokú školu , “ vyhlásila som , ale nespomenula som , že by som chcela ísť na menšiu , no o to prestížnejšiu univerzitu .	získam	4	Perf
Prichádzali sme zozadu , a tak sme sa vyhli autobusom , autám a nápisom nad vstupom .	Prichádzali	0	Imp
Uspokojil sa aj so zvyškami .	Uspokojil	0	Perf
Neuspokojme sa s tým , že sme poslali svojím blízkym veľkonočný pozdrav , ale ukážme im ako vyzerá život v nádeji vzkriesenia a víťazstva v Kristu .	vyzerá	17	Imp
Opatrne odhrnula okvetné lístky a vyzrela von .	vyzrela	5	Perf
“ Nesmieš sa udrieť , nesmieš sa udrieť , nesmieš sa udrieť .	Nesmieš	1	Imp
Za jeho stiahnutými mihalnicami sa pohyboval celý les prstov v akomsi tanci , vykrúcal sa a skrúcal , strácal sa jeden za druhým a znova sa objavoval .	vykrúcal	13	Imp
“ Ty chceš ísť na túru ? “ spýtala som sa a pozrela na hodinky .	pozrela	12	Perf
Keď však videl tých zamyslených zubáčov , nedalo mu to .	nedalo	7	Imp
Aj tak sa vybrala pod harmanček , či náhodou pod lístkom neostala nejaká kvapôčka .	neostala	11	Perf
Lori sa nahlas zasmiala .	zasmiala	3	Perf
Položil Winstona na lôžko .	Položil	0	Perf
Možno ich nevidel .	nevidel	2	Imp
“ Na to sa spoľahnite ! “ začal vyjednávať chrobák Truhlík .	vyjednávať	8	Imp
Stiahol páku a pokračoval :	Stiahol	0	Perf
Priateľky a príbuzní ju ponechali svojmu osudu .	ponechali	4	Perf
Pred domom kuny Chytráčky viali pestré slepačie perá , Alfonz vystavoval lesklú kukuricu a kliešťak Drakula voňavé krvavé klobásky .	vystavoval	10	Imp
Stále som kľačal na kolenách a čelo sa mi pokrylo potom .	pokrylo	9	Perf
Omar pustil vankúš a skočil na zem .	skočil	4	Perf
Súžitie etník tu teda fungovalo na princípe spoločenstiev v ktorých jednotlivé zložky popri sebe slobodne existovali a zároveň sa ovplyvňovali , miešali a splývali .	fungovalo	4	Imp
Nechal som ju vzlykať .	Nechal	0	Perf
Bohužiaľ , vzali si z nich príklad všetky deti a tiež sa chceli hrať v odpadovej jame .	hrať	13	Imp
Strhla aj mladšiu sestru a s rachotom prevrhli otcovu stoličku .	Strhla	0	Perf
Žuk meškal , a hoci som sa všemožne pokúšal opäť zaspať , nedarilo sa mi to .	nedarilo	12	Imp
Od tvojho príchodu na svet , od vzniku Strany , od začiatku dejín trvá stále tá istá vojna bez prestávky .	trvá	13	Imp
“ Tu opice hniezdia .	hniezdia	3	Imp
Vládol tu čulý ruch , no Chrisa nevyrušil zo sústredenia .	nevyrušil	7	Perf
Detektíva Steva McGarretta hral Jack Lord .	hral	3	Imp
Priadli , priadli až upriadli .	Priadli	0	Imp
Neverím , že by sme mohli niečo zmeniť za nášho života .	Neverím	0	Imp
Na druhej strane všetky špinavé práce robia politickí väzni .	robia	6	Imp
“ Vezmeš Mauglího do osady , “ prikázal mu Baghíra .	Vezmeš	1	Imp
V poslednom čase ju Ministerstvo hojnosti veľmi obľubovalo .	obľubovalo	7	Imp
Pokiaľ ide o vši , veľmi sa netráp .	netráp	7	Imp
Počuješ ma ?	Počuješ	0	Imp
Kasandra preto vyslala včielky popoludní na pole , aby nazbierali kukuricu .	nazbierali	9	Perf
Zrazu zažmurkal a prekvapene na oboch pozrel .	pozrel	6	Perf
Musí byť pri tom také život , zdravie a príčetnosť ohrozujúce nasadenie ?	Musí	0	Imp
Pre Lizu by bolo katastrofou , keby som rozpovedal ostatným , čo som videl v Profesorovej izbe .	rozpovedal	8	Perf
Mlčky sme sedeli a dívali sa , ako medená žiara pomaly bledne .	dívali	4	Imp
A stalo sa .	stalo	1	Perf
I Hanibal si to všimol , a preto vzal pred ňou nohy na plecia .	vzal	8	Perf
Cítila som zvláštny pokoj .	Cítila	0	Imp
Rusi prenasledovali kacírstvo ešte krutejšie , než inkvizícia .	prenasledovali	1	Imp
Strhla sa búrka	Strhla	0	Perf
Keď som na nej otvoril dvere , zarazene som zastal na prahu : hrali tam šach dvaja učitelia .	zastal	9	Perf
Utiekla z paláca pred nekonečným zástupom nápadníkov .	Utiekla	0	Perf
“ Spomínaš na tú rozprávku , čo ti mama rozprávala , keď si nemohla zaspať ? “	zaspať	14	Perf
“ Stále by ti hovorili , kam máš ísť a čo si máš obliecť . “	máš	7	Imp
Chris sa držal vľavo , šiel v pruhu , ktorý rozhodne neviedol ku knižnici .	držal	2	Imp
Blythe pokrútila hlavou .	pokrútila	1	Perf
„ Nebyť toho , Slovensko by dnes neexistovalo , “ hovorí Ľubomír Ďurovič .	Nebyť	1	Imp
Zobudil som sa o dvanásť hodín .	Zobudil	0	Perf
Volala sa Znepokojenia .	Volala	0	Imp
“ Ihneď ma pustite , “ zvolala Maja .	zvolala	6	Perf
Sadli si na konár medzi šuštiace lístie topoľa .	Sadli	0	Perf
Pomyslel som si , že Soni by závidela Faike jej pleť .	závidela	7	Imp
Neuspokojme sa s tým , že sme poslali svojím blízkym veľkonočný pozdrav , ale ukážme im ako vyzerá život v nádeji vzkriesenia a víťazstva v Kristu .	Neuspokojme	0	Perf
Winstonovu čeľusť zovrela bodavá bolesť .	zovrela	2	Perf
Týchto ľudí som stvoril ja , vyjachtal som .	stvoril	3	Perf
“ Chcem vedieť , kedy stretnem pravú lásku . “	Chcem	1	Imp
“ Určite hľadáte Fawada , obchodníka so šperkami , “ povedala , keď k nej podišli .	podišli	15	Perf
Zmocnil sa ma nevysvetliteľný strach , mal som pocit , že ju už neuvidím .	Zmocnil	0	Perf
" Zradila som ťa , " povedala bez okolkov .	Zradila	1	Perf
Poď so mnou do Petrohradu namiesto mojich rodičov .	Poď	0	Imp
Šmátrala som okolo seba a hľadala môj poklad .	hľadala	5	Imp
Soni ma prosila , aby som nerobil hlúposti .	prosila	2	Imp
Realita života na vidieku zatláča náboženské rozdiely do úzadia .	zatláča	4	Imp
Všetci smutne hľadeli do prázdneho košíka , kde predtým ležali šteniatka .	ležali	9	Imp
Kalich zvončeka , kde strávila noc , sa knísal vo vetre a bolo tam chladno .	knísal	8	Imp
Už dávno som stratil kontakt so svetom kina a v nových televíziách ma nikto nepoznal .	nepoznal	14	Imp
“ Vieš , musím chvíľu popremýšľať , “ povedal Káa .	Vieš	1	Imp
Všetci smutne hľadeli do prázdneho košíka , kde predtým ležali šteniatka .	hľadeli	2	Imp
Za jasotu spoluobčanov prevzali cenu a Dr . Slimák slzil od dojatia , pretože v tejto súťaži doteraz nijaký slimák nevyhral .	prevzali	3	Perf
Veľa čítal , niekedy aj písal .	čítal	1	Imp
Aladin držal špajľu horúcej pečenej jahňaciny , ktorú ukradol zo stánku .	ukradol	8	Perf
Alia sa tvárila zamyslene .	tvárila	2	Imp
Bol rehoľníkom v niekoľkých kláštoroch v Itálii i Hispánii , no oveľa viac ho priťahoval eremitský spôsob života .	priťahoval	14	Imp
“ Počkajte ! “ zakričal niekto .	Počkajte	1	Perf
Zem sa ustavične triasla a kopček z hliny rástol a rástol .	triasla	3	Imp
Najprv Maja spoznala dobrého kamaráta , ktorý jej pripadal veľmi zvláštny .	spoznala	2	Perf
Pozrela som na jedálny lístok vyvesený nad pultom , potom na zem a do výkladu .	Pozrela	0	Perf
Nepoznám nič horšie ako utáraných kamarátov .	Nepoznám	0	Imp
Už som ho niekde počul .	počul	4	Perf
Je síce pravda , že nijaký súdruh Ogilvy nikdy neexistoval , ale zopár riadkov v tlači a niekoľko vyfabrikovaných fotografií čoskoro splodia jeho existenciu .	neexistoval	9	Imp
“ Toto je tvoja detská izba , neskôr dostaneš večeru , “ vysvetľovala mu Maja .	vysvetľovala	12	Imp
“ Ale , počkaj chvíľu , “ odvetil Mauglí .	počkaj	3	Perf
Trvalo to tri týždne .	Trvalo	0	Imp
Iba na bodliaku sa jagali veľké kvapky rosy , lebo sa báli skotúľať do trávy .	skotúľať	12	Perf
Vysoko na oblohe uprostred jasných hviezd žiaril guľatý mesiac .	žiaril	6	Imp
“ Nestrachuj sa o mňa , “ odvetil Mauglí .	Nestrachuj	1	Imp
Ale ja nemôžem žiť bez tohto priznania .	nemôžem	2	Imp
V každom prípade musím otvoriť oči a nesmiem veriť legendám .	nesmiem	7	Imp
“ Amy ! “ zvolal rozpačito .	zvolal	4	Perf
“ Tak ma polej , “ povedal ľan .	povedal	6	Perf
Potom sa moja fantázia zmiatla .	zmiatla	4	Perf
Marketing je súborom disciplín , ktoré sa zaoberajú trhom a v trhovej ekonomike človek má cenu , ktorá sa vyjadruje len peniazmi .	vyjadruje	19	Imp
Vláda urýchli liberalizáciu trhu a vytvorí konkurenčné prostredie v energetike .	urýchli	1	Perf
Cítila som , aké má teplé dlane .	Cítila	0	Imp
Sedela som vedľa neho na vrchole Squaw Peaku a zmocnil sa ma pocit šťastia .	Sedela	0	Imp
Rovnako prekvapujúco dobre vedela rozprávať bez pohybovania perami .	rozprávať	4	Imp
Jazmína otvorila dvere .	otvorila	1	Perf
Hlas mi znel neprirodzene .	znel	2	Imp
“ Nazri do svojho srdca , ono ti povie , čo máš robiť . “	Nazri	1	Perf
“ Podľa mňa by mal mať šofér právo veta , “ navrhol Rýchlik .	mať	5	Imp
Ale keď veľký vlk vopchal do košíka ňufák , bábätko sa zasmialo .	zasmialo	11	Perf
Vtom sa odraz mesiaca rozbil na črepy , no zakrátko sa zasa zjavil na hladine .	zjavil	12	Perf
Nakoniec , takisto môže aj Čech čítať slovenské , keby chcel , oni však tú potrebu V ROVNAKEJ MIERE nemajú . “	nemajú	19	Imp
Telefón mlčal .	mlčal	1	Imp
A pomyslel som si , že ju už neuvidím .	pomyslel	1	Perf
Jeho nádej opäť zhasínala .	zhasínala	3	Imp
Napriek tomu Syme odhalil uňho niečo ako nedostatok nadšenia .	odhalil	3	Perf
Nech ma Tom netrápi , chcel som jej povedať .	netrápi	3	Imp
Zahundrala akýsi súhlas .	Zahundrala	0	Perf
Nevlastní rodičia sa o Herkula dobre starali a vyrástol z neho milujúci syn a mladík .	starali	6	Imp
“ Zvykneš si naňho . “	Zvykneš	1	Perf
“ Sledovala som ho na chate . “	Sledovala	1	Imp
Pokúšala by sa presvedčiť ma , že nemá zmysel rozčuľovať sa .	rozčuľovať	9	Imp
Keď pred správami zaznela trúbka , vždy to znamenalo víťazstvo .	zaznela	3	Perf
Nové , moderné pedagogické postupy v mnohých oblastiach zlyhávajú .	zlyhávajú	8	Imp
V uplynulých rokoch ukázalo silný vzťah k demokratickým hodnotám a silu riešiť mnohé problémy .	ukázalo	3	Perf
“ Poviem vám to stručne a jasne , “ odvetil Ferdo .	odvetil	9	Perf
“ Veru vyľakal .	vyľakal	2	Perf
“ Mala som pocit , že sa vznášam ! “ vravela som mame , keď za mnou pribehla a objala ma .	objala	19	Perf
Zaplietla sa do niečoho neznámeho , ako keby ju lapila neviditeľná nitka .	lapila	9	Perf
“ Už dávno som opustila svoj roj , “ nesmelo odvetila Maja .	odvetila	10	Perf
“ Nič , “ odvetila som a pozrela na Chrisa .	pozrela	7	Perf
Zdalo sa mu , že naň čakal celý život .	čakal	6	Imp
Dieťa prikývlo , akoby mu rozumelo .	prikývlo	1	Perf
Nerozumel som , prečo mi to hovorí .	Nerozumel	0	Imp
Túto hru prerušil Tom .	prerušil	2	Perf
“ Kam ideme ? “ vypytoval sa .	vypytoval	5	Imp
Profesor Eugen Jóna , ktorý sa dejinami spisovnej slovenčiny dlhé roky zaoberal , si uvedomil potrebu dať do rúk slovenskej i medzinárodnej vedeckej verejnosti dostatočne prístupný skutočný text tohto základného diela .	dať	16	Perf
Kým sa obliekala , v chodbe zazvonil telefón .	obliekala	2	Imp
Opustila strom , ktorý ju chránil , a veľkými oblúkmi letela povetrím .	chránil	5	Imp
Na chvíľu privrel viečka .	privrel	2	Perf
Nemal topánky , veľké špinavé prsty mu vyčnievali z dier na ponožkách .	vyčnievali	7	Imp
“ Rozviažte ich ! “ prikázal .	Rozviažte	1	Perf
Do chrobákovho obydlia dopadalo tlmené červené svetlo a sladká vôňa bola oveľa prenikavejšia .	dopadalo	3	Perf
Vznikla v tretej štvrtine 11 . storočia ( medzi rokmi 1050 – 1076 ) a bola určená na používanie v rímskej kúrii a pre pápežských legátov .	Vznikla	0	Perf
“ Tak ma pusť , “ vyhŕkla som .	vyhŕkla	6	Perf
Jemu to pripadalo ako večnosť .	pripadalo	2	Imp
Znehybnel som , ležiac na boku : to vzlykala Marga .	vzlykala	8	Imp
“ Veď vravím , “ zasmial sa aj Chris .	zasmial	5	Perf
Zazrel bielko okolo dúhoviek Júliiných očí .	Zazrel	0	Perf
Neverím , že by sme mohli niečo zmeniť za nášho života .	zmeniť	7	Perf
Rovnako prekvapujúco dobre vedela rozprávať bez pohybovania perami .	vedela	3	Imp
“ Hrozne sa na tých hodinách nudím .	nudím	6	Imp
Jedného dňa tam zájdem .	zájdem	3	Perf
“ Na mňa ? “ vyjachtala som .	vyjachtala	5	Perf
Nemohla som si spomenúť , odkiaľ ju poznám .	spomenúť	3	Perf
Nikdy by jej nezišlo na um , že bezvýsledný čin nemá význam .	nezišlo	3	Perf
Každá od neho však utiekla , pretože len čo otvoril ústa , ovalil ich zápach cesnaku a syra .	utiekla	4	Perf
Ak si želáte dievča , povedala , zariadime to .	želáte	2	Imp
Vymenoval som štyri číslice , ktoré tvorili číslo mojej izby .	tvorili	6	Imp
A vyhrávam .	vyhrávam	1	Imp
“ Našla si ju ? “ spýtal sa Chris .	Našla	1	Perf
Vláda prijme opatrenia , ktoré zabránia možnosti subjektívneho rozhodovania štátneho zamestnanca vo všetkých oblastiach podnikania .	prijme	1	Perf
Uteč ! “ kričal .	kričal	3	Imp
Keď sa o tom dozvie , usporiada slávnostný obed .	usporiada	6	Perf
Obrátila som sa a zbadala som to prekrásne staré autíčko .	Obrátila	0	Perf
Keď zbadal , že mám poloprázdny pohár , hneď mi dolial .	zbadal	1	Perf
Keď Šer Chán narátal do desať , otvoril oči .	otvoril	7	Perf
Iba my s Chrisom sme tak zúrivo nepísali a nehrbili sa nad lavicami .	nepísali	7	Imp
A tu či inde sa v úplnej tajnosti nachádzali riadiace mozgy , ktoré koordinovali toto úsilie a určovali politickú líniu : rozhodovali o tom , že tento fragment minulosti sa zachová , tento sa sfalšuje a ďalší prestane jestvovať .	určovali	17	Imp
“ Neuveriteľné ! “ zvolala Blythe .	zvolala	4	Perf
Tatko sa hneval na deti , lebo ukrutne vyvádzali , a mamka sa hnevala na tatka , že je precitlivený .	hneval	2	Imp
Nikto sa mu nečuduje .	nečuduje	3	Imp
“ Nechcela som ťa nahnevať , “ vravela som rozpačito .	vravela	7	Imp
Veľmi dobre som vedel , že má pravdu .	vedel	3	Imp
Ten film vysielali veľmi zriedka .	vysielali	2	Imp
Musím rešpektovať Marginu požiadavku , aby som deťom nič nepovedal , a zároveň musím nájsť pre Irmu nejaké presvedčivé vysvetlenie .	Musím	0	Imp
Maja tomu nechcela veriť .	veriť	3	Imp
“ To je idiotský nápad ! “ zvolal , ale videla som , že sa mu to páči .	videla	10	Imp
Ďalšie zasadnutie zborového presbyterstva sa konalo dňa 16 . 5 . 2004 .	konalo	5	Imp
Rýchlo ju prezrela a zistila , že sa na svet pýtajú šteniatka .	zistila	4	Perf
Jeho nádej opäť zhasínala .	zhasínala	3	Imp
Lori nemala ani najmenšie podozrenie , že vo mne sa prebudilo zviera .	prebudilo	10	Perf
Večer vhupli všetky včielky do postieľok a vytiahli si deky až pod nos .	vhupli	1	Perf
No teraz ho Akéla zavolal .	zavolal	4	Perf
Keď človek dostane vši , je to nepríjemné .	dostane	2	Perf
Blythe stála v strede a vystrúhala na Ricka grímasu , aby si ju všimol .	všimol	13	Perf
Pinta je predsa polovica štvrtky a štyri štvrtky idú do galóna .	idú	8	Imp
Človek očakával , že ho zabijú .	zabijú	5	Perf
Každý teraz prosil o žiletky .	prosil	2	Imp
Nečakal na myšiakove ďalšie požiadavky a dvaapolmetrovým skokom sa vzdialil .	vzdialil	9	Perf
Ja ta pôjdem inokade .	pôjdem	2	Imp
Snažím sa vidieť päť . "	Snažím	0	Imp
“ Nič sa nestalo , “ odpovedala som hanblivo .	odpovedala	6	Imp
Usmiala som sa .	Usmiala	0	Perf
Smiala som sa , akoby sme boli len kamoši , ale keď som si sadla do auta vedľa Shannon , naskočili mi na ruke zimomriavky , keď sa ma Chris dotkol .	dotkol	30	Perf
Faikiným rukojemníkom som zostal až do chvíle , keď sa rozhodla , že odíde , a vydala sa .	odíde	13	Perf
Vysvetlila môj výrok ohľadom časopisov v konkrétnom zmysle .	Vysvetlila	0	Perf
Syme zdvihol zrak . " Tam prichádza Parsons , " poznamenal .	zdvihol	1	Perf
Toľko stačilo , aby sa vydesilo aj dieťa .	vydesilo	5	Perf
Cestou zoťali strom — budú ho potrebovať , ako baranidlo , keď budú chcieť vyvaliť bránu .	potrebovať	6	Imp
Ponáhľala som sa , lebo ak pozrú z okna , uvidia , ako sedíme na múre .	Ponáhľala	0	Imp
V takomto prípade hovoríme o tzv . primárnej prevencii .	hovoríme	3	Imp
“ Dokázal som to ! “ zvolal .	Dokázal	1	Perf
Klesol som na stoličku .	Klesol	0	Perf
Kapitán sa opäť zamyslel .	zamyslel	3	Perf
Nemám čas , “ odvrkla som .	Nemám	0	Imp
“ Vezmem ho , “ zvolala som a letela k nemu , “ určite je to pre teba . “	Vezmem	1	Perf
V dome zavládlo hrobové ticho .	zavládlo	2	Perf
So zlovestným úškľabkom na tvári Uršuľa chrlila na Arielu hromy ‐ blesky .	chrlila	6	Imp
Budem škaredá ! “ vravela a nedočkavo obracala ošúchané listy .	obracala	7	Imp
Chris sa na mňa usmieval , a tak som sa usmiala i ja naňho .	usmiala	10	Perf
Svoje životy zasvätili dobytiu sveta , ale vedia aj to , že vojna má sa viesť do nekonečna a nemá ju korunovať víťazstvo .	vedia	7	Imp
Nechápeš , že smrť jednotlivca nie je vôbec smrť .	Nechápeš	0	Imp
“ Už to mám ! “ vyskočila zrazu Maja .	vyskočila	6	Perf
Neviditeľní jazdci na koňoch sú vyjadrením predstavy o zlých duchoch , schopných ubližovať človeku odnesením jeho duše do podsvetia .	ubližovať	12	Imp
“ Naozaj , to je zaujímavé , “ poznamenala Maja .	poznamenala	8	Perf
Na zvončeku za sebou uvidel Maju .	uvidel	4	Perf
" Môže to trvať dlho , " odvetil O ' Brien . " Ty si ťažký prípad .	odvetil	7	Perf
Šmátrala som okolo seba a hľadala môj poklad .	Šmátrala	0	Imp
Opatrne vyzrela z komôrky .	vyzrela	1	Perf
Namiesto toho urobila večeru , ako na zmierenie , a celú večnosť čakala , že sa vrátim .	urobila	2	Perf
“ Chcela by som , aby ste mi vyveštili budúcnosť , ale nemám veľa peňazí . “	Chcela	1	Imp
“ Nemá čas .	Nemá	1	Imp
Vilko spal v kuse dva dni a dve noci .	spal	1	Imp
Človeka to bohvieako nezaujímalo , popíjal z pohára a škriabal na papier tie svoje znaky .	popíjal	5	Imp
“ Keby som nevedela , že máte bezpečnostný systém , “ doberala som si Chrisa , “ preliezla by som plot a skočila dnu . “	nevedela	3	Imp
Otvoril mešec a zacinkal .	zacinkal	3	Perf
Bola v nej jedna posteľ .	Bola	0	Imp
Okamžite som ich vytiahol .	vytiahol	3	Perf
Opice , čo držali Mauglího , sa zaškerili a pustili ho .	zaškerili	7	Perf
Drž ! “ povedal .	Drž	0	Imp
Vylial som zvyšnú vodku do pohára .	Vylial	0	Perf
Koľkokrát Aladin počul , ako po nich pokrikujú tie isté slová !	pokrikujú	7	Imp
Uvažovala som , akú časť pretekov teraz v duchu pláva .	pláva	9	Imp
Vilko najprv reptal , ale potom ho Maja nespoznávala .	nespoznávala	8	Imp
“ Nenávidí Mauglího a túži po pomste , “ vysvetľoval Baghíra .	túži	4	Imp
Tam oslávili Majino vyslobodenie .	oslávili	1	Perf
Nasleduje objavenie sa volchva v Rostove , udalosti v Polocku , sucho a Polovci .	Nasleduje	0	Imp
Pritisla sa mi tam tvár Dolory .	Pritisla	0	Perf
Nasledovali ďalšie veci , ktoré boli podľa Sergeja podpichovaním na Cerberovu adresu , hoci jeho meno sa tam nespomínalo .	nespomínalo	18	Imp
“ Pozri , ocko ! “ zvolala Jane .	zvolala	6	Perf
Zostupujúc do hĺbok duševných priepastí , ( seba ) obnažuje , bičuje ( sa ) .	obnažuje	9	Imp
Pravdu povediac , nemala som to v úmysle .	povediac	1	Perf
Možno budeš musieť čakať .	musieť	2	Imp
“ Švihaj , Dean ! “ zakričal Rýchlik .	Švihaj	1	Imp
Keď zistil , že je to Meg , potešil sa .	zistil	1	Perf
Tá za desaťročia sústredeného výskumu vyprodukovala stovky monografických a časopiseckých spracovaní danej témy .	vyprodukovala	5	Perf
V nasledujúcich dňoch som márne čakal , že niekto z nich mi zverí nejaký list .	zverí	12	Perf
Vedomie más treba ovplyvňovať len negatívnym spôsobom .	ovplyvňovať	3	Imp
Vzal kôš a deku , do ktorej sme sa spolu zabalili .	zabalili	10	Perf
Postávali v tieni lieštiny .	Postávali	0	Imp
Zajac mohol byť vykladaný v systéme predkresťanských názorov jednak ako symbol plodnosti / dodnes spájame na veľkú noc vyobrazenia zajacov s vajíčkami , Nemci počas tohto sviatku hľadajú v záhrade vajíčka ukryté veľkonočným zajacom / .	hľadajú	27	Imp
Druhou činnosťou , ktorú v Ostrihome klerikom zakázali , bolo úžerníctvo .	zakázali	7	Perf
Jednostaj prichádzali a odchádzali všakovakí väzni : distribútori drog , zlodeji , banditi , šmelinári , opilci , prostitútky .	prichádzali	1	Imp
“ Prečo by si mal utiecť ? “ spýtal sa .	spýtal	8	Perf
Meno ruže bola totiž jediná beletria , ktorú v jeho knižnici vyhrabala medzi odbornou literatúrou .	vyhrabala	11	Perf
Zakryte nádobu pokrievkou a nechajte vychladnúť na izbovú teplotu .	Zakryte	0	Perf
Premáhal ho spánok .	Premáhal	0	Imp
Márne sa prezliekala , v našej izbe sa vždy našlo niečo , čo smrdelo kravínom .	prezliekala	2	Imp
V poslednom čase ju Ministerstvo hojnosti veľmi obľubovalo .	obľubovalo	7	Imp
Tu boli zvyknutí vyberané spôsoby a správali sa podľa spoločenských pravidiel .	správali	6	Imp
Detský biblický tábor pripravujeme v prekrásnom prostredí Žiarskej doliny v dňoch 31 . 7 . až 7 . 8 . 2004	pripravujeme	3	Imp
Chodili jej normálnou poštou do školy , kde učila .	učila	8	Imp
Nato sa obrátil a bežal im na pomoc .	bežal	4	Imp
Naše hlasy sa donekonečna odrážali od orosených skál .	odrážali	4	Imp
Ľúbil som všetky ženy , s ktorými som mal pomer .	Ľúbil	0	Imp
Začal som pochybovať , či som v izbe sám .	Začal	0	Perf
Koho máte na mysli ?	máte	1	Imp
Mamu už dávno odniesli .	odniesli	3	Perf
Nespýtala som sa ho to .	Nespýtala	0	Perf
Tú ženu som nepoznal , nikdy som ju nestretol .	nestretol	8	Perf
“ Flip sa chcel do jednej hneď pustiť .	pustiť	7	Perf
Vážne prikývol .	prikývol	1	Perf
Čudné veci rozprávala Petronila o ľuďoch .	rozprávala	2	Imp
Cieľom Strany nebolo len to , aby medzi mužmi a ženami nevznikali vzťahy vernosti , nad ktorými nemala moc .	nevznikali	11	Imp
Táto povinnosť sa však nevzťahovala na produkty , ktoré sa jednak priamo a jednak symbolicky týkali základných prejavov kresťanského kultu .	týkali	15	Imp
Rozprávali sme sa až po pretekoch .	Rozprávali	0	Imp
A očervenel som .	očervenel	1	Perf
“ Čo tu robíš ?	robíš	3	Imp
“ Vari si môžem niekde chvíľu odpočinúť ! “ uštipačne odvetila .	odvetila	10	Perf
Pretože bolo kakarátky , nepohádali sa , ale išli spolu na zmrzlinu .	nepohádali	4	Perf
Šer Chán ich počúval zo svojho úkrytu z kroví .	počúval	3	Imp
“ Džafar , rozkazujem ti , aby si prestal ! “ zlostne skríkol sultán .	rozkazujem	3	Imp
Rodičia zostali prekvapene stáť .	stáť	3	Imp
Možno som vôbec nič nepovedal .	nepovedal	4	Perf
Neznášala som tieto slová .	Neznášala	0	Imp
Môj mozog zatiaľ začínal špekulovať .	začínal	3	Imp
" Máte dojem , že ste slobodnejší , než ste boli vtedy ?	Máte	1	Imp
Chcela by som mať kaktus .	mať	3	Imp
A tak sa stalo , že nakoniec som sa na jednej hodine roztriasla , keď som si predstavila niečo strašné : v budúcnosti ma čaká to isté , čo stihlo moju mamu .	predstavila	17	Perf
Keď preberal znova volant , prikryl mi ruky , ktoré ostali naspodu .	ostali	10	Perf
“ Aká ste nevzdelaná , milá moja ! “ zvolala Lolka .	zvolala	9	Perf
Aladin zle spal .	spal	2	Imp
Marga odchádzala prvá .	odchádzala	1	Imp
“ Tomuto ja hovorím najpotrebnejšie veci , “ výsmešne škriekala opica .	hovorím	3	Imp
Majine jemné krídelká sa jagali ako perly a zlatisté telíčko na slnku len tak žiarilo .	jagali	4	Imp
Pečať č . 4 sa našla v dvoch exemplároch .	našla	5	Perf
Chutilo jedlo vždy takto ?	Chutilo	0	Imp
“ Prepáč , Herkules .	Prepáč	1	Perf
Okamžite som ju spoznal .	spoznal	3	Perf
Aladin pristál na hromade šperkov .	pristál	1	Perf
Zasmiala sa .	Zasmiala	0	Perf
“ Počujem prenasledovateľov !	Počujem	1	Imp
SPIELBERG PREPUSTIL KAMERAMANA	PREPUSTIL	1	Perf
Vtedy som ju otočil k sebe .	otočil	3	Perf
Videl , ako Júlia zodvihla pohár a privoňala k nemu s úprimnou zvedavosťou .	zodvihla	4	Perf
Nedávno som odovzdal do skalického Záhorského múzea otcove denníky .	odovzdal	2	Perf
Usmieval sa .	Usmieval	0	Imp
“ Chyť volant , “ povedal a otočil sa k zadnému sedadlu , kde mal športový vak .	Chyť	1	Perf
Vyrába umelé potreby , ktoré nás aktivujú , vyprázdňujú , ničia a zotročujú .	ničia	10	Imp
Princezná Jazmína pozerala z okna do hlbokej púštnej noci .	pozerala	2	Imp
Vláda v každom prípade prijme kroky na zvýšenie motivácie rodičov a ich detí študovať , respektíve skutočne plniť povinnú školskú dochádzku .	prijme	4	Perf
Pri slávnostných obradoch ju potom niesol jej najuznávanejší člen .	niesol	5	Imp
Fridolín stál opäť na nohách .	stál	1	Imp
“ U nás budete zaručene spokojní , inak vám vrátime peniaze ! “ kričal .	vrátime	9	Perf
Sporenie prostredníctvom individuálnych účtov vytvorí priestor , aby v budúcnosti o čase svojho odchodu do dôchodku mohol rozhodovať sám občan .	rozhodovať	17	Imp
Mal som príležitosť poznať dievčinu , ktorá sa volala Lori , ale ona sa stratila .	volala	8	Imp
Taniere obložte hlávkovým šalátom , na ktorý servírujte kuskus a zeleninovú zmes .	servírujte	7	Imp
Pomyslel som si , že sa nebojí môjho semena .	nebojí	6	Imp
Napokon preletel cez domček slimáka Oskara a skončil na baze .	preletel	1	Perf
“ Nechceš ochutnať ? “ spýtala sa bosorka .	Nechceš	1	Imp
Keď som to vyslovil , prebehli mi po tele zimomriavky .	prebehli	5	Perf
Niekto ťa prepadol ? “ vypytovala sa hlavná sestra .	vypytovala	5	Imp
Išla prvá , ja za ňou a ocitli sme sa uprostred izby .	ocitli	7	Perf
Tá relácia , i keď varovala pred známymi dôsledkami zbožšťovania jedla , ma definitívne presvedčia o tom , čo som už dávnejšie tušil .	presvedčia	14	Perf
Napokon sa ozvalo klopanie na dvere .	ozvalo	2	Perf
Nezáleží na tom , čo povieš či urobíš ; záleží jedine na tom , čo cítiš .	cítiš	15	Imp
Vláda sa zároveň zaväzuje presadiť v zdravotníctve tvrdé rozpočtové obmedzenie tak , aby od roku 2004 nedochádzalo k tvorbe nového dlhu .	nedochádzalo	16	Imp
V podstate som blufovala .	blufovala	3	Imp
Ten okamih prerušil prenikavý zvuk .	prerušil	2	Perf
Lykožrút Fridolín potom odniesol víťaza medzi jasajúcich divákov .	odniesol	3	Perf
Vonku opäť zaznel dupot čižiem .	zaznel	2	Perf
Pokúšala by sa presvedčiť ma , že nemá zmysel rozčuľovať sa .	presvedčiť	3	Perf
Miestnosť bola priveľmi stiesnená , lebo všetky steny dookola podopierali nespočítateľné množstvo zaprášených rámov naukladaných jeden na druhý .	podopierali	9	Imp
“ Idem , “ podujala som sa .	Idem	1	Imp
Zdvihol zrak na O ' Briena .	Zdvihol	0	Perf
Reformátori 11 . storočia však už dospeli k precíznejšej formulácii , ktorá , podľa nás , reprezentuje nimi presadzovanú snahu o čo najpresnejšie vymedzenie sfér vplyvu svetskej a cirkevnej moci .	dospeli	6	Perf
Pravdepodobne sa napokon nevyrobili vôbec nijaké topánky .	nevyrobili	3	Perf
“ Pripravuje ju podľa starého rodinného receptu . “	Pripravuje	1	Imp
V ten večer asi vedela , že je to naše posledné stretnutie .	vedela	4	Imp
Abdullah povedal , že raz budem bohatý . “	povedal	1	Perf
Vláda zruší poplatky za vyňatie pôdy z poľnohospodárskeho pôdneho fondu .	zruší	1	Perf
Ukazuje sa teda , že tým stredoslovenským nárečím , ktorÉ Štúrovci povýšili na spisovný JAZYK , bol prestížny liptovský mestský jazyk .	Ukazuje	0	Imp
Vždy som mával zvláštny pocit , že ten človek ma neznáša .	neznáša	10	Imp
Niečo tu nesedí .	nesedí	2	Imp
Samozrejme , že Maja s Vilkom zablúdili v jesennej hmle ako prví .	zablúdili	6	Perf
“ To znie prekrásne .	znie	2	Imp
Nemám pravdu ?	Nemám	0	Imp
Vidím , že začínam strácať niť .	strácať	4	Imp
Začala som výčitkami , ale teraz pokračujem radami do nového roku .	pokračujem	6	Imp
Terk bežala k lagúne a vytiahla Tarzana , ktorý sa poriadne napil vody .	bežala	1	Imp
Prísnosť uhorských „ protialkoholických “ kánonov a aj ich početnosť svedčia o Kolomanovej snahe vykoreniť z klerických kruhov neduh nadmerného požívania alkoholu .	svedčia	10	Imp
“ To by bolo niečo pre mňa , “ vravel si .	vravel	9	Imp
Chris mi otvoril a ja som nastúpila .	nastúpila	6	Perf
Chceš povedať , že Amy Wyseovej sa páči nejaký chalan ?	Chceš	0	Imp
Popoludní o tretej sa začínali Majstrovstvá Makovej lúky v skákaní .	začínali	4	Imp
Pomedzi stromy zbadala chalúpku , v ktorej bývali trpaslíci .	bývali	7	Imp
Takého neposedného spoločníka ešte nestretla .	nestretla	4	Perf
Veľa sa naučila a nazbierala dôležité skúsenosti .	nazbierala	4	Perf
“ Môžeš si dať za mňa , “ povedala som .	dať	3	Perf
Keď som mala bundu na sebe , zistila som , že ju nepotrebujem .	nepotrebujem	12	Imp
“ Sľúbil mi to . “	Sľúbil	1	Perf
Až doteraz vlastne nepostrehol , aký je chudý a slabý .	nepostrehol	3	Perf
Aj ona sa mi zahľadela do očí .	zahľadela	4	Perf
Z kúpeľne som vyšiel o pol hodiny .	vyšiel	3	Perf
Niečo ma však na tom znepokojuje .	znepokojuje	5	Imp
Malá Maja sa začervenala .	začervenala	3	Perf
Teraz ťa pozývam ja , povedal som , ale Lori odvetila , že nič nechce .	pozývam	2	Imp
Po známej zrážke s okrajom bazéna ma boleli päty a prestala som si veriť .	veriť	13	Imp
Sadli si na rímsu a Maja zreteľne videla , čo sa dnu deje .	videla	7	Imp
Stúpame po schodíkoch , ktoré jej dali meno , a mierime na Karlovo naměstí .	Stúpame	0	Imp
“ Tú šóru v žiadnom prípade nezvládneme , “ povedal Rýchlik a začal cúvať .	nezvládneme	6	Perf
Vstúpil tam dozorca .	Vstúpil	0	Perf
Priplával k okraju a stiahol polystyrénovú dosku .	stiahol	4	Perf
Pocítila prenikavú , pálčivú bolesť .	Pocítila	0	Perf
Potom vložila ten lístok do zásuvky , vytiahla z nej kľúč s ťažkým bronzovým štítkom , na ktorom bolo číslo izby , a strčila mi ho do ruky .	strčila	23	Perf
Začala som mať podozrenie už pred rokom , povedala .	Začala	0	Perf
Potom si ľahli spať .	ľahli	2	Perf
Nemôžete ho minúť . “	Nemôžete	0	Imp
V jednom rohu podložky je ventil , po jeho otvorení pena nasáva vzduch , nafukuje sa .	nafukuje	14	Imp
Chris šliapal vodu a ako psík krúžil okolo mňa .	šliapal	1	Imp
Prekvapene som na ňu pozrela .	pozrela	4	Perf
Cestou zoťali strom — budú ho potrebovať , ako baranidlo , keď budú chcieť vyvaliť bránu .	zoťali	1	Perf
Piateho mája sa začalo Pražské povstanie a z rádia sa ozývala výzva o pomoc .	ozývala	10	Imp
A zdvihol sa .	zdvihol	1	Perf
Stretla ho v tieni čiernej bazy , keď počúvala spev červienky .	Stretla	0	Perf
Znehybnel som , ležiac na boku : to vzlykala Marga .	ležiac	3	Imp
Každý sa očistí .	očistí	2	Perf
Meg márne odmietala , lebo podľa starej dohody s Hádesom vymenila svoju slobodu za život bývalého priateľa .	odmietala	2	Imp
Pomyslel som si , že keď ju tam zvalili a vláčili po uliciach , podarilo sa jej nejako utiecť , ako utekajú sochy , a prišla sa postaviť sem .	vláčili	10	Imp
Schuti som sa zasmiala , keď šaškoval na trávniku .	šaškoval	6	Imp
Maja ho ustavične chválila a polichotený Vilko len tak rástol .	chválila	3	Imp
V ten deň od rána lialo .	lialo	5	Imp
Prisunula sa ku mne a spýtala sa , či som v poriadku .	Prisunula	0	Perf
“ Nemôžem to počúvať ! “ zamrmlala som a pohodlne sa oprela .	oprela	11	Perf
Bál som sa , že moji rodičia sa namiesto toho , aby ma bránili , postavia na stranu útočníka .	bránili	13	Imp
Zoskočili sme naraz .	Zoskočili	0	Perf
Vták opäť kývol lesklou čiernou hlavou .	kývol	2	Perf
Vstal som .	Vstal	0	Perf
Zhlboka sa nadýchla , poriadne si vydrhla predné nohy a ostala nehybne sedieť na liste ako prikovaná .	vydrhla	6	Perf
Od straníkov sa vyžadoval podobný názor , aký mali starovekí Židia , ktorí síce vedeli , že všetky iné národy uctievajú nepravých bohov , ale to bolo všetko , čo o nich vedeli .	vedeli	14	Imp
Čo tu robíš sama v noci ?	robíš	2	Imp
Ako som takto táral , pochopil som , že rozprávam hlúposti .	táral	3	Imp
Zlá víla sa princovi Filipovi posmievala , no prezradila mu , že iba on môže zrušiť Zorničkinu kliatbu , ak ju pobozká .	zrušiť	15	Perf
“ Mal som vedieť , že to je tvoja práca ! “	vedieť	3	Imp
Soni nedodržala našu dohodu , nenapísala nič .	nenapísala	5	Perf
Pokúšal sa jej to vysvetliť tak , aby pochopila . " Toto bol výnimočný prípad .	vysvetliť	4	Perf
Mnohí z nás s nimi nadviazali hlboké priateľstvá , spoznali sme ich krehučké duše prahnúce po láske , priateľstve a uznaní .	spoznali	9	Perf
“ Prosím , ja uznávam , že Ferdo je jednotka .	uznávam	4	Imp
Týchto ľudí som stvoril ja , vyjachtal som .	vyjachtal	6	Perf
Vyliezla spod listu a obzerala sa okolo seba .	obzerala	4	Imp
Mama mi naznačila , že nemám otvárať .	nemám	5	Imp
Koňak im udrel do hlavy .	udrel	2	Perf
Rad sa predlžoval a čoskoro poskakovala po telocvični polovica študentov .	predlžoval	2	Imp
Skĺzla som z dosky a ponorila sa .	ponorila	5	Perf
“ Naozaj ? “ zvolala prekvapená Snehulienka .	zvolala	4	Perf
Preskúmal jej dlhé prsty , pekne vytvarované nechty , dlaň zatvrdnutú ťažkou prácou s množstvom mozoľov , hladkú pokožku pod zápästím .	Preskúmal	0	Perf
Kým som tam osamote sedel , začul som na chodbe kroky a hlasy .	začul	6	Perf
Nezískala ho ani Matica , ani občianske združenie Komorra a nedarí sa to ani gymnáziu .	nedarí	10	Imp
“ Ako sa voláš a kde bývaš ? “ spýtala sa toho stvoreniatka .	spýtala	9	Perf
Syma vyparia .	vyparia	1	Perf
Zrazu zažmurkal a prekvapene na oboch pozrel .	zažmurkal	1	Perf
Otvoril mešec a zacinkal .	Otvoril	0	Perf
Išiel som za ňou , akoby som kráčal v ústrety budúcnosti .	Išiel	0	Imp
Namiesto toho urobila večeru , ako na zmierenie , a celú večnosť čakala , že sa vrátim .	vrátim	16	Perf
Pustil Winstona a zároveň ho postrčil dozorcom .	postrčil	5	Perf
Napriek tomu som stratil formu .	stratil	3	Perf
Otočila sa a odletela .	odletela	3	Perf
Vytrhla som Blythe fotoaparát a odfotila som ich .	Vytrhla	0	Perf
Vtáky spievajú , proleti spievajú , Strana nespieva .	nespieva	7	Imp
Pozrela som naňho a šťastne sa usmiala .	usmiala	6	Perf
“ A navyše mám tetovačku , “ ochotne doplnil Omar .	mám	3	Imp
V džungli by ste nenašli šťastnejšieho tvora .	nenašli	4	Perf
Skormútený Herkulovou tvrdohlavosťou odchádzal a nechal ho vznášať sa v oblakoch .	vznášať	7	Imp
K tejto problematike patria podľa nášho názoru i právne normy , ktoré upravujú niektoré procesné záležitosti .	patria	3	Imp
V ten deň , keď som sa prebudila chorá , som sledovala z obloka návrat osadenstva vily .	sledovala	11	Imp
Vezmeš si tie Finneganky ? “	Vezmeš	0	Perf
Nová Koncepcia ochrany prírody a krajiny bude obsahovať racionálny systém manažmentu chránených území , prehodnotí ich cieľový stav a navrhne opatrenia a programy starostlivosti tak , aby chránené územia slúžili aj verejnosti .	slúžili	29	Perf
“ Poď sem , sadni si vedľa mňa . “	Poď	1	Imp
“ Máš nejaký problém ? “ spýtala sa Jill , keď plávala popri mne .	Máš	1	Imp
No toto ! “ zvolala Cruella .	zvolala	4	Perf
Prejavila ľútosť .	Prejavila	0	Perf
Prikrčená som vyliezla na vrchol strechy , chvíľu som balansovala a opatrne som zliezla na opačnú stranu .	vyliezla	2	Perf
“ Nezmysel , to by Radža neurobil . “	neurobil	6	Perf
Nahradilo ich niekoľko všeobecných slov , čím sa zlikvidovali .	Nahradilo	0	Perf
Vláda sa bude usilovať o postupné zapájanie kapacít nášho obranného priemyslu do štruktúr európskeho obranného priemyslu .	usilovať	3	Imp
Niet pochýb , že nikdy nemohlo jestvovať obdobie , keď to bolo celkom bežné .	Niet	0	Imp
Dôraz tentoraz patrí na slovo jedinečný .	patrí	2	Imp
Kala bábätko vybrala a v tej chvíli prestalo plakať .	plakať	8	Imp
Osobitne by sme si chceli povšimnúť právne normy , v ktorých ide o odvádzanie desiatku klérom .	povšimnúť	5	Perf
V tomto omámení som si spomenul na niečo zvláštne , čo som kdesi čítal alebo počul .	čítal	13	Imp
Potom som sa po špičkách odkradla do kuchyne a potichu som vypla hodiny .	odkradla	5	Perf
Zhlboka sa nadýchla , poriadne si vydrhla predné nohy a ostala nehybne sedieť na liste ako prikovaná .	sedieť	12	Imp
Beztak tie pracovité mravce nemohol ani cítiť .	nemohol	4	Imp
Na bielizníku mi nechala odkaz : “ Dúfam , že si sa dobre bavila , srdiečko . “	Dúfam	7	Imp
Podľa mojich predstáv sa vracali do pekných domov s vyhrievanými bazénmi .	vracali	4	Imp
Adresátom jej listov bol otec , a ten sedel vo väzení .	sedel	8	Imp
Počas jazdy sa Rýchlik a Jill hádali , ktorú stanicu naladia .	hádali	6	Imp
Lúče slnka , ktoré pretínali okno priečne , dopadali na zaprášené dosky stolov .	dopadali	8	Imp
“ Tieto zbrane ti pomôžu zvíťaziť nad zlom , “ povedali mu .	zvíťaziť	5	Perf
No človek sa nevzdáva .	nevzdáva	3	Imp
Odviazal kôš a podal mi ho .	podal	3	Perf
Tak znie neodvolateľné proroctvo o osude jeho umenia .	znie	1	Imp
Nálože jeho nenávisti explodujú .	explodujú	3	Imp
Hook sa otočil k pirátovi Smíovi a posmešne napodobnil dievčatko .	otočil	2	Perf
“ Ani sa nečudujem , že pre ňu nemôžete nič vymyslieť .	nemôžete	8	Imp
Chytil ma za ruku a bežali sme dolu kopcom až k svetlám .	Chytil	0	Perf
Vilko najprv reptal , ale potom ho Maja nespoznávala .	reptal	2	Imp
Vláda bude analyzovať možnosti zavedenia rovnej dane .	analyzovať	2	Imp
A komentovali ste tvoje veľdiela o sexuálnych nenásytníkoch .	komentovali	1	Imp
Ako vyzerá herec snov ?	vyzerá	1	Imp
Ako predpokladal , pán Charrington nerobil s prenájmom izby nijaké drahoty .	predpokladal	1	Imp
Vedela som , že obaja túžime , aby táto čarovná noc trvala večne .	túžime	5	Imp
Samo Gorze sa na začiatku 11 . storočia dostalo vďaka zásahu svojho diecézneho biskupa do rúk clunyjského reformátora Viliama z Dijonu .	dostalo	8	Perf
“ Ty zradná potvora ! “ oboril sa na ňu .	oboril	6	Perf
“ Už letím ! “ kričí Polly .	kričí	5	Imp
Na druhý deň som zistil , že ležím celkom oblečený na skladacej posteli .	zistil	4	Perf
Zámok sa zatriasol , keď dedinčania vrazili baranidlom do brány .	zatriasol	2	Perf
Nastolíme po voľbách zmenu - odhalením zbohatlíkov , mafiánov , delikventov , korupčníkov a lobistov pri stálom sledovaní blaha občana .	Nastolíme	0	Perf
Na tvári som jej videla , že ju to vzalo , a keď vstala zo stoličky , bála som sa , že odíde z kuchyne .	vstala	13	Perf
Abu sa zamračil .	zamračil	2	Perf
Ak má môj rod zomrieť , tak chcem zomrieť i ja , pomyslela si .	zomrieť	8	Perf
Abuov citlivý noštek vykrúcalo od najodpornejších pachov a jeho jemné ušká urážalo nedôstojné pokrikovanie .	urážalo	11	Imp
Odložil som pohár a očami som opäť zablúdil k protiľahlým stolom , pri ktorých sedeli spomínaní ľudia .	Odložil	0	Perf
Napokon sme z kríkov vybrali Chrisov bicykel a pomaly sme vyšli na ulicu .	vybrali	4	Perf
“ Ale mne veriť môžeš . “	môžeš	4	Imp
Omar prikývol a usmial sa .	usmial	3	Perf
Bohatstvo a privilégiá sa najľahšie ochraňujú , keď majú spoločného vlastníka .	ochraňujú	5	Imp
Vieš o tom , že Jaro zomrel ?	Vieš	0	Imp
A hneď volala motýľa Emanuela , aby ju tam v noci nenechával .	nenechával	11	Imp
Vtedy som vyriekol jediné slová , o ktorých som si myslel , že vystihujú moje rozpoloženie .	vystihujú	13	Imp
Nejestvoval ; nikdy nejestvoval .	Nejestvoval	0	Imp
Na manifestáciách vždy nesiem jednu časť transparentu .	nesiem	3	Imp
Vláda dopracuje a predloží návrh zákona o voľbách do Európskeho parlamentu tak , aby Slovenská republika bola pripravená voliť poslancov do tohto orgánu v prvom polroku 2004 .	voliť	18	Imp
Nakukol pomedzi húštinu a uvidel troch tvorov v šatách namiesto kožušiny .	Nakukol	0	Perf
Pohľad opäť sústredil na stranu .	sústredil	2	Perf
Všetci len oddychovali pod slnečníkmi z ďatelinových lístočkov .	oddychovali	2	Imp
Tigríča jej nešikovne skočilo do náručia a princezná zacítila mäkulinkú teplú guľku s hodvábnou srsťou .	zacítila	8	Perf
Zazrela som ho , keď vystrkoval z obloženia svoj odporný rypák .	Zazrela	0	Perf
Muž s prenikavým hlasom po jeho ľavici bezohľadne rozprával ďalej .	rozprával	8	Imp
Ostávala po ňom mokrá stopa .	Ostávala	0	Imp
Mama sa správala odmerane .	správala	2	Imp
Herkules zajasal .	zajasal	1	Imp
Povedal si , že môžem ostať s tebou . “	ostať	5	Perf
Kapitoly vytvoria protiváhu hlboko miestne ukotveného archeologicko ‐ historického prehľadu a predkladajú nový zorný uhol na skúmanú tému .	predkladajú	11	Imp
Vláda však v tejto súvislosti zastáva názor , že NATO i naďalej zostane hlavnou inštitúciou , prostredníctvom ktorej budú európski a severoamerickí spojenci i naďalej riešiť bezpečnostné otázky transatlantického rozmeru .	zastáva	5	Imp
Winston neodvetil .	neodvetil	1	Perf
Fráza " za nový , šťastný život " sa tam objavila niekoľkokrát .	objavila	10	Perf
u Martina nemám čo do zvonca .	nemám	2	Imp
Lulu tigra najprv prekvapene sledovala , ale po chvíli sa rozosmiala .	sledovala	4	Imp
Snažím sa vidieť päť . "	vidieť	2	Imp
Snažil sa vyliezť po steble trávy hore , ale steblo sa pod jeho váhou nebezpečne naklonilo nabok .	Snažil	0	Imp
Chrisova mama zabalila chlebíčky po štyroch do plastovej fólie a ešte do alobalu .	zabalila	2	Perf
Majino mužstvo zvíťazilo .	zvíťazilo	2	Perf
Zabočila za roh a pridala plyn .	pridala	4	Perf
“ Nemôžem , “ čo znamenalo , že ho nemôžem pozvať dnu , a nie bozkávať sa .	nemôžem	9	Imp
“ Musím si to prečítať odznova , “ povedala som , zúfalo listujúc v učebnici .	prečítať	4	Perf
Postav ho na okrúhly stôl .	Postav	0	Perf
V zásade príslušnosť k týmto trom skupinám sa nededí .	nededí	8	Imp
Netušili však , akí je múdry !	Netušili	0	Imp
Opice , čo držali Mauglího , sa zaškerili a pustili ho .	pustili	9	Perf
Na schodišti som mal opäť zvláštny pocit , že ma niekto sleduje , a znova som rýchlym pohybom otočil hlavu , akoby som ho chcel nečakane prekvapiť .	prekvapiť	26	Perf
Musíte byť tolerantní , musíte pochopiť , že som nemal iné východisko .	Musíte	0	Imp
“ Často som brával Mauglího na potulky džungľou .	brával	3	Imp
Blahoželám , slečna , povedal som s predstieraným nadšením , využijúc všetky svoje herecké schopnosti .	Blahoželám	0	Imp
Náhlila som sa do kabínky pri bazéne , napchala som mokré veci do vaku , obula si mokré tenisky a vybehla von .	napchala	8	Perf
“ Pripadá mi to najmenej nebezpečné . “	Pripadá	1	Imp
Jeden výhonok bol fuksiovej , druhý tehlovej farby , hoci zrejme vyrastali z jediného koreňa .	vyrastali	11	Imp
O niekoľko dní zmenila pracovné miesto : z kravínov prešla do kancelárií na družstve , stala sa upratovačkou .	zmenila	3	Perf
Od tej chvíle som sa myšlienky , že tá mačka mi vidí do duše , nevedela zbaviť .	vidí	11	Imp
Nakoniec vstal .	vstal	1	Perf
Volám sa Kalif . “	Volám	0	Imp
Všetky formality vytrvalo vybavila naša kurátorka Justína Petrová , ktorá v tomto smere nepozná prekážky .	vybavila	3	Perf
Mama mi oznámila , že chceš ísť na vysokú a samozrejme , chcem ti podľa svojich možností pomôcť .	oznámila	2	Perf
Podľa Irminých pokynov – samotná Irma vybavovala všelijaké formality – ma poprosili , aby som odišiel z domu a vrátil sa podľa možnosti až večer .	odišiel	15	Perf
Lenže milé bábätko trhalo Jane obrázok z rúk .	trhalo	3	Imp
Čoskoro sa spriatelili a stále vymýšľali nové hry .	vymýšľali	5	Imp
Zišlo mu na um , že ešte stále nepozná jej priezvisko , ani jej adresu .	nepozná	8	Imp
Teraz ťa pozývam ja , povedal som , ale Lori odvetila , že nič nechce .	nechce	14	Imp
Ukrutne sa zľakli a hneď to hlásli svojmu veliteľovi .	hlásli	6	Imp
Mala pravdu a ja som to dobre vedel .	vedel	7	Imp
Raz si u mňa zabudol baseballovú čiapku .	zabudol	4	Perf
Väčšie zlá sústavne unikali ich pozornosti .	unikali	3	Imp
Tigríča sledovalo , ako sa rozkotúľali , a skočilo medzi ne !	skočilo	8	Perf
Jazmína váhala .	váhala	1	Imp
Vedela , že nemôže strácať čas .	Vedela	0	Imp
Zúčastniť sa mohol každý , kto mal krídla .	Zúčastniť	0	Perf
Poznala som aj všelijaké iné historky , podozvedala som sa ich , keď k mame chodili na návštevu ženy .	chodili	15	Imp
Veronika sa najprv urazila , ale keď jej Ferdo vysvetlil , že rehotanie je taká zvláštna psia choroba , trochu sa upokojila .	vysvetlil	9	Perf
Bolo to beznádejné , nedokázal sa zdvihnúť ani o centimeter .	zdvihnúť	6	Perf
Nemohla som pochopiť , ako to zo mňa vyletelo .	pochopiť	2	Perf
Klopanie sa opakovalo .	opakovalo	2	Imp
Možno moje postavy vedia hrať šach .	hrať	4	Imp
Napokon usúdil , že najbezpečnejším miestom je kantína .	usúdil	1	Perf
Začal písať o značkách aj seriál , pretože patria neodmysliteľne k našej civilizácii .	písať	1	Imp
Spolu s ním bývala v tom istom byte aj rodina s troma veľkými mládencami .	bývala	3	Imp
„ Čas , v ktorom žijem , viem , že je Tvojím darom .	žijem	5	Imp
Zaletela k nim , sadla na kvet a počúvala tiché zurčanie potoka .	Zaletela	0	Perf
“ Viem , “ povedala som a vystúpila z auta , “ ale ak budem myslieť len na zábavu , môžem ísť zametať chodníky . “	môžem	20	Imp
Zmĺkla som , lebo som si spomenula , ako sa moja mama pustila do pečenia aj po dvoch šichtách .	Zmĺkla	0	Perf
Začula ma a hneď na druhý deň mastila k hliadke .	mastila	7	Imp
" Kto vytrvá do konca , bude spasený .	vytrvá	2	Perf
Jej duša odletela do neba o polnoci , keď sa striedali storočia .	odletela	2	Perf
Našťastie sa mi podarilo zobudiť sa .	zobudiť	4	Perf
Môj úsmev do diaľky žiari , tvár zdobia mandľové oči .	zdobia	7	Imp
“ Kam ideme , Baghíra ? “ spýtal sa Mauglí .	ideme	2	Imp
Neodvážila sa otvoriť oči a ja som pochopil , že očakáva niečo strašné .	očakáva	10	Imp
Vzhľadom na vytrvalosť , akú prejavoval , som očakával , že takto zaboduje .	prejavoval	5	Imp
Už sa zberala preč , ale vo dverách sa otočila .	zberala	2	Imp
“ Musím sa učiť . “	Musím	1	Imp
Rozbehla som sa a skočila , pričom sa hladina rozbúrila ako po výbuchu .	rozbúrila	9	Perf
Mám osem nôh , osem očí a sedem chutí .	Mám	0	Imp
“ Mimochodom , “ poznamenal chrobák , “ zabudol som sa predstaviť .	predstaviť	11	Perf
Všetci sa uveličene zahľadeli hore .	zahľadeli	3	Perf
Maja volala o pomoc , čo jej hrdlo stačilo .	volala	1	Imp
Prešlo niekoľko dní a princezná ani len nepomyslela na návrat domov .	Prešlo	0	Perf
Uvedomila som si , že to , čo vravela , mohlo pokojne platiť aj na Chrisa .	mohlo	10	Imp
Pavol , ktorý bol do Fridy zaľúbený až po uši , sa zľakol a začal ju hľadať .	zľakol	12	Perf
Ja jeden mám .	mám	2	Imp
Rodinka prašivých túlavých psov zaliezla od strachu pod haldu kobercov .	zaliezla	4	Perf
Pomysli na slobodu , ktorou ťa Boh obdaril , na možnosti , ktoré sa vďaka tomu pred tebou otvorili .	obdaril	7	Perf
Uvidíme , ako do celé dopadne .	dopadne	5	Perf
Radili sme mu , aby išiel pomaly .	Radili	0	Imp
Povedala , že už neznesie život v takomto špicľovaní .	Povedala	0	Perf
Snažila som sa zachovať rozvahu , ale u Favatovcov sa zažínalo jedno svetlo za druhým .	zažínalo	10	Imp
Tarzan podrástol a veľmi rád si matku doberal .	podrástol	1	Perf
Napokon vstal , tackavo a hojdavo prešiel celou , hlboko ponoril ruku do vrecka na kombinéze a s rozpačitým výrazom podal mužovi s umrlčou tvárou ufúľaný kúsok chleba .	vstal	1	Perf
Zastali sme na červenú a Chris sa na mňa usmial .	usmial	9	Perf
Vláda považuje za jednu zo svojich priorít dôslednú reformu súdnictva , posilňovanie vymožiteľnosť práva a zásadnú zmenu v trestnej politike štátu .	považuje	1	Imp
Pošli ďalej !	Pošli	0	Perf
Na jeho ľavom konci bola stará studňa bez vody , pred studňou rástla marhuľa .	rástla	12	Imp
“ Čo by si chcela robiť v sobotu ? “ spýtal sa Chris a ja som na uchu zacítila jeho dych .	chcela	4	Imp
Barbie a Sandra sa zľakli .	zľakli	4	Perf
“ Vysvetlíme mu , že ja také niečo nikdy neurobím ! “	neurobím	9	Perf
Vyžaduje mnoho trpezlivosti , pokánia , sebazapierania a vernosti .	Vyžaduje	0	Imp
Nalial som aj sebe .	Nalial	0	Perf
Keď to rozprával Maji , spozornela .	rozprával	2	Imp
Našla tam Pegasa .	Našla	0	Perf
Len čo som ju uvidel , mal som pocit , že mi pripomína ktorúsi z hrdiniek klasickej ruskej literatúry .	uvidel	4	Perf
“ Môjmu kráľovskému uchu sa donieslo , že chceš ostať v džungli . “	ostať	9	Perf
Zišlo mu na um , že až doteraz ho zrejme nevidela na voľnom priestranstve v plnom dennom svetle .	Zišlo	0	Perf
Začnem podľa poradia , od fascikla s číslom 1 .	Začnem	0	Perf
“ Presne , “ odvetil Chris .	odvetil	4	Perf
Zväčša to boli obyčajní zločinci , ale našla sa tam aj hŕstka politických väzňov .	našla	7	Perf
Ja som však mohol odprisahať , že tie slová mi povedal N . T .	odprisahať	4	Perf
“ Naozaj sľubujem . “	sľubujem	2	Imp
Túto úlohu by mali zabezpečiť názvy jednotlivých kapitol .	zabezpečiť	4	Perf
Pavla výborne kryje Muf .	kryje	2	Imp
Keď sa zasa vrátili do triedy , pani učiteľka im prečítala zaujímavú rozprávku .	prečítala	10	Perf
Maja ju však nechala , nech rozpráva .	rozpráva	6	Imp
Ale mama na mňa vôbec nemyslela .	nemyslela	5	Imp
Spratal neuveriteľné množstvo kukuričných placiek a mľaskal pritom a navyše ich zlostil híkavým smiechom .	zlostil	11	Imp
Poď dolu , Omar .	Poď	0	Imp
Nemala som najmenšiu chuť rozoberať pred ním svoje zmätené pocity a zbabraný test .	rozoberať	4	Imp
Mama vošla do izby mlčky .	vošla	1	Perf
To nás veľmi teší .	teší	3	Imp
“ To rada počujem , “ vyhlásila Lienka .	počujem	3	Perf
Vláda bude podporovať vývoj a šírenie výrobkov i služieb šetriacich životné prostredie a v rámci legitímnych trhových nástrojov hľadať možnosti podpory malým a stredným podnikateľom zvyšovať investície do „ čistej “ výroby a environmentálnych podnikateľských aktivít .	hľadať	18	Imp
Rozbehla som sa a skočila , pričom sa hladina rozbúrila ako po výbuchu .	Rozbehla	0	Perf
Vláda prijme opatrenia na minimalizáciu možnosti vzniku korupcie a dopracuje systém kontroly zameraný na kontrolu použitia verejných prostriedkov , vrátane prostriedkov plynúcich z EÚ .	dopracuje	9	Perf
A potom som začal rozprávať v spánku .	rozprávať	4	Imp
Jednoznačne ide o účelovú mystifikáciu s cieľom zmanipulovať konanie bežného občana a obrať ho o posledné základné životné istoty .	obrať	12	Perf
Zároveň však Cluny urobilo veľký krok na ceste k libertas , lebo vytvorilo spoločenstvo ( zväčša ) úplne slobodných kláštorov , ktoré nepodliehali laikom .	nepodliehali	22	Imp
“ Tak poďme privítať môjho nápadníka . “	privítať	3	Perf
Bola horúca júlová noc a vládla dusivá spara .	Bola	0	Imp
Čím dlhšie som tam šliapala vodu , tým väčšia zlosť ma chytala .	chytala	11	Imp
Šľahali okolo nej , no zakaždým ju o vlások minuli .	minuli	9	Perf
Usilujem sa počúvať , ale myslím pritom na Chrisa .	myslím	5	Imp
“ Vezmem ho , “ zvolala som a letela k nemu , “ určite je to pre teba . “	letela	8	Imp
Winston si prečítal nevhodný článok .	prečítal	2	Perf
“ V Aquitare jedia červíky , otec !	jedia	3	Imp
Prepáčila by mi to , aj keby vedela , že som to odkladala kvôli nočnému astronomickému klubu s Chrisom ?	Prepáčila	0	Perf
Omar ležal chvíľu roztiahnutý na zemi .	ležal	1	Imp
Našťastie za prvým bukom stretli Truhlíka a zistili , že aj on má na otrokárov ťažké srdce .	zistili	7	Perf
V tejto súvislosti počíta s efektívnou podporou cirkví .	počíta	3	Imp
Vstal som a zamieril k pultu .	Vstal	0	Perf
Pripravovali sme definitívne vydanie Kiplingovho básnického diela .	Pripravovali	0	Imp
Barbie a Sandra ju pozorne počúvali .	počúvali	5	Imp
“ A prečo palác nepresťahujete inde ? “	nepresťahujete	4	Perf
Keď prišiel , Profesor mu ponúkol svoju stoličku .	ponúkol	5	Perf
Jeho záujem opäť ochabol .	ochabol	3	Perf
Vtedy som nemohol tušiť , že to mesto mi vybrala prozreteľnosť .	nemohol	2	Imp
Nastala chvíľa , aby som si oživil v pamäti tú ženu .	Nastala	0	Perf
“ Tuším pôjdeme zajtra zasa po žobraní .	pôjdeme	2	Imp
Volala sa Dolora .	Volala	0	Imp
“ Ide ti to ! “	Ide	1	Imp
Zatvorím oči a narátam do desať .	narátam	3	Perf
Srdce mu divoko bilo .	bilo	3	Imp
“ Si mojím otrokom a zaraz mi splníš prvé želanie .	splníš	7	Perf
Vilko sa zamračil .	zamračil	2	Perf
M . N . Tichomirov fakt jednostranné vykladá len ako príčinu „ hladových vzbúr “ , Frojanov si všíma dôležitú okolnosť — volchovia sa zjavujú , aby zabezpečili blahobyt , hojnosť , úrodu .	zjavujú	24	Imp
Urazený som sa ho pokúšal presvedčiť , že neklamem .	neklamem	8	Imp
Pokrčil plecami a podal mi Colu .	podal	3	Perf
Keď som to vyslovil , prebehli mi po tele zimomriavky .	vyslovil	3	Perf
A čo tu robíš ?	robíš	3	Imp
Nebola som schopná plakať .	plakať	3	Imp
Neviem , či na mňa viac zapôsobila skutočnosť , že môjho starého otca zabili , alebo meno Hádes , ktoré náš hosť ticho precedil cez zuby .	precedil	23	Perf
“ Vy máte šťastie ! “ povedala mora Maji , lebo vedela , čo znamená stretnutie so škriatkom kvetov .	máte	2	Imp
Ostražito sa zakrádala k neznámemu miestu , keď začula plač .	zakrádala	2	Imp
Jeho dej sa odohráva vo fiktívnom mužstve Miami Sharks .	odohráva	3	Imp
Chutila výborne .	Chutila	0	Imp
Mohli si nás všimnúť a vyjavene sa na nás dívať .	dívať	9	Imp
Nevyhýbali sme sa ani politike .	Nevyhýbali	0	Imp
Do sklenej nádoby , v ktorej varila zázračný nápoj , pridávala čarovné prísady , a pritom čítala .	varila	6	Imp
“ Dúfam , že mi nechalo aspoň zákusok . “	Dúfam	1	Imp
Ilúzia takejto taktiky netrvala dlho .	netrvala	3	Imp
Pomyslela som si , že píše otcovi .	píše	5	Imp
Kľúčové miesto vo vzdelávaní zastáva škola .	zastáva	4	Imp
Vzdychla si .	Vzdychla	0	Perf
Celý deň som snívala len o ňom .	snívala	3	Imp
Spočiatku ich nepoužil .	nepoužil	2	Perf
“ Nie je zlý , hoci lepšie mi chutí náš . “	chutí	8	Imp
A obchody , ktoré chcú predávať zaručene čerstvý , v noci upečený a nezabalený chlieb , musia ho držať v osobitných zasklených policiach , takže skôr nebalenie chlieb zdražuje .	zdražuje	28	Imp
Náš vzťah trval rok .	trval	2	Imp
“ Kam ideš ? “ spýtal sa Chris .	ideš	2	Imp
Skúsil to ešte raz , ale nezdvihol ju .	Skúsil	0	Perf
Každý deň som chodievala do školy spolu s mamou .	chodievala	3	Imp
Nič sa nedalo robiť .	nedalo	2	Imp
Mala som pocit , že potrebujem vypadnúť na čerstvý vzduch .	Mala	0	Imp
Chytil ma za zápästie a ja som zacítila jeho mocné prsty .	zacítila	7	Perf
Keď práve nemala v ústach štipec na bielizeň , mohutným kontraaltom spievala :	spievala	11	Imp
Pochutnával si na hurkách kliešťaka Drakulu a pritom nahlas mľaskal .	mľaskal	9	Imp
Režíruje ho holandský režisér Dick Maas .	Režíruje	0	Imp
Skry sa ! “ zvolala som a zatiahla Chrisa pod oleander .	zvolala	4	Perf
Vietor hvízdal v konároch a trápil sporadické , ufúľané krókusy .	hvízdal	1	Imp
Otvorila som oči a mimovoľne som si pošúchala pätu .	pošúchala	7	Perf
Pri štvrtej obrátke sa mi stužka s kľúčikom z krku vyvliekla .	vyvliekla	10	Perf
“ Mohla by som doplniť aj najhulvátskejší ? “ dodala Aziza .	doplniť	4	Perf
Nemohol som sa na nič sústrediť , nevládal som zniesť nikoho pri sebe : ani Margu , ani mamu , ani Toma .	zniesť	9	Perf
Nebude jestvovať umenie , literatúra , veda .	jestvovať	1	Imp
“ Alma ? “ zakričal .	zakričal	4	Perf
Zamieril som k činžiaku .	Zamieril	0	Perf
Keďže v mojej spálni bolo v tej chvíli len negramotné dieťa , odpísala som : " Skuste to osobne , mozno to zaberie .	odpísala	12	Perf
Podľa nej som svojím nedostatočne tvrdým postojom kazil dcéru .	kazil	7	Imp
Naháňalo mi to strach .	Naháňalo	0	Imp
Vo Winstonovi zápasili zvláštne pocity .	zápasili	2	Imp
" Ľutuješ , že si to neurobil ? "	neurobil	6	Perf
Nemohla som tomu uveriť .	Nemohla	0	Imp
Berte to tak , že ich píšu Marťania , s ktorými sa nikdy nedorozumiete .	nedorozumiete	13	Perf
Naozaj , mravenisko vyzeralo ako pevnosť .	vyzeralo	3	Imp
Spočiatku som mala nepríjemný pocit , že sa na mňa všetci dívajú , ale trvalo to len moment .	dívajú	11	Imp
Myslela som na jeho hlboké hnedé oči .	Myslela	0	Imp
Lístok z recepcie som podal Raise .	podal	4	Perf
Ako možno komunikovať s budúcnosťou ?	komunikovať	2	Imp
V tomto ohľade sme sa všetci mýlili .	mýlili	6	Imp
Za jasotu spoluobčanov prevzali cenu a Dr . Slimák slzil od dojatia , pretože v tejto súťaži doteraz nijaký slimák nevyhral .	slzil	9	Imp
Na nič spred začiatku šesťdesiatych rokov sa nepamätala a ( zo všetkých známych ) jediný človek , ktorý často rozprával o rokoch pred Revolúciou , bol jej starý otec .	rozprával	19	Imp
Ponášalo sa to na rovnicu o dvoch neznámych .	Ponášalo	0	Imp
Všetky tieto ich snahy mali aj svoju právnu dimenziu , vďaka čomu sa v okolí reformných pápežov vytvorilo „ nové “ reformné kánonické právo .	vytvorilo	17	Imp
Rozprávala , akoby jej vynechávalo srdce .	vynechávalo	4	Imp
" Si posledný človek , " poznamenal O ' Brien . " Si ochranca ľudského ducha .	poznamenal	6	Perf
My z nich robíme pravdu .	robíme	3	Imp
Zúrivo odrážal nápory paniky .	odrážal	1	Imp
Chcel som jej povedať , že to mesto poznám .	povedať	3	Perf
Obaja sme začuli mamino zlostné vzdychnutie .	začuli	2	Perf
A obchody , ktoré chcú predávať zaručene čerstvý , v noci upečený a nezabalený chlieb , musia ho držať v osobitných zasklených policiach , takže skôr nebalenie chlieb zdražuje .	chcú	4	Imp
Vybral desať najlepších policajtov a tí potom starostlivo prehľadali lúku .	Vybral	0	Perf
“ Chcete povedať , že som herec ? “ pýtal sa Pinocchio .	pýtal	9	Imp
Nie je dobrý v počtoch , a preto sa často mýlil .	mýlil	10	Imp
Abu síce nevedel čítať , no páčili sa mu obrázky .	nevedel	2	Imp
Tých , ktorí ma poznajú , takéto vyhlásenie neprekvapí .	neprekvapí	8	Perf
Vláda pripraví program zameraný na ekonomický rozvoj , v rámci tohto programu vypracuje podprogramy pre jednotlivé sektory .	pripraví	1	Perf
Nemalo nijaké okná .	Nemalo	0	Imp
Takto ty zdravíš svojho otca ? “ spýtal sa ho Zeus .	zdravíš	2	Imp
Po chvíli sa upokojil a začal vysvetľovať .	upokojil	3	Perf
Neboli sme tam už dosť dlho .	Neboli	0	Imp
“ Tak rozprávaj , “ súrila ma Blythe , keď sme nastúpili do jej džípu .	rozprávaj	2	Imp
Terk neverila vlastným očiam .	neverila	1	Imp
“ Teba , “ odvrkol a bol preč .	odvrkol	4	Perf
Prekvapená videla , ako zvonka preniká do spálne jemné modravé svetlo .	videla	1	Imp
Chcem poďakovať aj sestrám , ktoré sa podieľajú na upratovaní nášho chrámu .	podieľajú	7	Imp
Vytrváte všetci ?	Vytrváte	0	Perf
S letenkou v ruke som vyšiel z izby a zamieril k stolu , kde sedeli recepčné z môjho poschodia .	zamieril	9	Perf
Svojím typickým gestom si O ' Brien upravil na nose okuliare .	upravil	7	Perf
Roztrhajte jej tvár , roztrhajte jej ju až na kosť .	Roztrhajte	0	Perf
Sám sa dovtíp , kto som !	dovtíp	2	Perf
Tarzana urazilo , že sa Kerchak hnevá a utiekol do džungle .	hnevá	6	Imp
“ Daj im pokoj ! “ skríkol Aladin .	Daj	1	Imp
Máte kvalitnú vodku , poznamenala , čo som vôbec nečakal .	nečakal	9	Imp
Kora tam nebola .	nebola	2	Imp
Usmiala som sa na Chrisa , a on sa uškrnul , ako keby mu naozaj odľahlo , že súhlasím .	uškrnul	9	Perf
Vendelín zasa zosmutnel .	zosmutnel	2	Perf
Voňala sladkokyslo .	Voňala	0	Imp
V prúde krvi a slín mu z úst vypadli dve polovice zubnej protézy .	vypadli	8	Perf
Sudcovia sa sa celkom priklonili na jej stranu .	priklonili	4	Perf
Napriek všetkému Delina nevenuje tomuto človeku pozornosť .	nevenuje	3	Imp
Telefón zazvonil vo chvíli , keď som začal hľadať šach .	zazvonil	1	Perf
Zničíme ho ! “ kričali .	Zničíme	0	Perf
V ich národnom epose Kalevala nájdeme napr . starobylý výklad o pôvode sveta z vajca .	nájdeme	5	Perf
Myslel som to úprimne .	Myslel	0	Imp
Nenávidím tie hodiny .	Nenávidím	0	Imp
Srdce mu poskočilo .	poskočilo	2	Perf
Roztiahni krídla a leť .	Roztiahni	0	Perf
Musím vymyslieť nejakú tajnú skrýšu , kam ťa cez deň ukryjem .	Musím	0	Imp
Vláda dopracuje a predloží návrh zákona o voľbách do Európskeho parlamentu tak , aby Slovenská republika bola pripravená voliť poslancov do tohto orgánu v prvom polroku 2004 .	dopracuje	1	Perf
Chvíľami mu na náprsenku kombinézy kvapol pramienok krvi .	kvapol	5	Perf
Navrhli im , že ak chcú prežiť v nových podmienkach trhového hospodárstva , môžu predávať po tiranských chodníkoch cigarety alebo banány .	prežiť	6	Perf
“ Preber sa , Baghíra , preber sa ! “ kričal Mauglí .	kričal	10	Imp
Má pokojný , rozvážny hlas , dbá na každé slovo a tvári sa vážne .	tvári	11	Imp
Uznal som za vhodné požiadať ich , aby ma zobudili o pol piatej .	Uznal	0	Perf
Prečo sa pýtate ?	pýtate	2	Imp
Mlčky ho sledovala celá trieda .	sledovala	2	Imp
Nepekný odev môže všetko pokaziť .	pokaziť	4	Perf
“ Prečo nie , “ odvetil Chris , keď chvíľu snoril v knižnici a prezeral si farebné obaly kníh .	snoril	10	Imp
“ Vysvetlíme mu , že ja také niečo nikdy neurobím ! “	Vysvetlíme	1	Perf
Nepovedal som jej to .	Nepovedal	0	Perf
Zavedenie inštitútu manažéra súdu zníži počet funkcionárov súdov , ktorí obmedzene vykonávajú súdnictvo .	vykonávajú	11	Imp
Brúsil si na nás zubiská a najradšej by nás zhltol ako malinu .	zhltol	9	Perf
Súžitie etník tu teda fungovalo na princípe spoločenstiev v ktorých jednotlivé zložky popri sebe slobodne existovali a zároveň sa ovplyvňovali , miešali a splývali .	miešali	21	Imp
Ukradomky pozrel na Kalifa .	pozrel	1	Perf
Jeho veľká , odporná tvár sa priblížila , oči sa mu trochu zúžili .	priblížila	6	Perf
Rovnako prirodzené bolo , že zablúdila očami k fľaši s vodkou značky Smirnoff na stole .	zablúdila	5	Perf
Neskoro večer , keď bandy surových proletov vyvádzali na uliciach , vládla v meste zvláštna horúčkovitá atmosféra .	vládla	11	Imp
Pohľadal som letenku .	Pohľadal	0	Perf
Nezískala ho ani Matica , ani občianske združenie Komorra a nedarí sa to ani gymnáziu .	Nezískala	0	Perf
Areál Zväzu spisovateľov smrdí močom .	smrdí	3	Imp
“ Tak čo je ? “ spýtal sa .	spýtal	6	Perf
Mravce dovliekli celý kôš dobrôt , včielky priniesli ovocný medovník a Kasandra jazmínové želé .	priniesli	7	Perf
Nikto neprotestoval , že sa predbiehame .	predbiehame	5	Imp
" A čo sa stalo s tým mužom ? " opýtal sa Winston .	opýtal	10	Perf
Prešmykla sa okolo Kasandry a vonku sa nadýchla čerstvého vzduchu .	nadýchla	7	Perf
A , prosím ťa , nalej mi ešte raz do tohto pohára !	prosím	2	Imp
Pri ďalšej skúške vymenila slák za golfovú palicu , takže Klotilda musela kričať a prišla o hlas .	kričať	12	Imp
“ Môže tu ostať do desiatej . “	ostať	3	Perf
Bol som v jeho pracovni , mal som v sebe nerozumnú dávku alkoholu a čakal som , že všetko sa definitívne vyjasní a ja odídem .	čakal	14	Imp
Predo mnou sa týčila iná socha , socha Vladimíra Iľjiča Lenina .	týčila	3	Imp
A takisto dúfam , že neskôr nevidel ani film Hmla .	dúfam	2	Imp
Stáva sa to veľmi zriedkavo .	Stáva	0	Imp
Pri ceste postávali stopári a z fľašiek popíjali osviežujúce nápoje .	postávali	2	Imp
Maja s Vilkom sedeli na lesnej čistine a vymýšľali si o nich príbehy .	sedeli	3	Imp
Vnútri sa krásna kobylka rozdvojila a vyskočili z nej Bôľ a Zmätok .	vyskočili	6	Perf
Okrem toho som mala zo seba hrozný pocit , pretože Rick sa len mierne knísal zboka nabok a meravo mi držal prsty .	knísal	14	Imp
Opatrne ju položil na zelené súkno .	položil	2	Perf
Mal som pocit , že za známymi črtami tváre , ktorých som sa vo sne neraz dotýkal , sa skrýva akési tajomstvo .	dotýkal	16	Imp
“ Džafar , rozkazujem ti , aby si prestal ! “ zlostne skríkol sultán .	prestal	8	Perf
Išla som k dverám jej izby : “ Volá Rick , “ zašepkala som .	zašepkala	12	Perf
Len čo stačil dobehnúť do úkrytu , z jaskyne vytrielila svorka vĺčat .	vytrielila	9	Perf
“ To všetko je veľmi pekné , ale to som nechcel počuť .	počuť	11	Perf
“ Páliš ? “ spýtal sa opatrne bodliak .	Páliš	1	Imp
Človek by si myslel , že som mu ponúkla sviatočný obed .	myslel	3	Imp
Pri ďalšej skúške vymenila slák za golfovú palicu , takže Klotilda musela kričať a prišla o hlas .	musela	11	Imp
Naposledy požiadalo o povolenie na postavenie súsošia na svojom pozemku Gymnázium Ľudovíta Jaroslava Šuleka .	požiadalo	1	Perf
Na pokojnej hladine plával medený odraz mesiaca .	plával	3	Imp
Len spomedzi študentov náročnej školy vzídu študenti , ktorí sa dokážu presadiť v silnej konkurencii .	dokážu	10	Perf
Ako ho nájdem ?	nájdem	2	Perf
Chcel som , aby sa Soni smiala .	smiala	6	Imp
Odhodil som cigaretu .	Odhodil	0	Perf
O malú chvíľočku si na Mauglího miesto sadla iná opica .	sadla	7	Perf
“ Tentoraz by sme mali hudbu vynechať a usporiadať maratónsky beh , “ navrhol Rudko a všetci nadšene súhlasili .	vynechať	6	Perf
Najprv so mnou nechcela hovoriť .	hovoriť	4	Imp
Nemohla sa dočkať , kedy preberieme moje citové záležitosti , a tak prišla k nám .	preberieme	5	Perf
Teším sa na Vaše odpovede a prajem príjemný týždeň ,	Teším	0	Imp
Keby som bol prehltol tú návnadu , moje postavy by ma boli priviedli do hrobu .	prehltol	3	Perf
Zasa zaspal .	zaspal	1	Perf
Priviezol ho džíp , za ktorým išlo kryté nákladné auto , naložené naplno .	Priviezol	0	Perf
Už sme spomenuli , že za Ladislavovej vlády prichádza k postupnej konsolidácii pomerov v krajine .	spomenuli	2	Perf
Svätojánske mušky , lienky a niekoľko včiel sedelo alebo ležalo na dlážke a smutne vyčkávalo na svoj osud .	sedelo	7	Imp
Preto predpokladáme , že žili pomerne izolovane od ostatného uhorského mníšstva .	žili	4	Imp
Uvedomila som si , že to , čo vravela , mohlo pokojne platiť aj na Chrisa .	Uvedomila	0	Perf
Kolos , ktorý celkom ovládol svet !	ovládol	4	Perf
V noci sa voľne pohybovali dedinské psy a ja som sa ich bál na smrť .	pohybovali	4	Imp
Voda špliechala o okraje a zamočila ležadlá pri bazéne .	špliechala	1	Imp
Ja som uložil mladým batožinu do taxíka a nasadol som doň .	nasadol	8	Perf
Najradšej obhrýzalo Džafarove obľúbené topánky z najjemnejšej kože .	obhrýzalo	1	Imp
No keď Lulu kefovala tigriu srsť , diali sa čudné veci .	kefovala	3	Imp
Mohol sa volať akokoľvek , nebol však Vehap .	Mohol	0	Imp
Winston sa zľahka poškrabal na nose sponkou na spisy .	poškrabal	3	Perf
Rahim zdvorilo prikývol .	prikývol	2	Perf
Keď to rozprával Maji , spozornela .	spozornela	5	Perf
Určený čas a meno kina mi utkveli v mozgu .	utkveli	6	Perf
O ' Brien mu položil ruku na rameno takmer priateľsky .	položil	4	Perf
My sme mravce smelé , my sa nezľakneme .	nezľakneme	7	Perf
Kriminalisti dospeli k záveru , že ich napísali ženy .	napísali	7	Perf
Rozochvel som sa a pomyslel som si , že rovnako rozochvieť sa musela aj ona .	Rozochvel	0	Perf
Usmiala som sa na Chrisa , a on sa uškrnul , ako keby mu naozaj odľahlo , že súhlasím .	súhlasím	18	Imp
“ Asi mám , “ odvetil Chris a pokračoval v kreslení .	odvetil	5	Perf
Skočili sme do bazéna Joea Favatu . “	Skočili	0	Perf
“ Nech ti nelepí , vyhnem sa ti , ak sa vyhneš ty mne !	nelepí	3	Imp
Poďakovanie patrí aj posudzovateľom rukopisu – pánovi prof . PhDr . Richardovi Marsinovi , DrSc . a pánovi PhDr . Jánovi Steinhübelovi , CSc . , ktorí mi pomohli vylepšiť text svojimi cennými postrehmi .	pomohli	28	Perf
Zavedenie inštitútu manažéra súdu zníži počet funkcionárov súdov , ktorí obmedzene vykonávajú súdnictvo .	zníži	4	Perf
Rozochvel som sa a pomyslel som si , že rovnako rozochvieť sa musela aj ona .	musela	12	Imp
Primátor Komárna Štefan Pásztor po svojej sekretárke odkázal SME , že sa k problému nevyjadrí .	nevyjadrí	14	Perf
JEDNÉHO DŇA SA PYŠNÁ KRÁĽOVNÁ SPÝTALA svojho zázračného zrkadla : “ Povedzže mi , ktože je najkrajší v našej zemi ? “	SPÝTALA	5	Perf
Pomaly vstala a po niekoľkých knísavých krokoch zasa našla rovnováhu .	vstala	1	Perf
Tešila som sa , ale zároveň mi chýbali tie chvíle , keď sme po večierkoch spolu posedeli a rozoberali každý detail .	chýbali	7	Imp
Vláda bude zvyšovať prostriedky na vzdelávanie , aby sa postupne priblížili priemernej hodnote podielu z HDP v krajinách EÚ .	zvyšovať	2	Imp
Mama rázne podišla k oknu .	podišla	2	Perf
Keď sa však priblížila , uvidela v tráve svetlovlasé spiace dievčatko v červených šatôčkach .	uvidela	5	Imp
Túžil som vypiť tú vodku čo najrýchlejšie .	Túžil	0	Imp
Vyzliekol si košeľu a skočil za mnou .	Vyzliekol	0	Perf
Boris svieti zrkadielkom do očí , končím , “ hlásil vysielačkou Vilko .	svieti	1	Imp
Kov ma príjemne chladil .	chladil	3	Imp
“ Musíte to urobiť ešte dnes ! “ skríkla na nich Cruella .	urobiť	3	Perf
Mama nazrela do izby , aby sa presvedčila , či spím .	presvedčila	7	Perf
Zaslané médium vám vrátime spolu s vyvolanými fotkami .	vrátime	3	Perf
Zaspíš , kým sa dopečie , “ vyhlásila som neisto .	Zaspíš	0	Perf
Ďakujem , “ odvetila som a vymanila si studené prsty spod jeho rúk .	odvetila	3	Perf
Cítila som , ako sa mi do hlavy hrnie krv .	hrnie	8	Imp
My však každému ponaprávame mozog do dokonalosti , kým mu ho vystrelíme .	vystrelíme	11	Perf
“ Mohla by som doplniť aj najhulvátskejší ? “ dodala Aziza .	Mohla	1	Imp
N . T . bol za stenou , vyšetroval Margu .	vyšetroval	8	Imp
Opatrne odhrnula okvetné lístky a vyzrela von .	odhrnula	1	Perf
Obyčajne sedávala v poslednom rade , kam som si sadal i ja .	sadal	9	Imp
“ Skúsme ich preľstiť , “ navrhol Rudko .	preľstiť	3	Perf
A položil som slúchadlo .	položil	1	Perf
“ Nevydeli ste tu nejakého koňa ? “ vypytoval som sa chrobákov .	vypytoval	8	Imp
Zabezpečia to baterky s pogumovaným povrchom .	Zabezpečia	0	Perf
Niektoré z nich , vydané vo francúzštine , občas dávala aj mne , pričom mi nezabudla prikázať , aby som to nikomu neprezradil .	prikázať	16	Perf
Pochopil som to , keď som prišiel na koniec schodišťa a stretol som suseda z prízemia .	Pochopil	0	Perf
" Niekedy , " poznamenala , " pohrozia človeku niečím -- niečím , čomu nedokáže vzdorovať , na čo nedokáže ani pomyslieť .	nedokáže	19	Perf
“ Zabije ? “ zvolal Mauglí .	Zabije	1	Perf
Poskladali sme vlhkú deku , napchali ju do koša , ktorý sme pomaly uväzovali o korman .	uväzovali	13	Imp
Potom zostával na noc aj inokedy .	zostával	1	Imp
Hladko som vkĺzla pod vodu a vynorila sa na hladine .	vynorila	6	Perf
“ Maj sa , princ Ali Abubu ! “ kričal za ním Džafar .	kričal	9	Imp
Ja sa volám Faika , odvetila .	volám	2	Imp
Môžete lietať ? “ vypytoval sa ustarane Chrabroš .	lietať	1	Imp
Vtom som zazrel červené auto .	zazrel	2	Perf
Bál som sa , že zloží slúchadlo , a tak som sa usiloval rýchlo niečo vymyslieť .	vymyslieť	15	Perf
Odporná extáza strachu a pomstychtivosti , túžba zabíjať , mučiť , drúzgať tváre kováčskym mlátom akoby preskočila sťa elektrický prúd na všetkých a premenila každého aj proti jeho vôli na vrieskajúceho pomätenca s pokrivenou tvárou .	mučiť	9	Imp
Ako teda vysvetliť , že žobráci touto zónou opovrhujú ?	opovrhujú	8	Imp
Vláda pripraví podmienky pre sústredenie kompetencií v oblasti regulácie a koordinácie elektronickej komunikácie a rozvoja informačnej spoločnosti z rôznych orgánov na jeden regulačný orgán .	pripraví	1	Perf
Stoly a stoličky boli prevrhnuté , vázy rozbité a obrazy viseli nakrivo .	viseli	10	Imp
Títo Sosolci tiahnú proti Rusom , plienia ruský oporný bod Jurjev a útočia na Pskov .	plienia	6	Imp
Vtom sa na schodoch ozvali rýchle kroky .	ozvali	4	Perf
Pri cieli sa skrýval osiak Boris a zrkadielkom oslňoval ostatných pretekárov , len aby pomohol svojmu zmrzačenému kamarátovi zvíťaziť .	zvíťaziť	18	Perf
Keď som tak urobil , spamätal som sa .	spamätal	5	Perf
Aladin sa uškrnul a podal Abdullahovi krištáľovú guľu .	uškrnul	2	Perf
Keď som to dokončila , odľahlo mi a bola som so sebou spokojná .	odľahlo	5	Perf
Zrazu ma hnev pominul a nahradil ho smútok .	nahradil	5	Perf
Tvoj druh vyhynul a my sme jeho dedičia .	vyhynul	2	Perf
Predavačka sa silene usmievala , aby dala najavo , že ju to pobavilo .	pobavilo	12	Perf
Všetky formality vytrvalo vybavila naša kurátorka Justína Petrová , ktorá v tomto smere nepozná prekážky .	nepozná	13	Imp
Spoločne vyrazili jabĺčko babizne z ruky .	vyrazili	1	Perf
Čoskoro som však zapochybovala o svojom odhodlaní , lebo pred školou ma dobehol Chris a chytil za ruku .	chytil	15	Perf
S cieľom vyhľadávať námety pre kritiku .	vyhľadávať	2	Imp
Ak chcem niečo dokázať , musím sa Chrisa zriecť .	chcem	1	Imp
Všetko prebehlo v tichosti , vedenie fakulty nevydalo nijaké oficiálne vyhlásenie .	prebehlo	1	Perf
Ženu zachráni traktorista .	zachráni	1	Perf
Namiesto toho spoznala iného , prečudesného spoločníka z čeľade hmyzu .	spoznala	2	Perf
A dodala : Narodila som sa v internácii .	dodala	1	Perf
Škole chýbali priestory , a tak žiaci prvého stupňa , čiže aj my prváčikovia , mávali vyučovanie popoludní .	mávali	15	Imp
“ Hádes nás zabije , keď to zistí ! “	zabije	3	Perf
Winstona bolestne bodlo pri srdci .	bodlo	2	Perf
Maja sa sklonila k zemi .	sklonila	2	Perf
Na stenách viseli zaprášené police s prastarými knihami zaklínadiel a čarov .	viseli	2	Imp
“ Videla som ju zblízka .	Videla	1	Imp
Začala som výčitkami , ale teraz pokračujem radami do nového roku .	Začala	0	Perf
Zvrtol sa a utiekol do džungle .	Zvrtol	0	Perf
Zatvorím oči a narátam do desať .	Zatvorím	0	Perf
Lenže svedomie mi nedalo , a musela som jej niečo povedať .	povedať	10	Perf
Položil mi poslednú otázku .	Položil	0	Perf
Vrhol pohľad na ciferník .	Vrhol	0	Perf
Touto syntézou môžme vysvetliť mnohé osobitosti hospodárskeho i politického života oblasti .	môžme	2	Imp
Celý svet vyvalí oči , keď Belu a Gastona zbadá taký pár málokde zočí , krásavci jedna balada .	vyvalí	2	Perf
Potom ma táto scéna stále prenasledovala .	prenasledovala	5	Imp
Teraz sa v noci budievam zo spánku a hrdlo mi zviera úzkosť : trápi ma nočná mora , že aj ja som v dave , ktorý ženie mamu v ústrety smrti .	ženie	26	Imp
Keď však Maja s Fridolínom krepčili v divom tanci , stala sa ďalšia katastrofa .	krepčili	5	Imp
Bohužiaľ , vzali si z nich príklad všetky deti a tiež sa chceli hrať v odpadovej jame .	chceli	12	Imp
Kňučala a ťahala ich k dverám , akoby im chcela niečo dôležité povedať .	Kňučala	0	Imp
Pri ceste postávali stopári a z fľašiek popíjali osviežujúce nápoje .	popíjali	7	Imp
Po chvíli Chris vyliezol na strechu .	vyliezol	3	Perf
“ Ak chceš , môžeme začať od začiatku , “ povedal .	chceš	2	Imp
Veľkú tašku hodil do kúta a mľaskavo ho pobozkal .	pobozkal	8	Perf
Škriatok sa zasmial .	zasmial	2	Perf
Ráma bol zhrozený , i keď niečo podobné očakával .	očakával	8	Imp
“ Radža naozaj nikomu neublíži , “ ubezpečovala ho Jazmína .	neublíži	4	Perf
“ Možno spolu na niečo prídeme .	prídeme	5	Perf
Muselo sa mu to stať v noci , “ odvetila Bibi .	Muselo	0	Imp
Nemôžeš spať ? “	spať	1	Imp
“ Vítame vás , Pichuľko ! “ povedala Makulienka .	Vítame	1	Imp
Maja vedela , že blízko úľa je veľké mravenisko .	vedela	1	Imp
Chris ma chytil za ruku a kľúčik sme zvierali medzi dlaňami .	zvierali	8	Imp
Naopak , pamätala si niečo iné : pohľad mojich očí .	pamätala	2	Imp
" Niekedy , " poznamenala , " pohrozia človeku niečím -- niečím , čomu nedokáže vzdorovať , na čo nedokáže ani pomyslieť .	poznamenala	4	Perf
Zdivočenci sa zarazili .	zarazili	2	Perf
“ Tú šóru v žiadnom prípade nezvládneme , “ povedal Rýchlik a začal cúvať .	cúvať	13	Imp
Keď som ju začal ťahať k posteli , vymanila sa mi .	vymanila	8	Perf
Iba pred piatimi dňami sa pohrával myšlienkou , že jej rozbije hlavu dlažobným kameňom , lenže čo tam teraz po tom ?	rozbije	10	Perf
Vtedy mi položila ďalšiu otázku .	položila	2	Perf
Vyliezla spod listu a obzerala sa okolo seba .	Vyliezla	0	Perf
Povedala , že by sme mali odísť bez rozlúčky , nechcela , aby sme nechali Irme odkaz , kam ideme , a ja som pozbieral odvahu .	ideme	19	Imp
A tento rok to prišlo zas .	prišlo	4	Perf
“ Zničíme ho ! “ zahrmeli Titan Skala , Titan Sopka , Titan Ľadovec , Titan Tornádo a jednooký Kyklop , keď po jednom vychádzali z jaskyne .	Zničíme	1	Perf
V ten deň som zaplávala osobný rekord .	zaplávala	4	Perf
“ Odpočiňme si , “ povedal .	Odpočiňme	1	Perf
Tak čo si o mne vypátral ? “	vypátral	5	Perf
Povzdychol si .	Povzdychol	0	Perf
Vchádzala na parkovacie miesto , kde trhane zastala .	Vchádzala	0	Imp
V náručí niesol nákupnú tašku .	niesol	2	Imp
Mauglí pokrútil hlavou a chytil sa neďalekého stromčeka .	chytil	4	Perf
Nehybnú princeznú nechala ležať na studenej kamennej dlážke .	nechala	2	Perf
“ Chceš povedať , že s tým nemôžeš niečo urobiť ? “ pýtal sa zúfalý Herkules .	povedať	2	Perf
Tentoraz oveľa viac sníval a vždy to boli príjemné sny .	sníval	3	Imp
Prvý raz mám príležitosť byť so spisovateľom a filmovým scenáristom , povedala .	mám	2	Imp
Obra Jumba všetci oslavovali a vymenovali za čestného občana Makovej lúky .	oslavovali	3	Imp
Nech ich srdce stále viac a viac poznáva hodnotu tej blaženosti , ktorú nám pripravil Tvoj jednorodený Syn .	poznáva	7	Imp
Chcela dva doláre .	Chcela	0	Imp
“ Z nás sa nikdy nestanú piráti , “ hrdo vyhlásila Wendy .	vyhlásila	10	Perf
Keď leteli nad potokom , vodná hladina sa pod nimi tak jagala , akoby do nej spadla hviezda .	leteli	1	Imp
Na mieste , kde sedelo , ostala vlhká , tmavá škvrna .	sedelo	4	Imp
“ Chcete povedať , že som herec ? “ pýtal sa Pinocchio .	povedať	2	Perf
Sprevádzali ho ďalší štyria strážcovia s vytasenými mečmi .	Sprevádzali	0	Imp
Na jednom z programov Českej televízie sa momentálne dá vidieť skvelá séria ľahkých , avšak nebulvárnych reportáží zo života s názvom Ta naše povaha česká .	vidieť	9	Imp
Alia sa začervenala .	začervenala	2	Perf
Mama postupne napísala otcovi niekoľko listov , ale on jej neodpovedal .	napísala	2	Perf
“ No ak to nezistí , nezabije nás , “ navrhol Bôľ .	nezistí	4	Perf
Išlo to !	Išlo	0	Imp
Podporíme intenzívnu ekonomickú poľnohospodársku výrobu .	Podporíme	0	Perf
Zaletela k nim , sadla na kvet a počúvala tiché zurčanie potoka .	sadla	4	Perf
S nádejou pozrela na Aladina .	pozrela	2	Perf
Vo svojom blaženom sne Winston nevenoval nijakú pozornosť tomu , že mu nalieva pohár .	nevenoval	5	Perf
Nič sa ma nepýtal .	nepýtal	3	Imp
Čakala som na Chrisa .	Čakala	0	Imp
“ Pravdaže , “ odvetila svätojánska muška a zasvietila jasnejšie .	zasvietila	8	Perf
Navyše nepriateľskú osu hral jeho kamarát hnojník Kurt .	hral	3	Imp
Vláda zabezpečí implementáciu koncepcie integrácie zdravotne postihnutých do života , aby mohli pracovať a plnohodnotne sa zúčastňovať na živote spoločnosti .	zúčastňovať	16	Imp
A nohy ma priviedli do obchodu , kde predávali alkoholické nápoje .	priviedli	3	Perf
Prekvapená videla , ako zvonka preniká do spálne jemné modravé svetlo .	preniká	5	Imp
Netvor na ňu hľadel rovnakým pohľadom .	hľadel	3	Imp
“ Mhm , “ zamrmlala som .	zamrmlala	4	Perf
Keď po prižmúrení vytlačil z očí slzy , náhle pocítil hlad .	vytlačil	3	Perf
Makovej lúky sa totiž chceli zmocniť lúpežné mravce .	chceli	4	Imp
Zlá víla sa princovi Filipovi posmievala , no prezradila mu , že iba on môže zrušiť Zorničkinu kliatbu , ak ju pobozká .	prezradila	8	Perf
Svetové ríše , silné krajiny , politické systémy vznikajú a zanikajú , nič netrvá večne .	vznikajú	8	Imp
Je veľmi pravdepodobné , že uhorskí zákonodarcovia formulovali príslušné právne normy o celibáte pod vplyvom výziev reformátorov .	formulovali	7	Imp
Svojho času som ich spomínal pri popisovaní nosenia fotografickej tašky na ruksaku .	spomínal	4	Imp
A predovšetkým , nedovoľujeme mŕtvym , aby povstali proti nám .	povstali	7	Perf
Pozoroval som každý štvorcový milimeter jej tváre .	Pozoroval	0	Imp
Ja som chcela vyhrávať .	vyhrávať	3	Imp
Nemyslite si , že nepôjdu .	nepôjdu	4	Imp
“ Amy , “ zašepkal .	zašepkal	4	Perf
Publikum nevie , či sa má smiať alebo plakať , ale napokon sa rozosmeje .	rozosmeje	13	Perf
Spomenul som si na dve veci : na hysterickú eufóriu učiteľov po incidente , pri ktorom sa spomenulo meno mytologického božstva záhrobného sveta .	spomenulo	17	Perf
Poprosil som ju , aby ma odprevadila domov .	odprevadila	6	Perf
Snažila som sa potlačiť vzrušenie .	potlačiť	3	Perf
Bola špička a cez okienka som videla , že všetky sedadlá obsadili ľudia , čo pracujú v centre .	pracujú	15	Imp
Verila , že neurobím to čo ona .	neurobím	3	Perf
Chytila Petronilu pod krk a niekoľkokrát ňou zatriasla .	zatriasla	7	Perf
Vytiahol z vrecka mešec a zdvihol ho do výšky .	Vytiahol	0	Perf
“ Tak , čo mi na to povieš ? “ spustil na Vilka .	spustil	10	Perf
“ Čo mi nesieš , Emanuel ? “ vypytovalo sa slniečko .	vypytovalo	8	Imp
Postavila sa teda pred televízor a zaclonila im obraz .	Postavila	0	Perf
Zavalíme ľan kameňom , aby ostal vo vode .	Zavalíme	0	Perf
“ Navštívte ma občas , “ zakričal šťastný Vendelín Maji a Vilkovi .	Navštívte	1	Perf
Musím ti nejako pomôcť , Omar .	Musím	0	Imp
Vzala si kráľov trojzubec a jeho zlatá žiara sa jej rozliala po tvári .	Vzala	0	Perf
Keď opätoval môj pohľad , vedela som , že je to naozaj on .	vedela	5	Imp
Odložil denník do zásuvky .	Odložil	0	Perf
Musím zbaviť Margu myšlienky na smrť .	Musím	0	Imp
Myšlienka , že sa môžem stať otrokom svojich postáv , mi naháňala hrôzu .	môžem	4	Imp
Chceš vidieť , ako urobím leoparada ? “ spýtal sa .	Chceš	0	Imp
“ Nanosilo ju sem dvadsať tiav . “	Nanosilo	1	Perf
Všetci by lavínu najradšej čo najrýchlejšie odstránili , no nevedeli ako .	nevedeli	9	Imp
Postavila sa na špičky prstov a pobozkala ma .	pobozkala	6	Perf
Ležala som v posteli a po tvári mi stekali slzy .	Ležala	0	Imp
Netrvalo dlho a opäť sa ozvalo zvonenie .	Netrvalo	0	Imp
Syme zdvihol zrak . " Tam prichádza Parsons , " poznamenal .	poznamenal	10	Perf
V oblasti manželského práva je teda uhorské ranoarpádovské zákonodarstvo , ak ho porovnávame s dobovým kánonickým právom , nejednoznačné .	porovnávame	12	Imp
Toto ministerstvo však nemuselo uspokojovať mnohoraké potreby straníkov , ale opakovať celú operáciu na nižšej úrovni pre blaho proletariátu .	uspokojovať	4	Imp
“ Nie , “ odvetila som a žmurkla na Chrisa .	odvetila	4	Perf
Skupina kánonov I . ostrihomskej synody sa venuje stanoveniu obsahu bohoslužieb a príbuzným kultovým predpisom .	venuje	7	Perf
A čo ho tam čakalo ?	čakalo	4	Imp
“ Volám sa . . . “	Volám	1	Imp
Nebolo tajomstvom , že odoslané listy sa bežne otvárajú .	otvárajú	8	Imp
Medzitým prestalo pršať a svitlo slniečko .	svitlo	4	Perf
Zničí ich raz a navždy !	Zničí	0	Perf
Dokážem dobre vytipovať nezaradených ľudí .	Dokážem	0	Perf
Dupot za Ferdom neutíchal a chodba pred ním sa akoby z ničoho nič končila .	končila	13	Imp
Cítil som , že sa to takto skončí .	skončí	7	Perf
Keby ste si mohli vybrať , žili by ste radšej vtedy či teraz ?	žili	6	Imp
“ Mal som iba dvoch zákazníkov , ženu a muža .	Mal	1	Imp
Bál som sa , že moji rodičia sa namiesto toho , aby ma bránili , postavia na stranu útočníka .	postavia	15	Perf
Zatiaľ nič nevidel .	nevidel	2	Imp
Mám tam po niečo zájsť . “	zájsť	4	Perf
O päť sekúnd sedel Winston s rozbúchaným srdcom pri stole dievčiny .	sedel	3	Imp
“ To nemôže uškodiť , “ povedal Aladin .	povedal	6	Perf
Neskôrnateli vnútorne .	Neskôrnateli	0	Perf
Maja si zatiaľ hladkala boľavé plece .	hladkala	3	Imp
Nemôžeme sa skrývať za masu ani za tradíciu cirkvi , keď nás Kristus oslovuje na ceste nášho života .	Nemôžeme	0	Imp
Niektoré úmrtia tak akosi predpokladáme , ľudia sa k nim systematicky dopracovávajú .	predpokladáme	4	Imp
Mauglí so supmi sa smiali , keď im tiger zmizol z dohľadu .	zmizol	9	Perf
“ Tak ti teda prezradím , aká budúcnosť ťa čaká , “ odvetil Abdullah .	prezradím	4	Perf
Keby ste tu vyrastali , pripadalo by vám to normálne .	vyrastali	3	Imp
“ Tu niekde mám bundu , “ zamrmlal .	mám	3	Imp
Spomenul si , že sedí s drevenou bábkou , na ktorej zarobí milióny .	sedí	4	Imp
“ To sa zle skončí , “ kuvikal dážďovka Vendelín , ale nikto ho nepočúval .	skončí	4	Perf
Vtedy som vyriekol jediné slová , o ktorých som si myslel , že vystihujú moje rozpoloženie .	vyriekol	2	Perf
Vláda pripraví transformáciu štátnych zdravotných ústavov na inštitúcie verejného zdravotníctva so zvýraznením opatrení zameraných na zníženie , resp . vylúčenie rizika poškodenia zdravia .	pripraví	1	Perf
Kapitoly vytvoria protiváhu hlboko miestne ukotveného archeologicko ‐ historického prehľadu a predkladajú nový zorný uhol na skúmanú tému .	vytvoria	1	Perf
Jedného dňa stretla na malinčí čudného tvora .	stretla	2	Perf
Postávali v tieni lieštiny .	Postávali	0	Imp
Rodičia zhasli svetlo a vyšli z izby .	vyšli	4	Perf
Aladin hodil Rasoulovi horúcu špajľu a ten ju bez rozmýšľania chytil .	hodil	1	Perf
Prevrátila sa a klesla na dno .	klesla	3	Perf
Zlá víla sa princovi Filipovi posmievala , no prezradila mu , že iba on môže zrušiť Zorničkinu kliatbu , ak ju pobozká .	pobozká	21	Perf
“ To my poznáme , “ povedal Flaps .	poznáme	3	Imp
A keď som ho počúval , pri akejsi zmene v zafarbení jeho hlasu sa mi na chvíľu zazdalo , že ho poznám .	zazdalo	17	Perf
Jeho vyduté biele bruško pripomínalo huňatý kopček .	pripomínalo	4	Imp
Ťahal voz dovrchu naložený melónmi .	Ťahal	0	Imp
Chvíľu mlčky prehliadal Margu a oficiálne konštatoval jej smrť .	konštatoval	6	Perf
Vzápätí za ním s krikom vybehla i Bibina slúžka : “ Zastavte ho .	Zastavte	11	Perf
“ Ako to myslíš ? “ zaujímal sa škriatok .	myslíš	3	Imp
Keby ste ho nenašli , leťte za slnečným svitom .	nenašli	3	Perf
V niektorých ohľadoch bola oveľa kritickejšia ako Winston a oveľa menej ochotná prijímať stranícku propagandu .	prijímať	12	Imp
Ak sa neponáhľate , počkajte chvíľu . “	neponáhľate	2	Imp
Vtom si spomenula na poštového poslíčka Pavla , ktorý okrem správ roznášal po lúke dobrú náladu .	roznášal	11	Imp
“ Zaplaťte , “ povedal Rýchlik , ktorý dal kolovať plaveckú čiapku .	povedal	4	Perf
Navrhne systém transparentného financovania mediálneho prostredia .	Navrhne	0	Perf
Zjavila sa vo dverách , mala na sebe čierno ‐ bielu uniformu .	Zjavila	0	Perf
Keď sa mi posmievala , zmocňovala sa ma trpká zlosť , napriek tomu medzi nami nedochádzalo k scénam .	posmievala	3	Imp
Ja to viem , prehovoril som po dlhom váhaní .	prehovoril	4	Perf
Namrzený Mauglí si sadol na opačný koniec .	sadol	3	Perf
Na tretí deň ráno spratal päť porcií raňajok a spokojne sa ponaťahoval .	ponaťahoval	11	Perf
Snažila som sa potlačiť vzrušenie .	Snažila	0	Imp
Aj Maja so škriatkom opustili topoľ a leteli , kým nedoleteli k domu , kde sa v oknách ešte svietilo .	opustili	4	Perf
Zdalo sa mu , že to tu pozná .	pozná	7	Imp
A oblial ma studený pot .	oblial	1	Perf
Až teraz som si všimla , že je obutý .	všimla	4	Perf
“ Kým neodíde , nevylieziem na žiaden strom . “	nevylieziem	4	Perf
Kolektívne postupovať nemôžeme .	postupovať	1	Imp
Zmiluj sa nad nimi a veď a ochraňuj ich aj v ďalšie dni života .	Zmiluj	0	Perf
Ak má môj rod zomrieť , tak chcem zomrieť i ja , pomyslela si .	pomyslela	12	Perf
Zrazu ma hnev pominul a nahradil ho smútok .	pominul	3	Perf
Prišli pokušenia , zvody a ony podľahli .	Prišli	0	Perf
Ani ja som si to neželal .	neželal	5	Imp
Na Makovej lúke panovalo ticho .	panovalo	3	Imp
Oblievala ma smrteľná hrôza a trepal som nohami zo všetkých síl .	Oblievala	0	Imp
“ Aj ja , “ odvetil Chris a pohrával sa mi s vlasmi .	odvetil	5	Perf
Zamračila sa .	Zamračila	0	Perf
Vidím dobre ? “ vyľakal sa Ferdo .	Vidím	0	Imp
Práve vyliezol zo svojho kopčeka .	vyliezol	1	Perf
“ Ubezpečujem vás , že nič nehrozí , “ kričal žene sultánov hlavný vezír Džafar .	nehrozí	6	Imp
Smutné včielky sedeli pri raňakjách , na stole chýbal tanier s medom .	sedeli	2	Imp
Nežne pozhŕňal mince do hnedého plátenného mešca .	pozhŕňal	1	Perf
Nič som nevidel .	nevidel	2	Imp
V dome im Bibi vysvetlila , čo dáva psíkom jesť a kde majú svoje misky .	jesť	9	Imp
“ Ty pokúšaš moju trpezlivosť ? “ zreval .	pokúšaš	2	Imp
Ten telnatý muž sa ma nič nevypytoval .	nevypytoval	6	Imp
Za nič na svete však nechcela opustiť svoju rodinku , a tak sa Rudko a Flip rozhodli , že jej občas pomôžu .	nechcela	5	Imp
Vzápätí pribehli mandelinčatá s boľavými bruchami , takže musela ošetriť aj ich .	ošetriť	9	Perf
Vláda bude venovať pozornosť aj ďalším súčastiam slovenskej zahraničnej politiky , medzi ktoré patria viaceré oblasti dvojstrannej a mnohostrannej diplomacie , otázky ľudskej dimenzie , ekonomický rozmer diplomacie , optimalizácia zahraničnej služby .	venovať	2	Imp
" Ako vyzerá ? "	vyzerá	2	Imp
Aj on sa medzitým prezliekol .	prezliekol	4	Perf
Abu strčil hlavu do mešca .	strčil	1	Perf
Zjavne potešení novou udalosťou pozorne načúvali .	načúvali	5	Imp
Srdce mi bilo ako zvon , no odľahlo mi , len čo za sebou zavrela .	bilo	2	Imp
Obsah tvorili nevyberané útoky na maďarskú menšinu žijúcu na Slovensku .	tvorili	1	Imp
Pri dychovke , čo kvôli nemu vyhrávala , tancoval s istou slečnou myškou ako divoch .	tancoval	8	Imp
Beztak tie pracovité mravce nemohol ani cítiť .	cítiť	6	Imp
V oblasti aktívnej politiky trhu práce bude vláda presadzovať princíp návratnosti a projektového financovania .	presadzovať	8	Imp
Abu položil na zem pred mladého muža vankúš .	položil	1	Perf
“ Máte Baghírovo slovo , “ dodal .	dodal	6	Perf
Hneď nás pribehla spolu odfotiť .	pribehla	2	Perf
U nás jeme to , čo sa objedná cez donášku alebo mrazené jedlá , “ povedal Chris .	jeme	2	Imp
Kto zažil sparné pražské popoludnie , vie veľmi dobre , čo znamená spojenie " správně vychlazená dvanáctka " .	zažil	1	Perf
Kuber to vie , no neodváži sa odporovať .	odporovať	7	Imp
Našťastie sa nemusím veľmi rozpisovať , lebo Hysteria Pub má svoju webovú stránku .	nemusím	2	Imp
Na trhovisku ho zarazilo množstvo čudných vecí a kadejakých vôní .	zarazilo	3	Perf
Trochu sa zľakla , no pozrela hore .	zľakla	2	Perf
Od ich svadby ubehli tri či štyri mesiace .	ubehli	3	Perf
Ich bojový pokrik prilákal spústu divákov .	prilákal	3	Perf
Nakoniec , takisto môže aj Čech čítať slovenské , keby chcel , oni však tú potrebu V ROVNAKEJ MIERE nemajú . “	čítať	6	Imp
Krútiace sa duše mŕtvych stiahli pána podsvetia medzi seba .	stiahli	4	Perf
A po ďalšej minúte sa opäť rozburácal divoký rev davu .	rozburácal	6	Perf
Odkašlal si .	Odkašlal	0	Perf
Zrazu sa nad ňou ktosi tichučko zasmial a akýsi hlások sa jej spýtal : “ Prečo sa bavíte so bzdochou ? “	bavíte	17	Imp
Navoskované hlavičky zápaliek chránia pred namočením .	chránia	3	Imp
“ Napríklad na nej chodiť , “ napadlo Maji a hneď si to vyskúšala .	vyskúšala	13	Perf
Niektoré úmrtia tak akosi predpokladáme , ľudia sa k nim systematicky dopracovávajú .	dopracovávajú	11	Imp
Chvíľu ho nechali metať sa vo vode , no potom prilákali k studni muža , čo okopával záhradku .	prilákali	10	Perf
Komár unudene pozrel do trávy .	pozrel	2	Perf
Tá žena mi položila ruku na hlavu a rozstrapatila mi vlasy .	položila	3	Perf
Občas sa niekto chabo a dosť bezvýsledne pokúsil sfúknuť dvadsaťcentimetrové plamene .	sfúknuť	8	Perf
“ Ako môžete také niečo povedať ! “ vyhŕkla Maja .	vyhŕkla	8	Perf
Chcel som poprosiť aj redaktorku , aby už nevyužívala repliky mojich postáv .	nevyužívala	8	Imp
Po špičkách som vošiel do Irminej izby .	vošiel	3	Perf
V Čarodejníckej vile sa nikto netešil takému privilégiu .	netešil	5	Imp
Rozbehla som sa a skočila , pričom sa hladina rozbúrila ako po výbuchu .	skočila	4	Perf
Ty si to vedel -- odnepamäti si to vedel . "	vedel	8	Imp
V temnej miestnosti blikalo iba svetlo sviec .	blikalo	3	Imp
“ Pri opičom more to tak býva , “ odvetil chlapec .	odvetil	9	Perf
Môžem ti pomôcť ? “ ľutovala ju Maja .	Môžem	0	Imp
Nakoniec obrazovka môjho mozgu zhasla a uprostred nej zostal jeden žiariaci bod .	zhasla	4	Perf
Rozvíjajú sa jednotlivé kniežatstvá .	Rozvíjajú	0	Imp
“ Tú šóru v žiadnom prípade nezvládneme , “ povedal Rýchlik a začal cúvať .	povedal	9	Perf
Otočila som sa a medzi divákmi som zazrela Jilliných rodičov .	Otočila	0	Perf
Bežala na rodnú lúku , ktorú po búrke ľahko našla .	našla	9	Perf
Snežilo husto , padali veľké vločky .	Snežilo	0	Imp
Chichúňali sme sa ako pojašení , prebehli sme cez trávnik a smerovali k múru .	prebehli	6	Perf
Dievča sa zaľúbi ako moja mama , a vzdá sa štúdia .	zaľúbi	2	Perf
“ Musím sa porozprávať s dcérou . “	Musím	1	Imp
Zrazu som začula klopkanie na okno , no neposkočilo mi srdce ako inokedy .	začula	2	Perf
Ale keď veľký vlk vopchal do košíka ňufák , bábätko sa zasmialo .	vopchal	4	Perf
Ocitlo sa osamote s Lori a zo svojej skrýše všetko pozorne vnímalo : tvary Lorinho tela , jej dych , vôňu jej mäsa .	vnímalo	11	Imp
Keď opätoval môj pohľad , vedela som , že je to naozaj on .	opätoval	1	Imp
Cez tenké steny sem zvonku dopadalo iba chabé svetlo .	dopadalo	5	Imp
Wendy a chlapci vyjavene hľadeli , ako k oblohe stúpa čierny dym .	hľadeli	4	Imp
Ja to viem , prehovoril som po dlhom váhaní .	viem	2	Imp
Na nebi ani mráčka a z blankytného neba hrialo slnko .	hrialo	8	Imp
Jeho KLIP ‐ KLAP ! počuť široko ‐ ďaleko .	počuť	5	Imp
A opäť som zamieril kameru na Lorinu tvár .	zamieril	3	Perf
“ Počkajte , chvíľu .	Počkajte	1	Perf
“ Prosím vás , slečna , “ prosíkal .	prosíkal	7	Imp
Jej tvár vo mne vzbudzovala dôveru : bola to pokojná , vľúdna tvár .	vzbudzovala	4	Imp
Všetky ďalšie uhorské právne normy , ktoré reglementujú život kláštorných spoločenstiev nachádzame potom až medzi kánonmi I . ostrihomskej synody .	reglementujú	7	Imp
“ Musím sa učiť . “	učiť	3	Imp
Chcela som , aby bral život trocha vážnejšie .	bral	4	Imp
“ I mne sa raz snívalo , že budem učiť najväčšieho hrdinu všetkých čias , “ vyhlásil Fil .	snívalo	5	Imp
Svorka sa vrhne za ním .	vrhne	2	Perf
“ Nemôžem sa správať , ako ty chceš ! “ kričala som zachrípnuto .	chceš	7	Imp
Medzitým Mauglí vo vzduchu kričal : “ Pustite ma !	Pustite	7	Perf
Potrebujem finančnú podporu , ak chcem študovať .	chcem	5	Imp
“ Uteč , Mauglí , uteč ! “ kričal Balú .	kričal	8	Imp
Celú noc som ani oko nezažmúril , spal som iba chvíľu nadránom .	spal	7	Imp
Vláda upraví rámcové podmienky regionálneho rozvoja decentralizáciou verejných financií a zavedie nový , efektívnejší systém finančného vyrovnávania sociálno - ekonomických rozdielov vyšších územných celkov .	zavedie	10	Perf
Po príchode „ trestnej výpravy “ však nepokoje už opadli a všetko bolo v poriadku — no príchodzích museli kolonisti živiť .	živiť	20	Imp
Táto odpoveď mi stačila .	stačila	3	Perf
S čím som mala súhlasiť ? “ nechápala som .	nechápala	7	Imp
Formulácia „ Volumus , ut episcopi habeant potestatem . . . “ implikuje interpretáciu , že biskupi , vykonávali svoj úrad z vôle panovníka , že on im udeľoval mandát na reálne pôsobenie v ich úrade .	vykonávali	18	Imp
Tentoraz nebola sama .	nebola	1	Imp
Chvíľu čakal , ale mnoho ľudí mu netlieskalo .	netlieskalo	7	Imp
Šaty , ktoré šila Flóra , sa nevydarili .	nevydarili	7	Perf
Vilko skúsil aj vyskočiť .	skúsil	1	Perf
Pokľakol pred ňou a vzal jej ruky do svojich .	Pokľakol	0	Perf
“ Obviňujeme vás , že ste nám odcudzili drahocennú potravu , “ povedal prísne veliteľ a dal pokyn , aby ich zajali a postavili pred sudcu .	Obviňujeme	1	Imp
Zdalo sa , že je bystrý .	Zdalo	0	Imp
Winston ho jemne uchopil za ruku .	uchopil	3	Perf
“ Konečne ! “ zvolal so smiechom .	zvolal	4	Perf
Kúpil som , čo bolo treba , a odišiel som .	Kúpil	0	Perf
Žiť pre jedlo je to najlepšie , najistejšie a najbezpečnejšie , čo sa môže prihodiť .	Žiť	0	Imp
Potom sa všetko vyvinulo nečakaným smerom .	vyvinulo	3	Perf
Asi sa budem musieť nad sebou zamyslieť .	zamyslieť	6	Perf
Bláznovstvo , bláznovstvo , bláznovstvo , pomyslel si znovu .	pomyslel	6	Perf
Počul , ako Júlia zaťala zuby . " Asi by sme sa mali rozlúčiť , " poznamenal .	zaťala	4	Perf
Ležala som na doske a pozerala naňho .	Ležala	0	Imp
“ Vyhral si ! “	Vyhral	1	Perf
Sadli si na rímsu a Maja zreteľne videla , čo sa dnu deje .	Sadli	0	Perf
“ To je super ! “ zvolala som .	zvolala	6	Perf
Vždy mu odporovala , keď povedal niečo podobné .	odporovala	2	Imp
Ak im dovolíme , aby na nás zaútočili zo všetkých strán , nikdy sa neubránime .	dovolíme	2	Perf
Polovicu zo všetkého , čo vo mne je , mám z domu , z toho , čo sa doma povedalo , napríklad pri stole .	mám	9	Imp
Buď som nečakal , že mi do toho zasiahne , alebo mal vo svojom výzore i držaní tela stále čosi neprirodzené , čo ma znepokojovalo a zároveň uvádzalo do rozpakov .	znepokojovalo	24	Imp
Lori bola vedľa mňa , aby mi potvrdila , že Irma , ktorú pohltilo nebo , teraz letí do iného sveta .	letí	17	Imp
Otvoril oči a s vďakou sa zahľadel na O ' Briena .	zahľadel	6	Perf
“ Kto ma volá ? “ ozvalo sa .	ozvalo	6	Perf
Keď bol bohatý , pripadali mu tie jagavé vežičky akosi bližšie .	pripadali	4	Imp
“ S vami sa už nemienim baviť ! “ kričal rozhorčene .	nemienim	5	Imp
Medzitým prišlo na plaváreň zopár deciek z oddielu a ich hlasy sa ozývali po vykachličkovanom priestore .	prišlo	1	Perf
Niekto zo susedov si mohol všimnúť , že som bol preč , mohol by sa ma zvedavo vypytovať , kde som bol , a to by stačilo , aby sa som sa rozčúlil .	rozčúlil	32	Perf
“ Ranná čata pôjde chlapca hľadať . “	pôjde	3	Imp
“ Pustite ma ! “ vykríkla vystrašená Petronila .	Pustite	1	Perf
„ Ypsilon ako hláska nie je funkčný a v slovenskom jazyku takej hlásky niet .	niet	13	Imp
“ Nejedz od nej nič , “ zašepkal .	Nejedz	1	Perf
Rád by som v tomto poďakovaní spomenul všetkých , ktorí akoukoľvek radou či pomocou prispeli ku zrodu predkladanej publikácie .	prispeli	14	Perf
Reklama nás každý deň bombarduje rôznymi výzvami , sľubuje bohatstvo , zdravie a úspech .	bombarduje	4	Imp
“ Mimozemšťania , “ zašepkal Rudko vystrašene .	zašepkal	4	Perf
Keď sme asi hodinu kráčali po ceste pre vozy , mama odbočovala ku kravínom a ja som išla ďalej do školy .	kráčali	4	Imp
Spôsobuje mi najväčšie utrpenie .	Spôsobuje	0	Imp
“ Čo sa deje ? “ spýtal sa Chris , hoci sme to obaja vedeli .	vedeli	14	Imp
Prosíme o Vaše príspevky a finančnú podporu .	Prosíme	0	Imp
“ Je mi to ľúto , chlapče , “ smutne mu vravel Fil .	vravel	11	Imp
“ Tu niekde mám bundu , “ zamrmlal .	zamrmlal	7	Perf
Duchovní v tejto funkcii sa netešia veľkej úcte , sú ohováraní svojimi nevoľníkmi , mučení a zabíjaní .	netešia	5	Imp
Tekla vychrlila niekoľko oplzlých pavúčich nadávok , ale na silného Chrabroša si netrúfla , a tak kľajúc zaliezla pod vädnúci list .	kľajúc	16	Imp
Naším zámerom je odstrániť najmä deformácie , ktoré zakladajú neopodstatnené nerovnosti medzi občanmi alebo zavádzajú do sociálneho systému cudzorodé prvky , akým je napríklad nesystémové včlenenie kúpeľnej starostlivosti do sociálneho poistenia .	zakladajú	8	Imp
Videl , že chce niečo povedať .	Videl	0	Imp
Všetky ďalšie uhorské právne normy , ktoré reglementujú život kláštorných spoločenstiev nachádzame potom až medzi kánonmi I . ostrihomskej synody .	nachádzame	11	Imp
Spamätala sa , až keď zacítila jemný dotyk .	Spamätala	0	Perf
Vcelku ľutujem , že som to neurobil . "	ľutujem	1	Imp
V jednom rohu podložky je ventil , po jeho otvorení pena nasáva vzduch , nafukuje sa .	nasáva	11	Imp
V každom prípade musím otvoriť oči a nesmiem veriť legendám .	veriť	8	Imp
Išiel som za ňou , akoby som kráčal v ústrety budúcnosti .	kráčal	7	Imp
Rozsiahla a pomerne dobre organizovaná archeologická práca na teritóriu bývalého ZSSR , detailne zachytená v materiáloch časopisu „ Sovetskaja Archeologija “ / od roku 1990 Rosijskaja Archeologia / ho dáva k dispozícií veľké množstvo .	dáva	29	Imp
Raz som chytil muchu a vlastnoručne som ju hodil do pavučiny , ale nevidel som , že by sa objavil nejaký pavúk , ktorý by ju zožral .	nevidel	13	Imp
“ TUŠÍM MÁŠ DOBRÚ NÁLADU , “ podozrievavo povedala mama , keď som sa ponúkla , že jej umyjem auto , kým pôjde do práce .	pôjde	22	Imp
Dnes to dotiahnu ďaleko takí , ako si ty . . .	dotiahnu	2	Perf
Vyzerala staršie a veľmi intelektuálsky .	Vyzerala	0	Imp
Zaburácal silný výbuch , ktorý akoby zodvihol vydláždený chodník ; na chrbát mu dopadla spŕška ľahkých predmetov .	zodvihol	6	Perf
“ Chodí spať ako slniečko , “ povzdychol si motýľ Emanuel .	povzdychol	7	Perf
“ Viete čo ? “ povedal Ferdo kamarátom .	Viete	1	Imp
Winston bol ženatý a pravdepodobne ešte stále je ženatý , lebo pokiaľ vie , jeho žena nezomrela .	vie	12	Imp
“ Čo tam robíš , Amy ?	robíš	3	Imp
O tom , že si v nich počínajú veľmi dobre , svedčia niektoré úspechy .	počínajú	7	Imp
Smrteľne nebezpečné bolo predovšetkým to , ak niekto rozprával v spánku .	rozprával	8	Imp
Usadila sa na leknovom liste a začala sa umývať .	umývať	8	Imp
Skladal sa z dvoch odlišných častí .	Skladal	0	Imp
Často sa pokúšam nájsť nejaké vysvetlenie , prečo som ju vtedy nenávidela .	nenávidela	11	Imp
“ Rob ako ja .	Rob	1	Imp
“ Cítil som , že to povieš . “	povieš	6	Perf
V ten deň mi povedala , že sa podobáme na Čechovových provinčných hrdinov .	podobáme	8	Imp
“ Ďakujem , pani Hutchinsonová , “ odvetila som naradostene .	odvetila	7	Perf
Dôležitejším znakom oboch kategórií šamanov je , že úspech ich činov nezávisí od toho , akú obetu bohu prinesú , ale od toho v akom vzťahu sú oni sami s bohmi — tj . od ich schopností .	nezávisí	11	Imp
Chris pokrútil hlavou .	pokrútil	1	Perf
Chcel som ju pohoršiť , dosiahnuť , aby odišla .	Chcel	0	Imp
V dôsledku rímsko - centralistickej tendencie zbierok prevzali do nich zostavovatelia i viaceré úplne alebo čiastočne sfalšované texty , ktoré však svojím obsahom zodpovedali stanoviskám a snaženiam reformátorov .	prevzali	7	Perf
Pokračovali sme v pití mlčky , sediac proti sebe .	Pokračovali	0	Imp
Neďaleko jazdil na koni mladý princ .	jazdil	1	Imp
Zachvátila ma panika , nevládal som utekať .	nevládal	4	Imp
Slúžil som u jednej kňažnej !	Slúžil	0	Imp
Človek nikdy nevie , na čo natrafí .	nevie	2	Imp
Mestské zastupiteľstvo schválilo umiestnenie menších sôch šiestich patrónov Európy na Nádvorie Európy , ktoré je vo výstavbe .	schválilo	2	Perf
Vláda SR predloží nový zákon o rozpočtových pravidlách a pravidlách rozpočtového hospodárenia územnej samosprávy .	predloží	2	Perf
Nebojme sa klásť otázky , pýtať sa a odpovede hľadať v Písme .	hľadať	9	Imp
Zrazu rozčúlene pribehol Vilko .	pribehol	2	Perf
Winston sa začal obliekať pomalými , strnulými pohybmi .	obliekať	3	Imp
Už vedela , na čo ho Barbie potrebuje .	vedela	1	Imp
Hru , ktorú hráme , nemôžeme vyhrať .	nemôžeme	5	Imp
Mauglí pokrútil hlavou a chytil sa neďalekého stromčeka .	pokrútil	1	Perf
Keď mravenisku hrozilo nebezpečenstvo , statočne ho bránili .	bránili	7	Imp
Bál som sa , že zloží slúchadlo , a tak som sa usiloval rýchlo niečo vymyslieť .	zloží	5	Perf
Pozreli vyššie , ešte vyššie a zistili , že je to človek .	zistili	6	Perf
Až do Petrohradu som sa pokúšal spať .	spať	6	Imp
Rodičom sa však taký vývoj udalostí nepáčil a zišli sa na porade .	nepáčil	6	Imp
Bál som sa , že moji rodičia sa namiesto toho , aby ma bránili , postavia na stranu útočníka .	Bál	0	Imp
Chvíľu som naňho uprene hľadela a uvedomila si , že hoci to myslel úprimne , nebola to pravda .	myslel	12	Imp
Prsty sa jej skrivili a nechty sa premenili na zahnuté pazúriská .	skrivili	3	Perf
Ako sme už spomenuli , clunyjská reforma sa dostala aj do Lotrinska .	spomenuli	3	Perf
Ale ony medzitým zmizli , pohltila ich temnota .	zmizli	3	Perf
Pomaly zacielil pohľad na Winstona .	zacielil	1	Perf
Vyhrala som !	Vyhrala	0	Perf
Ešteže to spozorvali mravce a zavolali hasičov !	spozorvali	2	Perf
Všetci vedeli , že na papieri sa každý kvartál vyrobili astronomické počty topánok , kým vari polovica obyvateľov Oceánie chodila bosá .	chodila	19	Imp
“ Amy , “ zašepkal Chris , objal ma okolo krku a hladkal ma po vlasoch .	objal	7	Perf
Terk si začala priateľa väčšmi vážiť , ale Kerchak sa zlostil .	vážiť	5	Imp
Chvíľu trvalo , kým zbadali drozda .	zbadali	4	Perf
Vystrela k nemu zdravú ruku a on jej pomohol na nohy .	Vystrela	0	Perf
“ Nesmieš sa udrieť , nesmieš sa udrieť , nesmieš sa udrieť .	udrieť	3	Perf
Mravce roztiahli plachtu a razom všetko stíchlo .	stíchlo	6	Perf
Zaživa ! “ krákala bosorka .	krákala	3	Imp
Už ma bolia nohy . “	bolia	2	Imp
Dobrý Bože , osloboď nás od pyšného presvedčenia , že sme skúsení a múdri .	osloboď	3	Perf
Veľkého brata nepočul nikto .	nepočul	2	Imp
“ Stále by ti hovorili , kam máš ísť a čo si máš obliecť . “	máš	12	Imp
“ Nedopustíme predsa , aby utiekli a varovali netvora , “ povedal ľuďom .	varovali	7	Imp
" Záleží mu iba na sebe , " opakoval po nej .	opakoval	8	Imp
“ Chodí spať ako slniečko , “ povzdychol si motýľ Emanuel .	spať	2	Imp
A pred pevnosťou cvičilo vojsko .	cvičilo	3	Imp
“ Pán Shepherd , “ povedal profesor Tayerle a kývol rukou , “ nemyslite si , že som nevidel lístok , ktorý ste dali pred chvíľou slečne Wyseovej .	nevidel	18	Imp
Schytilo dievčinku labkami a vraví : “ Ty moja krásna dievčinka , odnesiem si ťa do hniezda ! “	vraví	4	Imp
Spomenul Sergeja .	Spomenul	0	Perf
Myslel si , že obdivujem západ slnka .	Myslel	0	Imp
Povedala mi , že užíva antikoncepčné tabletky .	užíva	4	Imp
“ Nesmieš sa udrieť , nesmieš sa udrieť , nesmieš sa udrieť .	udrieť	11	Perf
“ Musíme byť ticho , “ šepkal škriatok .	Musíme	1	Imp
Znovu ho objala .	objala	2	Perf
Už neuvažoval o tom , že by mu mohla nastavovať pascu .	neuvažoval	1	Imp
Veľmi som chcela , aby ostali spolu , no cítila som sa pri nich trochu navyše .	cítila	9	Imp
“ Nehovor , “ zahlásila Jill .	zahlásila	4	Perf
Isteže , už dnes nejestvuje dôvod či opodstatnenie na páchanie ideozločinov .	nejestvuje	4	Imp
Už tretíkrát sme sa mohli stretnúť na neformálnej úrovni a prebrať pálčivé problémy , s ktorými sa stretávame na chodbách našej školy .	stretnúť	5	Perf
Ako starý priateľ tvojho nebohého otca považujem za potrebné , aby sme sa porozprávali celkom otvorene .	považujem	6	Imp
Paravojenské oddiely pritom zabíjali a vyháňali nesrbských civilistov .	zabíjali	3	Imp
V takýchto podmienkach sa moja modlitba mohla len ťažko dostať na správne miesto , napriek tomu som to skúsil .	skúsil	18	Perf
Napla svaly na nohách , vystrela plecia , pozbierala odvahu a slabo sa na mňa usmiala .	vystrela	5	Perf
Keď dohovoril , usmial sa svojím záhadným úsmevom a ustúpil nabok , aby uvoľnil cestu Lori .	dohovoril	1	Perf
Spomínala na deň , keď sa princezná narodila .	Spomínala	0	Imp
Na chrbtici mu vystúpili kropaje potu .	vystúpili	3	Perf
Mám z toho večera fotku .	Mám	0	Imp
Sčista jasna sa strhla búrka .	strhla	3	Perf
Boli ako zmyslov zbavené .	Boli	0	Imp
Ten chlapec tu býva ?	býva	3	Imp
Bála som sa , že keby som naznačila , po čom túžim , mama by si našla aj tretie zamestnanie .	naznačila	7	Perf
Sandra nakukla cez okno dnu .	nakukla	1	Perf
Večer vhupli všetky včielky do postieľok a vytiahli si deky až pod nos .	vytiahli	7	Perf
Mal neuveriteľne dlhé , tenké nohy a smiešne , malé , hnedé a guľaté telíčko .	Mal	0	Imp
Uvedomila som si , že som nevhodne zareagovala , lenže ten bozk ma naozaj vyviedol z miery .	Uvedomila	0	Perf
Povedal som jej , že mám pokazené okno .	mám	5	Imp
Takisto pršalo a ja som opäť stál pri okne salóna a pozoroval ulicu .	stál	6	Imp
" Zradil som ťa , " povedal .	Zradil	1	Perf
Pousmejú sa a zíde im na um moja prezývka .	zíde	3	Perf
Bežala k otvorenému oknu .	Bežala	0	Imp
“ To sa zle skončí , “ kuvikal dážďovka Vendelín , ale nikto ho nepočúval .	kuvikal	7	Imp
Tváril som sa , že odchádzam spokojný , a v tom bol paradox .	Tváril	0	Imp
Za finančnú podporu sa chcem poďakovať Ekumenickej rade cirkví , nášmu drahému zboru a „ staršej “ mládeži ECAV v Prešove , modlitebnému spoločenstvu , kamarátom z tréningu Rovesník a jednotlivcom .	poďakovať	5	Perf
Pomyslel som si , že sa mi to len zdá .	zdá	9	Imp
Na tvári som jej videla , že ju to vzalo , a keď vstala zo stoličky , bála som sa , že odíde z kuchyne .	odíde	22	Perf
Zachytil ma , aby som sa neudrela .	Zachytil	0	Perf
Do nášho podvedomia pomaly a nenápadne ukladá hrdzu , ktorá ukradomky rozožiera našu psychiku .	rozožiera	11	Imp
Potom sa v jednej zákrute objavil ďalší stôl , za ktorým sedeli ďalšie dve ženy .	sedeli	11	Imp
Boli sme najedení až po krk , keď Rýchlik vyhlásil , že sa ide na tortilly , po ktorých Delfíni zaručene zvíťazia .	zvíťazia	21	Perf
Keď na mňa pozrel a usmial sa , pripadala som si krásna , zbožňovaná a múdra .	usmial	5	Perf
“ Amy , “ povedal a jemne ma chytil za lakeť .	chytil	8	Perf
Prežívali sme požehnané chvíle .	Prežívali	0	Imp
“ Toto robia ľudia každý deň ? “ čudovala sa .	robia	2	Imp
V svetle lampy som uvidel agresívnu formu jej pŕs .	uvidel	4	Perf
Presne , “ povedal Chris .	povedal	3	Perf
Ak ste sa na ňu pozreli zblízka , okolo očí mala zopár vrások .	pozreli	5	Perf
Bála som sa , že keby som naznačila , po čom túžim , mama by si našla aj tretie zamestnanie .	našla	16	Perf
“ Ale veď sú ako dobrí priatelia , “ namietala som .	namietala	9	Imp
Opantal ho pocit absolútnej bezmocnosti .	Opantal	0	Perf
“ Tak predsa ste sa bozkávali ! “ zvolala .	bozkávali	5	Imp
“ Tu je diera , “ zašepkala som a vybrala trs trávy , ktorý zakrýval vyčnievajúci stupienok z palmového dreva .	vybrala	9	Perf
Zlosyn napol luk a vystrelil .	vystrelil	4	Perf
Aby sa ľudia mohli smiať .	smiať	4	Imp
Pri tejto príležitosti som zistil , že o tom , čo sa deje už tri mesiace , sa dozvedám ako posledný .	dozvedám	18	Imp
Moji rodičia sa báli .	báli	3	Imp
Zovrelo mi žalúdok a zrýchlil sa mi pulz .	Zovrelo	0	Perf
Polly to nesmierne potešilo .	potešilo	3	Perf
Kúsok chleba ešte stále ležal tam , kam ho odhodil muž bez brady .	odhodil	9	Perf
Áno , jej zmiznutie sa dá vysvetliť jednoducho a logicky .	vysvetliť	6	Perf
Máme prvé dve požiadavky na modernú baterku .	Máme	0	Imp
“ Zaplaťte , “ povedal Rýchlik , ktorý dal kolovať plaveckú čiapku .	kolovať	9	Imp
“ Cítil som , že ma čoskoro prepustí . “	Cítil	1	Imp
S cieľom zefektívnenia správy rozpočtových prostriedkov a správy finančných prostriedkov štátu vláda uskutoční kroky na urýchlené dobudovanie systému štátnej pokladnice .	uskutoční	12	Perf
Drž ! “ povedal .	povedal	3	Perf
Prikývla a povedala , že sa o chvíľu vráti .	vráti	8	Perf
Preglgla som .	Preglgla	0	Perf
Čo iné mi ostávalo ?	ostávalo	3	Imp
Ja som zaujímal svoj výklenok , ona prichádzala po mne .	zaujímal	2	Imp
“ Nedopustíme predsa , aby utiekli a varovali netvora , “ povedal ľuďom .	Nedopustíme	1	Perf
Odkry si tvár !	Odkry	0	Perf
“ Rozmliaždi ho , Džafar , “ škriekal škodoradostne Jago .	Rozmliaždi	1	Perf
Prišlo „ ale “ , ktoré som počul iba nejasne .	počul	7	Imp
Nevdojak som sa poobzeral , či neuvidím Háda .	poobzeral	3	Perf
Nemal najmenšie pokušenie jej klamať .	klamať	4	Imp
Syreeta vyvesila oznam o Abuovom úteku a kto ho nájde , dostane odmenu .	vyvesila	1	Perf
Uchopil ju za ruku .	Uchopil	0	Perf
Jaskyne ma vždy lákali .	lákali	3	Imp
Zmiluj sa nad nimi a veď a ochraňuj ich aj v ďalšie dni života .	ochraňuj	7	Imp
Otrasený , ale zdravý sa z nej vymotal .	vymotal	7	Perf
Pomôž mi .	Pomôž	0	Perf
Odišla som preč , nechala som ho tam .	Odišla	0	Perf
" Vybudovať civilizáciu na strachu , nenávisti a krutosti nemožno .	Vybudovať	1	Perf
V prípade , že klerik žaluje laika , má sa spor prerokovať pred svetským sudcom .	prerokovať	11	Perf
“ Čože ? “ zvolala Maja .	zvolala	4	Perf
Snehulienke sa zakrútila hlava a obchádzali ju mdloby .	obchádzali	5	Imp
Herkules prišiel do podsvetia vo chvíli , keď Megina duša vošla do Hádesovej jaskyne smrti .	vošla	10	Perf
Mešťania sa nazlostili a upozornili Herkulovho otca , nech ho viac do mesta nepúšťa .	nepúšťa	13	Imp
Len čo to Maja začula , zabudla na Hanibalovu prečnohu a ukázala žihadlo .	začula	4	Perf
Začali sme na kolotočoch , kde sme vyliezli na koňa .	vyliezli	7	Perf
Bol som náchylný veriť vo veľké veci .	veriť	3	Imp
Zrkadlo , zrkadlo povedzže mi , ktože je najkrajší v našej zemi ?	povedzže	3	Perf
Iba my s Chrisom sme tak zúrivo nepísali a nehrbili sa nad lavicami .	nehrbili	9	Imp
Skutočnosť , ktorú mi Lori oznámila , bola jednoduchá .	oznámila	5	Perf
Nečakal som , že ju moje slová až tak rozosmejú .	rozosmejú	9	Perf
Kurz dolára trochu klesol , pomyslel som si .	klesol	3	Perf
“ To je dobre , ale dúfam , že najprv budem bohatý a mocný . “	dúfam	6	Imp
“ Tu strávime noc .	strávime	2	Perf
Kedy sa zmenili Rickove city ku mne a prečo som si to nevšimla ?	nevšimla	12	Perf
Robíme , čo môžeme , aby z toho vyšlo fantastické predstavenie .	vyšlo	8	Perf
Vtedy nás poslali na brigádu do Jonufëru pri Vlore , kde sme mesiac budovali terasové polia .	budovali	13	Imp
Najskôr sa na hornej časti schodišťa objavila drobná starena v širokých nohaviciach .	objavila	6	Perf
Vláda pripraví návrh zákona o menšinách , vrátane financovania menšinových kultúr .	pripraví	1	Perf
Prichádzali tam , keď si ich predvolal Cerberus .	predvolal	6	Perf
Na druhom konci linky som začul jej hlas .	začul	5	Perf
V sobotu doobeda odstraňovala deficit spánku , ktorý sa nahromadil za celý týždeň .	odstraňovala	3	Imp
Zvončeky popadali na zem ako vodopád .	popadali	1	Perf
Vtedy mi pripadalo prirodzené vyhľadať v tme jej ruku .	pripadalo	2	Imp
V tej chvíli zišiel zo svojho ležoviska na strome Baghíra , ktorý pozorne počúval všetko , čo sa vravelo .	počúval	13	Imp
Na niektorých uliciach metropoly sa matky ani na chvíľku neodvážia nechať svoje bábätká samotné .	nechať	10	Perf
“ Môžeš chodiť , kam len chceš . “	Môžeš	1	Imp
“ Ale ja som nevinný ! “ vykríkol som .	vykríkol	7	Perf
“ Takto to vyzerá na Mesiaci , “ povedala som Cheryl Wagnerovej , maturantke , čo sedela vedľa mňa .	sedela	16	Imp
Ale nevieš si predstaviť , kde som .	predstaviť	3	Perf
Zrejme poznala ten sladiak naspamäť .	poznala	1	Imp
Kuber to vie , no neodváži sa odporovať .	neodváži	5	Perf
Pomyslel som si , že plače .	Pomyslel	0	Perf
Môj otec po jeho rozpade niekoľko týždňov nespal . . .	nespal	7	Imp
“ Porozprávame sa inokedy , “ zavolala Blythe a veselo mi zakývala , keď odchádzali .	odchádzali	14	Imp
Ale mozog mi nefungoval .	nefungoval	3	Imp
Určite však videla , ako k nej zamieril a hádam aj pochopila , že jej niečo naznačoval .	pochopila	11	Perf
Z politického hľadiska Koloman pápežovi vyhovel .	vyhovel	5	Perf
Vystúpenie veľkého množstva jeho bojových oddielov sa dalo chápať i ako pohanský nepokoj — prežitky predkresťanskej viery sa u Estóncov udržali neobvykle dlho .	udržali	20	Perf
Nič som však nepovedal .	nepovedal	3	Perf
Neskôrnateli vnútorne .	Neskôrnateli	0	Perf
Potom leteli ponad lúkou , až sa dostali k topoľovej aleji .	leteli	1	Imp
Na chvíľu zavládlo ticho .	zavládlo	2	Perf
Pri pohľade na obidvoch som si spomenula na Chrisa .	spomenula	6	Perf
Mnohí z nás s nimi nadviazali hlboké priateľstvá , spoznali sme ich krehučké duše prahnúce po láske , priateľstve a uznaní .	nadviazali	5	Perf
“ Hej ! “ zvolala som a chytila volant .	chytila	7	Perf
To ho dopálilo .	dopálilo	2	Perf
“ Neviem , “ vraví myška , “ ale možno ti poradia tamtie modré kvietky . “	Neviem	1	Imp
Prešiel som do strednej časti mosta .	Prešiel	0	Perf
Určite však videla , ako k nej zamieril a hádam aj pochopila , že jej niečo naznačoval .	naznačoval	16	Imp
To Maju nahnevalo .	nahnevalo	2	Perf
Dôsledky učenia Strany ju ani trochu nezaujímali .	nezaujímali	6	Imp
Aj Maja so škriatkom opustili topoľ a leteli , kým nedoleteli k domu , kde sa v oknách ešte svietilo .	nedoleteli	10	Perf
A kým je môj pas v rukách toho muža , veci vonkoncom nevyzerajú dobre .	nevyzerajú	12	Imp
Chrobáčiky ju najprv utešovali , no potom sa rozhodli , že to povedia Maji .	utešovali	3	Imp
Vlak sa šinul svojou slimačou pomalosťou .	šinul	2	Imp
Vyvesili na tabuľu text , ale ani to nepomohlo , lebo Vilko sa z lenivosti nenaučil dobre čítať .	Vyvesili	0	Perf
" To robí táto pliaga , " povedala , strhla si šarlátovú šerpu Antisexuálnej ligy mládeže a odhodila ju na konár .	strhla	9	Perf
Niečo , čo by nevydesilo Lavdima Lavdoshaja .	nevydesilo	4	Perf
Vždy povstali noví a noví zadubenci , ktorí sa mu dali zviesť .	zviesť	11	Perf
A možno mi zatemnila zrak dažďová clona .	zatemnila	3	Perf
Koleso sa krútilo a náš vozík pomaly stúpal na vrchol .	krútilo	2	Imp
Na úplný záver dlžím ešte jedno poďakovanie .	dlžím	3	Imp
Dnes meškáš , povedala , bála som sa , že neprídeš .	bála	5	Imp
Keď v nej uviazneš , čaká ťa hrozná smrť .	čaká	5	Imp
“ Ty nemáš otca alebo mamu ? “ spýtal sa Dizzy .	nemáš	2	Imp
" Ľutuješ , že si to neurobil ? "	Ľutuješ	1	Imp
Hľadala som v zásuvke nejaký papier na poznámky , keď som zbadala formulár na udelenie finančnej podpory počas štúdia na vysokej , ktorý mi dal ešte pred niekoľkými týždňami výchovný poradca pán Hatch .	Hľadala	0	Imp
Toto stieranie hraníc je veľmi príjemné , pokiaľ ide o poriadneho občana , ktorý cestuje za svojím obchodom alebo za svojou dovolenkou .	cestuje	14	Imp
Bolo by hanba predstúpiť pred žiakov v takom stave .	predstúpiť	3	Perf
Nerúhajme sa Bohu a nereptajme na všetko a všetkých .	nereptajme	4	Imp
“ Tuším vidím princa Omara , ocko . “	vidím	2	Imp
Balú zatiaľ chlapcovi nepovedal , že ho vedie do osady .	nepovedal	3	Perf
“ Nechceme pomstu , “ povedal zmierlivo Ferdo .	Nechceme	1	Imp
Porota však ocenila práce slimákov Šuchtáka a Plazivca , ktorý si prekrásne vymaľovali domčeky .	vymaľovali	12	Perf
Z obilia sa robila múka a z nej sa piekol chlieb .	piekol	9	Imp
O kulte jaštera svedčia už spomenuté rúčky čiaš .	svedčia	3	Imp
“ Pustíš ? “ spýtal sa Ferdinand .	spýtal	4	Perf
Uprene si navzájom hľadeli do očí .	hľadeli	3	Imp
Jurko sa urazil .	urazil	2	Perf
HZDS sa musí vyprofilovať .	vyprofilovať	3	Perf
V sledovaných zbierkach kánonického práva nachádzame celý rad podobných ustanovení .	nachádzame	5	Imp
To ju zobudilo .	zobudilo	2	Perf
Chcel som sa stretnúť s človekom číslo jeden a to ho zrejme prekvapilo .	prekvapilo	12	Perf
Znovu sa ozval zvonivý hlas a nocou sa niesla prekrásna melódia .	niesla	8	Imp
Po špičkách som zišiel do salóna na prízemí , kde som na chvíľu zastal so zatajeným dychom .	zastal	13	Perf
“ Asi som ho zabudol u vás na streche ! “	zabudol	4	Perf
“ A správaj sa slušne , srdiečko , “ zašepkala .	zašepkala	9	Perf
Príjemne ma hrial .	hrial	2	Imp
Umožniť jazykovedcovi rozhovoriť sa o systéme v jazyku , prináša zdanlivo nebezpečenstvo , že sa vstúpi do nezaujímavého a nudného sveta .	rozhovoriť	2	Perf
“ Ricka zaujímajú vážne veci , “ namietla Blythe .	zaujímajú	2	Imp
Pripomínala lebku umrlca .	Pripomínala	0	Imp
