Хазайката се щура из къщи .	щура	2	3
Аз смятам , че тази точка е необходимото допълнение , което балансира цялото решение .	смятам	1	1
Заповядал съм войниците , които пожелаят да работят при нас , след като отслужат , да не бъдат връщани .	отслужат	13	3
Радвам се , че научих много в гимназията , както се радвам , че успях да постъпя в колежа , който исках .	научих	4	1
Действието се развива в романтична атмосфера , създадена от снопове тръстика и папур .	развива	2	3
Господин Пирински , винаги си просрочвате времето и колкото пъти Ви се прави бележка , продължавате да си говорите .	просрочвате	5	2
Разкажете нещо повече за развитието на въоръжението и бойните припаси през последните години ?	Разкажете	0	2
Ако желаете , слушайте ме , ако желаете , вземете ги предвид .	слушайте	3	2
Ако в този текст ние открием себе си като българи , намирайки себе си , мисля , че ще намерим и контакт с нашите зрители .	намерим	19	1
Като усетих , че се люлеем , за секунди се облякох и зарязах болната , изхвърчах като куршум навън .	люлеем	5	1
Тъкмо нашето политическо общество разтърсва сърцата ни .	разтърсва	4	3
Вярно ли е , че притежава в столицата 4 къщи , които струват повече от 200000 лв.	струват	12	3
Аз работих в посолството в София в периода 1985-1987 година , т.е. по времето на комунизма .	работих	1	1
И тя го запита какъв е той .	запита	3	3
С радост се превърнете в най-добрата , най-справедливата , най-обичащата и най-търпеливата , за да му помогнете да преодолее вродения си страх от изоставяне .	превърнете	3	2
- Предполагам не очаквате , че ще има такова въздържане точно в месеците преди изборите ?	очаквате	3	2
Една от причините , поради които голяма част от политиците толкова обичат да ходят на посещения в чужбина , също заслужава внимание .	ходят	13	3
Повече слушай , по-малко говори .	слушай	1	2
За нещастие , действието на пиесата се развива в Испания , защото аз избрах това , след като размислих , че трябва да се развива именно там .	избрах	13	1
Заспа , щом положи глава на възглавницата .	положи	3	3
Ако ще тръгваш , тръгвай !	тръгвай	4	2
Ако желаете , слушайте ме , ако желаете , вземете ги предвид .	желаете	7	2
Български национален интерес е България , ние българите , да станем пълноправна част от Обединена Европа , да станем част от Обединена Европа , така че границите на Обединена Европа да са нашите граници .	станем	18	1
Затова и се гордеем , че оцеляваме .	гордеем	3	1
Двамата мъже се втрещиха .	втрещиха	3	3
До края на годината ни предстои да положим общо 16 667 метра железен път на обектите София - Волуяк , Хасково - Димитровград , Долно Камарци - Мирово и Павликени - Лесичери .	положим	7	1
Принуждават българите да напуснат Германия ?	Принуждават	0	3
Същите тези лица цяла година се мотаха с промените в Закона за енергетиката , които трябваше да регламентират отношенията между " Топлофикация " и хората .	мотаха	6	3
Благодаря ти !	Благодаря	0	1
- Ще намерим , ти не се тревожи !	намерим	2	1
- Смятате ли , че ще се облекчат и пътуванията на наши военнослужещи в различните мисии ?	облекчат	7	3
Доказал си го и отново ще го докажеш .	докажеш	7	2
Моята лична позиция , доколкото може да бъде защитена , е да смятам , че ако хората не са невинни , то те са виновни само от невежество .	смятам	12	1
Активно учене означава да правиш бележки по записките си , да ги осмисляш , да преразказваш информацията , да правиш планове .	осмисляш	12	2
Изпратиха нов човек на групата за ръководител .	Изпратиха	0	3
За нещастие , действието на пиесата се развива в Испания , защото аз избрах това , след като размислих , че трябва да се развива именно там .	размислих	18	1
И това ще те принуди рано или късно да върнеш заетото .	върнеш	9	2
Тримата направихме жива картина .	направихме	1	1
С моя незначителен принос аз направих каквото можах и то ви скандализира .	направих	5	1
Остава обаче една малка подробност - също толкова енергично те да ни помогнат да повишим благосъстоянието си , за да има с какво да ходим на Запад като бели хора .	ходим	24	1
Може в последния момент да ми се прииска да видя пристигането на Дядо Коледа .	прииска	7	3
Това почна да го смущава .	смущава	4	3
Това показва изследване на НЦИОМ от ноември за правното съзнание .	показва	1	3
И си останал у тях да притяга кочината .	притяга	6	3
Необходимо е да се настройва системата , за да работи по-добре , обясни новите промени министърът .	настройва	4	3
Малката газена лампа едва смогваше да освети само лявата й страна , по средата на която едва се крепеше бистра , едра сълза .	крепеше	18	3
Юристите на правителството на САЩ разнищваха подробно през последните седмици резолюцията и стигнаха до заключението , че тя не изключва независимостта .	разнищваха	5	3
Тъй си чака от година време .	чака	2	3
Не , моята хитрост е още по-голяма : аз пиша само добрите .	пиша	9	1
За процедура думата има господин Овчаров , но наистина да е процедура , а не да почвате да отговаряте .	отговаряте	18	2
Жела умееше да се докарва и знаеше кога да бъде по-смела .	докарва	4	3
Ако продължава така , ще се избием	избием	6	1
Сърцето ми бие силно .	бие	2	3
Можеш да имаш талант , но като те мързи , всичко отива по дяволите .	Можеш	0	2
" Разбирам се с околните . "	Разбирам	1	1
Един ден спрях .	спрях	2	1
Проектът за единния център предвиждаше заемът от 60 млн. евро да бъде само за 72 % от стойността на целия обект , а остатъкът да се даде от самото РВД .	предвиждаше	4	3
Един милиард души ще умрат през новия век , ако днешните тенденции сред пушачите се запазят , прогнозират британски лекари , цитирани от Ройтерс .	прогнозират	17	3
Въобще оказа се , че някои служители в МВР са с къса памет в последно време , което ме навежда на мисълта , че трябва да ги уволня , за да не се затормозяват и да си опреснят паметта	опреснят	37	3
Тия думи на стареца не трогнаха Павел .	трогнаха	5	3
Ако протегнеш ръка вдясно , ще докоснеш нищото .	докоснеш	6	2
Искаше да я улови и да я реже на късове .	реже	7	3
Разгледахме докладите за финансовото състояние на пловдивското козметично предприятие и стигнахме до извода , че претенциите на Тоню Икономов за намаляване на цената са неоснователни , обяви шеф-надзорникът на АП Асен Дюлгеров .	Разгледахме	0	1
В новогодишната нощ " Акага " , " Уикеда " , Иван Лечев , Валя Балканска и " Щурците " ще пеят на живо за всички , които решат да посрещнат новото хилядолетие навън .	посрещнат	30	3
Заповядал съм войниците , които пожелаят да работят при нас , след като отслужат , да не бъдат връщани .	пожелаят	5	3
Виеха глутници чакали .	Виеха	0	3
Но когато кризата започне , ще се ограничим още .	ограничим	7	1
Докато не ми се случи това , самата аз не вярвах и се присмивах на ясновидците	вярвах	10	1
Имаме адреса му във Франция , а и не мислим , че човекът ще се опита да избяга от правосъдието	Имаме	0	1
Ако искаш да вземеш , научи се да даваш .	вземеш	3	2
Предпочитах да бях му го давал .	Предпочитах	0	1
Продължава спорът за олимпийската виза в категория до 56 килограма в свободната борба .	Продължава	0	3
- От Пловдив съм и ще пътувам .	пътувам	6	1
Ще разположим и търговски обекти , за да можем да изпием по чаша топло вино , каза кметът Софиянски .	разположим	1	1
- Можем да направим собствено издателство .	направим	3	1
Така че ако наистина дават кола за непознали , със сигурност ще я спечеля .	спечеля	13	1
Книгата ли му четеш ?	четеш	3	2
Когато учех за контролното есе за Ренесанса на мистър Уайдман , измислих думата пракехплимим да ми напомня за перспектива , религия , анатомия , класически езици , хуманитарни науки , природа , литература , интелектуалност , материализъм и младост .	измислих	11	1
Може да ти помогне следното : занимавай се с книгите около час , след това се поразходи 15 минути , а след това отново учи , като определиш друг отрязък от време .	занимавай	6	2
Нямах друг избор , освен да се разгранича от позиция , с която не съм съгласен , като подам оставка .	Нямах	0	1
Докато берете памука , няма да ги освобождаваш .	освобождаваш	7	2
Ние сме неколцина , които не желаем да мълчим за нищо .	мълчим	8	1
Погледнах си часовника .	Погледнах	0	1
В края на 1998 г. Конгресът предприе процедура за отстраняването му от власт , но след шумен процес в Сената президентът на Америка бе оправдан .	предприе	6	3
Трафиканти ни заобикалят заради строгите митничари	заобикалят	2	3
Три пъти ни бяха оказвани масирани атаки за дестабилизиране на ДСК , но устояхме	устояхме	13	1
Ако протегнеш ръка вляво , ще докоснеш пустотата .	докоснеш	6	2
- Вие мразите ония горе ?	мразите	2	2
През това време хора като Красимир Балъков , които наистина разбират и играят истински футбол , са пренебрегвани по уникално безумен начин .	разбират	10	3
Единствено млеко- и месопреработвателите могат да разчитат на субсидиите , защото те залагат техника и цехове , смятат експерти .	разчитат	6	3
Глава 15 съдържа полезни идеи за това , как да включите справянето във вашата философия за живота , и сигурно ще искате да я прочетете след това .	включите	10	2
Опитай да започнеш работата си по проекта отрано и да го правиш стъпка по стъпка , за да не се претовариш .	претовариш	20	2
Кого мислиш , че Иван каза да потърсиш ?	потърсиш	7	2
Когато поставяш пред народни представители проблемите , е напълно логично да очакваш съответната законодателна реакция .	поставяш	1	2
Приемаме изявлението на президента като положителна индикация в нашето политическо пространство .	Приемаме	0	1
Но днес малцина помнят как тогава всички обещаваха , че след десет години първите страни ще бъдат приети за членки в съюза .	помнят	3	3
Групата ще нарастне до 98 , ако двойката ни по бийчволей - сестри Янчулови , влезе в схемата за игрите .	нарастне	2	3
В личен план се надявам да си намеря работа , защото иначе се живее много трудно .	намеря	7	1
В някои градове дори има горещи линии за домашни работи , на които ще ти помогнат да се справиш с трудните въпроси .	помогнат	15	3
Достатъчно е да се създаде възможност всеки , който погаси част от дълга , да ползва инвестираните средства за плащане на бъдещите си задължения към държавата .	създаде	4	3
Ще подам официална жалба , ако не бъда върнат на работа .	подам	1	1
На събранието присъстваха и студенти , някои от които се изказаха .	присъстваха	2	3
Провери за правописни грешки ( опитай се да намериш " одавена " или " по-малко " в речника ) .	Провери	0	2
Пет пъти се прекръстих онази нощ .	прекръстих	3	1
Още не мога да си пречупя езика да проговоря на турски , ама вече всичко разбирам	разбирам	15	1
Това исках да внеса аз като уточнения .	внеса	3	1
" Критикувах се / Четох си конско . "	Критикувах	1	1
За мястото при мъжете спорят Юнаков , Иван Киряков , Иван Филчев , Пламен Пенчев , Цветан Попов , Стефан Жечев , Алексей Василев и украинецът Анатолий Семенюк .	спорят	4	3
Но самите преговори на присъединяване отвориха нова страница на предизвикателства пред България .	отвориха	5	3
Видях 2-ма души , които поразително приличат на президента и премиера .	Видях	0	1
Бившите собственици заплашват да легнат пред френските танкове и да попречат на учението на войници от НАТО на полигона .	легнат	4	3
По общата логика в този случай отново следва да се иска решение на общинския съвет и отново възниква въпросът за начина на съчетаване на интересите при вземането на решение .	възниква	17	3
Зная му , вика , цаката и като гледам какви пари се сипят в джобовете на аптекарите от града , коремът чак ме присвива , ама какво да правя , като си нямам наличност .	правя	28	1
Гангрената спечели .	спечели	1	3
Мерих , гласих , отрязах им главите , направих снимката и операцията излезе горе-долу сполучлива , ама не е там работата !	гласих	2	1
Отговорът е : защото не искаме повече от проектобюджета на социалната хазна да лъха само мизерия и пълно пренебрежение към хората , които днес плащат на НОИ за хипотетичните си бъдещи пенсии .	искаме	5	1
Не можем да търпим треторазредни чиновници да ни унижават с месеци за една виза , говореше от трибуната Каракачанов , докато децата ритаха кашоните .	търпим	3	1
Този гражданин на планетата Земя - огледайте го добре и го запомнете , - този гражданин на планетата е решил да се самоубие .	запомнете	11	2
Разкажете малко повече за образователния ценз и качествения подбор на девойките , които постъпват като курсантки в училището ?	Разкажете	0	2
Забелязвам изключителната слабост на банковата система по отношение на кредитирането .	Забелязвам	0	1
Бъдещите младоженци ще се преместят да живеят в Лондон .	живеят	6	3
Връчих си рапорта за напускане .	Връчих	0	1
Те не знаеха как си е загубил прасето и го попитаха .	знаеха	2	3
Узнах новината от него .	Узнах	0	1
Ще бръкне да извади някое шише - иди го гони сетне .	гони	9	2
Тя написа болничния лист , постави предварителната диагноза и изписа медикаменти .	постави	5	3
Образованието ти ( във и извън училище ) е за тебе - така ще можеш да управляваш живота вместо да се оставяш той да те води .	управляваш	16	2
Аз между другото съм гласувал за това тези реактори да продължат да се експлоатират докогато е тяхната проектирана експлоатация , експлоатационния им срок .	експлоатират	13	3
Не можела да започне работа по професията си , тъй като няма работодател , който да те наеме без всякакви документи и само с червения паспорт с туристическа виза .	наеме	17	3
Президентът Стоянов ги нарече лумпени , които се гаврят с българското национално съзнание , и призова най-сетне да се вземат мерки .	гаврят	8	3
Вашата Военна академия работи по всички стандарти .	работи	3	3
Той ги увери , че ще могат да разчитат на субсидиите на Евросъюза , но след като полското селско стопанство осъществи необходимите реформи и се модернизира в съответствие с европейските стандарти .	разчитат	8	3
- Няма да го поканя !	поканя	4	1
Докато берете памука , няма да ги освобождаваш .	освобождаваш	7	2
Ако не видиш злото , не познаваш доброто .	познаваш	6	2
Стани премести книгите .	премести	1	2
Като го доближи , ритна го с все сила , та изпращя , разглоби се на парчета и парите се пръснаха по земята .	изпращя	11	3
Подозрението за сделка с управляващите , което се роди заради безстрастната му реакция при назначаването на Поля Станчева за програмен шеф в БНР , ще се потвърди или отпадне в зависимост от крайния избор на съвета .	роди	8	3
Настояваме за това .	Настояваме	0	1
Един пие , друг пуши , Пеньо писарят , да речем , обича да яде печени семки с хляб , а на наша Лала дай й да си похапва и работа й дай .	речем	10	1
- Имам много ангажименти .	Имам	1	1
Догодина ще се събират по 4 промила от цената на жилищните имоти за извозването на кофите за отпадъци .	събират	3	3
Слушай внимателно , когато учителят обяснява какво ще включва тестът и така ще знаеш точно какво да учиш .	учиш	17	2
Вие несъмнено ще сметнете , че влагам много страст по такъв малък повод .	влагам	6	1
Най-после в нашата страна се изправяме пред този въпрос .	изправяме	5	1
Нещата , които могат да се случат на СДС , са много малко и ги изчерпваме с общата тема компромати .	изчерпваме	15	1
При всички положения си даваме реална сметка за покупателната възможност на потребителите у нас .	даваме	4	1
Ако сметнете погрешно , че то просто обича да бъде само , ще го нараните за дълги години напред , затова забравете строгостта и участвайте в заниманията и игрите му .	участвайте	24	2
Гълъбин Боевски отказва да е знаменосец в Сидни , за да сваля килограми	сваля	11	3
Хората те ги видяха .	видяха	3	3
Полша призова и за свикване на международна конференция с участието на всички заинтересовани страни , които да обсъдят проекта .	обсъдят	17	3
Продажбата на алкохол по магазините и заведенията се спира преди обяд в неделя и ще бъде възобновена едва на следващия ден .	спира	8	3
Опитай да започнеш работата си по проекта отрано и да го правиш стъпка по стъпка , за да не се претовариш .	започнеш	2	2
Ако се стигне до споразумение , ЦСКА ще изиграе приятелска среща на разменни начала с отбора на " Биркиркара " .	стигне	2	3
В интервю пред столичен всекидневник обаче прокурорът признава , че не разполага с улики .	разполага	11	3
Вероятно вие ще знаете , че той е чувствителен , нуждае се от пространство , топлота и свобода , за да даде воля на мечтите си за красота , любов и разбирателство .	знаете	3	2
Да преминеш през гимназията , да постъпиш в колеж	постъпиш	6	2
Ако ги достигне ...	достигне	2	3
Говорим , че искаме да имаме мобилна , добре въоръжена , добре екипирана армия , но човекът продължава и ще продължава да играе основна роля в тази армия .	Говорим	0	1
И ето виждам да се приближава към нас тъмна , вълнуваща се маса хора .	виждам	2	1
Банките и сарафите обаче ще подават сигнали до Бюрото за финансово разследване , само ако има съмнения за пране на пари , поясниха експерти .	подават	5	3
Дано хората , които го посрещнат , да си прекарат весело .	посрещнат	5	3
" Поставям си високи стандарти . "	Поставям	1	1
Скочи Дечко , сграбчи я през кръста ...	Скочи	0	3
Не плачи , момчето ми , стига .	плачи	1	2
И двата прототипа са част от една обща вълна на прототипи , която залива последователно големите автосалони .	залива	13	3
Прави списъци .	Прави	0	2
Само да имаха дързостта да излязат насреща му .	имаха	2	3
Черноморският комплекс купи хотела за 1,25 млн. швейцарски франка и изцяло го обнови .	обнови	12	3
Вие намирате , че въпросната роля е отвратителна , докато в романа ми не е била такава .	намирате	1	2
Пътуваме цяла нощ .	Пътуваме	0	1
Аз съм в състояние да почувствам напълно едно стихотворение само когато го науча наизуст и мога да си го повтарям непрекъснато , да го обръщам и да го оглеждам отвсякъде .	оглеждам	28	1
Населението , което е далеч от дървения бизнес , иска да се затворят цеховете , преди гората да бъде унищожена .	затворят	12	3
" Полагам големи грижи за нещата , които ми принадлежат . "	Полагам	1	1
БСП се коалира с обединението на Дон Цеци	коалира	2	3
Аз малко разбирам от тези работи , та затова мога да сгреша .	разбирам	2	1
Успяхме да поведем в края на двубоя , но тогава за 5 фаула излезе най-добрият ни в тази среща Димитър Ангелов .	Успяхме	0	1
Следващите игри за сексуалните малцинства ще се състоят през 2002 г. в Сидни .	състоят	7	3
Тези характеристики са важни при определяне на справянето , защото ни позволяват да изучаваме различни стилове и стратегии на справяне и да оценяваме кои от тях работят най-добре в различните ситуации .	оценяваме	22	1
Ако сметнете погрешно , че то просто обича да бъде само , ще го нараните за дълги години напред , затова забравете строгостта и участвайте в заниманията и игрите му .	нараните	14	2
Все пак не можех да избера международната публика на " Ридърс Дайджест " или читателите на " Самди соар " и " Франс соар " .	избера	5	1
Ако ги предадете , кой занапред ще работи за нас , попита Антонов .	предадете	2	2
Проблемът с измамата е , че ти само м.... с... си ( попълни празното място ) .	м....	8	2
Това , че се състезават за западни клубове , ги кара да се поддържат , защото всяко едно състезание им носи определен финансов еквивалент , който е достатъчен стимул за тях да не прекъсват заниманията в залата .	състезават	4	3
- Непрекъснато мисля за тези коледни подаръци , но засега не успявам да измисля нищо .	успявам	11	1
Каквото намериш , е твое .	намериш	1	2
Хората обикновено знаят , че ще страдат емоционално , когато се ангажират в тези вредни поведения .	ангажират	11	3
Но ако успея да се освободя , с удоволствие бих отишла да посрещна Дядо Коледа .	успея	2	1
Застанах на пусията , разкрачих се в позата на строител на Хаинбоаз и с вдигната над чуждия живот торба изпаднах в нетърпение .	изпаднах	19	1
През ноември 1886 г. на бял свят се появява Вивиан , а Уайлд се впуска в първата си връзка с Роби Рос , студент в Кеймбридж .	впуска	14	3
Исках да атакувам фронтално определен тип политическо общество , което е организирано или се организира отляво и отдясно върху тоталитарния морал .	Исках	0	1
След това отбележете колко често сте прибягвали до следните реакции :	отбележете	2	2
Над 200 души изпратиха детето в последния му път , а пред всяка къща , пред която мина шествието , хората излизаха да му отдадат последна почит .	отдадат	24	3
От всички маси ги следяха враждебни погледи .	следяха	4	3
След като проведохме изключително скъпа , бавна и самоцелна поземлена реформа , резултатите са налице .	проведохме	2	1
Аз съм в състояние да почувствам напълно едно стихотворение само когато го науча наизуст и мога да си го повтарям непрекъснато , да го обръщам и да го оглеждам отвсякъде .	науча	12	1
В гимназията често оставах след училище , киснех в класната стая или в библиотеката , за да направя нещо по домашното си .	направя	17	1
Джим Кери и Рене Зелуегър оповестиха , че се разделят , предаде И-Онлайн .	оповестиха	5	3
- Как ще запомниш Студентски град ?	запомниш	3	2
Икономиката на Република България се основава на свободната стопанска инициатива .	основава	5	3
Похвалете се с някои чисто ваши разработки на научната мисъл на училището ?	Похвалете	0	2
Но той пак ми се озъби , преброи отново кокалчетата на лявата си ръка и каза нещо , което на днешния ни език може да се преведе в смисъл , че още бил под нормата .	преброи	7	3
Ще внеса официално предложение за това , заяви лидерът на ОБТ Кръстьо Петков пред БНР минути преди подписването на меморандума за новия политически съюз .	внеса	1	1
Чакам те да се изкажеш .	изкажеш	4	2
Вдигна очи към тях и остана с отворена уста .	Вдигна	0	3
Слязоха майстори от Балкана , запретнаха се , дигнаха чукове , забиха длета в камъните , почнаха градежа .	забиха	11	3
Който няма това сетивно , ако щете , материално отношение към нея , той не е поет .	щете	6	2
Те я виждат , чуват , опипват и усещат .	опипват	6	3
Моят отговор е , че гражданското общество оспори този дневен ред по много различни начини и ни принуди да обясним и защитим политиката си пред правителството .	защитим	21	1
- Какво да очакваме от предстоящата учебна година ?	очакваме	3	1
Бандити отмъкнаха картечницата " Максим " на легендарния руски командир Чапаев от музея му в Чапаево , Казахстан , съобщи в. " Комсомолская правда " .	отмъкнаха	1	3
Вместо това разпредели работата си на малки порции и започни .	започни	9	2
Започнах тоя дневник , за да записвам преживяванията си .	Започнах	0	1
За повече подробности вижте секцията " интервюта / брифинги " на нашия уеб-сайт .	вижте	3	2
Международната общност трябва да гарантира сигурността на новата държава , да наблюдава зачитането на човешките права на живеещите в нея сърби и да съдейства за интегрирането й в Пакта за стабилност на Балканите , се предлага в документа .	наблюдава	11	3
Бях се отдалечил на двеста метра от колата , когато чух изстрел .	чух	10	1
Мерих , гласих , отрязах им главите , направих снимката и операцията излезе горе-долу сполучлива , ама не е там работата !	Мерих	0	1
Все пак не можех да избера международната публика на " Ридърс Дайджест " или читателите на " Самди соар " и " Франс соар " .	можех	3	1
Накарах го да ти каже това .	Накарах	0	1
Чакайте размествания в РДВР-Варна , каза още Октай .	Чакайте	0	2
Активно учене означава да правиш бележки по записките си , да ги осмисляш , да преразказваш информацията , да правиш планове .	преразказваш	15	2
Не знам кого да питам .	питам	4	1
Иначе кой бяга от хубавото	бяга	2	3
Но това , което казвате , би оправдало например един немски писател националист , който пише " Нибелунгите " в страна , където Хитлер би тържествувал .	казвате	4	2
- Споделяш ли думите на Иван Абаджиев , че националният отбор може да се разбяга ...	Споделяш	1	2
Провери за правописни грешки ( опитай се да намериш " одавена " или " по-малко " в речника ) .	намериш	8	2
Опитай да започнеш работата си по проекта отрано и да го правиш стъпка по стъпка , за да не се претовариш .	Опитай	0	2
Тази година , когато артгилдията празнуваше 50-ия рожден ден на Минчо , някои пропуснаха да аплодират впечатляващия му принос в организирането на музикалния живот у нас през последното десетилетие .	празнуваше	5	3
Том , поразен от безразличието и равнодушието на войниците , се помъкна обратно към джипа и включи транзистора си .	помъкна	11	3
Деница Петрова изчезна часове преди Нова година .	изчезна	2	3
Ще разчитам депутатите както отляво , така и отдясно да намерят формула това да се компенсира при приемането на бюджета за 2001 г. , добави той .	разчитам	1	1
Въпреки това оставаме много по-бедни от страните в съюза , сочи проучване	оставаме	2	1
И в бъдеще всяко компромисно решение ще се постига с арбитража на по-големите , а разделението вече ще бъде не между Севера и Юга , а между големите и малките .	постига	8	3
Няма да мръдна от тук , докато не ми връчите документите !	връчите	9	2
Сега съм единственият българин , който работи във фирмата на Тамер бей , поддържам технически автомобилите му .	поддържам	13	1
ЦСКА плаши " А " група с бойкот	плаши	1	3
Това е поредното нарушение на конституционното право на защита от началото на разследването за устройствата в дома на главния прокурор , отбелязват юристи .	отбелязват	21	3
Не преминавайте трамвайните релси фронтално .	преминавайте	1	2
Отдъхнах си и закрачих свободно по улицата .	Отдъхнах	0	1
Нямах време да говоря , вкарах го на 1-вия етаж и започнах реанимация със свои сили .	вкарах	5	1
- Общо взето , ако ми позволите да отговоря на въпроса ви с една дума , това е застой .	позволите	6	2
" Избягващите " са по-депресирани , тревожни и страдат от по-силен физически стрес .	страдат	8	3
- Сега доверието в ОДС се увеличава .	увеличава	6	3
БТК като телефонна компания се нуждае от достъп до безжична цифрова комуникация .	нуждае	5	3
Който студент повикаш , ще дойде .	повикаш	2	2
Междувременно обаче преговарящите решили , със съгласието на премиера , да проведат последни телефонни разговори с представители на консорциума , при които да бъде намерена подходяща форма да им се съобщи , че повече няма да се водят преговори .	проведат	11	3
Дойдох , без той да знае .	Дойдох	0	1
Приспособявай се .	Приспособявай	0	2
Мога да направя обосновано и аргументирано предложение за спиране на разформироването на войските на Министерството на транспорта .	Мога	0	1
Кой се чудиш дали е дошъл ?	чудиш	2	2
Тъй като зависимите разчитат твърде много на другите хора , преживяват значително количество стрес .	разчитат	3	3
Давам някои предложения за развитие на нагласа на издръжливост и на неподдаваща се на стреса личност .	Давам	0	1
Трябваше да чака десетина минути , докато освободят входа за моста .	освободят	7	3
Провери за правописни грешки ( опитай се да намериш " одавена " или " по-малко " в речника ) .	опитай	5	2
Общата сума с лихвите възлиза на 168 113 лв.	възлиза	4	3
Не смятам , че тя е опасна .	смятам	1	1
Сега предстои да разрушим единствената част от нея , която все още работи ефективно .	разрушим	3	1
В деня на заминаването поведох групата към автобуса за летището .	поведох	4	1
Дойдох в УНСС , за да ме научат да мисля икономически .	Дойдох	0	1
И аз горя , и ти гориш .	гориш	6	2
Ако прилагате нагласата на справяне към живота си , ще засилите потенциала си за растеж .	прилагате	1	2
Да преминеш през гимназията , да постъпиш в колеж	преминеш	1	2
Чакаме я по 10 мин да дойде , за да се изкъпем , а след това плащаме огромни сметки .	Чакаме	0	1
Развалиха договора за " Ален мак "	Развалиха	0	3
Благодарност към президента на Република България за следенето на нашата парламентарна дейност , включително за върнатите закони , с което в много случаи позволи те да бъдат подобрени .	позволи	23	3
Нефтинвестбанк ще обслужва еврофондове	обслужва	2	3
Ако искате да опознаете потайностите на нощна София , може би трябва да излезете въоръжен с черпак или вилица .	искате	1	2
И момъкът почна да се взира в тъмнината .	взира	5	3
Няма нито да се подобри , нито да се влоши .	подобри	4	3
Няма нужда да се бърза , коментира Цанев .	бърза	4	3
Но аз не смятам , че една пълна ревизия и пълно разваляне на отношенията с италианската фирма е най-добрият изход .	смятам	3	1
Дойдох да те питам нещо .	Дойдох	0	1
" Вярно е , че взимахме по някоя лютеница " , призна анонимната .	взимахме	5	1
Според астрономите тялото ЕВ 173 обикаля около Слънцето повече от четири милиарда години и материалът , от който е изградено , датира от времето , когато се е образувала Слънчевата система .	обикаля	5	3
Какво се е получило с тези пари ще следим от тази вечер .	следим	8	1
През всеки три стъпала Дяволът взимаше своя малък откуп .	взимаше	5	3
И това , което аз правя като посланик , е да уверявам бизнесмените в тези възможности .	правя	5	1
За процедура думата има господин Овчаров , но наистина да е процедура , а не да почвате да отговаряте .	почвате	16	2
Лицата от български произход придобиват българско гражданство по облекчен ред .	придобиват	4	3
Направи добро , та го хвърли в морето .	Направи	0	2
Ще говоря , който и да сте Вие .	говоря	1	1
И някъде през цялото това оцеляване забравихме да живеем .	забравихме	6	1
Кажи й нещо , което да я зарадва .	Кажи	0	2
По територия сякаш ще отговаряте за половин България .	отговаряте	4	2
На научна конференция , която се провежда в Лондон , Алън Пийс предизвикал истинска сензация с откритието , че в процеса на един разговор жените могат да извличат много повече информация от мъжете .	извличат	27	3
Излязоха и четиримата - Балашев , Димка и телеграфистът със сестра си .	Излязоха	0	3
Разделете се с сиво-черната гама .	Разделете	0	2
Джукелова репетира ежедневно за премиерата на представлението , която е планирана за началото на 2001 г.	репетира	1	3
Редовните гости на курорта ще получат карта на половин цена .	получат	5	3
Затова кметовете и финансовото министерство продължават да гледат настрани и да вървят в различни посоки .	гледат	7	3
От липсата на влага част от растенията загинаха , а на цели масиви семената не са поникнали , поясниха местни фермери .	загинаха	7	3
Конете се опитваха да потеглят , но оня отпред ги държеше и се мъчеше да ги обърне .	държеше	10	3
" Ядосвам се на другите , защото те не ме уважават . "	Ядосвам	1	1
Тръгнахме седмина да се бием .	Тръгнахме	0	1
40-годишният Красимир Т. от с. Старцово изпуснал волана , защото карал с несъобразена за трасето скорост , смятат криминалистите .	смятат	17	3
Няма нужда да казвам , че не затворих очи цяла нощ .	затворих	7	1
Планирате ли вече първите си срещи с ръководството на Министерството на отбраната и Българската армия или все още е рано за тях ?	Планирате	0	2
Всички тук декларирахме , поне на думи , че търсим общото в нашите позиции в интерес на България .	декларирахме	2	1
Около 50 % по-малко приходи ще съберем от мита догодина , стана ясно също вчера .	съберем	6	1
Ще бием турците на терена , не е необходимо да ги налагаме и извън стадиона	налагаме	11	1
Желаещи за трета реплика не виждам .	виждам	5	1
- Аз нямам злато , аз нямам нищо , с което да те подкупя ...	подкупя	13	1
Иван го чакаше да се върне .	чакаше	2	3
Аз забравих да затворя и да пусна завесата на вратата на нашето купе .	затворя	3	1
И няма защо да се лъжем , ако те сега не го обявиха , това показва , че те са малко по-гъвкави по отношение на собствените си интереси .	лъжем	5	1
Чете се криминална книга .	Чете	0	3
Откак се ожени , не излизаш често по свят .	ожени	2	2
Намерих го да седи на стълбите .	Намерих	0	1
- Платих .	Платих	1	1
Най-категорично настояваме военният министър г-н Паприков да ни отговори на следните запитвания :	настояваме	1	1
- Правете с Павел Попандов	Правете	1	2
Помня , че в тая минута бях твърде смутен .	Помня	0	1
Не бива ти да оставаш .	оставаш	4	2
Чичо Ериксон се е надвесил над своята черна книга , бързешком вдига поглед , дръпва от лулата и изпуска облаче пушек :	дръпва	14	3
Хем го храниш , хем те лае .	храниш	2	2
Плясват ръце и залавят хоро вито , извиха се , изтъпкаха златно жито .	извиха	7	3
И все пак не можеш да се върнеш , откъдето си тръгнал ...	върнеш	7	2
Давай си почивки и превключвай на различни предмети , ако ти се доспи .	превключвай	4	2
Определи приоритетите си .	Определи	0	2
Сетих се кого ще попиташ .	Сетих	0	1
Правете разлика .	Правете	0	2
Английски вестник хвали зимните ни курорти	хвали	2	3
Минка нищо не отговаря , оставя котето до кълбото и почва да изтърсва полата си .	почва	10	3
Букет цветя лежеше на масата .	лежеше	2	3
А още за следващата година специалистите прогнозират възстановяване на корабоплаването и превозите на товари .	прогнозират	6	3
Ела да излезем да изучим позицията .	излезем	2	1
Искам да направя изявление .	направя	2	1
Това ще стане след турнира в Полша , за който борците заминават утре ( б.р - днес ) .	заминават	11	3
Я ставай , че ще се простудиш на голата земя .	ставай	1	2
Пребиваха ме ежедневно , за да подпиша протокол за изземването на яхтата	подпиша	6	1
Кирил се надигна да стане , но тя препречи ръка пред гърдите му .	надигна	2	3
Даваме на Югославия помощи за $ 50 000 помощ	Даваме	0	1
96 спортисти заминават за Австралия .	заминават	2	3
И докато политиците пресмятат най-печелившите модели и стратегии , гражданите си задават прост въпрос .	пресмятат	3	3
Но след като разбереш , че това не е отговорът на собствените ти проблеми , ти отново се интегрираш в него с доста по-прагматични и диференцирани очаквания .	разбереш	3	2
Закривам Тридесет и осмото Народно събрание .	Закривам	0	1
Еврото страда и от тази несигурност .	страда	1	3
Влиза романистът А. , поздравява студено и сяда на друга маса .	сяда	7	3
Ставам и отивам при отворения прозорец .	отивам	2	1
Тъй като трябва да си напишеш домашното , така или иначе трябва да приключиш с него .	напишеш	5	2
Господин Пирински , винаги си просрочвате времето и колкото пъти Ви се прави бележка , продължавате да си говорите .	продължавате	15	2
Спомняте ли си каква фантастична зърнена криза преживяхме преди години ?	Спомняте	0	2
Ако България сега се отклони от пътя , по който върви , това ще прилича на ситуация , в която пациент , подложен на операция , слиза от масата заради голямата болка , посочи Стоянов .	слиза	26	3
Не само възстановихме отношенията на собственост върху земята отпреди половин век , но върнахме технологиите в земеделието от още по-далечни исторически времена .	върнахме	13	1
Тя може да се сдобие с концесия за добив , ако открие газ при проучванията си .	сдобие	4	3
Да вървим , докато не са светнали лампите .	вървим	1	1
Запали , снахо , пещта , да опечем агнето , дето ще го донесат .	Запали	0	2
Има още едно обстоятелство , което стеснява възможността за повишаване на конкурентността на износа ни .	стеснява	6	3
Дебатът бе доста разгорещен , как преценявате това ?	преценявате	6	2
Момъкът мина още три стъпала и се вгледа надолу .	вгледа	7	3
Въпреки тези проблеми в никакъв случай няма да отписваме мача .	отписваме	8	1
От месец чешмите спират всяка нощ .	спират	3	3
Не бива да спираме да гледаме нагоре .	спираме	3	1
Трябва да призная обаче заслугите на Платини , Пеле , Кройф , Ривалдо	призная	2	1
" Избягвам да си предавам работата . "	предавам	4	1
Тогава кандидатстваха 12 световноизвестни фирми , но най-големите от тях бяха отстранени от търга по формални критерии , за да бъде избрана " Главболгарстрой " .	кандидатстваха	1	3
Федерации и конфедерации отхвърлиха доста работа , по-голямата част от която обаче трудно може да бъде дефинирана като традиционен синдикализъм .	отхвърлиха	3	3
Хайде да поровя в торбата със стратегии за справяне и да си направя план А и план В , а може би дори и план С .	поровя	2	1
Никоя част от народа , политическа партия или друга организация , държавна институция или отделна личност не може да си присвоява осъществяването на народния суверенитет .	присвоява	20	3
Там пък един крадец на диаманти ще закъса заради нелепи залози .	закъса	7	3
Да събираш парите си възможно най-бързо и да плащаш задълженията си възможно най-бавно .	събираш	1	2
Той обаче няма възможност да следи за правилното им използване и с това се занимаваше МВР .	занимаваше	14	3
Заедно с опростените дългове и допълнителните трансфери този ръст е 70 процента , но не се чистят стари плащания .	чистят	16	3
Сирийският президент Башар Асад се ожени за своята сънародничка Асма Ахрас , съобщи правителственият всекидневник " Тишрин " вчера .	ожени	5	3
По-късно обаче се уверих , че това всъщност вече е официалната позиция на страната .	уверих	3	1
Ще прочета двете становища за двата проекта за решение по реда , по който са постъпили в Комисията по външна и интеграционна политика .	прочета	1	1
Ще бръкне да извади някое шише - иди го гони сетне .	бръкне	1	3
Ние наистина в момента трябва да вземем едно сериозно политическо решение .	вземем	6	1
Тъкмо се изправих и мислех за раната си , когато нещо ме бодна в окото .	изправих	2	1
Следващия път се опитай да ги завършиш предварително или да бъдеш реалистка , когато отлагаш .	завършиш	6	2
Когато си тръгваше , Стоянов каза " Сега трябва да намеря семейството си , изгубихме се някъде сред хората " .	намеря	10	1
В писмо до премиера и НС те настояват да участват в проекта за промяна на Закона за специалните разузнавателни средства .	настояват	7	3
Сега си поставяме за цел да форсираме българската икономика .	форсираме	6	1
Защитата на Пламен Арсов едва вчера бе допусната до делото за " бръмбарите " у Филчев , по което бившият служител на СОТИ изкара 3 денонощия арест и бе обвинен за неразрешено държане на спецтехническо средство .	изкара	23	3
Наум се залови да разказва .	разказва	4	3
Той захвана да задлъжнява , да залага и да продава част от оскъдното си имущество .	продава	9	3
Като останах сам , му дочетох книгата .	дочетох	5	1
Екатерина Дафовска и Павлина Филипова паднаха в генералното класиране за Световната купа по биатлон след масовия старт на 12,5 км в Оберхоф ( Гер ) вчера .	паднаха	5	3
Бием Алжир с 2 : 1	Бием	0	1
Ето това е големият авторитет , който за съжаление в България не умеем да ценим .	умеем	12	1
И го гледаше с омраза и тържество , па се обърна и се затича към вратата на воденицата .	обърна	10	3
Представи си , че това е въпрос за есе на едночасов изпит .	Представи	0	2
На трапезата ни поднесоха круши с восъчен цвят .	поднесоха	3	3
- Колко пъти да ти казвам да не слагаш дафинов лист в манджата .	слагаш	8	2
Другата цел , която си поставяме със сержантския състав , е да поддържаме високия имидж на Българската армия зад граница , който е дело на предните взводове , продължи генералът .	поддържаме	12	1
Сюжетът се пази в тайна , но от " Върайъти " загатнаха , че ще бъде доста по-различен от досегашните холивудски версии .	пази	2	3
Те се вълнуваха , кипваха мигом , вдигаха гора от сухи , черни ръце , гръм от негодувание и яростни викове разлюляваха въздуха и ехото замираше бавно , тържествено , като далечни топовни гърмежи .	кипваха	4	3
- Ние много съжаляваме , ако не продължим да работим с г-н Карадимов , защото работихме с него много добре .	работихме	15	1
Като усетих , че се люлеем , за секунди се облякох и зарязах болната , изхвърчах като куршум навън .	усетих	1	1
Надяваме се обаче , че няма да се стигне дотам .	Надяваме	0	1
Имаме много хубави стоки .	Имаме	0	1
Той си спомни за писмото , което преди два месеца беше писал на Райна .	спомни	2	3
Обичаше ярката светлина и не се боеше от нея .	боеше	6	3
Специалистите , с които се консултира , преди да се захване с този бизнес , излязоха прави .	консултира	5	3
Трябваше да извия нагоре цялата си глава , за да го видя	извия	2	1
Служителите на реда охраняват храма от миналия петък , когато в него пристигна ревизор от синода на Инокентий .	охраняват	3	3
Срамуваха ли се заради брат си ?	Срамуваха	0	3
Залудо работи , залудо не стой .	стой	5	2
Маратонът на " Мис България 98 " стартира от хотел " Шератон " , където тя уважи коктейла на US пастата за зъби " P.M. " .	уважи	16	3
А вие как приготвяте хляба за любовта си ?	приготвяте	3	2
Предполагам , че върша много грехове .	Предполагам	0	1
В случай че забравя , ще ме подсетиш .	подсетиш	7	2
На това място тя се умълча .	умълча	5	3
Глобиха със 790 лв. лекарката на починалия Мартин	Глобиха	0	3
Така в гъмжилото , точещо се по централния булевард " Ататюрк " , току пред изхода на хотел " Кент " , чувам две жени да си бъбрят .	чувам	22	1
Създава се уникална среда .	Създава	0	3
Би могла също да направиш преговор на автобусната спирка , в учебната зала или като влезеш в клас преди учителя .	влезеш	15	2
Право да ви кажа , господа , светнаха ми очите , като го видях .	светнаха	7	3
Няма да знам със сигурност дали съм в беда преди утре сутринта , но ще е най-добре да се подготвя с цифрите и графиките .	знам	2	1
Да ви призная ли , на ваше място малко бих се срамувал да поставя този въпрос .	призная	2	1
Ела да излезем да изучим позицията .	Ела	0	2
Но ако вие мислите , че ще излъжете Европейския съюз с такива стратегии , вие трябва да сте големи наивници .	излъжете	7	2
Как стои въпросът с подготовката на граждански специалисти във вуза ?	стои	1	3
Още не мога да си пречупя езика да проговоря на турски , ама вече всичко разбирам	пречупя	5	1
Момъкът се затече , наведнъж прекрачи три стъпала , но косматата ръка на Дявола го дръпна :	затече	2	3
Всички кандидат-депутати да разкрият имуществото си , предлагат евролевите .	разкрият	3	3
- Вие имате впечатление от един обширен район , в който граничат християнството и ислямът .	имате	2	2
Не завиждам на колегите , след като ни закрият .	завиждам	1	1
Сбирката бе насрочена за днес , но поради отсъствието на президента на БФБ Васил Иванов-Лучано от страната тя няма да се осъществи .	осъществи	21	3
Според автора лъжата и неискреността крепят света на възрастните .	крепят	5	3
Както видяхте и в този случай има бивши служители на МВР , разбирайте Държавна сигурност , които си пазят бяла информация за черни дни и не се знае кога ще решат да я използват по този начин	видяхте	1	2
Банкери се дърпат от програма САПАРД	дърпат	2	3
И аз ви благодаря .	благодаря	3	1
Предполагам , че върша много грехове .	върша	3	1
Да не спираме да го правим .	спираме	2	1
Това предвиждат последните промени в Закона за енергетиката , които ще се дискутират в сряда .	дискутират	12	3
- Нямам таван на амбициите си , но сега първо трябва да се справя с новото предаване .	справя	13	1
Не се смятам за специалист по отношенията между исляма и християнството .	смятам	2	1
Като университетски преподавател аз мога да твърдя отговорно , че българката е много високо образована , интелигентна и можеща .	твърдя	6	1
Ръководих акцията по задържането там .	Ръководих	0	1
Две години чука камъни , дълбае букви и релефи на варненските гробища , преди да го приемат в Художествената академия в класа на проф. Димитър Бойков .	дълбае	5	3
Предпочитам да отида да специализирам нещо и да се върна .	специализирам	4	1
Ако желаете , слушайте ме , ако желаете , вземете ги предвид .	желаете	1	2
Съпругата на Антонио Бандерас , която злоупотребявала и с таблетки за отслабване , щяла да опита терапията " Талула Банкхед " , твърди в. " Сън " .	опита	15	3
ЕС обаче иска Москва да ратифицира Еврохартата за инвестиции в енергоотрасъла , припомня Ройтерс .	ратифицира	5	3
Гостите се увериха , че зъбите на госпожицата наистина са бели , след което тя не пропусна да види и " Мъж на годината 2000 " .	пропусна	16	3
- Той казва , че сте били много уморен , за да обясните . . .	обясните	12	2
Какво очаквате от новата година ?	очаквате	1	2
Ако се оправдаят прогнозите за суха зима , миньорският град ще премине на драстичен воден режим , предупредиха специалистите .	оправдаят	2	3
Не се поддавай на безпокойство по отношение на математиката , което може да те подтикне към грешна стъпка .	поддавай	2	2
С 8 взрива плевенчани изпратиха последната година от стария век .	изпратиха	4	3
Кои са добрите , колко струват , къде да ги намерите .	намерите	10	2
Целта ми при писането на тази книга беше да запозная с резултатите от тези изследвания хората , които не са обучени в научния жаргон , съдържащ се в професионалните списания .	запозная	9	1
" Аз не знаех нищо за решението на президента , докато не прочетох за него в пресата " , каза първата дама пред репортери .	прочетох	12	1
С радост се превърнете в най-добрата , най-справедливата , най-обичащата и най-търпеливата , за да му помогнете да преодолее вродения си страх от изоставяне .	помогнете	16	2
Самият ремонт на кабинета бе свързван с очаквания за очистване от корумпираните , после потекоха компроматите , а доверието в новия кабинет постоянно се топеше от незадоволения глад на обществото за сериозни противодействия на корупцията .	потекоха	14	3
Те нямат чувство за вътрешен контрол ( вж. трета глава ) и често вършат неща , които не са в техен интерес , например мамене , изневеряване , невнимателно шофиране и пренебрегване на здравето си .	вършат	13	3
Не мислите ли , че те поставят културата в опасност само защото не са разбрали в какво се състои същността на творбата на изкуството ?	мислите	1	2
Дали да си лягам вече ?	лягам	3	1
- Как се регистрират вероизповеданията в САЩ ?	регистрират	3	3
Имам две дъщери , които просто трябва да се гордеят с мен .	Имам	0	1
Стоянов и Павлов отдавна обмислят идеята да направят криминале заедно .	обмислят	4	3
Плувците Ивге де Брюин и Петер ван ден Хоогенбанд , които спечелиха по 3 олимпийски титли , бяха без конкуренция .	спечелиха	11	3
Всуе полиция и общинари си губят всяка година времето с показни акции по конфискация на пиратки .	губят	5	3
Ако искате да опознаете потайностите на нощна София , може би трябва да излезете въоръжен с черпак или вилица .	опознаете	3	2
Всички зяпнахме и Жотев веднага им заяви , че никой не е твърдял , че ще подпишем договор	подпишем	16	1
А когато тя си тръгна от вечеринката с някакво непознато момче , тогава пък аз разбрах , че в този лов на неопитни сърца играех заека .	играех	24	1
Така по-лесно европейските социалдемократи ще трябва да захапят въдичката , че нашенската левица има нови характеристики .	захапят	7	3
И още един въпрос имам към Вас .	имам	4	1
Учех за тестове предишната нощ , след това преглеждах материала отново , преди да вляза в клас .	Учех	0	1
Аз малко разбирам от тези работи , та затова мога да сгреша .	сгреша	11	1
- Жена ми не ми дава да пускам тото .	пускам	7	1
Христина каза да я убие , ако го лъже .	лъже	8	3
Пожелавам си по-малко бели коси .	Пожелавам	0	1
Възприемам избора на София и като още един важен сигнал , който дава Европейската народна партия - сигнал , основан на цялостния фундамент на нейната политика по отношение на разширяването на Европейския съюз , каза Президентът .	Възприемам	0	1
Присъединяваме се към вашата скръб в този тъжен за вас момент , се казва още в телеграмата .	Присъединяваме	0	1
Разговарях с ръководителя на дирекцията Любомир Младенов .	Разговарях	0	1
На този етап се питаме дали си струва да се разстройваме .	разстройваме	10	1
Елиминирай ненужни или повтарящи се думи .	Елиминирай	0	2
В случай че забравя , ще ме подсетиш .	забравя	3	1
Подадох оставка .	Подадох	0	1
Говорим , че искаме да имаме мобилна , добре въоръжена , добре екипирана армия , но човекът продължава и ще продължава да играе основна роля в тази армия .	продължава	17	3
Циана помръкна , а инженерът край тях тайно стисна палци .	помръкна	1	3
Подлостта и измамата биха означавали да влезеш в съглашателство .	влезеш	6	2
- Налагало ли ти се е да подкупваш преподавател , за да си вземеш изпит ?	вземеш	13	2
Заклех се .	Заклех	0	1
- Мини !	Мини	1	2
Направи добро , па го хвърли в морето .	Направи	0	2
Ако не бях ви дръпнал , щяха да ви прегазят конете .	щяха	6	3
Вадим нови лични карти още година	Вадим	0	1
Но от хода на преговорите , които водят страните преди нас , ние вече виждаме къде се насочват изискванията на Европейската комисия и безусловно такива изисквания ще бъдат предявени и към България .	насочват	17	3
Предвид на това смятам , че лансирането на повърхностни мнения и поставянето на етикети по адрес на Румъния нямат смисъл , тъй като са неподходящи и непродуктивни , каза в заключение Петре Роман .	смятам	3	1
Който се е справил със следпразничния махмурлук и се е уморил от евтините холивудски бози по телевизиите - да заповяда !	заповяда	19	3
Но днес малцина помнят как тогава всички обещаваха , че след десет години първите страни ще бъдат приети за членки в съюза .	обещаваха	7	3
Те се спотаиха някак виновно .	спотаиха	2	3
- Ако успеем да намерим вярната , нашата си пътека , смятам , че нещата ще тръгнат учудващо бързо .	намерим	4	1
Изглежда , че ти си весела .	Изглежда	0	3
А притвори ли очи , хич се не май , а грабвай си шапката и бягай в друга махала чак .	грабвай	11	2
Можеш да имаш талант , но като те мързи , всичко отива по дяволите .	мързи	8	3
Донесоха писмо ...	Донесоха	0	3
Влиза романистът А. , поздравява студено и сяда на друга маса .	поздравява	4	3
Не мога да си спомня да е пяла .	спомня	4	1
Той прикани всички граждани на Македония към диалог .	прикани	1	3
Много съжалявам , защото дойдохме за победа	дойдохме	4	1
По възможния най-прост начин ще се гласуват декларациите .	гласуват	6	3
Не храним илюзии относно времето и усилията , които ще изисква този процес .	храним	1	1
Ако излъжеш един път , не ти вярват довека .	излъжеш	1	2
Ако си потърсеше правата в по-горните медицински инстанции , не се знаеше дали не ще налети на същите закостенели в грижите си за обществото фанатици .	налети	15	3
Искам ти да заминеш .	заминеш	3	2
- Защото той ги знае къде са .	знае	4	3
Той уверил , че инцидентът не заплашва националната сигурност .	заплашва	6	3
Беше прекалено да се преструва , че и цигари не е виждала , но пък умело се преструваше .	преструва	4	3
Книгата му ли четеш ?	четеш	3	2
По отношение на това , което се спомена по въпросите за водене на преговорите и даване на мандат , аз бих искал да се спра на два факта .	спра	24	1
- Имат ли студентите достатъчно средства , за да изкарат добре празника ?	изкарат	9	3
Броих му парите и го изпратих .	изпратих	5	1
Мислите ли вече за коледните подаръци ?	Мислите	0	2
Със средствата на бюджета обучаваме специалисти , които отиват да работят за друго общество .	обучаваме	4	1
Тъй като трябва да си напишеш домашното , така или иначе трябва да приключиш с него .	приключиш	13	2
Ако не можеш да работиш с компютър , ограничаваш маркетинговите си умения .	работиш	4	2
Мерих , гласих , отрязах им главите , направих снимката и операцията излезе горе-долу сполучлива , ама не е там работата !	направих	8	1
Когато пристигнахме , платих сметката и закрачих след водача по една планинска пътека .	платих	3	1
И Вие , господин президент , се примирихте , подкрепихте с участието си в партийни форуми утвърждаването на диктата на тази олигархия .	примирихте	7	2
Ние изразяваме различни виждания за позицията на България .	изразяваме	1	1
Ако не работиш ефективно късно през нощта , легни си и стани рано .	легни	8	2
Затова толкова исках дъщеря , да те продължи .	исках	2	1
Цели се високо - стреляй за 100 и може да получиш 90 .	стреляй	4	2
През отиващата си 2000 г. хората бяха принудени да изтърпят и поскъпване на тока , транспорта , таксите за образование , лекарствата , телефонните услуги , учебниците .	изтърпят	9	3
Около стотина фенове на " железничарите " дойдоха да се сбогуват с любимеца си и го чакаха на студа близо час , тъй като Пеев се забави заради среща с изпълнителния директор на БФС Иван Вуцов .	сбогуват	10	3
Как обяснявате тази моя оценка ?	обяснявате	1	2
Точно в 12 ч за всеобща изненада химна изпя Дони .	изпя	8	3
Решили сме да не се разпръсваме като друг път , затова вече всички срещи ще се правят тук	разпръсваме	5	1
Проблемът с измамата е , че ти само м.... с... си ( попълни празното място ) .	попълни	12	2
Преди да дам почивка каня всички гости и народни представители на чаша шампанско в клуба на народния представител .	каня	4	1
Заговори бързо , защото младите приближаваха .	Заговори	0	3
Ще се погрижа да го намеря .	погрижа	2	1
Той ще ви даде указания , как да постъпите .	постъпите	8	2
Имахме потенциала , имахме хората , отнеха ни възможността да се докажем .	Имахме	0	1
Новият дизайн излъчва повече спортна тръпка , но не напуска класическата елегантност .	напуска	9	3
Полицаи от РПУ-Троян 3 дни издирват без резултат телата на двама братя рибари в язовир " Сопот " край с. Голяма Желязна , съобщиха от полицията .	издирват	5	3
Така те губят форма .	губят	2	3
Просто трябва да се стегнем и да работим за страната си , а не да гледаме как да избягаме от нея .	стегнем	4	1
Спомняте ли си каква фантастична зърнена криза преживяхме преди години ?	Спомняте	0	2
Сред тях са кукли , напитки , елегантни дрехи и дори вурстчета , които щели да се приготвят по специална рецепта .	приготвят	17	3
Витае трета нощ над водната пустиня .	Витае	0	3
Всеки отделен случай се разглежда и ако е допусната грешка , тя се отстранява за наша сметка , увери подп. Николов .	отстранява	13	3
Когато стигнем до тях , виждаме , че са били съвсем близо .	стигнем	1	1
Кашлица и сиромашия не могат да се крият .	крият	7	3
Със събраните 18 000 лв. няма да можем да осигурим престоя му в бъдеще , поясни тя .	осигурим	9	1
Ние сме тия , които търсите .	търсите	5	2
Досега нощем мръзнехме в ледената пещера , ала през деня слънцето ни съживяваше .	съживяваше	12	3
Следващия път се опитай да ги завършиш предварително или да бъдеш реалистка , когато отлагаш .	опитай	3	2
Може да ти помогне следното : занимавай се с книгите около час , след това се поразходи 15 минути , а след това отново учи , като определиш друг отрязък от време .	поразходи	16	2
Има опасност да подменят реалните ни цели	Има	0	3
Ние ще преустановим контактите със социалистите на общинско ниво , ако те създадат областен координиращ съвет с участието на Камовите хора , закани се местният лидер на БЕЛ Георги Костов .	преустановим	2	1
Но очарованието се засилва още повече , когато посещаваме три гробници от Долината на царете .	посещаваме	8	1
Би било възможно да стане такава грешка при предишния вид стикери , които се лепяха на ръка , допусна той .	допусна	18	3
- Оттегляте ли се от " Берое " ?	Оттегляте	1	2
Не желаем да коментираме самата продажба на телекома и лиценза за втория GSM-оператор , тъй като не сме страна по тази сделка и нямаме отношение към нея , каза говорителят на " Мобилтел " Константин Каменаров .	коментираме	3	1
- През тази седмица ще имаме заседание на Управителния съвет и там ще изберем новия наставник .	имаме	5	1
Той разбра всичко , когато погледите им се срещнаха .	срещнаха	8	3
Постът му пое депутатът Людмил Бешков .	пое	2	3
Нещата не стават по-лесни , но и ние не бавим темпото .	бавим	9	1
Другата цел , която си поставяме със сержантския състав , е да поддържаме високия имидж на Българската армия зад граница , който е дело на предните взводове , продължи генералът .	поставяме	5	1
По-високи равнища на емоционален дистрес се преживяват от лицата , които се чувстват безпомощни , обвиняват себе си и се ангажират в отричане и избягване .	чувстват	12	3
Подаряваш дъвки на децата .	Подаряваш	0	2
Само още едно стъпало и ти ще отмъстиш .	отмъстиш	7	2
Другите глави могат да ви помогнат да разберете познатите си , които са изправени пред конкретни проблеми .	разберете	7	2
Навън валеше дъжд и духаше вятър , а тя седеше до прозореца и се опитваше да чете .	валеше	1	3
Които ние очакваме те да демонстрират в близките дни .	очакваме	2	1
Той се опита да я прегърне , да спре змийските сгъвания на тялото й , но тя му се изплъзна и продължи да се облича .	облича	24	3
Благодаря Ви , господин председател , за двете секунди екстра , които ми позволихте .	позволихте	13	2
Почукайте и ще ви се отвори .	Почукайте	0	2
И не забравяйте , че тази събота под прицел е Евгений Дайнов .	забравяйте	2	2
За да се справяте успешно в предизвикателствата на живота , е необходимо да осъзнавате личностния си стил .	осъзнавате	13	2
Спри да чуеш как стенат там доле твоите братя !	Спри	0	2
Господарката много обичаше Минка да й мие краката с топла вода , а господарят редовно я караше да го чеше по гърба .	мие	6	3
Пожелавам си да се обичаме все повече и по-силно .	Пожелавам	0	1
Димитър Луджев се закани до дни да заведе дело срещу Соколов за публично обвинение и лъжа .	закани	3	3
Разговаряхме с вицепремиера Петър Жотев и със заместника му Левон Хампарцумян .	Разговаряхме	0	1
- Когато чух изказването на шефа на парламентарната комисия по външна политика Асен Агов , очаквах това да е само негова лична позиция .	очаквах	15	1
И шареният скафандър изглеждаше така близо , че човек се изкушаваше да се наведе от терасата и да го хване за крака .	изкушаваше	10	3
Не бих могъл да продължавам да пиша .	продължавам	4	1
Старецът , изненадан от внезапната злост на двете си снахи , седна на прага .	седна	11	3
Пръкна се още един защитник на евреите - Иван Дочев ! ...	Пръкна	0	3
Но докато си в училище , е трудно да съдиш кое е необходимо .	съдиш	9	2
Взех го за един приятел .	Взех	0	1
Едва ли доктор се залавя за операция с такова внимание , с каквото Димо се хвана за ботушите на поручика .	залавя	4	3
Ако не работиш ефективно късно през нощта , легни си и стани рано .	работиш	2	2
Ще защитя достойнството си	защитя	1	1
Ако българското правителство реши да компенсира загубите ни , ще направим бензина по една стотинка .	направим	10	1
Наложи се целият научен съвет на Института по древна история да решава как да възстанови нормалното положение на нещата .	Наложи	0	3
Ще можем да увеличим годишния бюджет и да преследваме по-големи цели	увеличим	3	1
Петър , Боян и аз ще останем на работа в библиотеката .	останем	6	1
Вие знаете , че има богати държави и една богата държава , в която не се гласува за членство в Европейския съюз на референдум .	знаете	1	2
По време на подготовката очакваме най-много още двама играчи .	очакваме	4	1
Знаех го само като изпълнителен и работлив другар .	Знаех	0	1
В т.нар. българско социално министерство явно цари пълно безхаберие и там вече е крайно време за оставки ( вж. стр. 1 ) .	вж.	18	2
Прочетох му статията му .	Прочетох	0	1
Посягам , но преди да те хвана , ти отлиташ .	Посягам	0	1
Иска й се да дойдеш .	дойдеш	4	2
Не мога да оспоря решението на правителството за БТК .	оспоря	3	1
Мислеше си за компютъра и за неговото участие в тези страховити експерименти .	Мислеше	0	3
И ще продължа да го правя .	правя	5	1
Муравей Радев не пропуска да отбележи , че е дал достатъчно пари на кметовете , за да запълнят напълно дупката в общинските бюджети и дори да решат повечето от текущите си проблеми следващата година .	отбележи	5	3
Ще се боря за титулярно място	боря	2	1
- О , аз ще отмъстя на тия принцове и князе .	отмъстя	5	1
Една силна ръка го хвана за шията като железни клещи и го накара да седне на мястото си .	накара	12	3
На второ място , държавността присъства в двустранната връзка между нация и армия чрез осъществяваната политика .	присъства	5	3
В четвъртък ходихме до ужасната регата .	ходихме	2	1
Сетих се кого да попиташ .	Сетих	0	1
Така българската 100 % частна фирма ще може самостоятелно или в консорциум с турски или други фирми да изгради участъци от гигантската мрежа от газопроводи , която ще се строи в Турция .	строи	29	3
Уведомих обаче за оставката си говорителя на Пакта за стабилност , който ми се обади лично , за да разбере какви са мотивите ми да се оттегля .	Уведомих	0	1
Знаете ли , във войските ни пристигат и момчета , които за първи път спят на бял чаршаф в казармата .	Знаете	0	2
Според мен решението за развитието на икономиката ни е едно - да заложим на собствените си сили .	заложим	12	1
Пазиш ли вестника от оня ден ?	Пазиш	0	2
И ще продължа да го правя .	продължа	2	1
Спомняте ли си каква фантастична зърнена криза преживяхме преди години ?	преживяхме	7	1
Ако трябваше отново да напиша " Обсадно положение " , действието пак щеше да се развива в Испания , ето моето заключение .	развива	15	3
Отсега можем да се обзаложим да речем , че едномесечната дървена ваканция ще важи само тази година .	речем	6	1
Много пъти той вдигаше ръка да бие .	бие	6	3
Скочи , едва не катурна чашата и се метна в прегръдките му .	катурна	4	3
Все пак завършихме като есенни лидери и това е най-радващото .	завършихме	2	1
Да си лягам вече ?	лягам	2	1
Смятам , че ние сме морално задължени да изразим и своята готовност за хуманитарна помощ от страна на България след спирането на ударите .	изразим	8	1
Докато берете памука , няма да ги освобождаваш .	берете	1	2
Плащането се изтегля във връзка с Коледните празници , обясниха от НОИ .	изтегля	2	3
Ако не можеш да работиш с компютър , ограничаваш маркетинговите си умения .	ограничаваш	8	2
Наизлязоха слуги , светнаха фенери и дълги шипове светлина прорязаха тъмнината .	светнаха	3	3
Той се изкачваше по високото било на планината , където вятърът къдреше тревата на поляните , а наоколо беше синьо небе и бели облаци .	изкачваше	2	3
Заявихте , че вече приключвате с революциите .	приключвате	4	2
Така смятам аз , предполагам че и много други хора смятат така .	предполагам	4	1
Вместо да се успокои , страхът и безпокойството му още повече пораснаха .	успокои	3	3
Ще си очарована да чуеш , че раждането мина успешно и Констанс изстрада смело всяка болка .	чуеш	4	2
Специалисти контролират непрекъснато целия процес по издаването на новите документи .	контролират	1	3
Всъщност тя има голям шанс да стане реалност , както доказаха последните събития .	доказаха	10	3
Казах му , че Иван ще замине .	Казах	0	1
- Споделяш ли думите на Иван Абаджиев , че националният отбор може да се разбяга ...	разбяга	14	3
По стълбите тежко изтрополяват стъпки и в холчето влиза брадат мъж - зет й Андон Гавазов , съпруг на сестра й , който се връща от работа .	изтрополяват	3	3
Трябва повече да си вярваме .	вярваме	4	1
Пасивно учене означава да преглеждаш записките си и да прелистваш книгите .	прелистваш	9	2
Ние сме неколцина , които не желаем да мълчим за нищо .	желаем	6	1
Ще открием , че Бергман преди 30 години е писал за нас .	открием	1	1
Имам мотивирани възражения .	Имам	0	1
Ще дойдеш ти , очакван ден !	дойдеш	1	2
И това ще те принуди рано или късно да върнеш заетото .	принуди	4	3
Студентите , които впрочем си бяха взели изпита , заминаха .	заминаха	9	3
Известието , че заминава , го разтревожи .	разтревожи	6	3
С това намаление страната ни изчерпва ангажиментите си и за 2002 г.	изчерпва	5	3
Пасивно учене означава да преглеждаш записките си и да прелистваш книгите .	преглеждаш	4	2
Легалният бизнес е невъзможен , казват Валя и Красимир Цонкови от София .	казват	5	3
Излезе най-новият брой на " Наш дом " - списанието за хората с вкус	Излезе	0	3
" Когато нещата се объркат , се депресирам и се предавам . "	предавам	10	1
Че трябва да харчим пари за здравето и обучението на нашите деца .	харчим	3	1
Завчера в столицата Букурещ той пя пред повече от 5000 души .	пя	5	3
Инго се надява хрумването му да допадне на студентите от околностите на Ливърпул .	допадне	6	3
Вие забравихте , че първите оръжия на тоталитарната война бяха потопени в испанска кръв .	забравихте	1	2
Една от основните ми цели е да ви помогна да осъзнаете личния си стил , така че адекватно да възприемате и реагирате на предизвикателните житейски събития .	осъзнаете	10	2
Вие твърдо вярвате в женствеността и интелекта на българката ?	вярвате	2	2
Прецени колко дълъг ще бъде .	Прецени	0	2
Как мога да се науча да се справям по-ефективно с предизвикателствата , пред които се изправям ?	науча	4	1
Да не си продумал никому , че езика ти отрязвам .	отрязвам	9	1
Излъчват се лоши биотокове .	Излъчват	0	3
И няма да се уморим да ги отстояваме !	отстояваме	7	1
Нима ще бликне пак в гърди предишна мощ ?	бликне	2	3
Той трудно се събува когато е мокър .	събува	3	3
Него той слушаше , нему се подчиняваше като роб .	подчиняваше	6	3
Това кара ли те да се чувстваш по-голяма ?	кара	1	2
Този път Циана не посмя да излъже .	посмя	4	3
Но да се учим да живеем заедно е възможност , все още трудно достижима .	живеем	5	1
Можехме да бъдем хегемони .	Можехме	0	1
Върнаха отвлечения Кристиян на майка му	Върнаха	0	3
Величаенето не е излишно в нито едно общество , но е редно повече да го свързваме с поетите от личността отговорности , а не да възкачваме на престол личността , която е някакъв шеф .	свързваме	15	1
" Опитвам се да бъда любезен с всеки . "	Опитвам	1	1
Правителството ще се вслуша в гласа на българския бизнес и ще защити неговите интереси , и аз се надявам до края на годината проблемът да бъде решен .	вслуша	3	3
Според него хората са се научили да разпознават политиците .	разпознават	7	3
Победа на СДС е нужна на европейските християндемократи , за да повярват , че могат да спечелят избори и в своите страни .	повярват	11	3
" Лийдс " отрязва " Барса "	отрязва	3	3
На този етап се питаме дали си струва да се разстройваме .	питаме	4	1
Ти го не познаваш .	познаваш	3	2
засмя се той .	засмя	0	3
Виждам , че идва често .	Виждам	0	1
Чакаме я по 10 мин да дойде , за да се изкъпем , а след това плащаме огромни сметки .	изкъпем	11	1
Съжалявам за това , че заминаваш .	заминаваш	5	2
За да не товаря домашния й телефон , й предложих да позвъни на съпругата ми , която си беше вкъщи .	предложих	9	1
- Вие разполагате и с един много добър учебен команден пункт .	разполагате	2	2
И аз не ще извиня тази отвратителна чума в Западна Европа , защото тя извършва своите опустошения на Изток върху много по-големи пространства .	извиня	4	1
Ако дойдеш , тръгваме веднага .	тръгваме	3	1
Хиляди жители по двата бряга на Марица изпаднаха в ужас , а стотици се наредиха по мостовете , за да наблюдават наводнението .	наредиха	14	3
Проект на Валутен закон , който значително ще либерализира валутния режим в България , одобри днес правителството .	либерализира	8	3
Първо мисли , после пиши .	пиши	4	2
Когато си тръгваше , Стоянов каза " Сега трябва да намеря семейството си , изгубихме се някъде сред хората " .	тръгваше	2	3
Постигнато бе съгласие срещите между двете комисии да станат периодични .	станат	8	3
Ако трябваше отново да напиша " Обсадно положение " , действието пак щеше да се развива в Испания , ето моето заключение .	напиша	4	1
Позволете ми да кажа , господин председател , че ние дълбоко ценим този принос , тъй като той е още един знак , още един признак за действащата обединена Европа .	ценим	11	1
Миналия вторник Цветан Н. ( 50 г. ) и Тошо Н. ( 47 г. ) от Ботевград отишли да ловят риба .	ловят	19	3
Какъв е критерият за оценка на въпроса , който днес обсъждаме , на решението , което трябва да вземем и декларацията , която трябва да приемем ?	обсъждаме	10	1
Моля да говориш с него .	Моля	0	1
Когато почна да изгрява месецът , навън ставаше видело и снегът лъщеше .	изгрява	3	3
И няма да се уморим да ги отстояваме !	уморим	4	1
Свихме се на местата си , спотаихме се , не дишаме от страх и трепет .	дишаме	10	1
Позволете ми най-напред да изкажа благодарност на българското Народно събрание за любезната покана .	изкажа	4	1
До Коледа обаче ще успея .	успея	4	1
Трябваше да вземем медали във всички категории .	вземем	2	1
Те нямат чувство за вътрешен контрол ( вж. трета глава ) и често вършат неща , които не са в техен интерес , например мамене , изневеряване , невнимателно шофиране и пренебрегване на здравето си .	вж.	7	2
Той обвини Ясер Арафат за нападенията от последните седмици и провала на мирните преговори .	обвини	1	3
Грози ни суша , пестите ли водата ?	пестите	4	2
Чух го как се разсвирва в коридора и се впечатлих от неговата невероятна самовзискателност .	впечатлих	9	1
Те създават работните места , могат да наемат солидни адвокати , които да бранят интересите им , ако се наложи дори да си платят за нечие мълчание .	бранят	13	3
Посягам , но преди да те хвана , ти отлиташ .	отлиташ	9	2
Няма ли да седнете ?	седнете	3	2
Фактът вероятно ще ви подскаже , че това свръхсензитивно същество се нуждае от опитен духовен учител , за да овладее протичащата през него непозната енергия .	подскаже	4	3
След като месеци наред отричаше връзката си с Моника Люински , президентът Клинтън бе принуден да признае за съществуването й .	признае	16	3
Иван го чакаше да се върне .	чакаше	2	3
Според Славински претенциите се основавали на клаузи , които не фигурират нито в договора , подписан между фирмата и предшественика му Вилхелм Краус , нито в анекса , подписан от него .	фигурират	10	3
Колкото до финансовата страна наистина смятам , че има някакво недоразумение .	смятам	5	1
Аз да бях я сварил , щях да я науча аз нея .	науча	9	1
Заедно с това ние трябва най-сетне , казвам най-сетне , защото го предлагаме повече от година , не просто да приемем декларация , а да формираме държавническа позиция , позиция , основана на добре осъзнатия национален интерес .	приемем	20	1
Разберете го ясно и категорично .	Разберете	0	2
Глава 15 съдържа полезни идеи за това , как да включите справянето във вашата философия за живота , и сигурно ще искате да я прочетете след това .	искате	21	2
Но вие се подготвихте да бъдете зле осведомен , като поддържахте забравата .	подготвихте	3	2
Представете си един типичен сюжет на американски филм .	Представете	0	2
- Тогава как без профсъюзите ще договаряте колективните трудови договори ?	договаряте	6	2
Можем ли отсега да прогнозираме какъв ще е бюджетът за материално подпомагане през следващата година ?	Можем	0	1
С толкова сигурно ще мога да си покривам най-належащите нужди .	покривам	7	1
Не избягвайте проблемите , които изискват непосредственото ви внимание , но си дайте почивка , когато се нуждаете от нея - не " изгаряйте " .	дайте	12	2
От страх взех да се озъртам при всеки шум .	взех	2	1
И ти отиде да му помогнеш !	помогнеш	5	2
Всичко ще хвърля .	хвърля	2	1
Опитай да се изявиш най-малко по един предмет .	изявиш	3	2
Не съм политическа сваха и не правя политически годежи , каза президентът Петър Стоянов след вчерашната си среща с ръководството на ДПС .	правя	6	1
През това време шефът на НСО ген. Владимиров и бодигард изкъртиха малка стълба от сцената , подпряха я на загражденията , преминаха по нея и отново заградиха президента .	подпряха	16	3
Да се разрешат ефективните стачки в здравеопазването и съобщенията , поиска зам.-конфедеративният секретар на КНСБ Чавдар Христов .	разрешат	2	3
Той каза , че трябва да заминеш .	заминеш	6	2
Атанас Вълков от Районния съд постанови , че там са се съдържали " клеветнически твърдения по отношение личността на ищеца " и ги оцени на 1850 лв. , макар че Тагарински настояваше за 5000 лв.	настояваше	31	3
Но вие се подготвихте да бъдете зле осведомен , като поддържахте забравата .	поддържахте	10	2
Да предположим , че една община има приемлив кредитен рейтинг и получава кредит от банка за инвестиционни цели за срок от пет години .	предположим	1	1
Продажбата на билетите от по 5 лв. започнала късно и екипите решили да вкарат в студиото само свои хора и журналисти .	вкарат	13	3
Агенцията за приватизация ( АП ) вече ще се ръководи от изпълнителен съвет , съставен от директор и двама заместници , като и тримата ще се назначават от кабинета .	назначават	26	3
Пожарът избухнал на борда на акостиралия на гръцкото пристанище танкер с панамска регистрация " Морски вълк " , уточниха от гръцките власти .	уточниха	18	3
Той излезе , макар че валеше .	валеше	5	3
Надявах се господин министър-председателят да остане да послуша малко , но уви !	послуша	7	3
По всяка вероятност това ще бъде новият арсенал за борба със столичните мутри , които напоследък все по-често изпълзяват от своите сумрачни офиси .	изпълзяват	18	3
Радвам се , че пристигат .	Радвам	0	1
И така , след като огласи осъществената мечта на живота си - да спре 100-годишната война със социалдемократите , Георги Първанов тържествено гръмна шампанското на политическия съюз Нова левица .	огласи	5	3
Ако сметнете погрешно , че то просто обича да бъде само , ще го нараните за дълги години напред , затова забравете строгостта и участвайте в заниманията и игрите му .	сметнете	1	2
Докато се разхождаше бавно из двора , патицата оглеждаше кладенеца .	разхождаше	2	3
" Не се разстройвам и не се разгневявам , когато хората са груби с мен . "	разгневявам	7	1
Успяхме да поведем в края на двубоя , но тогава за 5 фаула излезе най-добрият ни в тази среща Димитър Ангелов .	поведем	2	1
Като познаваме обаче нрава на Муравей , спокойно можем да прогнозираме , че изненадите едва ли ще спрат дотук .	прогнозираме	10	1
На колкото повелява възпитанието .	повелява	2	3
Откъсва ли се тя от френското сърце ?	Откъсва	0	3
Смятате ли , че в кариерата стигнахте ранга на баща си например ?	стигнахте	6	2
Само за две години извън голямата битка националният ни отбор се срина с пет места в ранглистата и вече изпитва затруднения да бие отбори като Финландия и Полша , която от миналата година също е сред участниците в лигата .	бие	22	3
Иска ми се да заминеш .	заминеш	4	2
Един наместник ще управлява центъра , замислят окрупняване на сегашните райони	замислят	6	3
Грандовете " Левски " и ЦСКА се опитват да вземат 18-годишния нападател Крум Бибишков , съобщиха близки до двата лагера .	опитват	7	3
Взех те за директора .	Взех	0	1
И ми давате окончателно думата , като пишете , че в това виждате липса на кураж и честност .	пишете	7	2
Както знаете , госпожи и господа , понеже съм шотландец , английският не е майчиният ми език .	знаете	1	2
Конституционният съд разглежда обвинението срещу президента или вицепрезидента в едномесечен срок от внасянето на обвинението .	разглежда	2	3
Хайдутин ли съм да ме връзваш ?	връзваш	5	2
- Две учителки се отказаха , след като си бяха намерили работа .	отказаха	4	3
Той го нарече глупак .	нарече	2	3
Десет отмярвай , едно отрязвай .	отрязвай	4	2
Всичко зависи от нагласата на студента .	зависи	1	3
- За първи път се сблъсквам с него .	сблъсквам	5	1
Не можеше да ги понася .	понася	4	3
Президентът Стоянов , премиерът Костов и съпругата му Елена , министрите Евгени Чачев и Иван Нейков , сини депутати уважиха организираното от Столична община и БНТ народно веселие .	уважиха	19	3
Начинът да се настроиш за ритъма на работата е да започнеш да работиш .	работиш	12	2
- Щях да те забележа - каза той .	Щях	1	1
Стани премести книгите .	Стани	0	2
Да събираш парите си възможно най-бързо и да плащаш задълженията си възможно най-бавно .	плащаш	8	2
Дали ще разберем през новия век очевидната истина , че единственото ни богатство , което интересува другите народи , е това , което тече в кръвта ни ?	разберем	2	1
Запали , снахо , пещта , да опечем агнето , дето ще го донесат .	Запали	0	2
Букурещ се обиди на премиера ни	обиди	2	3
Това кара ли те да се чувстваш по-голяма ?	чувстваш	6	2
Търся път да води към върха .	Търся	0	1
Той грабна фунията , притича до горното стъпало и изрева три пъти надолу към Лабиринта .	притича	4	3
Забравих да искам това .	Забравих	0	1
Имаме адреса му във Франция , а и не мислим , че човекът ще се опита да избяга от правосъдието	мислим	9	1
Интервенцията се изчаква само за да бъде по-ефективна , коментира Бисер Манолов .	коментира	9	3
Аргументът , че с тях заплашваме спокойствието на съседите , не върви .	заплашваме	5	1
- Непрекъснато мисля за тези коледни подаръци , но засега не успявам да измисля нищо .	измисля	13	1
Тя ще се зарадва , каквато и шапка да й сложиш .	сложиш	10	2
Ще дойда по-рано , за да има време за по едно кафе .	дойда	1	1
Отсега можем да се обзаложим да речем , че едномесечната дървена ваканция ще важи само тази година .	обзаложим	4	1
- Знаеш ли кой е открил топлата вода ?	Знаеш	1	2
Това , което казвам , се вижда много добре в разказите за литературна чистка .	казвам	3	1
Просто трябва да се стегнем и да работим за страната си , а не да гледаме как да избягаме от нея .	гледаме	15	1
Искам да отбележа , че в последните седмици стореното от България в последните две години привлече особен интерес .	отбележа	2	1
Благодаря ти !	Благодаря	0	1
- През тази седмица ще имаме заседание на Управителния съвет и там ще изберем новия наставник .	изберем	13	1
- Който желае , може да кандидатства за вакантните длъжности в Българската армия .	кандидатства	6	3
Вчера институциите в Плевен мъдруваха как да се справят с взривовете .	справят	8	3
След три дена го пренесохме по гръб през село .	пренесохме	4	1
Трябва да използваме сегашната организационна структура на армията и с възлагането на допълнителни задачи и подготовка да се използват силите и средствата , с които се разполага .	използваме	2	1
Не бих могъл да продължавам да пиша .	пиша	6	1
Ако някой си мисли , че ние ще застанем до СДС против БСП , това няма да стане .	застанем	8	1
Замълча за миг и впери в него зелените си бадемови очи с толкова много разноцветие и отблясъци .	Замълча	0	3
И Вие , господин президент , се примирихте , подкрепихте с участието си в партийни форуми утвърждаването на диктата на тази олигархия .	подкрепихте	9	2
Прекъсна връзката .	Прекъсна	0	3
- Не виждам предпоставки за съществен срив на доверието в кабинета .	виждам	2	1
Станах юноша .	Станах	0	1
Ще се погрижа да го намеря .	намеря	5	1
Така атентаторите щели да докажат , че още са навън .	докажат	4	3
Хората често правят лоши компромиси , когато не са се научили как да се справят с неуспеха ( вж. четвърта глава ) .	вж.	18	2
Когато учех за контролното есе за Ренесанса на мистър Уайдман , измислих думата пракехплимим да ми напомня за перспектива , религия , анатомия , класически езици , хуманитарни науки , природа , литература , интелектуалност , материализъм и младост .	учех	1	1
Инженерът не разбираше от работата на историците , но видимо се чувствуваше виновен и тя му прости , заканвайки се само на колегите си .	чувствуваше	11	3
Ако ми дадеш билет , бих отишъл на театър .	дадеш	2	2
" Избягвам ситуации , в които трябва да завися от други хора . "	завися	8	1
Положителната преоценка е по-ефективна за типовете проблеми , пред които се изправят 30- и 40-годишните .	изправят	11	3
Ако не печелиш навън , не можеш да станеш шампион	печелиш	2	2
Ти гледаше към петокласниците и се правеше , че имаш много домашни , защото това те караше да се чувстваш по-голяма .	правеше	6	2
" Когато нещата се объркат , се депресирам и се предавам . "	депресирам	7	1
Обичаше ярката светлина и не се боеше от нея .	Обичаше	0	3
Надяваме се визите да паднат преди изборите , каза премиерът Костов при завръщането си от 2-дневна совалка в Брюксел и Лисабон .	Надяваме	0	1
Да очакваме ли скоро македонски офицери и курсанти в нашата академия и военните училища ?	очакваме	1	1
Да кажеш , че ще подкрепяш туризма и селското стопанство , е добре , но това не е стратегия за растеж .	подкрепяш	5	2
Не подписвай , без да прочетеш .	прочетеш	5	2
- Говори се , че със СДС преговаряте да получите образователното министерство срещу подкрепа в следващия парламент .	преговаряте	7	2
- Не съм запознат как е в отделните европейски страни , знам само , че най-слабо синхронизираните отношения в Европейския съюз са трудовоправните .	знам	11	1
Ела ме , майко , прегърни , и в красно чело целуни .	Ела	0	2
Той приближи плътно до нея и най-неочаквано я притисна към себе си .	притисна	8	3
Ако в посочения срок президентът не свика Народното събрание , то се свиква от една пета от народните представители .	свика	6	3
В туй време звънецът издрънка .	издрънка	4	3
" Да са ми живи и здрави приятелите " , казва тя , помогнали й да струпа покъщнина .	струпа	16	3
В Дюселдорф той присъства на вечеря и концерт , средствата от които са предназначени за децата от третия свят .	присъства	3	3
Бащите влизат в родилното след курс	влизат	1	3
Не виждам откъде идва монополизмът .	виждам	1	1
И двамата тръгнахме веднага .	тръгнахме	2	1
Узнах новината от него .	Узнах	0	1
Ако България сега се отклони от пътя , по който върви , това ще прилича на ситуация , в която пациент , подложен на операция , слиза от масата заради голямата болка , посочи Стоянов .	прилича	14	3
- И без това не можех да имам деца .	имам	7	1
- Ще участвам в този тираж на тотото .	участвам	2	1
Излязохме и ние с дядо Гено .	Излязохме	0	1
Вместо да се насочим към източника на проблемите , ги игнорираме и се надяваме , че те някак си ще изчезнат .	надяваме	13	1
Броя до десет и ако не дойде , аз тръгвам .	тръгвам	9	1
Аз мога да заявя , че ние ще отстояваме тези интереси на България .	отстояваме	8	1
Дай ми ти само слуха си !	Дай	0	2
В 16,20 ч се прибрах .	прибрах	4	1
Топалов победи Георгиев на световното по шах	победи	1	3
Магистратите да не се сърдят , позират , хленчат , да не шантажират , че не са разбрани още в самото начало на преговорите с ЕС , защото ще си направят лоша услуга .	позират	6	3
Те по достойнство ще се възползват от новите възможности , които ще имат .	възползват	5	3
Възрастните хора над 70 г. ще могат да сменят паспортите си , когато пожелаят .	пожелаят	13	3
Ако следваме тази логика , можем да предположим , че общинските каси ще се изпразнят още в началото на 2001 г.	следваме	1	1
Сетих се за това неочаквано , както си вървях .	Сетих	0	1
Нося ти книги да четеш .	четеш	4	2
Чужденците и чуждестранните юридически лица не могат да придобиват право на собственост върху земя освен при наследяване по закон .	придобиват	8	3
Докато водещи европолитици като комисарят по разширяването Гюнтер Ферхойген дори мечтаят за приемането на група до 10 страни , бюджетните специалисти все още се лутат в неизвестност .	мечтаят	10	3
Получихме редица индикации , че интересът на другите телекоми към БТК е нараснал по време на преговорния процес , заяви вчера Антони Славински , но не спомена конкретно име на фирма .	Получихме	0	1
- Трябва да го отпразнуваме !	отпразнуваме	4	1
Не мога да те позная бе .	позная	4	1
Аз обикалях , за да им давам упование .	обикалях	1	1
Пощенска станция в Китай разшири дейността си , като доставя на клиентите си храна по домовете и съпровожда булки до мястото на брачната церемония , оповести в. " Женмин жибао " .	разшири	4	3
Пък да си го видял , кога играе театро , ще си забравиш хапката в устата и няма да клепнеш , дорде не пуснат завесата .	забравиш	12	2
Може би защото , както обикновено , той отсъстваше от залата .	отсъстваше	8	3
Занимаваше ги въпросът , къде е той .	Занимаваше	0	3
Не остана под небето сила да не устои срещу тях .	устои	7	3
Трябва да можеш да продължиш да бягаш .	бягаш	6	2
Народното събрание може да определя и други длъжности и дейности , които членовете на Министерския съвет не могат да заемат или извършват .	заемат	19	3
Една от основните ми цели е да ви помогна да осъзнаете личния си стил , така че адекватно да възприемате и реагирате на предизвикателните житейски събития .	възприемате	19	2
Тръгваме на заход слънце , тъй като дългия път трябва да минем през нощта .	минем	11	1
Ние ще преустановим контактите със социалистите на общинско ниво , ако те създадат областен координиращ съвет с участието на Камовите хора , закани се местният лидер на БЕЛ Георги Костов .	закани	22	3
Има само една възможност да направиш добро впечатление и ЕЦБ я пропусна , твърди " Кориере дела сера " .	направиш	5	2
Време ни е да тръгваме .	тръгваме	4	1
Вальо се засмя и наистина скочи от стола .	засмя	2	3
Поставят ни ултиматум за по-ниски такси при внос на руски коли и машини	Поставят	0	3
Взрив разтърси израелски курорт	разтърси	1	3
Радвам се , че научих много в гимназията , както се радвам , че успях да постъпя в колежа , който исках .	исках	21	1
- Имах добри оценки благодарение на това , че си скъсвах задника от учене .	скъсвах	10	1
- Аз съм страж на ония горе и без подкуп няма да ги предам .	предам	13	1
Дали мислиш , е важно .	мислиш	1	2
- Надявам се да го посрещнем топло .	посрещнем	5	1
След това между него и жена му избухна караница дали да ходят сутринта рано на черква .	ходят	11	3
Наизлязоха слуги , светнаха фенери и дълги шипове светлина прорязаха тъмнината .	прорязаха	9	3
Тъй като сегашният момент е следобед в края на юли , той е облечен в избеляла от пране риза с отрязани ръкави и къси панталони , долните му гащи висят изпод крачолите на панталоните .	висят	29	3
Като пристигнаха , гледат , озъртат се - няма ни кон , ни дявол .	озъртат	5	3
Помислете как ще стигнете дотам .	стигнете	3	2
Помни , че измамата и плагиатството са незаконни .	Помни	0	2
В момента печелим от добива и продажбата на нефт .	печелим	2	1
За да използвате ползотворно бягството , добре е да практикувате следните умения :	практикувате	9	2
Дори и да не позная нито едно число , пак трябва шанс , за да спечеля колата .	позная	4	1
Понякога учех в библиотеката през първите 10 минути от времето за обяд - всичко , което пропусках , бяха дългите опашки в стола .	пропусках	16	1
Аз съм в състояние да почувствам напълно едно стихотворение само когато го науча наизуст и мога да си го повтарям непрекъснато , да го обръщам и да го оглеждам отвсякъде .	почувствам	5	1
Ще посрещнете ли Дядо Коледа на метростанция " Сердика " ?	посрещнете	1	2
Хората на Николай Павлов се обявиха против възможността да се отнема лицензът на мобилен оператор , тъй като това би довело до облагодетелстването на друга фирма от бранша .	отнема	10	3
Стават тревожни и страхливи , когато от тях се изисква да се грижат за себе си .	грижат	12	3
С " бръмбарите " се разпорежда изпълнителната власт .	разпорежда	5	3
Превърнете се в неговите приятели и не скривайте радостта си , че е с вас .	Превърнете	0	2
Ние не подкрепяме каквито и да е опити за разбиване на СДС , каза той .	подкрепяме	2	1
Че го обичаш , зная добре .	обичаш	2	2
Ела ме , майко , прегърни , и в красно чело целуни .	целуни	11	2
Опитай да започнеш работата си по проекта отрано и да го правиш стъпка по стъпка , за да не се претовариш .	правиш	11	2
Познавам я .	Познавам	0	1
Не се мъчи да измисляш : казвай без страх истината !	измисляш	4	2
Топалов игра с черните фигури , като Дреев бързо взе леко предимство .	игра	1	3
Знае ли човек , през новия век може отново да излезем на сцена	излезем	10	1
Омесете тестото .	Омесете	0	2
- От тази гледна точка как оценявате проекта за нов закон за вероизповеданията в България ?	оценявате	6	2
Според Жотев няма да плащаме никакви неустойки за пропиляното в преговори време , защото такива клаузи не е имало .	плащаме	4	1
Стихна боят , мили мой , ала ти не се завръщаш .	завръщаш	10	2
От здравното министерство препоръчват да не се пие вода от неохраняеми източници , да не се ядат миди и редовно да се мият ръцете .	препоръчват	3	3
Абитуриентите пристигнаха в резиденция " Бояна " благодарение на бензин , осигурен от " Шел " .	пристигнаха	1	3
Сега ще се спрем на по-конкретните реакции на справяне .	спрем	3	1
Позволете ми да кажа , господин председател , че ние дълбоко ценим този принос , тъй като той е още един знак , още един признак за действащата обединена Европа .	Позволете	0	2
Не щеш ли , по това време минавал наблизо кметът .	щеш	1	2
Мненията са в МОН и се обработват .	обработват	6	3
Ракетни специалисти от американската армия са поискали да ликвидираме ракетите си Р-300 .	ликвидираме	8	1
Не се очакваха и снощните изригвания , помисли си Том .	очакваха	2	3
Ще прочета двете становища за двата проекта за решение по реда , по който са постъпили в Комисията по външна и интеграционна политика .	прочета	1	1
Така и така го гледаме от екрана по-често от патриарха си .	гледаме	4	1
А посветените на по-далечното минало направо разочароваха .	разочароваха	6	3
Ще предложим да се намали срокът , обеща вчера шефът на Генщаба ген. Михов .	предложим	1	1
Напускам , защото не одобряваме сегашното ръководство на МВР - министърът , заместник-министрите и главният секретар , каза Коларов .	Напускам	0	1
Донеси каквото ти казах .	Донеси	0	2
Ще бръкне да извади някое шише - иди го гони сетне .	иди	7	2
Редът е такъв , откакто действа новият Закон за държавната собственост .	действа	5	3
А как ще щурмувате , моля ?	щурмувате	3	2
Ние не изключваме в тази коалиционна политика ДПС .	изключваме	2	1
И напразно тълкува успеха си като влияние : той е тук повлияният .	тълкува	2	3
Сигурно здраво се опирате на уменията и опита на командирския състав , който служи в училището ?	опирате	3	2
Уведомих обаче за оставката си говорителя на Пакта за стабилност , който ми се обади лично , за да разбере какви са мотивите ми да се оттегля .	оттегля	26	1
Аз говоря тук от името на цяла България , защото преди това се срещнах с всички политически лидери и дискутирах въпросите , които се каня да поставя пред вас .	дискутирах	19	1
С успех нашите юноши се изявиха в две области - изобразително изкуство и музика .	изявиха	5	3
Знаеш ли Иван заминал ли е ?	Знаеш	0	2
Днес сме се събрали , за да сложим начало на националните чествания по случай 180 години от раждането на големия българин Георги Раковски , каза Президентът .	сложим	7	1
Министерският съвет ръководи изпълнението на държавния бюджет ; организира стопанисването на държавното имущество ; сключва , утвърждава и денонсира международни договори в случаите , предвидени в закона .	утвърждава	16	3
Според държавния глава ще бъде " национално късогледство , ако не съхраним този авторитет " .	съхраним	11	1
Правата предполагат свобода , за да ги защитаваш .	защитаваш	7	2
Считаме досегашната си коалиционна политика за успешна , но започналите преговори за членство в ЕС изискват повече усилия , коментира Костов .	Считаме	0	1
Наопаки , някакво стеснение я придружава винаги и само по него ние можем да я отгатнем .	отгатнем	15	1
И именно заради това в декларацията , която предлагаме , ние настояваме за това .	настояваме	11	1
" Билла " ще строи магазин и в Пловдив	строи	4	3
Ако не работиш ефективно късно през нощта , легни си и стани рано .	стани	11	2
Беше преписвал направо от един малко известен том - оказа се , че авторът е приятел на учителя му !	оказа	9	3
Те изгориха цяла кола дърва .	изгориха	1	3
Кои бяха ония , дето ги видяхме .	видяхме	6	1
Християнството , което е тотална религия , да употребя една модна дума , не може да приеме мисълта човек да дава само част на този , който , според неговия смисъл , трябва да притежава цялото .	притежава	34	3
БЕЛ посрещна с изненада и безпокойство изказването на г-н Агов .	посрещна	1	3
Материалите завършват с анализи на проблемите на информационната сигурност и информационното осигуряване на военната реформа .	завършват	1	3
- Напълно признавам правото на бившите собственици да бъдат обезщетени за причиненото им от комунистическите власти .	признавам	2	1
Нашето виждане е , че е необходимо да се създаде качествено нов кодекс , който да отговаря на новите реалности .	отговаря	16	3
Българската артилерия бе успяла да заеме позиции и откри яростен огън по отстъпващите немски вериги .	откри	8	3
Рано или късно , докато пишеш програма по информатика , правиш опит с плодова мушица по биология , пееш в хора или слагаш гърне в пещта , ще се почувстваш пълна с енергия и ентусиазъм .	слагаш	22	2
Опитай се да го намериш .	Опитай	0	2
Би могла също да направиш преговор на автобусната спирка , в учебната зала или като влезеш в клас преди учителя .	направиш	4	2
Дъждът плющи в нощний мрак .	плющи	1	3
А притвори ли очи , хич се не май , а грабвай си шапката и бягай в друга махала чак .	май	8	2
Кълна се .	Кълна	0	1
Събрал съм малко глина , но не зная какво да направя от нея .	направя	10	1
Грешно е това , което се прави , и след време ще страдаме .	страдаме	12	1
За да не товаря домашния й телефон , й предложих да позвъни на съпругата ми , която си беше вкъщи .	товаря	3	1
Да действаш като богат .	действаш	1	2
Не обръщайте внимание на думата " порнографска " в заглавието на този филм на белгийския режисьор Фредерик Фонтейн .	обръщайте	1	2
Колкото и да викаш , напразно е .	викаш	3	2
Имахме потенциала , имахме хората , отнеха ни възможността да се докажем .	докажем	11	1
- Хубаво е , че научих за инициативата .	научих	5	1
За първи път хората от моята възраст срещаха неправдата да възтържествува в историята .	възтържествува	10	3
Коледа обаче ще празнувам със семейството .	празнувам	3	1
Сутрин и вечер слушах клепалата и рева на Янтра .	слушах	3	1
Бизанти подкрепи искането на адвокат Шейтанов за отменяне на мярката за неотклонение " задържане под стража " за подсъдимите българи , но съдът го отхвърли .	отхвърли	24	3
Татко ухае на вода за бръснене и папироси , бузата му малко дращи .	ухае	1	3
След като Божидар се отдръпна от нея , Джина изкусително се превъртя на единия си хълбок .	отдръпна	4	3
Очакваме 20 % от учениците , които ще се явяват всяка година на задължителни матури , да не издържат изпитите .	Очакваме	0	1
- Идеята дойде от разговорите с директора на " Театър 199 " Валентин Стойчев какво да направим съвместно .	направим	16	1
Пускат парното до 1 ноември	Пускат	0	3
И го подписаха в този ден , в който смених заглавието на статията си " Престъпници " с доста по-мекото - " Манипулатори " .	смених	9	1
Сетих се кого да попиташ .	попиташ	4	2
- Преди време Банев бе казал , че е възможно да закупи инсталациите за етилен в " ЛУКойл " .	закупи	11	3
Като си спомняше снощната среща с Пиротски , горският разбираше , че нещата стават по-сложни .	стават	13	3
Мъка е , когато не се боиш от нищо .	боиш	6	2
Често се насаждах до някой всезнайко , така че можех да проверя многобройните възможни отговори .	проверя	11	1
Министър-председателят на Франция социалистът Лионел Жоспен наруши обичая и изпревари президента-консерватор Жак Ширак с новогодишните си пожелания към нацията , предаде АФП .	наруши	6	3
За жалост няма да мога да отида , защото имам много да уча .	уча	12	1
Според данните 87 % се интересуват дали ще вали , 83 % следят политическите новини от България , а 71 % търсят здравните информации .	интересуват	5	3
Искаме демократични Балкани , защото няма как да се развиваме нормално в регион , в който страните са на различно положение , различно са се развили в демократичните процеси .	развиваме	9	1
- Върнах я .	Върнах	1	1
Пред препълнени трибуни в зала " Универсиада " българските шампиони започнаха устремно двубоя и бързо натрупаха преднина от 7-8 точки , която не отстъпиха до края на гейма .	отстъпиха	23	3
Набрах цвят от липа .	Набрах	0	1
Да живееш като богат .	живееш	1	2
Ти гледаше към петокласниците и се правеше , че имаш много домашни , защото това те караше да се чувстваш по-голяма .	караше	16	2
В същата глава дискутирам посттравматичното стресово разстройство .	дискутирам	3	1
Много пъти той вдигаше ръка да бие .	вдигаше	3	3
Пръв път съм закачил да пиша в Свищов .	пиша	5	1
Не се интересувам от папата .	интересувам	2	1
Тъй като не са успели да спечелят самооценка и признание за следване на социалните норми , понякога стават антисоциални .	спечелят	6	3
Съжалявам за това , че заминаваш .	Съжалявам	0	1
Вие бяхте ли , когато гласувахме ?	бяхте	1	2
Просто помислих , че трябва да почакам да вземат решение , преди да ги нарека крадци .	нарека	14	1
Гледам гнездото на щъркелите отсреща .	Гледам	0	1
Затова повечето ми колеги започват като бармани , сервитьори , охрана , консултанти , продавачи , помощник-счетоводители .	започват	4	3
Пухти , хърка , квичи , писука до клепнало време и дорде я не събудят , не става .	събудят	14	3
Както е известно , близо 1/3 от селищата у нас са на воден режим , напомнят експерти .	напомнят	15	3
Хванах се за носа и си приготвих кърпичката за всеки случай .	Хванах	0	1
Инцидентите станаха в град Адана , който е четвърти по големина в Турция .	станаха	1	3
- С господин Митев ще продължите онова , което оставям .	продължите	5	2
Както речникът , така и фразеологичният състав на даден език подлежат на изменение и попълване с нови елементи .	подлежат	10	3
Още преди да открият трупа , полицаите обявиха Илия Илиев като заподозрян за отвличането на детето .	обявиха	7	3
Или си представи , че пишеш писмо на приятелка .	представи	2	2
Ако " Плама " спре , трябва да купуваме прескъпи масла и други петролни продукти от западни производители	купуваме	8	1
Апропо , чувствах се като онези мъже , които са вечно втори в живота на жените .	чувствах	2	1
Измъкнахме се и поехме за село .	Измъкнахме	0	1
Не мога да поема тази отговорност и да поставя под риск самото провеждане на изборите поради чисто технически причини , ако върна новоприетия избирателен закон	поема	3	1
Ако визитата на германците пропадне , нашите ще гостуват на Италия .	пропадне	4	3
Напролет баба Марга се помина съвсем ненадейно .	помина	4	3
Пиши и преписвай това , което учиш .	Пиши	0	2
Овчарят се оказа негов познат .	оказа	2	3
И не гледай часовника си , и недей да се разсейваш , така че , когато те вдигнат , да питаш : " На коя страница сме ? "	недей	7	2
Стягаме се , отиваме с жената и още щом доближихме кухнята , една ужасна миризма на вмирисано месо ме удари по носа .	Стягаме	0	1
Не мога да поема тази отговорност и да поставя под риск самото провеждане на изборите поради чисто технически причини , ако върна новоприетия избирателен закон	поставя	8	1
Как да се реши въпросът ще решат министрите на вътрешните работи от Евросъюза , които ще се срещнат след двадесетина дни .	срещнат	17	3
Величаенето не е излишно в нито едно общество , но е редно повече да го свързваме с поетите от личността отговорности , а не да възкачваме на престол личността , която е някакъв шеф .	възкачваме	25	1
Ние искахме то да бъде взето на 30 ноември .	искахме	1	1
Засега в България няма регистриран случай на опасната болест по говедата , която може да се предаде и на хората , ако консумират месо от болно животно .	консумират	22	3
Ето , това е , госпожи и господа , различната цена на мандата , която платихте вие и обикновените хора .	платихте	15	2
Смятам , че ние сме морално задължени да изразим и своята готовност за хуманитарна помощ от страна на България след спирането на ударите .	изразим	8	1
Вадят ни от черния списък до края на годината	Вадят	0	3
Напускам , защото не одобряваме сегашното ръководство на МВР - министърът , заместник-министрите и главният секретар , каза Коларов .	одобряваме	4	1
Откак се ожени , не излизаш често по свят .	излизаш	5	2
Вместо да се успокои , страхът и безпокойството му още повече пораснаха .	пораснаха	11	3
Спри да говориш , не е нужно това .	Спри	0	2
Световният шампион от Формула 1 Михаел Шумахер преразгледал безбройните си договори за реклама и решил да постави името и титлата си на световен шампион върху 350 вида продукти .	постави	16	3
Трябва да се почисти градинката до блока .	почисти	3	3
Взех че скроих друг план .	скроих	2	1
Дадеш ли му пари на заем , върви го търси после .	върви	7	2
Въобще оказа се , че някои служители в МВР са с къса памет в последно време , което ме навежда на мисълта , че трябва да ги уволня , за да не се затормозяват и да си опреснят паметта	уволня	27	1
По този начин мъжът ще разбере колко е трудно на жената и ще оцени нейното страдание .	оцени	13	3
Не виждам .	виждам	1	1
Едни от най-добрите проекти за миналата година са свързаните със социалната сфера , които целят да намалят тежестта на реформата за хората .	целят	14	3
Свихме се на местата си , спотаихме се , не дишаме от страх и трепет .	Свихме	0	1
Имах много добри взаимоотношения с мениджъра Арсен Венгер и оставям много приятели в " Арсенал " .	оставям	9	1
Заедно с уикендите обаче се събират общо 7 почивни дни за Коледа и Нова година .	събират	5	3
С моя незначителен принос аз направих каквото можах и то ви скандализира .	можах	7	1
Ти гледаше към петокласниците и се правеше , че имаш много домашни , защото това те караше да се чувстваш по-голяма .	чувстваш	19	2
Нямаше смисъл да виси повече тука , сомът бе подплашил рибата във вира .	виси	3	3
Съвзех се по едно време , гледам , парите ми се виждат много .	Съвзех	0	1
Уведомих обаче за оставката си говорителя на Пакта за стабилност , който ми се обади лично , за да разбере какви са мотивите ми да се оттегля .	обади	14	3
С Николай размишляваме дали да не плиснем в лицето на журналистката киселина .	размишляваме	2	1
А това означаваше да намери пари .	означаваше	2	3
И не гледай часовника си , и недей да се разсейваш , така че , когато те вдигнат , да питаш : " На коя страница сме ? "	разсейваш	10	2
Седемчленният Надзорен съвет на агенцията вече ще се избира и освобождава изцяло от парламента .	освобождава	10	3
Конгоанецът Моке и вчера не пристигна в България , за да се присъедини към отбора на ЦСКА .	присъедини	12	3
Избраните от него актьори обаче ще минат на кастинг в БНТ .	минат	6	3
Те чакат , докато заплахата стане реалност , за да реагират .	реагират	10	3
Невеста Нена престана да вика .	престана	2	3
- Ще намерим , ти не се тревожи !	тревожи	7	3
Семинарията е , изглежда , място , дето човек най-лесно може да изгуби вярата си .	изгуби	12	3
Хората с потискащ стил на справяне са се научили да гледат на света и на себе си по много предубеден начин .	гледат	10	3
- Аз не искам да взимам отношение .	взимам	5	1
Кого ти ще поканиш ?	поканиш	3	2
Споделихте , че вече има такива девойки , които са решили да потърсят професионална реализация в армията .	Споделихте	0	2
Тая музика те кара да се замислиш .	замислиш	6	2
Правителството на Тони Блеър не може разумно да защити позициите си и възпрепятства прогреса в ЕС .	възпрепятства	12	3
Аз съм в състояние да почувствам напълно едно стихотворение само когато го науча наизуст и мога да си го повтарям непрекъснато , да го обръщам и да го оглеждам отвсякъде .	обръщам	24	1
Всички тук декларирахме , поне на думи , че търсим общото в нашите позиции в интерес на България .	търсим	9	1
Не избягвайте проблемите , които изискват непосредственото ви внимание , но си дайте почивка , когато се нуждаете от нея - не " изгаряйте " .	избягвайте	1	2
Аксиния притича до баща си , притисна се в него и го погледна с големите си светли очи .	притича	1	3
Например когато се опитват да разрешат труден проблем или да преговарят по сложен въпрос , хората понякога си пречат , като не обмислят всички възможни варианти .	преговарят	10	3
По време на дебатите Михаил Миков се оплака , че трите часовника в залата отмерват различен час и пречат да се отчита кой колко е говорил .	отмерват	14	3
Поемането на отговорност изисква честно да определим кога сме отговорни за причините и решенията на проблемите ни ( вж. 15 глава ) .	вж.	18	2
Учителите са , които ще вдъхнат живот на плана със своите знания и педагогическо майсторство .	вдъхнат	5	3
Потреперах от мисълта дали не са заловили Дякона .	Потреперах	0	1
Аз , казва , мигар нямам други грижи , та ще седна да се занимавам с лекомислени работи , драги ми господине !	седна	11	1
Сега искам да обърна вниманието ви на това , как двамата кандидати реагираха на случилото се .	обърна	3	1
Нереалистично е да искаме четирикратно по-големи заплати , но настояваме за увеличаването им , както и за подобряването на условията за труд	настояваме	9	1
Ще можем да увеличим годишния бюджет и да преследваме по-големи цели	преследваме	8	1
Телекомуникационните гиганти " Водафон Международен Холдинг БВ " - Холандия , и " Панафон " - Гърция , купиха вчера документите за участие в търга за втория GSM-оператор у нас .	купиха	18	3
Ние не знаехме дали ротният командир беше наистина недоволен от нас .	знаехме	2	1
Причината е , че Турция затяга мерките на гранично-пропускателните си пунктове за чужденците , които пристигат с туристически визи .	пристигат	15	3
Тогава оставете ме още веднъж да говоря от свое име .	оставете	1	2
Край стената отдясно се промъкваше еснаф , чиито руси мустаци се хвърляха в очи .	промъкваше	4	3
Циана не бе подписвала нищо и вероятно го дължеше на препоръката на своя професор по темпоралните машини .	дължеше	8	3
Надеждата да си върнеш загубеното постепенно те напуска .	върнеш	3	2
Но вие несъмнено бързате .	бързате	3	2
Смятам , че му помогнах , като го пуснах от началото .	помогнах	4	1
Това издателство беше обречено на бавно и дълго тлеене , докато си изгасне от само себе си .	изгасне	12	3
Пречиш на другите както си застанал .	Пречиш	0	2
За мен връщане назад няма , защото изгубих доверие в бившите си шефове	изгубих	7	1
Не избягвайте проблемите , които изискват непосредственото ви внимание , но си дайте почивка , когато се нуждаете от нея - не " изгаряйте " .	нуждаете	17	2
Явно празниците ни се отразяват идеално	отразяват	4	3
Старши-треньорът на " Левски " Владимир Федотов се надява голямата звезда на " сините " Георги Иванов-Гонзо да се разпише във вратата на " Бешикташ " .	разпише	19	3
В анкетата на в. " Команда " участваха 210 футболисти и 14 треньори .	участваха	7	3
Може ти да заминеш .	заминеш	3	2
Радвам се , че научих много в гимназията , както се радвам , че успях да постъпя в колежа , който исках .	Радвам	0	1
От друга страна , ако си перфекционистка , успокой малко топката .	успокой	8	2
Живях в заключени простори , в неумолима пустота .	Живях	0	1
Въпреки това ще стискам палци за победа на " Левски " до последно	стискам	3	1
Само да ме излъжеш , не си ми приятел повече .	излъжеш	3	2
С издигането на Ганчо Стоянов на лидерския пост главният секретар Бисеров искал да постави Цонев начело на депутатската листа в Добрич .	постави	13	3
Поемането на отговорност изисква честно да определим кога сме отговорни за причините и решенията на проблемите ни ( вж. 15 глава ) .	определим	6	1
Пътят не беше извървян от БСП и аз не виждам дали има някаква солидност в позицията й .	виждам	9	1
Поставяйте си реалистични цели , така че да можете да постигате успехи без хроничен страх от неуспех .	постигате	10	2
Помоли някой да те изпита за спрежението на чужд глагол или го напиши на празен лист .	Помоли	0	2
- Подправям нещо .	Подправям	1	1
Можем ли отсега да прогнозираме какъв ще е бюджетът за материално подпомагане през следващата година ?	прогнозираме	4	1
Те се вълнуваха , кипваха мигом , вдигаха гора от сухи , черни ръце , гръм от негодувание и яростни викове разлюляваха въздуха и ехото замираше бавно , тържествено , като далечни топовни гърмежи .	замираше	25	3
Ако не се подобрят условията на труд и не започне редовно изплащане на заплатите , ще обявим стачка на 1 ноември , заплашиха от синдикатите в компанията миналата седмица на среща със зам.-министъра на транспорта Любомил Иванов .	обявим	16	1
Определи къде ти е най-удобно да учиш .	Определи	0	2
Освен това обучаваме бойците по 38 специалности , по които след това могат да си намерят работа .	обучаваме	2	1
Мога да науча много неща в " Прост "	Мога	0	1
Отдавна мислех за " Есенна соната " .	мислех	1	1
По време на престоя си в Малта Любо Пенев ще разговаря и за нападателя на " Биркиркара " Чъкс Нвоко , цената на който е $ 240 000 .	разговаря	10	3
Отче , рекох , до дванайсет часа искам книжата да са готови .	рекох	2	1
Политическият кабинет бди срещу подслушването !	бди	2	3
Как се отнасяте към нашумялата теория на проф. Хънтингтън , който вещае сблъсък на цивилизациите от културно-религиозна гледна точка ?	отнасяте	2	2
Испанският гранд се опитва да вземе тийнейджъра , който се утвърди като една от големите звезди във Висшата лига .	утвърди	10	3
Достатъчно е да споменем , че по онова време Виктор Жердицкий даде кратко тв интервю на автора на тези редове на фона на разкошните старинни книги , поразяващото великолепие на антиквариата и скъпи картини от колекцията на Градобанк .	споменем	3	1
Късно снощи се очакваше Кнесета да гласува вот на доверие на кабинета Барак , който управлява с малцинство .	очакваше	3	3
Пътувах из различни страни , из самата Америка .	Пътувах	0	1
Евролевицата бойкотира гласуването .	бойкотира	1	3
Желая успех на всички ви !	Желая	0	1
Трудно е да я накараш да признае .	накараш	4	2
Очаквам скоро да разтрогна с " Академик " и да замина за чужбина .	разтрогна	3	1
Пияният се мъчеше да развърже горната препаска на хитона й .	развърже	4	3
- Имаме програма за ограмотяване .	Имаме	1	1
Ние сме , които търсите .	търсите	4	2
Без да искам да поставям специален акцент върху тях , защото вече имах възможност да ги изложа публично , все пак искам да подчертая някои от тях .	подчертая	23	1
Това ще даде възможност моментално парите на българските фирми да се насочат към намаляването на дълга .	насочат	11	3
И не обръщай внимание на разни изказвания , че момичетата не били добри по математика , или че момчетата предпочитат тъпи момичета .	обръщай	2	2
За нещастие , действието на пиесата се развива в Испания , защото аз избрах това , след като размислих , че трябва да се развива именно там .	развива	7	3
Като усетих , че се люлеем , за секунди се облякох и зарязах болната , изхвърчах като куршум навън .	облякох	10	1
Не е редно да давате голяма власт на Дирекцията по вероизповеданията .	давате	4	2
Както видяхте и в този случай има бивши служители на МВР , разбирайте Държавна сигурност , които си пазят бяла информация за черни дни и не се знае кога ще решат да я използват по този начин	знае	27	3
Тя ще се зарадва , каквато шапка и да й сложиш .	сложиш	10	2
Ако ще тръгваш , тръгвай !	тръгваш	2	2
Въоръжените сили гарантират суверенитета , сигурността и независимостта на страната и защитават нейната териториална цялост .	защитават	11	3
Отивам да купя нещо в магазина .	Отивам	0	1
Искам да ги разделя .	разделя	3	1
Ами ако в края на краищата пред мен отново застанеше някой полковник ?	застанеше	9	3
Ставаме ний , гледаме - сняг .	гледаме	3	1
Един немски свещеник , Мартин Лютер , дълбоко разочарован след посещението си в Рим от нравите на ватиканския клир и лично на папа Лъв X , се обявява открито против търговията с индулгенции .	обявява	27	3
Да станеш футболист на века е като да докоснеш небето с ръце	докоснеш	8	2
Исках да атакувам фронтално определен тип политическо общество , което е организирано или се организира отляво и отдясно върху тоталитарния морал .	атакувам	2	1
500 лева глоба за предприемачите , които не спазят срока	спазят	8	3
Бензинът поевтинява средно с 10-12 ст. от днес по бензиностанциите .	поевтинява	1	3
Вадят всички агенти на ДС	Вадят	0	3
Ела да излезем да изучим позицията .	изучим	4	1
" Избягвам да се занимавам с финансови въпроси . "	занимавам	4	1
Каза го така мило , че ония тъмни сили в него се отдръпнаха и съвсем се спотаиха .	отдръпнаха	12	3
По канала на езерото към морето се пущаха лодка след лодка .	пущаха	7	3
От вносителите някой желае ли да се изкаже ?	желае	3	3
И не гледай часовника си , и недей да се разсейваш , така че , когато те вдигнат , да питаш : " На коя страница сме ? "	гледай	2	2
- На кого връчихте оставката си ?	връчихте	3	2
Две денонощия пътувах с Вас из страната и ме впечатлихте с ведростта си и винаги доброто настроение .	пътувах	2	1
Знаеш ли , че една трета от хората по света са необразовани ?	Знаеш	0	2
Той или тя вероятно със задоволство ще отбележат напредъка .	отбележат	7	3
Хайде , я разправи днес какво ви предава учителят .	разправи	3	2
Циана вдигна ръце за прегръдка , при което ръкавите на широкия халат се дръпнаха , за да открият девствената им белота .	вдигна	1	3
В читалнята не се спи .	спи	4	3
Взех го за един приятел .	Взех	0	1
Аз смятам , че тази точка е необходимото допълнение , което балансира цялото решение .	балансира	11	3
Предполагам , че тази криза ще ме накара да се замисля как да оползотворявам водата .	накара	7	3
Дори и да не позная нито едно число , пак трябва шанс , за да спечеля колата .	спечеля	15	1
Ако нещо ми хареса , си го взимам .	взимам	7	1
Как можех да знам накъде води тази пътека ?	можех	1	1
Остава обаче една малка подробност - също толкова енергично те да ни помогнат да повишим благосъстоянието си , за да има с какво да ходим на Запад като бели хора .	повишим	14	1
Излязох си нормално .	Излязох	0	1
Надзорният съвет няма да чака правно становище от принципала по сделката - вицепремиера Петър Жотев , тъй като то ще се забави , поясниха от АП .	поясниха	23	3
Да се организира Европа на повече скорости е неизбежна задача , която обаче заплашва да разбие институциите на Съюза , а еврото страда и от тази несигурност , заключава " Кориере дела сера " .	страда	22	3
Бойните плувци се появяват в личната охрана на ръководителите на СССР от 1968 г.	появяват	3	3
Най-важният извод е , че оценяваме досегашното единство на институциите като основна причина успешно да бъде завършен мандатът на ОДС в управлението на България .	оценяваме	5	1
Нямах друг избор , освен да се разгранича от позиция , с която не съм съгласен , като подам оставка .	подам	18	1
Манолов провежда поотделно срещи с роднините на всеки от обвиняемите без Шейтанов поради спецификата на проблемите , поясни източник от Външно .	поясни	17	3
- Опитвам се , но с дете на 5 г. не успявам много .	успявам	11	1
- Обичаш ли го ? - попита той .	Обичаш	1	2
Попитах го да не би да няма пари .	Попитах	0	1
Ще се опитам да работя .	опитам	2	1
( Изказването на Захаринов , излъчено по БНТ публикуваме със съкращения , Б.р. )	публикуваме	8	1
Слязоха майстори от Балкана , запретнаха се , дигнаха чукове , забиха длета в камъните , почнаха градежа .	запретнаха	5	3
Ние ще преустановим контактите със социалистите на общинско ниво , ако те създадат областен координиращ съвет с участието на Камовите хора , закани се местният лидер на БЕЛ Георги Костов .	създадат	12	3
И ето виждам да се приближава към нас тъмна , вълнуваща се маса хора .	приближава	5	3
И щом като засега не успяват да постигнат такива икономически показатели като Полша или Чехия , поне визовият режим с Русия да бъде същият , коментира " Известия " .	успяват	5	3
Нито мъка , нито омраза , дори и погнуса не чувствах .	чувствах	10	1
Лентата с равномерна скорост ги спускаше към силно осветено помещение в глъбините на скалата .	спускаше	5	3
Прави проверки в речника или решавай трудни задачи .	решавай	5	2
Взех че скроих друг план .	Взех	0	1
Правя те бан на Търновската област .	Правя	0	1
Как мога да се науча да се справям по-ефективно с предизвикателствата , пред които се изправям ?	изправям	15	1
Не избягвайте проблемите , които изискват непосредственото ви внимание , но си дайте почивка , когато се нуждаете от нея - не " изгаряйте " .	изгаряйте	23	2
Едната пръчка внезапно се огъна , макарата й затрака като шевна машина .	затрака	8	3
Партиите от европейското социалистическо семейството в опозиция се възпитават в дух " разчитайте на собствените сили " .	разчитайте	12	2
Той търсеше очилата си за да види надписа .	търсеше	1	3
Притъпяването се отнася до склонността ни да се разсейваме от чувствата и емоциите , асоциирани с гнева и заплахата .	разсейваме	8	1
В България не тресе , но като те тресне гладът , е същото	тресне	8	3
Понякога учех в библиотеката през първите 10 минути от времето за обяд - всичко , което пропусках , бяха дългите опашки в стола .	учех	1	1
- Как така ще ги купува ?	купува	5	3
" Даунтаун " пусна в търговската мрежа рекламни афиши , върху които посочва " Тонус " като менте .	посочва	12	3
Ако работниците не са доволни от даден профсъюз , нека да имат свободата и правото да си изберат съвет от свои хора , с които да преговаряме .	преговаряме	26	1
Помоли някой да те изпита за спрежението на чужд глагол или го напиши на празен лист .	напиши	12	2
Баташки обаче държи неоспоримата палма по брой демонстрации на груба сила , съпроводени от забележителната мисъл " Докато не ги набия , няма да мирясат , мамка им " .	набия	20	1
Пия каквото си искам .	Пия	0	1
Ела да се разберем .	Ела	0	2
Затова ние предлагаме 10 % от бюджетния излишък да се даде за образование .	предлагаме	2	1
Аз там не виждам заявки .	виждам	3	1
Като дочета романа си , ще си поговорим .	дочета	1	1
Съществуват индикации , че съседите на България са наясно относно промените в глобалната стратегия и прилагат успешно новите способи в полза на националните си интереси .	Съществуват	0	3
Приемате ли решението на Народното събрание ?	Приемате	0	2
Не виждаше никой , обзе го чувството , че отнякъде внимателно следят всяко негово действие .	обзе	4	3
Може ли отказът от упражняване на правото на глас също да се тълкува като избор на някакво зло ?	тълкува	12	3
Задвижи ли се българската машина и да очакваме ли по-голям ръст в икономиката ?	очакваме	7	1
" Избягвам ситуациите , в които трябва да се подчиня на изискванията на другите . "	подчиня	9	1
При потъването на спирачния педал е почти сигурно , че някъде по спирачната уредба има теч и губите спирачна течност .	губите	17	2
След инцидента ченгетата едвам озаптили гетото , тъй като хората се заканили да режат релсите .	режат	13	3
Тези характеристики са важни при определяне на справянето , защото ни позволяват да изучаваме различни стилове и стратегии на справяне и да оценяваме кои от тях работят най-добре в различните ситуации .	изучаваме	13	1
Преди месец беше предложено банки и застрахователи да направят гаранционен фонд , който да поема риска по тези заеми , но идеята увисна във въздуха .	направят	8	3
Доброто представяне по един може да те вдъхнови да се изявиш по други предмети .	изявиш	10	2
- Ограничаваме се най-вече в ползването на топлата вода .	Ограничаваме	1	1
Ти идеш от дълбочината на вековете , от потъмнелите страници на историята .	идеш	1	2
Защото обичаме авиацията , сродили сме се с нея и не можем без нея .	обичаме	1	1
Певицата отказа в последния момент да участва в благотворителен концерт в Нюпорт , Уелс , за да не изпусне бракуването на холивудските именитости .	изпусне	18	3
Той не можеше да се насити на тая миризма , на тоя неопределен дъх .	насити	5	3
През това време шефът на НСО ген. Владимиров и бодигард изкъртиха малка стълба от сцената , подпряха я на загражденията , преминаха по нея и отново заградиха президента .	заградиха	26	3
Той имаше само убеждението , че всичко носеше отпечатък на отдавна осъдена в душата му несправедливост .	носеше	7	3
Постъпва в класа на проф. Емил Камиларов и бързо тръгва по стъпките на своя учител още със спечелването на втора награда от " Паганини " в Генуа през 1970 г.	Постъпва	0	3
Такива хора се предпазват от емоционалното влияние на отрицателните преживявания .	предпазват	3	3
Но очарованието се засилва още повече , когато посещаваме три гробници от Долината на царете .	засилва	3	3
Може да ти помогне следното : занимавай се с книгите около час , след това се поразходи 15 минути , а след това отново учи , като определиш друг отрязък от време .	определиш	27	2
Отдъхнах си и закрачих свободно по улицата .	закрачих	3	1
Очертайте границите , в които е разположено обединението .	Очертайте	0	2
Знаехме още преди началото на мача , че няма да е лесно	Знаехме	0	1
Кръвта пълнеше дланта му , та преливаше между пръстите и течеше по земята .	пълнеше	1	3
Като идвах , валеше .	идвах	1	1
Помните ли конкретна случка кога за първи път усетихте , че сте известен ?	усетихте	8	2
Най-големите престъпници станаха милиардери .	станаха	2	3
Без да погледна пеперудата , подскочих и отлетях при врявата .	подскочих	5	1
Той щя да каже .	щя	1	3
Генералният въпрос , който витае във Висшето военноморско училище , е неговият бъдещ статут .	витае	4	3
Опитай се да го намериш .	намериш	4	2
Вероятно патриархът има причини да се притеснява .	притеснява	6	3
Бре убеждавах я , бре разправях й , че това е специално осветление , че половината лице нарочно е поставено в сянка за ефект , най-после й направих отстъпка и едва се съгласи да вземе снимката .	направих	27	1
Две денонощия пътувах с Вас из страната и ме впечатлихте с ведростта си и винаги доброто настроение .	впечатлихте	9	2
Влязох , извадих детето и го увих в яке	извадих	2	1
Образованието ти ( във и извън училище ) е за тебе - така ще можеш да управляваш живота вместо да се оставяш той да те води .	оставяш	21	2
Резултатите " съществено допринасят за легализирането на моноетническото общество , което започна да се формира след заминаването на неалбанците от Косово " .	формира	14	3
- Щях да те забележа - каза той .	забележа	4	1
Помниш ли дъжда вчера .	Помниш	0	2
Избягването означава да не полагаш усилието да се справиш , когато това е необходимо .	полагаш	4	2
Ако по някакъв начин се е стигнало до забавяне на тази новина , аз изказвам своето съжаление .	изказвам	14	1
Или си представи , че пишеш писмо на приятелка .	пишеш	5	2
Трябва да бъдеш поканен , за да го видиш .	видиш	8	2
Тлъста хапка , без да го задави .	задави	6	3
Забраних му да работи , за да си почине .	Забраних	0	1
И двамата имаха поръка да забавляват гостенина .	забавляват	5	3
Кучета в костюми дефилират из улиците на Бетълхъм , Пенсилвания .	дефилират	3	3
Отговорът е : защото не искаме повече от проектобюджета на социалната хазна да лъха само мизерия и пълно пренебрежение към хората , които днес плащат на НОИ за хипотетичните си бъдещи пенсии .	лъха	13	3
Уважаеми колеги , аз не бих желал да правя декларации във връзка с консенсуса на политическите сили , свързан с главната политическа и икономическа стратегия на България - интеграцията в европейските структури .	правя	8	1
С какви средства купихте оръжието ?	купихте	3	2
Кого къде искаш да видиш ?	видиш	4	2
Запали , снахо , пещта , да опечем агнето , дето ще го донесат .	опечем	7	1
Какво да направя , все на тежко болни попадах , свикнала съм със смъртта вече	попадах	8	1
Развивайте дарбите и богатото му въображение и търпеливо се превръщайте в неговите идоли като най-добри във всичко .	Развивайте	0	2
Обяснява , че без да го купим , не можем да си вземем изпита .	купим	6	1
Какъв е критерият за оценка на въпроса , който днес обсъждаме , на решението , което трябва да вземем и декларацията , която трябва да приемем ?	вземем	18	1
А помниш ли , когато после дойде да живееш при мен .	живееш	8	2
- Напоследък се заговори , че през февруари ще има нов конгрес на БФС ...	заговори	3	3
Мерих , гласих , отрязах им главите , направих снимката и операцията излезе горе-долу сполучлива , ама не е там работата !	отрязах	4	1
Ние заедно трябва да разработим една убедителна стратегическа политика за България за присъединяване към Съюза .	разработим	4	1
Фактът вероятно ще ви подскаже , че това свръхсензитивно същество се нуждае от опитен духовен учител , за да овладее протичащата през него непозната енергия .	нуждае	11	3
Стана ми горещо , та трябваше да сваля старото си палто .	сваля	7	1
Отделям внимание на " Гергьовден " , защото политологичният анализ изисква да се обърне внимание и на извънпарламентарните сили .	Отделям	0	1
Докато да извикам , че падам , намерих се във водата .	падам	5	1
Защото за депутатското им битие електоратът научаваше рядко и по най-странен начин .	научаваше	6	3
Получихме редица индикации , че интересът на другите телекоми към БТК е нараснал по време на преговорния процес , заяви вчера Антони Славински , но не спомена конкретно име на фирма .	спомена	26	3
Казахте , че има ранени .	Казахте	0	2
Затова човечеството не трябва да прекъсва нито за миг борбата с нея , призова Олбрайт .	прекъсва	5	3
Уморих се да тичам .	тичам	3	1
Наситихме се на тях !	Наситихме	0	1
Ако се увеличат заплатите на учителите пък , ще се решат много социални проблеми , които заплашват да прераснат в конфликт между държавата и образованието .	прераснат	18	3
Използвайте почивните дни за активизиране на двигателния режим .	Използвайте	0	2
Но той е против другите да се разпространяват .	разпространяват	7	3
Компютърна мишка " помни " пръстови отпечатъци	помни	3	3
" Искаше ми се ситуацията да изчезне или да приключи . "	Искаше	1	3
Имах проблем в избора с много силни индивидуалности за всяка от ролите .	Имах	0	1
Ако следваме тази логика , можем да предположим , че общинските каси ще се изпразнят още в началото на 2001 г.	предположим	7	1
Той хвърли гнездото в другия край на градината , животните се изсипаха от него още докато летеше във въздуха .	летеше	16	3
Напомням ви , че това не е първи прецедент .	Напомням	0	1
Александър потрепера от вълнение - нима това не показваше , че Циана все пак го обича , щом се е загрижила за него ?	потрепера	1	3
В Европа изкараха дегенератите извън стадионите и така проблемите също минаха отвъд границите на игрището .	изкараха	2	3
Вярвам , защото когато говорим за социалната цена на българския преход , децата , които най-силно са го усетили на гърба си - това сте вие , посочи Президентът .	Вярвам	0	1
Всички в стаята се размърдаха , някои излязоха на балкона да се поразтъпчат .	размърдаха	4	3
Отново се върни към написаното , провери го и го преработи .	върни	2	2
Моля ви , не ме замесвайте в игра на сметки .	замесвайте	5	2
И ти отиде да му помогнеш !	помогнеш	5	2
Ти , който четеш житието му , прощавай .	четеш	3	2
Очаква се призовки да получат в следствието и в здравното министерство .	получат	4	3
Нито съм ходил някога с бодигардове , нито пък се крия от когото и да било .	крия	10	1
Него ден - на бащините си третини - видя той доде лакомията може да заслепи хората .	заслепи	14	3
Пишман бизнесмен се похвали , че е помогнал на НСС да изгони Чорни	изгони	11	3
Хем да й погостува , хем да си сръбне от минералната вода , че я присвиваше понякога стомах .	погостува	3	3
Тази политика вече даде много добри резултати и всички прогнозирани тенденции доказват перспективността й .	доказват	11	3
Впрочем вече се нахраних , ето виж .	нахраних	3	1
Застреляха шеф на мандра пред дома му в Елена	Застреляха	0	3
Нарушавайки я със създаването на сборни отряди , ние не бихме могли да подобрим очакваните от тях резултати .	подобрим	13	1
Предполагам , че тази криза ще ме накара да се замисля как да оползотворявам водата .	оползотворявам	13	1
Тя говори силно , така че ще я чуеш .	чуеш	8	2
Губернатор Буш , ние сме готови и желаем да се разпръснем из тази велика наша земя и да агитираме за реформа от ваше име	желаем	7	1
Аз мисля , че утре ще умре , освен ако е ранен в крилото .	умре	6	3
Той и първият секретар на руското посолство в София Андрей Кедров се срещнаха с представители на 52 фирми от Пловдивско .	срещнаха	12	3
- Налагало ли ти се е да подкупваш преподавател , за да си вземеш изпит ?	подкупваш	7	2
Всички нормативни актове се публикуват .	публикуват	4	3
Стягаме се , отиваме с жената и още щом доближихме кухнята , една ужасна миризма на вмирисано месо ме удари по носа .	отиваме	3	1
Ах , летете , ескадрони !	летете	2	2
Той постига хармония между дружелюбността към добрите хора и деликатната студенина към фалшивите приятели и почитатели .	постига	1	3
Взимаш ли хапчета , които да те държат будна цяла нощ ?	Взимаш	0	2
- Въпреки че отричате ползата от провежданата икономическа политика , от изявленията на зам. финансовия министър Пламен Орешарски в края на миналата година стана ясно , че външният ни дълг не расте през последните 3 години .	расте	31	3
Мъжете и жените не се различават по употребата на активно-когнитивните методи .	различават	5	3
Крайбрежните черноморски течения концентрират вредните замърсявания по Дунав около българския бряг .	концентрират	3	3
Нося ти книги да четеш .	Нося	0	1
Постепенното въвеждане на правилата на ЕС по време на водене на преговорите премахва свободата да избираш най-малката разходна тежест при ориентацията на експорта си .	избираш	15	2
Той уж слуша , ама виждам , че акълът му е другаде .	виждам	5	1
Броя до десет и ако не дойде , аз тръгвам .	Броя	0	1
Ако се тръгне по този път , французите могат да изявят авторските си права върху нашите панталони , защото панталон е френска дума .	тръгне	2	3
Сложете си рогата й на края на китката и огънете дръжката .	Сложете	0	2
Трупат радиоактивен боклук в столичен квартал	Трупат	0	3
Не бих искал да имам славата за съпруга .	имам	4	1
Но само ако знаеше за мене какво си .	знаеше	3	2
Не се плаши , ще те отмъкна , без никой да забележи .	плаши	2	2
Иронията му подсказваше , че или е преживял някое лично разочарование от хетерите , или пък нещо се е променило с течение на времето .	подсказваше	2	3
Изправих се , преди отново да ме връхлети .	Изправих	0	1
Не предавай наполовина скалъпено съчинение , което си надраскала един час преди да влезеш в клас .	предавай	1	2
Заложете на ярките и атрактивни цветове , на дължината около коляното и на панталоните .	Заложете	0	2
Тя влезе и заговори .	заговори	3	3
Искам с удоволствие да подчертая , че България действително извървя за тези две години един огромен път , който може да бъде пример за подражание .	подчертая	4	1
Ако не видиш злото , не познаваш доброто .	видиш	2	2
Спомням си , че още тогава Панчо Владигеров оцени 14-годишния цигулар .	Спомням	0	1
Започнах тоя дневник , за да записвам преживяванията си .	записвам	6	1
От синода на Максим съобщиха , че утре ще проведат литийно шествие в София .	проведат	9	3
Не се плаши , ще те отмъкна , без никой да забележи .	отмъкна	6	1
- Няма нужда да се лъжем - не сме на европейско ниво .	лъжем	5	1
Най-после Павел престана да си идва .	престана	2	3
43-годишната актриса Мелани Грифит ще се залежи поне месец в болница в Марина дел Рей , Калифорния .	залежи	6	3
Вероятно срещате съпротива ?	срещате	1	2
За това алармира вчера началникът на Инспектората по образование в София - област Румяна Цолова .	алармира	2	3
Не е хубаво да се мъчиш .	мъчиш	5	2
Позволете ми най-напред да изкажа благодарност на българското Народно събрание за любезната покана .	Позволете	0	2
Без да погледна пеперудата , подскочих и отлетях при врявата .	отлетях	7	1
Ако се докажат запасите , то ще може да задоволява нуждите на България от газ в продължение на две години .	докажат	2	3
Вярвам , че е от загриженост .	Вярвам	0	1
Но ако успея да се освободя , с удоволствие бих отишла да посрещна Дядо Коледа .	освободя	5	1
Следователно не можеш да продадеш къщата си на двойна цена , след като няма кой да ти предложи и половината от нея .	продадеш	4	2
Хората често правят лоши компромиси , когато не са се научили как да се справят с неуспеха ( вж. четвърта глава ) .	справят	14	3
- Жената винаги иска бащата да присъства на раждането , защото това е вид подкрепа .	присъства	6	3
Апелирам тези думи да не се приемат буквално	Апелирам	0	1
Илиеску е кандидат за президент на изборите есента и подозира , че разкритията целят да провалят кампанията му .	подозира	9	3
Та като откъснах главата на пеперудата , тя трепна и замря .	откъснах	2	1
Но губим от преработката .	губим	1	1
Докато да извикам , че падам , намерих се във водата .	извикам	2	1
Вече се посяга на крайградските паркове , няма да пожалят и резерватите .	посяга	2	3
Даде ли сено на магарето Иван вчера ?	Даде	0	2
Една от основните ми цели е да ви помогна да осъзнаете личния си стил , така че адекватно да възприемате и реагирате на предизвикателните житейски събития .	реагирате	21	2
Можете да използвате главите , които включват проблемите , интересуващи ви най-много , като насоки за днешните предизвикателства в живота .	Можете	0	2
Помолих го да ме почака да поговорим .	поговорим	6	1
Международната общност трябва да гарантира сигурността на новата държава , да наблюдава зачитането на човешките права на живеещите в нея сърби и да съдейства за интегрирането й в Пакта за стабилност на Балканите , се предлага в документа .	съдейства	23	3
, разказа присъствал на конферентната връзка .	разказа	1	3
Трудовите ресурси , необходими за изпълнение на военновременния план , се формират от населението в трудоспособна възраст , което няма мобилизационно назначение във въоръжените сили .	формират	11	3
Те бяха много коректни и попитаха дали е възможно да не подписват договори с нас .	подписват	11	3
Остава ни да проследим кой ще е победителят .	проследим	3	1
Не скитай като слуга , ами ела да бъдеш господар тука .	ела	6	2
Дано повече не ми се наложи да защитавам правото си на глас , като си бръсна главата или сека телевизори с брадва .	защитавам	7	1
Е , аз не мога да задължа .	задължа	6	1
А истина е , че няма сила , която да не я предаде , с изключение на Германия и Италия , които разстрелваха испанците от упор .	разстрелваха	22	3
- Наближава ли " залезът " на Транспортните войски , господин генерал ?	Наближава	1	3
- Значи " Берое " напуска Висшата лига ?	напуска	5	3
Кирил захвърли пръчката и тръгна подире й .	захвърли	1	3
Говореше на всички като началник .	Говореше	0	3
Пред военен следовател вчера адвокатите подписали декларации , че няма да огласяват факти по делото .	огласяват	11	3
Постигнем ли това , въпрос на съвсем кратко време е нашите деца да станат и по-богати .	Постигнем	0	1
Ако работниците не са доволни от даден профсъюз , нека да имат свободата и правото да си изберат съвет от свои хора , с които да преговаряме .	изберат	17	3
- Ако успеем да намерим вярната , нашата си пътека , смятам , че нещата ще тръгнат учудващо бързо .	смятам	11	1
Когато хората са изправени пред потенциално предизвикателство или стрес , първо определят дали са в беда или опасност .	определят	11	3
Когато сте изправени пред конфронтация , може да се справяте , като запазите хладнокръвие ( фокусирано върху емоциите ) и използвате ефективни умения за преговаряне ( фокусирано върху проблема ) .	запазите	12	2
Щом заминат , пренеси се у дома .	пренеси	3	2
Той влезе във вагона до бюфета , който вагон се оказа празен .	оказа	10	3
Ако се носиш като призрак сутринта , не очаквай да научиш нещо преди училище .	очаквай	8	2
Напълно подкрепям исканията на работодателските организации , каза след срещата вицепремиерът Петър Жотев .	подкрепям	1	1
Сега обаче нямам нито желание , нито сили да говоря повече на тази тема .	говоря	9	1
Не ми е все едно дали тези , които ще управляват след следващите избори , ще вървят по същия път , каза Стоянов .	управляват	10	3
Обвиняемий , пристъпете по-близко .	пристъпете	2	2
Сега не започвайте с обидите само ...	започвайте	2	2
Продължава тенденцията на намаление на митата , като от 17,85 % през 1998 г. средната ставка вече е 12,42 % .	Продължава	0	3
Обхвана го страшно напрежение .	Обхвана	0	3
Прашасалите листове рисуват един интимен портрет на щастливото семейство , преди Уайлд да се впусне в разрушителна за него серия от хомосексуални приключения .	рисуват	2	3
Не желаем да коментираме самата продажба на телекома и лиценза за втория GSM-оператор , тъй като не сме страна по тази сделка и нямаме отношение към нея , каза говорителят на " Мобилтел " Константин Каменаров .	желаем	1	1
Не подписвай , без да прочетеш .	подписвай	1	2
Каквото и да казват хората против Кеймбридж , това безспорно е най-доброто подготвително училище за Оксфорд , което познавам .	познавам	18	1
Аз уважавам дистанцията и това е начинът да покажа , че уважавам хората .	уважавам	11	1
Тая скръб на селянката го смая .	смая	5	3
Ако се разделим с някого , това ще е Пламен Тимнев , за когото има сериозен интерес от израелски тим от Ерусалим .	разделим	2	1
Спестеното отиде , взех назаем .	взех	3	1
Няма ли да вечеряте ?	вечеряте	3	2
На хоризонта не се вижда някой , който да яхне метлата с подобна идеология и да превърне т.нар. лумпени в електорат .	яхне	9	3
- Наплачи се , скъпа .	Наплачи	1	2
- Имате ли любопитна новина за читателите ни ?	Имате	1	2
Сега мога спокойно да отида на интервю , да кандидатствам и да започна работа .	кандидатствам	9	1
Върна ли книгата на Петър ?	Върна	0	2
Учех за тестове предишната нощ , след това преглеждах материала отново , преди да вляза в клас .	преглеждах	8	1
Седни да си починеш .	Седни	0	2
Министерският съвет оценява , че при тази ситуация не възниква военна опасност за сигурността на Република България .	оценява	2	3
Не скитай като слуга , ами ела да бъдеш господар тука .	скитай	1	2
Какъв е критерият за оценка на въпроса , който днес обсъждаме , на решението , което трябва да вземем и декларацията , която трябва да приемем ?	приемем	25	1
В това отношение много изоставаме в сравнение със западните страни .	изоставаме	4	1
Започваме разискванията по тези два проекта .	Започваме	0	1
А сега бих искала накратко да се спра върху един друг въпрос , който също бе в центъра на вниманието на семинара - сътрудничеството в областта на военните индустрии .	спра	7	1
Пусни ме да видя колибата .	Пусни	0	2
Спомняте ли си каква фантастична зърнена криза преживяхме преди години ?	преживяхме	7	1
През септември американската телевизия Си Ен Ен излъчи филм за комплекса Перперикон , който няма аналог в Европа .	излъчи	7	3
Вървим през късна ноемврийска вечер .	Вървим	0	1
Какво очаквате от евентуална визита на папата ?	очаквате	1	2
Петима души издигнаха транспарант със свастика пред паметника на Христо Ботев в Борисовата градина в столицата в събота , съобщи МВР .	издигнаха	2	3
Дрешките му са закрепени посредством скаутски колан , а от колана виси нож .	виси	11	3
Хванах се за носа и си приготвих кърпичката за всеки случай .	приготвих	6	1
Докато берете памука , няма да ги освобождаваш .	берете	1	2
Пазиш ли вестника от вчера .	Пазиш	0	2
А той шепне нещо и не му се разбира дума .	шепне	2	3
След като веднъж си станал абонат на някое топлофикационно дружество , си оставаш такъв , докато ги има топлофикацията и собствеността върху жилището .	оставаш	12	2
И нека приемаме това естествено , без да се озлобяваме на заблужденията на предците ни .	озлобяваме	9	1
Вечерта , преди да тръгне , Войка го повика при воденицата .	повика	8	3
Зависи само от нас - българите , гражданите на Република България .	Зависи	0	3
Моят отговор е , че гражданското общество оспори този дневен ред по много различни начини и ни принуди да обясним и защитим политиката си пред правителството .	обясним	19	1
Спря ме един непознат човек .	Спря	0	3
Значи още в обучението търсите начините на съвместимост ?	търсите	4	2
Ставаме ний , гледаме - сняг .	Ставаме	0	1
Председателят на БОК и шеф на БФС Иван Славков присъства на жребия за 1/8 финалите от турнира за купата на България " Форд Мото-Пфое " .	присъства	9	3
Сложете си рогата й на края на китката и огънете дръжката .	огънете	9	2
Изсипете тестото в намазана с масло тавичка и го изпечете четвърт час на силна фурна .	изпечете	9	2
Чух го , че пита за тебе .	Чух	0	1
- Опитвам се , но с дете на 5 г. не успявам много .	Опитвам	1	1
От друга страна , трябва да се научат да изразяват чувствата си пред другите .	научат	7	3
Оставих Весела на тротоара и не се обърнах повече .	обърнах	7	1
Година по-късно стотици миньори загиват при експлозия в мината близо до този град .	загиват	4	3
Сега очевидно очаквате утвърждаването и влизането в сила на тези нормативни документи ?	очаквате	2	2
Тръгнахме седмина да се бием .	бием	4	1
Вие несъмнено ще сметнете , че влагам много страст по такъв малък повод .	сметнете	3	2
Ако се случи на 12 декември , ще отгледате жизнено бебе , спазва ли майката строг режим , не допуска ли то да има траен запек и възпитава ли го самостоятелно .	възпитава	27	3
Те могат да се разпечатат и от страницата на Главна данъчна дирекция в Интернет ( www.taxadmin.government.bg ) , да се попълнят и представят .	попълнят	20	3
Конете се опитваха да потеглят , но оня отпред ги държеше и се мъчеше да ги обърне .	мъчеше	13	3
Търся път , който да води към върха .	Търся	0	1
- По принцип не разхищавам много вода .	разхищавам	4	1
Ако не подпишете за 30 % увеличение , ще загубите и тях	подпишете	2	2
Дано повече не ми се наложи да защитавам правото си на глас , като си бръсна главата или сека телевизори с брадва .	бръсна	15	1
Аз ви предлагам документ на вашето внимание , който , надявам се , ще гарантира едно солидно , стратегическо мнозинство за бъдещето на България .	предлагам	2	1
Научете се как да " си вземате почивка " от проблемите , като използвате въображението си и се ангажирате в творчески дейности .	Научете	0	2
Към 100 000 души бяха дошли да посрещнат новото хилядолетие на открито на площад " Батенберг " .	посрещнат	7	3
Ако сметнете погрешно , че то просто обича да бъде само , ще го нараните за дълги години напред , затова забравете строгостта и участвайте в заниманията и игрите му .	обича	7	3
Фантастът едва не блъсна колата в тротоара .	блъсна	3	3
- Искам да ти покажа нещо . -	покажа	4	1
Докторите , които работят в малки села и не могат да наберат 800 пациенти , ще запазят практиките си и дори ще получават парични компенсации .	запазят	16	3
Никога няма да си разкъсате ризата ?	разкъсате	4	2
Ако протегнеш ръка вдясно , ще докоснеш нищото .	протегнеш	1	2
Успешните справящи се използват житейските предизвикателства като възможност за личен растеж и се опитват да се изправят лице в лице с тях с надежда , търпение и чувство за хумор .	опитват	13	3
Забравих да ти кажа утре рано да си дойдеш .	Забравих	0	1
След две седмици можем да започнем да строим новото училище .	започнем	5	1
Радвам се , че научих много в гимназията , както се радвам , че успях да постъпя в колежа , който исках .	успях	14	1
- Аз нямам злато , аз нямам нищо , с което да те подкупя ...	нямам	2	1
От страх взех да се озъртам при всеки шум .	озъртам	5	1
Аз ще докажа че съм невинен .	докажа	2	1
А когато тя си тръгна от вечеринката с някакво непознато момче , тогава пък аз разбрах , че в този лов на неопитни сърца играех заека .	тръгна	4	3
Палеонтолози откриха напълно запазен заден крак на динозавър , живял преди 130 млн. години , предадоха световните агенции .	откриха	1	3
- Можем да направим собствено издателство .	Можем	1	1
Докато не ми се случи това , самата аз не вярвах и се присмивах на ясновидците	присмивах	13	1
Пу се засилва и с радостен смях се хвърля към баща си , който веднага прихва , вдига сина си и го прегръща силно .	засилва	2	3
А кумата сипва и носи , знаете , сипва и носи и слага пред мене пълна чиния с вмирисано месо .	сипва	8	3
Предай й поздрави от мен .	Предай	0	2
В отговор на журналистически въпрос днес държавният глава заяви , че без никакви колебания застава зад договора с двете американски фирми за ТЕЦ Марица-Изток 1 и 3 .	застава	14	3
Двойно се увеличава квотата за безмитен внос на водка през 2001 г. от ЕС .	увеличава	2	3
Това застрашава живота на военните ни разведки зад граница , реагираха специалисти .	застрашава	1	3
Като засилвате личното си чувство на компетентност и ефективност , имате шанс да спечелите повече и по-положителни реакции от другите .	засилвате	1	2
Ще ги поканя на сцената	поканя	2	1
Унесена в трагедията си , Циана късно осъзна опасността и се хвърли подире му .	осъзна	7	3
Джапар отминава нататък .	отминава	1	3
Не иде ти да оставаш .	оставаш	4	2
Вие бяхте ли , когато гласувахме ?	гласувахме	5	1
Това може да ти помогне да си изработиш режим на учене и да се придържаш към него .	изработиш	7	2
Тя си пое дъх , стисна клепачи и скочи , сякаш се самоубиваше .	стисна	5	3
Сетих се за това неочаквано , както си вървях .	вървях	8	1
Изненадаха ни с агресивна защита .	Изненадаха	0	3
Лондон ми харесва много и не исках да напускам Висшата лига .	напускам	8	1
Аз съм честен човек и искам от цялата тази мръсотия , която се излива , да изляза с гордо вдигната глава .	излива	13	3
След като беше отведен в районното управление , г-н Пирнарев се върна и обслужихме останалите двама граждани .	обслужихме	13	1
Пускаме цяла една инсталация " Етилен 250 " , за да може да снабдява " Полимери " .	Пускаме	0	1
Но ако вие мислите , че ще излъжете Европейския съюз с такива стратегии , вие трябва да сте големи наивници .	мислите	3	2
Когато пристигнахме , платих сметката и закрачих след водача по една планинска пътека .	пристигнахме	1	1
Нямах време да говоря , вкарах го на 1-вия етаж и започнах реанимация със свои сили .	започнах	11	1
- Имах добри оценки благодарение на това , че си скъсвах задника от учене .	Имах	1	1
Десет отмярвай , едно отрязвай .	отмярвай	1	2
- Предполагам , че с 250 лв. бих се чувствала по-добре .	Предполагам	1	1
За сините е най-важно да укрепят организационно си състояние преди изборите .	укрепят	5	3
Я ставай , че ще се простудиш на голата земя .	простудиш	6	2
Суровото кафе ще се внася без мито от януари .	внася	4	3
След като се запознаете с наученото по тези въпроси , ще сте в състояние да разграничавате ефективните стратегии за справяне , които можете да използвате в живота си .	разграничавате	15	2
Прочетох му собствената му статия , но той не я разбра .	Прочетох	0	1
Поразяват само на близко разстояние .	Поразяват	0	3
Просто помислих , че трябва да почакам да вземат решение , преди да ги нарека крадци .	помислих	1	1
Дори и да ме отпуснеха да си ида на Балкана , вече нищо нямаше да намеря там .	намеря	15	1
А може би надценяваше себе си ? ...	надценяваше	3	3
Като ни чул , зачука , затропа и ний му отворихме .	отворихме	10	1
Бъдещите младоженци ще се преместят да живеят в Лондон .	преместят	4	3
- Заминавам в Швеция .	Заминавам	1	1
България и без това страда от невисока представителност на своите политически институции , защото интересите на гражданите са слабо застъпени в тях .	страда	4	3
В първия ден от новата година " Обединени монархисти " предлагат княгиня Калина да се нарича Добруджанска .	нарича	15	3
Полицията си позволи и повече препоръки - вземи си виза , върни се пак и направи фиктивен брак , това ти е спасението , иначе не може да получиш отново временно жителство , открехнали й те .	вземи	7	2
Като дочета романа си , ще си поговорим .	поговорим	7	1
Ако прилагате нагласата на справяне към живота си , ще засилите потенциала си за растеж .	засилите	10	2
Според турски икономисти нездравата конкуренция , създавана от икономиката в сянка , нанася на страната вреда , която не е възможно точно да се определи с цифри .	нанася	12	3
Ако се случи на 12 декември , ще отгледате жизнено бебе , спазва ли майката строг режим , не допуска ли то да има траен запек и възпитава ли го самостоятелно .	отгледате	8	2
- Има ли младежи , които се опитват да хитруват , за да не влязат в казармата ?	хитруват	9	3
Тези два текста са пренесени от ЗТСУ и е странно сега да се обявяват за еретични , след като са от действащ закон , обясняват експертите .	обясняват	24	3
След като се запознаете с наученото по тези въпроси , ще сте в състояние да разграничавате ефективните стратегии за справяне , които можете да използвате в живота си .	запознаете	3	2
По правилата на етикецията домакините им се усмихват и ги обграждат с грижи .	обграждат	10	3
Бакалов поиска данните от Чирипов , за да прецени дали комисията да разследва незаконното използване на специалните разузнавателни средства .	прецени	8	3
Бре убеждавах я , бре разправях й , че това е специално осветление , че половината лице нарочно е поставено в сянка за ефект , най-после й направих отстъпка и едва се съгласи да вземе снимката .	разправях	5	1
Типично по български окаляхме Старшията набързо , а после никой не каза " извинявай " .	извинявай	13	2
Отрязах му ухото , заприлича на чучула и толкоз !	Отрязах	0	1
И твърдя това без ирония , като пред някакво абсурдно разпятие и с чувството за неизбежна солидарност .	твърдя	1	1
" Заведението " с изглед към река Сейнт Лорънс и водопада Монтморенси ще работи до края на март или началото на април , когато снегът и ледът започнат да се топят .	започнат	27	3
Оставих Весела на тротоара и не се обърнах повече .	Оставих	0	1
- Да , разговарях с министър-председателя .	разговарях	3	1
Непрекъснато ни обясняват колко желаещи имало за нашите места .	обясняват	2	3
Асен впи очи в него .	впи	1	3
Говорих за нея и за тебе .	Говорих	0	1
Тя бе представена на Панаира на книгата във Франкфурт и веднага предизвика несъгласието на повечето читатели , предава радио Би Би Си .	предава	17	3
Разбирането на тези себеразрушителни тенденции може да ви помогне да ги избягвате .	избягвате	11	2
Аз , казва , мигар нямам други грижи , та ще седна да се занимавам с лекомислени работи , драги ми господине !	занимавам	14	1
- Господин заместник-министър , какво следва след решението на парламента висшистите да служат шест месеца ?	служат	12	3
Губернатор Буш , ние сме готови и желаем да се разпръснем из тази велика наша земя и да агитираме за реформа от ваше име	агитираме	18	1
Ако си събуя панталоните , ще ми видите синините	събуя	2	1
Синдикатът подклажда стачка за по-високи заплати сред социалните работници , които ще дават тези помощи , като по този начин блокира отпускането на парите .	подклажда	1	3
Спри да чуеш как стенат там доле твоите братя !	чуеш	2	2
След завръщането му хазайката на студента се държеше много тайнствено .	държеше	7	3
Сега обаче нямам нито желание , нито сили да говоря повече на тази тема .	нямам	2	1
Пиши и преписвай това , което учиш .	учиш	6	2
Ще се срещнеш с него , който и да е той .	срещнеш	2	2
После написва някъде встрани формулата на водата и пак зачаква .	написва	1	3
А притвори ли очи , хич се не май , а грабвай си шапката и бягай в друга махала чак .	бягай	15	2
Ще се мотивирам .	мотивирам	2	1
Както видяхте и в този случай има бивши служители на МВР , разбирайте Държавна сигурност , които си пазят бяла информация за черни дни и не се знае кога ще решат да я използват по този начин	разбирайте	12	2
С каруци , пикапи и трактори нарушителите влачат по тъмно .	влачат	7	3
Полицията си позволи и повече препоръки - вземи си виза , върни се пак и направи фиктивен брак , това ти е спасението , иначе не може да получиш отново временно жителство , открехнали й те .	върни	11	2
Не отлагай .	отлагай	1	2
В тази глава ще намериш съвети как да се справяш възможно най-добре в училище , дори ако то е затвор , зоологическа градина или тенджера под налягане .	справяш	9	2
Пак ще вдигнем митата за българските стоки , ако не намалите митата за руски автомобили , машини и съоръжения , предупреди вчера търговският представител на Москва у нас Александър Семерньов .	намалите	10	2
Тя сграбчи ръката на Краси , тъкмо когато той понечи да тръгне .	тръгне	11	3
Ако ние не се съобразяваме с тези реалности на европейската политика , ние не можем да водим европейски дебат .	съобразяваме	4	1
Блъскат се врати , изчезват вещи и после пак се появяват .	изчезват	4	3
Не знам кого да питам .	знам	1	1
Когато поставяш пред народни представители проблемите , е напълно логично да очакваш съответната законодателна реакция .	очакваш	11	2
Техните антиподи живеят , без да обръщат голямо внимание на потенциалните опасности .	обръщат	6	3
Тя тичаше към него и простираше ръце , като да го запази той разтвори ръце като да я прегърне .	разтвори	13	3
- Сега виждам - каза той , - че няма да е без полза идването ми при тебе .	виждам	2	1
Делото срещу фараона , който измами над 5000 вложители у нас , се точи вече втора година .	точи	13	3
На първенството на Стария континент се представихме много добре и от там вече имахме нагласата за същата добра реализация на олимпиадата .	представихме	6	1
- Свършвай , че имаме работа да вършим !	Свършвай	1	2
От вносителите някой желае ли да се изкаже ?	изкаже	7	3
Аз не мога се правя на ханъма	правя	4	1
Да , можеш да получиш отличен , но ти знаеш , че не си изкарала оценката си с честен труд .	знаеш	9	2
Ако се носиш като призрак сутринта , не очаквай да научиш нещо преди училище .	научиш	10	2
Ако хората бяха съвършени , нямаше да се различават помежду си .	различават	8	3
Тя извърна глава към него и явно хареса самообладанието му .	извърна	1	3
Постепенно то ще преодолее мощното космическо въздействие и ще ви радва с игривостта и жизнеността си .	преодолее	3	3
В рамките на това сътрудничество шест български делегации ще посетят парламента в Белгия за обмяна на опит .	посетят	9	3
- Имахте и практическа демонстрация с военно поделение ...	Имахте	1	2
Задигнаха картечницата на Чапаев	Задигнаха	0	3
Помолиха Уилям и Хари да си планират погребенията	планират	6	3
- Татко е бил в Стокхолм , за да изнесе проповед пред краля и кралицата .	изнесе	9	3
И там се взима за база проектният живот на атомните централи и всички държави се третират по един и същи начин .	взима	3	3
Не можете да ми кажете какво да правя .	кажете	4	2
Сега аз съм му командир и като такъв съвместно с щаба търсим най-оптималното решение .	търсим	11	1
Не можах да му дам синдиката за партийни цели .	можах	1	1
Индже възседна коня си и потегли бързо , като не поглеждаше назад .	възседна	1	3
При малката разлика в обществената подкрепа за двамата изходът от изборите вероятно е в ръцете на 7 процента от т.нар. отворени избиратели , които в последния момент ще определят за кого да гласуват .	гласуват	32	3
Георгиев ще прибере $ 21 600 от наградния фонд на турнира .	прибере	2	3
Нищо не ми пречи сега да се пробвам , може и да спечеля .	спечеля	12	1
Моля , гласувайте предложението на господин Румен Овчаров .	гласувайте	2	2
И направо на буксир изтегли общественото мнение , без да се съобразява със собствения си рейтинг .	съобразява	11	3
Заявихте , че вече приключвате с революциите .	Заявихте	0	2
- Ако имам свободно време , бих отишла .	имам	2	1
През зимата ще се постараем със селекцията и с подготовката .	постараем	4	1
Ти хляб ли носиш ?	носиш	3	2
И няма да ми кажете какво ви е вътре ?	кажете	4	2
Няма причина да го задържаме повече .	задържаме	4	1
Следващия път се опитай да ги завършиш предварително или да бъдеш реалистка , когато отлагаш .	отлагаш	14	2
Етнографската карта на света бележи намаляване на етническото разнообразие , като изчезват редица малки народи .	бележи	4	3
Блъсканица пред тунизийския ферибот " Картагена " в пристанището Ла Валета настъпи в неделя , след като малтийската полиция подгони с предупредителни изстрели около 200 тунизийци без документи да се върнат на борда му .	върнат	30	3
Посрещаме века с купон на открито	Посрещаме	0	1
Идеята ни е да свържем новите единици със старите имена на районите , каза кметът .	свържем	4	1
Лично ще координирам участието на изпълнителната власт в проектите , които заедно трябва да изпълним , обеща министър-председателят .	координирам	2	1
Членовете на Министерския съвет не могат да заемат длъжности и да извършват дейности , които са несъвместими с положението на народен представител .	заемат	7	3
Хора загинаха от фойерверки и небрежност	загинаха	1	3
Имам какво да чета .	чета	3	1
Управляващи и опозиция пак не се разбраха по въпроса как най-добре да се финансират общините .	разбраха	6	3
С Николай размишляваме дали да не плиснем в лицето на журналистката киселина .	плиснем	6	1
При положение че се помотаем още малко обаче , от този пазар в региона ще се възползва Румъния , а на всичкото отгоре може да се появи недостиг на енергия в самата България .	помотаем	4	1
Имате право да гласувате , както искате .	искате	6	2
Изсипете тестото в намазана с масло тавичка и го изпечете четвърт час на силна фурна .	Изсипете	0	2
Като загубим ли ?	загубим	1	1
Стана ми горещо , та трябваше да сваля старото си палто .	Стана	0	3
В новогодишната нощ " Акага " , " Уикеда " , Иван Лечев , Валя Балканска и " Щурците " ще пеят на живо за всички , които решат да посрещнат новото хилядолетие навън .	пеят	21	3
Това е човекът , дето тя твърдеше , че е видяла у нас .	твърдеше	6	3
Изведнъж нещо свирна във въздуха като камшик и докато се усетя , яко се омота около мене .	усетя	10	1
И ми давате окончателно думата , като пишете , че в това виждате липса на кураж и честност .	давате	2	2
Затова и се гордеем , че оцеляваме .	оцеляваме	6	1
Повече можеше да бъде направено за да се насърчат демократичните промени в Югославия .	насърчат	8	3
Преди месец и половина бургаски бизнесмен поискал безплатно да укрепи и охранява кораба , но от полицията отказали , защото фирмата му нямала разрешително за оръжие .	укрепи	9	3
В лекарския екип ще има медик , който ще окаже първа помощ , ако таткото припадне .	припадне	15	3
Тя се управлява според Конституцията и законите на страната .	управлява	2	3
Локомотив прегази 10-годишно циганче около 16,15 ч в понеделник в столичния кв. " Хаджи Димитър " , съобщиха от БДЖ .	прегази	1	3
Магистратите да не се сърдят , позират , хленчат , да не шантажират , че не са разбрани още в самото начало на преговорите с ЕС , защото ще си направят лоша услуга .	сърдят	4	3
Дебелата пъстра котка се изправя , изпъва предните си крака , мърка .	изпъва	6	3
Върху двора като преспи сняг лежи студената светлина на луната .	лежи	5	3
Помислете как ще стигнете дотам .	Помислете	0	2
Това би трябвало да се развие .	развие	5	3
Младият учен автоматично й го съобщи , сепна се от някакво подозрение , но махна с ръка .	махна	14	3
Говорим , че искаме да имаме мобилна , добре въоръжена , добре екипирана армия , но човекът продължава и ще продължава да играе основна роля в тази армия .	искаме	3	1
Ще се опитам , уважаеми колеги , за кратко време да се принизя до равнището на репликите .	опитам	2	1
Той бе говорил по телефона с шефа безброй пъти , но сега за пръв път шефът го викаше на среща с него .	викаше	17	3
Дано повече не ми се наложи да защитавам правото си на глас , като си бръсна главата или сека телевизори с брадва .	сека	18	1
Важното е да бием - така трупаме самочувствие .	трупаме	6	1
- Имам , но не искам да коментирам .	Имам	1	1
От 8 юни , не мога точно да си спомня е решението на МС за преотстъпването на фонда на БОДК на разпореждане на НС и МС .	спомня	9	1
Точно затова аз ще подкрепя проекторешението на правителството и в двете му точки .	подкрепя	4	1
Сега зад тази врата я очакваше с цялата си строгост нейният двайсет и четвърти век .	очакваше	5	3
" Отстоявах позициите си и се борих за това , което искам . "	Отстоявах	1	1
Ще извадя " Металург " от първенството във втора група , ако не бъдат коригирани наказанията и глобите , наложени на перничани след мача със " Спартак " ( Пл ) , обяви вчера президентът на клуба Първан Първанов .	извадя	1	1
Ще се преборим за наше тв време , заявиха инициаторите .	преборим	2	1
Книгата на пророк Малахия представлява приключване на старозаветните пророчества и започване на благодатната история на тяхното изпълнение .	представлява	4	3
Трябва ти да заминеш .	заминеш	3	2
Купих й плат за рокля .	Купих	0	1
Как можеш да се справиш с pas compos , ако дори не знаеш сегашното време на avoir ?	справиш	4	2
" Другите ме смятат за справедлив и честен човек . "	смятат	3	3
А писателите , за които говорите , използват , каквото и да казват , ценностите на изкуството .	говорите	5	2
В петнадесета глава обобщавам темата на тази книга чрез обсъждане на справянето като философия на живота .	обобщавам	3	1
Аз виждам всяка година как големият трап в градината се издига все повече и повече , расте и се изпълва , както се изпълва рана .	виждам	1	1
Грамотността вече има нови кодове - не азбуката и смятането , а познаването на компютрите , възможността да влезеш в Интернет и знанието на английски език .	влезеш	18	2
В Коста брава е много хубаво , но там никой не им обръща никакво внимание , никой не блокира движението - например за да минат техните кортежи .	блокира	18	3
Излезе , като затръшна вратата след себе си .	затръшна	3	3
В дискусията , предполагам , ще се засегнат важни въпроси .	предполагам	3	1
Мога да отговоря лично от мое име .	Мога	0	1
Моето не е предложение , аз питах дали вие искате .	искате	9	2
Цели се високо - стреляй за 100 и може да получиш 90 .	Цели	0	2
" Цункай ме " , казва и Пу го млясва по ухото .	Цункай	1	2
Тоя селянин я проучи внимателно и влезе в нея .	проучи	3	3
Той грабна фунията , притича до горното стъпало и изрева три пъти надолу към Лабиринта .	изрева	9	3
Вие самите го казахте това .	казахте	3	2
Омръзна ми да наливам пари на вятъра .	наливам	3	1
Какво означава да се справяш ?	справяш	4	2
При обилен снеговалеж ще затворим първо малкия център , обясни полк. Вълков .	затворим	4	1
Не сме се отказали от таксата за спряно парно , нито пък сме в конфликт с Агенцията по енергийна ефективност , казаха вчера от ведомството на Иван Шиляшки .	казаха	21	3
Нямаше да ги отнесе вкъщи , бяха скарани с жена му и тя подхвърляше думи за развод .	подхвърляше	13	3
Той кимна , а усмивката му този път ми се стори заканителна .	стори	10	3
Аз взимах частни уроци и знам , че това може да направи чудеса .	взимах	1	1
Днес отидох при министъра .	отидох	1	1
Имам две дъщери , които просто трябва да се гордеят с мен .	гордеят	9	3
Просто дължим пари - не е страшно !	дължим	1	1
Фирмите имат и това предимство , че могат да усвоят много по-бързо и много повече нови инвестиции , без да имат административни проблеми от това .	усвоят	9	3
Нещата не стават по-лесни , но и ние не бавим темпото .	бавим	9	1
Дали не звуча като безпомощна гимназиална глупачка ?	звуча	2	1
Делото срещу фараона , който измами над 5000 вложители у нас , се точи вече втора година .	измами	5	3
В друго интервю казахте , че България няма дефицит по текущата сметка на платежния баланс ?	казахте	3	2
Съжаляваме за Карадимов	Съжаляваме	0	1
Той предполага сила да видиш истината и смелост да я кажеш .	видиш	4	2
Ако тръгнеш сред мрака , ще си като слепец в стая без под , без таван , без стени , дори без ехото на стъпките , които ти указват пътя .	тръгнеш	1	2
Според документа , който разглеждахме , най-лошият възможен сценарий беше Сърбия да визира България като участник във военните операции ...	разглеждахме	4	1
- Разбрах , че има момчета , които дори не могат да се подпишат под клетвения лист ...	Разбрах	1	1
Циганите от гетото блокираха жп линията и се заканиха да отрежат и извадят релсите .	отрежат	10	3
Застанах на пусията , разкрачих се в позата на строител на Хаинбоаз и с вдигната над чуждия живот торба изпаднах в нетърпение .	Застанах	0	1
Упътих го как да стигне до там .	Упътих	0	1
- засмя се той , преодоля само страха .	преодоля	5	3
Общият баланс обаче ни позволява да поддържаме тези цени в България .	поддържаме	6	1
Като обобщава мненията на мнозина автори , Очинклос изтъква криза на политиката , особено с намаляване доверието към политиците на изборни постове :	изтъква	8	3
Все още не съм започнала да ходя по магазините .	ходя	6	1
Халит ага , утре Цена роб ти я дарявам .	дарявам	8	1
Видях го да седи .	Видях	0	1
С това се обясняват и неумелите и противоречащи си позиции на финансовото министерство и на правителството по делото .	обясняват	3	3
Нямаше смисъл да виси повече тука , сомът бе подплашил рибата във вира .	Нямаше	0	3
Не изключвам някъде да се стигне и до това .	изключвам	1	1
При тях се опипва холографската лента , която е допълнително залепена .	опипва	3	3
Министърът обяви , че щял да направи широка обществена дискусия по въпроса и щял да се допита дали да не внесе поправки в закона преди влизането му в сила на 31 март .	допита	16	3
Докато да извикам , че падам , намерих се във водата .	намерих	7	1
Културният синтез , характерен за взаимното проникване и унаследяване на културите , което се установява на Балканския полуостров , не се намира в Мала Азия .	установява	14	3
Американката опроверга слуховете , че събитието щяло да се състои преди Коледа в шотландски замък .	опроверга	1	3
Днес за нас най-важната цел на икономическата ни политика е да компенсираме фактора политически риск , който пречи на инвеститорите в България .	компенсираме	11	1
Смеем да твърдим , че това е единственият професионалист в паспортна служба .	твърдим	2	1
Изводът е , че ние ще режем здрава тъкан от нашата икономика .	режем	6	1
Една от основните ми цели е да ви помогна да осъзнаете личния си стил , така че адекватно да възприемате и реагирате на предизвикателните житейски събития .	помогна	8	1
Сетих се кого ще попиташ .	попиташ	4	2
Ако искате да опознаете потайностите на нощна София , може би трябва да излезете въоръжен с черпак или вилица .	излезете	13	2
Възстановете традиционната за България офицерска пелерина .	Възстановете	0	2
Ний се провалихме окончателно .	провалихме	2	1
Върна ли книгата на Петър ?	Върна	0	2
Правото на собственост и на наследяване се гарантира и защитава от закона .	гарантира	7	3
Инцидентът стана на 27 октомври 1997 г. , докато Христов крадеше мерцедеса на Минасян .	крадеше	10	3
Вместо това разпредели работата си на малки порции и започни .	разпредели	2	2
В гимназията често оставах след училище , киснех в класната стая или в библиотеката , за да направя нещо по домашното си .	киснех	7	1
През април т.г. на вратата на жилището й се изсипват униформени , за да я предупредят , че трябва незабавно да напусне Турция .	предупредят	15	3
През нощта неочаквано се събуждам .	събуждам	4	1
- Въпреки че отричате ползата от провежданата икономическа политика , от изявленията на зам. финансовия министър Пламен Орешарски в края на миналата година стана ясно , че външният ни дълг не расте през последните 3 години .	отричате	3	2
Просто трябва да се стегнем и да работим за страната си , а не да гледаме как да избягаме от нея .	избягаме	18	1
Той се съгласи едва когато му показах документите .	показах	6	1
Всички , които пристигнахме , бяхме настанени веднага .	пристигнахме	3	1
Получавате чудесна гривна .	Получавате	0	2
Да станеш футболист на века е като да докоснеш небето с ръце	станеш	1	2
Да плуваш ли можеш ?	плуваш	1	2
В колата екна смях и кикот .	екна	2	3
Капитанът си наложи да не посяга още сега към цигарите .	посяга	5	3
В този аспект ли гледате и на сегашното състояние на българската отбранителна промишленост ?	гледате	4	2
В текстове се размножавам .	размножавам	3	1
Време е да спрем с подобен подход .	спрем	3	1
Понякога да седнеш зад бюрото е по-трудно от самата задача .	седнеш	2	2
Опитай да се изявиш най-малко по един предмет .	Опитай	0	2
Президентът отхвърли съмненията , че някои разпоредби в новия избирателния закон го лишават от правото му да назначава ЦИК .	лишават	12	3
Всеки има право да търси , получава и разпространява информация .	получава	6	3
Седни да си починеш .	починеш	3	2
Прочетох за експедицията , че е заминала .	Прочетох	0	1
- Да , пестя .	пестя	3	1
Пиши и преписвай това , което учиш .	преписвай	2	2
Ако сметнете погрешно , че то просто обича да бъде само , ще го нараните за дълги години напред , затова забравете строгостта и участвайте в заниманията и игрите му .	забравете	21	2
Всеки български гражданин има право да се завръща в страната .	завръща	7	3
Как ще коментирате това ?	коментирате	2	2
Воден режим разболя Враца	разболя	2	3
Броих му парите и го изпратих .	Броих	0	1
Аз мога да заявя , че ние ще отстояваме тези интереси на България .	заявя	3	1
Тя чак се просълзи от този очарователно архаичен начин да изразяваш любовта си .	изразяваш	10	2
Видях него и нея .	Видях	0	1
" Не се разстройвам и не се разгневявам , когато хората са груби с мен . "	разстройвам	3	1
То трая твърде дълго , защото , когато почти се бях отказал и си погледнах в цървулите - заекът беше там .	погледнах	14	1
Слънцето изгрява в 7 ч и 28 мин и ще залезе в 16 ч и 58 мин .	залезе	10	3
Този път Циана не посмя да излъже .	излъже	6	3
Ела да се разберем .	разберем	3	1
Ти , който четеш житието му , прощавай .	прощавай	7	2
Необходимо е да бъдем изключително прецизни в преценката си за годността за военна служба , тъй като вървим към изграждането на професионална армия .	вървим	17	1
Моята работа е да играя и да вярвам , че положението ми ще се оправи скоро .	играя	4	1
Купих от пазара кола дърва .	Купих	0	1
Това може да ти помогне да си изработиш режим на учене и да се придържаш към него .	придържаш	14	2
В романа откриваме българския свят на 90-те години от изминалия вече век , с неговите митове и емблеми .	откриваме	2	1
Наизвадиха всичко , каквото носеха .	Наизвадиха	0	3
И така , след като огласи осъществената мечта на живота си - да спре 100-годишната война със социалдемократите , Георги Първанов тържествено гръмна шампанското на политическия съюз Нова левица .	гръмна	22	3
Този гражданин на планетата Земя - огледайте го добре и го запомнете , - този гражданин на планетата е решил да се самоубие .	самоубие	22	3
Застанах на пусията , разкрачих се в позата на строител на Хаинбоаз и с вдигната над чуждия живот торба изпаднах в нетърпение .	разкрачих	4	1
Не се случва за пръв път двама да делят приза , уточниха организаторите .	уточниха	11	3
Ето това е големият авторитет , който за съжаление в България не умеем да ценим .	ценим	14	1
Президентът насрочва избори за Велико Народно събрание в тримесечен срок от решението на Народното събрание .	насрочва	1	3
Валя цяла нощ , святка се , гърмя .	гърмя	7	3
Разбира се , че искаме да влезем в Европа .	влезем	6	1
Руснакът Валери Буре записа 4 точки за победата на " Калгари " над " Монреал " с 5 : 4 след продължение в последния мач от НХЛ за 2000 г.	записа	3	3
Почна се борба страшна , яростна и бясна .	Почна	0	3
Не бива да започваме да орем .	орем	5	1
- Често ли отменяте решения на наборните комисии ?	отменяте	3	2
, спомни си Петрова .	спомни	1	3
Правя разграничение между психологическите ефекти от безнадеждността и надеждата .	Правя	0	1
Всичко продължаваше да е толкова налудничаво , че се налагаше човек да поддържа чувството си за хумор .	налагаше	9	3
Когато си тръгваше , Стоянов каза " Сега трябва да намеря семейството си , изгубихме се някъде сред хората " .	изгубихме	14	1
Пък да си го видял , кога играе театро , ще си забравиш хапката в устата и няма да клепнеш , дорде не пуснат завесата .	клепнеш	19	2
Полицаи пазят рухналата под напора на публиката метална ограда ( на горната снимка ) .	пазят	1	3
Отбележете дали приемате следните твърдения :	Отбележете	0	2
В тази глава ще намериш съвети как да се справяш възможно най-добре в училище , дори ако то е затвор , зоологическа градина или тенджера под налягане .	намериш	4	2
В тях има и истина , и едно старо предубеждение , което лесно не можеш прекърши .	прекърши	15	2
И точно тези качества видяхте у жените с пагони ?	видяхте	4	2
Като усетих , че се люлеем , за секунди се облякох и зарязах болната , изхвърчах като куршум навън .	зарязах	12	1
Ако в срок от 24 часа не последва конфискация , спирането преустановява действието си .	последва	7	3
Главата му се пукаше от мисли .	пукаше	3	3
Началото на предаването съвпада с първия рожден ден на " Междинна станция " .	съвпада	3	3
Сега си поставяме за цел да форсираме българската икономика .	поставяме	2	1
Всеки човек и всеки народ тегли от ума си .	тегли	5	3
Ако не печелиш навън , не можеш да станеш шампион	станеш	8	2
Хайде да поровя в торбата със стратегии за справяне и да си направя план А и план В , а може би дори и план С .	направя	12	1
Догодина на 8 февруари ще направя 30 години в МВР .	направя	5	1
Ще се разпадне на безчислени частици и ще се въплъти в цялото битие .	разпадне	2	3
Събрал съм малко глина , но не зная какво да направя от нея .	зная	7	1
Европейската народна партия възложи на външния ни министър да укрепи връзките й с Югославия , среща с югопрезидента не е сигурна	укрепи	9	3
- Какви са стъпките , които очаквате да направи СДС ?	очаквате	6	2
Не можеш да започнеш ?	започнеш	3	2
Ето как мухата може да изхвърли човека дори от леглото му , а някои говорят , че било лесно да се убие мухата !	изхвърли	5	3
Ще разположим и търговски обекти , за да можем да изпием по чаша топло вино , каза кметът Софиянски .	изпием	10	1
" Вкусът на другите " ще представя Франция в раздела за най-добър чуждестранен филм на щатските награди " Оскар " .	представя	6	3
Един уморен банкер напусна през миналата седмица кабинета си , за да влезе в кошмарите на онези политици , които се стряскат от вероятността той да се захване с правенето на политическа кариера .	захване	27	3
" Избягвам ситуации , в които може да се наложи да изразявам отрицателни чувства . "	изразявам	11	1
Споходи ли ви радостта на 3 януари , ще отгледате жизнено и справящо се с неразположенията си бебе , ако майката кърмачка е здрава и не изпадне в следродова депресия .	отгледате	9	2
Откъде черпите тези данни ?	черпите	1	2
Ние , разбира се , не можем да се задоволим с това .	задоволим	9	1
Мога да направя обосновано и аргументирано предложение за спиране на разформироването на войските на Министерството на транспорта .	направя	2	1
Как мога да се науча да се справям по-ефективно с предизвикателствата , пред които се изправям ?	справям	7	1
Християнството , което е тотална религия , да употребя една модна дума , не може да приеме мисълта човек да дава само част на този , който , според неговия смисъл , трябва да притежава цялото .	употребя	8	1
Впрочем не сме ние , които ще трябва да решаваме този въпрос .	решаваме	9	1
Свърна към бюрото на Балкан и си купи билет за след седмица .	Свърна	0	3
Той тежи 3,150 кг. и е първата рожба на 22-годишната Силвия Павлова .	тежи	1	3
- Трябва постоянно да държите врага под око !	държите	4	2
Отново се върни към написаното , провери го и го преработи .	преработи	10	2
Исках да завися от себе си .	Исках	0	1
Ще атакуваме визовия режим с всички възможни законови средства .	атакуваме	1	1
Определи къде ти е най-удобно да учиш .	учиш	6	2
Бялото го смущаваше , но макар че го смущаваше , бе привлекателно и той гледаше все в него , докато жената мина от другата страна .	смущаваше	8	3
В четири часа аз седях вече срещу него .	седях	4	1
Не се обърна , усети я съвсем до себе си по парфюма й и преди да чуе гласа й , каза твърдо : - Работя ..	Работя	24	1
Давате ли си всички сметка ?	Давате	0	2
Разбира се , ако към дадена общност има търговско дружество , то подлежи на данъчно облагане на общо основание .	подлежи	12	3
" Радвам се " , едва промълви той и стисна за ръка булката си връстница .	Радвам	1	1
Но след като разбереш , че това не е отговорът на собствените ти проблеми , ти отново се интегрираш в него с доста по-прагматични и диференцирани очаквания .	интегрираш	18	2
Когато пристигнахме , платих сметката и закрачих след водача по една планинска пътека .	закрачих	6	1
Мама , Май и Даг се приближават бавно през двора , облян в бяла светлина и посипан с пясък .	приближават	6	3
И утре , както и днес , ще бъде ясно , че присъдата , която произнесох над Испания , визира всички тоталитарни общества .	произнесох	15	1
Но истина е , че историческото положение днес го изостря още повече .	изостря	9	3
Единствено млеко- и месопреработвателите могат да разчитат на субсидиите , защото те залагат техника и цехове , смятат експерти .	залагат	12	3
РМД ще купуват фирми с компенсаторки още година	купуват	2	3
И отново се видя да препуска лудо и весело из отминалите векове .	препуска	5	3
Да погледнем само набор 1982 г. - първата смяна .	погледнем	1	1
Новият срок на службата е факт и ние ще работим според решението на Народното събрание , посочи след гласуването министърът на отбраната Бойко Ноев .	работим	9	1
Не си помисляй и за секунда , че си ужасна ученичка .	помисляй	2	2
Ела ме , майко , прегърни , и в красно чело целуни .	прегърни	5	2
Той търсеше очилата си да види надписа .	търсеше	1	3
Резултатите сочат , че 92 % от първата група са хора , които редовно пият кафе , а във втората група любителите на топлата напитка са 83 процента .	сочат	1	3
Пусни ме !	Пусни	0	2
Сушата може да обезлюди България , алармират учени	обезлюди	3	3
За нас затварянето на нашата ядрена енергетика срещу компенсации е все едно да си отрежем краката , за да ходим с патерици .	отрежем	14	1
Потърпете до изборите в Сърбия	Потърпете	0	2
Досегашните изследвания сочат , че махмурлукът е като грипа и се причинява от вторичен продукт на ферментацията .	сочат	2	3
За изненада и на двамата обаче никой не помръдна .	помръдна	8	3
Условията на търга бяха цените в офертите да са свободни и , ако надвишат 30 млн. евро , остатъкът да се плати от собствени средства на РВД .	надвишат	13	3
Падането на митата ще стимулира фирмите да пекат кафе у нас , което ще създаде допълнителна заетост , смятат от ГУ " Митници " .	стимулира	4	3
Вярно ли е , че от бюджета на Министерството на отбраната ще се отделят пари за закупуване на хеликоптер за правителството ?	отделят	13	3
Държавните и правителствените ръководители все пак се споразумяха по въпроса за институционните реформи , за да може бъдещият разширен съюз да продължи да съществува в по-комфортна институционална рамка .	споразумяха	7	3
Споделяте ли техните изводи и как си обяснявате тези резултати ?	обяснявате	7	2
Още Аристотел справедливо беше забелязал , че докато историята повествува за станалото , поезията дава израз на възможното .	повествува	9	3
Нужни са ми поне около 500 лв. , за да задоволявам основните си нужди .	задоволявам	10	1
В момента обсъждаме и средствата , които ще отидат за модернизация на V и VI блок в АЕЦ " Козлодуй " , съобщи още Хиновски .	обсъждаме	2	1
Досега нощем мръзнехме в ледената пещера , ала през деня слънцето ни съживяваше .	мръзнехме	2	1
- Имам , но не искам да коментирам .	коментирам	7	1
А кумата сипва и носи , знаете , сипва и носи и слага пред мене пълна чиния с вмирисано месо .	знаете	6	2
Имате право да гласувате , както искате .	гласувате	3	2
Те възнамеряват да изпратят парите по пощата , като ги адресират лично до Джордж Буш .	изпратят	3	3
Същевременно огромните икономически проблеми , породени от високата цена на обединението , ескалираха във финансови проблеми за цялата европейска монетарна система още преди осем години .	ескалираха	12	3
Много ви благодаря за вашата покана да говоря пред Народното събрание .	благодаря	2	1
Ние сме човеци , ние сме българи , ние изпълнихме нашата света длъжност към отечеството .	изпълнихме	9	1
Малцина предпочетоха безалкохолни напитки .	предпочетоха	1	3
Резултатите показват , че след четвъртото място на Кейт Мос се класират Рупърт Евърет , Мадона , Камерън Диаз , Лиза Тарбък , Калиста Флокхарт и Гуинет Палтроу .	показват	1	3
Госпожа хаджи Ровоама .. се славеше като най-веща узнавачка на всички градски тайни и като изкусна сплетница .	славеше	5	3
Оперираха албанче с двоен бъбрек в " Пирогов "	Оперираха	0	3
Тя тичаше към него и простираше ръце , като да го запази той разтвори ръце като да я прегърне .	запази	11	3
Стягаме се , отиваме с жената и още щом доближихме кухнята , една ужасна миризма на вмирисано месо ме удари по носа .	доближихме	9	1
За първи път хората от моята възраст срещаха неправдата да възтържествува в историята .	срещаха	7	3
Прави проверки в речника или решавай трудни задачи .	Прави	0	2
Ученикът преглъща суха плюнка , гледа безпомощно и без да иска , дроби на късове бърсалката .	преглъща	1	3
В тази посока ще срещнете твърдата подкрепа на всички военни институции !	срещнете	4	2
Заради парашутисти депутати избирателите ни изоставят , смята той .	изоставят	5	3
Измъкнахме се и поехме за село .	поехме	3	1
А помниш ли , когато после дойде да живееш при мен .	помниш	1	2
В проекта за разсекретяване на всички досиета на бившата ДС и РУМНО има текстове , които заплашват националната сигурност , заяви секретарят по сигурността към МС Иво Цанев .	заплашват	16	3
Искам да ида да си почина .	ида	2	1
Съставителите на книгата - Анет Ли-Кай и Джон Барг разглеждат понятието " власт " , като използват четири основни подхода , обобщени в отделни части на сборника .	разглеждат	9	3
Аз се наемам да ги смажа бързо , ако ме подкрепите .	подкрепите	10	2
След срещата си с него се убедих , че моята дейност на този пост повече не е нужна на България .	убедих	6	1
И след като ги реши , да се справя с още милиони други , с още милиони други ...	справя	8	3
Имам какво да чета .	Имам	0	1
Радвам се на новината .	Радвам	0	1
Същевременно това не означава , че не можете да се промените .	промените	10	2
Питайте съответния генерал .	Питайте	0	2
Губернатор Буш , ние сме готови и желаем да се разпръснем из тази велика наша земя и да агитираме за реформа от ваше име	разпръснем	10	1
Възобновиха делото срещу Гаич	Възобновиха	0	3
" Прекарвам по-голямата част от времето си с други хора . "	Прекарвам	1	1
Лондон ми харесва много и не исках да напускам Висшата лига .	исках	6	1
Не е имало насилие и побой , а г-н Богданов непрекъснато крещеше " Убиха ме " .	Убиха	13	3
Искаме да поддържаме добри отношения със съседите , но президентът при цялото му желание не може да отиде на срещата заради посещението си в Германия	поддържаме	2	1
И винаги съм гледал било на власт , било в опозиция , да помогна , доколкото мога , с моето скромно мнение и съвет .	помогна	13	1
Специалистите , с които се консултира , преди да се захване с този бизнес , излязоха прави .	захване	10	3
Всички празници стоплят женското сърце и ние искаме да направим за жените с униформа един прекрасен гергьовденски бал .	направим	9	1
Питайте и ще получите отговор !	Питайте	0	2
Иван Белин не се съмнява в откритието си .	съмнява	4	3
Освен това най-добрият билет за излизане от скучно училище е да се справяш добре там .	справяш	12	2
Идрис каза , че подкрепя българския държавен глава в усилията му и високо оценява членството на Петър Стоянов в Консултативния съвет на СОИС .	подкрепя	4	3
- Тази година празнуваш последния си 8 декември .	празнуваш	3	2
Това стана на извънредно четиричасово заседание на НИС на СДС , което започна в 10 ч на " Раковски " 134 вчера .	започна	12	3
Той се опита да я прегърне , да спре змийските сгъвания на тялото й , но тя му се изплъзна и продължи да се облича .	опита	2	3
Да се организира Европа на повече скорости е неизбежна задача , която обаче заплашва да разбие институциите на Съюза , а еврото страда и от тази несигурност , заключава " Кориере дела сера " .	организира	2	3
Просто помислих , че трябва да почакам да вземат решение , преди да ги нарека крадци .	почакам	6	1
Просто годините и опитът не ми дават право да бъркам .	бъркам	9	1
Санкциите за нарушителите са смешни и не стряскат никого .	стряскат	7	3
Те създават работните места , могат да наемат солидни адвокати , които да бранят интересите им , ако се наложи дори да си платят за нечие мълчание .	създават	1	3
Аз се наемам да ги смажа бързо , ако ме подкрепите .	смажа	5	1
Спортно-техническата комисия в БФС отказа да картотекира вчера привлечените през лятната пауза футболисти заради президента на " Нефтохимик " Христо Порточанов .	картотекира	6	3
Вие се занимавате с България отскоро .	занимавате	2	2
Превърнете се в неговите приятели и не скривайте радостта си , че е с вас .	скривайте	7	2
Макар че използват различни термини в инструментите за измерване на справянето , всички те достигат до следните заключения :	достигат	14	3
Поставяйте си реалистични цели , така че да можете да постигате успехи без хроничен страх от неуспех .	Поставяйте	0	2
Докато се взирах до болка в посоките , които сочеше ръката му , далечен кучешки лай прекъсна обясненията на водача .	взирах	2	1
Трудно е да я накараш да признае .	признае	6	3
Не може отвън да се налагат еднакви заплати по логиката , че ставало дума за един отрасъл .	налагат	5	3
Мисля , че играхме на ниво въпреки умората от претоварения цикъл и пътуването	играхме	3	1
Държавата създава условия за осъществяване на правото на труд на лицата с физически и психически увреждания .	създава	1	3
Харесвам такива инициативи .	Харесвам	0	1
Слушай внимателно , когато учителят обяснява какво ще включва тестът и така ще знаеш точно какво да учиш .	Слушай	0	2
Преди да започне изпитът , прегледай теста добре .	прегледай	5	2
Но в своя роман аз трябваше да отдам право на тези от моите приятели християни , които бях срещал по време на окупацията в една борба , която беше справедлива .	отдам	7	1
Не съм тукашен , та не ви познавам .	познавам	7	1
Господин Пирински , винаги си просрочвате времето и колкото пъти Ви се прави бележка , продължавате да си говорите .	говорите	18	2
Начинът да се настроиш за ритъма на работата е да започнеш да работиш .	започнеш	10	2
Рано или късно , докато пишеш програма по информатика , правиш опит с плодова мушица по биология , пееш в хора или слагаш гърне в пещта , ще се почувстваш пълна с енергия и ентусиазъм .	почувстваш	29	2
Нямах време да говоря , вкарах го на 1-вия етаж и започнах реанимация със свои сили .	Нямах	0	1
Не сме големи приятели , но го уважавам	уважавам	7	1
Моето не е предложение , аз питах дали вие искате .	питах	6	1
Сега как реализирате дейността си в тази област ?	реализирате	2	2
Възрастните хора над 70 г. ще могат да сменят паспортите си , когато пожелаят .	сменят	8	3
Дори и да ме отпуснеха да си ида на Балкана , вече нищо нямаше да намеря там .	ида	7	1
Хванаха напитки " Савой клуб " с фалшиви бандероли във всички нощни заведения в Благоевград при изненадваща среднощна проверка на баровете , ресторантите и дискотеките в града , съобщиха от Икономическа полиция .	Хванаха	0	3
Това сътрудничество е от полза за България и ние очакваме и сме убедени , че то ще продължи .	очакваме	9	1
Бих ли могъл да измамя човек с $ 6 млн. и да съм още жив	измамя	4	1
Вместо да се насочим към източника на проблемите , ги игнорираме и се надяваме , че те някак си ще изчезнат .	насочим	3	1
Аз се наемам да ги смажа бързо , ако ме подкрепите .	наемам	2	1
Идвам по важна работа .	Идвам	0	1
Кого мислиш , че тя обича ?	обича	5	3
Не предавай наполовина скалъпено съчинение , което си надраскала един час преди да влезеш в клас .	влезеш	13	2
Научете се как да " си вземате почивка " от проблемите , като използвате въображението си и се ангажирате в творчески дейности .	вземате	6	2
Премести го синът , ама и ний не стоим със скръстени ръце .	стоим	8	1
Случи ли се на 8 декември , ще отгледате жизнено бебе и само в случаите , когато майката е с крехко здраве или изживява следродилна депресия , то ще ви създава проблеми .	отгледате	8	2
Той каза да заминеш .	заминеш	3	2
Преписването е много по-лесно , ако имаш достъп до компютър и тъй като ще ти се наложи да го правиш в колежа или в работата ти , най-добре е да започнеш отсега .	започнеш	30	2
Но като потърпевш аз си търся правата .	търся	5	1
Радвам се , че научих много в гимназията , както се радвам , че успях да постъпя в колежа , който исках .	постъпя	16	1
" Добре сме " пишат медиците в Либия	пишат	4	3
Асен Агов е изразил лично мнение с революционното си изказване да излезем от Пакта за стабилност , ако не ни извадят от визовия списък .	излезем	11	1
От него взех правилната методика на тренировка .	взех	2	1
Или ми помогни , или поне не ме гледай .	гледай	8	2
СДС подстрекава екстремизма у нас , като реабилитира пронацисткия режим в страната до 1944 г. и дава широка трибуна на бивши легионери , реагираха от " Позитано " 20 .	подстрекава	1	3
Иди да му помогнеш !	помогнеш	3	2
Оказа се обаче , че за да се поправи едно лятно недоразумение очевидно трябва сняг да завали .	поправи	8	3
Това идваше при нас от руската армия .	идваше	1	3
Толкова исках да ти хареса , ама сега ме ... плашиш !	плашиш	10	2
И аз не ще извиня тази отвратителна чума в Западна Европа , защото тя извършва своите опустошения на Изток върху много по-големи пространства .	извършва	14	3
За себе си искам да завърша успешно средното си образование .	завърша	5	1
Тя сметна , че може да си служи със своите писатели .	служи	7	3
Лесно ли е да регистрираш фирма в Полша ?	регистрираш	4	2
Какво умееш ти ?	умееш	1	2
На мястото на Тейлър ще пее Мика Парис .	пее	5	3
Сегашната програмна директорка на БНР Поля Станчева отговаря на условията .	отговаря	7	3
Давай си почивки и превключвай на различни предмети , ако ти се доспи .	Давай	0	2
Затварят центъра на София при преспи	Затварят	0	3
По този начин ние получихме реално и трайно одобрение за необходимите реформи .	получихме	4	1
- Наблюдавате делото " Акрам " .	Наблюдавате	1	2
Как мислиш , ако беше останал в България , щеше ли да продължиш с пантомимата - какво би станало с теб ?	мислиш	1	2
Искам да добавя , че имаме много добри взаимоотношения с Техническия университет в София .	добавя	2	1
Ако темповете се запазят , през 2019 г. ще има 3 млрд. копия на певеца или близо една трета от жителите на Земята , твърди в. " Дейли стар " .	запазят	3	3
В изпълнение на своите правомощия президентът издава укази , отправя обръщения и послания .	издава	6	3
Не остава друго , освен да чакаме .	чакаме	6	1
Начинът да се настроиш за ритъма на работата е да започнеш да работиш .	настроиш	3	2
Той може да се разбере чрез обмисляне на начините , по които децата се научават да се справят с емоциите си .	справят	17	3
Обяснявам , нищо не коментирам .	Обяснявам	0	1
По отношение на хуманитарните рискове ще говоря във връзка с политическите рискове .	говоря	6	1
За България се отбелязва , че шефовете на държавните радио и телевизия и на БТА се назначават от съвет от представители на партиите и на президентството .	отбелязва	3	3
Ще те питам за нещо .	питам	2	1
Днес започват преговорите с Евросъюза по главата за телекомуникациите	започват	1	3
Отиде право при него , че се на юнак похвали .	похвали	9	3
Ще намеря книгата , която да й хареса .	намеря	1	1
Предпочитай библиотеката .	Предпочитай	0	2
Споделяте ли техните изводи и как си обяснявате тези резултати ?	Споделяте	0	2
Подпалиха колата на изобретател	Подпалиха	0	3
Обикновено човек се ангажира във фокусирано върху проблема справяне , когато чувства , че има нещо , което може да направи по проблема или по дадено предизвикателство .	ангажира	3	3
И в двете партии българите имаха леко предимство .	имаха	5	3
Ако се носиш като призрак сутринта , не очаквай да научиш нещо преди училище .	носиш	2	2
Как , сега против ли ще гласуват ?	гласуват	6	3
Трябва да дадем простор на националния капитал .	дадем	2	1
Ако желаете , слушайте ме , ако желаете , вземете ги предвид .	вземете	9	2
- Обвинихте шефовете и играчите на " Ловеч " в уреждане на мача в събота .	Обвинихте	1	2
- Обичаш ли я ? - попита тя .	Обичаш	1	2
Обяснява , че без да го купим , не можем да си вземем изпита .	вземем	12	1
Насърчавам ви да развиете нагласа на овладяване и Аз-ефективност .	развиете	3	2
В извън активния сезон цената за българи за 7-дневен полупансион е 615 долара при настаняване в двойна стая , поясни Маргита Тодорова .	поясни	19	3
Избягването означава да не полагаш усилието да се справиш , когато това е необходимо .	справиш	8	2
Без да искам да поставям специален акцент върху тях , защото вече имах възможност да ги изложа публично , все пак искам да подчертая някои от тях .	изложа	16	1
Можеш ли да плуваш ?	плуваш	3	2
Забравих , че искам това .	Забравих	0	1
Стигаме до парадокса вместо да съчувстват на Македония , български медии да жалят за щетите , понесени от югославската военна машина .	Стигаме	0	1
Дадеш ли му пари на заем , върви го търси после .	Дадеш	0	2
Ако протегнеш ръка вляво , ще докоснеш пустотата .	протегнеш	1	2
Сигурно здраво се опирате на уменията и опита на командирския състав , който служи в училището ?	служи	13	3
Даваме им хляб в ръцете .	Даваме	0	1
Вече говорихме за ненавременните плащания за доставени продукти .	говорихме	1	1
- Когато чух изказването на шефа на парламентарната комисия по външна политика Асен Агов , очаквах това да е само негова лична позиция .	чух	2	1
Разсипан си , затуй го казваш .	казваш	5	2
Сега в пловдивското кметство обсъждат как да се отпуснат исканите терени и къде да са те .	отпуснат	8	3
Така че ще се стараем да държим максимално приемливи цени .	стараем	4	1
Споделихте , че вече има такива девойки , които са решили да потърсят професионална реализация в армията .	Споделихте	0	2
И прокуратурата , и съдът да контролират използването на подслушвателните устройства настоя Висшият съдебен съвет вчера .	настоя	11	3
Търся книга , която да й хареса .	Търся	0	1
Развивайте дарбите и богатото му въображение и търпеливо се превръщайте в неговите идоли като най-добри във всичко .	превръщайте	9	2
" Отстоявах позициите си и се борих за това , което искам . "	борих	6	1
Няма начин , когато се командва , а не се управлява , хората да застанат зад нас .	командва	5	3
Така че в рамките на шегата , аз имам на главата си 18 " началници " в Конгреса .	имам	8	1
Ако искаш да вземеш , научи се да даваш .	даваш	8	2
- На среща със зам.-министъра на образованието проф. Борислав Тошев вие предложихте отново да се въведе платеният прием в държавните университети .	предложихте	11	2
В казармата старшина се обръща към готвача :	обръща	4	3
А за всеки случай утре ще се облека страхотно .	облека	7	1
Този гражданин на планетата Земя - огледайте го добре и го запомнете , - този гражданин на планетата е решил да се самоубие .	огледайте	6	2
Нищо не коментирам , а правя предложение .	правя	5	1
Съмнявам се , че България , Румъния , Словакия и Малта принадлежат културно към Стария континент	Съмнявам	0	1
- Г-н Танев , наистина ли разпускате отбора ?	разпускате	6	2
Седем души загинаха от проливните дъждове и ураганните ветрове във Великобритания , Франция , Холандия , Швеция и Дания , предадоха агенциите .	предадоха	20	3
В четвъртък ще се срещнат шефовете на " Металург " и чиновниците от " Кърниградска " .	срещнат	4	3
Трябва да измисля някакъв добър план .	измисля	2	1
Нека всички заедно намерим верния път на страната ни през минното поле , което представляват Балканите днес .	намерим	3	1
Знам кого да повикам .	повикам	3	1
Когато се връщах , есето ми беше започнато и беше по-лесно да се върна отново към нагласата за работа .	връщах	2	1
Добре е , че научих за тази идея .	научих	4	1
Карайте , както сте я намислили .	Карайте	0	2
Нали от години проповядвам капитализъм за България .	проповядвам	3	1
Аз обичах да разговарям с него .	разговарям	3	1
Който и да наследи Белия дом , ще ни се стори сив и скучен след него	наследи	3	3
- Не повтаряй като латерна -	повтаряй	2	2
Ако потопим в разтвор от киселина син лакмус , той става червен .	потопим	1	1
В някои градове дори има горещи линии за домашни работи , на които ще ти помогнат да се справиш с трудните въпроси .	справиш	18	2
, изпъшква той и се сгромолясва в креслото .	сгромолясва	5	3
Някои мъкнат трупи за собствените си банцинги скрити зад високите дувари на къщите им .	мъкнат	1	3
