- Bai , baina ... Ikasturtea hain arin pasatu da ... .	pasatu	8	Perf
Ekaitza zetorren .	zetorren	1	Prog
EHNEk Hego Euskal Herrian eta COAGek Espainian ( Nekazari eta Ganaduzaleen Koordinadora ) mobilizazioekin jarraituko duten ala ez gaur erabakiko dute nekazaritza gasolioaren beherapena eskatzeko .	erabakiko	19	Prosp
Behin batean Pasai Antxoko plazan jotzen geundelarik , ikus-entzuleen artean , aulkien lehenengo lerroan bazegoen mutil bat bere zakurrarekin .	bazegoen	14	Prog
Eztena landarean sartu eta izerdia zurrupatzen dute , hura ahuldu eta zimurtuz .	zurrupatzen	5	Imp
Haatik , 113 lagunen heriotza eragin zuen ezbeharraren nondik norakoaz argibide nahikoa dakartza dagoeneko .	dakartza	12	Prog
Nire anpuluak ibai bat sortu zuen eta ibai hori heriotzaren itsasoan , itsasoratu zen .	itsasoratu	12	Perf
Multikulturalismoaz eta zuzentasun politikoaz hemen garatutako ideia batzuk berari zor dizkiot .	dizkiot	10	Prog
Djukanovicen gobernua saiatu zen Jugoslaviako Federazioa berrantolatzen , baina negoziazioek ez zuten fruiturik eman eta autodeterminazio erreferenduma egiteko aukerari eusten dio .	eusten	19	Imp
Baina Paben nintzela ohartu nintzenean Zepai bertsolariaren hura gogoratu zitzaidan .	nintzela	2	Prog
Arrailaduren itzalak marraztu du abian den Espainiako zentral zaharrenaren historia eta hau ixteko aldarrikapenak kalea hartuko du datorren larunbatean .	marraztu	2	Perf
John emaztegaiarekin zegoen eta bikoteari ezinegona igertzen zitzaion .	igertzen	6	Imp
Argazkigintzan aritzen da .	aritzen	1	Imp
Orduan ezkontzeko problemak baditugu ?	baditugu	3	Prog
Bere ustetan , XXI. mendean iraungo duten hizkuntza horiek " beharrezko direlako iraungo dute , hiztunek hala nahi dutelako eta presiorik ez dutelako " .	dutelako	22	Prog
Gorpua besarkatu eta muxukatu nuen , berriro bizitza eta zoriontasuna itzul zedin .	muxukatu	3	Perf
JUGOSLAVIAKO Gobernuak ez dio ofizialki Nazio Batuen administrazioari ( UNMIK ) eskatu hauteskundeak egin ahal izateko baimena , baina Slobodan Milosevic presidentearen SPS Serbiako Alderdi Sozialistak iragarri du Kosovon 500 hautes-leku jarriko dituela .	jarriko	31	Prosp
Gizarteak indarkeriaren inguruko diagnosi bateratua egitea eskatzen duela iritzi dio Sudupek , eta ildo horretan Juan Jose Ibarretxek foroa sortzeko eginiko ahalegina txalotu zuen .	txalotu	22	Perf
Ziur nago aitzin-multzo gotor eta sarkorrarekin asmatzen badu txanza ukanen duela , eta Tolosako makina nahastea lortuko duela .	asmatzen	6	Imp
Udalbiltzak duen egitekoaren garrantzian sinisten duela dio EAk , baina fruituak eman eta parte-hartzea handitu dezan giza eskubideen defentsa beharrezkoa dela gaineratzen du .	sinisten	4	Imp
Buliganek hiru aste daramatza haragirik jan gabe .	daramatza	3	Prog
" Bi herrialdeen artean estradizio itun bat badago , pentsatzekoa da estradizioa onartzera doan herrialdeak bere erabakia justifikatuko duela , nazioartean agerian uzten ari delako bere erantzukizuna eta sinesgarritasuna " .	justifikatuko	17	Prosp
ZER ESKAINTZEN DIGU INFORMATIKAK HIZKUNTZEN IKASKUNTZA ARLOAN ?	ESKAINTZEN	1	Imp
Korritu diren sei etapetatik lau , 24 urteko txirrindulariek irabazi dituzte :	Korritu	0	Perf
Bestetik , Down konterrian RUCeko polizia bat larri zauritu zen lankide batekin Poliziaren komisaldegi baten ondotik oinez zebiltzala bonba bat lehertu ostean .	zauritu	8	Perf
" Gai horiek tratatuko lituzkeen egitura judiziala eta emakumeentzako komisariak sortu beharko lirateke .	tratatuko	3	Prosp
Inoiz pentsatu zenuen zure ekintza politikoengatik atxilotuko zintuztela ?	atxilotuko	6	Prosp
" Eta udako erromeriak iristerako ikusi genuen jendeak ikasiak zituela kantuak " .	zituela	9	Prog
Igandean atseden hartu zuen , eta astelehenean " oso burugogor " joan zen , baina giro sargoriak ez zion laga bidea bukatzen .	laga	19	Perf
Erraz konformatzen ziren garai hartako umeak .	konformatzen	1	Imp
24 segundoko aldearekin iritsi zen helmugara .	iritsi	3	Perf
BRASILEKO ezkerreko oposizioaren gora egite nabarmen batek markatu zituen , herri honetan joan den igandean egindako udal-hauteskundeen lehen txandako emaitzak .	markatu	7	Perf
Kontzertu Ekonomikoa eta datorren urteko aurrekontuak negoziatzera gonbidatu zituen oposizioko alderdiak , batez ere PSE-EEri luzatu zion eskua .	gonbidatu	7	Perf
Kafetegitik ateratzean , beste zereginik ezean , paseatzen jarraitu dut barrenean oraindik ere egonezina dabilkidalarik .	dabilkidalarik	14	Prog
Nirvana budistarik ez du inork eraiki munduan , ezta utopia komunistarik .	eraiki	5	Perf
ITALIAK , diotenez , " Jainkoaren laguntza du " Eurokopa honetan .	diotenez	2	Prog
Hainbat jokaldi genituen oraindik zehazteke , eta gainera , huts ttipi batzuk ere konpondu behar genituen .	zehazteke	4	Imp
Zabortegiari zegokionez , aurreko egunetan izandako istiluengatik edo , bazirudien agintariak ez zirela aurrerapausorik ematera ausartzen .	bazirudien	9	Prog
EBren Oinarrizko Eskubideen Agiriak soil-soilik jatorria Bruselan duten legeei eragingo die , ezin ditu araudi nazionalak gainditu .	gainditu	16	Perf
Santiago Apelazio Gorteak apirilaren 5ean ondorioztatu zuenez , Pinochetek ez du immunitaterik eta diktadura garaian egindako delituengatik epai daiteke .	ondorioztatu	5	Perf
Honako esaldi hauen tankerakoak sarritan entzungo zenituen , noski :	entzungo	5	Prosp
Prest geunden , bada , entzuteko , dena ongi suertatuko zen itxaropenaz .	geunden	1	Prog
Arlo ekonomikoaren inguruan baikor agertu zen Sudupe eta Gipuzkoa 2003 plana aipatu zuen garapenerako ardatz gisa .	aipatu	11	Perf
PSE-EEk , gainera , legez besteko proposamen bat aurkeztu du Legebiltzarreko erroldan Jaurlaritzari proiektua eskatuz .	aurkeztu	8	Perf
Juanelek bikain zuzendu zuen kontraerasoa , eta baloia Montenegrori eman ondoren Jamellik bikain errematatu zuen argentinarrak egindako erdiraketa .	zuzendu	2	Perf
Eskola-Graduatuko tituluak hurrengo ikasketa hauek jarraitzeko eskubidea ematen du :	ematen	7	Imp
Prest geunden , bada , entzuteko , dena ongi suertatuko zen itxaropenaz .	suertatuko	9	Prosp
Antzerkia , ontsa futitzen naun antzerki eta gainerateko literaturetaz , nahi niken egiazki arizan .	futitzen	3	Imp
- Orduan , horrela ez bada , zergatik geratu zara bide erdian hona zentozela ?	zentozela	13	Prog
Houda-ren izena ahoskatzen da .	ahoskatzen	2	Imp
HAATIK , kondenatzen badute ere , Suhartok ez du espetxea ezagutuko , gaur egungo presidente Abdurrahman Wahidek aurretik iragarri baitu indultua emango diola .	kondenatzen	2	Imp
Briu-brau , zutitzen naiz , murgiltzen eta Kakotxengana noa ahal bezala .	zutitzen	2	Imp
" Badakigu gure aurkariek ahalegin itzela egin dutela euren taldeak indartzeko .	Badakigu	1	Prog
Osasunako 23 jokalariak dira Oronozen , eta bi entrenamendu bakarrik eginen dituzte .	eginen	10	Prosp
Alderdi Errepublikanoak kontrolatzen duen Floridako Legebiltzarraren batzorde berezi batek datorren astean ezohiko bilera egiteko gomendioa eman du .	kontrolatzen	2	Imp
- Nik ezagutzen nuena ez zegoan hi bezain segail eta ez zeramatzaan horrelako antiparrak , gainera .	ezagutzen	2	Imp
Rider jokalari ikusgarria da , eta dohain berezi horiek erakusten baditu , Phil Jackson entrenatzaile soil bat baino askoz gehiago dela frogatuko da berriro .	frogatuko	21	Prosp
Azkenik , Rojoren aburuz , " Euskadin errejimen aldaketa behar da , gobernurik ere ez dagoelako " .	dagoelako	15	Prog
Arrisku islamikoaren kontua ekintza armatu palestinarren eskutik hasi zen , eta Libia eta Iranen ostrazismo politikoarekin segitu zuen .	segitu	16	Perf
Paul-Louis Arslanian BEAko zuzendariak prentsaurreko batean atzo emandako argibideen arabera , Aeroport de Paris mantenimendu enpresako langileek pista miatu zuten goizaldeko 04:30ean eta eguerdiko 12:00etan .	miatu	18	Perf
JL-1 deritze urpeko horiei .	deritze	1	Prog
ERRUBLOA izango da 2005. urtean Errusia eta Bielorrusiako diru batua , Vladimir Putin eta Alekxander Lukaxenko bi herriotako presidenteek Minsken atzo izenpetutako akordioa gauzatzen bada behintzat .	gauzatzen	23	Imp
Harri horri aspalditik ari zarete kiloak eransten .	zarete	4	Prog
Horretaz gain zarata itsusiak eta mugimendu arraroak egiten badituzte inpresio galanta eman diezaiokete berauek jatera datorrenari .	datorrenari	15	Prog
Egun hauetan Atlantako zilarraz galdetu diogun bakoitzean hura errepikatzea ia ezinezkoa dela erantzun du Abraham Olanok .	erantzun	12	Perf
Ez zuten atzeko koadroetatik inoiz barkatu , eta bakoitzak bere aukerak bikain profitatu zituen .	profitatu	12	Perf
Baina gairik minberenak geratzen dira adosteko :	geratzen	3	Imp
Atzoko finalean korritu zuen Cathy Freemanek ere , baina Australia dominetatik urruti izan zen lasterketa osoan .	korritu	2	Perf
Hauek aztertuko ditugu :	aztertuko	1	Prosp
Eztabaida gogorrenak gaur arratsaldean hasiko dira , Europako Batasunaren erreformaren gaiari helduko baitiote EBko kideek .	helduko	11	Prosp
Froga-aldia amaituta , interesdunak dioena entzungo da , Administrazio-Ihardunbideari buruzko Legeak ezartzen duenez .	entzungo	5	Prosp
Gainerakoek , berriz , beti amarrako izan dela erantzuten diote , eta ea nondik atera duen " hamarreko " hori .	erantzuten	8	Imp
Baskoniak egindako defentsak errebote ugari eskuratzeko aukera eman zion , eta , baloia eskuetan zutela , kontraerasoen bidez saskiratu zuen .	saskiratu	18	Perf
Igoera arrazoitzeko , ministerioko iturri batek esan zuenez , gazteek ez dute orain iraila arte itxaroten Enplegurako Agentzi Nazionalean izena emateko .	itxaroten	15	Imp
Guzti honen nondik-norakoak argituak izan artean , aleman hedabideak zuhurtzia gabeko jokaera aztertzen egongo dira .	egongo	13	Prosp
Kaxmirko talde ugarik baztertu zuten suetena berehala , eta Indiaren aurkako borrokarekin jarraituko zutela esan zuten .	baztertu	3	Perf
Valladoliden aurka aritu zen hamaikakoarekin alderatuz , hiru aldaketa egongo dira atzoko taldea zelairatzen badu :	zelairatzen	13	Imp
Bozeramailearen ustez , Milosevicek lehenbailehen utzi beharko luke gobernua , " Jugoslaviako gobernuaren kontrolpean ez dauden nazioarteko begirale guztiek onartu dutelako Vojislav Kostunicaren garaipena " .	onartu	19	Perf
Atzo Joerg Haider burua elkarrizketatu zuen Poliziak , eta horrek handitu zuen eskandaluaren oihartzuna .	elkarrizketatu	4	Perf
Kontzertu Ekonomikoa eta datorren urteko aurrekontuak negoziatzera gonbidatu zituen oposizioko alderdiak , batez ere PSE-EEri luzatu zion eskua .	luzatu	15	Perf
urrundu , ez duzu ezagutuko sekula arazoa eta bera nolakoa den .	ezagutuko	4	Prosp
Ezkurra jarraian jantziko lukeen seigarren txapela irabazteko " konfiantza osoarekin " azaldu zen .	jantziko	2	Prosp
Indarrak puri-purian daudenean azaltzen dira , lehen astean normalean , eta aurrerago zeregin handirik izaten ez dutenez , hil edo biziko desafioa izaten dute azken metroetan .	daudenean	2	Prog
Soroetako jabeak han zebiltzala konturatzen zirenean , abere hauek soroetatik kanporatzeko eta berriz ere mendian gora bidaltzeko , eltzegorra hartu eta bertara inguratuz , jotzen hasten ziren .	zebiltzala	3	Prog
Zulueta abokatuak , berriz , Ruiz Polancok atxilotu bat mehatxatu duela esan zuen eta delitu den ikertzeko ekinbideak hastea aztertuko dutela .	mehatxatu	9	Perf
Dozena inguru argazki diptiko apailatu ditu Santos Montesek , eta erretratua dute ardatz .	apailatu	4	Perf
Bestalde , oso argi planteatu genizuen orain sortu den egoera berria behin betirakoa izatearen ardura denona zela .	planteatu	4	Perf
Horretaz gain , bertsolariak , umeentzako jolasak eta erromeria antolatu ziren " .	antolatu	9	Perf
Arratsalde beranta zen hara iritsi ginenean , auzotegi hura urruti baitago gu bizi ginenekotik .	ginenekotik	13	Prog
Andereñoa ez zen harritu Jontxu hain alai ikustean , eta ez zuen ezer susmatu .	harritu	3	Perf
Beti giza saldoan txintxo bazabiltza inola berezitu gabe , gizarteak bere modura sarituko zaitu :	bazabiltza	4	Prog
Bere hodi horixkak oso motzak dira eta hankako gune zabalean zehar hedatzen dira eta oso zaila da mamitik banatzea .	hedatzen	11	Imp
" Euskararen irakaskuntza Estatu paralelo bat sortzeko nahitik datorrela esatea da kezkagarriena iruditzen zaiguna .	datorrela	8	Prog
Hygrocybe gehienak bezala berankorra da , Azarotik aurrera ernetzen da neguko lehenengo hotzaldira arte , kare-lurretan eta mendiko larreetako belar artean .	ernetzen	8	Imp
Tankera horretan mintzatu zen SDLP Alderdi Sozialdemokrata eta Laboristako kide eta Magherafelteko zinegotzi Pat Kilpatrick .	mintzatu	2	Perf
« Interes nazionalen aurkako erabakia da eta herrialdeko ekonomia suntsituko du » .	suntsituko	9	Prosp
Lurraren barnealdetik sortutako indarrei zor zaizkienak dira , eta beste atal batean landuko ditugu .	zaizkienak	5	Prog
Haatik , 113 lagunen heriotza eragin zuen ezbeharraren nondik norakoaz argibide nahikoa dakartza dagoeneko .	eragin	5	Perf
Burua ere badudala erakutsiko diot munduari , ez dut modu horretan nire gorputza lagatuko , ahantziko .	lagatuko	13	Prosp
" Kontzertu zoragarria zen , eta guztiak nahi genuen oholtzara hurbildu ; hortaz , atzean zeudenek presio oso-oso handia egiten zieten aurrealdean zirenei " azaldu zuen , berriz , Lasse Aagard beste lekuko batek .	zirenei	22	Prog
Bigarren zatian ez zen Hormadi itsutu erasoan , baina beste behin aukera apartak galdu zituen golak sartzeko .	itsutu	5	Perf
Azaroak 20an Frankfurteko burtsan kotizatzen hasiko dira akziook .	hasiko	5	Prosp
Bestalde , argazki andana baten bitartez , emanak zauzkigu xeheki , euskaraz eta frantsesez , argitasun guziak .	zauzkigu	8	Prog
Ezpainik mugitu gabe esaten ditu , barnerantz , bortizki , eta jendaurrean , Ako herri osoaren aurrean dioela sentitzen du .	dioela	17	Prog
HOUDA ELAZHARREK HAMAR URTE DITU eta Marokon bizi da , Afrikako ipar-mendebaldean .	DITU	4	Prog
" Ez dakit zer gertatzen zaigun .	gertatzen	4	Imp
Baina nik uste dut oraindino azkarregi gabiltzala .	gabiltzala	6	Prog
30 urtekoa , Indonesiako ringetan zaildua dago Victor Ramos , eta dominen borrokan sartzeko helburuz zetorrela adierazi zuen Eki Timorreko ordezkaritzaburu Frank Fowliek , taldea Sydneyra heldu zenean .	zetorrela	15	Prog
Igandean atseden hartu zuen , eta astelehenean " oso burugogor " joan zen , baina giro sargoriak ez zion laga bidea bukatzen .	joan	11	Perf
Egia da badituela elementuak :	badituela	2	Prog
Hala , Udal Batzarrak , 1993ko azaroaren 25eko bileran , aldeko botoak zazpi eta kontrakoak lau zirela , eta Iker-Taldek egindako txostena bere eginez , Itziar Debatik Bereizteko Batzordeak aurkeztutako Azterketa Osagarria ezetsi zuen .	ezetsi	32	Perf
" Inguruan lokalak dituztenak kexatzen dira , bai .	kexatzen	4	Imp
Haien iduriko , ideia berrien bila hasteak " bake planaren eta konponbidearen heriotza " lekarke , eta atzera egite hori ez dute onartzen .	lekarke	14	Prog
Garraio ministroak berak , hondoraketa tokiaren gainetik helikopteroz ibili ostean , ikusi ahal izan zuenez , 700 metroko luzera eta 10 metroko zabalera zaukan kutsadura aztarna bat ageri zen itsas gainean .	zaukan	23	Prog
Gentzel ez da San Antoniora etorriko .	etorriko	5	Prosp
Ez dinat gauza haundirik ikasi eskolan , bainan oraino gogoan dinat mediku baten istorio bat , eta esplikatzen zinan osagarri onean zirenak eri zirela ez zekiten batzu zirela .	esplikatzen	17	Imp
Pertsona batekin imajinatzen zenuen hurbiltasun xamurretik urruntzea , latza da .	imajinatzen	2	Imp
Gure lehendabiziko kontzertu ohorezkoari hasiera emateko zorian ginen .	ginen	7	Prog
Harper , Bryant eta Glenn Ricek osatu zuten iaz hiruki hori .	osatu	6	Perf
Jendeak txaloka agurtu zituen laurak .	agurtu	2	Perf
Soroetako jabeak han zebiltzala konturatzen zirenean , abere hauek soroetatik kanporatzeko eta berriz ere mendian gora bidaltzeko , eltzegorra hartu eta bertara inguratuz , jotzen hasten ziren .	hasten	25	Imp
Hemen inork ez du sinetsi bere istorioa , eta denek uste dute Freemanen beldur zela .	sinetsi	4	Perf
Zehazki , itunak dio ehundaka militar jugoslaviar Kosovoko mugak zaintzera bueltatuko direla eta beste batzuek monastegi ortodoxoak zainduko dituztela .	zainduko	17	Prosp
( Bere besoetara amiltzeko keinua egiten du , baina Jojok atzera egin eta tristeki ezetz esaten dio buruaz .	esaten	15	Imp
Pentsatu zuen beharbada Hegoameriketara lagundu beharko zuela .	Pentsatu	0	Perf
Zenbait igelek , esate baterako , beren gorputza puztu egiten dute direna baino haundiagoak direla erakutsiz .	direna	11	Prog
Ikerketak zuzentzen , Kubako bi psikiatra ospetsuk dihardute :	dihardute	7	Prog
TOM CONSTANTINE estatubatuarrak aztertuko ditu RUC Ipar Irlandako Poliziari egingo zaizkion erreformak , atzo Peter Mandelson ministro britainiarrak iragarri zuenez .	aztertuko	3	Prosp
Horren ondoren protestak izan ziren Europa , Goreren kanpaina bulego eta Etxe Zuritik , halako portaerak EEBBen eragina eta NATOren sendotasun bera ere arriskuan jarriko lituzkeela esanda .	jarriko	24	Prosp
Urrean etsi ahala , aurrez ezagutzen zuten lantegiari lotu ziren :	ezagutzen	5	Imp
Paganismo berriaren azken parte guztia oso gogoratzen du , " genio alemana " delakoaren berbizkundea iragartzen duen zatiarena alegia .	iragartzen	15	Imp
Baina pauso berri bat eman beharrean zaude , eta beharbada ondo etorriko zaizu berriro ere ikas-norabideari gainbegiratu bat ematea , atalez aldatu behar baituzu .	zaude	6	Prog
FONTCUBERTAren hitzetatik jalkitzen den pesimismo hori errealitatea agortu delako uste horrek probokatua dago , beharbada .	agortu	7	Perf
Errefuxiatuak izatea errazten duten nazioarteko politika ekonomikoak zuzentzearen beharra azpimarratu du .	errazten	2	Imp
ETAren helburu dela esan dio Iragik Ruiz Polancori , eta honek erantzun dio epaile ez balitz " muturra hautsiko " liokeela .	erantzun	11	Perf
" Gaur egun , antzerkigintza beste bide batetik dihoa , talde pribatuek komediari ekiten baitiote " .	dihoa	8	Prog
Miarriztarrek diote ez dutela deus galtzeko , baina Morlaes uztartze erdiak honokoa gehitu zigun :	gehitu	12	Perf
Horretaz guztiaz gain , mundu osoan zehar 2 milioi emakumeri genitalak mozten dizkiotela dio Unicefek eginiko azterketak .	mozten	11	Imp
Hitz horien atzean , guk ulertu dugun mezua da :	ulertu	5	Perf
Joan den larunbatean 43-26 irabazi zion Perigueux taldeari .	Joan	0	Perf
Jose Lasak aukera asko ditu Baskoniako bigarren joko banatzailea izateko , Ivanovicek onartu ez zuen arren .	onartu	12	Perf
Lurraren barnealdetik sortutako indarrei zor zaizkienak dira , eta beste atal batean landuko ditugu .	landuko	12	Prosp
Liginagako Dronde senar-emazteak , aldiz , 7. lekuaz jabetu ziren .	jabetu	8	Perf
Ostean emandako prentsaurrekoan ere Osasunari " inolako argibiderik " emateko asmorik ez zuela nabarmendu zuen Jose Manuel Esnal Manek , " dagoeneko oso ondo ezagutzen baikaituzte " .	ezagutzen	24	Imp
- Hori da , Xucek bihar entzungo du .	entzungo	6	Prosp
Lanean niharduen anaiarekin , egurra mozten .	niharduen	1	Prog
Honela azaldu dit istoriotxoa , autoan sartu eta Silver State motelera goazela .	goazela	11	Prog
Udalbiltzari laguntzak eman nahi badiote " euren poltsikotik " egiteko gomendatu die Oiartzabalek alderdi abertzaleei .	gomendatu	10	Perf
Aukerak ezin zaizkio ukatu , baina ez da Miguel Indurain .	zaizkio	2	Prog
Bilera horretan oinarrizko errentaren proposamenak aztertu ziren , eta EAJ , PSE-EE eta PPk defendatzen duten planteamenduren ondorioz kopuru hori gutxieneko soldataren %75era mugatuko da .	defendatzen	14	Imp
Sendotasuna emango dio atzealdeari .	emango	1	Prosp
" Putin ezkerrean edo eskuinean duela esertzen da mahaian , eta serieko hiltzaileekin " .	esertzen	6	Imp
Hala , esan zuen gauza bakarra izan zen fiskalak haren akusazio idatzian dioena ez dela egia eta berak ez zuela idatzia banatu .	dioena	12	Prog
Nafarroako Hizkuntza Politika Zuzendaritza Nagusitik bereziki azpimarratu dute datu hau .	azpimarratu	6	Perf
Hizkuntza-heldutasuna neurtzeko era hau Brown ( 1976 ) ikerlariak asmatu zuen haurren hizkuntza-maila mugatzeko helburuagaz , eta euskararentzat Idizabalek ( 1991a ) egokitu du .	asmatu	9	Perf
Pinocheten abokatuek horri apelazioa aurkeztu zioten Gorte Gorenean , eta orain , horri dagokio erabakia hartzea .	dagokio	13	Prog
Aldi berean , lanera bidean zihoazen beharginei erreparatu zien , eta haiengan antzeman zuen alaitasunaz hunkiturik , zera deliberatu zuen bere artean :	antzeman	12	Perf
Bikote ikusgarri hori Phil Jacksonek zuzentzen du , NBAko entrenatzaile onena egun , eta Ligako historia osoko onenetakoa .	zuzentzen	5	Imp
FIJI Kolpistek atzera egitera behartu dute Gobernu mlilitarra .	behartu	4	Perf
Badut zera bat barne-muinetan , jartzen didana barrena penatan .	Badut	0	Prog
" Genituen zalantzak desagertu dira , ez genekien zein egoeratan geunden , eta horretarako baliagarria izan da .	geunden	10	Prog
Egileak dioenez , egungo gizakiok " gutxi entzuten dugu " , eta inguruko pertsonez " gutxi " arduratzen garela azpimarratzen du .	arduratzen	17	Imp
Jendeak ez daki kutsatua dagoena .	daki	2	Prog
Jaialdia arratsaldeko 18:00etan hasiko da .	hasiko	3	Prosp
Bertako prentsan egindako adierazpenetan , damutzen dela onartu eta barkamena eskatu dio Vitalicioko Francisco Cerezori eta " burua galdu " zuela argudiatu , Cerezok " putasemea " deitu zionean .	damutzen	5	Imp
Datozen egunotan iragarriko du Londresek Patten batzordearen zein proposamen beteko dituen RUC Polizia erreformatzeko .	iragarriko	2	Prosp
nire agindutara hago , eta hi ere joan egingo haiz !	hago	2	Prog
Hondoratu zen unetik , 250 metroz higitu da itsasontzia .	higitu	6	Perf
PPko legebiltzarkide Anton Danboreneak adierazi zuenez , erabaki horrek berretsi egiten du Juan Jose Ibarretxek zuzentzen duen gobernuaren " ezintasuna " .	zuzentzen	15	Imp
Zine izarra edo Tourreko garailea bailitzan hartu zuten argazkilariek aurrena , eta , kazetariek , gero , David Etxebarria .	bailitzan	5	Prog
Merzek burua bueltatu eta Jean Luc ikustean , ez zuen harritzekorik egin ; aitzitik , haren seriotasunak zain zegokiola ere adierazi zezakeen .	zegokiola	18	Prog
" Jerusalemeraino eskuan harriak daramatzaten haur palestinarrei ez diete betilerik mugituko helikopteroek .	daramatzaten	4	Prog
Hori dela eta , Joseba Beloki lazkaoarra eta Roberto Heras ez ditu Sidneyko Olinpiar Jokoetarako taldean sartuko .	sartuko	16	Prosp
Segituan berebaitaratu zen , ordea .	berebaitaratu	1	Perf
Egungo alderdien sistema ez dute gogoko , eta behetik gora eraikitako demokrazia nahi dute , " obedituz aginduko den sistema bat " .	aginduko	17	Prosp
Negozio zentroek hainbat zerbitzu eskaintzen dituzte :	eskaintzen	4	Imp
LEHEN eta Bigarren mailako buruz buruko pala txapelketak abian jarriko dira gaur Bilboko Deportibo pilotalekuan ( 16:30 ) .	jarriko	9	Prosp
Orain arteko 15 herrialde kideekin dauden arazoak nabarmen areagotuko lirateke , erakundeen ibilmoldean aldaketarik gertatu ezean .	areagotuko	8	Prosp
Goiz hartan Xucekin hitzegin zuen eta elkarrekin joan ziren egunpasa .	hitzegin	3	Perf
Diputatuek ez zioten barkatu Baraki palestinarrei " kontzesioak " egiteko prest egon izana Camp Davideko ( EEBB ) bake elkarrizketetan .	barkatu	3	Perf
Ez da inor heriotza zigorrera kondenatuko .	kondenatuko	5	Prosp
Tratu txarrengatik eta atxilotuak inkomunikatuta izateagatik " kezkatuta " daudela esan zuen Vincent del Buonok , eta horri buruz ere galdetuko diote Justizia Ministerioari .	galdetuko	20	Prosp
Boza aldatuz , galdegiten dit :	galdegiten	3	Imp
Banatze edo dibortzio tramiteetan dabiltzanen kasuan %60k onartzen dute .	dabiltzanen	4	Prog
Hauen lorapoteetan urtero azidotasun horri eutsiko dion gehigarri edo ongarria erantsi behar da .	eutsiko	5	Prosp
Burua ere badudala erakutsiko diot munduari , ez dut modu horretan nire gorputza lagatuko , ahantziko .	erakutsiko	3	Prosp
Tony Blair Erresuma Batuko lehen ministroak adierazi zuen ez zuela amore emango garrantzitsuentzat jotzen dituen sei alorretan .	emango	11	Prosp
Badago itxaropenik .	Badago	0	Prog
Ondorioz , ez da zaila azaltzen arlo honetan sortu diren tresna kuantitatiboen aniztasuna .	sortu	8	Perf
Egoera ikusita , hauteskundeak aurreratzeko aholkatu zion Efrain Sne Israelgo Defentsa ministrordeak lehen ministroari .	aholkatu	5	Perf
Felipe , ezer gehiago gal ez dezakeen jakiteak ematen duen segurtasunez , makinara sartu zen .	ematen	8	Imp
Egingo dut , baina gogoz kontra .	Egingo	0	Prosp
" Ez dakit erabaki hori atzera botatzerik badagoen , baina nik behintzat azalpenak eskatuko dizkiot Verbruggeni , lehenbailehen " .	eskatuko	13	Prosp
atzerritarren sarbidea , beraz , eskaera onartzen zaien baldintzapean gertatzen da .	gertatzen	9	Imp
OSASUNA eta Realaren aurka jokatu ostean , bere hirugarren euskal derbia jokatuko du igandean Jordi Cruyffek eta ondorioz , oso ongi daki zer nolako giroa egoten den horrelako partiduetan .	daki	21	Prog
Badirudi Zidanek zerutik ikusten duela futbola , erraz .	Badirudi	0	Prog
Gainera , oraindik inork ez daki nork beteko duen Urzaizen hutsunea .	beteko	7	Prosp
Taldeak " kalitateko atezaina behar " duela gaineratu zuen , eta , ziurrenik , " etxetik kanpo " bilatuko dutela .	bilatuko	18	Prosp
Ez dut inoiz horrenbeste gozatu .	gozatu	4	Perf
Cockburnek dioenez " emakumeak lan merkatuan sartzen dira esku bat atzera lotuta " .	dioenez	1	Prog
Eurekin bukatuko da arazoa eta kito .	bukatuko	1	Prosp
Polarizazio zuzenean dagoela atetik korrontea ( tentsio positiboko inpultsua ) aplikatzen badiogu , eroale bihurtzen da tiristorea .	aplikatzen	10	Imp
" Bada garaia prozesu hauetan berme juridikoak exijitzeko " .	Bada	1	Prog
Mende honen berrogeigarren hamarkadan oraindik Nafarroako Sakana bailarako haurrek jotzen zituzten txulubita hauek .	jotzen	9	Imp
Inter Milanek jokalaria urtebeterako uztea litekeena da , lesionatu zenetik " etsita " baitabil Ronaldo .	lesionatu	8	Perf
Alanbre gainean higitzen ziren harriz edo bolaz osatuta zegoen eta zenbakien balioa , haiek okupatzen zituzten posizioen bidez markatzen zen .	markatzen	18	Imp
Honelako sistemei , sistema homogeneoak deituko diegu .	deituko	5	Prosp
Dorsalen zerrenda berriaren arabera , Guerrerok eta Antiak 8 eta 12 zenbakiekin segituko dute .	segituko	12	Prosp
Musulmanek egunean bost aldiz errezatzen dute , etxean edo meskitan .	errezatzen	4	Imp
Peter Mandelson Ipar Irlandarako ministro britainiarrak erdibidea topatu nahi duela dioen arren , nazionalistek ez ezik , Irlandako Gobernuak ere uste du unionistei amore eman diela .	dioen	10	Prog
- David ... , gogoratzen nola etorri zitzaizkigun hitzak ezpainetara :	gogoratzen	4	Imp
korapiloak estutzen du .	estutzen	1	Imp
Realaren aukera garbiena berriz , hamabostgarren minutuan iritsi zen , Delfi Geli bere atean gola egitekotan izan baitzen baloi luze bat urruntzen ahalegindu zenean .	ahalegindu	22	Perf
Sudupe nahikoa haserreturik agertu zen errepiken txandan eta ez PPri ez PSE-EEri ez zitzaiola gustatu esan zion Olanori .	gustatu	14	Perf
Orain pare bat urtera arte emakumeak hil egiten ziren , azterketa ginekologikorik ez zutelako .	zutelako	13	Prog
Buenos Aires utzi eta , gutxienez , martxoa arte jardungo du , orduan amaituko baitzaio kontratua .	jardungo	9	Prosp
Ba , nahi niken sinets nazan , ez dinat batere senditzen , hau ez dun bestea bezain sineskorra .	niken	3	Prog
Lasaitasun handiz aritu zen Almudena Cid , eta oso seguru jardu zen ariketetan .	jardu	10	Perf
Itoko da !	Itoko	0	Prosp
Osasunak ez zuen tokirik galdu , baina zelai-erdian ez zuten asmatzen , eta baloia erraztasun handiz galtzen zuten .	asmatzen	10	Imp
Talde berria Domo-Farm Frites deituko da , eta orain arteko bi taldeetako egiturak aukera berdinean lehiatuko dira .	lehiatuko	15	Prosp
Denbora hain laburrean piztutako eztabaidak EEBBetan atzerri politikaz dagoen joera interbentzionista eta isolazionisten arteko banaketa zaharra agertu zuen .	dagoen	8	Prog
Orduan ohartu nintzen neu ere Pabeko kalean idatzirik dagoen " Euskal Herria askatu " nork ulertuko duen .	ulertuko	15	Prosp
( Goian dagoena behera jaistea igotzea baino errazago delako , agian ) .	dagoena	2	Prog
Maia taldeak fitxatzeko borondatea erakutsi zuen , eta Jazztel-Costa de Almeriarekin sinatzen ez badut , izango dut hara joateko aukerarik , diru gutxiago kobratuta .	sinatzen	11	Imp
Ihes egitea lortu zuena Fernando Solon zen eta hori eginda , Jean-Jacques Le Garrec eta Roland Madura frantses kazetariek iragan irailaren 19an kausitu zutena errepikatu zuen .	kausitu	22	Perf
Argitik ilunpetara eroriko zara egia gogorraren kontrara !	eroriko	2	Prosp
" Gure sistema ekonomikoak desarautu ditugu , espazio librea eman diogu ekimen pribatuari , produkzio kostuak murriztu ditugu eta kanpoko lehiakideei aurre egiteko tresnak amatu ditugu " .	amatu	24	Perf
Argi iturriak aipatu ditugu aurreko jarduera horretan , baina argia sortzen den lekutik , fokutik , nola hedatzen da beste lekuetara ?	hedatzen	17	Imp
" Munduan zerbait aldatu ahal izango banu , etxe handi guztiak txiki bihurtuko nituzke " .	bihurtuko	12	Prosp
Horrela , 1994. urtean udaletxeak Gaztainuzketako proiektu honi ebatu zion .	ebatu	8	Perf
Zakartu egiten da .	Zakartu	0	Perf
Hiru egunez inkomunikatuta eduki zuten , eta Ertzaintzaren aurrean onartu ez bazuen ere , epailearen aurrean kutxazainari su eman izana onartu zuen , eta berak bakarrik burutu zuela ekintza esan zuen .	onartu	9	Perf
Bi anaien estiloa beretsua izan zen , adimenak agintzen du intimitatea eta fantasiaren gainetik .	agintzen	8	Imp
ETXEAN bezala sentituko da Julio Cesar Lamas argentinarra hurrengo denboraldian Tau Baskonian , lau herrikide izango dituelako :	sentituko	2	Prosp
Galtzagorrik musu bat eman zion haur bakoitzari eta pozik joan zen beste galtzagorriekin .	joan	9	Perf
Horrekin erantzun nahi dio klase politikoak joan den ostegunean Duesseldorfen izandako atentatuari :	joan	6	Perf
Tajinearen osagaiak haragia edo arraina eta barazkiak dira eta izena , prestatzeko erabiltzen den ontzitik datorkio .	datorkio	15	Prog
Bagenekien urteko estropada onena egin behar genuela eta gauzak ondo atera zaizkigu , espero baino hobeto .	Bagenekien	0	Prog
Horri erantzun zion DOSeko kide Zoran Djindjicek esanez beldurra diela herritarrei .	erantzun	1	Perf
Beti giza saldoan txintxo bazabiltza inola berezitu gabe , gizarteak bere modura sarituko zaitu :	sarituko	12	Prosp
Hauteskundeak egiteko Federazioak onartu zituen datak ere " estuegiak " zirela argudiatu zuten lau pilotazaleek .	argudiatu	11	Perf
" Familiako kontuek bultzatu dute gure eskaintzari uko egitera .	bultzatu	3	Perf
Baina subiranotasuna eta pakea lortzea denon helburua izanik , ikuspegi horiek adostasun orokor batean kokatu eta aritzeko aukera delakoan gaude .	delakoan	18	Prog
Belokik , berriz , orain arte lau eta erdian eman dezakeen maila ematea ez duela lortu erran zuen , baina noizbait emanen duela .	erran	16	Perf
Prest zegoenean , kanal batetik beste putzu batera bidaltzen zen .	bidaltzen	8	Imp
Hego Euskal Herriak 47.870 milioi pezeta jasoko ditu Europako Gizarte Fondotik .	jasoko	6	Prosp
Ivanovic pozik agertu zen atzo Breoganen kontra garaipean lortu ostean .	agertu	2	Perf
Lehen aipatu den 1991ko apirilaren 9ko ez-legezko Proposamenean jasotako adierazpenen ondorioa da neurri hori ; izan ere , proposamen horretan honela esaten zen :	aipatu	1	Perf
Alex Zulle liderrak gertutik zaindu zituen bi aurkari horiek , eta sasoiko dagoela frogatu .	zaindu	4	Perf
Batetik , pentsa daiteke hiztunak bere bi hizkuntzetako bat erabiltzen duenean bestea automatikoki indargetzen dela interferentziarik ez gertatzeko .	indargetzen	13	Imp
Michael Zijlaard entrenatzaileak ( senarra gaur egun ) , ordea , txirrindularitza baino gauza garrantzitsuagoak badirela esan zion , eta geroztik garaipenen sekretua hori duela dio .	badirela	15	Prog
Hiru egunez inkomunikatuta eduki zuten , eta Ertzaintzaren aurrean onartu ez bazuen ere , epailearen aurrean kutxazainari su eman izana onartu zuen , eta berak bakarrik burutu zuela ekintza esan zuen .	onartu	20	Perf
Bruselak ikertuko dituen laguntza fiskalak Araba , Bizkaia eta Gipuzkoako Aldundiek enpresa sortu berrientzat onartutako Elkarteen gaineko Zerga kenkariak dira ( opor fiskalak ) .	ikertuko	1	Prosp
Australian egiten eta ingelesez idazten den gaur egungo literaturak ere bere lurrak landuta ditu jadanik .	idazten	4	Imp
Erregaliza mastekatzen zuen pentsatu bitartean .	mastekatzen	1	Imp
Udal hauteskundeetan ABko hautagaiak berezko zerrendetan , " idekidurazko zerrendetan " eta bertze zerrendetan integraturik aurkeztuko dira .	aurkeztuko	15	Prosp
Espainian martxan dagoen zaharrena da eta eraiki zenean 40 urteko bizia aurrikusi zitzaion egitasmoan ( Estatu Batuetako legezko epea ) .	aurrikusi	11	Perf
Behin batean Pasai Antxoko plazan jotzen geundelarik , ikus-entzuleen artean , aulkien lehenengo lerroan bazegoen mutil bat bere zakurrarekin .	geundelarik	6	Prog
Osasunak Aitor Ocio aurkeztuko du asteazkenean .	aurkeztuko	3	Prosp
Hiria kale estu eta karrika meharrez beteta dago eta erromatarren garaian ere esistitzen zen .	esistitzen	12	Imp
Gaur , ikertzaile ospetsuek kurtsoak eskainiko dituzte , eta hiru mintzaldi iraganen dira .	eskainiko	5	Prosp
mundua ikusteko , sentitzeko eta ulertzeko era , norberaren hizkuntzaren kategoriek baldintzatzen dute .	baldintzatzen	11	Imp
Oraindino ez daki ziur non jokatuko duen .	daki	2	Prog
Kontinente arteko torneoa jokoan , ikusmina sortu zuen atzoko Gernikako jaialdiak .	sortu	6	Perf
- Jesus ene , nirekin akabatuko du mutiko honek !	akabatuko	5	Prosp
Nik , bederen , ez dut tragatzen .	tragatzen	6	Imp
" Eztarrian arazoak izan ditut eta atzo gauean [ herenegun ] sukar pixka batekin joan nintzen ohera .	joan	14	Perf
Ez dira ezkondu beren amentsen zoko batean irudimenezko gizon idealisatu bat gordetzen baita .	ezkondu	2	Perf
- Herenak hezkuntza-sistemaz kanpo ikasi du euskara .	ikasi	4	Perf
Hasierako hamaikakori dagokionez , litekeena da Rojok aldaketa bi egitea .	litekeena	4	Prog
Strange Days ilun eta iradokitzailearen zuzendariak Jeane eta Marenen maitasun istorio zaurituak paraleloki kontatzen ditu ; etengabe iraganarera garamatzaten flash-back gordinez oraina zarramazkatuz .	kontatzen	13	Imp
Pablo Orbaiz ez dago deialdian , eta Andoni Imazek beteko du haren hutsunea .	beteko	9	Prosp
Bihar ponentzia bakarra eta sei ebazpenak eztabaidatu eta bozkatuko dituzte .	bozkatuko	8	Prosp
ARRATSALDE hartan , Lindroth neska-mutikoekin joan zen Selandertarren landetxera .	joan	5	Perf
BIHAR arte ez da jakingo EHUko errektore berria nor den , atzoko bozketan hautagaietako inork ez baitzuen gehiengo osoa lortu .	jakingo	4	Prosp
Whist jokoa aspaldi ezagutu zen kalkulu-ahalmenean zuen eraginagatik :	ezagutu	3	Perf
Horrela , bada , patriarkatuak gizonen arteko dependentzia eta elkartasunezko lokarriak eratzen ditu , emakumeak menderatzeko bidea ematen dienak .	eratzen	11	Imp
Hori dela eta , auzi saioak ordu bat bakarrik iraun zuen eta jujeek erabaki zuten epaiketa datorren irailaren 14era atzeratzea .	datorren	16	Prog
Enpresariek , ostera , begi onez ikusi dute neurria , batik bat zenbait lanpostu bete ezinean dabiltzan arloetakoek .	dabiltzan	16	Prog
Kaktusetan , adibidez , drenajea errazteko legar-kopurua handiagotu edo hartxintxarra gehituko dugu .	gehituko	10	Prosp
Eusko Legebiltzarreko bozeramaileek terrorismoaren biktimen omenaldirako lan taldeak antolatu dituzte .	antolatu	8	Perf
Zurtoin mardul bat aukeratu eta lur harroa duen lorapote batean alanbre batez sartuta eusten da .	eusten	13	Imp
Hauteskundeetan Aristiderekin lehiatu ziren beste bi hautagaiek ez ziren botoen %2,4tik pasatu .	lehiatu	2	Perf
Nahiko ongi ibili ginen , entrenamenduetan dena neurtuta eramaten genuelako , baina harri handia oso bestelakoa da .	eramaten	8	Imp
Sekulako parekotasuna dago taldeen artean , eta gauza txikiek apurtzen dute parekotasun hori partiduetan .	apurtzen	9	Imp
Ikus dezakezuenez , ez dira oso onak , baina hemen dihardugu , jo eta ke borrokan baldintza hauek hobetu asmoz .	dihardugu	10	Prog
Hau esanik , gartzelak , bi modutan sailkatuko genituzke .	sailkatuko	7	Prosp
IRAko disidenteei leporatu die Poliziak atentatua .	leporatu	2	Perf
Baina gero Egiptora Axtarte erreginaren hilobia bilatzera zihoala esan zion norbaiti .	zihoala	7	Prog
Lurrik gabeko 500.000 nekazari beltz finkatuko dira lur horietan .	finkatuko	5	Prosp
Bihar kurrituko dira Zalalagaine , Okabe 1 , Mehatze 1 , Okabe 2 , Mehatze 2 eta Bandetia .	kurrituko	1	Prosp
Unitate horretan konturatuko zinen bezala , materialak aldakorrak dira :	konturatuko	2	Prosp
Atzoko saioan , bere taldekideen erritmoari arazorik gabe eutsi zion behintzat .	eutsi	8	Perf
Zergatik zaude negarrez ?	zaude	1	Prog
Eraso larriena da , joan den astean suetena indarrean jarri zuenetik Hizbul Mujahideen gerrillak .	joan	4	Perf
Emaitzek lagundu ez arren , talde indartsua da , eta atzelariek lan bikaina egiten dihardute .	dihardute	14	Prog
Laguntzera etorriko ziren zaletu guztien aldean geunden .	etorriko	1	Prosp
Sail bakoitzean hiru sari banatuko dira .	banatuko	4	Prosp
Supersonikoaren ezkerraldeko lurreraratze tresneriaren pneumatiko baten lehertzea , aldiz , pista gainean zegoen 43 zentimetroko burdinazko pieza batek eragin zuela ondorioztatu du BEAk .	ondorioztatu	20	Perf
RTR telebista kateak zabaldutako irudietan , Serjent-Iurtez jabetu diren soldadu errusiarrek gerrilla txetxeniarraren kanpaleku bat atzeman zuten herri hau inguratzen duen oihanean ezkutaturik .	jabetu	7	Perf
Betoaren auziak arazo gehiago sortuko dituela espero da , zenbait kidek eutsi egin nahi diotelako beren interes nazionalak defendatzeko .	sortuko	4	Prosp
Zurigorriek presio itzela egin zioten aurkariari partidu hasieratik , eta erraz berreskuratzen zuten baloia .	berreskuratzen	11	Imp
Idatzi hau , beste kide baten bitartez helaraziko dizuet , nik , bi gutun baino ezin baititzaket idatzi , eta euskaraz idatziz gero , itzultzera bidaltzen dituzte .	bidaltzen	25	Imp
" Luxenburgo aretoa abangoardistek inbaditu dute aurten ; Estatuak erositako hainbat koadroren aurrean txundituta geratzen da bat ... " .	geratzen	14	Imp
" 2001. urtea arte kontratua nuen , eta gauzak nahikoa ondo ari zitzaizkidan ateratzen .	zitzaizkidan	12	Prog
Munduan gertatzen den guztia gure ardura ere badela pentsatu behar dugu .	badela	7	Prog
Taldea une oro edukiko dut aldamenean " .	edukiko	3	Prosp
Hala adostu zuten bi erkidegoek , baina batzorde mistoa ez da bildu azken zazpi hilabete hauetan .	adostu	1	Perf
" Kopa horren asmoa ez zen txarra , hilabete osoa baikenuen partidarik gabe , eta lehia horrek hutsunea beteko zuen .	baikenuen	10	Prog
Esperientzia dugu eta badakigu zer aurkituko dugun Mendizorrotzan .	badakigu	3	Prog
Madariagak esan zuenez , " gehienez abenduaren 31a arte egongo gara , baina itxura batean ez da hori gertatuko " .	gertatuko	18	Prosp
Ordu berean , aitak , esku erne batez hartzen nau eta bazterrera eramaten .	eramaten	12	Imp
norbait hiltzeari , noski , baimenik gabeko bizitzaren amaiera esaten zaio .	esaten	9	Imp
- Ederki asko berotuko diat , bai , ipurdi hori gauean , mukizu ahalena !	berotuko	3	Prosp
portland SAN ANTONIOK bolada bikainari eusten dio , eta , joan zen asteburuan Europako Superkopa irabazi ostean , sasoi onean dagoela berretsi zuen atzo Pilotes Posada Galiziako taldeari erraztasun osoz irabazita .	eusten	5	Imp
Okerrago jokatu zuten hirugarren laurdenean , eta , defentsak baino gehiago , talde baten zein bestearen hankasartzeek baldintzatu zuten jokoa .	baldintzatu	17	Perf
Presidenterik aukeratu ez bada , Kongresuko eledunak haren papera beteko du .	beteko	9	Prosp
Arafaten Al Fata erakunde palestinarrak greba orokorra antolatu du gaurko Palestinako lurretan , " Israelen okupazioaren aurka " .	antolatu	7	Perf
Tolosarrek esperientzia handiko internazionalak dituzte aitzinean , eta nazioartean jokatuta , baliabideak bereganatzen dituzu .	bereganatzen	12	Imp
Denboraldia amaitzear da .	amaitzear	1	Imp
Kutsatuta ez daudenek datu horiek hartzen dituztenean ondorio bitxiak ateratzen dituzte :	ateratzen	9	Imp
Espainiako merkatuan sortzen den lehen kooperazio aliantza da hau , eta datorren hilabeteetan beste hiri batzuetara hedatzeko asmoa du .	datorren	11	Prog
NATOk , ostera , erantzun du artean goizegi dela jugoslaviarren itzulerarako , Kosovon serbiarren eta albaniarren artean ezinikusi handia dagoelako .	erantzun	4	Perf
Jaurlaritzako eledunak esan zuen ez duela " ulertzen " Aznarren jokabidea , gizarteak alderdiei batuta egoteko eskatzen dietenean , Aznar tirabirak sortu eta polemika " bilatzen ari delako " .	bilatzen	25	Imp
Onenekin borroka egiteko moduan daudela ikasi dute Frantziako selekzioko kideek , eta horren emaitza bistan da .	ikasi	5	Perf
Frantxua Maitia sozialistak " mementoz Gobernua korsikar aferarekin " ari dela argudiatu zuen eta Hego Euskal Herrian dagoen bortizkeria egoera eta " Espainiak Euskal Departamendurik sor ez dadin egiten duen presioa " azpimarratu zituen .	azpimarratu	32	Perf
Asperren kasua emeki-emeki aitzinatu bada ere , Sa Pintoren etorkizuna fite argituko da .	aitzinatu	3	Perf
Gaur edo bihar jakingo da jokatzeko moduan dagoen .	jakingo	3	Prosp
Azpibalorazio horren errua fusioen nahiz sal-erosketen etengabeko zurrumurruei egotzi die .	egotzi	8	Perf
Aznarrek EAJ eta EA ETArekin parekatu zituen .	parekatu	5	Perf
Ezkerrean , kristalezko ate laxo bat ikus zitekeen , denboraren poderioan markoko pintura galduz eta likistasuna bereganatuz zihoana .	zihoana	17	Prog
Houdari gehien gustatzen zaion txokoa ataria da .	gustatzen	2	Imp
Greenpeaceko kideak salatu zuenez , " ez da egia errauspenak zabortegiak ezabatzen dituela " .	ezabatzen	11	Imp
Haiderrek berak halakoak iradoki ditu lehenago , baina beti zeharka , eta ez atzokoaren moduko egun sinbolikoan .	iradoki	3	Perf
" Gure sistema ekonomikoak desarautu ditugu , espazio librea eman diogu ekimen pribatuari , produkzio kostuak murriztu ditugu eta kanpoko lehiakideei aurre egiteko tresnak amatu ditugu " .	desarautu	4	Perf
Maribel Belastegi Arteszenako zuzendarietako batek atzo emandako prentsaurrekoan azpimarratu zuenez , Mephisto lana giza konpromezuzko antzerki esparruan kokatzen da .	azpimarratu	8	Perf
Askotan , momentu txarretan , esaten dut dena utzi eta joango nintzatekeela artzain Urbiara , hemengo presak eta estresak utzita .	esaten	5	Imp
Nork aginduko du ?	aginduko	1	Prosp
Concordearen Roissyko pista ez zuten behar beste arakatu .	arakatu	7	Perf
Hori dela eta , finalerdietako partidu berbera errepikatuko da .	errepikatuko	7	Prosp
- PNP transistorea da eta 4 terminala masari konektatzen badiougu , gailuaren funtzionamendua eragotzita geratzen da , irteerako tentsioa 0 V izaten delarik .	konektatzen	8	Imp
MIKEL ARTETXE txirrindulari bizkaitarrak bi urterako luzatu du Euskaltel-Euskadi taldearekin zuen kontratua .	luzatu	6	Perf
Hi hago isilik , Ottokar .	hago	1	Prog
Froga-aldia amaituta , interesdunak dioena entzungo da , Administrazio-Ihardunbideari buruzko Legeak ezartzen duenez .	dioena	4	Prog
Ez du frogarik ematen ordea esandako horiek baieztatzeko .	ematen	3	Imp
Alderdi demokratiko batekoa dela dioenak ETAko presoak euren jaioterrira ekartzeko eskaerarik ez diezaiola egin Madrilgo Gobernuari " .	dioenak	4	Prog
( Jeikitzen da , denbora berean Anne-Sophie sartzen da eta dozier bat bulegoan finkatzen , biziki eman behar du , ANPEn bezala ) .	finkatzen	13	Imp
Dolore luzeak izpiritua erabat mehetzen , sentiberatzen , fintzen du .	sentiberatzen	6	Imp
Adierazitako saiakera asko EEBBetan burutu dira , sarritan konplexuegiak , maneiatzeko zailak eta denbora luzea eskatzen duten eskalak izan dira .	burutu	4	Perf
Maurice Greene erraz nagusitu zen 100 metroetako proban , eta marka ona eginda gainera :	nagusitu	3	Perf
Atzo PSE-EEren Batzorde Eragilea Bilbon bildu zen , eta Ibarretxek jasango dituen zentsura mozioak izan zituen hizpide .	jasango	10	Prosp
Eta gaisorik dagoen bitartean ere gorde egiten da eta baztertu .	dagoen	2	Prog
Alemanian , esate baterako , emakumeek 395 minutu dedikatzen dituzte egunean etxeko zereginetara , eta gizonezkoek aldiz 90 minutu ( egunkaria , 95/8/24 ) .	dedikatzen	8	Imp
Borroka asko daramat denboraldi honetan eta oso pozik egon naiteke lortu dudanarekin .	daramat	2	Prog
PSE-EEk lehendakaritza eskatuko du hauteskundeen ostean aliantza egiteko .	eskatuko	2	Prosp
Egoera kezkagarriagoa da Ekialdeko Alemanian , erasoen erdiak han gertatzen baitira .	gertatzen	9	Imp
ETAk armak uzteko " formularik " baduen galdetu dio Otegik Ibarretxeri .	baduen	6	Prog
Hago hor !	Hago	0	Prog
" Urduritasunak erasan zion Urretabizkaiaren kontrako partiduan .	erasan	2	Perf
" Montte " berak kontatu zigun ondoko hau :	kontatu	4	Perf
Hiru herrialdeetan egindako iritzi ikerketen arabera , herritarren gehiengoa agertu da lurraldetasuna errespetatuko luketen egituratze administratiboen alde .	errespetatuko	12	Prosp
Tony Blair Erresuma Batuko lehen ministroak adierazi zuen ez zuela amore emango garrantzitsuentzat jotzen dituen sei alorretan .	jotzen	13	Imp
Tresna baten garapenean dagoen asmoa definitzea funtsezkoa da baliogarritasuna ebaluatzeko garaian .	dagoen	3	Prog
Jaiki eta urduri paseatu zen gelan barrena .	paseatu	3	Perf
Orain arte jakinarazitako datuak itxaropentsuak eta positiboak dira alderdi politiko berriarentzat eta , horien arabera , botoak alderdi guztietatik jasoko ditu , .	jasoko	19	Prosp
Zenbait txirrindularik jasandako erorikoengatik jaso dute komunikabideon arreta .	jaso	4	Perf
Izetak 100 kiloko zilindroarekin jardungo du , eta minutu batean , 23 jasoaldiko marka ondu nahi du .	jardungo	4	Prosp
Bizkaieraren apartekotasunak harrotzeari eta handitzeari ekin zitzaion , gainerako euskalkiekin batzen zituen ezaugarriak alde batera utzi eta haiengandik banatzen zituenei lehentasuna emanez .	banatzen	18	Imp
Iñaki Abaituak lurrean sakabanaturik geratu diren orriei begiratzen die ; gero , Juliak besoa altxatuz erakusten dion folio zimurtuari .	begiratzen	7	Imp
Hegazkin konpainiako eledun batek jakinarazi zuen ikertzaileek konpainiarena ez zen gurpil bat antzeman zutela hegazkinaren inguruan , eta gaineratu nekez pentsa daitekeela eguraldiak edo matxura batek eragin zuela istripua .	antzeman	12	Perf
Martxan 27 urte daramatza Euskal Herritik bost kilometrotara dagoen Garoñako zentral nuklearrak .	daramatza	3	Prog
Lurra oso-osorik geldituko da .	geldituko	2	Prosp
Kanpo politikako aferak barne politikako bihurtzen dira EEBBetan , batez ere azaroaren 7ko lehendakaritza eta Kongresurako hauteskundeak hurbiltzen diren neurrian .	hurbiltzen	17	Imp
EPOa igartzen duen test berria atzo aurkeztu zioten zientzialari australiarrek NBOri .	igartzen	1	Imp
Tortolisak gordetzeko telazko poltsatxo batzuk erabiltzen ziren , goitik soka batez estutzen zirenak .	estutzen	11	Imp
Mugaberen bozeramaileak azpimarratu zuenez , Hegoafrikako eta Nigeriako presidenteak " Zimbaweko herriari elkartasuna adieraztera etorri dira " .	azpimarratu	2	Perf
Partiduei ematen dien erritmoarekin gozatzen dugu Titinekin .	ematen	1	Imp
Selekzioko hainbat jokalarik Calcio-n dihardute , jokatu dute edo jokatuko dute :	dihardute	4	Prog
Badakigu partidu zaila izango dela .	Badakigu	0	Prog
Bestalde , jalkitako material horiekin batera arro edo haran sedimentarioetan bizitako animalia eta landare batzuen hondarrak pilatzen dira , harri " bereziak " sortaraziz .	pilatzen	16	Imp
Egun batzuk hilik zeramatzala , paperik ez zeuzkan gizon baten gorpua topatu zuten .	zeramatzala	3	Prog
Donostiako errefuxiatua hiru orduz elkarrizketatu zen herenegun UNHCReko aholkulariekin .	elkarrizketatu	4	Perf
Arauaren aldaketaren ondorioz , %5 hori %8ra pasatzen da ekoizpen naturala saltzen duten nekazaritza eta basoko ustiapenak dituztenei eta %7 abeltzaintza eta arrantza ustiapenak dituztenei .	dituztenei	24	Prog
Baina orduan ere , nahi izanez gero , CDU / CSUren eta FDPren arteko koalizioak gehiengoa lortuko zukeen .	lortuko	16	Prosp
- Badakizu zer egingo dugun ?	Badakizu	1	Prog
Sakana da egungo txapelduna , eta aurten aldaketak egiteko moduan denez , ez du aukerarik galduko .	galduko	15	Prosp
Lizaso ongi ezagutzen du Ezkurrak , eta haren sakea nabarmendu zuen :	ezagutzen	2	Imp
Paganismo berriaren azken parte guztia oso gogoratzen du , " genio alemana " delakoaren berbizkundea iragartzen duen zatiarena alegia .	gogoratzen	6	Imp
Baina kide ez direnak badira bortxatzen , holakoen batasuna laster da eteten .	eteten	11	Imp
Mahendra Chaudhry jatorri indiarreko lehen ministro ohiak oraingo Gobernuaren aurkako salaketa jarriko duela esan zuen atzo , ilegala dela argudiatuz .	jarriko	11	Prosp
Badago borondate ona alde bietatik .	Badago	0	Prog
Coulthardek azken ahalegina egin zuen minutu baten faltan , eta asko hurbildu bazen ere , bigarren postutik saiatuko da garaipena lortzen .	hurbildu	11	Perf
Ez zen bere urduritasunaz erabat jabetu halere , oroimenak ostera An-ekikoa oroitarazi ez zion arte .	jabetu	5	Perf
Entzunaldiaren ondoren , erabakia hartzeko proposamena aurkeztuko da .	aurkeztuko	6	Prosp
Zuzenean joan zen Añorgako ezkertia 22raino , eta denak berak egindako tantoak izan ziren :	joan	1	Perf
Luis Fernandezek fitxatu zuen eta ikusteke dago zer erabakitzen duen Rojok .	ikusteke	5	Imp
Ildo horretan , Estatuak abertzaleen arteko elkarlanari beldurra diola iritzi dio Egibarrek .	diola	8	Prog
Oliobide baten leherketak 30 hildako eragin ditu gutxienez .	eragin	5	Perf
Gustora egoteko moduko lana egin dut , baina laugarrengo postuak beti uzten dizu tristura bat , podiumaren atarian gelditzen baitzara .	gelditzen	18	Imp
Hosni Mubarak Egiptoko lehen ministroa Ehud Barak Israelgo lehen ministroarekin ere elkarrizketatu zen telefonoz atzo .	elkarrizketatu	11	Perf
Egun hauetan Atlantako zilarraz galdetu diogun bakoitzean hura errepikatzea ia ezinezkoa dela erantzun du Abraham Olanok .	galdetu	4	Perf
Ezin nion negarrari utzi .	nion	1	Prog
Bitartean , Kakotx , nire xakurtxoa ferekatzen dut eta bere askaria ematen diot .	ematen	11	Imp
Orduan ohartu nintzen neu ere Pabeko kalean idatzirik dagoen " Euskal Herria askatu " nork ulertuko duen .	ohartu	1	Perf
Ordu arte bazirudien CDU alderdi kontserbadoreak eta Bavarian duen adarrak CSU alokatua zutela lehen postua Alemaniako alderdi sisteman .	bazirudien	2	Prog
Gehienak etxera joan ziren , prestatuta zuten jaia ospatzeko gogorik eta motiborik ez zutelako ; eta telebistaz Rijkaardek selekzioa uzten zuela entzun behar izan zuten .	joan	2	Perf
Nornahik ezagutu gintuen .	ezagutu	1	Perf
Jadanik egun Bundestagen jorratzen diren legeen %60k dute « jatorria » Bruselan .	jorratzen	3	Imp
Gaia aztertzeko eta nondik nora doan ikusteko galdera batzuk egingo dizkizugu orain .	doan	5	Prog
AIk abiatutako kanpaina dela eta , Amnesty Internationalen jarduerarekin kritiko direla esan arren , erakunde hori indarkeriaren aurpegi ugariak mahai gainean jartzen saiatzen dela esan zuen Otegik .	saiatzen	22	Imp
PTri dagokionez , bigarren txandatik landa , 300 udalerri gobernatuko dituela aurrikusten da , gaur egun 107tan gehiengoa daukarik .	aurrikusten	11	Imp
Oinarrizko Eskubideen Agiria onartu dute hamabost estatuek .	onartu	3	Perf
" Garbi dago Giroa krono-igoeran erabakiko dela " .	erabakiko	5	Prosp
Jarraian aztertuko ditugu funtzio horiek guztiak eta funtzio horiek egiten dituzten gailuak .	aztertuko	1	Prosp
" Hasieratik erritmo azkarrean korritu da eta helmugara indarrez justu heldu gara .	korritu	4	Perf
Jaurlaritzako eledunak esan zuen ez duela " ulertzen " Aznarren jokabidea , gizarteak alderdiei batuta egoteko eskatzen dietenean , Aznar tirabirak sortu eta polemika " bilatzen ari delako " .	ulertzen	7	Imp
Baionara nola etorri den kontatu zigun Devichek :	kontatu	4	Perf
Burua ere badudala erakutsiko diot munduari , ez dut modu horretan nire gorputza lagatuko , ahantziko .	badudala	2	Prog
Eta premiatasun hari amore emanez , auzia lehenbailehen erabakitzera deliberatu zen .	deliberatu	9	Perf
Medikuek garbi ikusitu zuten apendizitis izan zitekeela , eta Basurtuko ospitalera eramatea erabaki zuten gauerdi aldera .	ikusitu	2	Perf
Singapur Airlines-eko bozeramaileek agertu zutenez , hegazkinak zerbait jo zuen aireratzen hasi zenean .	agertu	3	Perf
Erakusketa horrek informatika eta komunikazio produktuak jasoko ditu , eta enpresa eta profesionalei zuzenduta dago .	jasoko	6	Prosp
Emiliek arrazoi zeukan esaten zuelarik Andreas ez zela hilik , eta artean bizirik zegoela .	zeukan	2	Prog
Era horretan , Rouen , Amiens eta Reims saihestuko genituzke final-laurdenetan " .	saihestuko	8	Prosp
Errege-seme ez dirudizu , baina horrela deituko zaitut , .	dirudizu	2	Prog
Zimbawen ari den frantziskotar bat , beti ehuneko hamabosta esijitzen duena .	esijitzen	9	Imp
Beraz , hiruren arteko formula horri eutsi diogu .	eutsi	6	Perf
Asteazkenean Poliziak lehergai bat indargabetu zuen Aldi Baterako Lan Enpresa baten egoitzan Sevillan .	indargabetu	4	Perf
Partiduei ematen dien erritmoarekin gozatzen dugu Titinekin .	gozatzen	4	Imp
Ihes egitea lortu zuena Fernando Solon zen eta hori eginda , Jean-Jacques Le Garrec eta Roland Madura frantses kazetariek iragan irailaren 19an kausitu zutena errepikatu zuen .	errepikatu	24	Perf
Lapurtarrak Tarbestik kilometro batzuetara geratu ziren atzo , Ibos izeneko herrixkan , eta han emango dituzte partida aitzineko orduak .	emango	14	Prosp
Azken urteotan izandako bolada txarra gainditzen saiatuko da .	saiatuko	6	Prosp
ALBERTO Fujimoriren Gobernuko lehen ministro izandako Federico Salasek esan duenez , Vladimiro Montesinos Lehendakaritzako aholkulari ohia estatu kolpea egiteko prest zegoen kargua uztera behartzen bazuten .	behartzen	23	Imp
Enpresek ez dute zehaztu nola egituratuko duten programa , baina puntakoa izango dela ziurtatu zuten .	egituratuko	5	Prosp
Lagos hiriko kanpoaldeko oliobide batek eztanda egin eta gutxienez 30 pertsona hil eta beste asko zauritu ziren atzo .	zauritu	15	Perf
Guk gogoa jarriko dugu , eta erronkari aurre eginen .	jarriko	2	Prosp
Hegoaldean iduri zait euskararen mundu hau adi-adi dagola , Euskaltzaindiak zer erranen duen zain , haren arauen berehala betetzeko .	dagola	7	Prog
Galduz gero , errua zeri egotzi prestatuta dauka Al Gorek datorren astearte gauerako :	datorren	10	Prog
Hala , Munteanu , Mihalcea edo Mara bezalako jokalari gazteek arazo asko sortu zizkieten Alaveseko atzelariei , behin eta berriz hegaletatik arrisku handiarekin sartuz .	sortu	12	Perf
Nik aitortu nuen desobedientzia zibila egiten dugula , dena publikoa dela eta abar .	aitortu	1	Perf
Nola funtzionatzen du mendiko erreskate taldeak ?	funtzionatzen	1	Imp
Azkenik , Mariano Raxoi Espainiako Gobernuko lehen lehendakariordeak aitortu zuen " funtsean gure alderdiak eta PSOEk akordioa itaundu dutela " .	itaundu	17	Perf
Dolore luzeak izpiritua erabat mehetzen , sentiberatzen , fintzen du .	fintzen	8	Imp
" Amak egunero orrazten nau eta gaur , ilea atzera bilduta daramat " .	orrazten	3	Imp
Halaber , bestelako delitu motak ere tipifikatu dituzte , egun zigorrik jasotzen ez duten ekintzak zigortuz , batez ere adierazpen askatasunaren ingurukoak .	tipifikatu	6	Perf
Beraz , bi aurrelariek atzo ezagutu zuten entrenatzaile berria , Txetxu Rojo .	ezagutu	5	Perf
Abertzaleen artean , beti bazaukan fama gaitza kartsuetan kartsuenetarik zelakoa .	bazaukan	4	Prog
Gu saiatu gara eurekin hitzegiten baina ez dugu inolako erantzunik jaso .	jaso	10	Perf
Egoera zein den ikusita , pozik agertu dira antolatzaileak .	agertu	6	Perf
Oso pozgarria da gurpildun aulkian dabilen lagun bat domina batekin ikustea .	dabilen	5	Prog
Behar zaitut eskertu Euskal Herriaren izenean zure semea hain ontsa hazi baituzu .	zaitut	1	Prog
Maistrak agindutakoa egin ostean arratsalde osoa zeukaten jolasteko , beti ere , etxeko mandatuak egin ostean .	zeukaten	6	Prog
Berak idatzi zuen Schindlerren untzia eleberria , gerora Schindlerren zerrenda izenburuarekin zinemara egokitu zena .	idatzi	1	Perf
" Genituen zalantzak desagertu dira , ez genekien zein egoeratan geunden , eta horretarako baliagarria izan da .	Genituen	1	Prog
" Kopa horren asmoa ez zen txarra , hilabete osoa baikenuen partidarik gabe , eta lehia horrek hutsunea beteko zuen .	beteko	18	Prosp
Guztien artean Stefano Fiore gailendu da .	gailendu	4	Perf
Orain arteko lorpenik garrantzitsuena , duela bi urte , ekainaren 11n hain zuzen , onartu zen Euskadiko Kirolaren Legearen onarpena da .	onartu	14	Perf
Hiru denboraldi daramatza lehen mailan .	daramatza	2	Prog
" Gaur egun , antzerkigintza beste bide batetik dihoa , talde pribatuek komediari ekiten baitiote " .	ekiten	13	Imp
Izerdia zurrupatzen dute hostoak zimeldu eta eroriaraziz .	zurrupatzen	1	Imp
oporrak hastean itzuli egin behar nion .	nion	5	Prog
Zer pentsa lezake diozunaz nire moduko arlote batek ?	diozunaz	3	Prog
Salbatu zirenak semeak argitaratu zizkion .	Salbatu	0	Perf
GAUZATU da azkenean .	GAUZATU	0	Perf
29 urte betetzear , ustegabean egokitu zaio distira egiteko unea .	betetzear	2	Imp
Iturri hauek ziotenez , aldiz , Serjent-Iurt herriaren inguruan Armada federalak burututako ekitaldi zabalean , 120 gerrillari txetxeniar hil dituzte .	ziotenez	2	Prog
Fosilak deritze ( latinezko hitzetik eratorritako hitza da , eta lurretik ateratakoa esan nahi du ) .	deritze	1	Prog
Lana egiten badu , zigor osoari egunak kentzen joango zaizkio , epe jakin batetan , egun batzutako baimenarekin kalera irtengo da , eta azken finean , zigorraren erdia " ordainduz " , behin betiko kalera irtengo da .	irtengo	19	Prosp
Non dagoen jakin , badaki , egunero ikus dezakelako eguraldi mapetan - alderdi popularrari ez zaio hori ongi iruditzen - , baina ez pentsa , Iparraldeko euskal mundu zaleok , beste askorik dakienik Hegoaldeak zuetaz .	dagoen	1	Prog
HIRUGARREN eta azken jardunaldia dute gaur Arabako Txapelketan diharduten bost taldeek ; 600 kiloetako jarduna izango dute , Artziniegan ( 17:00 ) .	diharduten	8	Prog
Guk kilometro asko daramatzagu denboraldi osoan eta azkenean indar falta somatu dut .	somatu	10	Perf
Aipatutako terminoen azpian dagoen kontzepzioa , berriz , zabalagoa da .	dagoen	3	Prog
Bonifikazioek garrantzia dute , baina ez dira erabakigarriak , Itzulia ez dutelako erabakiko " .	erabakiko	12	Prosp
Senideek salatu dute preso bat HIESaren birusaz kutsatu dela .	kutsatu	7	Perf
Ulertzen dugu beraz ardura ezberdinak direla , baina bion aldetik sinatuta dagoenez zuei ere esan beharrean aurkitzen gara .	Ulertzen	0	Imp
Divac eta Djordjevic Sidneyn ez direla ariko baieztatu du Obradovicek .	baieztatu	7	Perf
Zarata egiterik ez nuen saihestu , baina ez nuen zaratarik egin .	saihestu	4	Perf
Zientzian eta progresoan sinesten duenak , problema guztien soluzioan sinesten du .	sinesten	9	Imp
Xuc jaiki zen aurrena , eta orain Knox eta biak sukaldean ari ziren , atzera eta aurrera , guztientzat kafesneak egin eta ogia txigortzen .	txigortzen	23	Imp
Langabezian daudenen kopurua 2,27 milioira jaitsi da irailean Frantzian .	daudenen	1	Prog
100 eta 200 metroak irabazten dituen lehen atleta da gainera , Seulen Griffithek egin zuenetik .	irabazten	4	Imp
Italiarrek saskipean duten indarra aipatu zuen Ivanovicek , " bertan dituen jokalariak oso garaiak baitira " .	aipatu	4	Perf
ZALEEK gogo handiz itxaroten zuten unea iritsi da eta Gasteizko Andra Mari Zuriaren jaietako pilota programaren baitan ikusiko da .	itxaroten	3	Imp
Kezka larri batek estutzen zion barrena , sosegu hartzea galeraziz .	estutzen	3	Imp
Felipek , buruarekin , ulertu zuelako keinua egin zuen , entenditu zuela , baina ez zuen oso garbi .	entenditu	10	Perf
EHren iritziz , sozialisten jarrera UPNrekin aurki negoziatuko dituen aurrekontuen atarian indarra baduela erakusteko " keinua da " .	negoziatuko	7	Prosp
- Nik ezagutzen nuena ez zegoan hi bezain segail eta ez zeramatzaan horrelako antiparrak , gainera .	zeramatzaan	11	Prog
Testuak gizabanako eta talde desberdinek irakurtzen edo interpretatzen dituzte , bakoitzaren baliabide sozial eta kulturalen , boterearekiko esperientzien eta norberaren biografiaren arabera .	interpretatzen	7	Imp
Bestetik , Down konterrian RUCeko polizia bat larri zauritu zen lankide batekin Poliziaren komisaldegi baten ondotik oinez zebiltzala bonba bat lehertu ostean .	zebiltzala	17	Prog
Sailkapen nagusian nahi bezain aurrean ez dira izaten inoiz , eta etapak irabaztea nekeza egiten zaie , arriskutsuak baitira eta motzean lotzen baitituzte .	lotzen	21	Imp
" Kontzertu zoragarria zen , eta guztiak nahi genuen oholtzara hurbildu ; hortaz , atzean zeudenek presio oso-oso handia egiten zieten aurrealdean zirenei " azaldu zuen , berriz , Lasse Aagard beste lekuko batek .	zeudenek	15	Prog
Gauza asko daude amerikarrek dituztenak eta guk ez .	dituztenak	4	Prog
" Presoen eskubideen urraketa salatzen jarraituko dugu , eta kartzelan dauden gizon-emakumeen aurkako indarkeria mota horri gure ustez babesa ematen diotenak seinalatuko ditugu " .	ematen	19	Imp
Irakasleek uste dute neskak eta mutilak berdin tratatzen dituztela , baina aski eta sobera frogatu da ohituraz maskulinotzat jo diren curriculum ikasketetan irakasleak gogotsuago aritzen direla mutilekin neskekin baino .	aritzen	24	Imp
Akhwari urrea irabaztera joan zen , baina azken postuarekin ere harro egoteko arrazoiak bazituen .	joan	3	Perf
Pinocheten abokatuek horri apelazioa aurkeztu zioten Gorte Gorenean , eta orain , horri dagokio erabakia hartzea .	aurkeztu	4	Perf
Eusko Trenbideak trenak eta autobusak jarriko ditu Donostiako geltokian ordu eta erdiro gaur eta bihar .	jarriko	5	Prosp
" Elementu literarioak badituen arren , nire ustez kronika da gehiago " .	badituen	3	Prog
Eta gazte horien ilusioaren adinakoa da Al Goreren aholkularien kezka , bi aldeak ( zentro eskuina eta aurrerazaleak ) aseko dituen mezua topatu ezinik .	aseko	19	Prosp
Bietako batek emango dio gaur distira Rotterdamgo zeruari .	emango	2	Prosp
McGuinnessek Egunkariari onartu berri dionez , bere departamenduan ez du britainiarra soilik zintzilikatuko .	zintzilikatuko	12	Prosp
Urrikaldu egiten zuten eta azkenean beste batekin ezkontzeko komentzitu zuten .	komentzitu	8	Perf
Baina hitzaurreak azpimarratzen duenez , « Europako Kontseiluak uste du agiria hitzarmenean sartu beharko litzatekeela , indar legala izateko Europako Batasuneko agintarien gainean eta edozein herritarrek auzitegietara jotzeko oinarria izan dadin » .	azpimarratzen	2	Imp
ETBtik botatzean akaso saltzaile sartuko naiz .	sartuko	4	Prosp
Ezkerreko oposizioak , orohar , bere posizioak mantendu ditu 6 Estatu federatutako hiri nagusietan .	mantendu	7	Perf
Aurtengo ere baikor agertu da azken bost urteotako txapelduna :	agertu	3	Perf
Gainera , berritasun bat aurkeztuko dute Ogeta pilotalekuko lehiak .	aurkeztuko	4	Prosp
- Macarena Browni Panotxa deitzen zioten .	deitzen	4	Imp
Afaldu ondoren , literetan etzan ziren .	Afaldu	0	Perf
Zaleen inguruan sortu den alarmari buruz zer deritzozu ?	deritzozu	7	Prog
Denboraldi polita egiten duen jokalariak klub boteretsuenen eskaintza izango du etxeko atarian , baina gutxi gailentzen dira izarrez beteriko talde horietan .	gailentzen	15	Imp
Gainera , entrenatzaile hauek prestijio handia lortu dute , eta iritsi dute orain urte batzuk Europa Ekialdeko entrenatzaileek zuten ospea .	iritsi	10	Perf
Zu kazetari bazina , nola kontatuko zenuke zure marka ahalegin bat ?	kontatuko	5	Prosp
" Zutikako emakume bat irudikatzen du .	irudikatzen	4	Imp
Errepide ugari moztu zituzten manifestariek , eta denda eta lantegi asko itxi .	moztu	2	Perf
Zein talde iristen da hobeto derbira ?	iristen	2	Imp
Oraindik ibili badabiltzan taldeetan , ordea , izan da estreinurik , eta gauza ez dago hain geldi , ez behintzat Hego Euskal Herrian .	badabiltzan	2	Prog
" Gure arropa guztiak aitak aukeratu eta erosten ditu " .	erosten	7	Imp
Ikerketatik ateratzen dituen datuetatik prozesu bat irekiko duela espero da , hilketa hauen arduradunak auzipetzeko .	ateratzen	1	Imp
Litekeena da Liga hasiera ez jokatzea .	Litekeena	0	Prog
Kevin Keagan Ingalaterrako hautatzaileak zerrendatik kanpo utzi du Andy Cole , " lesio txiki bat duelako " .	duelako	15	Prog
Athleticek utzita Osasunan den atzelariak adierazi zuen Real Madrili " errespetu handia " diotela , baina Osasunak bere jokoa egiten badu menpean hartuko duela .	diotela	13	Prog
Kontratua berritzen ez badu baztertuta egongo da urte guztian .	berritzen	1	Imp
Bera ere urduri zegoen , gero autortu zuenez :	autortu	6	Perf
Munduarentzat ez da eskaintzen soluziorik .	eskaintzen	3	Imp
Victor Alexander-en fitxaketa ere gertu egon daiteke ; datorren astean Gasteizen izan dezake Ivanovicek .	datorren	8	Prog
Dino Zoff hautatzaile italiarra saiatuko da hura gelditzen , eta ohiko taktika defentsiboa zelairatuko du :	zelairatuko	13	Prosp
Egun batzuk hilik zeramatzala , paperik ez zeuzkan gizon baten gorpua topatu zuten .	zeuzkan	7	Prog
Milaka herritar ihes egiten saiatu ziren , eta Diliko portuan pilatu ziren .	pilatu	10	Perf
Pentsio asegurua , adibidez , zeinen kuotak enpresaburuek eta enplegatuek berdin ordainduko dituzten , kapital finkoko aseguru pribatu batekin osatu ahal izango da ; jakina , soil-soilik enplegatuen kontura izango da .	ordainduko	11	Prosp
Ba , nahi niken sinets nazan , ez dinat batere senditzen , hau ez dun bestea bezain sineskorra .	senditzen	10	Imp
1973ko irailean estatu kolpea egin eta ondoren egindako krimenengatik epaituko luke , ziurrenik , Juan Guzman epaileak .	epaituko	9	Prosp
Nazioarteko komunitateari Irango Gobernuaren jarrera gaitzesteko eskatuko dio Tel Avivek .	eskatuko	6	Prosp
Norbanakoan iniziatiba hartzen dute , eta ongi egokiytzen dira .	egokiytzen	7	Imp
Amaren hilobian norbait zegoela ohartu nintzen , eta zuhaitz baten atzean kokatu nintzen .	kokatu	11	Perf
Funtsean , lege arrazista da , poliziari neurriz gaineko ahalmenak ematen dizkio , nahi duen eran iharduteko .	ematen	10	Imp
Naturarekin harremanetan , 630 mtako altueran dago , han eta hemen Ullibarriko urtegira doazen errekatxoek zeharkatzen dutela .	doazen	13	Prog
Zer gertatzen da ?	gertatzen	1	Imp
Lege horrek EAEren autogobernua murriztuko duela dio .	murriztuko	4	Prosp
Maratoia irabazi duenaren berri ere banuen .	banuen	5	Prog
Miel Saralegik Aian ( Gipuzkoa ) ondu zuen azken marka , 327 kiloko koadroarekin .	ondu	6	Perf
Eta arriskuetatik zure burua gordetzen ikasi duzula ere seguru nago .	ikasi	5	Perf
Inter Milanek jokalaria urtebeterako uztea litekeena da , lesionatu zenetik " etsita " baitabil Ronaldo .	litekeena	5	Prog
Emakumeak gutun bat igorri zion Baraki hori jakinaraziz .	igorri	3	Perf
Alanbre gainean higitzen ziren harriz edo bolaz osatuta zegoen eta zenbakien balioa , haiek okupatzen zituzten posizioen bidez markatzen zen .	okupatzen	14	Imp
Denbora luzez lanean ari diren leku ezberdinetako arduradunak ez ditugu ezagutzen " .	ezagutzen	10	Imp
Jokalari nafarra Basurtuko ospitalean dago , eta bertan egongo da lauzpabost egunetan .	egongo	8	Prosp
Horregatik , argi eta garbi esan zuten atzo borrokari eutsiko diotela haurra EEBBetan gera dadin .	eutsiko	9	Prosp
Gaur beste batzuk ikusiko ditugu .	ikusiko	3	Prosp
Jakina da Alexandru Buliganek erlijio ortodoxoaren garizuma errespetatzen duela , eta dagoeneko hiru aste daramatza haragia , arrautzak eta esnerik probatu gabe .	daramatza	14	Prog
Oraingoan erreaktoreko ontzi barnean dagoen kupeltxo bat aldatuko dute , zartatuta baitago .	baitago	11	Prog
- Badago gizon argi bat , aski daukana .	Badago	1	Prog
" Frano Botica asmatzen hasi da , puntuak batu ditugu , eta uste dut ekipo handia daukagula erakutsi dugula " .	daukagula	16	Prog
Zehazki , itunak dio ehundaka militar jugoslaviar Kosovoko mugak zaintzera bueltatuko direla eta beste batzuek monastegi ortodoxoak zainduko dituztela .	bueltatuko	10	Prosp
Halako hanketako mina zeukan ... !	zeukan	3	Prog
Zulueta abokatuak , berriz , Ruiz Polancok atxilotu bat mehatxatu duela esan zuen eta delitu den ikertzeko ekinbideak hastea aztertuko dutela .	aztertuko	19	Prosp
Errealitatea , fotografikoki , jadanik agortu eta erreportajea ` hil delako ` sentimenduak flotatzen du " .	flotatzen	13	Imp
Goizean Errioxakoak atseden hartu zuen , eta , gauzak ondo badoaz , hurrengo egunetan normaltasunez arituko da .	badoaz	10	Prog
Pepita Sagastume Etxabe izan zen aza-falta erremediatu zuena eta hegazkin batean ibili zen lehen pertsona ; horra hor hegazkinetako neskei esaten diegun " azafata " hitzaren jatorria .	erremediatu	6	Perf
Bestalde , bi aktoreek Pere Planella zuzendariaren lana azpimarratu zuten , esperientzia handiko gizona baita antzerkigintzan .	azpimarratu	8	Perf
Momentuz Euskal Herri mailan funtzionatzen du taldeak , baina gure lana urrunago zabaltzeko asmoa daukagu , Pirineotara esaterako .	funtzionatzen	4	Imp
Realeko zuzendaritzak baieztatu zuenez , hurrengo lau denboraldietan ariko da Asper Realean .	baieztatu	2	Perf
Ez dira erabat zokoratu Greg Lemond , Bernard Hinault , Giusseppe Saronni , Francesco Moser , Freddy Maertens , Luis Ocaña , Txomin Perurena , eta , besteak beste , Eddy Merckxsen lorpenak .	zokoratu	3	Perf
Badakizu , hemen ez dute nahi inork bere burua aparkalekuko bosgarren pisutik kalera bota dezan .	Badakizu	0	Prog
Nabarmendu direnetan , sona handiko - dirutza pilatu dutela esan nahi baita beti edo gehienean - , zenbait euskaldun ditugu kontsolagarri .	Nabarmendu	0	Perf
Egun , neurri batean behintzat , euskal gizarteak Euskal Selekzioaren kontzientzia barneratu du .	barneratu	11	Perf
EZLN Askapen Nazionalerako Armada Zapatista orain sei urte sortu zenetik lehen aldiz onartu du Mexikoko Armadak talde paramilitarrak badaudela Chiapasen .	sortu	8	Perf
Saiakera-liburuak eta literatur lanak ere sartzen ditugu hemen interesgarriak direlakoan .	sartzen	5	Imp
Horrela , lokal eta instalazioak ixteko ordutegia ondoko kasuetan haundituko da :	haundituko	9	Prosp
Joan behar dinagu ikustera !	dinagu	2	Prog
LAU egun iraungo du konbentzioak , eta EEBBetako errepublikanoak euforiko eta konfiantzaz beteta agertu dira azaroan lehendakaria aukeratzeko egingo diren hauteskundeak irabazteko dituzten aukerekin .	iraungo	2	Prosp
Honek baditu hasieran esan bezala gutxienik bi erantzun neuropsikologiko .	baditu	1	Prog
ETAren helburu dela esan dio Iragik Ruiz Polancori , eta honek erantzun dio epaile ez balitz " muturra hautsiko " liokeela .	hautsiko	18	Prosp
Irabazlearen izena datorren urteko udazkenean jakingo da , Moskun egingo den bozketan .	datorren	2	Prog
Lehen unean , CDU oposizioko alderdi kristau-demokrata oso gogor mintzatu zen aukeratutako inmigrazioaren aurka , eta bere liderretako batzuek nahiko adierazpen xenofoboak egin zituzten .	mintzatu	9	Perf
Bakea sinatu arren , ordea , Etiopiak kontrolpean izango ditu iparraldeko frontean berreskuratu dituen lurraldeak eta Zalambessa hiria .	berreskuratu	12	Perf
Konturatu da bera ere eta bere egoera fisikoari buruz " zalantzak " dituela aitortu zuen atzo , partiduetan " gehiago " nekatzen delako .	nekatzen	21	Imp
Gouloumetek gidatu zuen aitzinekoen jokoa .	gidatu	1	Perf
Segidan , ordea , asaldatu egin zen hura gogoratu izanaz eta gupidarik gabe oldartu zitzaion gogoeta tankera hari .	oldartu	13	Perf
Gutako bi erretiratzera baikoaz .	baikoaz	3	Prog
Umeentzako jolasa asmatu du Ormaiztegiko Zumalakarregi Museoak .	asmatu	2	Perf
Sasoi betean iritsi da Jokoetara , eta aurkariei ez zien inolako aukerarik eman .	iritsi	2	Perf
Bitartean , Kakotx , nire xakurtxoa ferekatzen dut eta bere askaria ematen diot .	ferekatzen	6	Imp
( Jeikitzen da , denbora berean Anne-Sophie sartzen da eta dozier bat bulegoan finkatzen , biziki eman behar du , ANPEn bezala ) .	Jeikitzen	1	Imp
Lehen taldearekin denboraldi aurre txukuna egin ondoren Racingen aurka debutatu zuen bigarren zatia aurrea zihoala .	debutatu	9	Perf
Autora iritsi nintzenean , portua itxita zegoen , eta lanera bueltatu behar nuen .	iritsi	1	Perf
Nazabalek aitortu zigun ez dagoela zutikakoak ebakitzera ohituta :	aitortu	1	Perf
Argi izan behar dugu ez direla egoera haiek berriro egokituko , baina , oraindik irauten duena mantentzen eta galdu denaren alderdirik baliagarrienak berreskuratzen saiatu beharko genuke .	egokituko	9	Prosp
FIFAk Sun Wen txinatarra aukeratu du inoizko jokalaririk onena .	aukeratu	4	Perf
EAJko bozeramailearen aburuz , " bai PPk , bai PSOEk elkarrizketa zertan datzan ez daukate batere garbi .	datzan	12	Prog
Garaieraz 1,75 metro inguru kalkulatu zizkion .	kalkulatu	4	Perf
Jojo badator .	badator	1	Prog
Andra Mari Zuriaren txapelketan , aldiz , finalerdietan gurutzatuko dira , lehenbizikoz .	gurutzatuko	8	Prosp
Garciak ez du oraindik sinatu , baina ahozko akordio batera iritsi da Paredes Movel taldearekin .	sinatu	4	Perf
Thomas Keneally 1935ean jaio zen , eta Sydneyn hazi eta hezi zen .	hezi	10	Perf
Oso jendetza handia bildu zen Mauleko industrialde inguruan moldatutako zirkuitoaren inguruan eta prologo hau goizago egiteak aurtengo ikusleen kopurua handiagotu zuen , ziur aski .	handiagotu	19	Perf
Gauzak ondo badoaz , Orbaiz Basurtuko ospitalean egongo da aste bukaera arte .	badoaz	2	Prog
Lortutako garaipenez ere gozatuko dut .	gozatuko	3	Prosp
Jatorriz tunisiarra zen , baina 1982az geroztik Luxenburgoko herritargoa zeukan Neji Bejaui 39 urteko gizonezkoak , hegazkin bat bere esku ezartzeko eta Libiara eramateko exijentzia egin zuen .	zeukan	9	Prog
Ane Aristi begira dagokio .	dagokio	3	Prog
Izenburu hori duen liburua idatzi du Hughesek , aldizkariko arte kritikariak :	idatzi	4	Perf
Gaur egun , ofizialki , Turkia demokratikoki hautatutako Gobernuak eta Parlamentuak gidatzen duten arren , militarrek dute azken hitza gai nagusietan .	gidatzen	11	Imp
Kinder Boloniak , bitartean , hiruko jaurtiketen bidez eusten zion markagailuko berdintasunari .	eusten	8	Imp
Hainbat zale gaurko partidua zapuzten saiatuko direla zioen zurrumurruak eragindako oihartzunarekin kezkati azaldu zen Miguel Angel Lotina .	saiatuko	5	Prosp
Horien arabera , Foxen hauteskunde kanpaina finantzatu zuten enpresari handien interesak izango dira gobernu berriaren lehentasuna .	finantzatu	6	Perf
FONTCUBERTAren hitzetatik jalkitzen den pesimismo hori errealitatea agortu delako uste horrek probokatua dago , beharbada .	jalkitzen	2	Imp
Errusiako itsas armadak ukatu du Kursk-eko hilotzak utzi eta ezkutuko agiriak berreskuratzen ari direla .	ukatu	3	Perf
Bapatean , ama hizketan hasten zitzaidala nabaritu nuen , ezinezkoa zen , erotzen hasia nintzen , harri bat hartu eta uretara bota nuen .	nabaritu	6	Perf
Zergatik bueltatu haiz horra ?	bueltatu	1	Perf
Beldurra ematen dioten bakarrak itsasertzetik hurbil dabiltzan marrazoak dira .	dabiltzan	6	Prog
" Egin diren txosten polizialek ez dute oinarririk , ikusten da loturarik ez dagoela , baina hala ere prozesuarekin jarraitu nahi dute " Izkok dioenez .	Egin	1	Perf
Ni baserrian konzentratzen naiz ondoen .	konzentratzen	2	Imp
Halaber , beste hondamendi ekologiko bat izan daitekeen gertaera honek polemikak sortu ditu mundu politikoan , eta hainbat salaketa ere plazaratu dira .	sortu	11	Perf
Ondorioz , Kubako federazioek kirolariak esportatu dituzte beste herrialdeetara .	esportatu	5	Perf
Atlantara irabaztera joan nintzen , Europako eta Munduko txapeldun izatetik netorren .	netorren	10	Prog
Etika medikoak , ordea , haien izenak ematea eragozten digu .	eragozten	8	Imp
Atzerritarrek ez dute inoiz derbia guk bezala sentituko .	sentituko	7	Prosp
Jokoan Zaragoza baino askoz gehiago izan ez bazen ere , Osasunak arrisku gehiago sortzen zuen aurrealdean , eta atsedenaldira gol bateko abantailarekin joan ziren Lotinaren mutilak .	joan	22	Perf
Maitalearen itzulerak , baina , jelosiaz pozoitu zuen haren bihotz apurtua .	pozoitu	6	Perf
Eta pentsatzen du konponduko dela arazoa :	konponduko	3	Prosp
Lehenik 10.000 baimen banatuko dira , eta beste hainbeste geroago .	banatuko	3	Prosp
AUSTRIAKO Gobernuan kalapita biziak sortu dira azken garaiotan Joerg Haiderren FPOEko mutur eskuinekoen eta Wolfgang Schuessel kantzillerraren kontserbadoreen artean .	sortu	4	Perf
Dominak banatzen ari zirela nire izebak galdetu zidan :	galdetu	6	Perf
Kokotean zeuzkan orain lau txima luze eta zepilo bitxia gandorrean , fijadorez orrazten zuena .	orrazten	12	Imp
Non dagoen jakin , badaki , egunero ikus dezakelako eguraldi mapetan - alderdi popularrari ez zaio hori ongi iruditzen - , baina ez pentsa , Iparraldeko euskal mundu zaleok , beste askorik dakienik Hegoaldeak zuetaz .	dakienik	32	Prog
Victoria Sauk patriarkatua honela definitu du :	definitu	4	Perf
Hamabost doinu dakartza diskoak .	dakartza	2	Prog
EHren testua ez zen eztabaidatu , EAJ , EA , PSE eta PPk beste agiri bat onartu baitzuten .	onartu	16	Perf
Defentsa Ministerioko sei agintari kargugabetu dituzte .	kargugabetu	4	Perf
" Bi herrialdeen artean estradizio itun bat badago , pentsatzekoa da estradizioa onartzera doan herrialdeak bere erabakia justifikatuko duela , nazioartean agerian uzten ari delako bere erantzukizuna eta sinesgarritasuna " .	badago	7	Prog
Kilometro askotako erradioan dagoen guztia suntsitzen du bonba horrek , eta argitasunak , 30 kilometrora dagoen jendea itsutatzen du .	suntsitzen	5	Imp
Baina uste dut etxera heltzen naizenean hasiko naizela seigarren postu hau gozatzen .	hasiko	6	Prosp
ACB txapelketan dagoen joko maila Gorizian Italian jokatu zuenean ikusi zuela adierazi zuen :	dagoen	2	Prog
Denbora luze honetan inork ez nau izan buruan , nik ere ez dut inor bilatu .	bilatu	14	Perf
Hanud-ek ihes egin zuen , ordea , eta Palestinako Poliziari errenditu zitzaion .	errenditu	10	Perf
" Oso azkar korritu da " .	korritu	3	Perf
Espainiako merkatuan sortzen den lehen kooperazio aliantza da hau , eta datorren hilabeteetan beste hiri batzuetara hedatzeko asmoa du .	sortzen	2	Imp
Joan den urtean Tourreko irteeran egoteko aukera genuela esaten aritu zitzaizkigun , eta , azkenean , ez ginen egon .	genuela	7	Prog
Anstey pibot osoa da , eta bete-betean sartzen da Baskoniak nahi duen jokalari ereduan .	sartzen	7	Imp
Beraz , historiako bigarren Kopa eskuratu zuen , 1937an bereganatu baitzuen aitzinekoa .	bereganatu	9	Perf
Labezomorro bat pasa da bere aurrean , patxadaz , inguruarekiko axolagabe , eta amonari konplize irribarre bat marraztu zaio aurpegian .	marraztu	17	Perf
Kordoba eta Valdepeñasko etapetan hartu zuen oporralditxoa ahaztuta , temati agertu da Eolo jainko indartsua azken hiru egunetan eta gogor zigortu ditu tropeleko txirrindulariak .	agertu	10	Perf
Ez zuten atzeko koadroetatik inoiz barkatu , eta bakoitzak bere aukerak bikain profitatu zituen .	barkatu	5	Perf
Guzti honez gain , perkusio instrumentuak jotzeko aukera ere badu umeak goiko argazkian ikusi daitekeen moduan .	badu	9	Prog
Red Globaliaren kasuan , zentro bakoitzak kudeatzeko independentzia edukiko du .	edukiko	8	Prosp
Laburbiltzeko asmoaz , aztertu ditugun gramatika-ezaugarrien eta sintaxi-arauen erabileraren hasiera 4. taulan datatuko dugu haurrez haur .	datatuko	12	Prosp
Landare nagusiaren inguruan sortzen diren landaretxoak askatu edo ebaki eta landatu .	sortzen	3	Imp
Bilkura " pribatua " eta " ateak itxirik " zela abisatu zuen argi eta garbi , bilkura tokia eta ordua sekretupean atxikirik .	abisatu	10	Perf
Sofritu dute , baina sofritu beharra dago uztartze ona ukaiteko .	Sofritu	0	Perf
Urtarrilean nahasmendu guztia iragan zenean , gorantz egin genuen , eta Tolosari irabazi egin genion .	iragan	3	Perf
Tropelak 128 kilometroko ibilbidea osatu beharko du , eta lau aldiz igoko dute Garateko gaina .	igoko	11	Prosp
Ni nahiko gustura ibili naiz , batez ere Melcior Mauri taldean genuelako , eta horri esker karrera onak korritzen genituelako .	genuelako	11	Prog
( Eli eta printzea elkarren aurrez aurre gelditzen dira poliki-poliki ilunduz doan bitartean .	gelditzen	7	Imp
Ordezkariek aurkeztutako ia berrehun zuzenketak hitzartu egin dira azkenik , eta ponentziari erantsiko zaizkio .	erantsiko	12	Prosp
Bulegoetan gizon trebea , 1980ko uztailaren 16an NOBko presidente aukeratu zuten .	aukeratu	9	Perf
Medikuarekin daukagun tratua ez dela berdina denontzat .	daukagun	1	Prog
Bestalde , Izeta II.ak 24 jasoaldi egin zituen 100 kiloko zilindroarekin minutu batean , eta Dolararen marka ondu zuen , Aizarnazabalen .	ondu	17	Perf
Dopatzen diren atleta asko ez dituzte atzeman Sydneyn .	Dopatzen	0	Imp
Mendia gustatzen zaiolako eta mendiaren inguruko gaietan ezagutza haundiagoa izateko sartu zen erreskate taldean .	gustatzen	1	Imp
Ikusteko dago indizeek gorako bideari modu sendoagoan helduko dioten .	helduko	7	Prosp
Ohi ez bezala , irailean ekin zion denboraldiari , anaia Nartxi zenaren Oroimenezkoa prestatzeko , eta hura irabazita , prest da marka ontzeko .	zenaren	11	Prog
- esaten dit Elorrik - .	esaten	1	Imp
Epaiak lesio delitua leporatu dio , soldadu batek zauriak jasan zituelako .	leporatu	3	Perf
XVII. eta XVIII. mendeetan elektrizitate mota bi ezberdintzen zituzten zientzilariek .	ezberdintzen	7	Imp
Eta aurrean kolpea eman behar denean , kolpea ematen du .	ematen	8	Imp
Gogo izpirik ez daukat !	daukat	3	Prog
EHEren ustez lege honek " lurraldetasuna ukatzen digu eta hizkuntz politika ere , eta euskaldunok ezin dugu gure borrero eta Justizi Administrazioarekin kolaboratu " .	ukatzen	6	Imp
Dolore luzeak izpiritua erabat mehetzen , sentiberatzen , fintzen du .	mehetzen	4	Imp
Guardia Zibilak legez kanpoko 75 etorkin atzeman ditu Cadizen .	atzeman	6	Perf
Partidu Popularreko parlamentarioaren aburuz , " ez da normala ETB Espainiako Erregearen Gabonetako mezua eskaintzen ez duen Espainiako telebista bakarra izatea .	eskaintzen	14	Imp
Gozatu Errastiren partidutzarrarekin , gozatu Elkororen defentsarekin , gozatu Unanuek pilotaz dakien guztiarekin , baina , batik bat , gozatu Augusto Ibañez Titin III.arekin .	dakien	11	Prog
Denek agertu dute egonezina .	agertu	1	Perf
Bestetik , azken jardunaldietan presioa ukan dugu bizkar gainean , eta beste behin , hala izango da ; ohituta gaude .	ukan	5	Perf
Goizeko eguzkiak bristadak jaurtitzen ditu horma eta zutabe gardenetan zehar .	jaurtitzen	3	Imp
Maticek erakutsitako bideo batean , lau atxilotuetako batek dio Milosevic bahitu nahi dutela eta gaizki irtetekotan , presidenteari lepoa moztuko diotela .	moztuko	19	Prosp
Indartsu netorren , erritmo on samarrean .	netorren	1	Prog
Dirua nabarmen irten zen Doneztebeko txapeldunaren alde , baina ez zuten inondik ere asmatu .	asmatu	13	Perf
Pinocheten figurak ordezkatzen duena ordezkatzen duela , txiletar guztiak berdinak garela legearen aurrean " .	ordezkatzen	4	Imp
" Ibarretxeren jokabideak errepublika bananero batena ematen du .	ematen	6	Imp
Lagunari zuzendu mezuak dituzu , ez buruzagiari .	dituzu	3	Prog
Frantziako lur bideetako rallyen proba nagusia bihurtu den Gailurretako Rallyaren faborito nagusiak izango dira aurten ere pilotu zuberotarrak .	bihurtu	6	Perf
Amak Kim Min-Sook du izena eta etxeaz arduratzeaz gain , ezpain-margoak gordetzeko kutxak egin eta saltzen ditu .	saltzen	15	Imp
" Argi baheukan bidali behar hiola , zergatik ez hintzen igandean bertan hartarako bideak bilatzen hasi ?	baheukan	2	Prog
Bertan , aditz-aspektu-markek , subjektuarekiko pertsona-komunztadura-markek , zehar-osagarriarekiko pertsona-komunztadura-markek , osagarri zuzenarekiko pertsona-komunztadura-markek , denbora-markek eta modu-markek , haur guztiengan agerrera mailakatua dutela baieztatzen digute .	baieztatzen	23	Imp
" SUHILTZAILEEN proba bat izan zen , eta , hortaz , pistaren miaketa atzeratu egin zen " .	atzeratu	13	Perf
Presoen gaia " agenda politikora itzultzeko beharra " azpimarratu du EHk .	azpimarratu	8	Perf
Berriro ere Aitor Mendiluzek eman zuen nota Loidisaletxerekin egin zuen saioan ( maitasun mezuarekin Aitor bidali eta Loidisaletxeri neska konkistatzen dionean ) .	konkistatzen	19	Imp
Intentsitateak diodoa zeharkatuko du eta sarrerako tentsioa irteeran agertuko da .	zeharkatuko	2	Prosp
Iruñetik emitituko da ETB1ko meza .	emitituko	1	Prosp
Hurrengo orrialdeko marrazkiei begirada bat botatzen badiezu eta arretaz irakurtzen baduzu alboan duten testua , erraz ulertuko duzu nola gertatzen den fosilizazioa .	irakurtzen	9	Imp
Maila handiko hiru proba hauetan , Tourreko zuzendariei urteko probarik garrantzitsuenean lekua badutela erakusten saiatuko dira .	saiatuko	14	Prosp
- Non jarriko duzu ?	jarriko	2	Prosp
Batik bat gauza bat deskubritu zuen hark :	deskubritu	4	Perf
Halere , bigarren zatian taldea hobeto ikusi zuen " aukera garbirik sortu ez arren " , eta " Lehen Mailari eusteko arazorik ez " dutela izango aurreratu zuen .	aurreratu	26	Perf
Argi esan zuen " ondorioak larriak " izango direla " Jasser Arafat PAN Palestinako Aginte Nazionaleko lehendakariak bortizkeria eteten ez badu " .	eteten	18	Imp
Aitzin multzo haustailea eta bultzatzailea du , baloi asko irabazten dute , eta defentsa zorrotza dute " .	irabazten	9	Imp
Luzapenak konfiantza emango dit :	emango	2	Prosp
Kirol hizkuntza berria asmatu dute .	asmatu	3	Perf
Oso gazte hasi ginen intsumisoan , eta atxiloketak ezagutu ditugu , eta desobedientzia soberanistan ere atxiloketak eta epaiketak izan zitezkeela uste genuen .	ezagutu	8	Perf
Noiz zian hori ?	zian	1	Prog
Eta zergatik ez zatoz Talgoan ?	zatoz	3	Prog
Josu Urrutiak talde bakarra ezagutzen du :	ezagutzen	4	Imp
Israel " besoak gurutzatuta " ez dela geratuko ohartarazi zuen .	geratuko	7	Prosp
EEBBetako Justizia Gorte Gorenean aurkeztuko dute auzia , Kendall Coffey abokatuak azaldu zuenez .	aurkeztuko	4	Prosp
Halere , Mindegiari ongi datorkio lan hori .	datorkio	4	Prog
Eta denona esaten dugunean printzipioz Espainia eta Frantzia ez dugu kontutan hartzen .	esaten	2	Imp
Aurreko atalean ikusi eta ikasi duzunarekin , seguraski bereiziko dituzu jadanik nahastura homogeneoak eta heterogeneoak .	bereiziko	8	Prosp
Ez dut sekulan gehiago hemen zangorik sartuko !	sartuko	6	Prosp
Une honetan harremanak etenda daude Realari dagokionez , eta orain Sportingek eman beharko du hurrengo urratsa benetan Sa Pinto fitxatu nahi badu .	dagokionez	6	Prog
Hasiera batean ia astakeria hutsa zirudiena , iraganarekin puskatzeak dakarren ohiko prozesuaren bidez , ideia hunkigarria bilakatu zen bere buruan .	dakarren	9	Prog
Albertini eta Deschamps txartel banarekin iritsi ziren finalerdietara , baina ez zieten besterik erakutsi .	iritsi	5	Perf
OHIKO estatistiketan lekurik ez duten arren , etxekoek bortxazhartzen dituzten emakumeen kopurua izugarria da .	bortxazhartzen	8	Imp
Mendiko kirol desberdinetan ezagutza eta esperientzia maila bat eskatzen da .	eskatzen	8	Imp
" Jokaldi batek erabakiko du derbia " .	erabakiko	3	Prosp
RICARDO SA PINTOK datorren denboraldian Lisboako Sportingen jokatu zuela pentsatzen genuen guztiok , baina une honetan Lisboarako bidea erabat zaildu zaio Realeko aurrelariari .	zaildu	19	Perf
Jakina da Alexandru Buliganek erlijio ortodoxoaren garizuma errespetatzen duela , eta dagoeneko hiru aste daramatza haragia , arrautzak eta esnerik probatu gabe .	errespetatzen	7	Imp
Banatze edo dibortzio tramiteetan dabiltzanen kasuan %60k onartzen dute .	onartzen	7	Imp
Aldiz , etxe barruan ditugun landareek lurretik elikatzeko aukera oso mugatua dute eta ematen zaizkien elikagaiek segurtatuko dute beren etorkizuna .	segurtatuko	16	Prosp
PTri dagokionez , bigarren txandatik landa , 300 udalerri gobernatuko dituela aurrikusten da , gaur egun 107tan gehiengoa daukarik .	daukarik	18	Prog
Baina Susako Iñigo Aranbarrik - eta irakurri zutenean literario bezala definitu zuten .	definitu	10	Perf
Azpi-atal honetan , arakatu gura dugun fenomenoaren konplexutasuna ikusirik , datuen erakusketa beste era baten antolatuko dugu .	antolatuko	15	Prosp
( Eli eta printzea elkarren aurrez aurre gelditzen dira poliki-poliki ilunduz doan bitartean .	doan	11	Prog
UPN eta PSNk aurretik adostua zuten datorren urteko aurrekontu testua eta CDNk ez zuela inoren proposamenik sostengatuko iragarri zuen .	datorren	6	Prog
Gainera , Baltikoko herrialdeek gehiago haserretu dute Mosku , Europako Batasunean eta NATOn sartzeko zerrendetan baitaude .	haserretu	5	Perf
Delitu mota horregatik zenbait urtetako espetxe zigorra ere aurreikusten du zigor kodeak .	aurreikusten	8	Imp
Oraindik ez dira ezabatu , sekula ez ezabatzeko moduan utzi baitzituen itsatsirik memorian , Mi-guel Indurainen balentriak .	ezabatu	3	Perf
ez zukeen golik sartuko " .	sartuko	3	Prosp
Alga usainaren ausentzia dastatu zuen airean , eta beste itsaso baten nostalgia .	dastatu	3	Perf
PP utzi bakean Euskal Herria zioen pankarta atzean EHko hainbat ordezkari bildu ziren .	zioen	5	Prog
Erakundeak PPren agindupean daudenetik " atzerapausoak " egin direla esan zuen , eta erakunde horiek eraikuntza nazionalaren alde jartzeko eskatu zuen .	daudenetik	3	Prog
Polarizazio zuzenean 0,7 V inguru markatzen du , eta alderantzizko polarizazioan zirkuitu irekia .	markatzen	5	Imp
Portland Trail Blazerseko jokalariak partidu handia egin zuen Los Angelesen 22 puntu , 6 errebote eta 4 txapel , eta bere taldea 88-96 nagusitu zitzaion Lakersi .	nagusitu	23	Perf
Itsasoa haserre zegoen eta zerbait arraroa nabaritu nuen nire hanketan .	nabaritu	6	Perf
Gaur amaituko da itzulia , eta Plazak 42 segundoko aldea du Klodenekiko .	amaituko	1	Prosp
Aldi berean , lanera bidean zihoazen beharginei erreparatu zien , eta haiengan antzeman zuen alaitasunaz hunkiturik , zera deliberatu zuen bere artean :	erreparatu	7	Perf
Guztira 75.000 langilek dihardute EAEko sektore publikoan , eta 18.000 beharginek Nafarroan .	dihardute	3	Prog
zaudezte ezkont-agentzia bat Garazin , ezin da .	zaudezte	0	Prog
Jose Inazio oroitzen da 1968ko abuztuaren 2an hartu zuela lehenbizikoz txistua eskuetan , 14 urte zituelarik .	zituelarik	15	Prog
Gauza bera korsikar edo bretoi baten eskubideen errespetua galdegiten delarik .	galdegiten	8	Imp
Irabazlearen izena datorren urteko udazkenean jakingo da , Moskun egingo den bozketan .	jakingo	5	Prosp
Niretzat garbi zegoen , ordea , oheburuko leihoari zegokion kontraleihoa hormaren kontra erabat zabalduz gero , bi oinera geldituko zela tximistorratzaren hagatxotik .	zegokion	8	Prog
Garaipen horrek konfiantza handia emango lioke taldeari .	emango	4	Prosp
Gaztea inkomunikatu egin zuten eta arratsaldeko zortziak aldera bere etxea miatu zuten .	miatu	10	Perf
Roberto Laiseka azken bi kilometrotan ahalegindu zen Morellako aldatsetan .	ahalegindu	5	Perf
" Aitzinean asmatzen badu txanza ukanen du " .	asmatzen	2	Imp
Bi makila luze elkartzen dituen soka eta diaboloa bera nahikoa dira arratsalde entretenigarria pasatzeko .	elkartzen	3	Imp
- Altdorfer , zuk zerbait ezkutatzen diguzu .	ezkutatzen	5	Imp
Indarkeriaren inguruan egin zuen gaitzespena bereziki eskertu zion Miguel Buen PSE-EEko bozeramaileak Suduperi .	eskertu	6	Perf
Alemanian etorkinentzako aterpetxeak atentatuz erre egiten dituztela eta Austrian antzeko gertakaririk ez dela izan azpimarratu zuen .	azpimarratu	14	Perf
Hiru egunez inkomunikatuta eduki zuten , eta Ertzaintzaren aurrean onartu ez bazuen ere , epailearen aurrean kutxazainari su eman izana onartu zuen , eta berak bakarrik burutu zuela ekintza esan zuen .	burutu	26	Perf
Zabortegiari zegokionez , aurreko egunetan izandako istiluengatik edo , bazirudien agintariak ez zirela aurrerapausorik ematera ausartzen .	ausartzen	15	Imp
Kantuetako batean Maiderrek maitasunezko bere amets bat kontatzen du ; beste batean , berriz , pertsona bat jadanik hamaika urtez berarengandik urruti bizi delako pena azaltzen .	kontatzen	7	Imp
Beste taldea plaza guztian zehar banatzen zen ( gaurko beisbol partiduetan bezala ) .	banatzen	5	Imp
Urduri hasten dela , erritmoa hartzea kosta egiten zaiola aitortu zigun .	hasten	1	Imp
Alustiza eta Rai pixka bat esnatu ziren bukaerarako , baina ezin izan zuten 17tik haratago joan .	esnatu	5	Perf
Gatazka politikoa badagoela esan zuen , halaber .	badagoela	2	Prog
Sezerrek kritika gogorrak jaso zituen , " Errepublikaren arerioen aurka bigunegia " izateagatik .	jaso	3	Perf
Hori dela eta , betiko Chinatown auzoaz gainera , badago beste Chinatown bat Clement kalean , jatetxe etnikoz betea , Golden Gate parkearen ondoan .	badago	9	Prog
Ireki orduko zimeltzen dira .	zimeltzen	2	Imp
Ruiz Polancok esan zuen ez dela esandakoaz damutzen .	damutzen	7	Imp
Akordio historikoa izan zen , bi herrialdeak gerra egoeran daudelako 1953tik .	daudelako	9	Prog
Gainera , atzo Betoñun egindako lan saioan errekuperazio lanetan aritu zen batik bat Alaves eta ez zen ikusi gaur zer-nolako taldea zelairatu dezakeen .	zelairatu	21	Perf
izenburuko liburukote hartan murgildurik , Cherbourg herriaren izena bilatu zuen lehendabizi , eta bere maiteñoaren Leblanc abizena gero .	bilatu	8	Perf
Biolentzia beraz egon badago , gure herria zapaltzen duten estaduek erabiltzen dutena .	badago	3	Prog
Amsterdamen 2:06 egitetik zetorren .	zetorren	3	Prog
BEFESA Medio Ambiente enpresak 2.100 milioi pezeta ordainduko ditu Erresuma Batuan birziklatze planta bat erosteko .	ordainduko	7	Prosp
Ameriketara joan zen .	joan	1	Perf
Matematika da gehien gustatzen zaiona .	gustatzen	3	Imp
Kilometro askotako erradioan dagoen guztia suntsitzen du bonba horrek , eta argitasunak , 30 kilometrora dagoen jendea itsutatzen du .	dagoen	3	Prog
Gainera , krisitik ateratzeko Ernesto Zedillo egungo lehendakariak hartutako neurriek , egoera ekonomikoa onbideratu duten arren , areagoatu egin dute aberatsen eta pobreen arteko jauzia .	onbideratu	13	Perf
Hil honen 24ean hauteskundeak dira Jugoslavian eta Slobodan Milosevic presidenteak uste du indar erakustaldi batek botoak emango dizkiola .	emango	16	Prosp
Badaude profesional onak ere , eta hauekin harreman onak dituzte .	Badaude	0	Prog
Alberto , neska kotxera hurbildu bitartean leihoa ireki gabe mantendu da segundo batzuetan , ustekabea dela eta nahiko aztoratua .	mantendu	9	Perf
Armiarma andreak badu errurik , .	badu	2	Prog
- Gaur hobeto zaude , ez ?	zaude	3	Prog
Sudupe nahikoa haserreturik agertu zen errepiken txandan eta ez PPri ez PSE-EEri ez zitzaiola gustatu esan zion Olanori .	agertu	3	Perf
Guk errespetua diegu Alaveseko jokalariei , eta giro kontuak baztertu egin nahi ditugu .	diegu	2	Prog
Garzonek " terrorismoa , genozidioa eta torturak " egotzi zizkion Pinocheti eta Espainiara estraditatzeko eskatu zuen .	egotzi	8	Perf
MAIATZAREN 28ko hauteskundeen ondoren , Nafarroako Parlamentuan mapa politiko berria agertuko da , batez ere CDNren partehartzeagatik .	agertuko	10	Prosp
Goizean defentsa arloko neurriak hitzartuko dituzte - erantzun azkarreko indarrak eta NATOrekiko harremanak - , aurreikuspenen arabera , eta arratsaldean orain arte gatazkatsuen izan diren auziei helduko diete :	hitzartuko	4	Prosp
AIk exijituko du aldaketak nazioarteko arautegiaren barruan egiteko .	exijituko	1	Prosp
Gorpua besarkatu eta muxukatu nuen , berriro bizitza eta zoriontasuna itzul zedin .	besarkatu	1	Perf
Litekeena da beren epaia datorren astean kaleratzea .	datorren	4	Prog
Materia mota baten propietate guztiak gordetzen dituen materia-zatirik txikienari molekula deitzen zaio .	deitzen	10	Imp
Astearte goizeko 09:00ak irian , La Hagueko portura erremolkatzen zutelarik hondatu egin zen kimika gaiak zeramatzan ontzi italiarra 70 metroz itsas barnean dago .	erremolkatzen	8	Imp
Ildo berean , COAGek ere gaurko bileran erabakiko du protesta egutegia hilabete honetarako .	erabakiko	7	Prosp
Baina zorionez , birako lehen egunetan gutxi gora-behera perfilatua neukan zer egin nahi nuen , eta orduan , koadernoko apunteak horretara bideratuta zeuden hasieratik .	neukan	9	Prog
Sarri hurbiltzen zen " haren " landarera , Andreasen presentzia somatzen zuen , bizitzaz blaituriko haren pentsamenduak sentitzen zituen .	somatzen	10	Imp
Asetu da .	Asetu	0	Perf
Bahametako taldeko kideek ez zuten alferrik abisatu .	abisatu	6	Perf
Horretarako , Nazio Batuek iragarri dute Gobernu berriak errolda irekiko duela serbiarrek izena eman dezaten , eta hiru komunitate serbiarretan berriro deituko dituztela bozak .	irekiko	9	Prosp
Azken bi hamarkadetan munduko kirola kontrolpean izan dute , baina Samaranchen agurrarekin aro berri bat zabalduko da .	zabalduko	15	Prosp
Zergatik daukazue aurpegia zuri ?	daukazue	1	Prog
RTR telebista kateak zabaldutako irudietan , Serjent-Iurtez jabetu diren soldadu errusiarrek gerrilla txetxeniarraren kanpaleku bat atzeman zuten herri hau inguratzen duen oihanean ezkutaturik .	inguratzen	19	Imp
Hasiera baten beldurra bazuten ere gogoz ebatu diote proiektu berriari .	ebatu	6	Perf
Garaiko kalkuluek , hiru egunetan 4.800 aza jan zirela esaten dute .	jan	7	Perf
Aurretik ere urteetan sufrimendu handia eragin duen gatazka izan da Ekialdeko Timorkoa .	eragin	5	Perf
Delitu larriak egin dituztenak , ustelkeria , mafia eta " terrorismoarekin " zerikusia dutenak , ez lirateke kartzeletatik irtengo .	irtengo	18	Prosp
Baina kide ez direnak badira bortxatzen , holakoen batasuna laster da eteten .	bortxatzen	5	Imp
Ipar eta Hego Koreak komunikatu bateratua argitaratu dute elkarlaguntza sendotuko dutela esanez .	sendotuko	9	Prosp
Jan Kirsipuu * Larre motzean ohitutako gizona da , eta joan den denboraldia arte ez zen esprinter handien artean aintzat hartzen , baina Tourreko lehen etapa irabazteak ireki zion atea .	joan	10	Perf
Sakea hanketara jarri zion Lizasori , dejadaz bikain moldatu zen unerik aproposenetan , jo behar zuenean jo eta lasaitu behar zuenean lasaitu , teknika eta taktika erakustaldia egin zuen Zeberiok .	moldatu	8	Perf
Lapa antzeko oskol baten azpian babestuta bizi eta ugaltzen da .	ugaltzen	8	Imp
Emeki-emeki Baturantz idekitzen hasten dira .	hasten	3	Imp
Zortzi silaba horiekin moldatzen gara bertsolariok herri batetik aldegiterakoan , ezer berririk bururatzen ez bazaigu .	bururatzen	12	Imp
Berdin zait lagunek , Gorkak eta eskolakoek zer dioten .	dioten	8	Prog
Desiok pase bikaina sartu zion sakonean Djolongari eta honek lehen ikutuan erdiratu zuen , Iodik bere atean sartu zuelarik baloia hurrentzen ahalegindu zenean .	erdiratu	11	Perf
Buffonek selekzioan titulartasuna kendu izana ez du ondo irentsi Inter Milaneko atezainak , eta uko egin zion Eurokopari :	irentsi	8	Perf
Gaur egun gehien zabaldu eta onartu den definizioa Osasun Mundu Erakundeak garatu duena da .	garatu	11	Perf
Lopez de Uraldek azpimarkatu zuenez , " Madrilen , hondakin tona baten kudeaketarako aurrikusitako kostua 2.000 pezetakoa da banatu eta birziklatzen baldin bada " .	azpimarkatu	3	Perf
Datuek ez dute bakartzen .	bakartzen	3	Imp
Ivanovicek eskatu diezaiokeena ez dakien arren , entrenatzaileak eskatzen dion lanera egokitzeko inolako arazorik ez duela aurreratu zuen Mindaugas Timinskasek .	dakien	4	Prog
Bizkaieraren apartekotasunak harrotzeari eta handitzeari ekin zitzaion , gainerako euskalkiekin batzen zituen ezaugarriak alde batera utzi eta haiengandik banatzen zituenei lehentasuna emanez .	batzen	10	Imp
Lander - Elizegi bikoteak erraz gainditu zuen Goikoetxea - Aranburu bikotea ( 35-17 ) .	gainditu	5	Perf
- " El Vergel " egoitzako sukaldeko buruari esleitutako lanpostuko osagarria , gaur egun plantila organikoan esleitua daukanari gehituko zaio .	daukanari	17	Prog
Azken aldian aurrelari den luzaidarra ez zen katxaratu , ordea , gerriko minez zelako , eta Tirapu aritu zen haren ordez .	katxaratu	7	Perf
Euskal Rock Topaketa burutuko da Lekunberrin datorren apirilaren 20an .	burutuko	3	Prosp
" Presoen eskubideen urraketa salatzen jarraituko dugu , eta kartzelan dauden gizon-emakumeen aurkako indarkeria mota horri gure ustez babesa ematen diotenak seinalatuko ditugu " .	seinalatuko	21	Prosp
Gehienak etxera joan ziren , prestatuta zuten jaia ospatzeko gogorik eta motiborik ez zutelako ; eta telebistaz Rijkaardek selekzioa uzten zuela entzun behar izan zuten .	zutelako	13	Prog
Brivek ederki erasotzen zuen aitzin-multzoarekin , primeran gidatzen zuelarik Carbonneau uztartze erdiak , eta Lamaisonek erraz irabazten zituen metroak hankarekin , eta Baionako ohiak sei puntu egin zituen jaurtiketetan .	gidatzen	7	Imp
Bururatu zaiguna isladatu dugu , eta benetan , lagungarria izan dadila .	Bururatu	0	Perf
... - agurtu zuen magoak - .	agurtu	2	Perf
Barriro dinot parekotasun eta lehia handiko partidua izango dela .	dinot	1	Prog
Euskadi taldeko zuzendaritzak dimisioa aurkeztu du .	aurkeztu	4	Perf
Gero ikusiko da zer gertatzen den , baina nik ez daramat aldez aurretik ideia jakinik .	ikusiko	1	Prosp
Zelai hondotik pilota gogor kolpatuz , eragozpenik gabe gainditu du bigarren koska Flushing Meadowsen .	gainditu	8	Perf
Batzuek , egungo instituzioei muzin egitea leporatu diote , beste batzuk demokrazia eta legearen kontra jotzea , gehienek mamu sezesionista edo independentziaren beldurra astindu dute .	astindu	23	Perf
Zer dakizu disoluzioez ?	dakizu	1	Prog
Azken laurdenean ez zuten bota lortutako aldea , eta defentsa oinarritzat hartuta norgehiagoka apurtu zuten .	apurtu	13	Perf
Laguntzera etorriko ziren zaletu guztien aldean geunden .	geunden	6	Prog
Athleticeko presidenteak helburu aberatsak ditu hastear dagoen denboraldiari begira .	hastear	5	Imp
Esaterako , Urbil hipermerkatuaren aurkako helegite kontentzioso-administratiboa aurkeztu dute , proiektuaren kontra daudela salatzeko .	aurkeztu	7	Perf
- Ideia bat daukat !	daukat	3	Prog
Rositari gehien gustatzen zaizkion animaliak Australiako mendebaldeko pinguinoak eta fokak dira .	gustatzen	2	Imp
Red Globalia zerbitzu sarea sortu da Hego Euskal Herrian , Katalunian eta Madrilen .	sortu	4	Perf
ARMADA britainiarrak Ipar Irlandan dituen bi kuartel eta beste bi begiratoki eraisteko lanak gaur goizean hasiko direla iragarri zuten atzo iturri ofizialek .	hasiko	15	Prosp
Etxea berogailuz berotzen bada , uda parteko sistema erabili .	berotzen	2	Imp
Hala , haren aburuz , " miserable horiek babesten dituztenekin esertzen direnek , eurekin akordioak egiten dituztenek askatasunean eta demokrazian bizitzea merezi duen herri honen nahiak zapuzten dituzte " .	esertzen	10	Imp
Azken unean aurreratu zuen Dulecha etiopiarra .	aurreratu	2	Perf
Geuri dagokigunez , guk interes bikoitza daukagu hemen bakea lor dadin , bi aldeetan baikaude .	dagokigunez	1	Prog
Sinn Feinek jada iragarri du ez duela halakorik onartuko , aldi berean irlandarra zintzilikatzen ez bada .	zintzilikatzen	13	Imp
Gaur , ikertzaile ospetsuek kurtsoak eskainiko dituzte , eta hiru mintzaldi iraganen dira .	iraganen	11	Prosp
Deklaratu zuten PPko hiru batzarkideetatik bakarrak esan zuen " izutu " egin zela .	Deklaratu	0	Perf
Baina gehien kezkatu gaituztenak akordioa eta sor zitekeen egoera desitxuratzeko egin dituzten ahaleginak izan dira .	kezkatu	2	Perf
Atzo heldu ziren adostasunera Alavesekin , eta gasteiztarrek 60 milioi pezeta inguru jasoko dituzte .	jasoko	12	Prosp
VLADIMIR Putin presidenteak Defentsa Ministerioko sei jeneral kargugabetu zituen atzo , horien artean Anatoli Xatalov bozeramailea .	kargugabetu	7	Perf
Ez dinat gauza haundirik ikasi eskolan , bainan oraino gogoan dinat mediku baten istorio bat , eta esplikatzen zinan osagarri onean zirenak eri zirela ez zekiten batzu zirela .	ikasi	4	Perf
Honelaxe ikusmiran nenbilela , hara non irakurtzen dudan erdi aldeko kale batean :	nenbilela	2	Prog
Sydneyra iritsi zenean ez zuen konfiantza askorik bere indarretan Joane Somarribak , onenak emanda baitzituen jada .	baitzituen	14	Prog
Prozesuak aurrera jarraituta , Kongresuak onartuko balu genozidioaren aitorpena aldarrikatzen duen testua , Ankarak ohartarazi du gertakizun honek " ondorio larririk " izango lukeela Turkia eta EEBBen arteko harremanetan eta , gainerat , tentsio egoera handituko lukeela Kaukasoan .	aldarrikatzen	9	Imp
Hong Kongeko , EEBBetako eta Erresuma Batuko egunkariek informazio eta arrazoi desberdinak hedatu dituzte Gaoren kargu-uzteari buruz .	hedatu	12	Perf
" Osasuna oso talde sendoa da , izugarri diziplinatua eta atzean oso ondo aritzen dena .	aritzen	13	Imp
Valladoliden aurka aritu zen hamaikakoarekin alderatuz , hiru aldaketa egongo dira atzoko taldea zelairatzen badu :	egongo	9	Prosp
Beno , nik urte asko neraman kontzertuekin nazkatuta , beti betikoa ikusten .	neraman	5	Prog
Egileak dioenez , egungo gizakiok " gutxi entzuten dugu " , eta inguruko pertsonez " gutxi " arduratzen garela azpimarratzen du .	dioenez	1	Prog
Jendea , ordea , behera bota arte ez da ohartzen .	ohartzen	9	Imp
Ez dakinat , ene senarrak din hautatu .	hautatu	6	Perf
Zuzenketak aurkeztutako alderdiek hainbat arlotan sumatu dituzten " gabeziak " salatu zituzten :	sumatu	5	Perf
Europako Batzordeak , berriz , beste modu bat aholkatu zuen urtarrilean herritar kopuruarekiko proportzionaltasuna lortzeko :	aholkatu	8	Perf
Hanka erdian du , zilindrikoa da , zenbaitetan oinaldean erraboilduna , bikortsu-ezkatatsua , txapelaren kolore berekoa edo zertxobait argiagoa , oinaldea kotoitsua eta zurixka du , zenbaitetan hexagono forma duten eta ilunagoak diren mailek estaltzen dute .	estaltzen	34	Imp
Dimentsio hauetako bakoitza item zenbaiten bidez deskribatzen da eta formulazioa zein kopurua aldatzen dira neurketa tresna bakoitzaren arabera .	deskribatzen	6	Imp
Argi izan behar dugu ez direla egoera haiek berriro egokituko , baina , oraindik irauten duena mantentzen eta galdu denaren alderdirik baliagarrienak berreskuratzen saiatu beharko genuke .	genuke	25	Prog
Eta orain , zein aitzaki ipini behar dizuet nik ?	dizuet	7	Prog
Ezpainik mugitu gabe esaten ditu , barnerantz , bortizki , eta jendaurrean , Ako herri osoaren aurrean dioela sentitzen du .	sentitzen	18	Imp
Eztabaidatzeari uko egin eta biolentziaren bidea aukeratuta , mugimendu zapatistarekin amaitu nahi izatea leporatu zion Marcosek presidente ohiari .	leporatu	13	Perf
Hau guztia kondatzen zion bitartean , hiri barnera sartu ziren .	kondatzen	2	Imp
Ikerketa egileek , esaterako , ez dute ulertzen pneumatiko baten lehertzeak nolaz zulatu ahal izan zuen Concordearen hegal azpian kokatuta dauden kerosen ontzietatik bat .	ulertzen	7	Imp
" Proiektuaren barrutik , ikuspegi kritiko batekin aztertu behar dugu hau guztia , baina horretarako beharrezkoa da oinarrizko pentsamendua zertan datzan ikustea " .	datzan	20	Prog
Jugoslaviako lehendakaria ez ezik , Jugoslaviako Parlamentu Federala ere hautatuko dute serbiarrek eta montenegroarrek .	hautatuko	9	Prosp
Horrela lur berrian zainak erraz haziko dira eta pujatzea eta loraldia ez dira zapuztuko .	zapuztuko	13	Prosp
Pinocheten figurak ordezkatzen duena ordezkatzen duela , txiletar guztiak berdinak garela legearen aurrean " .	ordezkatzen	2	Imp
1997an Europako Kopa irabazi zuen Brive handia menderatu zuen atzo Bordeleko Parc Lescure zelaian , 24-13 irabazita .	menderatu	7	Perf
Eta Jacksoni azkar erantzun zion Pippenek :	erantzun	3	Perf
Horrela laburbiltzen du Salazarrek Guiñazuren bilakaera Gasteizen .	laburbiltzen	1	Imp
SEI puntuko komunikatua hitzartu dute Ipar eta Hego Koreako ministroek .	hitzartu	3	Perf
GREENPEACE talde ekologista Erandioko ( Bizkaia ) Sakoni ibarrean hiri hondakin solidoen tratamendurako eraiki nahi dituzten errausteko bi planten aurka agertu zen atzo , " errauspena hondakinak tratatzeko metodorik garestiena eta ingurugiroarentzat kaltegarriena " delako .	agertu	20	Perf
Uda-udazken aldean ateratzen da , bai silizezko lurraldeetan bai karezkoetan , eta hostozabalen azpian .	ateratzen	2	Imp
Emanaldi berezietan , aldiz , amankomunean hartu ohi zituzten erabakiak , beti ere Isidro izaten zelarik solas-kide eskatzaileekin eta hark aurkezten zuen taldeko iritzia .	aurkezten	20	Imp
Speight eta bere sei jarraitzaileren aurkako karguak aurkeztu dituzte .	aurkeztu	7	Perf
Saria eskuratu nuenean La Salle ikastetxean nenbilen 4. mailan .	nenbilen	6	Prog
Indarrarekin banago han izango naiz .	banago	1	Prog
Chavezen " iraultza baketsua " legitimatu dute venezuelarrek .	legitimatu	5	Perf
- Ala joan bazihoan ?	joan	2	Perf
Ez dakizu zein bilakaera izango duen norgehiagokak .	dakizu	1	Prog
Lanbrorik ez zegoen eta une batez hiriaren mapa imajinarioak diseinatuz amestu genuen , gure gogoko auzoak eginez itsasondoan edota muinoen inguruan .	amestu	10	Perf
Garciak ez du oraindik sinatu , baina ahozko akordio batera iritsi da Paredes Movel taldearekin .	iritsi	10	Perf
Pedro Azpiazu EAJko diputatuak adierazi du aurrekontua " goitik behera " eratu dela , lehen helburua defizitik ez izatea izanik .	eratu	11	Perf
Bi agintariek ekainaren 14an egin zuten goi bilera Piongiangen , Ipar Koreako hiriburuan , eta ituna izenpetu zuten .	izenpetu	16	Perf
Etxeko bandera masailean margotuta dabil jende guztia Sydneyn , eta norbere selekzioko kideren bat podiumera igoz gero , bizitzako pozik handiena hartu dutela ematen du .	dabil	4	Prog
Hala egingo balitz , Turkiari Batasuneko kide izateko aurrebaldintzatzat ezarriko lioke heriotz zigorra eta exekuzioak bertan behera uztea .	ezarriko	9	Prosp
Sanzen gobernuaren ustez , 1996ko Naturguneen Legea ez du kontuan hartu Gorenak , eta horretan Gobernuak ezabatu zuen 500 metroko kotaren babesgunea .	ezabatu	16	Perf
Iparraldeko alderdi sozialistak ere kritika bera jalgi du .	jalgi	6	Perf
Gure kasuan , garaipena eskuratzeko beharrarekin gatoz , sailkapenean gora egin eta lasaiago egoteko .	gatoz	6	Prog
Badu saltsa gaurkoak .	Badu	0	Prog
Hala , BEAk ikerketa egileek baietsi dute Air France konpainiako Concordearen lurreratze tresneriako pneumatiko baten lehertzea izan zela istripuaren lehendabiziko eragilea .	baietsi	5	Perf
Kanadako Normand Labrie irakaslea , berriz , Europar Batasuneko hizkuntzez mintzatu zen .	mintzatu	10	Perf
AZKEN zazpi hamarkadetan Mexikon izan diren hauteskunde bero eta erabakigarrienak egingo dira gaur , denbora horretan guztian lehendabiziko aldiz boterea galtzeko arriskuan baitago Alderdi Instituzional Iraultzailea ( PRI ) .	baitago	22	Prog
Carme Juyent irakaslearen ustetan , hizkuntzen %90 galduko dira .	galduko	7	Prosp
Nabarmendu direnetan , sona handiko - dirutza pilatu dutela esan nahi baita beti edo gehienean - , zenbait euskaldun ditugu kontsolagarri .	pilatu	7	Perf
Gero Boticak ongi asmatu dute , eta aitzin-multzoak ere lana beltz egin du .	asmatu	3	Perf
Guk gogoa jarriko dugu , eta erronkari aurre eginen .	eginen	8	Prosp
Bakoitzean 2 , 4 edo 6 pertsona sartzen dira .	sartzen	7	Imp
Partiduaren hasieran , baionesek beren gogo eta indar guziarekin , ongi eutsi zioten donostiarren jokoari .	eutsi	11	Perf
Gizonak argal egoten gara , gizentzen dira txerriak .	gizentzen	5	Imp
Oporretatik bueltan , Bilbokoak Lezaman zuzendu zuen lehen entrenamenduan bere asmoak argi eta garbi utzi zituen :	zuzendu	5	Perf
morala gizon guztientzat berdina bada , moral pertsonalik ez dago , natura propioari uko egitea bihurtuko da morala .	bihurtuko	15	Prosp
- Hire lagunak dituk .	dituk	3	Prog
Gaur estropada ona egin izanak konfiantza emango digu Kontxari begira .	emango	6	Prosp
Dozena erdi bat salaketa aurkeztu da .	aurkeztu	4	Perf
Dirudienez , Sportingek eskaintza berbera egin dio orain Realari , eta horrek eragin du Urangaren harridura eta haserrea .	eragin	12	Perf
Ez dakit , baina nire hankak ondo badaude , datorren urtean ere hor izango naiz " .	datorren	9	Prog
Baina pauso berri bat eman beharrean zaude , eta beharbada ondo etorriko zaizu berriro ere ikas-norabideari gainbegiratu bat ematea , atalez aldatu behar baituzu .	etorriko	11	Prosp
Ez da jangarria , zapore guztiz mingarra duelako .	duelako	7	Prog
5. Taulan jasotako datuak dituzula oinarri eta koordenatu kartestiarrak erabiliz , egizu prozeduraren grafikoa .	egizu	11	Prog
- Rocka biziki interesatzen zaik ala ?	interesatzen	3	Imp
Atzo sakean asmatu zuen bost tanto egin zituen , baina eskuinarekin ez du lehen adina gozatzen .	gozatzen	15	Imp
SOL MELIA ( - %0,87 ) hotel taldeak Madrilgo Tryp hotel taldea erosi du , 366 milioi eurotan .	erosi	12	Perf
Imazek Jaurlaritza aurrean egindako gaitzespen kontzentrazioan egin zituen adierazpenok , eta hildakoen senitartekoei " euskal gizartearen gehiengoaren elkartasuna " igorri zien .	igorri	19	Perf
Momentuz , emaidazu baso bat ur , mesedez .	emaidazu	2	Prog
Sumindurarekin batera , ordea , ihes egiteko premia bortitz bat sortu zitzaion , buruan zerabiltzanak isilarazi zizkiona .	zerabiltzanak	14	Prog
" Europakoa helduko da heldu den sasoian , baina garrantzitsuena gaur irabaztea zen .	helduko	2	Prosp
Jarduera honekin hasi aurretik egizu aurrekoan irakurritako testuaren laburpen bat .	egizu	4	Prog
Oso argi zuten Holanda finalean sartuko zela .	sartuko	5	Prosp
( Plaztikazko botoila pasatzen dio , besteak edaten du eta berriz botatzen ) .	botatzen	11	Imp
Diktaduran gertatutako urratzeen berri militarrek badutela esan dute giza eskubideen aldeko erakundeek .	badutela	5	Prog
1989. eta 1996. urteen artean bidaia gehiago egin zituen Salazarrek Argentinara , baina ez zuen jokalaririk ekarri .	ekarri	16	Perf
Eusko Jaurlaritzari dirua emateko orduan aurten Araba " kaltetua " izan dela defendatu zuen , eta an taldearen onura defendatu , EAEko Finantza Kontseiluan proposamen bateratu bat aurkezteko asmoz .	defendatu	12	Perf
Gai honetan , ateen bidez eginiko erabilpen anitzeko zirkuitu konbinazional sinpleen eraiketa edo garapena jorratuko dugu , diseinatzeko gaitasuna lantzeko asmoz .	jorratuko	14	Prosp
Han zebiltzan Haimar Zubeldia , Euskal Bizikletako garailea , etorkizun aparta duen txirrindularia .	zebiltzan	1	Prog
Txondorra pizteko kendu egiten da , uzten duen zuloan txingarra sartuz .	uzten	6	Imp
ZURE HERRIAN EDO HURBILEAN ERE IZANGO DA , NOSKI , KALE EDO ESTATUAREN BAT NORBAITEN OMENEZ .	IZANGO	5	Prosp
Kilometro askotako erradioan dagoen guztia suntsitzen du bonba horrek , eta argitasunak , 30 kilometrora dagoen jendea itsutatzen du .	itsutatzen	17	Imp
Mila milioi pezetako diru laguntza jaso du Nafarroako Gobernuak mahastiak berregituratzeko .	jaso	5	Perf
Jendeak ez daki kutsatuta dagoena .	daki	2	Prog
Jon Eizagirrek , sakean maisua dela erakutsiz , 14 tanto egin zituen , eta beste hainbat tanto hasieratik dominatu zituen jokaldi zital horri esker .	dominatu	18	Perf
Gustora egoteko moduko lana egin dut , baina laugarrengo postuak beti uzten dizu tristura bat , podiumaren atarian gelditzen baitzara .	uzten	11	Imp
Hiru herrialdeetan egindako iritzi ikerketen arabera , herritarren gehiengoa agertu da lurraldetasuna errespetatuko luketen egituratze administratiboen alde .	agertu	9	Perf
Oso gaztetatik datorkio xakeko zaletasuna .	datorkio	2	Prog
Ez dakinat , ene senarrak din hautatu .	dakinat	1	Prog
Eta neska horiek baditugu .	baditugu	3	Prog
Vitaliciok Giro honetan lortzen duen hirugarren garaipena da , eta hori ere oso garrantzitsua dela zioen :	zioen	15	Prog
- Baliteke horrela gertatu izana .	Baliteke	1	Prog
2005ean jarriko da indarrean AMLE , eta horregatik hartu dute Hego Amerikako agintariek hainbesteko presa .	jarriko	1	Prosp
- Eta Amsterdameko Taldea tartean dabil .	dabil	5	Prog
Beharbada , barnean zebilzkion oraindik emakume-belaunaldi zaharren mamuak !	zebilzkion	3	Prog
Okerrak oker , partida orekatua joan zen lehen zatian :	joan	5	Perf
Bururatu zaiguna isladatu dugu , eta benetan , lagungarria izan dadila .	isladatu	2	Perf
Pertsona batzuek baskula gainean sentitzen dutena .	sentitzen	4	Imp
Biktimek diotenez , « agintariek Mercedes autoak erosteko dirua badute , elbarrituei laguntzeko dirua ere izan behar dute » .	diotenez	1	Prog
Gizonak baditinagu .	baditinagu	1	Prog
Lehiarako agintariek ikertuko dituzten laguntzak 1995a baino lehenagokoak dira , gaur egun indarrik gabe daudenak .	ikertuko	2	Prosp
Ingelesez idazten duten egile australiar horien artean zenbait ospetsuak dira nazioartean .	idazten	1	Imp
Atzokoa ikusita , ez dago zalantzarik 2000-2001 denboraldia oso gogorra izango dela bi jokalarientzat egun Athleticekin duten harremana hobetzen ez badute .	hobetzen	18	Imp
Beraiek irabazten dutena , aldiz , diru kopuru izugarria da , kaleko entrepresekin berebiziko kontratuak dituztelarik .	dituztelarik	15	Prog
Odolaren urdinagatik , itxitura baten barnean babesten den jende-multzoa .	babesten	6	Imp
Bi zati hauek markaturik dauden tokietatik tolesten dira .	tolesten	6	Imp
" Ez dakit erabaki hori atzera botatzerik badagoen , baina nik behintzat azalpenak eskatuko dizkiot Verbruggeni , lehenbailehen " .	badagoen	7	Prog
Aznarrek , ituna adosteko denbora gutxi zegoela esan baitzuen , eta Alfredo Perez Rubalcabaren eskutik Aznarri helarazi genizkion proposamenak ez baitute oraindik erantzunik jaso " .	jaso	23	Perf
HAATIK , kondenatzen badute ere , Suhartok ez du espetxea ezagutuko , gaur egungo presidente Abdurrahman Wahidek aurretik iragarri baitu indultua emango diola .	ezagutuko	10	Prosp
EHren testua ez zen eztabaidatu , EAJ , EA , PSE eta PPk beste agiri bat onartu baitzuten .	eztabaidatu	4	Perf
Niretzat garbi zegoen , ordea , oheburuko leihoari zegokion kontraleihoa hormaren kontra erabat zabalduz gero , bi oinera geldituko zela tximistorratzaren hagatxotik .	geldituko	18	Prosp
Joan printzea naiz , ezagutzen ?	ezagutzen	4	Imp
Juanelek bikain zuzendu zuen kontraerasoa , eta baloia Montenegrori eman ondoren Jamellik bikain errematatu zuen argentinarrak egindako erdiraketa .	errematatu	13	Perf
Emaztea hil zen , gizona azkarki kolpatua altxatu zuten .	altxatu	7	Perf
Prozesuak aurrera jarraituta , Kongresuak onartuko balu genozidioaren aitorpena aldarrikatzen duen testua , Ankarak ohartarazi du gertakizun honek " ondorio larririk " izango lukeela Turkia eta EEBBen arteko harremanetan eta , gainerat , tentsio egoera handituko lukeela Kaukasoan .	onartuko	5	Prosp
BAT-BATEAN kazetari guztiak gainera etorri zaizkio Abadiñoko ziklista gazteari ( 27 urte ) , baina ez da ikaratu .	ikaratu	17	Perf
Dopatzen diren atleta asko ez dituzte atzeman Sydneyn .	atzeman	6	Perf
Beste finalista , bihar Eugik eta Aimar Olaizolak Urantzian jokatuko duten Asperen finaletik irtengo da .	irtengo	13	Prosp
Gainera , 2.000. urtean sartu diren diru partidak - dela Europatik lortutakoak , Diputazioen apartazioak edo tesoreriako soberakinak - datorren urteko aurrekontuari gehituko zaio .	gehituko	22	Prosp
Gaur egin diguten ongietorria eta han geundela jaso ditugun animoak horren seinale dira .	jaso	7	Perf
ETAren azkeneko ekintzak ikusita , aipatu kamisetak debekatu egin behar direla dio , " ETA ordezkatzen dutelako eta indarkeria bultzatzen dutelako " .	ordezkatzen	15	Imp
Horretarako , Nazio Batuek iragarri dute Gobernu berriak errolda irekiko duela serbiarrek izena eman dezaten , eta hiru komunitate serbiarretan berriro deituko dituztela bozak .	deituko	21	Prosp
Espainian prezio industrialak %5,9 igo dira iazko urritik aurtengora eta , hori , ez da berri ona .	igo	4	Perf
Iazko abenduaren 24an beste preso batzuekin furbolean jolasten ari zela belaunarekin kolpea eman zion ahoan HIESa zuen preso bati , eta ondorioz bera ere GIB birusaz kutsatu zen .	kutsatu	26	Perf
Konturatu da bera ere eta bere egoera fisikoari buruz " zalantzak " dituela aitortu zuen atzo , partiduetan " gehiago " nekatzen delako .	Konturatu	0	Perf
Gure begiradak gurutzatu genituen , eta gauza arraro bat sentitu nuen nire gorputzaren barrenean .	gurutzatu	2	Perf
Kantauriko arraina bereiziko lukeen etiketa sortzea proposatu die Eusko Jaurlaritzak beste erkidegoei .	bereiziko	2	Prosp
Texasetik etorri da astebete pasa lagunen etxera , baina jadanik ez dabil lagunekin , samoarrarekin baizik .	dabil	11	Prog
Badira onar daitezkeen gauzak , baina hiltzeko mehatxuak ez daude nire nominan .	Badira	0	Prog
( Irakurtzen du eta egoten da ixtant batez pentsakor ) .	Irakurtzen	1	Imp
Errusiako Atzerri ministroa Belgradera bidaltzeko prest zegoen joan den astean , baina Slobodan Milosevic Jugoslaviako presidenteak ezetz esan zion .	joan	7	Perf
Kontseiluak ez dituela ez delitu larrien egiletzat , ez terroristatzat jo ondorioztatu dute gaiari arreta handirik eskaini ez dioten egunkari frankofonoek .	ondorioztatu	11	Perf
Retegik tanto bikainak eta huts galantak tartekatu zituen .	tartekatu	6	Perf
" Salbatuko diren ustea dute han , oraindik konfiantza dute eta guztia ematera etorriko dira " , zioen Rosadok .	Salbatuko	1	Prosp
HAATIK , kondenatzen badute ere , Suhartok ez du espetxea ezagutuko , gaur egungo presidente Abdurrahman Wahidek aurretik iragarri baitu indultua emango diola .	emango	21	Prosp
Barne ministroak azpimarratu du delitu gehienak " propagandakoak " izan direla .	azpimarratu	2	Perf
Hala , viura eta mazuelo mahats motak kendu eta ardo hobea produzitzen dutenak landatuko dituzte nekazariek .	produzitzen	11	Imp
Sail honetan azterlan eta ikerlanak aurki ditzakegu , maila teorikoan edo enpirikoan alderdi zehatzak edo orokorrak aztertzen dituztenak .	aztertzen	16	Imp
Era horretan , ez zaie batere zaila egiten Kubako kirol agintariei lesionatutakoak , goi mailako lehiaketak utzi dituzten kirolariak edo desertatu dutenak ordezkatzea .	desertatu	20	Perf
1992koak ere antolatzear izan ziren , baina Bartzelonak irabazi zuen orduko bozketa .	antolatzear	2	Imp
Samways , berriz , partidu bateko zigorra bete ondoren , bihar berriro agertuko da .	agertuko	12	Prosp
Rifondazione Comunista alderdi politikoak amnistia emateko proposamena aurkeztu du Italiako Legebiltzarrean kartzeletako arazoari irtenbide bat eman nahian .	aurkeztu	7	Perf
Antzerkia , ontsa futitzen naun antzerki eta gainerateko literaturetaz , nahi niken egiazki arizan .	niken	11	Prog
" Gizon-emakume guztiak aske jaiotzen dira , eskubide berberak dituztela beti .	jaiotzen	4	Imp
" Komunikabideetan irakurri dut gu ez gaudela gustura Txomin Perurena eta Lakarekin " .	gaudela	6	Prog
Ogasun batzordearen datorren bileran finkatuko da ziurrenik lan taldea .	finkatuko	4	Prosp
Nago - xelebrekeria hau aipatuz bukatzeko - lehenengo eklogak , Miangolarraren itzulpenean , kolore etxetiar berezi bat hartzen duela :	Nago	0	Prog
EMISOREA ( E ) , elektroiak igortzen dituena eta gehien dopaturiko kristala da .	igortzen	6	Imp
Jose Felix Guerrero , Frederic Peiremans eta Mikel Antia entrenatu ez baziren ere , berri on bat izan zen atzoko lan saioan :	entrenatu	9	Perf
Bertan , orientazioa , sokak nola erabili , kamila , norbere erreskatea , hormetako erreskatea , helikopteroz erreskatea ... ikasi genituen .	ikasi	19	Perf
- Bi alderdien artean egin dituzuen ñabardurak ez ditugu onartzen .	onartzen	9	Imp
- Zergatik ez duk hurrengoan heure ur-pistola hori mozten eta ferietako edo festetako barraka horietakoren batean salgai jartzen ... ?	mozten	8	Imp
Ikerketatik ateratzen dituen datuetatik prozesu bat irekiko duela espero da , hilketa hauen arduradunak auzipetzeko .	irekiko	6	Prosp
Uste dut Europako Batasuna saiatzen dela zerbait egiten , baina ez die erantzuten gertaerei behar bezain sendo eta azkar .	saiatzen	4	Imp
Abuztuaren 31n sinatu zen ituna , ekialdeko Berlinen .	sinatu	2	Perf
Tabernan egongo zen emakume lizun batekin , edota agian , hiri honetatik at zegoen , edo inon ez .	egongo	1	Prosp
Txartel berdearen sistemak badu , ordea , koska bat :	badu	3	Prog
Bestalde , espetxean ikusi dut jende pila bat dagoela benetan ETArekin harremanik ez duena , eta horrek baieztatu dit zein den estatuen jarrera .	duena	13	Prog
Suedian , berriz , Haiderrek zioenez , neonaziak kalera ateratzen dira eta hori Austrian jazotzea " pentsaezina " litzateke .	zioenez	5	Prog
Lopez de Uraldek azpimarkatu zuenez , " Madrilen , hondakin tona baten kudeaketarako aurrikusitako kostua 2.000 pezetakoa da banatu eta birziklatzen baldin bada " .	birziklatzen	20	Imp
Jose Inazio oroitzen da 1968ko abuztuaren 2an hartu zuela lehenbizikoz txistua eskuetan , 14 urte zituelarik .	oroitzen	2	Imp
Baina Kohl izan zen orduan batasuna bideratu zuena .	bideratu	6	Perf
" Produktu ekologikoen kontsumorako kooperatiben antzeko zerbait martxan jartzen saiatuko gara .	saiatuko	9	Prosp
Guerrerok gehiegi gurutzatu zuen jaurtiketa , Urzaiz alboan bakarrik zuela .	gurutzatu	2	Perf
Baiezkoa nagusituko balitz , berriz , presio handia jasango lukete euroa txanpon gisa onartu ez duten Europako Batasuneko beste bi herrialdeek :	nagusituko	1	Prosp
Abrilek Entzutegi Nazionaletik atera zen auto bat grabatu zuen , eta epailearen ustez irudi horiek ETAri laguntza emateko zirela esateko zantzuak daude .	grabatu	7	Perf
Londresen 1908an jokaturiko maratoian Pietri italiarra arrastaka iritsi zen estadiora , konortea erdi galduta .	iritsi	7	Perf
Aldi berean , lanera bidean zihoazen beharginei erreparatu zien , eta haiengan antzeman zuen alaitasunaz hunkiturik , zera deliberatu zuen bere artean :	deliberatu	18	Perf
Guk kilometro asko daramatzagu denboraldi osoan eta azkenean indar falta somatu dut .	daramatzagu	3	Prog
oraingo bakerako baldintzak onartu behar dituzue , bestela zuenak egin du .	dituzue	5	Prog
Aznarrek bereari eutsiko dio legegintzaldia amaitu bitartean , PSOErekin edo gabe .	eutsiko	2	Prosp
Kontrakoa gertatuz gero , bide ematen da tiranoak eta martiriak beren horretan jarraitzeko .	ematen	5	Imp
Anoetako Belodromoan , pantaila erraldoitik , bi lagun zintzilikatu ziren , eta Euskal Presoak Etxera zioen pankarta bat jarri zuten .	zintzilikatu	8	Perf
Baina arrunt desonesta duk .	duk	3	Prog
Joseba Ostolaza zestoarrak baino hiru jasoaldi gehiago eta 675 kilo gehiago bizkarreratu zituen Goenetxok , lau harriekin hiru minutuko txandak eginda .	bizkarreratu	11	Perf
- Jakin ahal liteke zer ostu du , behintzat ?	ostu	5	Perf
Hiztegiak , entziklopediak , egunkariak eta multimedia paketeak topatzen ditugu CD-ROM hauetan .	topatzen	8	Imp
Villar Nafarroan da egunotan Nicolas Leoz , Hegoamerikako Futbol Konfederazioko presidentearekin ( Ledeako arbasoak dituelako omendu du Nafarroako Gobernuak ) .	omendu	15	Perf
Goiz hartan Xucekin hitzegin zuen eta elkarrekin joan ziren egunpasa .	joan	7	Perf
Bereziki azpimarratu zuen ez dela aldaketa ikusgarririk izango Kubaren diplomazian , lehengo ildotik jarraituko duelako , eta Kubako Atzerri Harremanetarako Ministerioko adituen esperientzia eta profesionaltasuna onartu zituen .	azpimarratu	1	Perf
Indar Gorri taldea ez zegoen bilera hartan , Abel Diaz taldeko bozeramaileetako batek aitortu zuenez inoiz ez direlako saiatu taldea peña bezala eratzeko beharrezkoak diren agiriak lortzen .	aitortu	13	Perf
Alanbre gainean higitzen ziren harriz edo bolaz osatuta zegoen eta zenbakien balioa , haiek okupatzen zituzten posizioen bidez markatzen zen .	higitzen	2	Imp
UPNko lehendakariaren arabera , " Allik bere egin nahi ditu UPNren lorpenak , baina ez du inor engainatuko " .	engainatuko	17	Prosp
Eskuan zituen kartak mahai erdira bota eta kamastran eseri zen .	eseri	8	Perf
Honelaxe ikusmiran nenbilela , hara non irakurtzen dudan erdi aldeko kale batean :	irakurtzen	6	Imp
Jantzi ederrek , baina , ez dute nahitaez gorputz osasuntsua apaintzen .	apaintzen	10	Imp
Ekaitza mendi aldera baztertu zen eta haizea jotzen hasi zen .	baztertu	3	Perf
Froga-aldia amaituta , interesdunak dioena entzungo da , Administrazio-Ihardunbideari buruzko Legeak ezartzen duenez .	ezartzen	11	Imp
Napoliko erregeordea zen Lemosko kondearen idazkari izan zen eta , bere anaia Bartolomek esaten duenez , erre egin zituen bere poemak hiri hartan .	esaten	13	Imp
Okindegien usaina somatzen dut eta buru makur pasa behar umeen askari goxoen aurrean .	somatzen	2	Imp
Euskararen erabilerari dagokionez , honako hau izan daiteke ondoriorik garrantzitsuena :	dagokionez	2	Prog
Andereñoa ez zen harritu Jontxu hain alai ikustean , eta ez zuen ezer susmatu .	susmatu	13	Perf
Baiezkoa nagusituko balitz , berriz , presio handia jasango lukete euroa txanpon gisa onartu ez duten Europako Batasuneko beste bi herrialdeek :	jasango	8	Prosp
Iragan urrian 90.000 afiliatuen kopurua gaindituta , datozen lau urteetarako 100.000ra heltzeko helburua finkatuko du Kongresuak .	finkatuko	13	Prosp
- " El Vergel " egoitzako sukaldeko buruari esleitutako lanpostuko osagarria , gaur egun plantila organikoan esleitua daukanari gehituko zaio .	gehituko	18	Prosp
" Jendea gustora etortzen dela ikusi dugu eta horrek asko animatu gaitu " .	animatu	10	Perf
Abelek sarritan erabiltzen zuen , eta Ionek ere bai , batzuetan hori iruditzen zitzaion behintzat .	iruditzen	12	Imp
Bai eguraldi adituak , bai LASEMeko zientifikoak ohartu ziren kutsadura geruzatik 1,5 kilometrora hurbiltzean usain garratz bat oso nabari zela , eta hauen iritzian , styreno produktu kimikoarena zen .	ohartu	7	Perf
Zu zaude isilik !	zaude	1	Prog
Iaz Athleticek irabazi egin zigun Mendizorrotzan , eta Europara begira zegoen ; eta gu beherago geunden sailkapenean .	geunden	15	Prog
Ez primadera izan behar zunan .	zunan	4	Prog
Data zehazteke dago oraindik , baina asteburu honetan ez hurrengoan izango da Eibarren .	zehazteke	1	Imp
Minduta zegoen entrenatzaile iruindarra , baina ederki zekien zertaz ari zen .	zekien	7	Prog
Urriaren 3tik aurrera Alemania bat izango zela hitzartu zen .	hitzartu	7	Perf
Jokalari zuhurra da golak sartzen dakiena .	dakiena	5	Prog
Hondoratu zen unetik , 250 metroz higitu da itsasontzia .	Hondoratu	0	Perf
Txapelketa hasi aurretik Iñaki Altunak , Nuarbeko entrenatzaileak , zalantza zuen 560 kiloetan zer neurri emango zuen taldeak , gutxi aritutako tiralari bat sartu zuelako .	emango	15	Prosp
Defentsan ongi birkokatzen dira , eta horregatik , uste dut arazoak sortuko dizkiola Tolosari .	sortuko	11	Prosp
Liberalizazio hori gauzatzen denean , Iberdrolak hiru urte barru gas hornitzaile izateko asmoa dauka .	gauzatzen	2	Imp
Txapelketa larunbatean hasiko da , ekainaren 3an , Orkoienen , eta finala , berriz , uztailaren 7an jokatuko da , Iruñeko Labriten .	hasiko	2	Prosp
Elvis elizpetik irten zenean , alabaina , atzetik joan zitzaion don Meliton :	joan	8	Perf
Hainbat eleberriren egilea da - dozenatik gora - eta horien artean Itsas barneko emakumea , Odol gorria eta aipatua dugun Schindlerren untzia dira .	dugun	19	Prog
Neuk sendatuko zaitut !	sendatuko	1	Prosp
Hala ondorioztatu zuen atzo Eduardo Stein Guatemalako Atzerri ministro ohi eta OEA Amerikako Estatuen Erakundearen Peruko bozetarako misioko buruzagiak .	ondorioztatu	1	Perf
Erabilpenaz landara , inkestak beste datu batzuek ere azaleratu ditu .	azaleratu	8	Perf
" Egin diren txosten polizialek ez dute oinarririk , ikusten da loturarik ez dagoela , baina hala ere prozesuarekin jarraitu nahi dute " Izkok dioenez .	dioenez	24	Prog
Hobeto ikusteko itxura eginez , gorputza aurreratzen du , beharrik ez izan arren , ongi baitaki Marietta baten erretratuaren fotokopia erakusten ari zaiola .	aurreratzen	6	Imp
Baina oskolak baditu bere eragozpenak .	baditu	2	Prog
Badakit zer datorren " .	datorren	2	Prog
Bestetik , datak ez du atzerapenik , eta hartzera behartuta zaude .	zaude	10	Prog
Francine-k itxaroten zuen galdera hau , aurrekoa entzun ondoren .	itxaroten	1	Imp
- Baina sekula ez baduzu ikusi , nola dakizu emakumezkoa dela ?	dakizu	8	Prog
Sarri hurbiltzen zen " haren " landarera , Andreasen presentzia somatzen zuen , bizitzaz blaituriko haren pentsamenduak sentitzen zituen .	hurbiltzen	1	Imp
" Tiroketaren arrazoia edozein dela ere , horrelakoak gertatzea ahalmentzen duten egoerak konpondu behar ditugu , gehiago gerta ez dadin " .	ahalmentzen	9	Imp
Nafarroako Gobernuak 1.115 milioi pezeta jaso ditu Espainiako Nekazaritza Ministeriotik herrialdeko mahastiak berregituratzeko ( 44,6 milioi libera ) .	jaso	5	Perf
Hegoaldean iduri zait euskararen mundu hau adi-adi dagola , Euskaltzaindiak zer erranen duen zain , haren arauen berehala betetzeko .	erranen	11	Prosp
EPOa igartzen duen test berria atzo aurkeztu zioten zientzialari australiarrek NBOri .	aurkeztu	6	Perf
Liga hasi aitzin NBAn hautsak harrotu ditu , Isiah Rider jokalari polemikoa fitxatuta .	harrotu	5	Perf
Inkomunikazio epea luzatzen ez badiote , gaur eramango dute epailearen aurrean deklaratzera .	eramango	7	Prosp
Lau multzo nagusi bereiziko ditugu :	bereiziko	3	Prosp
Atzerapenak atzerapen , bere egunean han geuden kideok egin genizuen proposamena onartu duzuela irakur dezaket bertan ... .	geuden	6	Prog
Bide luzea eta gogorra bete du Carmonak lehen mailara iritsi arte , baina ondo merezitako saria jaso du .	jaso	16	Perf
Asperren kasua emeki-emeki aitzinatu bada ere , Sa Pintoren etorkizuna fite argituko da .	argituko	11	Prosp
Autoak N-1etik bideratu zituen Ertzaintzak , autopistatik ibiltzea ezinezkoa baitzen .	bideratu	2	Perf
Bazekiten zer esaten ari ziren .	Bazekiten	0	Prog
Oraindik ere zalantzak badituzu eta gai honi buruzko guztia argi ez bazaizu geratu , ez kezkatu gehiegi , ondorengo jardueretan egindako lanekin ondo ulertuko baitituzu aipatutako kontzeptuak eta erabilitako metodoak .	ulertuko	23	Prosp
ETAren atentatuak mundu osoan salatuko ditu AIk .	salatuko	4	Prosp
Hauteskundeak egiteko Federazioak onartu zituen datak ere " estuegiak " zirela argudiatu zuten lau pilotazaleek .	onartu	3	Perf
Ez dugu ahantzi , baina aitzinean hobeto lotuko gara .	ahantzi	2	Perf
Urteak joan dira eta erreferenduma ez da egin , ordea .	joan	1	Perf
Iritzi kontrajarriak sortu zituen berriak .	sortu	2	Perf
batzuk lurrindu egiten dira berotzen direnean , beste batzuk apurtu edo eraldatu , edo aldaketa kimikoak jasan ditzakete .	berotzen	4	Imp
Apika nehoiz ez zatzait lotu zure barneko hedea .	lotu	4	Perf
Antequerak ez du Joseba Beloki Sidneyra eramango .	eramango	6	Prosp
Egun , Hego Amerikako herrialdeak batzen dituzte bi egitura daude :	batzen	5	Imp
Aste honetan ofentsiba zorroztu du talde armatuak .	zorroztu	3	Perf
Angramain , galtzaile zara , bete zeure hitza , itzul herria , zoaz kanpora !	zoaz	12	Prog
Defentsan ongi birkokatzen dira , eta horregatik , uste dut arazoak sortuko dizkiola Tolosari .	birkokatzen	2	Imp
AUGUSTO PINOCHET Txileko diktadore ohiak senadore foruari eutsiko dion edo ez erabakiko du gaur Gorte Gorenak .	eutsiko	7	Prosp
PTri dagokionez , bigarren txandatik landa , 300 udalerri gobernatuko dituela aurrikusten da , gaur egun 107tan gehiengoa daukarik .	gobernatuko	9	Prosp
Frantxua Maitia sozialistak " mementoz Gobernua korsikar aferarekin " ari dela argudiatu zuen eta Hego Euskal Herrian dagoen bortizkeria egoera eta " Espainiak Euskal Departamendurik sor ez dadin egiten duen presioa " azpimarratu zituen .	argudiatu	11	Perf
Ia buruz zekien .	zekien	2	Prog
Elurretan oinatzak denboraren poderioz elurrez estaltzen dira , edo denbora aurrera joan ahala urtu egiten dira elurrarekin batera .	estaltzen	5	Imp
Hor nonbait , liburuetan edo ideien mundu platonikoan , edertasun osoz dirdiratzen da oraindik zoroastrismoa , baina gure eguneroko mundu latz honetan ez du predikamendu praktikorik .	dirdiratzen	11	Imp
Beste zaurituei dagokienez , herenegun gauerako beste bik jaso zuten senda-agiria , eta zortzi gelditzen dira hainbat erietxetan ingresatuta .	gelditzen	14	Imp
Txosten horrek dioenez , " emakume horietariko gehienak beren senitartekoen biktimak dira , berariaz edo arduragabekeriaren ondorioz , emakume izate hutsagatik hiltzen baitituzte " .	dioenez	2	Prog
Euskalaritzari zuzen-zuzenean lotzen bagatzaizkio , ostera , gertaera bi dira nahitaez nabarmendu beharreko .	lotzen	2	Imp
Gizonezko bat hil duela ukatu du LVF talde armatu loialistak .	ukatu	4	Perf
Horri lotuta , EITBk 4.500 milioi pezeta inbertitu ditu datozen hiru urteetan bertako ekoizpenak sustatzeko ( 180 mila libera ) , eta Euskal Herriko ekoizpena gehitzeko ahalegina egingo dute .	inbertitu	7	Perf
Ahmet Necdet Sezer presidenteak , ostera , bitan bota zuen atzera dekretu hori , iritzi baitzion garrantzi horretako gai batek Legebiltzarraren oniritzia behar zuela .	iritzi	14	Perf
Mephistok arrakastaren truke bere burua Alderdi Naziari saltzen dion pertsonaia bat erretratatzen du .	erretratatzen	11	Imp
Azken 30 urteotako gatazkan RUCeko 302 agente hil eta 8.000tik gora zauritu dira .	zauritu	11	Perf
Ez die arnasik ematen kontrarioei , ez ikusleei .	ematen	3	Imp
Bestetik " eraso guztiei tamainako erantzuna " emateko beharra aipatu zuen , eta alderdi , sindikatu eta eragile sozialei arduraz jokatzeko eskatu zien .	aipatu	9	Perf
Fijiko botere judizial berriak talde armatuen kide izatea eta legez kanpo biltzea leporatu die kolpistei .	leporatu	12	Perf
Zu , azpian zaudela , sentsazio desberdinak izaten dituzu :	zaudela	3	Prog
" Jerusalemeraino eskuan harriak daramatzaten haur palestinarrei ez diete betilerik mugituko helikopteroek .	mugituko	10	Prosp
Aurreko atalean ikusi eta ikasi duzunarekin , seguraski bereiziko dituzu jadanik nahastura homogeneoak eta heterogeneoak .	ikasi	4	Perf
Edurnezuri printzearekin ezkondu zenean , zazpi ipotxek edateari eman zioten .	ezkondu	2	Perf
Lana egiten badu , zigor osoari egunak kentzen joango zaizkio , epe jakin batetan , egun batzutako baimenarekin kalera irtengo da , eta azken finean , zigorraren erdia " ordainduz " , behin betiko kalera irtengo da .	irtengo	35	Prosp
Kezka horren berri gaurko akziodunen biltzarrean agertuko du Oriolek .	agertuko	6	Prosp
" Bi herrialdeen artean estradizio itun bat badago , pentsatzekoa da estradizioa onartzera doan herrialdeak bere erabakia justifikatuko duela , nazioartean agerian uzten ari delako bere erantzukizuna eta sinesgarritasuna " .	doan	13	Prog
Nazioarteko erakundea kezkatuta azaldu da , botoak zenbatzen ari diren eraikina Ekialdeko Timorko hiriburuan dagoelako .	dagoelako	14	Prog
) obrak aurkeztu zituen .	aurkeztu	2	Perf
Bere iritziz , kartzelak hustu arren , arazoek bere horretan segituko dute .	segituko	10	Prosp
Arauaren aldaketaren ondorioz , %5 hori %8ra pasatzen da ekoizpen naturala saltzen duten nekazaritza eta basoko ustiapenak dituztenei eta %7 abeltzaintza eta arrantza ustiapenak dituztenei .	dituztenei	17	Prog
Deklarazioek 15ean amaitu behar zuten , baina gaurko deituta zeudenak 22a arte atzeratu dira .	atzeratu	12	Perf
Alaitzek , berriz , afrikar emigranteen penak azaltzen du pieza batean ; beste batean , despertadorearen kontra jarduten du .	jarduten	17	Imp
Gazteak Alemanian dauden EEBBetako soldaduen semeak dira , eta karguak ukatu dituzte .	ukatu	10	Perf
Errege-seme ez dirudizu , baina horrela deituko zaitut , .	deituko	6	Prosp
UPN eta PSNk aurretik adostua zuten datorren urteko aurrekontu testua eta CDNk ez zuela inoren proposamenik sostengatuko iragarri zuen .	sostengatuko	16	Prosp
Hiru pareta ( frontisa , ezkerraldekoa eta eskuinaldekoa ) dituen frontoiari trinkete deitzen zaio .	deitzen	12	Imp
Seigarren postu hau Abel Antoni eskaini nahi diot , azken urte hauetan munduko maratoilaririk onena izan denari .	diot	7	Prog
Baina ostegunean Etiopiako lehen ministro Meles Zenawik adierazi zuen amaitzear zegoela orain bi urte hasi zen gatazka .	amaitzear	9	Imp
" Gehienbat Frantziakoaz nekien , batez ere han diharduten internazionalek kontatu zidatena .	kontatu	10	Perf
AIko ordezkaritza Madrilen izango da gaur , Justizia Ministerioko ordezkariekin , eta jakinaraziko dio ETAri aurre egiteko Espainiak izenpetu dituen neurrietatik kanpo ez aritzeko .	izenpetu	18	Perf
Gamesaren akzioak %72,46 igo dira burtsako estrenaldian .	igo	3	Perf
Irainak " min handia " egin ziola dio , aita istripu batetik osatzen ari delako eta bere amak horregatik asko sufritzen duelako .	sufritzen	20	Imp
Speighten abokatuak , artean , errebeldeek Suvako kostaldetik gertu dagoen Nukulau uharte-presondegian tratu txarrak jaso dituztela salatu eta epaiketa ahalik eta azkarren egitea eskatu du .	jaso	14	Perf
Badira hor aldaketa nabarmen batzuk .	Badira	0	Prog
" Hurbiltasun geografikoa eremu ekonomiko bihur dadin gonbidatu ditut Hego Amerikako nire hamaika kargukideak .	gonbidatu	7	Perf
Sumindurarekin batera , ordea , ihes egiteko premia bortitz bat sortu zitzaion , buruan zerabiltzanak isilarazi zizkiona .	sortu	10	Perf
Europako Batasunak orain gutxi egindako txostenaren arabera , 35 orduko lan-astearen neurriak izan da lan eskaria bultzatu duen neurri garrantzitsuena .	bultzatu	16	Perf
Horrek denak eskatzen den bereizketa ezestera bultzatzen du .	bultzatzen	6	Imp
Hortaz , ligaren hasierako hilabete eta erdia galduko du .	galduko	7	Prosp
Halere , bi aldeak ados jarriz gero , beste urte batez luzatuko dute kontratua .	luzatuko	11	Prosp
Kalera zoaz eta batek diotsu :	diotsu	4	Prog
Talde berria Domo-Farm Frites deituko da , eta orain arteko bi taldeetako egiturak aukera berdinean lehiatuko dira .	deituko	4	Prosp
Azken laurdenean , Baskoniak , erreboteei esker , gertutik jarraitu zion Kinderren arrastoari , baina Kinder markagailuan zuen errenta handituz joan zen poliki-poliki .	joan	20	Perf
Bizia eta biziraupena baliodun bihurtu duten kualitateak zehazteko bideratu diren ikerketa enpirikoak urriak izan dira .	bideratu	8	Perf
Hala , haren aburuz , " miserable horiek babesten dituztenekin esertzen direnek , eurekin akordioak egiten dituztenek askatasunean eta demokrazian bizitzea merezi duen herri honen nahiak zapuzten dituzte " .	zapuzten	26	Imp
Oraindik ere zalantzak badituzu eta gai honi buruzko guztia argi ez bazaizu geratu , ez kezkatu gehiegi , ondorengo jardueretan egindako lanekin ondo ulertuko baitituzu aipatutako kontzeptuak eta erabilitako metodoak .	badituzu	3	Prog
Arteszena Gipuzkoako Teatro Publikoak Klaus Mann-ek idatzi eta Ariane Mnouchkinek moldatutako Mephisto antzezlanaren lau emanaldi eskainiko ditu , bai erdaraz zein euskaraz , bihar eta etzi Iruñeko Gaiarre Antzokian .	eskainiko	15	Prosp
Normalean talde gisa aritzen dira , beste lagun hauekin :	aritzen	3	Imp
" Gehienbat Frantziakoaz nekien , batez ere han diharduten internazionalek kontatu zidatena .	diharduten	8	Prog
- Ala joan bazihoan ?	bazihoan	3	Prog
Atzo aurkeztu ziren Kongresuan lehiatuko diren hautagaitza biak :	lehiatuko	4	Prosp
Gaur egun gehien zabaldu eta onartu den definizioa Osasun Mundu Erakundeak garatu duena da .	onartu	5	Perf
Erlojupekoan nindoala denboraldiko azken lasterketa dela erabaki dut .	nindoala	1	Prog
Guztira , 160 palestinar inguru hil dira joan zen irailaren 28an istiluak hasi zirenetik .	joan	7	Perf
Sudupek , berriz , akordioa hautsi zuena EH izan zela esan zuen baina ez zuen azalpenetan sartu nahi izan .	hautsi	5	Perf
Orain arte enpresa bakoitzeko ordezkariak lehiatzen ziren finalerdietan , eta finalean gurutzatzen ziren beste enpresakoekin .	lehiatzen	5	Imp
Atzoko lan saioari dagokionez , Alaveseko jokalariek oso lan arina egin zutela nabarmendu behar da .	dagokionez	3	Prog
An-ek ez zion deus erantzun haren galderari , baizik bere kabuz mintzatzen hasi zitzaion .	erantzun	4	Perf
3.000 polizia israeldar inguruk zaindu zituzten leku sakratuetan palestinarrek atzo egindako otoitzak .	zaindu	4	Perf
- Zatoz bisitatzera .	Zatoz	1	Prog
Haien pausoa bizkorra zen , eta espaloietatik ez ezik erdigunetik ere saiatzen ziren , autoen arteko meharguneak baliatuz .	saiatzen	11	Imp
- Eta karobikoak egun batzuk zeramatzak hilik .	zeramatzak	5	Prog
Herri guztietan etengabe sortzen dira herri mailako ekimenak :	sortzen	3	Imp
Thomas senarrarekin uhartera abiatuko da Jean , koñataren belauntzian .	abiatuko	3	Prosp
Lehenago ez darabiltzatela argi geratu dela uste dugu .	darabiltzatela	2	Prog
Nik ez diot jendeari esan HIESa daukadala .	daukadala	6	Prog
Gailurra ez zegoen aurreikusita , baina aukera hori astelehenean iradoki zuen Israelek eta iritzi hori nagusitu da , azkenean , Oslon .	nagusitu	15	Perf
Agian , bizpahiru urte gehiago izan zitzakeen , kirolariak erretiratu baina profesionariek gailurra jotzen duteneko adina .	jotzen	13	Imp
Aukerak ezin zaizkio ukatu , baina ez da Miguel Indurain .	ukatu	3	Perf
" Orain arteko ordutegia batzuek betetzen zuten eta beste batzuek ez eta piskat horren kontrola hobetzeko landu da araudi berria .	betetzen	5	Imp
Informatika arloan langile alemaniar trebatuen eskasia dela medio , Gerhard Schroederren gobernuak ateak ireki dizkie 20.000 langileri .	ireki	13	Perf
Erresuma Batua horren kontra mintzatu da .	mintzatu	4	Perf
Arnas estuka esnatu nintzen .	esnatu	2	Perf
Eta artaldeak zainduz , kostaldetik barru aldeko mendietara mugitu ziren .	mugitu	8	Perf
Mephisto joan den urtarrilean estreinatu zen Bilboko Arriaga Antzokian Pere Planellaren zuzendaritzapean .	estreinatu	4	Perf
Bere eleberriek , ondorengo idazle askori , jarraitu beharreko bidea irakatsi diete .	irakatsi	10	Perf
Haatik , Kosovoko albaniarrek ez dute onartuko besterik gabe hauteskundeak egitea Serbiako erakunde baterako , subiranotasuna nahi baitute .	onartuko	6	Prosp
PSE-EE-K Auzitegietara eraman nahi du Jaurlaritza 2001. urteko aurrekontu proiektua ez duelako aurkeztu .	aurkeztu	12	Perf
Prozesuak aurrera jarraituta , Kongresuak onartuko balu genozidioaren aitorpena aldarrikatzen duen testua , Ankarak ohartarazi du gertakizun honek " ondorio larririk " izango lukeela Turkia eta EEBBen arteko harremanetan eta , gainerat , tentsio egoera handituko lukeela Kaukasoan .	handituko	35	Prosp
Erdilari kataluinarra euskarri lanetan ohitutako gizona da , baina Angelen etorrerak zelai erdian aurreraxeago jokatzera behartu zuen , eta postu horretan ez du , nonbait , Miguel Angel Lotinak nahi zuena eskaini Alex Fernandezek .	behartu	15	Perf
Batetik , Koefiziente bertikala ( Jaurlaritzari ordaintzen zaion zerga bilketaren %66,25a ) zuzentzea , baina horretarako administrazio bakoitzak eskaintzen dituen zerbitzuak kontuan izanik .	eskaintzen	18	Imp
Madrilgo Kongresuak 46.624 milioiko kreditua onartuko du ETAren biktimentzat .	onartuko	5	Prosp
Laosko agirien faltsifikazioan inkulpatu du Tardonek Roldan .	inkulpatu	3	Perf
Espainiako bigarren mailan lehiatuko diren taldeen zerrenda nahikoa ikusgarria da .	lehiatuko	3	Prosp
Jokalariei dagokienez , ikusi beharko da Dagerre errekuperatzen den .	errekuperatzen	7	Imp
1980. urtetik gure ustez gaztelaniaz argitaratu edo berrargitaratu den bibliografiarik garrantzitsuena hautatu dugu , berrikien argitaratu denari lehentasuna emanez .	berrargitaratu	7	Perf
Sailkapen nagusian ez dago aldaketarik eta Claus Moller danimarkarrak eusten dio lehen postuari .	eusten	9	Imp
Tour hartan bistaratu zitzaizkon lehendabiziko aldiz , mendian zituen benetako zailtasunak .	bistaratu	2	Perf
Marie-Roseekin ezkonduko haiz ?	ezkonduko	1	Prosp
Legeetan ezarrita dauden eskubideak , pertsona orori edo langile orori dagozkionak , aitortu edo errespetatu ezean , arraza-bereizkeria egiten da .	dagozkionak	10	Prog
Proiektuok egungo mahastien azpiegitura eta kalitatea hobetzean oinarrituko dira .	oinarrituko	7	Prosp
Gorte Gorenera jo du Demirrek , baina , horrek epaia berresten badu , kartzelara joan beharko du .	berresten	10	Imp
Ondo nengoela banekien , baina nire helburua maillot zuria lortzea zen .	nengoela	1	Prog
Belokik , berriz , orain arte lau eta erdian eman dezakeen maila ematea ez duela lortu erran zuen , baina noizbait emanen duela .	emanen	21	Prosp
Besaulkian eseri da , eta bi eskuez aurpegia estaliz erantzuten du , oso nekaturik bailegoen .	eseri	1	Perf
Badirudi , beraz , Gramatika Unibertsalaren hatsarre-multzoko ezaugarriak gramatika zehatzera moldatzean haurrek duda-mudako edo saio-aldi bat izan dezaketela , edo nahiago bada , ezaugarri zehatzaren aukeretako baten bermaketa egiteko aldi bat behar dutela .	Badirudi	0	Prog
Ez dugu ahantzi , baina aitzinean hobeto lotuko gara .	lotuko	7	Prosp
Zertara zetorren erretolika hori ?	zetorren	1	Prog
Gure helburu bakarra Lehen Mailara igotzea zen urtero , eta , horrek , nire ibilbide profesional eta pertsonala markatu egin du " , azpimarratu du jokalari gorritxoak .	azpimarratu	23	Perf
Neskalaguna eta Karakorumera trekkinga antolatu duen Banoa bidai agentziako Jon Lazkano eta Mikel Eseri ordezkariak zituen zain mendizaleak .	antolatu	4	Perf
Oraindik biziko balu bezala errepikatzen du :	errepikatzen	4	Imp
" Lasai joan nintzen , beste egunetan baino lasaiago .	joan	2	Perf
Datozen egunotan iragarriko du Londresek Patten batzordearen zein proposamen beteko dituen RUC Polizia erreformatzeko .	Datozen	0	Prog
Tentsioa handitu zen , eta gordeta zeuden herritarrengan izua nagusitu zen , Horiek UNAMETen egoitzan babesten saiatu ziren , baina paramilitarrek eragotzi zieten .	babesten	15	Imp
Garbi dago , Rivaldo eta enparauek gol asko sartuko dituztela .	sartuko	8	Prosp
Talde aldaketak , antza , ez dio onurarik ekarri .	ekarri	8	Perf
Athleticen gertatzen den bezala , atezainak ez du behar bezalako errespetua sartzen bere arean .	sartzen	11	Imp
EUROPAKO Gizarte Fondoak 2000 eta 2006 urte bitarterako egingo duen diru banaketan , Hego Euskal Herriak 47.870 milioi pezeta ( 1.914,8 milioi libera ) jasoko ditu .	jasoko	24	Prosp
Diego Armando Maradonari ez zaizkio festak ahazten .	ahazten	6	Imp
Ikaragarritako ospe txarra lekarkioke kasinoari .	lekarkioke	3	Prog
Orain duzu , gaiarekin hasi aurretik , eta dakizuna kontuan hartuta , zure iritzia azaltzeko momentua , disoluzioak izango baitira ikergai atal honetan .	dakizuna	8	Prog
Bilboko pibotaren egoera aspaldi zegoen zalantzan , Ivanovicek taldera ailegatu zenetik , alegia .	ailegatu	9	Perf
Zaharren egoitzaren mugakide den lursailaren erabilera definituko da .	definituko	6	Prosp
ITZALI DIRA .	ITZALI	0	Perf
LDPko buruek Mori hautatu zuten apirilean Keizo Obuchi orduko lehen ministroa ordezkatzeko , hark tronbosia izan ostean .	hautatu	3	Perf
Tarte honi histeresi-tentsioa ( V ) deitzen zaio .	deitzen	6	Imp
Hamar minutu edo ordu-laurden bat bakarrik dauka gurekin egoteko , ez bada gauza arraroren bat gertatzen edo medikua bera nahiko berezia ez bada .	gertatzen	15	Imp
Eusko Jaurlaritzak 5.170 milioi pezetako laguntzak onartu ditu ITPrentzat .	onartu	6	Perf
Biolentzia beraz egon badago , gure herria zapaltzen duten estaduek erabiltzen dutena .	zapaltzen	7	Imp
Bestalde saiatzen naiz zuberera klasiko batean idaztera , Belapeyreren ondotik elizak eman digun zuberera batu , " igantenean " .	saiatzen	1	Imp
Musulmanen arabera Alaren hitza Mahoma profetari errebelatu zion bezalaxe dago bertan .	errebelatu	6	Perf
Txartelaren bidez herritarrek komertzio txikietan erosteko ohitura berreskuratu nahi da , saltoki handiek eragin dituzten ondorio kaltegarriak saihesteko eta aldi berean bizitza soziala birsortzeko .	eragin	13	Perf
1366an Gaztelako Enrike II.ak Trebiñoko jaurerria Pedro Manrique-ri esleitu zion .	esleitu	8	Perf
Barruan daudenean , poltsa honetan gordetzen dituzte kaleko zapatak .	gordetzen	5	Imp
Gobernuaren bake politika defenditu zuen Barakek saio horretan , eta ukatu egin zuen Israelgo segurtasuna kolokan jarriko duela palestinarrekiko akordioak .	defenditu	3	Perf
- Azaren Aldeko Bertso-Jaialdia antolatu zen , bertsolari onenekin ( Txirrita eta ) .	antolatu	4	Perf
Etorkin zauritu batzuk topatu dituzte Eurotunelean .	topatu	3	Perf
Piraguismo munduan jarraitzeko asmoa badu ere , " nahikoa erreta " dago pasaitarra , eta taldean zein gelditzen den kontuan hartuko du aurrera jarraitu edota goi mailako probak baztertzeko .	badu	4	Prog
" Jaurlaritzak ez du Aznarren jokurik segiko .	segiko	6	Prosp
Strange Days ilun eta iradokitzailearen zuzendariak Jeane eta Marenen maitasun istorio zaurituak paraleloki kontatzen ditu ; etengabe iraganarera garamatzaten flash-back gordinez oraina zarramazkatuz .	garamatzaten	18	Prog
( Plaztikazko botoila pasatzen dio , besteak edaten du eta berriz botatzen ) .	pasatzen	3	Imp
Ez , medikuntza prebentiboa behar dugu , alegia , ordena politiko-ekonomiko justu bat bilatu behar da , eta uste dut oso urrun gaudela oraindik .	gaudela	22	Prog
Drogatik irten direnak badaude , eta homosexualak ere gutxi .	badaude	3	Prog
Gizarteak indarkeriaren inguruko diagnosi bateratua egitea eskatzen duela iritzi dio Sudupek , eta ildo horretan Juan Jose Ibarretxek foroa sortzeko eginiko ahalegina txalotu zuen .	eskatzen	6	Imp
Andrew Jennings kazetariak dioenez , Dasslerrek jarri zituen hirurak euren karguetan , kirol ekitaldi handien bitartez bere produktuak mundu osoan zabaltzeko .	dioenez	3	Prog
Hasiera baten beldurra bazuten ere gogoz ebatu diote proiektu berriari .	bazuten	3	Prog
PALESTINARREN erakunde nagusietako batek , Batzorde Zentralak , aurki independentzia aldarrikatzeko aukera aztertuko du gaur .	aztertuko	12	Prosp
Baina Bruselaren arabera , laguntza horiek ez dira orokorrak , esportatzen dituzten enpresentzat soilik baitira .	esportatzen	10	Imp
Stevenssonekin alderatu dute sarri .	alderatu	1	Perf
Hobeto ikusteko itxura eginez , gorputza aurreratzen du , beharrik ez izan arren , ongi baitaki Marietta baten erretratuaren fotokopia erakusten ari zaiola .	baitaki	15	Prog
Besteak seropositiboari gaitzen bat kutsatzen badio , hau hil egin daiteke .	kutsatzen	4	Imp
Azken partiduetan itxura ona eman duten arren , Osasunako jokalariek bost partidu daramatzate jarraian garaipenik lortu gabe .	daramatzate	12	Prog
ARRATSALDEKO 19:20ak ziren Wasserbilligeko haurtzaindegia inguratzen zuten Polizia indarretako eliteko unitateek erasoa hasi zutelarik .	inguratzen	5	Imp
Lehen aipatu den 1991ko apirilaren 9ko ez-legezko Proposamenean jasotako adierazpenen ondorioa da neurri hori ; izan ere , proposamen horretan honela esaten zen :	esaten	21	Imp
Bortizkeria ikertzeko , nazioarteko batzorde independente baten sorrera defenditu zuen Cordonek .	defenditu	8	Perf
Kritikoek diotenez , ordea , Foxek egingo duen gauza bakarra enpresa pribatuaren ideologia politika publikora eramatea izango da .	diotenez	1	Prog
Garai batean , gorpuekin batera hilobietan ipinitako urrea eta zilarra lapurtzen zituzten ebasleek .	lapurtzen	10	Imp
ERREPIDEKO lege zurrunak Vuelta irabazteko hautagaien multzoa seikote batera mugatu du lehen sei etapetan .	mugatu	9	Perf
Berriki arte denek atxiki dute grafia xaharra , nik ezik , Baiona eta Arantzazuko legeak hastetik aplikatu bainizkion euskalkiari ere .	aplikatu	16	Perf
Madrilera joan zen familiarekin .	joan	1	Perf
Europako Kopak lehenik eta Frantziako Kopak gero , etenaldi luzea eragin diote ligari .	eragin	10	Perf
Bera arduratu zen atzoko saioan Bushek kanpo politika eta segurtasun nazionalaren inguruan egindako proposamenak laburbiltzeaz .	arduratu	1	Perf
Leila zain zeukaten lekuan gelditu zen autoa .	zeukaten	2	Prog
Sarrerako tentsioa diodoan geratuko da .	geratuko	3	Prosp
Hala , viura eta mazuelo mahats motak kendu eta ardo hobea produzitzen dutenak landatuko dituzte nekazariek .	landatuko	13	Prosp
Alta , bi urte ia jokatu gabe egin ditu Erroman eta taldean sartzea kostako zaio .	kostako	13	Prosp
Testuak gizabanako eta talde desberdinek irakurtzen edo interpretatzen dituzte , bakoitzaren baliabide sozial eta kulturalen , boterearekiko esperientzien eta norberaren biografiaren arabera .	irakurtzen	5	Imp
Alta , ez dut pentsatzen oraingoz horrelako konturik daukagunik .	daukagunik	8	Prog
Itsasontzia urruntzen zen segundu bakoitzean , nire gorputzaren odol tanta bat erortzen zitzaidan .	urruntzen	1	Imp
Fizek Miguel Indurain txapeldunarekin alderatu zuen bere jarduna , eta bera erretiratzean lortutako garaipenei behar adina garrantzi emango zaiela esan zuen .	alderatu	4	Perf
Cetinjeren erasoko jokoa nahikoa mugatua da , eta partiduak defentsan irabazten ditu .	irabazten	10	Imp
Lanesak dio ez duela ahantzi partida hura :	ahantzi	4	Perf
Uztailean , Putinek botere handia kendu zien gobernadoreei , Senatutik kanporatu zituelako eta haien gainetik Gobernuko ordezkari bat jarri zuelako .	kanporatu	10	Perf
Gainera , aiarrak Mendatan ere ( Bizkaia ) badu erakustaldia , 17:00etan .	badu	8	Prog
Ezpainik mugitu gabe esaten ditu , barnerantz , bortizki , eta jendaurrean , Ako herri osoaren aurrean dioela sentitzen du .	esaten	3	Imp
Iaz Frantziako Tourra eta Espainiako Vuelta korritu nituen , eta aurten Giroa , eta hemen iritsi da hainbat aldiz bilaturiko garaipen handia " .	korritu	6	Perf
Urte sasoi interesgarrienetako bat estreinatu dugu astearekin batera :	estreinatu	4	Perf
Ez ninan beste beldurrik !	ninan	1	Prog
Lurra lehengo maila berean geldituko da .	geldituko	4	Prosp
Ildi beretik , azken urteetan Hego Amerika merkatu ekonomiaren eredu izan dela azpimarratu zuen :	azpimarratu	12	Perf
Kanporaketak direnez , ordu erdiko lana bete beharko dute , eta belar kilo gehien batzen duten biek sartuko dira Lantzeko ( Nafarroa ) finalerdietara .	batzen	14	Imp
Orain badaude itsasontzietan , eta banandu egiten dira .	badaude	1	Prog
Eta eskertu ere eskertuko nuke Euskal Herriko kaleetan hain txukun ezarriko balituzkete idatzi guztiak .	eskertuko	3	Prosp
" UPNk hitzarmenak bete egiten ditu eta , gainera , honek ez digu inolako arazorik sortzen , UPNk erabateko askatasuna duelako Nafarroan " , adierazi zuen UPNko lehendakariak .	sortzen	15	Imp
Elkarri gizarte mugimenduak ere oharra kaleratu zuen eta kritiko agertu zen Garzonen autoarekin .	agertu	9	Perf
Marion Jonesek 400 metroetako proba prestatuz gero , Cathy Freeman estutuko lukeela ikusi zen atzoko lasterketan .	estutuko	10	Prosp
Gazteen proiektuak ere badaude .	badaude	3	Prog
aldeko botoa emango dutenen kopurua gorantz doa eta behera kontra egingo dutenena .	emango	2	Prosp
Hasiera batean ia astakeria hutsa zirudiena , iraganarekin puskatzeak dakarren ohiko prozesuaren bidez , ideia hunkigarria bilakatu zen bere buruan .	zirudiena	5	Prog
Goreren gobernu batek Clintonen ildoari segituko dio , Armadari buruzko aditu ezkertiar William Hartungek esan duenez .	segituko	5	Prosp
Gainerako zigor-espedienteak egokitzat jotako ikerketez eta frogez hornituko dira , ofizioz edo doakionaren eskariz .	hornituko	7	Prosp
Beharbada , lehendik bazekikeen karobiko hilotzarena .	bazekikeen	3	Prog
Une hartan ez nion kabina bitan zatitzen zuen kristalari erreparatu .	zatitzen	6	Imp
Zabortegiari zegokionez , aurreko egunetan izandako istiluengatik edo , bazirudien agintariak ez zirela aurrerapausorik ematera ausartzen .	zegokionez	1	Prog
Drogazale naizenez , arrisku handiagoa daukat , eta homosexuala ere naizenez arrisku handiagoa .	daukat	5	Prog
Hortik aurrera halaxe portatu da .	portatu	3	Perf
Eta Ajuria Eneko iturriek diotenez , abisu horren ondorioz etorri zen Xuntak egindako afaltzeko gonbita :	diotenez	4	Prog
Hark ere arazoak ukan zituen jokalariekin :	ukan	3	Perf
Badaki zelan jokatu behar duen , betiko entrenatzailea du eta gainera , aurrelariak ondo ari dira aurkariaren ate aurrean .	Badaki	0	Prog
Egunkariek deitzen zuten , irrati eta telebistek .	deitzen	1	Imp
Pazifikoko uretan bainatzen diren herrietako lagunek biziki maite dute San Franciscoko giro multikulturala .	bainatzen	2	Imp
" Miarritzek arazoak sortuko dizkio Tolosari " .	sortuko	3	Prosp
Gainerako zigor-espedienteak egokitzat jotako ikerketez eta frogez hornituko dira , ofizioz edo doakionaren eskariz .	doakionaren	12	Prog
Herenegun Heike Drechslerrek esnatu zuen ametsetatik , eta atzo Bahametako esprinterrek .	esnatu	3	Perf
Bururatu zait !	Bururatu	0	Perf
Eta hori guztia ari da ikusten aurtengo Vueltan , aurrez , Tourrean , antzeman zen modu berean .	antzeman	13	Perf
Garaipena lortzera joango gara , baina badakigu larri ibiliko garela .	badakigu	6	Prog
Sendo gaudenok argalen ahuleriak eraman behar ditugu .	gaudenok	1	Prog
Inguruko landareen hostoetatik eta lorontzietako lurretik lurrintzen den ura medio , inguru berezi bat sortuko da bere artean .	sortuko	14	Prosp
Agintariak hitza eman du gerrak suntsitutako guneak berrituko dituela petrolio salmentatik lortutako diruarekin .	berrituko	7	Prosp
" Gure taldeak gaitasuna du gauza handiak egiteko eta ziur nago lortuko ditugula .	lortuko	11	Prosp
Ikurrean erraz identifikatzen dira :	identifikatzen	2	Imp
- Foru Dekretu honen arabera osagarriaren esleipena hartzen duten lanpostuen titularrek , lanpostu horiei asimilatutako atal edo bulego edo unitateko burutzaren batean ari badira , osagarri hori jasoko dute burutzari dagokionaz gainera .	dagokionaz	30	Prog
Santutegi zaharraren dorre bat kontserbatzen da , oinalde karratukoa eta inskripzio batean 1870 urtea ageri du .	kontserbatzen	4	Imp
PPk , galdera horretan , " kezka " agertzen du , euskal gazteriako " sektore jakin batzuen " eta " jazarpenezko indarkeria deitzen dutenaren protagonisten edota ETAko kideen " artean lotura dagoela esanez .	deitzen	22	Imp
Orain arte Athleticen gauzak lasai badaude ere , Zaragozari ez irabazteak argi gorria piztuko luke talde zurigorrian .	piztuko	13	Prosp
Bertsolariak soinuaren abiada baino azkarrago kantatzen duenean .	kantatzen	5	Imp
" Joan den igandean Bidanian [ Gipuzkoa ] aritu nintzen , eta gorputzaldian nagoela uste dut " .	nagoela	13	Prog
Kezkatzekotan beraiek kezkatu beharko lukete , beraiek baitatoz Mendizorrotzara .	baitatoz	7	Prog
" Badirudi argia ikusten ari garela " .	Badirudi	1	Prog
Lehenak agiriaren kontrako jarrera islatzen du .	islatzen	4	Imp
Ez zeukaten zertan , gainera :	zeukaten	1	Prog
Egoitza militarrak ixtea ez dakar berez soldadu britainiarren erretiratzerik , baina hiru hilabete barru beste azterketa bat izango dela azaldu zuen Flanaganek .	dakar	4	Prog
Aurretik , Errolda Bulegoa aholku eske eta galdezka zuzendu zen Renoko Euskal Mintegira .	zuzendu	8	Perf
Jaiegunetako ohiko protokoloari jarraituz , kafea egin zuen eta irratia piztu , doi-doi musika klasikoari eskaintzen zioten larunbateroko saio berezia hastera zihoanean .	zihoanean	21	Prog
1997an egin zuen debuta , eta beti korritu du Pantaniren itzalpean , Mercatone Uno taldean .	korritu	7	Perf
Juan Mari Olanok adierazi zuenez , " Frantziak eta Espainiak Euskal Herrian garatzen duten errepresio politikoaren aurpegiak nabarmentzera eta euskaldunoi kanpotik eta indarraz inposatu diguten gatazkaren irtenbide politikorako alternatiba aurkeztera joango gara " .	inposatu	23	Perf
Orain , berriz , Ibon Aranberri eta Jexuxmari Villabonarekin dihardut .	dihardut	9	Prog
Fiskalak berak azaldu zuen ez zuela espetxeratzea eskatuko , nahiz eta delitua egin duten zantzuak badaudela esan .	badaudela	15	Prog
Andereñoa poztu egin zen :	poztu	1	Perf
Urralburu kasuko inputatuek jarri errekurtsoak datorren urtarrilaren 10ean aztertuko ditu Auzitegi Gorenak .	aztertuko	8	Prosp
Inguruko landareen hostoetatik eta lorontzietako lurretik lurrintzen den ura medio , inguru berezi bat sortuko da bere artean .	lurrintzen	6	Imp
Merezita lortu du Fiorentinako atezainak gailurrera iristea , baina izugarri kostata .	Merezita	0	Perf
Jarduera eta gaiarekin hasi aurretik eman iezaiozu begirada bat ikas-norabideari eta aztertu ea zer dakizun edo gogoratzen duzun han agertzen zaizkizun gauzez .	dakizun	14	Prog
Txantreako atxiloketak badu zerikusirik joan zen asteazkenean Mexikoko hiriburuan izan zenarekin .	joan	4	Perf
Elkarri gizarte mugimenduak ere oharra kaleratu zuen eta kritiko agertu zen Garzonen autoarekin .	kaleratu	5	Perf
Alderdi sozialistarekiko aliantzaren aukerak sinesgarritasuna galduko luke , PPk kutsatuta egongo litzatekeelako .	galduko	5	Prosp
( Erakusten dio ) .	Erakusten	1	Imp
Andereseroraeneko aintzinean iraganen da , laborari gazteen batasunak apailaturik .	iraganen	2	Prosp
Egiptoko Atzerri ministro Amro Musak Sharonek Jerusalemera egindako bisita " terrorismo politikotzat " definitu zuen .	definitu	13	Perf
Beraz , egon badago bideren bat maitasun gorenera .	badago	3	Prog
Azkenean , partiduak berak aginduko du .	aginduko	4	Prosp
Menditik behera jaitsi eta kale ezagunak zeharkatu genituen :	zeharkatu	6	Perf
Bere arima zurigorria da , eta Athletic odolean darama .	darama	8	Prog
" Genituen zalantzak desagertu dira , ez genekien zein egoeratan geunden , eta horretarako baliagarria izan da .	genekien	7	Prog
- Hobe diagu abisua ematea , Knox .	diagu	2	Prog
Euriak eraginda , igandean bertan behera gelditu zen torneoa , baina Loweryk arazorik gabe eutsi zion atzo lehen portuari .	eutsi	14	Perf
Barruan daudenean , poltsa honetan gordetzen dituzte kaleko zapatak .	daudenean	1	Prog
Bainan ahanzten duk gauzatxo bat .	ahanzten	1	Imp
Esnatu zenean , zikin somatu zuen bere soina tabako usaineko maindire artean , eta ahoa lehor .	somatu	4	Perf
Q emisore jarraitzaile gisa dabil eta irteerako seinalea sarrerakoaren ia berdina izango da , irteerako inpedantzia ( erresistentzia ) txikia delarik .	dabil	4	Prog
Bi botoi batera zanpatu zituen .	zanpatu	3	Perf
Nazio eraikuntzari lotutako ideiak aurrekontuen negoziaketara ezin direla eraman iritzi dio PSE-EEko bozeramaileak .	iritzi	9	Perf
ZALEEK gogo handiz itxaroten zuten unea iritsi da eta Gasteizko Andra Mari Zuriaren jaietako pilota programaren baitan ikusiko da .	ikusiko	17	Prosp
Eta informazio asko daukagu .	daukagu	3	Prog
Mapa handi bat zeukan bere aurreko mahaian .	zeukan	3	Prog
- Inor jasotzen ari bada konpentsaziozko osagarria , esleitzen diren osagarriek hura irentsi eginen dute .	esleitzen	8	Imp
PSE-EEk dio Jaurlaritzak " iruzur " egin duela aurrekontuak luzatu dituelako .	luzatu	9	Perf
EAk elkarretaratzea antolatuko du Baionan , " bakea solastatuz " leloaren inguruan .	antolatuko	2	Prosp
Letoniako hizkuntz lege berria gaur jarriko da indarrean .	jarriko	5	Prosp
Baina Josuren lagunen mezuen bidez , inguruaz zituen harremanak berdintasunean oinarriturikoak zirela ikasi dugu .	ikasi	12	Perf
Zenbaiti ez zaio ondo iruditzen galtzailearen gainera maskuria hustu behar hori .	iruditzen	4	Imp
KORSIKAK eskuratzear duen autonomia maila Bretainiari ere emateko eskatu du Emgann talde abertzaleak .	eskuratzear	1	Imp
Iñaki Rekarte presoak gutun bat igorri du isolamenduan jasaten dituen " presio eta kontrolak " salatuz .	igorri	5	Perf
Hala , erretratatuaren bizitza sexualaren une zehatz bat edota desioak , fantasiak eta abar betikotzen ditu egileak .	betikotzen	14	Imp
ERAUNTSI garaiotan analistek sarri gomendatzen dute enpresa handia eta " betikoa " , argindar sektorean kasu , babeslekutzat .	gomendatzen	4	Imp
Iruñean igoera lortutzat ematen dute zale guztiek , dagoeneko , eta ospatzeko irrikan dira .	ematen	3	Imp
Bien arteko harremana oso estua zela azpimarratu dute Montenegroko komunikabideek .	azpimarratu	6	Perf
EZLN Askapen Nazionalerako Armada Zapatista orain sei urte sortu zenetik lehen aldiz onartu du Mexikoko Armadak talde paramilitarrak badaudela Chiapasen .	badaudela	18	Prog
Orain urte batzuk pin-pinke deitzen zitzaion jolas horri .	deitzen	4	Imp
" Nire izena , Sabah , honela idazten da eta " goiza " esan nahi du " .	idazten	7	Imp
Bilbon , ostera , denak gripeak jota hil dira , HIESak ez du inor hiltzen Bilbon .	hiltzen	14	Imp
Miarritzek Perpinya kanporatu zuen final-laurdenetan , 47-44 irabazita .	kanporatu	2	Perf
Kaixo , ni Ganix naiz eta nire dordokaren abenturak kontatuko dizkizuet .	kontatuko	9	Prosp
Aurrekontuak luzatzeak Eusko Jaurlaritzaren " ezintasuna " berresten duela uste du PPk .	berresten	7	Imp
Lazoak diruditen irudiz egindako dekorazio fin hau , oso tipikoa da arabiar arkitekturan .	diruditen	1	Prog
Epaiketak egin arte oso denbora luzea pasatzen da eta horrela ustelkeria kasuengatik kartzelan dauden asko , horrekin zerikusia duten politikariak , esaterako , libre irten daitezke delituak preskribitu duelako .	preskribitu	27	Perf
( Lurraren kontra tupust egitean , zerua piztu egiten da une batean eta mila argi-puska zirimolatzen dira airean .	zirimolatzen	15	Imp
botoi berde bat sakatu zuen .	sakatu	3	Perf
Gaur egin diguten ongietorria eta han geundela jaso ditugun animoak horren seinale dira .	geundela	6	Prog
Eta horretarako , batu behar gaituen kezka ez da Madril edota Pariseko gobernuek emango duten erantzuna , abertzale garenok hartzen dugun konpromezua eta egiten ditugun urratsak baizik .	emango	13	Prosp
Ez zuten batak bestea ondo ulertzen .	ulertzen	5	Imp
Hasiera batean ia astakeria hutsa zirudiena , iraganarekin puskatzeak dakarren ohiko prozesuaren bidez , ideia hunkigarria bilakatu zen bere buruan .	bilakatu	16	Perf
Datu garrantzitsua da hori , datozen egunotan irundarrek erronka handiak baitituzte , Ligan zein Europan .	baitituzte	10	Prog
urralburu kasuko inplikatuek jarritako errekurtsoak datorren urtarrilaren 10ean goizeko 10:30ean aztertuko ditu Auzitegi Gorenak .	aztertuko	10	Prosp
Interesdunaren nahia aintzat hartuko da eta aurreko puntuan ezarritakoa eta eskatzailearen inguruko gainerako egoerak ere aztertuko dira .	aztertuko	15	Prosp
Erakunde berri horretan eseriko dira Errusiako 89 errepublika eta autonomietako gobernadoreak eta bere egitekoa izango da presidentea bera aholkatzea .	eseriko	3	Prosp
" Nork hitzegiten duen hemen frantsesez ?	hitzegiten	2	Imp
Beno ... espero dut jokalariek duten guztia ematea , eta dugun txantza baliatzea .	dugun	10	Prog
Eskolan bazkaltzen du eta gehien gustatzen zaion janaria saltxitxak dira .	bazkaltzen	1	Imp
( Hankatzarrak zeruraino luzatzen ditu .	luzatzen	3	Imp
Olivier Nauroy berriro bigarren lerroan ariko da , eta miarriztarrak hau zioen :	zioen	11	Prog
Beren ezagupide bereziez baliatuz , ahalmen bereziak ere bazituzten gizaki horiek :	bazituzten	8	Prog
Zenbait gauza gertatzen direnean ahaztea izaten da onena , eta orain , datorren urtean ibiliko naizen taldean ari naiz pentsatzen .	datorren	12	Prog
Horregatik , interpelazio bat aurkeztu du Legebiltzarrean luzapenaren zioak argi ditzan .	aurkeztu	4	Perf
Leku horretan kokatzen da hain zuzen ere Gatzagako Udalak martxan jarri duen proiektu berria :	kokatzen	2	Imp
Nola hedatzen da argia ?	hedatzen	1	Imp
Udalbiltzak duen egitekoaren garrantzian sinisten duela dio EAk , baina fruituak eman eta parte-hartzea handitu dezan giza eskubideen defentsa beharrezkoa dela gaineratzen du .	gaineratzen	21	Imp
Baliteke gu jalgitzea .	Baliteke	0	Prog
Brivek ederki erasotzen zuen aitzin-multzoarekin , primeran gidatzen zuelarik Carbonneau uztartze erdiak , eta Lamaisonek erraz irabazten zituen metroak hankarekin , eta Baionako ohiak sei puntu egin zituen jaurtiketetan .	erasotzen	2	Imp
Zer ikasi zenuten kurtso horietan ?	ikasi	1	Perf
