Topshopissa koinkin sitten ihastumisen , kun kiinnitin heti ovella katseeni ihaniin nudekorkkareihin .	katseeni	9	1
Työ valtaa elämästämme suuremman osan kuin edes siihen käytetyt tunnit osoittavat : se ei enää kerro vain mitä teemme , vaan myös mitä olemme .	elämästämme	2	1
Puin omani päälle , otin avainkorttini , suorin hissiin ja matkasin kaksitoista kerrosta alaspäin niin , että vatsasta otti .	avainkorttini	5	1
Marraskuun alussa hän sai surmansa terroristin luodeista .	surmansa	4	3
Skeptikko voisi kysyä , että olisiko se tenavansa teilannut isä välttynyt kierteeltään , jos sosiaalitäti olisi pienenä häntä silittänyt ?	tenavansa	7	3
Tyttärenpoikani on nyt Tikkakoskella armeijassa ja ainakin siellä henki kuuluu olevan voimakas , kertoo 71-vuotias Veikko Lindell .	Tyttärenpoikani	0	1
Olisiko niin , että vanha sanonta Se koira älähtää , johon kalikka kalahtaa , pitää tässäkin paikkansa .	paikkansa	16	3
Ajatusvirtani jatkaa tuohtunutta tulvaansa .	Ajatusvirtani	0	1
Sen on pohjaväriltään vaalean ruskeanharmaa .	pohjaväriltään	2	3
Uskon hänen voittoonsa	voittoonsa	2	3
Haluaisin lisäksi korostaa 9 kohtaa koskevaa seikkaa , jonka jäsen Hyland toi esiin : palasin juuri vierailulta , jonka tein Ulko-Hebrideille sen viikon aikana , jona kiersin vaalipiirissäni .	vaalipiirissäni	27	1
Heräsin vierestäsi haihtuvassa humalassa Puistolasta radanvarren asunnosta puolipukeisena kieli viipyvästä maustasi tahmeana .	maustasi	10	2
Se oli veljeni joka ihmetteli mihin olin kadonnut .	veljeni	2	1
Lastensa vastuun ohessa , vanhemmat ovat myös toki vastuussa omasta alkoholin käytöstään .	käytöstään	11	3
Ajattelin hänen tuskaansa hänen ottaessaan syliinsä pienen suloisen nelikuisen poikansa .	tuskaansa	2	3
Me katsomme maailmaa siitä nimenomaisesta perspektiivistä , johon olemme sitoutuneet , koska meidän paikkamme maailman kokemuksellisessa järjestyksessä on tietynlainen .	paikkamme	13	1
Ammatissani joudun paikallissijojen nimitysten kanssa tekemisiin harva se päivä .	Ammatissani	0	1
Nöyrry vain , sinä alhainen asiakas , ja käy kiltisti kantamassa itse oma kaljasi .	kaljasi	13	2
Kynäni on hieno .	Kynäni	0	1
Useat puolueet ovat Vihreän liiton jälkeen ilmoittaneet halunsa puolittaa energiankulutus vuoteen 2030 mennessä .	halunsa	7	3
Auringolla tuntui olevan rennompi asenne kaikkeuteen , ja vanhus , joskin ensin empiväinen , hyväksyi lopulta täysin uuden ystävänsä olevan pysyvää sorttia – pysyvämpää kuin entisen kotimaansa takakireät ja tuuliset työpaikat .	ystävänsä	18	3
se ol Hiakal trenkin , ja sanos et se hyppäs yli aeraj ja häm putos sen suust ja häm pääs puuhu ja sit se , ol puuj juures pystös se susi , ja nual vert ko tul häne reirestäs	reirestäs	38	3
Arvoisa puhemies , hyvät kollegat , kannatan tietenkin rouva Van Dijkin mietintöä , jossa on hyvä ongelmanasettelu ja jossa kuvaillaan monien kanssaihmistemme oikeutettua suuttumusta ja eläinkuljetuksiin liittyviä skandaaleita .	kanssaihmistemme	21	1
Onneksi muisti lempirantasi , otin mukaan vilttejä , laita nämä yllesi niin soitan ambulanssin !	lempirantasi	2	2
− Sihvosen tutkimuksessa osoitetaan , miten tietokonepelien modausta analysoimalla päästään tarttumaan laajempaan digitaalista kulttuuriamme määrittävään dynamiikkaan .	kulttuuriamme	13	1
Pelander teki väitöskirjansa Turun yliopiston hoitotieteen laitoksella .	väitöskirjansa	2	3
Vaalipiirini asukkaalle vastannut lentoyhtiö kuitenkin totesi , että " asetuksessa ( EY ) N:o 261/2004 ei velvoiteta lentoliikenteen harjoittajia tarjoamaan tai maksamaan korvausta viivästymisen vuoksi " .	Vaalipiirini	0	1
Aikanaan hän olisi rahoittanut myös opiskeluni , mutta niistä ei tullut mitään .	opiskeluni	5	1
Porissa asuneen Helmin saapuminen vähintään kerran vuodessa Loimaalle oli oma draamansa .	draamansa	10	3
Ohjaajat ovat koulutukseltaan lähi- tai perushoitajia .	koulutukseltaan	2	3
Ostossaldoni jäi ihailtavasti yhteen kenkäpariin , yhteen neuletakkiin ja kaksiin sukkahousuihin , joista toiset ovat vieläpä aivan normaalit mustat ja H&M:lta .	Ostossaldoni	0	1
toinen poliisi löysi Dockeryn makaamassa talon pihalta luodinreikä otsassaan .	otsassaan	8	3
Hän meni talliin jossa jalkansa loukannut hevonen seisoi pilttuussa .	jalkansa	4	3
Pesti jäi kuitenkin varsin lyhyeksi , sillä Åkeby sai elokuun lopussa 2008 potkut tehtävistään Aalesundin majaillessa Tippeligaenissa toiseksi viimeisellä sijalla .	tehtävistään	13	3
Meidän on sopeutettava toimintamme Aseanin toimintatapaan ja tyyliin .	toimintamme	3	1
Muutaman kerran ujosti sanot ' moi ' kun törmäätte koulunkäytävillä ja melkein myyt maailmasi , kun saat tietää hänen olevan sellainen , tiedättehän , helposti muiden matkaan menevä .	maailmasi	13	2
Eikä Suomi-kuva enää meidän aikanamme ole haudan vakava asia , sillä ranskalaistunut itsetuntomme kestää urheasti jopa sekaantumisen norjalaisiin ja sen , että jonkun mielestä Helsingissä kävelee jääkarhuja .	itsetuntomme	12	1
Menestyksestään huolimatta Nokia on tippunut kolmanneksi myös älypuhelinten myynnissä .	Menestyksestään	0	3
Mitenkä teidän huollettavanne ovat pärjänneet ?	huollettavanne	2	2
Mieheni katsoi kauhuissaan muttei yllättyneenä kun latasin koriin puolitoista kiloa erilaista spelttejä , rouheita ja epäilyttävän nimisiä teepusseja .	kauhuissaan	2	3
Em mä niinku mitenkään tieten tahtoe oo , mum murrettani karsinu pois	murrettani	9	1
Ensimmäisenä paikalle päässyt poliisi otti virka-aseensa esiin , koska hän havaitsi paikalla olevan muitakin aseistettuja henkilöitä .	virka-aseensa	5	3
6 ) jäsenvaltioilla on yksinomainen toimivalta yleisen järjestyksen ylläpitämisessä ja sisäisen turvallisuuden varmistamisessa sekä sen määrittelemisessä , mitkä toimenpiteet kussakin tilanteessa ja vaiheessa ovat välttämättömiä ja suhteellisia tavaroiden vapaan liikkuvuuden edistämiseksi alueellaan ,	alueellaan	31	3
vasta sinun tapaamisesi sai minut tajuamaan että jotain olin ollut paitsi .	tapaamisesi	2	2
Kiinnostus lammastalouteen on kasvanut lakipisteeseensä : alan käyttää villapaitoja .	lakipisteeseensä	4	3
Meidän on varmistettava , että sääntelymekanismimme toimivat , ja meidän on tarkoin käsiteltävä riskejä ja uhkia sekä ratkaistava oikein tekniset pulmat .	sääntelymekanismimme	5	1
Marja sijoittaa rahansa eläkerahastoihin .	rahansa	2	3
Mielestäni on oleellista vahvistaa valvontaa koskevat normit , ja meidän on toimittava päättäväisesti tässä suhteessa .	Mielestäni	0	1
Hyvä ja paha taistelevat kokoajan , miksei minunkin huoneessa .	huoneessa	8	1
Vakuutuksenottaja on esimerkiksi saattanut saada vakuutuksensa poikkeuksellisen halvalla konkurssiin menneestä yhtiöstä .	vakuutuksensa	5	3
Olin varma , että juttuni hylättäisiin kättelyssä lapsellisena tekeleenä .	juttuni	4	1
Sillon minä vuosin , purskahdin itkuun ja kastelin housuni , en mahtanut sille mitään .	housuni	8	1
en kai minä huvikseni soittele tähän aikaan .	huvikseni	3	1
Tyttönimeltäni olen Tenni .	Tyttönimeltäni	0	1
Uuvuin taas sen tutun kiven viereen , sen joka oli ennenkin tuntenut kyyneleeni .	kyyneleeni	12	1
Useimmat ovat taittelukaavioidensa mukaisia monisteita , mutta joukossa on mitä mielikuvituksellisimpia variaatioita samasta teemasta .	taittelukaavioidensa	2	3
Tampereen yliopistossa yleislääketieteen apulaisopettajana työskentelevän Virtasen väitöskirjan juuret ovat hänen kotikaupungissaan Nokialla .	kotikaupungissaan	10	3
Kuninkaalliset häät oli ihan jees , ikävästi vaan toi meidän excu konsulttifirmaan häiritsi katsomista , uskomatonta !	excu	10	1
Perutkos puheesi ja äkkiä !	puheesi	1	2
Minä rakastin höyryvetureita , niiden onkapannuja ja kaksiväristä puhkua , jota ne työnsivät ulos piipustaan .	piipustaan	14	3
Eikä Suomi-kuva enää meidän aikanamme ole haudan vakava asia , sillä ranskalaistunut itsetuntomme kestää urheasti jopa sekaantumisen norjalaisiin ja sen , että jonkun mielestä Helsingissä kävelee jääkarhuja .	aikanamme	4	1
Hän on kiertänyt käsivartensa olkapäillesi ja sinä taivut hänen puoleensa kuin vastatuulessa .	käsivartensa	3	3
Ja jos työ muodostaa identiteettimme ytimen , työssä epäonnistumisen merkitys on helppo laskea .	identiteettimme	4	1
Se oli hänen vapauttaan .	vapauttaan	3	3
Osa katsoi ADS:n pelit loppuun ja liittyi sitten seuraammme .	seuraammme	8	1
Päätin laajentaa käyttövärieni kirjoa uudella värillä ja niin vaaleansininen siirtyi suosikkivärieni listalle .	suosikkivärieni	10	1
Pois jääntiä työpäivänä , mukaan lukien myös perjantai , mikä on lempiaiheeni , ei voi puolustella millään , jos haluamme säilyttää uskottavuutemme .	uskottavuutemme	21	1
Ilta laskeutui auringon takaa ja annoin hiuksieni mennä tuulen mukana kun ajoin vanhalla Saint -polkupyörälläni pitkin kuolleiden lehtien katuja , silloi minusta tuli astronautti ja nousin raketillani jo stratosfääriin .	-polkupyörälläni	14	1
Orion on pitänyt koko vuoden näkymänsä ennallaan .	näkymänsä	5	3
Koirani heittäytyi selälleen olohuoneemme lattialle ja nauroi kita ammollaan ja kaikki hampaat näkyvissä .	Koirani	0	1
Sitä mukaa kun joulukuussa järjestettävät parlamenttivaalit lähestyvät kasvaa myös kansanedustajien into nostaa profiiliaan .	profiiliaan	12	3
äitinsä hylkäämä lapsi	äitinsä	0	3
Emmekä ole näin ollen vastuussa mistään sellaisesta ydinjätteen sijoittamisesta joka tulee muualta maailmasta mutta samalla olemme tietysti vastuussa ydinjätteistämme ja muista tämänkaltaisista ratkaisuista .	ydinjätteistämme	18	1
” Älä anna epäilyksen kalvaa uskoasi ” , Qazibe tokaisi .	uskoasi	5	2
Pidä hermosi kurissa tai menetät pelin	hermosi	1	2
Hänet tunnetaan erityisesti pysäyttävistä muotokuvistaan ja yhteiskunnallisesti kantaaottavasta kuvajournalismistaan .	kuvajournalismistaan	8	3
Ajattelin hänen tuskaansa hänen ottaessaan syliinsä pienen suloisen nelikuisen poikansa .	syliinsä	5	3
Enkä voi olla hymyilemättä peilikuvalleni .	peilikuvalleni	4	1
Tilannetta kuvaa hyvin se , että Sähköpalatsista ei haluttu antaa hintavertailuumme minkäänlaisia lukuja Nokian tuotteista .	hintavertailuumme	10	1
Minä olinkin koneessa näkevinäni hänet , mutta en luottanut silmiini ...	silmiini	9	1
Tulos ei tietenkään riipu pelkästään meidän hyvästä tahdostamme - ja se on oikeastaan kaikkien näiden töiden varsinainen este , teollisen yhteistyön alallakin - vaan se riippuu myös kumppanivaltioiden hyvästä tahdosta .	tahdostamme	7	1
" Hupsis " , ajattelimme ja päätimme muuttaa elintapojamme .	elintapojamme	8	1
Toisaalta suuri osa ihmisistä , olevista ja menneistä , säilyvät jalanjälkineen sydämissämme ilman , että teemme kodistamme vanhojen tavaroiden museon .	jalanjälkineen	10	3
Raimo huomasi meidän katsomisemme , kääntyi , näki Kaisun ja kysyi , halusinko , että hän haki emäntäni baariin .	emäntäni	17	1
Täytyy kuitenkin pistää jäitä hattuun ja pitää suurena onnistumisena , jos yksikään kuvistani pääsee Mr. Gurumoorthyn pöytää pidemmälle .	kuvistani	12	1
Pidättäytymisemme äänestämästä osoittaa vastalauseemme pankkijärjestelmän niin kansallista kuin eurooppalaista järjestelmää vastaan .	vastalauseemme	3	1
Aina muistan kuinka ajoimme keskellä sysimustia metsiä , pitkin öisiä teitä , joita vain autosi himmeät etuvalot valaisivat .	autosi	14	2
On myös tärkeää keskustella Euroopan teollisuuden kilpailukyvystä , koska suurin osa hyvinvoinnistamme perustuu siihen .	hyvinvoinnistamme	11	1
Hän on koulutukseltaan diplomiekonomi .	koulutukseltaan	2	3
Toinen sanoi että Eino Kailan Persoonallisuus oli hänen mielikirjansa .	mielikirjansa	8	3
Kukaan tiedemiehistä ei suostunut siihen , että hänen tietonsa olisi peittynyt toisten tiedon alle , vaan jokainen halusi oman tietonsa kasan päällimmäiseksi , sen huipuksi .	tietonsa	19	3
Hän otti askeleen kerrallaan ja eteni näin suojatien puoliväliin , seisoen sitten keskellä tietä .	kerrallaan	3	3
Lapset pystyvät arvioimaan omaa sairaalahoitoaan	sairaalahoitoaan	4	3
Ovatko kansanedustajat vapaaehtoisesti luovuttamassa lainsäädäntövaltansa Brysseliin ?	lainsäädäntövaltansa	4	3
Tämä on sinun ravintolasi , totta hemmetissä sinä saat määrätä täällä kaikesta .	ravintolasi	3	2
Minulla ei ollut vaikeuksia saada aikaani kulumaan	aikaani	5	1
Erkki kirjoitti , että hän jatkaisi tänään matkaansa tänne meidän luoksemme .	matkaansa	7	3
Pitäkääpäs pojat varanne !	varanne	2	2
Etelästä lähestyy jo maatamme paksuja pilviä	maatamme	3	1
Hän ei enää ollut tutussa kotikylässään .	kotikylässään	5	3
Se haluaa sinun rahasi .	rahasi	3	2
Täytyy myöntää , että huoneeseeni päästyä kiedoin kerran käytetyn pyyhkeen pitkiin hiuksiini ja peitin puhtaan varteni kylpytakilla , mutta jos olisin lyhythiuksinen ja kiireinen , olisin voinut aivan hyvin vain pyyhkäistä hiukseni kuivaksi ( käsipyyhkeeseen ) ja pukeutua samantien .	varteni	15	1
Ikuisuuden kotimatkalla tuijotin tossujani , vesilammikoistakin astelin , ihan sama .	tossujani	3	1
Kesät olivat kuumia kun meidän pihalla hypittiin sadettajan ympärillä , jonka jälkeen pyöräiltiin kilpaa jäätelökioskille .	pihalla	5	1
Toisena vuotenaan hän myös todella löysi koulun Mac tietokoneet ja innostui niistä .	vuotenaan	1	3
Hänen kohtalonsa jäi kuitenkin tukholmalaisten mieleen ja hänen kapeaa asuinkatuaan ryhdyttiin kutsumaan Trotzigin kaduksi .	kohtalonsa	1	3
Fergie aikoo kirjoittaa ellei ole jo niin tehnyt elämäkertansa .	elämäkertansa	8	3
Milosevic tuskin paljoa piittaa hädänalaisten heimoveljiensä asemasta .	heimoveljiensä	5	3
Tönäisen kengänkärjelläni jalkatilassa lojuvia tyhjiä pulloja ja yritän olla huomaamatta ilmaan lemahtavaa kaljan ja siiderin hajua .	kengänkärjelläni	1	1
Taisto arveli minun oppineen tämän sen pitkän kokemukseni kautta , joka minulla naisista oli .	kokemukseni	7	1
Pyydämme teitä kiinnittämään istuinvyönne ja nostamaan istuimenne selkänojan pystyasentoon .	istuimenne	6	2
Muuan virolainen kuntoutettavani , entinen metsäveli , liittyi Neuvostoliiton armeijaan , koska koki olevansa siellä turvassa , sinne ei etsijän käsi ulottunut .	kuntoutettavani	2	1
Bobby Fischer kehitti myös oman jatkonsa , äärimmäisen terävän jatkon , jonka nimi on Muzion gambiitti : 4. Lc4 g4 5. 0-0!? gxf3 6. Dxf3 .	jatkonsa	5	3
Kaikesta epätodellisuudestaan ja keinotekoisuudestaan huolimatta " Kauniiden ja rohkeiden " maailma on aikuisten maailma .	keinotekoisuudestaan	3	3
Minä en voinut sietää hikisen tukan painoa harteillani ja siksi olin sitonut sen nutturalle .	harteillani	7	1
Hänen silmistään huutaa pelko miehen , josta hän on ollut vieraantumisestaan huolimatta hyvin riippuvainen , kuolemasta .	silmistään	1	3
kasvattaisin lapseni toisella lailla kuin mutsi mua .	lapseni	1	1
Olkaa hyvä ja seuratkaa minua niin menemme ottamaan mittanne pukuanne varten ” , ääni hymyili .	pukuanne	9	2
Ja se sun kellos taitaa olla sit kakskytvaille neljä edelleen ? ”	kellos	3	2
näyttely joka esitteli poliisien työssään tarvitsemia välineitä	työssään	4	3
Et todella tule katumaan päätöstäsi !	päätöstäsi	4	2
Suuret ikäluokat tyytyvät osaansa , koska ovat hampaattomia lampaita .	osaansa	3	3
Ulkona pakkasessa on talven ihmemaa , jonka keskelle minäkin tänä iltana suunnistan kulkuni .	kulkuni	12	1
Käydäänpäs välillä vilkaisemassa minun autoani .	autoani	4	1
Teollisuusjohtajat kustansivat tuotantolaitostensa yhdyskunnille kirkkorakennuksia .	tuotantolaitostensa	2	3
Kulttuurintuotteet tulevat olemassa oleviksi vasta vuorovaikutuksessa käyttäjiensä kanssa , sanoi vuoden humanistitohtorin valinnan tehnyt emeritusprofessori Reino Kero .	käyttäjiensä	6	3
Teleste pitää loppuvuoden näkymänsä ennallaan .	näkymänsä	3	3
Ylen entinen pääjohtaja Sakari Kiuru toivoi maanantaisessa kolumnissaan , että .	kolumnissaan	7	3
Tartun pulloon ja puristan leukojani tiukemmin yhteen , jotten purskahtaisi .	leukojani	4	1
Sinulla on onnea - paitsi että lupaa ottaa Sinut vastaan hän myös osoittaa lämmintä mielenkiintoa sinun vaiheitasi kohtaan .	vaiheitasi	16	2
Malcolm Harbourin erinomaisessa mietinnössä meitä kehotetaan tarkastelemaan tutkimusaloitettamme , ja suhtaudumme myönteisesti juuri tähän näkökantaan ja kannatamme sitä .	tutkimusaloitettamme	7	1
Väläytän hurmaavan ja vinohampaisen hymyni .	hymyni	4	1
Tarkoituksenani on aluksi hiukan harjoitella elektroniikkarakentelua ja Arduinon ohjelmointia ( ohjelmointi tapahtuu C/C++:n kaltaisella kielellä ) , jonka jälkeen lähden todennäköisesti kehittämään ainakin intervalliajastinta ja siihen moottoritoimista liikkuvaa jalustaa .	Tarkoituksenani	0	1
Tein heti selväksi , että lapset ovat minulle tärkeintä elämässäni .	elämässäni	9	1
Suonet anteeksi , jos epäilen sanojasi .	sanojasi	5	2
Soitettuaan vuosia bändissä nimeltään Heatmiser , Smith aloitti soolouransa vuonna 1994 .	soolouransa	8	3
Tunnen melkein ylpeyttä olohousuistani ja hupparistani .	hupparistani	5	1
Päinvastoin : kesäni oli paras vuosiin .	kesäni	2	1
Nuorekas pääministeri Tony Blair ja hänen uranaispuolisonsa Cherie aloittivat uuden tyylikauden .	uranaispuolisonsa	6	3
Mikäli jokin asia jää sinulle epäselväksi , lähetä lisäkysymyksesi osoitteeseen .	lisäkysymyksesi	8	2
Oma varma kikkani taxikeskuksen huutaessa varattua ( taas toimi ) on mennä Pohjois-Tapiolan ABC:lle ja kysyä tauolla olevilta taxikuskeilta , josko tauon jälkeen ehtisivät heittää meidät päämäärään .	kikkani	2	1
Mutta jotenkin tämä sopi vain minulle , halusin että tunnen kuinka elintoimintoni hiipuvat .	elintoimintoni	11	1
Vanhimpana minun tehtävänäni on avata tämä istunto , ja tämän parlamentin kaikkein vanhimpana sallinette minun tehdä muutaman lyhyen henkilökohtaisen huomautuksen .	tehtävänäni	2	1
Kenties tämä voisi olla yhteinen alueellinen tehtävämme , Lönnberg visioi .	tehtävämme	6	1
Huolehtikaamme vain siitä , että saamme entistä laadukkaampaa perunaa lautasellemme - ja paljon .	lautasellemme	9	1
Nyt yritys on pyytänyt Yhdysvaltain suurimpiin kuuluvan vakuutusyhtiön , WellPointin asiakkaita arvostelemaan lääkärikokemuksensa , ja arvoimaan esimerkiksi lääkärinsä kommunikointikykyä ja tämän kanssa saavutettua luottamussuhdetta .	lääkärikokemuksensa	12	3
Seppä hörppää haaleankitkerän kahvitilkan kupistaan .	kupistaan	4	3
Sosiaalidemokraattien osalta presidentinvaalin marssijärjestys on se , että Sdp:n puoluekokous pyytää presidentti Mauno Koivistoa ehdokkaakseen kesäkuussa .	ehdokkaakseen	14	3
Jo Turun keskustan puoli viiden ruuhkassa mielemme valtaa lähes kosminen ihmetys ja kauhu .	mielemme	6	1
En anna sen kuitenkaan pilata fiilistäni , vaan tarkkailen onko unelmieni nainen ilmestynyt tyhjästä heidän joukkoonsa .	fiilistäni	5	1
ennen Italian MM-kisoihin lähtöä suomalaiset kiekkoilijat ilmoittivat ensikertaa tavoitteekseen kultamitalit .	tavoitteekseen	8	3
Harvoihin löytöihini kuului Bikbokista bongattu “ pappakalsaritakki ” .	löytöihini	1	1
Molemmat olivat kovin kiinnostuneita ja he olivatkin heti ottaneet yhteyttä tutkimusvastaavaan , joka oli sanonut isäni täyttävän kaikki kriteerit .	isäni	15	1
Tuijotin silmäni kipeiksi leikkikalukaupan ikkunassa esillä olevia pienoisrautateitä ja niillä puhisevia vetureita .	silmäni	1	1
Hetken aikaa katsoimme sitä kiveä , sitä joka tunsi kyyneleeni , sitä kiveä , jossa luki : ' Rakas poika , veli ja enkeli ' .	kyyneleeni	9	1
Obama puhui ulkomaista ja niiden johtajista yksityiskohtaisesti ikään kuin vakuuttaakseen yleisölle ulkopoliittista tietämystään .	tietämystään	12	3
Sain rahaa ystävältäni	ystävältäni	2	1
Meidän perheemme joulujuhlaa vietetään huomenna , sillä koko perhe lennähtää jouluaatoksi eri teille .	perheemme	1	1
Pienet vauvat eivät tietenkään voi kertoa lihaskivuistaan tai muista oireistaan .	oireistaan	9	3
Tämän postauksen angstivibat eivät muuten olleet mielikuvituksenne tuotetta , jos ehditte jo luulla niin .	mielikuvituksenne	6	2
Ministeriö alensi ensimmäisen neljännen kasvuvauhtiarvionsa 1,9 prosentista 0,4 prosenttiin .	kasvuvauhtiarvionsa	4	3
Miehille Yhdistyneet Arabiemiirikunnat on tietysti hyvä paikka asua , koska kaikki tapahtuu heidän ehdoillaan .	ehdoillaan	13	3
Onneksi istuit viereeni painaen pääsi olkapäälleni .	olkapäälleni	5	1
Leikkitoverini olivat mustia lapsia .	Leikkitoverini	0	1
- Haluan jatkaa lahjoituksellani sukuni perinteitä .	lahjoituksellani	3	1
Oletteko ostanut viimeksi kuluneen kuukauden aikana talouteenne uusia jalkineita ja jos , niin mistä seuraavista liikeryhmistä ?	talouteenne	6	2
Luullakseni ainakin minun lähettämäni kirjeet luettiin vankilassa , mutta käsittääksemme mitään viestejämme ei sensuroitu .	viestejämme	11	1
Iberian aateliset eivät juuri vastustaneet heidän toimiaan .	toimiaan	6	3
Luulin ensin , että hän jännitti näitä minun juhliani , mutta ei tietenkään .	juhliani	8	1
MIES : En mä sun naamaasi naura , vaan sitä kuinka joku ihminen voi olla noin onnesta sekaisin yhdestä puuropurkista .	naamaasi	5	2
Velkaantunut voi pahentaa omaa tilannettaan selvästi myös unohtamalla kokonaiskuvan ja keskittymällä yhden velan hoitamiseen .	tilannettaan	4	3
Miksi niin moni mies kertoo , kuinka ” se makasi kuin lahna , ei koskettanut minun kalua tai mitään muutakaan paikkaa , se odotti vain valmista , ei edes suudellut ” .	kalua	16	1
Välillä minusta tuntuu , että olen ainoa , joka ei ole hyväksynyt kohtaloaan alkoholille elämänsä perustavana pikkukaupungin tyypillisenä asukkaana , välillä taas vajoan epätoivoon , koska en saata keksiä vaihtoehtoista identiteettiä itselleni .	kohtaloaan	12	3
Pitäkäähän varanne , ett eivät omat rakkaat lapsenne käänny joskus teitä vastaan .	lapsenne	7	2
Toivonkin , että neuvosto antaa sopimukselle hyväksyntänsä mahdollisimman nopeasti , toisin sanoen kokouksessaan 22. maaliskuuta .	kokouksessaan	12	3
Raportissa muistutetaan lentokentistä tulleen merkittävä tekijä ympäristönsä kehitykselle .	ympäristönsä	6	3
Sytkyt jatkavat syyskaudella yhteistyötään Helsingin kaupunginteatterin kanssa sekä vierailevat mm. Saksassa , Itävallassa ja Ruotsissa .	yhteistyötään	3	3
John Grishamin juristiromaaneissakin nämä nuoret kokelaat sitten raataa kahdeksankymmenen tunnin työviikkoa jossakin isossa lakifirmassa päästäkseen nelkytvuotiaana määräämään vaihtosuhteensa ehdoista määräämään mitä töitä ottavat hoitaakseen ja pelatakseen suurimman osan ajastaan golfia Floridassa .	vaihtosuhteensa	17	3
tulen myöhemmin tarjoamaan myös novellikokoelmaani yhtiöllenne .	novellikokoelmaani	4	1
Minä myin autoni	autoni	2	1
Olet rohkea , horoskooppimerkkisikin on leijona , ja ennen tuntien alkua istahdat hänen viereensä koulunkäytävällä .	horoskooppimerkkisikin	3	2
Hänen silmistään huutaa pelko miehen , josta hän on ollut vieraantumisestaan huolimatta hyvin riippuvainen , kuolemasta .	vieraantumisestaan	10	3
Tutuksi tuli erityisesti venäläisten nuorten tapa elää , joka ymmärrettävästi on sydäntämme lähellä .	sydäntämme	11	1
Ferrand ei voisi kuvitella itsensä tai ystäviensä innostuvan kommunismista tosissaan	ystäviensä	6	3
Sain pienokaiseni rinnalleni ja ajattelin etten ikinä ollut nähnyt mitään niin ihanaa !!	pienokaiseni	1	1
Reseptejä toimitettaessa siirtyvät ostot rekisteritietoihin henkilötunnuksen kautta , eli jos olette näyttäneet Kela-korttinne reseptejä toimitettaessa niin nämä ostotiedot siirtyvät rekisteritietoihinne .	Kela-korttinne	12	2
Säkö muistelee oman rekrytointiprosessinsa sujuneen esimerkillisen rivakkaan .	rekrytointiprosessinsa	3	3
Lukekaapa ja vetäkääpä omat johtopäätöksenne seuraavasta tulosluettelosta miesten 200 metrin vapaauinnissa : .	johtopäätöksenne	4	2
Kun hän joskus palaisi kotiinsa , Q:lla olisi mukanaan ehkä puolet reppunsa sisällöstä , mutta hänen ihonsa tuoksuisi vielä auringolta .	ihonsa	16	3
Yhtye julkaisi tapahtumassa Welterwerk-albuminsa , jonka kappaleista heidän esityksensä koostui .	esityksensä	8	3
Meitä harmittaa , että suomalaiset kuluttajat jäävät paitsi meidän oluttamme .	oluttamme	9	1
Kuulen hänen äänensä korvissani , kun hän soittaa minulle tavoitellessaan veljeäni .	veljeäni	10	1
Saitko vasusi täyteen ?	vasusi	1	2
Jos unohdan näyttää Apteekkikorttini reseptejäni käsiteltäessä tai maksaessani kassalla , voiko ostamani tuotteet siirtää jälkikäteen rekisteröintitietoihin ?	Apteekkikorttini	3	1
" Anteeksi myöhästymiseni , toivottavasti et joutunut odottelemaan liian pitkään . "	myöhästymiseni	2	1
Olen täysi vastakohta miehestäni .	miehestäni	3	1
Kaunis tietokonevelhotar taistelee olemassaolostaan mahtavia verkkoterroristeja vastaan .	olemassaolostaan	3	3
Mielessäni mä näin kuvan siitä , kun isoisä antaa mulle piiskaa , enste siitä etten saanu Mollaa takas navettaan elossa , ja sitte siitä että sen tulvapyrskähdyksen , joka Mollan vei , mukana meni ne saappaat	Mielessäni	0	1
Asmo Koskinen ylläpitää ja kehittää vakinaisen toimensa ohella Noormarkussa koulun päätejärjestelmää .	toimensa	6	3
Hugo ilmoitti perheelleen , että koulunkäynti saisi jäädä : hän muuttaisi Paulin kanssa Helsinkiin , pyrkisi Ateneumiin ja tulisi taiteilijaksi .	perheelleen	2	3
Keskustelumme kuulostaa samalta , kuin jos keskustelisimme siitä , miksi veljeni ei ostanutkaan maitoa , vaikka lupasi :	Keskustelumme	0	1
Pienet rahalaitokset voivat halutessaan olla hyödyntämättä poikkeuksia ja täyttää sen sijaan tiedonantovaatimuksensa täysimääräisesti .	tiedonantovaatimuksensa	11	3
Otathan mukaan ystäväsikin .	ystäväsikin	2	2
Eurooppalaista identiteettiä rakentavalla sivistyneistöllämme oli kuitenkin edessään suuri haaste .	sivistyneistöllämme	3	1
Joudun siristämään silmiäni kun aurinko paistaa porottaa ja olen täysin kylläinen tähän päivään .	silmiäni	2	1
Arvoisa puhemies , haluan onnitella herra Caudronia , joka on avoimesti ottanut vastaan näkökantoja ja liittänyt ne mietintöönsä , jota me talousvaliokunnassa olemme pitkään ja hartaasti muokanneet .	mietintöönsä	17	3
joku tamppasi jalkojaan kynnysmattoon .	jalkojaan	2	3
Se sade oli vieny mun huomiota niin paljon , etten yhtään tajunnu kuinka paljon kello oli , ja kun vihdoin tajusin katsoa sitä , päähäni iski vain isoisän ohjeet saappaiden kuivaamisesta saunassa .	huomiota	5	1
Silloin tällöin kuitenkin näkisit hänet , ja aina sydämesi kompassi menisi sekaisin , ensimmäisestä kerrasta siihen viimeiseen asti .	sydämesi	8	2
Viime viikonloppuna Espoonlahdessa Vesa oli taas paraatilajissaan 200 metrillä nopein ja niin myös eilen Malmössä .	paraatilajissaan	6	3
Haluaisin kysyä teiltä , isiltä ja äideiltä , jotka annatte lapsillenne ilmakivääreitä lahjoiksi , että .	lapsillenne	10	2
Tuossa näkyy muuten Disney Couturen Pocahontas-korunikin , uskalsin vihdoinkin vihkiä sen käyttöön . :)	Pocahontas-korunikin	5	1
Minulla on parempi kynä käytössäni kuin sinulla .	käytössäni	4	1
Lentokoneessa tyynnyin ja lepyttelin puolisoani , joka on hankalasti tyynnyteltävää sorttia .	puolisoani	4	1
Chirac ei voinut enää väistää velvollisuuttaan tulla kuulusteluun , sillä viran myötä myös hänen oikeudellinen koskemattomuutensa lakkasi .	koskemattomuutensa	15	3
Tässä ois mun ensimmäinen lyhyt novellini .	novellini	5	1
Molla piti pylly pystyssä tohtorinhatustaan kiinni .	tohtorinhatustaan	4	3
Eilisellä kotimatkalla , kun raahasin miljoona laukkujani / kassejani / pussukoitani rautatieasemalta kotiin , vasenta jalkaani alkoi vihloa .	jalkaani	15	1
Vähän aikaa on olo kuin katsoisi uutta passikuvaansa , että tuonko näköinen minä nykyään olen .	passikuvaansa	7	3
Perheeseeni kuuluvat isä Mauri , äiti Johanna , minä ja kaksi pikkuveljeäni , Oskari ja Otto .	pikkuveljeäni	11	1
Huippuunsa säädetyn ilmastoinnin jäähdytys pureutuu opiskelijaan ja pitää virkeänä , vaikka kuinka yrittäisikin kääriytyä toppatakkiinsa .	Huippuunsa	0	3
Olen saanut velvollisuudekseni tutustua moniin uusiin ihmisiin , yhdistyksen toimintaan kokonaisvaltaisesti ja vieläpä opetella olemaan altis vuoden loppupuolella kehittämään sitä .	velvollisuudekseni	2	1
Santala suututti varustamoyhdistyksen joustamattomuudellaan niin pahasti , että .	joustamattomuudellaan	3	3
Onko nyt mun vuoroni ajaa vai ei ?	vuoroni	3	1
Hän rupesi taas juomaan ja vaimo seurustelemaan työtovereittensa kanssa .	työtovereittensa	7	3
Olen tyytyväinen mietintöön , koska sen ansiosta voidaan pelastaa satoja auto-onnettomuuksien uhreja , jotka jäävät loukkuun autoonsa eivätkä pysty käyttämään matkapuhelimiaan vammojensa vuoksi .	vammojensa	21	3
Minun nimeni on Sinikka , mutta jo Pariisissa olin lyhentänyt sen käytännön syistä Siniksi .	nimeni	1	1
Sohkanen kertoo omista kokemuksistaan kansalaissodan aikana Tikkurilassa , rintamalla Kavantsaaressa ja Viipurissa , ja lopulta Helsingin valtauksen sekasortoisista tapahtumista ja vankeusajastaan Suomenlinnan vankileirissä .	vankeusajastaan	20	3
Mummo oli menettänyt sodassa isänmaansa , äidinmaansa , veljenmaansa sekä sukulaisensa .	äidinmaansa	6	3
Pidättäytymisemme äänestämästä osoittaa vastalauseemme pankkijärjestelmän niin kansallista kuin eurooppalaista järjestelmää vastaan .	Pidättäytymisemme	0	1
Kansliapäällikkö halveksi miestä koko loppuikänsä luonnehtien häntä kansliapäällikköaikansa tyhmimmäksi oikeusministeriksi .	loppuikänsä	4	3
Sitäkin on sopiva hetki miettiä , miten me kehitämme edunvalvontaamme .	edunvalvontaamme	9	1
- Kai sitä nyt koulukaslinjasa kuskin jokkainen tietää !	koulukaslinjasa	4	3
Kokljuschkin erotettiin Topmostista , jonka jälkeen hän aloitti keikkailun tyttöystävänsä Pian kanssa .	tyttöystävänsä	9	3
Ymmärrän kyllä sen , että jos presidentti tarvitsee avustajan muistelmiensa kirjoittamiseen tai johonkin muuhun entiseen tehtäväänsä liittyvään työhön , niin sellainen voidaan palkata valtion varoin .	muistelmiensa	9	3
Sen , jonka Peku oli miehelleen jouluna ostanut .	miehelleen	5	3
Potilaan voimavaraistumista tukevan ohjauksen ideana on se , että potilas saa tietoa , joka vastaa hänen omia odotuksiaan ja tietorakenteitaan .	odotuksiaan	17	3
- Mielestäni opiskelualallani on hyvät kesätyönäkymät , Björk sanoi .	Mielestäni	1	1
Setäni omistaa valokuvaamon	Setäni	0	1
Nuoret tutkijat -viikon avannut professori Tero Soukka painotti tiistaisessa avajaispuheenvuorossaan , kuinka tärkeää nuorelle tutkijalle on pystyä puhumaan omista tutkimustuloksistaan .	tutkimustuloksistaan	19	3
En ole löytänyt - kahta paitsi - ketään , jolla ei sydämessään , silmäkulmassaan tai suupielessään olisi pientä vihreää virinää .	silmäkulmassaan	13	3
Mutta eiköhän tämä ole minunkin tapauksessani ohimenevää .	tapauksessani	5	1
Isä valitsi kolmesta tyttärestä seuraajakseen Libušen , joka osoittautui viisaaksi hallitsijaksi .	seuraajakseen	4	3
Miltä tuntuisi , jos työnantajasi voisi silmäillä geenejäsi työhönotossa ?	työnantajasi	4	2
Onko isäsi todella sanonut niin ?	isäsi	1	2
Haideria on arvosteltu myös hänen puhetyylinsä rajuudesta .	puhetyylinsä	5	3
Mieleeni juolahti , että voisin kokeilla jotain uutta .	Mieleeni	0	1
He unohtivat laukkunsa .	laukkunsa	2	3
Espanjan hallitus ilmoitti , että pääministeri Jose Luis Rodriguez Zapatero keskeytti tiistaina alkaneen lomansa ja palasi Madridiin keskiviikkoaamuna .	lomansa	13	3
Kynäni on rikki .	Kynäni	0	1
Väriltään se on päältä ruskea ja alapuolelta harmahtava .	Väriltään	0	3
Paljon suurempi kuin rivitaloasunnon etu- ja takapiha yhteensä , jopa suurempi kuin kotikatuni pienpihaisimmilla omakotitaloilla .	kotikatuni	12	1
Kuitenkin Matista ja hänen kolmesta veljestään tuli kauppiaita .	veljestään	5	3
Hän kärsi entuudestaan verenkiertohäiriöistä , joiden takia hänen pelaaminen ottelussa oli epävarmaa .	pelaaminen	8	3
Minulla oli ikävä poikaani .	poikaani	3	1
Melko nopeasti hän palasi , ihan tajuihinsa .	tajuihinsa	6	3
– Sitä en tiedä , katseliko ryssän vakooja toimiani tai veikö salakuljettaja jätökset ryssänpuolelle .	toimiani	8	1
En tiedä , paljonko komission jäsen voi vielä parantaa tilannetta , mutta meidän olisi pyrittävä vähentämään ilman epäpuhtauksia ja meidän pitäisi tukea hänen ponnistelujaan asiaa koskevissa neuvotteluissa .	ponnistelujaan	23	3
Poikani ja tyttäreni ovat vesipetoja , mistä lie geeninsä perineet .	Poikani	0	1
Äiti vei poikansa terveyskeskukseen ja siitä lääkärikeskukseen .	poikansa	2	3
Ja jos lapset saavat päähänsä remeltää niin , että pöytä keikahtaa , on serkun keraamiselle astialle pinoamat kakut ja limpparit vaarassa kokea romahduksen .	päähänsä	4	3
Katselin etuhampaansa menettänyttä pikkupoikaa .	etuhampaansa	1	3
Koitin pitää kaupungilla mieleni avoinna , mutta keskittyä silti etsimään vain minua oikeasti kiinnostavia asioita .	mieleni	3	1
Voisin harkita myymistä sillä ehdolla , että te kaikki saatte pitää työpaikkanne .	työpaikkanne	11	2
Arvoisa puhemies , haluaisin sanoa kollegoilleni , että jälleen kerran pelkään , että parlamenttimme on turhan vaatimaton .	kollegoilleni	5	1
Voitko tehdä ruokaostoksesi Stockan Herkussa ilman , että joku liimautuu kannoillesi höpöttämään ?	ruokaostoksesi	2	2
Hevostensa rääkkäyksestä tuomittu mies	Hevostensa	0	3
Rankilan aloite ilahduttanee myös monia ikäihmisiä , joilla on koira ystävänään ja turvanaan .	ystävänään	10	3
Sohkanen kertoo omista kokemuksistaan kansalaissodan aikana Tikkurilassa , rintamalla Kavantsaaressa ja Viipurissa , ja lopulta Helsingin valtauksen sekasortoisista tapahtumista ja vankeusajastaan Suomenlinnan vankileirissä .	kokemuksistaan	3	3
Näiden esimerkkien lisäksi tiedekuntamme sisältä löytyy kyllä myös monia välimalleja opintopisteisiin vaadittavista työmääristä .	tiedekuntamme	3	1
Moni maa on jo syönyt velkaantumisvaransa .	velkaantumisvaransa	5	3
Sen jälkeen on parasta , että tarvittaessa tallennat työsi , koska kun varaamasi aika loppuu , ohjelma lukitsee työaseman .	työsi	8	2
Samassa yhteydessä on paljastunut professori Virtasen saaneen tupakkayhtiöltä runsaan rahallisen korvauksen lausunnostaan .	lausunnostaan	11	3
Euroopan komissio korosti jo vuonna 1994 ensimmäisessä maahanmuutto- ja turvapaikkapolitiikkaa koskevassa tiedonannossaan , kuinka tärkeätä olisi luoda järjestely muuttovirtojen seuraamiseksi koko EU:ssa mahdollisimman laaja-alaisesti .	tiedonannossaan	11	3
Mikäli vanhemmat eivät osaa ottaa lasta huomioon ja osoittaa tälle , että hän on yhtä hyvä , vahva ja taitava kuin vanhemmatkin , niin lapsen mieli järkkyy ja hänen itsetuntonsa ei vahvistu , ja hänen psyykensä voi vaurioitua .	itsetuntonsa	29	3
Hän unohti oman viimeisen kysymyksensä	kysymyksensä	4	3
Kävipä näin : laukkuni jäi Länsilinjojen bussiin	laukkuni	3	1
Ottakoon tästä opikseen .	opikseen	2	3
Kaarle ( Charles Théodore Henri Antoine Meinrad / Karel Theodoor Hendrik Anton Meinrad ) syntyi Brabantin herttuan ja tulevan kuninkaan Albert I:n ja hänen puolisonsa Elisabethin , syntyjään herttuatar Baijerissa , toisena poikana .	puolisonsa	24	3
Mielestäni tämä keskustelu tiivistyy seuraavaan kysymykseen : uskommeko , että Göteborgin pöytäkirja oli paras tulos , jonka jäsenvaltioiden voidaan odottaa realistisesti saavuttavan ?	Mielestäni	0	1
Ilta laskeutui auringon takaa ja annoin hiuksieni mennä tuulen mukana kun ajoin vanhalla Saint -polkupyörälläni pitkin kuolleiden lehtien katuja , silloi minusta tuli astronautti ja nousin raketillani jo stratosfääriin .	hiuksieni	6	1
" Harkitse nyt vielä kerran " , aneli ulkoilupusakkani pidellen molemmin hihoin kiinni käsivarrestani .	ulkoilupusakkani	8	1
Välttämättä nykyinen lakikielemme ei ole ymmärrettävyydeltään selkeämpää ja sanonnaltaan iskevämpää kuin Ruotsin valtakunnan lain vanha suomennos .	lakikielemme	2	1
Hän itse kertoi , että hänen tarkoituksenaan oli rynnätä parvekkeelle ja hypätä sieltä alas .	tarkoituksenaan	6	3
Panhelainen aprikoi " haluaakohan visaisäntä testata , ovatko visan herrakerholaiset ehtineet kaikilta kiireiltään lukea lapsilleen ? "	kiireiltään	12	3
Peku ei oikeastaan tunne mitään ajatellessaan ystäviään , vanhempiaan tai miestään .	ystäviään	6	3
en itkultani enää pystynyt puhumaan .	itkultani	1	1
Haluaisin kysyä teiltä , isiltä ja äideiltä , jotka annatte lapsillenne ilmakivääreitä lahjoiksi , että tiedättekö mitä lapsenne niillä tekevät ?	lapsillenne	10	2
Nyt painotetaan kotimaisen kulutuksen lisäämistä , sillä vasta se toisi tärkeän piristysruiskeen talouteemme .	talouteemme	12	1
Jos muut toimijat kopioivat meidän konseptin , siitä voi olla haittaa tavaramerkillemme , Ikean tiedottaja Ylva Magnusson sanoi DN:lle .	tavaramerkillemme	11	1
Yleisradion rahoitusta pohtinut työryhmä antoi tänään viestintäministeri Suvi Lindénille ( kok. ) raporttinsa , jossa ehdotetaan jokaisen kotitalouden maksettavaksi noin 175 euron vuosittaista mediamaksua .	raporttinsa	12	3
Katsoin kelloa uudestaan , ja mielessäni laskin kuinka kauan menisi tässä sateessa taluttaa Molla takaisin meidän navettaan .	navettaan	16	1
Mut siinä oli aina hyvä konsti niin aina sanoa sitten että tota toinen joka oli niinku vähän enemmän tolkuissaan nii sille että ku sä oot tommonen vähän viksumpi mies niin voisitko viedä ystäväs pois .	ystäväs	32	2
Pääosin valuma-alue kuuluu Tammelan kuntaan , mutta ulottuu latvoiltaan myös Forssan , Urjalan , Hämeenlinnan , Hattulan , Lopen , Karkkilan , Nummi-Pusulan ja Someron alueille .	latvoiltaan	8	3
Oman mielenkiintonsa kohde on Marseille , jossa UMP-puolueen kunnanjohtaja Jean-Claude Gaudin ylsi 41,03 % annetuista äänistä , kun hänen pahin kilpailijansa sosialistinen Jean-Nöel Guérini saa äänistä 29,14 % .	mielenkiintonsa	1	3
Suomen tasavallan presidentti Tarja Halonen on esittänyt illalla Espanjan kuninkaalle Juan Carlosille surunvalittelunsa onnettomuuden johdosta .	surunvalittelunsa	12	3
sitten taas kerran pelästyin omia ajatuksiani	ajatuksiani	5	1
Hän hymähteli ja örähteli puheilleni .	puheilleni	4	1
Täytyy myöntää , että huoneeseeni päästyä kiedoin kerran käytetyn pyyhkeen pitkiin hiuksiini ja peitin puhtaan varteni kylpytakilla , mutta jos olisin lyhythiuksinen ja kiireinen , olisin voinut aivan hyvin vain pyyhkäistä hiukseni kuivaksi ( käsipyyhkeeseen ) ja pukeutua samantien .	hiukseni	31	1
Hän korosti seminaaripuheenvuorossaan uhrin aseman ensisijaisuutta arvioitaessa sitä , missä tilanteissa on kyse ihmiskaupasta .	seminaaripuheenvuorossaan	2	3
Jos ottaisimme Humen giljotiinin * elämänohjeeksemme , emme voisi suunnitella elämäämme emmekä ylipäätään ... no , tehdä paljon mitään .	elämänohjeeksemme	5	1
Viisumi on saatava nopeammin , halvemmalla ja yksinkertaisemmin , ja Euroopan parlamentille on annettava mahdollisuus lausua mielipiteensä neuvotteluvaltuudesta , jota parhaillaan valmistellaan .	mielipiteensä	16	3
Hänen sisaruksiaan olivat Aino Sibelius , taidemaalari Eero Järnefelt ja säveltäjä Armas Järnefelt .	sisaruksiaan	1	3
Haluaisin kulkea oman taloni omalla nurmikollani paljain varpain	nurmikollani	5	1
Olkaamme suomalaisia ja esittäkäämme asiamme mahdollisimman pitkälle suomalaisesta näkökulmasta muuttuvassa Euroopassa .	asiamme	4	1
Tuoko on teidän uusi autonne ?	autonne	4	2
Jaksan lähteä baariin tarkkailemaan ympäristöäni .	ympäristöäni	4	1
Ekskun jälkeen festiseurueemme palasi kiltikselle , jossa killan tietokoneet joutuivat turkulaisten himojen välikappaleiksi .	festiseurueemme	2	1
Pihkala häiritsi opetusta muutenkin , enimmäkseen kuitenkin aika hyvillä piloillaan .	piloillaan	9	3
Ja sitten on tämä uusi kymmenluku , johon totuttautuminen kestää varmasti oman aikansa .	aikansa	12	3
Kaijasilta päätti vaihtaa maisemaa löytääkseen kadonneen maalijyvänsä , ja uudeksi seuraksi valikoitui VPS .	maalijyvänsä	6	3
Haluan kokeilemaan siipiäni	siipiäni	2	1
Meidän välimme ovat hyviä	välimme	1	1
mikäli politiikalla yleensä ymmärretään sitä , mitä esim. sinä ja puoluetoverisi ovat tässä maassa ehtineet vuosikymmenet harjoittaa .	puoluetoverisi	10	2
Ruotsalainen menetti ajokkinsa hallinnan oikealle kaartuvassa mutkassa päätyen syvään ojaan .	ajokkinsa	2	3
Tai sitten juutalaiset tuhoavat itse valtionsa käymällä toistensa kimppuun kuten silloin , kun temppeliä olisi pitänyt yhdessä puolustaa pari tuhatta vuotta sitten .	valtionsa	5	3
Hän on taitava käsistään .	käsistään	3	3
Aleksei Sultanov on tällä hetkellä yksi kaikkein kuumimpia nimiä uudessa pianistikaartissa - paitsi ei tietenkään kotimaassaan .	kotimaassaan	15	3
Kuvia saavutuksestamme ei ole esittää , sillä värvätty kuvaaja koodasi eikä huomannut tapahtumia .	saavutuksestamme	1	1
Sekoitetaanko sinut usein roolihenkilöösi ?	roolihenkilöösi	3	2
No , ei oltais voitu valita parempaa paikkaa ja aikaa meidän minilomalle !	minilomalle	11	1
Tämä on ensimmäinen kymppini .	kymppini	3	1
Se oli minun ratkaisuni .	ratkaisuni	3	1
Mutta sittenkin , saisinko nimesi että voisin jotenkin korvata !	nimesi	4	2
Ja yllätysyllätys muutaman tunnin päästä olin ajatunut parisuhdekriisiin typerän vänkäämiseni ansiosta .	vänkäämiseni	9	1
Kysyä toki voi kommenteissa , vaikka voi olla , etten osaa vastata kysymyksiinne .	kysymyksiinne	12	2
Kolmatta kertaa pidetyssä ICT ShowRoom -tapahtumassa Turun yliopiston , Åbo Akademin ja Turun ammattikorkeakoulun yli 30 opiskelijaryhmää esittelivät projektitöitään .	projektitöitään	18	3
Tutustuimme uusiin opettajiimme .	opettajiimme	2	1
Saimme juuri viestin Presidentiltämme Martti Ahtisaarelta ja samaan aikaan sekä USA:sta , että Japanista .	Presidentiltämme	3	1
Markkasen osanotto PM-turnaukseen oli jo ennen vammaa epävarma , sillä hänen mukaantulonsa olisi ratkennut hänen seuransa St. Josephin ohjelman perusteella .	seuransa	15	3
Arvoisa puhemies , haluaisin sanoa kollegoilleni , että jälleen kerran pelkään , että parlamenttimme on turhan vaatimaton .	parlamenttimme	13	1
Leipäidentiteettiäni kyseenalaistaessa heitän kuitenkin nyt hirvipadan reseptin .	Leipäidentiteettiäni	0	1
Työskenneltyään muutaman vuoden Ignatiuksen alaisena Italiassa Rodrigues lähetettiin synnyinmaahansa Portugaliin .	synnyinmaahansa	8	3
Kekkosen kaatoon haettiin moraaliltaan ja kansalaiskunnoltaan ryvettymätöntä henkilöä .	kansalaiskunnoltaan	5	3
Ensimmäinen rappion merkki miehellä on , jos hän jättää partansa ajamatta .	partansa	9	3
Mulla olis kaikenlaista juotavaa huoneessani .	huoneessani	4	1
Tiedustelemme isänniltämme , että noinkohan Accenturella mahtaisi tulevaisuudessa olla toimipiste Turussakin .	isänniltämme	1	1
Vihreät ilmoittivat ryhmäpuheenvuorossaan antavansa jäsenilleen kuitenkin vapaat kädet .	jäsenilleen	4	3
Olen vasta toisen vuoden opiskelija , joten ehkä ajattelukykyni on vielä hieman puutteellinen , mutta minun silmiini nuo kolme eri kurssia vaikuttaisivat jakavan opintopisteensä hyvin erilaisiin työmääriin perustuen .	ajattelukykyni	8	1
joulujuhlaa pukkeineen päivineen	päivineen	2	3
Mårten heitti satulalaukut hevosensa selkään , nousi satulaan ja ratsasti ulos Tukholmasta .	hevosensa	3	3
Toiseksi jäsen Martínezin havainnot ja minun havaintoni Kuubasta eivät ole samanlaisia .	havaintoni	6	1
Andylla on nähtävästi tarkat käsitykset naisista ja heidän kunnollisuudestaan .	kunnollisuudestaan	8	3
Lopulta sekä loput Tyrvään kunnasta , että Karkun kunta kokonaisuudessaan yhdistettiin Vammalan kaupunkiin vuonna 1973 .	kokonaisuudessaan	9	3
Avasimme termospullomme ja joimme kahvit .	termospullomme	1	1
Arvosta itseäsi ja lahjojasi ja muut seuraavat kiltisti perässä .	lahjojasi	3	2
He olivat ilmoittautuneet sinun luennollesi .	luennollesi	4	2
Oma ikkunani nousee vosun puuskuttaessa kärpäslasinsa huuruun .	ikkunani	1	1
Oppimispäiväkirjan kirjoittaminen aiheutti hajoilua , jota kuvastaa parhaiten parivaljakkomme päiväkirjaan kirjoittamat nimet : ” mies Simo Kauhala , huomaa syrjivä etuliite ” ja ” J. Rajajärvi ” häpeillen miehekästä etunimeään .	parivaljakkomme	8	1
Lapsi muistuttaa mummiaan .	mummiaan	2	3
Tässä yhteydessä haluan osoittaa kunnioitukseni komission edustajalle , jolla oli – ja on edelleen – merkittävä tehtävä Addis Abebassa .	kunnioitukseni	4	1
Dora kilisytti sulavia jääpaloja lasissaan .	lasissaan	4	3
Mielikappaleeni on Satumaa , olen opetellut sen ulkoa , paljastaa Ilkka mieltymyksensä tangoihin .	Mielikappaleeni	0	1
Trokarit tai venäläisittäin jobbarit hankkivat leveämpää leipää ostamalla turisteilta länsitavaraa ja myymällä sitä huikeaan hintaan maamiehilleen .	maamiehilleen	15	3
Toisin sanoen jos emme pääse yksimielisyyteen perustuslakisopimuksesta vuoden loppuun mennessä , se laimentaa tehokkaasti ihmisten äänestysintoa , koska viestitämme silloin kansalaisille , että eurooppalainen ihanteemme on kriisissä .	ihanteemme	24	1
RIM:n maailmanlaajuinen myynti kasvoi kuitenkin Latinalaisen Amerikan vetämänä , missä RIM on markkinajohtaja 28 prosentin osuudellaan .	osuudellaan	15	3
Ajatusvirtani jatkaa tuohtunutta tulvaansa .	tulvaansa	3	3
Poika repäisi sivun vihostaan , kirjoitti ' pidä huoli itsestäsi ' , ja taitteli sen nätisti äidin etutaskuun .	vihostaan	3	3
Kuusi vuotta myöhemmin paavi Paavali III antoi siunauksensa veljeskunnalle .	siunauksensa	7	3
Hän oli valmis uuteen päivään tuttuine rutiineineen , tunsi lempeän lämpimän tuulenvireen rinnassaan ja olisi kiittänyt aurinkoa verbaalisesti , jos olisi ollut vähäjärkisempi .	rinnassaan	12	3
Sanoin kollegalleni Paula Koivuniemelle , että --	kollegalleni	1	1
Olen viettänyt tämän päivän kuvainnollisesti oman asuntoni vankina .	asuntoni	6	1
Puute jäi vain kaivertamaan sisimpääni .	sisimpääni	4	1
Kuusamon koskenlaskukisa on ainutlaatuinen elämys kokemusvarastooni .	kokemusvarastooni	5	1
Hänellä on luultavasti synteettisiä siirrännäisiä nenässään .	nenässään	5	3
Wetherbyn väkiluku on 22_000 , ja se on hyvin tunnettu kilparadastaan .	kilparadastaan	10	3
Mieluummin minä radalla olen kuin hautajaisissa , tuumii joulukuussa 50-vuotisjuhliaan viettävä suomalaisen moottoriurheilun legenda .	50-vuotisjuhliaan	9	3
Ihmiset puhuvat elämästään juhlallisin ilmaisuin , on kuin kuuntelisi Aki Kaurismäen dialogia .	elämästään	2	3
Tosiaan sanotte siellä laboratooriossa vaan nimenne ni he tietää sitte mitä ottaa ja , siitä tulee sitte kotio siitä .	nimenne	5	2
jotta he voivat nämä edellytykset täyttää , heidän persoonansa täytyy olla jakautunut .	persoonansa	8	3
Loki osaa kertoa vain sitsien ulkopuolisista tapahtumista , sillä toinen lokikirjamme hävisi sitsien saatossa .	lokikirjamme	10	1
HS julkaisi pari päivää sitten vaalikoneensa datan avoimesti kaikkien käytettäväksi .	vaalikoneensa	5	3
Mietin , jaksaako vanhuksia ihan oikeasti meidän pienessä kämpässä , varsinkin jos tutkimusjakso on useita päiviä kerrallaan .	kämpässä	8	1
Olisin pettynyt , jollei Assa-Abloy pystyisi kaksinkertaistamaan nykyistä liikevaihtoaan .	liikevaihtoaan	8	3
Ja silloin minä ensimmäistä kertaa kunnolla näen hänet silmissäni .	silmissäni	8	1
Eilisellä kotimatkalla , kun raahasin miljoona laukkujani / kassejani / pussukoitani rautatieasemalta kotiin , vasenta jalkaani alkoi vihloa .	pussukoitani	10	1
Pistoolinlaukauksesta , ruudinkärystä ja veren hajusta hermostunut hevonen kavahti takajaloilleen ryövärien lähestyessä sitä .	takajaloilleen	9	3
Minulla olisi ollut yksi kerran käytetty pyyhe huoneessani , mutta yläkertaan oli liian pitkä matka ja olin jo ehtinyt riisua vaatteeni .	vaatteeni	20	1
Älkää ihmeessä ottako kotiinne pääsiäistipuja , vaikka kuinka tekisi mieli ja vaikka kuka pyytäisi .	kotiinne	3	2
Oliko asuintalollasi tai -korttelilla nimeä ?	asuintalollasi	1	2
Hän oli sahannut yhden haulikoistaan , sopinut tapaamisesta Huurteen kanssa pääsiäismaanantaina .	haulikoistaan	4	3
Wienin-vuosinaan Penttilällä oli myös viinitila Toscanassa , Italiassa .	Wienin-vuosinaan	0	3
Huvilassa näytti olevan makuuhuone ja iso tupa takkoineen .	takkoineen	7	3
Lisäksi voi arvioida omaa herkkyystasoaan esimerkiksi yhdessä hoitavan lääkärin kanssa .	herkkyystasoaan	4	3
Turvamieheksemme oli otettu eräs opexilaistyttö , joka suojeli meitä pelottavilta feministeiltä .	Turvamieheksemme	0	1
Vapaaehtoistyöllä on edelleenkin se merkittävin osuus meidänkin tapahtumassamme .	tapahtumassamme	7	1
Olisi tehnyt mieli vastata vaikka mitä , mutta suljin suuni sekä esitteen ja käännyin lasteni puoleen .	suuni	9	1
Miksi emme pidä seksuaalielämäämme usein kovinkaan hyvänä ?	seksuaalielämäämme	3	1
Sinun virkaurasi kääntyi juuri rajuun nousuun .	virkaurasi	1	2
− Tuolloin tytöt eivät saaneet käydä koulua , tietävät useat historianläksynsä lukeneet opastettavat .	historianläksynsä	10	3
Toisaalta suuri osa ihmisistä , olevista ja menneistä , säilyvät jalanjälkineen sydämissämme ilman , että teemme kodistamme vanhojen tavaroiden museon .	sydämissämme	11	1
Nappaan tavarat syliini ja juoksen kompuroiden ulos luokasta .	syliini	2	1
No se Molla , se oli siinä läheisen puron väärällä puolella ja mä liukastelin mutasella peltotiellä niillä isoisän arvosaappailla , enemmän huolissani niistä saappaista kun yhdestä meidän sadasta lehmästä .	lehmästä	28	1
Äitini on taitava tässä puuhassa .	Äitini	0	1
Toisin sanoen Persianlahden tai Aasian kaltaisella suhteellisen tuottoisalla vaikutusalueella toimiva lentoliikenteen harjoittaja suuntaa enemmän voimavaroja lentoyhtiönsä turvallisuuteen .	lentoyhtiönsä	15	3
Voutilaista harmittaa ja säälittää kahden entisen seuransa , Kuusysin ja KuPS:n nykyinen alennustila .	seuransa	6	3
Siellä mies kertasi elämäänsä , kuten ennenkin , ja kaikki hymyilivät hänelle .	elämäänsä	3	3
Eikö se , että tavoitteenani on olla onnellinen , ole kunnianhimoista ?	tavoitteenani	4	1
– Haluamme kukkarosi ja hevosesi !	kukkarosi	2	2
kuka tahansa voi tilata sähkönsä keneltä tahtoo .	sähkönsä	4	3
Meidän täytyy vastata tähän kaikin voiminemme .	voiminemme	5	1
Saadessanne käteenne tämän Kauppalehden toisen EY-lehden on osa lehden tekstistä valitettavasti jo vanhentunutta .	käteenne	1	2
Reitesi lepää omieni päällä ja ihosi pinnalla oleva nukka on herkintä , mitä sinussa on .	Reitesi	0	2
Kaikki tutkimustyön tekijät , olipa heidän perusasenteensa teoreettinen tai käytännöllinen , eivät voi vapaasti valita ongelmiaan .	ongelmiaan	15	3
Romantiikka vaatii romanssia , eikä sinun asunnossasi ole erkkereitä .	asunnossasi	6	2
Kahden viikon kuluttua lapsi siirretään ottovanhempiensa luokse .	ottovanhempiensa	5	3
Lasse pyöritteli päätään .	päätään	2	3
Hän on palkkansa ansainnut	palkkansa	2	3
Ravintolaoppaistaan tunnettu Zagat on laajentamassa käyttäjien arvosteluihin pohjautuvaa liiketoimintaansa terveydenhuoltoon .	liiketoimintaansa	8	3
Salolainen on siis vaatimuksineen liikkeellä hyvissä ajoin .	vaatimuksineen	3	3
Ympäristömme tahallista saastuttamista ei voida sen avulla torjua kunnolla .	Ympäristömme	0	1
Haluaisin kysyä teiltä , isiltä ja äideiltä , jotka annatte lapsillenne ilmakivääreitä lahjoiksi , että .	lapsillenne	10	2
Eräs vanha sukulaiseni , tosin opettaja , haluaa edelleenkin puhua yli 10_000 markan summista vanhoina miljoonina , enkä häntä siitä syytä !	sukulaiseni	2	1
Pohjoisin kolkka siksikin , ettei minun tarvitsisi huolestua kukkeimmalla iälläni niinkään järistysten vaara-asteesta .	iälläni	9	1
Mä hiljensin kävelyvauhtiani , mä en halunnu että se lähtis taas jolkottelemaan pakoon , janoonsa se ei voinu näillä säillä enää juoda .	kävelyvauhtiani	2	1
Savolainen on koulutukseltaan yo-merkonomi ja hieroja .	koulutukseltaan	2	3
Opetusohjelmamme on selvästi muita luonnontieteellisempi .	Opetusohjelmamme	0	1
Kati vilkaisi minua ja levitin käsiäni .	käsiäni	5	1
Kolmanenta iltana olin vähän freesimpi oloasussani , mutta hiuksia en ollut jaksanut harjata päiväsaunan jälkeen .	oloasussani	5	1
Hytin valaistus yhdistettynä kämäiseen pokkariini tekevät vaan optisia temppujaan .	temppujaan	8	3
yleisön suosionsa perusteella yleisö suosii	suosionsa	1	3
Näissä merkeissä se aloitti viime marraskuussa kampanjan tunnettavuutensa puolesta Euroopassa .	tunnettavuutensa	7	3
Toissayönä joku kävi spreijaamassa yhden kauneimmista Mirhabar-matoistani .	Mirhabar-matoistani	6	1
YK:lla on enää kymmenen vuotta aikaa onnistua väestöohjelmissaan	väestöohjelmissaan	7	3
Moolenaar otti käyttöönsä parhaan löytämänsä Vi-kloonin ja alkoi parannella sitä .	käyttöönsä	2	3
Liisa peruutti autonsa katukäytävään .	autonsa	2	3
Se muistuttaa sukulaislajiaan kangassirkkaa .	sukulaislajiaan	2	3
Heräsin aamuyöllä tutkimaan kaikkea tätä ja perhettäni .	perhettäni	6	1
Hän avasi oven hitaasti kyynärpäällään	kyynärpäällään	4	3
Eilen äitini oli jättänyt vastaajaani viestin ja sanoi , että he voisivat osallistua tutkimukseen , mutta siinä on jossakin vaiheessa kolmen kuukauden periodi , jolloin Turussa täytyy käydä joka toinen viikko .	vastaajaani	4	1
Minä tosiaan ajattelin nyt vaan poiketa morjestamaan sinua , täällä sinun omissa kotioloissasi .	kotioloissasi	12	2
Lopulta Moolenaar saavutti tavoitteensa ja alkoi lisätä vähitellen uusia ominaisuuksia , kuten monitasokumous ( multi-level undo ) .	tavoitteensa	3	3
En kuitenkaan iloitse hänen kuolemastaan niin kuin eräät .	kuolemastaan	4	3
Tässä vaiheessa koitin painaa ihmisen kasvoja mieleeni ja moikata tuttuja , mutta ihan se ei onnistunut .	mieleeni	6	1
Sitä , jonka perse sai ohi keikkuessaan miehen niskanikamat paikoiltaan pään kääntyessä luonnolliset 180 astetta .	paikoiltaan	9	3
Olin pukeutunut varsin napsakkaan hameasuun kun sipsutin 12-senttisissä koroissani heittämään hei-heit .	koroissani	8	1
Yksikerroksinen on majapaikkani vielä nuorella iällä , korkeammalle en mieli vielä tähdätä .	majapaikkani	2	1
Hodgkinsonin mukaan suoriutuisimme töistämmekin tehokkaammin , jos erilaisten nautintojen ravitsemina ja kroonisesta stressistä irrottautuneina pitäisimme energiatasomme tasaisesti katossa koko päivän ajan .	töistämmekin	3	1
No , no , rauhoitutaas nyt , Laitinen sanoi ja kiersi nyrkkiään puoli kierrosta .	nyrkkiään	11	3
Se analysoi tekstin kirjain kerrallaan , ja tietää useimmat alkoholin vaikutuksesta johtuvat kirjoitusvirhetyypit .	kerrallaan	4	3
perhe on viettänyt kaikki kesälomansa vesillä jo parikymmentä vuotta .	kesälomansa	4	3
Tällä perusteella olen vakaasti sitä mieltä , että Euroopan pitäisi pystyä suojaamaan omia lentoyhtiöitään yhä armottomammaksi käyvältä kilpailulta korostamalla kilpailuvalttinaan turvallisuuden parantamista eikä sen huonontamista .	lentoyhtiöitään	13	3
Jostain aivokuolleesta syystä jänistän lennokkien keruusta henkilöllisyyteni varjelemiseksi ja lähden paikalta koska en kuulu koko kurssille .	henkilöllisyyteni	6	1
Pian kävi kuitenkin ilmeiseksi , että Laodike suosi nuorempaa poikaansa Mithridates Chrestusta .	poikaansa	9	3
kirvesmies tuli juovuksissa koputtelemaan oveamme .	oveamme	4	1
tulen myöhemmin tarjoamaan myös novellikokoelmaani yhtiöllenne .	yhtiöllenne	5	2
Se sanoi että tuokaa tänne vielä eläimenne kun toitte kerran jo rehut .	eläimenne	6	2
Mietintöni perustana on yleisesti ottaen tämä : tiettyjä keskuudessamme hyvin yleisiä , vaikkakin silti laittomia menettelytapoja kuten väärentämistä ja laittomasti valmistettujen tavaroiden valmistamista tai kauppaa ehkäisevien toimien määritteleminen .	Mietintöni	0	1
Hän on pysynyt pirteänä kaksi viikkoa komentelevasta jamaikalaisesta huonetoveristaan huolimatta .	huonetoveristaan	8	3
Jo esi-isämme hiihtivät .	esi-isämme	1	1
Esimerkiksi polvileikkauspotilas saa jatkossa jo ennakkoon sähköisen asiointilomakkeen , jossa kartoitetaan hänen tiedon tarpeitaan .	tarpeitaan	13	3
" Aivan , olet varmasti väsynyt matkan jälkeen , joten vien sinut suoraan asunnollesi . "	asunnollesi	13	2
Olen vasta toisen vuoden opiskelija , joten ehkä ajattelukykyni on vielä hieman puutteellinen , mutta minun silmiini nuo kolme eri kurssia vaikuttaisivat jakavan opintopisteensä hyvin erilaisiin työmääriin perustuen .	silmiini	16	1
Totta te minun puolestani saatte heittää rahanne vaikka roskikseen .	rahanne	6	2
Hän voi jopa pyydellä anteeksi olemassaoloaan , sanallisesti tai kehollisesti .	olemassaoloaan	5	3
Valtaistuinpuheessaan keisari lupasi säädyille aloiteoikeuden kaikissa muissa paitsi perustuslakikysymyksissä eli vallanjakoa koskevissa kysymyksissä .	Valtaistuinpuheessaan	0	3
Loppukaneetiksi mies heitti oman mottonsa , kampesi itsensä pöydästä ja tyytyväisenä hyräillen tepasteli ylämäkeä takaisin majaansa .	mottonsa	4	3
emme pysty näkemään mahdollisuuksiemme rajaa , saatikka loppuamme .	loppuamme	7	1
Harva runoilija näet osaa esittää tekstiään ja vielä harvemmalla esiintymisen puoliammattilaisella on puoliakaan keskimääräisen rockartistin vetovoimasta ja intensiteetistä .	tekstiään	5	3
Mirjami otti takkinsa , rappusissa muisti kissan ja palasi täyttämään sen maitovadin .	takkinsa	2	3
Molemmissa tapauksissa varusmiehet olivat unohtaneet asettaa kuulosuojaimet korviinsa .	korviinsa	7	3
muistuttaisin lukijoita umpikieroista savolaisista sukujuuristani , mikä siirtää vastuun lukijalle .	sukujuuristani	4	1
Voi miten kiva toi sun puserosi !	puserosi	5	2
Vain hänellä ja Arimolla ei ollut lapsia , Tuura ajatteli sipaisten kädellään vyötäröään , joka oli yhtä hoikka kuin hänen tänne tullessaankin .	kädellään	11	3
Siihen päättyi myös joukkueemme taival tämänvuotisessa lentopalloturnauksessa .	joukkueemme	3	1
Kunmingistä löytyi heinäkuussa myös teknologiavalmistaja Applen myymälöitä sisustuksellaan , esillepanollaan ja suunnittelullaan jäljitteleviä myymäläkopioita .	suunnittelullaan	11	3
Sinä katsot merta kuin kahden sentin syvyistä kuralätäkköä , otsa kurtussa kengänkärkiesi kastuessa .	kengänkärkiesi	11	2
- Ammuit korvani irti , ryöväri mutisi vihaisesti .	korvani	2	1
Heinonen vähän etuajassa 50-vuotispäiviään .	50-vuotispäiviään	3	3
Tämä oli hiljattain valitun presidentin ensimmäinen testi ja hän on onnistunut kadottamaan suuren osan presidentin vaalien suosiostaan .	suosiostaan	16	3
Tiivistettynä : jos haluat kotiin palaamisen jälkeen puhua vain loistavasta kahdesta viikostasi niin kauan , että muut kyllästyvät jo juttuihisi , HAE kesäyliopistoon !	juttuihisi	19	2
Jos ottaisimme Humen giljotiinin * elämänohjeeksemme , emme voisi suunnitella elämäämme emmekä ylipäätään ... no , tehdä paljon mitään .	elämäämme	10	1
Lasse siveli hellästi kättäni .	kättäni	3	1
Merituomari on valmis nauttimaan siikakeittonsa .	siikakeittonsa	4	3
Tummanharmaa rajauskynäni loppui muutama viikko sitten ja ajattelin testata , olisiko tästä sen korvaajaksi . :)	rajauskynäni	1	1
Tyttönimeltäni olen Tenni .	Tyttönimeltäni	0	1
Miten saan käsiini vuosia sitten julkaistun kirjan ?	käsiini	2	1
Ammattilaiset ostavat öljynsä isoissa erissä .	öljynsä	2	3
On vaikea pysyä nahoissaan tai toppatakissaan .	nahoissaan	3	3
Patistan lapseni reppureissaamaan heti kun mahdollista .	lapseni	1	1
Koska tämäkin lepopäivä oli pitkä ja tylsä , kulutin aikaani tutustumalla risteilyltä saamiini kosmetiikkanäytteisiin .	aikaani	9	1
Tällä perusteella olen vakaasti sitä mieltä , että Euroopan pitäisi pystyä suojaamaan omia lentoyhtiöitään yhä armottomammaksi käyvältä kilpailulta korostamalla kilpailuvalttinaan turvallisuuden parantamista eikä sen huonontamista .	kilpailuvalttinaan	19	3
Jopa opettajat ovat oppilaisiinsa sitä tyytymättömämpiä mitä alemmas hierarkiassa mennään .	oppilaisiinsa	3	3
Että nimeni on laitettu addressiin , koska olin kyseisen ihmisen kanssa paljon tekemisissä viime keväänä .	nimeni	1	1
No , mitä mieltä itse olet kokemuksestasi ?	kokemuksestasi	6	2
Ei mikään typerä kerrostaluyksiö paperiseinineen .	paperiseinineen	4	3
Joukon kärjessä harppoo pääministeri Harri Holkeri kesäpartoineen .	kesäpartoineen	6	3
Liiallisesta omistautumisesta alalleen ei naistutkijoita voida syyttää .	alalleen	2	3
Pois silmistäni !	silmistäni	1	1
Nyt se minun ikioma hoitajani tuli	hoitajani	4	1
jättivätkö ihmiset äänestämättä tietoisesti , laiskuuttaan vai välinpitämättömyyttään ?	laiskuuttaan	5	3
Näkisimme enemmän millainen tästä Unionista tulee panisimme omaa talouttamme kuntoon omaa elintarviketalouttamme kuntoon .	elintarviketalouttamme	11	1
Mikäli hyväksymme , että kansalaisen vetoomusoikeus on hänen perusoikeutensa , kuten sopimuksissakin todetaan , mikäli hyväksymme , että Euroopan parlamentti palvelee tätä oikeutta , näemme , että vetoomusvaliokunta tukee Euroopan parlamentin nimissä Euroopan kansalaisten oikeutta vetoomuksiin .	perusoikeutensa	8	3
Mutta heittäisivät molemmat omaa lestiään .	lestiään	4	3
Pisin juoksematon kauteni vihon mukaan on parin vuoden takaa .	kauteni	2	1
Ole hyvä ja soita välittömästi numeroon XXXXXXX , jotta voimme sopia ne tunnit , jotka sopivat lapseni lukujärjestykseen eivätkä mene päällekkäin hänen harrastuksensa kanssa . "	harrastuksensa	22	3
Minun ehdotukseni on parempi .	ehdotukseni	1	1
Menninkäisen osakodikseen ottaneista voi mainita taiteilijaprofessori Tarmo Mannin .	osakodikseen	1	3
Asteriskin kojulla abit pääsivät pöydällä olleen , herra Liskin mukanaan tuoman Macin turvin tutustumaan alaamme hauskojen pelien muodossa .	alaamme	14	1
Nämä ovat kysymyksiä johon haluaisin vastauksia tämänkertaisessa aiheessani .	aiheessani	7	1
Eikä Suomi-kuva enää meidän aikanamme ole haudan vakava asia , sillä ranskalaistunut itsetuntomme kestää urheasti jopa sekaantumisen norjalaisiin ja sen , että jonkun mielestä Helsingissä kävelee jääkarhuja .	itsetuntomme	12	1
Lähdin matkaan Nieminen kumppaninani .	kumppaninani	3	1
12-vuotias tytär sai surmansa jäätyään liikenteessä auton töytäisemäksi	surmansa	3	3
Olenkin joskus sanonut ääneen , etten välttämättä halua edetä urallani erityisen korkealle , vaan toivon saavani mukavan koulutustani vastaavan työn , jonka hoitamiseen ei liity jatkuvaa kilpailua ja stressiä , ja joka sallii tarvittaessa myös kelvollisen perhe-elämän .	urallani	9	1
Yhtye julkaisi tapahtumassa Welterwerk-albuminsa , jonka kappaleista heidän esityksensä koostui .	Welterwerk-albuminsa	3	3
Ruotsalaiset ovat omalla tavallaan jo kasvotuksin tämän ongelman kanssa .	tavallaan	3	3
Eilisellä kotimatkalla , kun raahasin miljoona laukkujani / kassejani / pussukoitani rautatieasemalta kotiin , vasenta jalkaani alkoi vihloa .	laukkujani	6	1
Sosiaalidemokraattien osalta presidentinvaalin marssijärjestys on se , että Sdp:n puoluekokous pyytää presidentti Mauno Koivistoa ehdokkaakseen kesäkuussa .	ehdokkaakseen	14	3
Heille on sisustettu vierailujensa ajaksi huoneet .	vierailujensa	3	3
Vasara syöttää , Lehtinen pysäyttää päällään jalkoihinsa , käännähtää ja vetäisee Paijan vierestä takatolpan kautta : 2-1 .	päällään	5	3
Ennen lähtöään nainen halaa mummuaan , silittää tämän ryppyistä kädenselkää	mummuaan	4	3
Kertokaa ystävällisesti kommenttejanne sivustosta	kommenttejanne	2	2
33-vuotias Wahlbeck on alkuvuodesta blogissaan kirjoittanut harkitsevansa pokeriuransa päättämistä .	pokeriuransa	7	3
Arafat uskoi , että Israel aloittaa joukkojensa vetämisen jo parin päivän kuluessa .	joukkojensa	6	3
Ensin peseytyisin , kampaisin ja pukeutuisin puhtaisiin , sitten heittäisin myrkyt kurkkuuni ja kääriytyisin peitteeseen .	kurkkuuni	11	1
" Pidä varasi ! " huudahti Myyrä äkkiä .	varasi	2	2
Tekniikkani on nyt parempi kuin koskaan ennen .	Tekniikkani	0	1
Hymyilet ja vietät kaiken aikasi hänen kanssaan tai häntä ajatellen ja lähetät tekstiviestejä yömyöhään kunnes silmäsi taas sammuisivat tai hän ei enää vastaisi .	silmäsi	15	2
Hakemusmääräänsä kasvattivat viime vuodesta Turun kauppakorkeakoulu , kasvatustieteiden tiedekunta , matemaattis-luonnontieteellinen tiedekunta ja humanistinen tiedekunta .	Hakemusmääräänsä	0	3
Ihmeellistä , että pari vuotta sitten rakastin tasaista tunnusmerkitöntä ( pääsykoekirjojen kieli tunkee vahingossakin sanastooni ) rintakehääni , mutta nyt toivoisin edes yhden ihmisen kiinnittävän huomiota siihen , ettei minulla ole rintaliivejä .	sanastooni	14	1
Viisi pientä sorsaa tepastelee emonsa perässä .	emonsa	4	3
En yhtää nyt sun juttuus tajuu .	juttuus	4	2
Millainen oli oppimisen pimeä puoli kansanomaisine lukupelkoineen , kirjakammoineen ja ruumiillisine kurituksineen ?	kirjakammoineen	8	3
Vielä asunnollani ollessani siivosin sen , laitoin kerrankin kaiken aivan uuteen uskoon .	asunnollani	1	1
Heikkilä sanoi olevansa sotiemme veteraani .	sotiemme	3	1
Mun isoisä oli aina ollu huolissaan siitä että just ne kumisaappaat olis aina tallessa , ja sateiden jälkeen ne piti kuivata saunassa .	isoisä	1	1
Ville on sisareni entinen kihlattu	sisareni	2	1
- Tulosparannus oli merkittävä ja puolivuotistuloksemme tasoltaan paras sitten finanssikriisiä edeltäneen ennätysvuoden 2007 .	puolivuotistuloksemme	5	1
Kaikista mieluiten olisin viettänyt päiväni makuupussissa , mutta kun siinä on hieman vaikea kävellä . ;)	päiväni	4	1
Rakasta lähimmäistäsi niin kuin itseäsi .	lähimmäistäsi	1	2
Vain harvalle meistä on mahdollista ottaa lomaa laihdutuksen ajaksi , vaan meidän on suoriuduttava jokapäiväisistä töistämme .	töistämme	15	1
Kehitysaluerahasto lähtee kehittämään uusia huonekalumalleja alueensa yrityksille .	alueensa	5	3
Höyryveturi kaksine vaunuineen oli siitä vanhimmasta päästä .	vaunuineen	2	3
Kuluttajaa kiinnostaa hänen oma työtilanteensa ja oma palkkanauhansa	palkkanauhansa	7	3
Testaa : Millainen on oleva uusi vuotesi ?	vuotesi	6	2
Hyvää oli myös tämä toinen sekalainen salaatti minkä tein ollessamme pääsiäisen aikaan siskoni perheen luona Kaavilla .	siskoni	12	1
Jos käytät muita ohjelmia , kuten Microsoft Wordia , meidän ehkä täytyy asemoida teksti uudelleen tulostustasi vastaavaksi .	tulostustasi	15	2
Suuttuiko isä , koska tiedustelit häneltä minun naittamisestani ?	naittamisestani	7	1
Ja kuinka ollakaan Hämeensillalla vähän ennen Tillikkaa , huomasin edessäni kävelevällä miehellä matkakirjoituskoneeni .	matkakirjoituskoneeni	12	1
Mahtavasta varjosta työntyi esille suuri hymyilevä aurinko , joka tuijotti alaisiaan ääneti ainokaisella silmällään .	alaisiaan	10	3
Kokeilin sitten aikani kuluksi Da Vinci -merkkistä mineraaliluomiväriä ( sävy Light Grey ) .	aikani	2	1
Mieleeni hiipi ajatus , että ehkäpä asioita pitäisi miettiä uudestaan .	Mieleeni	0	1
Otin yhteyttä rautatieyhtiön pääkonttoriin ja kerroin halustani ajaa junaa .	halustani	6	1
Jos peto silti käy kimppuun , lukki voi uhrata yhden raajoistaan .	raajoistaan	10	3
Vaikuttaa siltä kuin ei suuri keskusvirasto ahneuksissaan ymmärtäisi , että pää se tulee vetävän käteen .	ahneuksissaan	6	3
Miksi minä puhuisin työstäni ?	työstäni	3	1
Aurinko laski jo hiljalleen mailleen vanhuksen avatessa kotitalonsa ovea pienellä avaimella , joka roikkui hänellä narun päästä kaulassa .	mailleen	4	3
Jos saisin valita omasta joulupöydästäni kolme ruokalajia , joilla saisin jouluruuantarpeeni tyydytettyä , olisivat ne lohi , itse tehty sienisalaatti ja itse tehty lanttulaatikko . :)	joulupöydästäni	4	1
Läpimurtonsa valmentajana hän teki siirryttyään kesken kauden 1999 Djurgårdens IF:n päävalmentajaksi yhdessä Zoran Lukicin kanssa .	Läpimurtonsa	0	3
Hailuotolaisten tulee saada itse päättää miten ja mitä kautta he saarelleen kulkevat .	saarelleen	10	3
Miksi emme kehitä taitojamme seksin alueella , jotta pystyisimme tyydyttämään kumppanimme ?	taitojamme	3	1
Tulet asumaan Englannissa enää vain kaksi vuotta , loppuelämäsi tulet viettämään Suomessa .	loppuelämäsi	8	2
Toiveistani täyttyi ainoastaan muutama puolikas : sain liian lyhyen hetken harrastaa huoletonta seksiä , sain yksinäni katsoa elokuvan , sain veljen seurassa keittiön pöydän ääressä syödä liikaa jäätelöä ja kinuskikastiketta ja sain aamupostia hakiessani temmeltää vähän lumessa koiran kanssa .	Toiveistani	0	1
Ryhmäni kannattaa täysin satelliittiseurantaa koskevaa kokeiluhanketta .	Ryhmäni	0	1
Niko oli kaksoisveljeni .	kaksoisveljeni	2	1
Pisin juoksematon kauteni vihon mukaan on parin vuoden takaa .	kauteni	2	1
Myrsky työnsi Askaisten Auton isokokoisen bussin kyljelleen ojaan Auran moottoritiellä .	kyljelleen	6	3
Tällä välin melkein työkaverini oli jostain hakenut “ kaverinsa ” , entisen venäläisen katsomaan kuinka minä teen töitä .	työkaverini	3	1
Sitäkin tärkeämpää on nyt , lähes vuosi Helsingin Eurooppa-neuvoston jälkeen , keskustella kansallisissa parlamenteissamme ja kansalaistemme kanssa Turkin liittymisen tulevaisuudennäkymistä .	parlamenteissamme	13	1
Itseäni vanhempi mänty rysähtää halki horisonttini ja rysähtää varrellaan polvieni päälle Kovien rusahdusten saattelemana .	varrellaan	8	3
Minusta on erittäin valitettavaa todeta , että meidän on vedettävä takaisin kompromissiehdotuksemme ja että meidän on sen vuoksi turvauduttava sovittelumenettelyyn .	kompromissiehdotuksemme	11	1
heidän itsestäänselvyyksiään painetaan hyvälle , parhaasta puusta tehdylle paperille .	itsestäänselvyyksiään	1	3
Anna meille meidän jokapäiväinen leipämme .	leipämme	4	1
Nyt Kalle Kultala kertoo juhlapuhujan akateemikko Matti Kuusen olleen antautumismielialassa kehottaessaan ikäluokkaa 1917 " nousemaan ylös seisomaan , tai jos ette kykene seisomaan , nostakaa kätenne ylös ! "	kätenne	25	2
Gepardi on jaloistaan nopea ja kolibri tikkaavasta nokastaan .	jaloistaan	2	3
Mihin sitten uskoisin , ellen enää omiin silmiinikään .	silmiinikään	7	1
Minä vääntäydyin istumaan niskaani hieroen .	niskaani	3	1
tietoisesti en rikostani tehnyt , vain tietämättömyyttäni .	rikostani	2	1
tule käymään kaupassa , niin saat viisikymppisesi	viisikymppisesi	6	2
Ehkä he ovat vaikeampia kuvattavia , sillä jotain heidän työstään tulisi kuvaajankin ymmärtää , vaikka ei olisi saanut samaa koulutusta .	työstään	9	3
Vain harvalle meistä on mahdollista ottaa lomaa laihdutuksen ajaksi , vaan meidän on suoriuduttava jokapäiväisistä töistämme .	töistämme	15	1
Muistosi säilyy ikuisesti sydämissämme - luokkakaverit	Muistosi	0	2
Joukkoraiskaajat polttivat 16-vuotiasta uhriaan hapolla	uhriaan	3	3
Keskustan Kimmo Tiilikainen on sanonut puolueen lehdelle Suomenmaalle , että Katainen olisi ylittänyt neuvotteluvaltuutensa sopiessaan Kreikan auttamisesta edellisessä EU-huippukokouksessa .	neuvotteluvaltuutensa	13	3
Hän myi autoni	autoni	2	1
Asiat mutkistuva kuitenkin heti , jos henkilössä on esimerkiksi maksuhäiriömerkintä tilillään , hän muistuttaa .	tilillään	10	3
Virallisten puhujien jälkeen halukkailla oli vielä mahdollisuus esitellä aihettaan tai kiinnostuksen kohdettaan salamapuheilla .	aihettaan	8	3
Minulle oli aikoinaan kerrottu Floridaan , että Kaisu odotti täällä lasta ; Taisto sitä uutista oli tuonut tultuaan Suomesta , jossa oli käynyt peräämässä vanhoilta velallisiltaan saamisiaan .	saamisiaan	26	3
Sitten heristelin sormeani ja varoittelin Doraa , ettei hänelle jää tästä ajasta muuta muistoa kuin kauhea krapula .	sormeani	2	1
Kansainvälinen valuuttarahasto IMF on varoittanut Ranskaa siitä , että se ei välttämättä pääse tavoitteisiinsa vajeiden kuromisessa , jos menokehitystä ei suitsita nykyistä tarmokkaammin .	tavoitteisiinsa	13	3
Kyseessä on vakava ongelma kirkollemme . "	kirkollemme	4	1
Pyyhe laihan ruotoni ympärillä avasin oven nieleskellen mutta vakavissani kuvittelematta että se olisit sinä , etkä se ollutkaan vaan mittarinlukija .	ruotoni	2	1
Leikkasin ilmoituksen irti ja lähetin vanhemmilleni .	vanhemmilleni	5	1
Myös SAK on jäsenliittoineen ollut mukana uudistustyössä .	jäsenliittoineen	3	3
Kaudella 2004 Kaijasilta voitti Kakkosen maalipörssin ylivoimaisesti 26 osumallaan , ja samalla auttoi PK-35:ä nousemaan Ykköseen .	osumallaan	8	3
Maanantaina vien ostoskassillisen rahaa sinun tilillesi .	tilillesi	5	2
Nähtävästi osa luterilaisesta väestöstä olikin Sakkolassa vain käymäseltään ja palasi takaisin entisille asuinpaikoilleen .	asuinpaikoilleen	12	3
Reseptejä toimitettaessa siirtyvät ostot rekisteritietoihin henkilötunnuksen kautta , eli jos olette näyttäneet Kela-korttinne reseptejä toimitettaessa niin nämä ostotiedot siirtyvät rekisteritietoihinne .	rekisteritietoihinne	19	2
Kun paljastui , että asumme Yhdysvaltain ehkä vaarallisimman myrkkyjen kaatopaikan päällä , raivollani ei ollut rajoja .	raivollani	12	1
Haluan kiittää myös esittelijäämme El Khadraouita hänen tarmokkuudestaan ja ansioistaan laadittaessa päätöslauselmaa , josta huomenna äänestämme .	esittelijäämme	3	1
Revon mukaan kiista kirkon johdon kanssa on rasittanut hänen vaalikampanjointiaan .	vaalikampanjointiaan	9	3
Arvoisa puhemies , haluan aloittaa onnittelemalla esittelijäämme erinomaisesta mietinnöstä ja toistamalla , että keskustelun aiheena ovat merenpohjien eli ekosysteemiemme korvaamattoman arvokkaiden aarteiden , kuten syvänmeren koralliriuttojen , merenalaisten vuorten , hydrotermisten halkeamien ja syvänmeren sienieläinten suojeleminen .	esittelijäämme	6	1
Mutta aloittakaa toki jo tarinointinne .	tarinointinne	4	2
Mikäli kaikki menee hyvin , myöhemmin on tiedossa vielä toinen haastattelukierros , ja jos senkään jälkeen ei ole onnistunut vakuuttamaan haastattelijoita olemattomista kyvyistään , voi työsopimus olla kourassa hyvinkin pian .	kyvyistään	22	3
" Jostain minunkin on pakko leipäni tienata . "	leipäni	5	1
Yhtiö päätti jatkaa suunnitelmiensa mukaisesti , koska ohjaaja on rangaistuksensa kärsinyt ja katuu tekojaan .	suunnitelmiensa	3	3
Ryöväri putosi polvilleen huutaen tuskasta ja painoi kädellään päänsä sivua yrittäen lopettaa verenvuodon .	päänsä	8	3
Sinun pyhävuattees housunpersaakset oovat iha hitulaesena	pyhävuattees	1	2
Se etsii ruokansa maasta tai lehvästöstä .	ruokansa	2	3
Naisen hysteerisyys alkaa pikkaisen ärsyttää , mutta en anna sen pilata hyvää tuultani .	tuultani	12	1
Te ja teidän sukupolvenne pelastitte meille nuoremmille vapaan isänmaan .	sukupolvenne	3	2
Patjasi on raidallinen vasten poskeani ja valkoinen lakana rytyssä sormieni välissä .	poskeani	4	1
Siinä kävi niin kuin yhdessä vanhassa esseessäni yhdelle metsälle .	esseessäni	6	1
Sairaalan ylilääkärin Eero Hirvensalon mukaan hänen ennusteensa on erittäin huono ja henkiinjäämisen mahdollisuutensa olematon .	ennusteensa	6	3
Olemme sen velkaa kansoillemme ja jokaiselle äänestäjällemme .	äänestäjällemme	6	1
Hän koputti olkapäähäni , että voisinko laittaa sen takaisin kiinni .	olkapäähäni	2	1
Otsani valui kylmää hikeä , ja tunsin pakottavaa tarvetta huutaa apua .	Otsani	0	1
Muuten asialliseen kiuasartikkeliinne oli tullut ikävä , joskin yleinen asia- ( termi ) virhe .	kiuasartikkeliinne	2	2
Enkä voi olla ajattelematta , onko olemassa jokin , joka tappaa ihmisiä yhtä lailla huvikseen kuin hyönteisiä .	huvikseen	14	3
Juosta jolkutin keppini kanssa lumisessa metsässä ja hauskaa oli , niin kauan kuin aamutunnelmissa jaksoin .	keppini	2	1
Viimeiseksi saaliikseen se oli syönyt metsäkauriin .	saaliikseen	1	3
Valonen kuitenkin ilmoitti , että ei hievahda paikaltaan mihinkään .	paikaltaan	7	3
Kohautin olkapäitäni , eipä ollut ensimmäinen omituisuus sille päivälle .	olkapäitäni	1	1
Käskystäni hän iski pöytää nyrkillään ja lantti kilahti kaatuessaan .	Käskystäni	0	1
Liittyminen voi tuoda mukanaan kansallisia intressejämme haittaavia muutoksia , mutta ulosjääminen unionista tietää varmaa eristäytymistä muusta Euroopasta .	intressejämme	5	1
Omana vahvuutena pitäisin sitä , että haluan tuoda ajatukseni esille selkokielisesti .	ajatukseni	8	1
tietoisesti en rikostani tehnyt , vain tietämättömyyttäni .	rikostani	2	1
Rahoitustilanteemme on sangen tyydyttävä ja hallinnassa .	Rahoitustilanteemme	0	1
Olkaa ystävälliset ja peittäkää kenkänne muovisuojuksilla .	kenkänne	4	2
Joukkueemme hyvä vire ei kestänyt vaan vastustaja pääsi heti karkaamaan hyvien aloitussyöttöjen avulla .	Joukkueemme	0	1
Kaisa pyörittelee pilleripurkkia käsissään , taas , muttei avaa sitä .	käsissään	3	3
Yhtiö pitää kuitenkin koko vuoden näkymänsä ennallaan ja uskoo liikevaihtonsa ja liiketuloksensa paranevan viime vuodesta .	liikevaihtonsa	9	3
Reitesi lepää omieni päällä ja ihosi pinnalla oleva nukka on herkintä , mitä sinussa on .	ihosi	5	2
Teidän vuoronne .	vuoronne	1	2
Meyer muistelee omaa nuoruuttaan , joka kului koulun asemesta kaivoksessa .	nuoruuttaan	3	3
Suurin osa uhanalaisista jäkälistämme on metsälajistoa , mutta myös kallioiden ja kulttuuriympäristöjen lajeista lukuisat ovat tulleet uhanalaisiksi .	jäkälistämme	3	1
Useita kertoja viikossa , jopa päivässä , olen ajatellut , että tästä kirjoitan ja tämän muistan varmasti , mutta tietokoneen ääressä inspiraationi katoaa ja huomaankin kirjoittelevani turhia viestejä samoille typerille foorumeille .	inspiraationi	21	1
Nainen ehti kulkea miehen perässä parin sadan metrin verran , kun mies pysähtyi ja kaivoi taskustaan pistoolia muistuttavan aseen .	taskustaan	15	3
Kunmingistä löytyi heinäkuussa myös teknologiavalmistaja Applen myymälöitä sisustuksellaan , esillepanollaan ja suunnittelullaan jäljitteleviä myymäläkopioita .	esillepanollaan	9	3
Olen syönyt mahani kipeäksi tulehduskipulääkkeitä	mahani	2	1
Patjasi on raidallinen vasten poskeani ja valkoinen lakana rytyssä sormieni välissä .	Patjasi	0	2
Meidän Hiski-karjumme niskassa !	Hiski-karjumme	1	1
Minulle oli aikoinaan kerrottu Floridaan , että Kaisu odotti täällä lasta ; Taisto sitä uutista oli tuonut tultuaan Suomesta , jossa oli käynyt peräämässä vanhoilta velallisiltaan saamisiaan .	velallisiltaan	25	3
Voinko luottaa sinun tukeesi ?	tukeesi	3	2
Kuka meidän elämästämme päättää , ellemme me itse sitä tee ” , Jan kysyy Pääskysen selältä , sulkeutuvalta etuovelta .	elämästämme	2	1
Äidinkielensä ruotsin ja hauskasti turkulaisittain murretun suomen lisäksi Carina taitaa vielä englantia ja saksaa sekä hieman venäjää .	Äidinkielensä	0	3
Tappioiden on loputtava ensi vuoden aikana , muuten menetämme lopullisesti etsikkoaikamme .	etsikkoaikamme	10	1
Ilta laskeutui auringon takaa ja annoin hiuksieni mennä tuulen mukana kun ajoin vanhalla Saint -polkupyörälläni pitkin kuolleiden lehtien katuja , silloi minusta tuli astronautti ja nousin raketillani jo stratosfääriin .	raketillani	26	1
jotta he voivat nämä edellytykset täyttää , heidän persoonansa täytyy olla jakautunut .	persoonansa	8	3
Jos olemme sen sijaan vaipuneet synkkyyteen , emme havainnoi ympäristön myönteisiä elementtejä myöskään nenällämme .	nenällämme	13	1
Puolisoni ajoi autoa lentokentälle , joskin vastentahtoisesti .	Puolisoni	0	1
hänen kapitalismin kritiikkinsä	kritiikkinsä	2	3
Kuten aiemminkin , The Black Eyed Peas on saanut tällekin albumilleen mukaan kuuluisia artisteja :	albumilleen	10	3
Toivon , että voin ja pystyn pian jättämään vihani ja katkeruuteni taakseni ja elämään vapaana kaunasta ja tuskasta .	katkeruuteni	10	1
Mikäli oma mieheni on kohtelee minua moukkamaisesti , palaa hihani riippumatta siitä , liittyykö tilanteeseen toinen nainen , auto , kesäkurpitsa tai anoppi .	hihani	9	1
Samoin kävi aikoinaan ammattikorkeakoulututkintojen kanssa .	aikoinaan	2	3
Ja nyt Pyro vahtii postiluukkuani , ikäänkuin suojellen minun huomistani ikäviltä kirjeiltä .	huomistani	9	1
Lempivärit , reitit valolle ja tyhjä tila esineiden välillä antavat niille mahdollisuuden näyttää koko kauneutensa ja ruokkia sillä kauneuden kaipuutamme .	kaipuutamme	19	1
Haideria on arvosteltu myös hänen puhetyylinsä rajuudesta .	puhetyylinsä	5	3
perhe on viettänyt kaikki kesälomansa vesillä jo parikymmentä vuotta .	kesälomansa	4	3
Eihän sitä voi pilana pitää , jos joku on tosimielellä kiinnostunut ostamaan liikennelaitoksemme .	liikennelaitoksemme	12	1
Arvoisa neuvoston puheenjohtaja , ryhmätoverini Miguel Ángel Martínez ja minä , jotka olemme yhdessä seuranneet poliittista elämää vuodesta 1977 alkaen , olemme keskustelleet paljon näistä asioista , ja haluaisinkin esittää muutaman täydennyksen .	ryhmätoverini	4	1
Oli syksy ja perjantai , katsoin ylös kun putoilevat lehdet tanssivat ilmassa tehden piruetteja ja taivaanrannanmaalarit värittivät ruskaväreillään kaiken kauniiksi .	ruskaväreillään	17	3
Hän kunnioittaa ulkonäöstään huolehtivaa naista .	ulkonäöstään	2	3
Koulussa teimme myös metsäretkiä ; tutustuimme sammakonkutuun ja nyhdimme yrttejä juurineen jorpakosta .	juurineen	10	3
Teatterikesän kunniavieras George Tabori lennähti Suomeen lomailemasta nykyisestä kotimaastaan Itävallasta .	kotimaastaan	8	3
Jännitys tiivistyy vasta kun pääkonnat astuvat areenalle oikeusavustajineen .	oikeusavustajineen	7	3
Monet eivät vielä ole epäonnekseen saaneet työpaikkaa .	epäonnekseen	4	3
Ihanaa tää sun joulukakkus aina .	joulukakkus	3	2
Ajattelin , etten minä tai kukaan muukaan saa jalkojaan norjiksi ennen juhannusta .	jalkojaan	8	3
Lisäksi minun on suotu pitkän elämäni ehtoona edustaa Baijeria Euroopan parlamentissa jo 18 vuoden ajan .	elämäni	5	1
Tämä on minun ja kollegani Sarlisin mietintöjen ajatuksena .	kollegani	4	1
Hymyilet ja vietät kaiken aikasi hänen kanssaan tai häntä ajatellen ja lähetät tekstiviestejä yömyöhään kunnes silmäsi taas sammuisivat tai hän ei enää vastaisi .	aikasi	4	2
Gliese 581 b löydettiin vuonna 2005 ja fysikaalisilta ominaisuuksiltaan se luokitellaan kuumien neptunusten ryhmään .	ominaisuuksiltaan	8	3
Meidän Hiski-karjumme niskassa !	Hiski-karjumme	1	1
Otathan mukaan ystäväsikin .	ystäväsikin	2	2
Olisi hullua ajatella , että mikään tieteen keksintö sinänsä voisi puhdistaa ihmislajin kaikista harhakuvitelmistaan .	harhakuvitelmistaan	13	3
Teidän ei ole aivan ehdottoman välttämätöntä sahata puitanne näin perusteellisesti , koska puut ovat suhteellisen nuoria .	puitanne	7	2
Ihmiset voivat kuitenkin hävittää korttinsa jossain muussa kuin 15 EU-maassa , eikä Internet-myyntikään rajoitu vain EU-maihin .	korttinsa	4	3
Tuijotin varpaisiini .	varpaisiini	1	1
YK:n päätös olisi parempi siirtää yhteisön säännöstöön kokonaisuudessaan , mikä yksinkertaistaisi asioita huomattavasti ja tekisi lainsäädännöstä huomattavasti toimivamman niin yhteisön vesillä kuin niiden ulkopuolellakin .	kokonaisuudessaan	7	3
Hän oli ensin nukkunut pommiin , keittänyt hätäpäissään kahvit ilman poroja , ja lopuksi potkaissut oikean pikkuvarpaansa niin lujasti seinään , että se oli varmasti murtunut .	pikkuvarpaansa	16	3
Hänen vilpittömyyttään ei ole asetettu kyseenalaiseksi , mutta johtamistaito ja ennen kaikkea uskottavuus on asetettu kyseenalaiseksi .	vilpittömyyttään	1	3
Sinä et enää kuitenkaan ottaisi minua matkustajan paikallesi , olet poissa , ja minä saan ajaa yksin näitä pilkkopimeitä teitä .	paikallesi	7	2
- Minun kissani kuoli .	kissani	2	1
Tässä sinulle hieman Nettikirjoittajakoulun palautetta tekstistäsi , joka muuten olikin melkoisen pitkä kirjoitus .	tekstistäsi	5	2
" Olet tekemässä suurta erehdystä " , totesi espressokeittimeni tuttuun lakoniseen sävyynsä , vaikka olikin suuren tunnekuohun vallassa .	espressokeittimeni	8	1
Kuuntelutenttejä varten opiskelijaa pyydetään ottamaan mukaan kasettisoitin kuulokkeineen .	kuulokkeineen	7	3
Näkisimme enemmän millainen tästä Unionista tulee panisimme omaa talouttamme kuntoon omaa elintarviketalouttamme kuntoon .	talouttamme	8	1
Naapurireviiriläiset saattavat tappaa alueelleen eksyneen naapurin nuoren yksilön .	alueelleen	3	3
Peku ei oikeastaan tunne mitään ajatellessaan ystäviään , vanhempiaan tai miestään .	miestään	10	3
Joka kymmenes katsoo voivansa edetä työssään vain ulkomailla .	työssään	5	3
Tiesitkö sen , että tietokoneesi varastoi tietoa osoitteista ja sivustoista joissa olet käynyt .	tietokoneesi	4	2
Harri Kirvesniemi palautteli elimistöään .	elimistöään	3	3
Toinen kysymykseni koskee Lissabonin strategiaa .	kysymykseni	1	1
" Tahdon , että lapseni saa aineenopettajan antamaa tukiopetusta vähintään kerran viikossa aina toukokuun loppuun asti , sillä hän ei jaksa keskittyä koko ryhmän kanssa .	lapseni	4	1
Hän näkee minun katseeni ja käsittää sen , hyvä ettei punastu .	katseeni	3	1
Tyytyväisenä , koska mieheni katsoi minua , omaa vaimoaan , samalla tavalla kuin säkkiakkojen miehet katsovat muita .	mieheni	3	1
Sydäntäni särki , kun jouduin vastaamaan kieltävästi .	Sydäntäni	0	1
Tiivistettynä : jos haluat kotiin palaamisen jälkeen puhua vain loistavasta kahdesta viikostasi niin kauan , että muut kyllästyvät jo juttuihisi , HAE kesäyliopistoon !	viikostasi	11	2
Suonet anteeksi , jos epäilen sanojasi .	sanojasi	5	2
Koska huidoin kaksin käsin , en pitänyt Mollan kaulassa roikkuneesta lyhyestä köydestä kiinni , ja huitomiseni tietysti oli taas se punainen vaate Mollalle .	huitomiseni	15	1
Se tulee silloin takaisin ja tuo ystävänsäkin , tietävät Muurimäet .	ystävänsäkin	6	3
Lapsenlapset olivat ainoa ilonaiheeni	ilonaiheeni	3	1
Miehen kaatuessa iskuista ja ilmeisesti lyödessä päänsä pöytään tuomittu jatkoi nyrkeillä hakkaamista .	päänsä	6	3
Mielestäni ne olivat kivoja , leppäkertut kun olivat pienessä mielessä kiehtovia otuksia .	Mielestäni	0	1
Lönnrot lähti keräämään kansanrunoutta , Snellman lähti Helsinkiin ja Runeberg lähti Paraisille , mistä hän löysi Fredika-vaimonsa − runebergintortun kehittäjän .	Fredika-vaimonsa	16	3
SKDL , jonka nimen suojassa kommunistit politiikkaansa harjoittivat , toimi edelleen aktiivisesti " kokoomuksen eristämiseksi " , kuten sanonta kuului .	politiikkaansa	6	3
Nuoruudessaan hän oli mystifioinut persoonansa , kokenut itsensä päähenkilöksi , jonka ympärillä kaikenlaiset mielenkiintoiset tapahtumat vain tapahtuisivat .	Nuoruudessaan	0	3
Vuonna 1987 Thom ja hänen silloinen tyttöystävänsä joutuivat auto-onnettomuuteen .	tyttöystävänsä	6	3
Iranin vastauksesta ei voida erehtyä : se on rikkonut Pariisin sopimusta ja muita sopimuksia , peitellyt rikkomuksiaan ja aloittanut uudelleen energiantuotannon ydinaseiden valmistamiseksi .	rikkomuksiaan	16	3
Haluaisin korostaa tänään erityisesti kollega Morillonin vaatimusta , että parlamentti luo Euroopan ja Turkin parlamenttien välisen keskustelufoorumin ja haluaisin vaatia lisäksi jäsenvaltioidemme kansallisia parlamentteja käymään julkista keskustelua Turkin liittymisen tulevaisuudennäkymistä .	jäsenvaltioidemme	21	1
meillä voisi olla tarve tukea ja kannustaa sitä , mikä meidän suomalaisessa kulttuurissamme on hyvää , niin filmissä kuin kirjallisuudessa kuin paljossa muussakin .	kulttuurissamme	12	1
Lasken pääni takaisin viltille ja suljen silmäni hymyillen .	silmäni	6	1
Päätin laajentaa käyttövärieni kirjoa uudella värillä ja niin vaaleansininen siirtyi suosikkivärieni listalle .	käyttövärieni	2	1
Ja emäntä kertoi kaikille kavereilleen , sukulaisilleen ja koirapuiston väelle että isäntä oli nähnyt valon .	kavereilleen	4	3
Oli jo liian myöhä lähteä ajamaan ryöväreitä takaa ja seuraavan yön lumisade peitti heidän jälkensä .	jälkensä	14	3
Strongbow Cider oli väriltään raadin mielestä hyvän keltainen .	väriltään	3	3
Rajansa minunkin röyhkeydelläni .	Rajansa	0	3
Katsoin melkein työkaveriani vihaisesti ja pyysin tätä viemään häirikkönsä muualle .	työkaveriani	2	1
Arabiantimalit rakentavat pesänsä pensaaseen tai puuhun 1–7 metriä korkealle ja rakentavat aina hyvin suojaisaan paikkaan latvustoon tai pensaan sisälle .	pesänsä	2	3
Ainakin jos mieheltäni kysytään .	mieheltäni	2	1
Tunsin kissani .	kissani	1	1
Piste suureni suurenemistaan ja lopulta vanhus sai vanhoilla silmillään selkoa , mistä oli kyse .	silmillään	8	3
Mitä elämästä tulee , jos alkaa pelätä jokaista askeltaan ?	askeltaan	8	3
Kiristelen hampaitani kun portaissa alaspäin on niin paljon jonoa että ohittamisesta on yhtä vähän hyötyä kuin Helsinki-Porvoo -tiellä .	hampaitani	1	1
Minun tyttäreni puhuu tuollaisia !	tyttäreni	1	1
Ymmärrän kyllä sen , että jos presidentti tarvitsee avustajan muistelmiensa kirjoittamiseen tai johonkin muuhun entiseen tehtäväänsä liittyvään työhön , niin sellainen voidaan palkata valtion varoin .	tehtäväänsä	15	3
Paitsi että käytämme sen tekemiseen kolmasosan vuorokaudestamme , murehdimme sitä hyvillä mielin myös jäljelle jäävinä kolmanneksina .	vuorokaudestamme	6	1
Vararehtori Harri Lönnberg nosti kommenttipuheenvuorossaan esiin aluetehtävän kansainvälisen ulottuvuuden .	kommenttipuheenvuorossaan	4	3
Kohta minua kutsuu ainejärjestömme hallituksen kokous .	ainejärjestömme	3	1
Sodan käyneet haluavat tulla haudatuksi lähelle ikätovereitaan	ikätovereitaan	6	3
Grafiikka on onnellisessa asemassa siinä , että sekä kaupallisilla että aatteellisilla että taiteellisilla yhteisöillä on intressinsä juhlia omiaan .	intressinsä	15	3
Vanhemmiltaan lapset odottivat sairaalassa turvallisuutta ja viihdyttämistä .	Vanhemmiltaan	0	3
Sen sijaan että orjuuttaisimme itseämme hamassa tulevaisuudessa epämääräisesti häämöttävän palkinnon toivossa , tulisi meidän vapautua suorituspaineistamme , karistaa ylimääräinen vastuuntunto harteiltamme ja ryhtyä nauttimaan raukeasta elämästä .	suorituspaineistamme	15	1
Vertailumenestys ei minun auton valintaani ratkaisisi , mutta onhan asiantuntijankin mielipide hyvä tietää .	valintaani	4	1
Veisit Suomeen mennessäsi yhden minun näytelaukuistani ?	näytelaukuistani	5	1
Kuluttajaa kiinnostaa hänen oma työtilanteensa ja oma palkkanauhansa	työtilanteensa	4	3
Nyt vielä on liian kylmä värkätä lämmittämättömässä työtilassani .	työtilassani	7	1
Sun on miehes ulkomailla	miehes	2	2
Onnellinen äiti halaa tytärtään ja päättää saada tämän unohtamaan vastenmielisen seikkailunsa lupaamalla tälle valoisan tulevaisuuden .	seikkailunsa	10	3
Tämä on tärkeää toisaalta Turkille mutta erityisesti itse jäsenvaltioille tai kansalaisillemme .	kansalaisillemme	10	1
Vahvasti päihtynyt säkyläläinen eläkeläismies törmäili autollaan Turussa tänä aamuna .	autollaan	5	3
Hän viettää nykyään iltansa usein television ääressä .	iltansa	3	3
Uusikylä on harvoja kasvatustieteilijöitä , jotka ovat nousseet tieteenalaltaan julkisiksi intellektuelleiksi .	tieteenalaltaan	8	3
Hän laulaa erittäin varmasti ja hallitsee ohjelmistoonsa sisältyvät vivahteet täysin suvereenisti .	ohjelmistoonsa	6	3
jälkeläisemme puistelevat päätään lukiessaan esi-isiensä mielettömyyksistä ja kiroavat meitä ajatellessaan , miten 1900- ja 2000-luvun ihminen rosvosi loppuun sen planeetan , josta oli tuleva myös heidän kotinsa .	jälkeläisemme	0	1
Varovaisen mutta todenmukaisen arvioni , joka perustuu laserin lailla leikkaavaan tarkkailukykyyni , mukaan 75 % toiseen naiseen liittyvistä riidoista eivät liity millään tavalla mustasukkaisuuteen .	tarkkailukykyyni	10	1
ommoo mehteesäkkäät talolliset soanneet hakatak .	mehteesäkkäät	1	3
Kello kuusi paikallista saavuimme hotelliimme , puoli seitsemän päät tuhisivat tyynyjä vasten .	hotelliimme	4	1
Surmansa saanut oli 60-vuotias .	Surmansa	0	3
Vastustajan taktiikkana oli vahva kilpikonnapuolustus johon vetomme useimmiten myös pysähtyivät .	vetomme	6	1
Söin vatsani täyteen .	vatsani	1	1
Mies saavuttaa oven , ojentaa kättänsä , mutta tuntee selässään polttavan kosketuksen .	kättänsä	5	3
– Senkun ammut , kaksi meistä syö ja juo tänään kievarissa kolmannen muistoksi sinun rahoillasi .	rahoillasi	14	2
Natsipuolueeseen kuulumattomana , mutta ideologialtaan natsina Wolters mainitsi filosofi ja matemaatikko Oskar Beckerin , jonka sodanjälkeisten oppilaiden hän totesi olleen tietämättömiä opettajansa taustasta .	ideologialtaan	4	3
Havainnointimme ja tiedonkäsittelymme ovat rakentuneet siten , että pyrimme harmoniaan ja jäsentyneeseen kokonaisuuteen .	Havainnointimme	0	1
Istuin selkäni kipeäksi	selkäni	1	1
Varmistathan , että merkitty aika sopii ohjelmaasi .	ohjelmaasi	6	2
Tuomisen arvion mukaan Mykkänen ei ole pyrkinytkään tekemään ideaaliehdotustaan , vaan esityksen , jonka Mykkänen arvioi menevän poliittisesti lävitse .	ideaaliehdotustaan	8	3
Amerikkalaisille vieraillemme valmistimme kiitospäiväksi kalkkunaa ja englantilaisille jouluksi vanukasta .	vieraillemme	1	1
Olet myös tervetullut toiveinesi ja uusine ideoinesi .	ideoinesi	6	2
Vastustajan omalta maalilta meidän päätyymme ” roiskitut ” pallot menivätkin sitten lähes kaikki sisään .	päätyymme	4	1
Eroaminen ystävistäni raastoi rintakehääni , ja kyyneleet nousivat silmiini kaikista ponnisteluista huolimatta .	ystävistäni	1	1
” Onhan se ylimielistä , että saan tietää tiedotusvälineistä , mitä kirkkomme johto ajattelee ” , Repo kertoi MTV3:lle .	kirkkomme	11	1
Äitisi kannattaisi hakea töitä teatterista , siellä hänellä olisi suuri tulevaisuus .	Äitisi	0	2
Peku kääntyy selälleen , kiskoo peitteen laittialta ja katselee matalaa , epätasaista kattoa .	selälleen	2	3
mies esitti uhkauksiaan viikonloppuiltaisin , jolloin väkeä on vain vähän paikalla .	uhkauksiaan	2	3
Omaan ryhmäänsä kuuluvat ne , jotka ovat jostain kuulleet ohjelmasta , mutta eivät tiedä , miten lähtisivät liikkeelle vai lähtisivätkö ollenkaan .	ryhmäänsä	1	3
Eroaminen ystävistäni raastoi rintakehääni , ja kyyneleet nousivat silmiini kaikista ponnisteluista huolimatta .	rintakehääni	3	1
Aloin pohtia tilannettani .	tilannettani	2	1
Kuin myös vaimon ” miksi sinun täytyy nöyryyttää minua näin –katse ” , joka seuraa heti tuijotuksen kohteeksi joutuneen naisen ” hakkaa hanskaasi , plösö ” –katsetta .	hanskaasi	22	2
Se onkin hyvä esimerkki joko miesten röyhkeydestä tai urhean fyysikkotutkijamme huomiokyvystä .	fyysikkotutkijamme	9	1
Vaikka taktiikka oli paikoin melkein väkivaltaista , taisi tyrmäys olla liiankin tekninen kun tamperelaiset Nahkamansikat voittivat joukkueemme osalta viimeisen pelin .	joukkueemme	16	1
Voittaja oli siis KY-Hunks , mutta hienoa peliä pelasi myös joukkueemme .	joukkueemme	10	1
Myös kauppasuhteemme Intian kanssa ovat tärkeitä .	kauppasuhteemme	1	1
Näissä merkeissä se aloitti viime marraskuussa kampanjan tunnettavuutensa puolesta Euroopassa .	tunnettavuutensa	7	3
Kerro mielipiteesi .	mielipiteesi	1	2
Jotkut eivät koskaan opi hallitsemaan ruumiinkieltään .	ruumiinkieltään	5	3
Koirani heittäytyi selälleen olohuoneemme lattialle ja nauroi kita ammollaan ja kaikki hampaat näkyvissä .	olohuoneemme	3	1
Silmien kohdatessa sanoi isä pojalleen ' pidä äidistäsi huoli ' , ja sulki pojan syliinsä kuin oltaisiin maailman lopulla .	äidistäsi	7	2
Mies saavuttaa oven , ojentaa kättänsä , mutta tuntee selässään polttavan kosketuksen .	selässään	9	3
Minä yritän selittää Lainalle , että kyllä se minun kissani tuntee , muistaa ja erottaa , vaikka tulisi metsässäkin vastaan .	kissani	9	1
Päinvastoin tuntuu siltä , että kompastelen läpi elämäni kehittäen itselleni vaikeuksia siellä , missä niitä ei ollut ennen .	elämäni	7	1
Tutkijat itsekin haluavat enenevässä määrin kertoa omista tutkimuksistaan ja niiden tuloksista ei vain omalle tiedeyhteisölleen vaan myös laajemmalle yleisölle .	tutkimuksistaan	7	3
Kun palaamme hotelliin , pyydän ettette kerro ystävillenne tästä päivästä .	ystävillenne	7	2
Selitän lapselleni , ettei minulla ole mitään aikomusta jäädä aloilleni sitä mukaa , mitä enemmän vanhenen .	lapselleni	1	1
Hodgkinson ei ole asenteineen yksin .	asenteineen	3	3
Varmista , että merkitty aika sopii ohjelmaasi .	ohjelmaasi	6	2
Ratcliffe edusti Walesia 59 A-maaottelussa , muttei pelannut koskaan jalkapallon arvokisoissa , vaikka hänen johtamaansa maajoukkueeseen kuului useita aikansa suurpelaajia , kuten Neville Southall , Mark Hughes ja Ian Rush .	aikansa	18	3
Kolmannessa erässä luovuttiin kokonaan vaihtopelaajien käytöstä ja joukkueemme peli loksahti kohdalleen .	joukkueemme	7	1
Näissä vasemmisto piti hallussaan 51 departementtia 101:sta , ja vahvisti näissäkin otettaan .	otettaan	11	3
( Jos jotain jäi hämäämään toisen illan puuttuminen , silloin kukaan ei kiinnittänyt huomiota asuuni , koska pelasin vain tietokoneella ja katsoin elokuvaa omassa rauhassani . )	rauhassani	24	1
Hän pysäytti junan ja minä siirryin veturiin hänen seurakseen .	seurakseen	8	3
Ymmärrän kyllä , että tyytyväiset kansalaiset ovat puolueellesi kauhistus , sillä tyytymätön , työtön vaalikarja teidät hengissä pitää .	puolueellesi	7	2
Baikalilla olet todennäköisesti turvemmassa kuin kesämökkipitäjäsi Nysäjärvessä .	kesämökkipitäjäsi	5	2
Siksi pyydän parlamentin ymmärtävän , että koen velvollisuudekseni olla äänestämättä tästä päätöslauselmaesityksestä .	velvollisuudekseni	7	1
Meidän taseissamme ei ole miljardien mentäviä aukkoja .	taseissamme	1	1
Kun otetaan huomioon luottoluokituslaitosten valta ja meidän pyrkimyksemme lisätä entisestään rahoitusmarkkinoiden sääntelyä ja valvontaa , on syytä pohtia tarkemmin , miten meidän on kohdeltava luottoluokituslaitoksia tulevaisuudessa .	pyrkimyksemme	7	1
Hän teki sen , pesi tukkani ja kampasi , toi jopa huulipunaa .	tukkani	5	1
Blogini ja oikeastaan koko elämäni uudeksi teemaksi voisi nimetä seuraavan lauseen .	Blogini	0	1
Jos 2 kohdan mukainen luettelon viimeisin käytettävissä oleva versio on kuitenkin virheellinen , EKP ei määrää seuraamuksia yhteisölle , joka ei ole asianmukaisesti täyttänyt raportointivaatimuksiaan siltä osin kuin se on hyvässä uskossa luottanut virheellisen luettelon tietoihin .	raportointivaatimuksiaan	24	3
Luentoesimerkeissään hän pysyttelee aina tässä Helsingissä .	Luentoesimerkeissään	0	3
Kohta nauroi poika isänsä kanssa , kun isä kaahasi pikkuautollaan väärää kaistaa rekan etupuskuriin .	isänsä	3	3
hae apua , älä jää yksin ; älä panttaa tunteitasi , itke tai ole vihainen .	tunteitasi	9	2
Olet minun omaa lihaani ja vertani .	lihaani	3	1
Mutta jo kauan ennenkö rämisevä viihde-eloktroniikkahelvetti saavutti putoamispisteen hän kaappasi laitteen syliinsä , puri hetken hammasta ja paiskasi sen seinään rikkoen Philipsin viiteen osaan jotka jatkoivat taas uuteen viiteen osaan ja niin edelleen .	syliinsä	11	3
Yhtiö päätti jatkaa suunnitelmiensa mukaisesti , koska ohjaaja on rangaistuksensa kärsinyt ja katuu tekojaan .	tekojaan	13	3
Jos olet palkollinen , työnantaja tai pyyteetön talkoolainen , pysy tiukasti lestissäsi .	lestissäsi	11	2
Olet myös tervetullut toiveinesi ja uusine ideoinesi .	toiveinesi	3	2
Työnsä hän signeerasi jokö " Charle de Flandre " tai flaaminkielisesti " Karel van Vlaanderen " .	Työnsä	0	3
Hän on kiertänyt käsivartensa olkapäillesi ja sinä taivut hänen puoleensa kuin vastatuulessa .	olkapäillesi	4	2
Minulla oli ikävä poikaani .	poikaani	3	1
Maamme ensimmäisen varsinaisen sairaalan ensimmäinen lääkäri Johan Haartman	Maamme	0	1
Musiikki hyväili hänen mieltään , keinutti ja tuuditti .	mieltään	3	3
Mutta mikäli vaimo iskee kauppajonossa toista naista kuolaavalta mieheltä ilmat pihalle tai suolestaa poskeaan soittaneen stevarin liikennevaloihin , on kyseessä hormonit .	poskeaan	13	3
– Haluamme kukkarosi ja hevosesi !	hevosesi	4	2
meidän kulttuurillemme ominaisia tapoja	kulttuurillemme	1	1
Fergie kommentoi eilen kuninkaallisen arvon riistoaikeita tyttäriltään .	tyttäriltään	6	3
heidän itsestäänselvyyksiään painetaan hyvälle , parhaasta puusta tehdylle paperille .	itsestäänselvyyksiään	1	3
Hän tahtoo että me kostamme hänen kuolemansa .	kuolemansa	6	3
Sen lisäksi , että säästin Tukholmassa rahaa , tänä aamuna eräs myöhästynyt palkkio oli siirretty tililleni .	tililleni	15	1
Myyntipalvelumme kunnia-asia on auttaa Sinua toteuttamaan yksilöllinen , juuri sinun näköisesi juhlatilaisuus .	Myyntipalvelumme	0	1
Ikänsä puolesta Harmaa tyttö voisi olla jo nainenkin , jos vain uskaltaisi .	Ikänsä	0	3
suomen kieltä olen oppinut vain kavereiltani ja naapureiltani .	kavereiltani	5	1
Voi jumalauta : oleksä noin arka että paskannat sydämes pottuun , kun pelkäät ?	sydämes	8	2
Perus festarimeininki bajamajoineen , kaljatelttoineen sekä myös sen suhteen , että puhelimella ei saanut ketään kiinni , kun verkko oli niin tukossa .	kaljatelttoineen	4	3
Olkaa hyvä ja seuratkaa minua niin menemme ottamaan mittanne pukuanne varten ” , ääni hymyili .	mittanne	8	2
Mikäli organisaationne kaipaa kartoittamista , ottanette yhteyttä !	organisaationne	1	2
Olin työkaverini kanssa kahvilla ja puheeksi tuli sateenkaariperheet .	työkaverini	1	1
On otettava huomioon , että luottamushenkilöillä on omat työnsä ja ammattinsa , johon he tietenkin päähuomionsa kiinnittävät .	päähuomionsa	15	3
Se on kertomus vapaasta kanasta , elävästä , hienosta yksilöstä omine tarpeineen .	tarpeineen	11	3
Ennen kuin Jussi kokonaan katosi mun taakse , tuli kuitenkin mieleeni kysyä , että minkä takia pyörä oli niin tärkeä Jussille .	mieleeni	10	1
Kirjailijalla ja ylläpitäjällä on koska tahansa mahdollisuus astua teokseensa ja hävittää se tai vain tehdä muutoksia , korjauksia , lisäyksiä ja poistoja .	teokseensa	8	3
Olisi edes joku , joka ilahtuisi tulostani pyyteettömästi .	tulostani	6	1
Vaalien jälkeen malli Began istui Berlusconin sylissä ja hänellä oli Berlusconin perhostunnus tatuoituna ja teksti ” Kohtaaminen , joka muutti elämäni S.B. ”	elämäni	20	1
Yhden sivun pituinen selvitys allekirjoittajineen on luettavissa sivulla http://www.climate.unsw.edu.au/bali/	allekirjoittajineen	4	3
Espressokeittimeni kanssa kävin pitkiä filosofisia keskusteluja sen keittäessä kahvia .	Espressokeittimeni	0	1
Minä ostin puolisolleni kahvia , unohdin maidon , mutta sain anteeksi .	puolisolleni	2	1
Vietin eilisen päivän tosiaan sohvalla lepäillen ja jalkaani hoitaen .	jalkaani	7	1
Käteni suojelevat arkaa ja jäätynyttä sydäntäni , eivätkä jalkani enää herää ikuisesta roudastaan .	jalkani	8	1
Palvelin meni varmaan ymmälleen ´ erikoisesta ´ html-slangistani .	html-slangistani	7	1
Onko pelaamistasi koskaan arvosteltu tai onko sinulle väitetty , että sinulla on peliongelma ?	pelaamistasi	1	2
Unohdin sateenvarjoni eilenkin .	sateenvarjoni	1	1
Kuule , yhtä turpea on sunkin aamunaamasi !	aamunaamasi	6	2
S & P kertoo , että se antaa AAA:n ainoastaan , jos luokitettava pystyy erittäin hyvin vastaamaan veloistaan .	veloistaan	17	3
Q ei suuremmin välittänyt tavaroistaan .	tavaroistaan	4	3
En myöskään kuule kavereitani tai opettajaani .	opettajaani	5	1
Minun puheestani ei kukaan uskoisi , että äidinkieleni olisi jokin muu kuin suomi .	äidinkieleni	7	1
Tuusula alkoi vilkuilla merkitsevästi kelloaan , ja mainitsi jotakin epämääräistä kiireistään .	kelloaan	4	3
Yhdeksän on onnennumeroni .	onnennumeroni	2	1
Vaalitarkkailutehtäväämme on muutettu molempien osapuolien toivomuksesta niin , että me tarkkailemme myös tätä prosessia , jossa tutkitaan esitettyjä valituksia .	Vaalitarkkailutehtäväämme	0	1
Meidän pitäisi kannattaa tätä mietintöä ja antaa hänelle tukemme .	tukemme	8	1
Älytavaroideni epätoivoinen vaikerrus kaikui syyttävänä korvissani .	Älytavaroideni	0	1
Istutteko vielä paikoillanne , otetaan vielä vähän kuuntelukuvia .	paikoillanne	2	2
Maamme taloudellinen tilanne tulee jatkumaan kireänä .	Maamme	0	1
Hän huitoi miekallaan kahta ryöväriä saamatta aikaan muuta kuin sen , että ryövärit pysyivät hänestä loitolla .	miekallaan	2	3
Omat kannattajansa se kuitenkin sai .	kannattajansa	1	3
Hän julkaisi myös soololevyjä ja teki kiertueita Zawinul Syndicate -yhtyeensä kanssa .	-yhtyeensä	9	3
Tämä täytti kymmenen , ei juuri arvostanut elettäni , irrotti pupulta pään ja marssi mielenosoituksellisesti huoneeseensa kuuntelemaan reggaeta .	elettäni	7	1
Leikkitoverini olivat mustia lapsia .	Leikkitoverini	0	1
Ampuja oli jo aiemmin ilmoittanut aikeistaan Internetin YouTube-sivustolla ja IRC-Galleriassa , johon hän oli ladannut kuvia ja suunnitelman tulevasta iskusta .	aikeistaan	5	3
Olen aiemmin kokeillut vain Mineralissiman mineraalimeikkejä , joten kauheasti minulla ei vertailukohtia meikkikokemukselleni ole .	meikkikokemukselleni	12	1
Käytetty tekniikka on nimeltään multiplexing .	nimeltään	3	3
Aikansa hän omisti taiteille .	Aikansa	0	3
Nyt on siis myös tilaisuus miettiä tässä puhtaasti kaupallisuuteen perustuvassa kulttuurissamme vallitsevia taloudellisia mekanismeja ja niiden turmiollisia seurauksia .	kulttuurissamme	10	1
Toki tykkään joskus pienestä luksuksesta , mutta kaikkein tärkeintä hyvinvoinnilleni on se , että saan tehdä elämässä niitä asioita , jotka herättävät minussa onnen tunteita .	hyvinvoinnilleni	9	1
varsin monet muuttavat koulutustavoitettaan .	koulutustavoitettaan	3	3
Ruusu hampaisiin , niin kukaan ei huomaa miten pinteessä olet , luulevat ilmettäsi hymyksi .	ilmettäsi	12	2
Ottakoon Jukan avukseen .	avukseen	2	3
Mieheni ei laita koskaan tomaatteja ja kurkkuja samalle leivälle .	Mieheni	0	1
Ne ovat seisseet paikallaan satoja vuosia , kenties vuosituhansia .	paikallaan	3	3
Heidän erottuaan hän palautti mieleensä sen , mitä he olivat sanoneet .	mieleensä	4	3
Tiikkainen on tiivistänyt muita vanhempana otettaan .	otettaan	5	3
Pahimmillaan työviikkoni ovat olleet 60-80 tuntisia kun päivystyksiä on useita .	työviikkoni	1	1
Voiko äiti olla omin päin ottanut sen käyttöönsä ?	käyttöönsä	7	3
Miekkaa hän ei juurikaan osannut käyttää , hän oli hankkinut sen vain koska muutkin rikkaat miehet kantoivat miekkaa vyöllään .	vyöllään	18	3
Kuitenkaan kaaokselle ei käännetä selkää : vaikka alinen on uhkaava muodottomuudessaan ja hajottavuudessaan , sieltä löytyvät myös todella suuret voimat .	muodottomuudessaan	10	3
Minä valitsin junani ja varasin kaikki paikat siitä .	junani	2	1
Putin puhuu huomenna Yhtenäinen Venäjä -puolueen puoluekokouksessa , mutta hänen ei uskota vielä paljastavan aikomuksiaan presidenttiytensä suhteen .	presidenttiytensä	15	3
Sitäkin tärkeämpää on nyt , lähes vuosi Helsingin Eurooppa-neuvoston jälkeen , keskustella kansallisissa parlamenteissamme ja kansalaistemme kanssa Turkin liittymisen tulevaisuudennäkymistä .	kansalaistemme	15	1
Eliniänodotteeni on laskentatavoista riippuen 82 .	Eliniänodotteeni	0	1
Tunnen melkein ylpeyttä olohousuistani ja hupparistani .	olohousuistani	3	1
Puolueettomuudelle Pöhl ei pannut mitään painoa , sellainen on hänen mukaansa aikansa elänyttä politiikkaa .	aikansa	11	3
Pitkän iän salaisuutena ritarimme pitää selkeää ohjetta , että pitää syödä kaikkee ruokoo riittävästi ja kunnolla ja sitten maata tarpeeksi , jotta ehtii levätä työn jälkeen .	ritarimme	3	1
Ilokseni sarja pyörii nyt meilläkin .	Ilokseni	0	1
Pulssini on tylsästi vain 87 .	Pulssini	0	1
Hän esti miestä käymästä kimppuunsa	kimppuunsa	4	3
Mielestäni vapaaehtoispalvelun täytyy pyrkiä kohti pitkän tähtäimen suunnitelmia , jotta siitä saatavat kokemukset olisivat tarpeeksi merkittäviä ja kestäviä .	Mielestäni	0	1
Miltä tuntuisi , jos työnantajasi voisi silmäillä geenejäsi työhönotossa ?	geenejäsi	7	2
Te Rauparaha kävi kauppaa eurooppalaisten kanssa ja sai näin käsiinsä musketteja .	käsiinsä	9	3
Tämä sama pätee kaikkiin asioihin elämässämme .	elämässämme	5	1
Suomen arkkitehtikunnan ahdasmieliseen ilmapiiriin tuskastuneena Penttilä siirtyi opetustehtäviin Wieniin ja etääntyi suomalaisista kollegoistaan .	kollegoistaan	12	3
Olo oli tosi itsevarma , tuntui että olin saavuttanut jotain elämässäni , ja vielä jotain hyvää oli tulossa .	elämässäni	10	1
Molla oli meidän nuorin lehmä , vasikoita lukuunottamatta , ja se oli aina hermostunu samalla lailla liiasta metelöinnistä , just niinku härät hermostuu ku ne näkee punasta .	lehmä	4	1
Kosketan etu- ja keskisormillani nenäni ja suuni väliin .	keskisormillani	3	1
Kalevi Wiik esitteli omaa näkemystään , jonka mukaan Pohjois-Eurooppa olisi jo jääkauden jälkeen ( alkaen n. 8000 eKr ) ollut jakautuneena kahteen kieli- ja kulttuurivyöhykkeeseen .	näkemystään	4	3
Tässä ei ole mielestämme pohdittu lainkaan tarvittavia makrotalouden uudistuksia eikä sitä , miten voitaisiin päästä kysyntäpuolen heikkouksista .	mielestämme	3	1
Pari vuotta sitten Suomessa vieraillut The Ragga Twins on typerästä nimestään huolimatta kelvollinen tanssijalan liikuttaja .	nimestään	10	3
Kansalliskalaamme ahventa kannattaa pyytää , sillä sen maku on mannaa .	Kansalliskalaamme	0	1
Auringolla tuntui olevan rennompi asenne kaikkeuteen , ja vanhus , joskin ensin empiväinen , hyväksyi lopulta täysin uuden ystävänsä olevan pysyvää sorttia – pysyvämpää kuin entisen kotimaansa takakireät ja tuuliset työpaikat .	kotimaansa	26	3
Matkapuhelinvalmistaja HTC , joka käyttää sekä Androidia että Windowsia älypuhelintensa käyttöjärjestelmänä , menestyi Yhdysvalloissa kasvattaen markkinaosuuttaan 21 prosenttiin .	älypuhelintensa	9	3
Olin näkevinään autojen valot edessä , ja aloin huitoa käsilläni .	käsilläni	9	1
vatsasi hellä hoituri	vatsasi	0	2
Näin tehtyäni pohdin muutaman hetken siirtymistä kofeiinipitoisen aamiaisen pariin keittiöön , mutta huoneilman hyytävä kylmyys ja jäsenieni uninen kohmeisuus pakottavat minut palaamaan peiton alle vielä viideksitoista minuutiksi .	jäsenieni	16	1
Ristiriitaista ottaen huomioon , että mies on yrittänyt vuosien ajan iskostaa kaaliini , että hän ei tee virheitä .	kaaliini	11	1
Kerää likaiset vaatteesi lattialta .	vaatteesi	2	2
Kutsut hänet synttäreillesi ja saisit lahjaksi suloisimman pehmoapinan , ajattelet , että tänään on se päivä , mutta tänään olisikin se päivä kun loppuillasta hän löytäisi jonkun toisen ja hakkaisi sydäntäsi moukarilla sirpaleiksi .	synttäreillesi	2	2
200_000 dollaria maksava Diablo oli luokkansa autoksi yllättävän askeettinen , CD-soitinkin oli lisävaruste , sähköikkunoita tai sähkötoimisia penkkejä ei ollut saatavilla , eikä myöskään lukkiutumattomia jarruja .	luokkansa	5	3
Tulin kohtaamaan tänne nuoruuttani ja nuoruudenaikaisia fysiikkaan liittyviä asioita .	nuoruuttani	3	1
Oli sanonut olevansa minun työkaverini , ja että olemme muka lähdössä Tampereelle teatteriin tai johonkin .	työkaverini	4	1
Pyydämme teitä kiinnittämään istuinvyönne ja nostamaan istuimenne selkänojan pystyasentoon .	istuinvyönne	3	2
Kirjan aineisto perustuu suurelta osin myymäläautoissa palvelleiden henkilöiden ja heidän asiakkaidensa haastatteluihin ja kertomuksiin .	asiakkaidensa	10	3
Eläisit omaa elämääsi , omien kavereidesi , seurustelusuhteiden ja tulevaisuuden kanssa ; valmistuisit Helsingistä kauppatieteiden maisteriksi ja hankkia omakotitalo merenrannalta , puoliso ja kaksi lasta .	kavereidesi	5	2
Toimistomme on suljettu torstaina 7.7.1994 klo 12 alkaen .	Toimistomme	0	1
Näkyvyyden puute johtuu pääasiassa siitä , että verkosto joutui käynnistämään toimintansa aivan tyhjästä , joten sen ensimmäiset toimintavuodet kuluivat perustamistöissä .	toimintansa	10	3
Päivä päättyi , kotimatkalla huomaat kuinka hän juttelee jo Janican kanssa , hymyilet vaikka sydämesi on ylösalaisin , ja laitat iPodistasi When you were youngin soimaan .	sydämesi	14	2
Marco Polo saattaa olla keksinyt matkakertomuksensa .	matkakertomuksensa	5	3
Mitä te oikein olette tehneet kukalleni ?	kukalleni	5	1
Vares tunsi inhottavan puristuksen vatsassaan .	vatsassaan	4	3
hänen ihonsa oli jo nuorena ryppyinen ja täynnä rokonarpia .	ihonsa	1	3
Presidentti Mauno Koivisto , miten katsotte onnistuneenne tehtävässänne ?	tehtävässänne	7	2
kaikki pudistelivat päätään .	päätään	2	3
Olemme pystyneet tekemään jopa pieniä sijoituksiakin ja kykenemme maksamaan kunnolla laskumme .	laskumme	10	1
Keskiarvoltaan risteily oli kuitenkin kiva , kun pääsin tapaamaan suosikkibloggaajatyttöjäni pitkästä aikaa .	suosikkibloggaajatyttöjäni	9	1
Ostatko yhden koon sukkahoususi ensisijaisesti K- , T- , S- vai E-kaupasta .	sukkahoususi	3	2
Entä viestivätkö naisen silmät miehelle , että ” uskon sinun kykyihisi , ota minut , saat minut hulluksi himosta ? ”	kykyihisi	10	2
Minulla olisi ollut yksi kerran käytetty pyyhe huoneessani , mutta yläkertaan oli liian pitkä matka ja olin jo ehtinyt riisua vaatteeni .	huoneessani	7	1
Miten mies voisikaan tietää , ettei Pekulla enää edes ole puhelintaan ?	puhelintaan	10	3
Lasse Pöysti kertoi muistelmissaan , miten välit Birgitta Ulfssonin kanssa saattoivat olla viileät ja kotoa teatterille matkattiin yhteisessä autossa sanaa vaihtamatta , mutta näyttämöllä tuettiin toinen toisiaan sataprosenttisesti .	muistelmissaan	3	3
Uskon siis , että ponnistelumme ovat nyt hyvässä vaiheessa ja että meidän ei tarvitse pelätä , että työmme ei tuottaisi vastaavaa tulosta .	ponnistelumme	4	1
Kutsut hänet synttäreillesi ja saisit lahjaksi suloisimman pehmoapinan , ajattelet , että tänään on se päivä , mutta tänään olisikin se päivä kun loppuillasta hän löytäisi jonkun toisen ja hakkaisi sydäntäsi moukarilla sirpaleiksi .	sydäntäsi	30	2
Vähi sai tehtäväkseen muodostaa hallituksen	tehtäväkseen	2	3
Elämäntapani , olkoonkin kuinka omani , oli edesvastuuton .	Elämäntapani	0	1
Arvoisa komission jäsen , meidän on korostettava sitoumustamme tähän lausekkeeseen .	sitoumustamme	7	1
Pyysin sairaanhoitajaa kohentamaan ulkonäköäni .	ulkonäköäni	3	1
Hänen lausumansa oli tuloksen kannalta ratkaiseva .	lausumansa	1	3
Myös hämmästystä aiheutti se , ettei avoimen lähdekoodin puolestapuhuja mainospuheistaan huolimatta tarjonnut omaa ohjelmistoaan avoimena vielä artikkelin kirjoitushetkelläkään .	mainospuheistaan	9	3
Kateusko vai mikä on syynä , että työtämme ei ole osattu arvostaa .	työtämme	7	1
Mikäli organisaationne kaipaa kartoittamista , ottanette yhteyttä !	organisaationne	1	2
Ryöväri putosi polvilleen huutaen tuskasta ja painoi kädellään päänsä sivua yrittäen lopettaa verenvuodon .	kädellään	7	3
Luulin sinua ystäväkseni .	ystäväkseni	2	1
Lehteään varten heillä on ” Parrakkaat naiset haastattelevat ” -sarja .	Lehteään	0	3
Kampaisit edes tukkasi kunnolla tai opettelisit käyttämään meikkejä .	tukkasi	2	2
Touko oli varreltaan toisia lyhyempi ja iholtaan tummempi .	iholtaan	6	3
Mithridateen kerrotaan pitäneen lähetystölle puheen , jossa hän väitti toimintansa olleen oikeutettua .	toimintansa	9	3
Olin heittämässä vihapäissäni Ladan avaimia roskikseen , kun muistin että kadullehan minä olin kulkuneuvoni jättänyt .	kulkuneuvoni	13	1
tule ostamaan oma lippusi tähän vuoden parhaaseen biletapahtumaan	lippusi	3	2
En tiedä miksi vielä pystyn ajattelemaan , en tiedä miksi vielä sydämeni sykkii .	sydämeni	11	1
( Jos jotain jäi hämäämään toisen illan puuttuminen , silloin kukaan ei kiinnittänyt huomiota asuuni , koska pelasin vain tietokoneella ja katsoin elokuvaa omassa rauhassani . )	asuuni	14	1
Tohtori sanoi lissabonilaisen sairaalan hoitaneen tehtävänsä ihan hyvin .	tehtävänsä	5	3
Siellä ulkopuolisuuteni jatkuu ja korostuu , mutta pidän siitä : pidän roolistani tarkkailijana .	roolistani	11	1
Hannu Salamasta tuli kuitenkin väkevän alkutuotantonsa takia tamperelais- ja erityisesti pispalaiskirjailija .	alkutuotantonsa	5	3
Poissaolevan puolesta taas tuli vastata sellaisen henkilön , joka parhaiten tiesi hänen sairastamisestaan .	sairastamisestaan	12	3
ne kyllä eli sitte , loppuelämänsä ihan kuitenki sopusasti .	loppuelämänsä	5	3
Pystyimme pitämään pelimme kasassa , ja lopulta me teimme sen .	pelimme	2	1
Unohdin sateenvarjonikin eilen .	sateenvarjonikin	1	1
Itseäni vanhempi mänty rysähtää halki horisonttini ja rysähtää varrellaan polvieni päälle Kovien rusahdusten saattelemana .	horisonttini	5	1
Minkälainen syntyhistoria tällä sinun persoonallisella palstallasi on .	palstallasi	5	2
Puolisoni ei , hän ei juuri virrestä piittaa .	Puolisoni	0	1
Äitisi kannattaisi hakea töitä teatterista , siinä hänellä olisi suuri tulevaisuus .	Äitisi	0	2
Hän kietoi käsivartensa suojelevasti tytön kapeiden hartioiden ympäri .	käsivartensa	2	3
Ne olivat tunkeutuneet komeroon seinässä olevan ilmanvaihtoputken kautta ja nauttineet mainion näkkileipäaterian , mutta kyllästyneet sitten oloonsa suljetussa paikassa ja pyrkineet vapauteen .	oloonsa	16	3
Voin nähdä sieluni silmin kuinka äidin musta , pitkä tukka hulmuaa tuulessa ja hän hymyilee kääntyessään katsomaan minua .	sieluni	2	1
Kosketan etu- ja keskisormillani nenäni ja suuni väliin .	suuni	6	1
Huomattavasti lähempänä omaa laatuani oli Markku Milton Into .	laatuani	3	1
Teleosakkeet ovat halventuneet liki 30 prosenttia huipustaan .	huipustaan	6	3
Tähän on olemassa oma hyvä syynsäkin kuten Aamulehden toimittaja Riitta-Liisa Pirttikoski toteaa : " Ja miksi , sillä paras on sama : omintakeinen itsellisyys , jonka avulla seistään pystyssä , toi tuleva mitä tahansa "	syynsäkin	5	3
Tee testamenttis perkele , Simo Simpatti huusi .	testamenttis	1	2
Isäni kertoman mukaan kello on erikoisen tarkka testattu yksilö .	Isäni	0	1
Lapseni täytti kolme vuotta .	Lapseni	0	1
Jos käytät muita ohjelmia , kuten Microsoft Wordia , meidän ehkä täytyy asemoida teksti uudelleen tulostustasi vastaavaksi .	tulostustasi	15	2
Haluan kiittää myös esittelijäämme El Khadraouita hänen tarmokkuudestaan ja ansioistaan laadittaessa päätöslauselmaa , josta huomenna äänestämme .	ansioistaan	9	3
Elokuva on kielletty alle 14-vuotiailta , mitä sekä Kati Outinen että leffan kutsuvierasnäytännössä nähnyt 12-vuotias Iida-tyttärensä ihmettelevät .	Iida-tyttärensä	15	3
Koira etsii sen hajuista esinettä , jolla se on tottunut ohjaajansa kanssa leikkimään .	ohjaajansa	10	3
Valmentajani Kari Mikkola ei lähde Floridaan , mutta päävalmentaja Kyösti Laasonen on paikalla .	Valmentajani	0	1
Teiden kulutus on minimissään .	minimissään	3	3
Laitan lukulampun niin , että voin käsilläni tehdä jäniksiä ja koiranpäitä ja vaikka mitä vastapäiselle seinälle .	käsilläni	6	1
Käsityksemme on , että tilapäiset panostukset , erityiset tiettyjä aloja koskevat säännöt tai valikoiva elinkeinopolitiikka ovat tehottomia , kalliita ja pitkällä aikavälillä yrittäjyydelle tuhoisia .	Käsityksemme	0	1
Mä olen voinut oikeen hyvin eikä edes jalkani ole särkeneet .	jalkani	7	1
Ylävartaloni on kokoa M ja alavartaloni XL .	alavartaloni	5	1
koko ruumiini sykki odotusta ja kaipausta ...	ruumiini	1	1
Sen muistan etten maksanut siitä paljoa , en olisi laittanut vähäisiä varojani kalliiseen olkikoiraan .	varojani	11	1
Näppituntumalta voinee veikata , että suomalaisjuntit eivät mökkejään helposti vieraille anna .	mökkejään	7	3
Omalla kohdallani olen tullut siihen tulokseen , että jollain tapaa haluamme tavaroiden kautta olla kiinni menneisyyden hyvissä muistoissa .	kohdallani	1	1
Joka tapauksessa kuskimme tuntuvat pitävän uudesta koneesta .	kuskimme	2	1
Kun kerroin äidille naisen identiteetistäni , äiti sanoi että nyt vihdoin ymmärrän mikä sinua on vaivannut .	identiteetistäni	4	1
Hän kumartui niin lähelle korvaani , että tunsin hänen hengityksensä ja alkoi kuiskia .	korvaani	4	1
Kaisu hätäili matkatavaroitamme , emme nähneet missään kuljettimia , joilla ne tulisivat .	matkatavaroitamme	2	1
Silloinen kuvernööri Robert FitzRoy päätti antaa maoreille anteeksi sillä New Zealand Company oli käyttänyt maahankinnoissaan hämäriä tapoja .	maahankinnoissaan	14	3
Nykyisen perustuslain mukaan presidentti Chávezin olisi pitänyt luopua asemastaan 2013 , jolloin hänen toinen kuusivuotiskautensa päättyy .	asemastaan	8	3
Zosima on häikäisevän valkoisine partoineen ja vaatteineen sadun hyvän haltijan näköinen .	vaatteineen	6	3
Kun kuitenkin perustuslaissa oli mahdollisuus määrätä sijaishallitsija , niin parlamentti ja senaatti yhteisistunnossaan nimittivät Flanderin Kaarlen veljensä Leopold III:n sijaishallitsijaksi .	yhteisistunnossaan	12	3
2. " toimimatta jättämisellä " tarkoitetaan tilannetta , jossa jäsenvaltion toimivaltaiset viranomaiset eivät yksittäisten henkilöiden toiminnasta aiheutuvan esteen ilmetessä toteuta kaikkia tarvittavia ja suhteellisia , niiden toimivaltaan kuuluvia toimenpiteitä esteen poistamiseksi ja tavaroiden vapaan liikkuvuuden varmistamiseksi alueellaan .	alueellaan	36	3
Ylioppilaskunnan Laulajat etsii riveihinsä uusia laulajia .	riveihinsä	3	3
Koko päivän ajan omatuntoni ruoskii minua käsiin levinneistä aikatauluista , koulutöiden aloittamisen siirtämisestä ja muusta yleisestä saamattomuudesta .	omatuntoni	3	1
Jatkosodassa alue vallattiin takaisin vuonna 1941 ja väestö pääsi palaamaan koteihinsa , mutta 1944 oli alue taas luovutettava ja väestö evakuoitava .	koteihinsa	10	3
Ei mene minun järkeeni .	järkeeni	3	1
Tanja Sihvonen kiitteli erityisesti humanistisen tiedekunnan laajoja ainevalintamahdollisuuksia sekä väitöskirjatyönsä osalta kiitteli vanhempien tutkijoiden innostavaa esimerkkiä .	väitöskirjatyönsä	9	3
Oma mieheni sanoo jo ihan suoraan , että ” onko pakko lähteä noin antavassa asussa ulos ” ja tulee korjaamaan paitapuseroni ylimmänkin napin kiinni .	mieheni	1	1
Aloin kertoa koiralle pitkää juttua siitä , miten ammoin , kolme koirasukupolvea sitten vanha Täplä oli helmikuussa tulipalopakkasen päivänä alkanut haukkua talossamme tuolloin sijaitsevan niinsanotun ´ yleiskomeron ´ oven takana .	talossamme	21	1
Kaaoskin kätkee helmaansa järjestyksen siemenen , niinhän nykyisin selitetään .	helmaansa	2	3
Hallituksemme hyväksyivät Turkin ehdokasvaltioksi Helsingin Eurooppa-neuvostossa .	Hallituksemme	0	1
Ehkä minä olen vain mieleltäni hyvin rajoittunut , mutta en ymmärrä .	mieleltäni	4	1
Heinonen on Ralf Gothonin kanssa pianistiemme eliittiä .	pianistiemme	5	1
Möttölä jatkaa pelejään Suomessa II-divisioonan FC Passen riveissä .	pelejään	2	3
Nyt on teidän vuoronne hyvät kuuntelijat toimia arvostelutuomareina .	vuoronne	3	2
Emme voi sysätä vastuutamme muille , sillä asettuessaan ehdokkaaksi Euroopan parlamenttivaaleissa jokainen meistä otti tehtävänsä vapaaehtoisesti vastaan .	vastuutamme	3	1
Anton Mikhailov on vahvempi omalla maallaan kuin maailman turuilla .	maallaan	5	3
' Mutta hän on poikasi '	poikasi	4	2
Lipponen viittasi siihen , että Virossa valtio ostaa oman turvallisuutensa hoitamiseksi turvallisuuspalveluja yksityisiltä yrityksiltä .	turvallisuutensa	9	3
Hän nousi autosta jalkojaan oikoen ja seisahtui tarkkailemaan ympäristöään .	ympäristöään	8	3
Semmoisia miehiä näistäkin minun junnuistani on kasvanut .	junnuistani	4	1
Se sanokin että hoida ite lehmäs , ja painu siihen suuntaan missä sanoin sen pyörän olevan .	lehmäs	5	2
oletko minkälaisessa yhteydessä ollut nyt perheeseesi ?	perheeseesi	5	2
Älä luulekaan että annan sinun laiminlyödä aviollisia velvollisuuksiasi .	velvollisuuksiasi	7	2
Pitäkäähän varanne , ett eivät omat rakkaat lapsenne käänny joskus teitä vastaan .	varanne	1	2
Åkeby aloitti peliuransa Hammarby IF:n juniorijoukkueessa .	peliuransa	2	3
Se on Suomen neljänneksi korkein tunturi , korkeudeltaan yli 1240 metriä .	korkeudeltaan	7	3
Zapatero lykkäsi tiistaina lomallelähtöään iltayhdeksään keskustellakseen muiden eurooppalaisten johtajien ja EU-komission kanssa .	lomallelähtöään	3	3
Tuolle värille on oma sanansa , tyttö miettii , muttei ihan tavoita sitä .	sanansa	4	3
Hän voisi tuoda niitä sinun dekkareitasi , en jaksa nyt lukea vakavia .	dekkareitasi	5	2
Mut jos kauppa menee kiinni vaik kasilt , ja sä katot kelloos et se on ton verran ku se on .	kelloos	11	2
Hän lupaa lähettää Sinulle SALT-paperinsa heti kun se on kirjoitettu .	SALT-paperinsa	4	3
Ylimielisyydessään useimmat poliitikot myös kuvittelevat , että puoluepolitiikka on politiikan kaikenkattava määritelmä .	Ylimielisyydessään	0	3
Kaikesta epätodellisuudestaan ja keinotekoisuudestaan huolimatta " Kauniiden ja rohkeiden " maailma on aikuisten maailma .	epätodellisuudestaan	1	3
Eläisit omaa elämääsi , omien kavereidesi , seurustelusuhteiden ja tulevaisuuden kanssa ; valmistuisit Helsingistä kauppatieteiden maisteriksi ja hankkia omakotitalo merenrannalta , puoliso ja kaksi lasta .	elämääsi	2	2
Onneksi sinun gerbiiliressukoillasi oli sentään toinen toisensa turvanaan .	gerbiiliressukoillasi	2	2
Lasselle en kertonut liikemiesurani kohtalosta eikä hän edes kysynyt sitä .	liikemiesurani	3	1
Tällöin valkea on uhrannut ratsunsa , mutta hänellä on kolme nappulaa hyökkäämässä mustan f7-sotilaan kimppuun .	ratsunsa	4	3
Jos kerran hahmotamme asemamme maailmankaikkeudessa pääasiassa ammattimme kautta , lienee selvää , että työn asema elämässämme on valtava .	elämässämme	15	1
Suvussani on aina ollut kovia rukoilijoita , viimeksi isoäitini , joka oli minulle kuin äiti .	Suvussani	0	1
Espoolla on Suomenojalla oma puhdistamonsa .	puhdistamonsa	4	3
Suunnitelmani viettää laiska viikonloppu kariutui Antin soittoon .	Suunnitelmani	0	1
Hän puree huuliaan , saa ne näyttämään siltä kuin olisi suudellut rakastaan tunteja .	huuliaan	2	3
Lopulta kiltahuoneen tietokonenäyttöjä koristikin laitoksemme kasvot .	laitoksemme	4	1
Siksi onkin myös aika tuoda näkökantamme selkeästi esiin komission suuntaan .	näkökantamme	5	1
Loppukaneetiksi mies heitti oman mottonsa , kampesi itsensä pöydästä ja tyytyväisenä hyräillen tepasteli ylämäkeä takaisin majaansa .	majaansa	15	3
Ennen sekin oli repussa , mutta menetettyään puhelimensa ja soittimensa ( sen , jonka hän oli matkaansa varten hankkinut ) , hän kasvoi varovaisemmaksi .	soittimensa	9	3
( 13 ) Yhteisön lentoliikenteen harjoittajien ei olisi järkevää soveltaa erilaisia korvausvastuujärjestelmiä verkostojensa eri reiteillä , ja tällainen olisi matkustajien kannalta hämmentävää .	verkostojensa	12	3
suomalaisten ponnisteluja verotuksensa uudistamisen parissa	verotuksensa	2	3
Kun kevätpuoli on töissä aika raskas päättöarviointeineen muineen .	päättöarviointeineen	6	3
Lopulta downshiftaajat ovat kuitenkin vain osa ilmassa väreilevää laajempaa asennemuutosta , jossa materialismi on menettämässä asemiaan , ja tilalle ovat nousemassa yhteisölliset ja ekologiset arvot sekä kriittisyys kiireistä ja kulutuskeskeistä elämänmuotoa kohtaan .	asemiaan	15	3
Tämä poikkeavuus , sekä se että koko Thomin lapsuuden ajan Yorket muuttivat usein , vaikeuttivat huomattavasti ystävien saamista , ja Yorken mukaan hänen lapsuuttaan leimasikin lähinnä yksinäisyyden ja eristyneisyyden tunne .	lapsuuttaan	23	3
Minä todella nautin pannessani henkeni alttiiksi .	henkeni	4	1
Tahtoisin kokeilla siipiäni	siipiäni	2	1
Doran erosi asemastaan Wikimedia-säätiön johdossa tämän jälkeen .	asemastaan	2	3
Erikoistyötapahtuman luonteeseen kuuluu , että niin opinnoissaan varhaisemmassa vaiheessa olevat opiskelijat kuin varttuneemmat tutkijatkin pääsevät tarkastelemaan laitoksen viimeaikaisia tutkimustuloksia .	opinnoissaan	6	3
Kaikki nämä ovat mahdollisia jos haluat kesältäsi unohtumattomia kokemuksia !	kesältäsi	6	2
Poikieni firmalla on hyvät toimitilat .	Poikieni	0	1
Se katseli vähiä tavaroitamme , arveli meidän viipyvän vain yhden yön .	tavaroitamme	3	1
Hänen nykyinen puolisonsa on Nancy Kassebaum Baker .	puolisonsa	2	3
Herään katkonaisesta unestani kännykkäni herätyskellon pirinään .	unestani	2	1
Palkinnon sai fil. yo. Johanna Pohtinen proseminaarityöstään Piiskan läiskettä ja PVC:n kahinaa .	proseminaarityöstään	6	3
” Asiakkaamme ovat pääosin suuria yrityksiä , jotka ovat keskittyneet tänne pääkaupunkiseudulle .	Asiakkaamme	1	1
Venäjä on ilmoittanut tyytyväisyytensä Suomen halusta huolehtia tapahtuman järjestämisestä .	tyytyväisyytensä	3	3
Useimmiten konsulaatissa kehotetaan , että menkääpä kotimaahanne .	kotimaahanne	6	2
Tavatessani ystäväni tänään kerroin hänelle asiasta ja omista epäilyksistäni .	epäilyksistäni	8	1
tietoisesti en rikostani tehnyt , vain tietämättömyyttäni .	tietämättömyyttäni	6	1
Olli kanteli annoksia kokkihattu päässään .	päässään	4	3
Jotkut professorit taas halusivat olla suuria kaloja pienessä lammessa ja nimesivät entisiä opiskelijoitaan tiedemiehiksi poislähteneiden tilalle .	opiskelijoitaan	12	3
TTE ei kierrä kilpailukieltoaan niin , että se ajattaisi omia autojaan muiden tallien toimesta .	kilpailukieltoaan	3	3
Asiantuntijamme voivat varmaankin antaa paljon sellaista perustietoutta , joka säästää teiltä aikaa ja rahaa .	Asiantuntijamme	0	1
Se oli joku , joka sai sydämesi lyömään yhden ylimääräisen lyönnin , pysäytti maailman hetkeksi kunnes se taas jatkoi matkaansa .	sydämesi	6	2
Ja sitten käyt mahallesi tuohon lattialle .	mahallesi	3	2
Kerrostalokaksio vaikuttaa aika vaatimattomalta ollakseen vakituinen asuntonne .	asuntonne	6	2
En halua vaikuttaa opiskelijalta , joka syyttää yliopistoa siitä , ettei saa opintojaan organisoitua ja ihmettelee kun opintopisteet eivät kartukaan itsestään .	opintojaan	12	3
Heidän avullaan voidaan kilpailla hinnoilla niin maataloudessa kuin hikipajoissa .	avullaan	1	3
Jotenkin kollegani silmistä näki , kuinka hänen tajuntansa laajentui .	kollegani	1	1
Täsmällisesti kuin ystävänsä toteutti mies päivittäin tehtävänsä kylässä : askelsi majatalon kautta järvelle , ruokalaan ja takaisin majaan .	ystävänsä	2	3
Sain päähäni uuden ajatuksen , joka muhi siellä kauan .	päähäni	1	1
Joku ei pitänyt aikeistani jatkaa löhöilyä , sillä sain kipeän potkun perskannikkaani .	aikeistani	3	1
Kulutustottumuksesi kertovat , kuka olet .	Kulutustottumuksesi	0	2
Mitä sitten mahdolliseen ydinvoiman lisärakentamiseen tulee , viimeisimpien kokemusten läntisestä naapurimaastamme Ruotsista tulisi antaa itse kullekin ajattelemisen aihetta .	naapurimaastamme	10	1
Teoksessaan Joutilaisuuden ylistys ( Basam Books Oy , 2006 ) Hodgkinson valottaa elämänfilosofiaansa ja yllyttää meitä hedonistiseen kulttuurivallankumoukseen : unohtakaamme herätyskellot , täyteen buukatut kalenterit , pikalounaat ja ylityöt !	elämänfilosofiaansa	12	3
Sain ihania ripsitupsuja silmiini ja pitihän ne sitten kuvata .	silmiini	3	1
Kehtaatkin solvata minua , epäillä rakkauttani ja kunniaani .	kunniaani	7	1
Hänen runonsa levisivät pääasiassa kädestä käteen eikä kukaan inahtanutkaan hänen ja hänen perheensä kohtalosta .	perheensä	12	3
Tässä on maitosi	maitosi	2	2
Nämä autothan ovat pohjalevyltään samaa puuta takapuskurista etupuskuriin .	pohjalevyltään	3	3
Sanoisin , etten tiedä mitään ärsyttävämpää kuin se , että joku kuvaa minua , vaikka nimenomaan olen sanonut , etten halua naamaani kameran eteen . :/	naamaani	21	1
Päinvastoin , määrittelen itsenikin ensisijaisesti ammattinimikkeeni perusteella .	ammattinimikkeeni	5	1
Jos unohdan näyttää Apteekkikorttini reseptejäni käsiteltäessä tai maksaessani kassalla , voiko ostamani tuotteet siirtää jälkikäteen rekisteröintitietoihin ?	reseptejäni	4	1
Pocahontas-nukke on ihana pitkine mustine hiuksineen .	hiuksineen	5	3
Toivottavasti ei käy kuten Ruotsissa , missä joka ainoa halukas jeppe saa tehdä almanakkoja ja niihin nimistöjä mielensä mukaan .	mielensä	17	3
Tarkoitan sitä , että valtiontuilla on puitteensa , jotka on luotu juuri meidän ehdotuksestamme , mutta tukia ei yksinkertaisesti voida säännellä , sillä perustamissopimuksessa määrätään niille normatiiviset puitteet .	ehdotuksestamme	13	1
Kovin kauaa en kyllä nauttinut sovinnosta , sillä Mies oli kuuma , untuvapeittoni oli kuuma , enkä minä ollut enää väsynyt .	untuvapeittoni	12	1
tietoisesti en rikostani tehnyt , vain tietämättömyyttäni .	tietämättömyyttäni	6	1
Nyt yritys on pyytänyt Yhdysvaltain suurimpiin kuuluvan vakuutusyhtiön , WellPointin asiakkaita arvostelemaan lääkärikokemuksensa , ja arvoimaan esimerkiksi lääkärinsä kommunikointikykyä ja tämän kanssa saavutettua luottamussuhdetta .	lääkärinsä	17	3
" Ei , ei suinkaan , mukavahan tässä oli vähän jalkojaan lepuuttaa . "	jalkojaan	10	3
Viimeiset kaksi vuotta Suomen Moskovan suurlähettiläänä toiminut Matti Anttonen esitteli vierailuluennollaan Turun kauppakorkeakoulussa erilaisia näkökulmia nyky-Venäjään ja sen talouteen .	vierailuluennollaan	10	3
Jos nainen näyttää liian varmalta kyvyistään tehdä mies villiksi , se saattaakin pelottaa miestä .	kyvyistään	5	3
Raimo huomasi meidän katsomisemme , kääntyi , näki Kaisun ja kysyi , halusinko , että hän haki emäntäni baariin .	katsomisemme	3	1
Toisin ku meidän tilan lähestymistie , ni Jussin vanhemmat oli onneks aidannu sen tien silleen , ettei Molla päässy ku sinne tilalle päin .	tilan	3	1
Hän oli myös paljon kuuluisamman kaimansa , kristityn Origeneen , aikalainen .	kaimansa	5	3
Eilisellä kotimatkalla , kun raahasin miljoona laukkujani / kassejani / pussukoitani rautatieasemalta kotiin , vasenta jalkaani alkoi vihloa .	kassejani	8	1
Ensimmäinen rappion merkki miehellä on , jos hän jättää partansa ajamatta .	partansa	9	3
Kuinka kehtaat herjata rakasta opettajaasi , joka on aina oikeassa ?	opettajaasi	4	2
Kaikki ihania ja suloisia , mutta luontoni ei antanut periksi hankkia kenellekään heistä leikkijunaa , itsestäni puhumattakaan .	luontoni	6	1
toinen poliisi löysi Dockeryn makaamassa talon pihalta luodinreikä otsassaan .	otsassaan	8	3
Arvoisa puhemies , kiitos huomaavaisuudestanne .	huomaavaisuudestanne	4	2
Tavoitteenamme pehmeämpi ammattikuva , josta lähipoliisi on yksi esimerkki .	Tavoitteenamme	0	1
Onneksemme festi-isännät lainasivat hänelle sikäläiset epäluonnon valkoiset haalarit , eikä Jupsun mönjät päässeet leviämään .	Onneksemme	0	1
Henkilöautossa saa kuljettaa nestekaasua enintään 60 kg pulloineen .	pulloineen	7	3
Sijaishallitsija vannoin virkavalansa perustuslaille 20. syyskuuta 1944 .	virkavalansa	2	3
Vihdoin näin sinut väkijoukossa muiden saartamana , olit jotain uskomatonta tummansinisessä paljettimekossasi , ja hymyillen lähdin sekoittelemaan omenalikööriä , josta joskus kerroit minulle tykkääväsi ( silloin joskus aloin pitämään siitä itsekin ) .	paljettimekossasi	11	2
Tunnustakaamme syntimme taivaalliselle Isällemme ; avatkaamme sydämemme kaikkitietävälle Jumalalle .	Isällemme	3	1
- Meidän juttu .	juttu	2	1
yö , tuo tunturimaailman loputtoman päivän tuskin tupakkatauon mittainen hengähdyspaussi , jolloin aurinko hiipuu pohjoisen äärellä ollen silti hereillä ja valvoen valtakuntansa elämää .	valtakuntansa	21	3
Meidän resurssimme eivät riitä kauppahuonetoiminnan opetteluun .	resurssimme	1	1
Se maa tulee kestämään yli vielä sinunkin elinaikasi .	elinaikasi	7	2
" Pidä varasi ! " huudahti Myyrä äkkiä .	varasi	2	2
Pyydämme teitä kiinnittämään istuinvyönne ja nostamaan istuimenne selkänojan pystyasentoon .	istuimenne	6	2
Näen tilanteen , jossa hän ojentaa minulle pillimehun komerostaan tai kertoo , miten hän on ajatellut ensi syksyn järjestää .	komerostaan	8	3
Ja tätä miestä korventaa vaalikampanjassaan se toinen tyttöministeri peräkkäin oikeusministeriössä .	vaalikampanjassaan	4	3
Älytavaroideni epätoivoinen vaikerrus kaikui syyttävänä korvissani .	korvissani	5	1
' Ne oli , nyt ne on meidän lätäkön sukellusveneinä '	lätäkön	8	1
Jokainen on toivon mukaan päässyt osaksi oman ainejärjestönsä toimintaa jokaiselle jäsenjärjestölle tunnusomaisen toiminnan muodossa – olipa se sitten toimintaa hallituksessa tai normaalina rivijäsenenä .	ainejärjestönsä	7	3
hänen ihonsa oli jo nuorena ryppyinen ja täynnä rokonarpia .	ihonsa	1	3
Illalla kuuntelin puhelinvastaajaani .	puhelinvastaajaani	2	1
Otsa hiessä pitää sinun leipäsi ansaitseman ?	leipäsi	4	2
Hän ei sanoisi tätä pakomatkaksi , ei vaikka lähdimme yötä vasten repulliset tavaravaa selässämme .	selässämme	13	1
Olin jo varma , että eroamme , mutta muutamien hermosavujen jälkeen Mies palasi takaisin sänkyyni .	sänkyyni	14	1
Pyydämme teitä kiinnittämään istuinvyönne ja nostamaan istuimenne selkänojan pystyasentoon .	istuinvyönne	3	2
Onko koskaan tapahtunut sellaista , että ihmiset olisivat joutuneet lähtemään talostaan vuokrarästien takia ?	talostaan	10	3
saat siinä koko ikäs olla	ikäs	3	2
Hän ei häikäile käyttää valtaansa .	valtaansa	4	3
Turkkilaiset kollegani suuresta Turkin kansalliskokouksesta harmittelevat samoin tätä epäkohtaa , nimittäin että kukaan ei halua ilmeisesti puhua heidän kanssaan , ei kansallisista hallituksista tai parlamenteista eikä myöskään lähes kaikista eurooppalaisista instituutioista .	kollegani	1	1
Koska leukamme pienenee nopeammin kuin hampaamme , hampaat joutuvat tulevaisuudessa entistä ahtaammalle .	leukamme	1	1
Pahiten kirpaisi sinun petollisuutesi .	petollisuutesi	3	2
Olen masokistisesti asettanut kännykän kirjahyllyyni siten , että olen pakotettu nousemaan sängystäni ja kävelemään huoneen poikki sammuttaakseni kellon .	kirjahyllyyni	4	1
Kotimatkalla soitin äidilleni ja sanoin että tottakai .	äidilleni	2	1
Kaarlea hävetti jälkeenpäin oma hätäännyksensä .	hätäännyksensä	4	3
jälkeläisemme puistelevat päätään lukiessaan esi-isiensä mielettömyyksistä ja kiroavat meitä ajatellessaan , miten 1900- ja 2000-luvun ihminen rosvosi loppuun sen planeetan , josta oli tuleva myös heidän kotinsa .	kotinsa	26	3
Olemme sen velkaa kansoillemme ja jokaiselle äänestäjällemme .	kansoillemme	3	1
Paljastukseni herättää yleensä myötätuntoa : on se niin sääli , että nykyajan nuorilla naisilla ei ole kunnianhimoa .	Paljastukseni	0	1
Ukkoskos sä huomasit ?	Ukkoskos	0	2
Määttäsen periaate on ollut , että mies pitää huolen siitä mitä hänen vastuulleen on annettu .	vastuulleen	12	3
Oranssi ry ei ole luopunut hankkeestaan saada rakennus nuorison käyttöön .	hankkeestaan	5	3
pariskunta tapasi kerran ennen häitä vain kertoakseen vanhemmilleen pitivätkö he vanhempiensa valitsemasta ehdokkaasta vai eivät .	vanhemmilleen	7	3
Minun jouluyön ateriani koostui iduista , vihreästä salaatista ja tofusta . :)	ateriani	2	1
Silloin saavatkin viettää aikansa aivan kahden .	aikansa	3	3
Nyt tilanne on heidän mukaansa liian usein se , että ensimmäinen yritys viestiä tutkimuksestaan on väitöskirjatiedotteen laatiminen .	tutkimuksestaan	13	3
Järkytykseni oli suuri , kun viimekesäistä kolmen kuukauden lomaa viettäessäni tajusin , etten kärsinyt tekemisen puutteesta , sisällöttömyydestä tai hyödyttömyyden tunteesta .	Järkytykseni	0	1
Sen vuoksi vähemmän saastuttavien moottoreiden käyttö tällaisissa koneissa on tärkeää , kun yritetään vähentää ilmansaasteita kaupungeissamme , ja tehdä tämä kohtuullisin kustannuksin .	kaupungeissamme	15	1
Ulkoilupusakkani osasi ennakoida säätilat ja opastaa minut perille läpi tuulten ja tuiskujen .	Ulkoilupusakkani	0	1
Siltanen kuului rapistelevan papereitaan .	papereitaan	3	3
Matkalla vastaan valuivat mummot kasseineen , koiranulkoiluttajat ja opiskelijat napit korvillaan .	kasseineen	4	3
Jättiläinen painoi 2,6 kiloa ja oli läpimitaltaan 46 senttiä .	läpimitaltaan	6	3
Wolters muun muassa esitteli luennolla jaon , jonka mukaan hän määrittelee saksalaisia filosofeja ja heidän ajatteluaan suhteessa natseihin , Hitleriin ja natsi-ideologiaan .	ajatteluaan	15	3
auringon kiertäessä eläinrataansa kiertää maa auringon ympäri spiraalimaista kierrosta .	eläinrataansa	2	3
Suvussani on aina ollut kovia rukoilijoita , viimeksi isoäitini , joka oli minulle kuin äiti .	isoäitini	8	1
Poikani ja tyttäreni ovat vesipetoja , mistä lie geeninsä perineet .	geeninsä	8	3
Minä vanhempana ja kokeneempana näin jo silloin , ettei heidän rakkaudellaan ollut tulevaisuutta .	rakkaudellaan	10	3
Hankkijan ja SOK:n taas kerran virinneet neuvottelut toimintojensa yhdistämisestä	toimintojensa	7	3
Onneks Jussi hiljeni ku sanoin että sen polkupyörä oli löytyny lähempää meidän tilan nurkilta .	tilan	12	1
Lukekaapa ja vetäkääpä omat johtopäätöksenne seuraavasta tulosluettelosta miesten 200 metrin vapaauinnissa : .	johtopäätöksenne	4	2
Äkkiä hänen paras ystävänsä alkoi vajota .	ystävänsä	3	3
Tämä täytti kymmenen , ei juuri arvostanut elettäni , irrotti pupulta pään ja marssi mielenosoituksellisesti huoneeseensa kuuntelemaan reggaeta .	huoneeseensa	15	3
Kuten sanottu , puolueryhmämme sai läpi suurimman osan tarkistuksistamme , mutta olisimme toivoneet näkevämme , että olisi selkeämmin painotettu sellaisten hyvin toimivien markkinoiden tärkeyttä , joilla on tehostettava toimia vääristävää valtion tukea ja monopoleja vastaan .	puolueryhmämme	3	1
Rehtorikin , joka aina sai sanat aseteltua kohdalleen , totesi jotain aiempaa ajattelijaa lainaten , että on hulluutta tehdä asiat aina samoin , mutta odottaa uusia tuloksia .	kohdalleen	7	3
Miten tota vaikuttaako se sun mielialaas jotenkin oleks sä niinkun ilosemmilla mielillä taikka .	mielialaas	5	2
Molemmat ehdokkaat käyttivät kaatuneiden sotilaiden tarinoita oman näkemyksensä ajamiseen .	näkemyksensä	7	3
Nyt minä vastasin vähän rumasti : ” Kuntosali ja keskuslukitus , voitko kerrankin olla pienentämättä miehuuttani . ”	miehuuttani	15	1
Itse tauti ei tule hoidetuksi , koska sen syyt ovat syvällä koko elämämme menossa	elämämme	12	1
Saithan sinä sen mun viestini ?	viestini	4	1
Olen masokistisesti asettanut kännykän kirjahyllyyni siten , että olen pakotettu nousemaan sängystäni ja kävelemään huoneen poikki sammuttaakseni kellon .	sängystäni	11	1
Kirjoittajamme oppeja ovat monet yrittäneet soveltaa käytäntöön , tulokset ovat olleet perin vaihtelevia .	Kirjoittajamme	0	1
Kun puuvarastot alkavat kasvaa , metsänomistajien on pakko tyytyä halvempaan hintaan , jos aikovat saada puunsa kaupaksi .	puunsa	15	3
DNA:n geeni on se kemiallinen olio , joka oman jatkuvuutensa takaamiseksi on kehittänyt ihmisen kaikkine elimineen .	jatkuvuutensa	9	3
Sen sijaan hän tuntee osan siitä paljastumisen pelosta luissaan , nostaa viltin harteilleen ja puhaltaa jäähtyneeseen teekuppiin tavan vuoksi .	luissaan	8	3
Torjuakseni mielteitä aloin laskea varpaitani , joita oli kymmenen , näin uskon , vaikka niitä oli hankala laskea kun jalkaterät väikkyivät veden alla kuin meduusat .	varpaitani	4	1
Vasta sitten , kun suurin osa jäsenvaltioista on ilmoittanut täytäntöönpanotoimistaan , voidaan antaa arvio siitä , kuinka paljon jäsenvaltiot ovat antaneet täydentäviä määrällisiä sijoitussääntöjä ja muuta lainsäädäntöä , jotka saattavat vaarantaa direktiivin asianmukaisen toiminnan .	täytäntöönpanotoimistaan	9	3
Mies joi sentään janoonsa ison olutlasin puolilleen .	janoonsa	3	3
Nykyisen perustuslain mukaan presidentti Chávezin olisi pitänyt luopua asemastaan 2013 , jolloin hänen toinen kuusivuotiskautensa päättyy .	kuusivuotiskautensa	14	3
Kirjastoissa on paitsi paljon kirjoja myös tietokoneet kieliohjelmineen .	kieliohjelmineen	7	3
Mutta minun ei olisi tarvinnut huolehtia , sillä hän ei enää nostanut katsettaan minuun , siirteli vain jalkojaan pitkin hiekkaa ja katseli sitä melko lumoutuneena .	jalkojaan	17	3
Lähetin paketin serkulleni Kuusamoon .	serkulleni	2	1
DeMille käyttää usein kirjojen tapahtumapaikkanaan kasvuseutuaan , Long Islandia .	kasvuseutuaan	5	3
Soitettuaan vuosia bändissä nimeltään Heatmiser , Smith aloitti soolouransa vuonna 1994 .	nimeltään	3	3
Käsikirjoittaja Suvi Kanniainen oli mielestäni onnistunut paitsi ohjauksessaan , myös käsikirjoituksessa .	ohjauksessaan	7	3
A-poikien osalta karanteenimaksu on maksimissaan 50_000 mk .	maksimissaan	4	3
Hänen mukaansa yleinen mediamaksu velvoittaa YLEn kehittämään palveluitaan niille suomalaisille , jotka eivät tähän asti ole YLEn palveluista välittäneet .	palveluitaan	7	3
Heimon miehet häpesivät kuitenkin naisvallan alla oloa , mistä suuttuneena Libuše lupasi osoittaa kansalle uuden miespuolisen hallitsijan , josta tulisi hänen aviomiehensä .	aviomiehensä	21	3
Prinssi Kaarle oleskeli Isossa-Britanniassa ensimmäisen maailmansodan aikana ja suoritti siellä perusopintonsa .	perusopintonsa	10	3
Kuitenkin Matista ja hänen kolmesta veljestään tuli kauppiaita .	veljestään	5	3
minun ansiostani nämä kissat elävät .	ansiostani	1	1
Nakit olivat uunissa grillivastusten ollessa päällä , kunnes olivat sopivasti ruskistuneet pinnaltaan .	pinnaltaan	11	3
Olin ajatelluki varmistella vähä siitä hänen tulostansa ettei tota tuu niinkun liian hätänen olo siinä .	tulostansa	6	3
Naamani valahtaa tomaatin punaiseksi , kun veri lähtee kiertämään poskissani vinhaa vauhtia .	Naamani	0	1
* 1990 – Tuottajat myönsivät , että vuoden 1990 parhaan uuden artistin Grammy-palkinnon saanut Milli Vanilli -popmusiikkiduo ei itse laulanut levyillään .	levyillään	20	3
Tykkään aivan mielettömästi piirretyistä ja tästä tuli kyllä eräs uusista elokuvasuosikeistani . :)	elokuvasuosikeistani	10	1
Antaako taloudellinen riippumattomuutemme Neuvostoliitosta meille aikaisempaa vapaammat kädet ja miten EY-maiden mahdollisesti aggressiiviseksikin muotoutuva idänpolitiikka meihin vaikuttaa , ovat avainkysymyksiä .	riippumattomuutemme	2	1
Joku ei pitänyt aikeistani jatkaa löhöilyä , sillä sain kipeän potkun perskannikkaani .	perskannikkaani	11	1
Finnair ei ole halukas muuttamaan politiikkaansa , jonka mukaisesti se haluaa keskittää toimintansa Vantaan kentälle .	toimintansa	12	3
Kohteen massa on vain 1,9 Maan massaa , mikä tekee siitä massaltaan pienimmän toistaiseksi löydetyn eksoplaneetan .	massaltaan	11	3
Varsinkin Salla Närän esittämä pornokaupan paha puuma sekä Tarja Vuolan elämäpakoinen leskirouva lunastivat paikkansa .	paikkansa	13	3
Toiset juovat kuravettä janoonsa , mutta meillä Suomessa on varaa huuhdella vessatkin raikkaalla juomavedellä !	janoonsa	3	3
Häpeä voi saada ihmisen kieltämään seksuaaliset tarpeensa , kirjoittaa Heidi Lindgren eräässä lehtiartikkelissa .	tarpeensa	6	3
Neljä suurinta purjelaivaa - Sedov , Mir , Cuauhtémoc ja Captain Miranda - käytti lähdössä hinaajien avustusta , mutta alkoivat nostaa purjeitaan jo Ruissalon kohdalla .	purjeitaan	21	3
Olin todella tyytyväinen ostokseeni koska housut olivat todella halvat ja juuri kuin minulle tehdyt .	ostokseeni	3	1
Silloin vasta se meni itsekkyyteni panssarin ohi .	itsekkyyteni	4	1
Jokaisella on sietorajansa .	sietorajansa	2	3
Tiesin joka solullani , että nämä ovat niitä viikkoja , joita muistellaan syksyllä , nauretaan porukalla , herkutellaan yksityiskohdilla .	solullani	2	1
Suvivirsi raikasi , minä lauloin palkeitteni pohjista .	palkeitteni	5	1
Muutaman uudenkin tuttavuuden kanssa tuli juteltua , eräs tyttö pelasti oikeastaan koko toisen iltani jutuillaan .	iltani	13	1
Mietin , jaksaako vanhuksia ihan oikeasti meidän pienessä kämpässä , varsinkin jos tutkimusjakso on useita päiviä kerrallaan .	kerrallaan	16	3
Yritykset ovat osallistuneet yhteistyöhön tukemalla tutkimusta sekä omien tuotekehitysprojektiensa muodossa .	tuotekehitysprojektiensa	8	3
Ehkä juuri dopingin ansiosta ( tai no mistä muustakaan ) aika moni oma joukkueemme putosi jo alussa , jotta pääsi harrastamaan lisää dopingia jonnekin lämpimään .	joukkueemme	13	1
Olemme hankalassa tilanteessa , sillä Air France -lentoyhtiöllä on täydellinen monopoliasema Yhdistyneessä kuningaskunnassa ja olisi hyvin valitettavaa , jos kahnaus lentoyhtiön kanssa estäisi Euroopan parlamentin brittijäseniä äänestämästä ja edustamasta omia vaalipiirejään .	vaalipiirejään	30	3
häntä ei hyväksytty , koska oli tehnyt rikoksensa koetusajalla .	rikoksensa	7	3
Päätäni särkee .	Päätäni	0	1
Joko vatsalaukkusi on tyhjä ?	vatsalaukkusi	1	2
Hajanaisesta kinkusta huolimatta joulumme oli mitä ehjin ja hupaisin .	joulumme	3	1
Olenko ihan oikeasti empimässä sitä , voisiko vanha isäni päästä ilmaiseksi tutkimukseen , jossa tarkkaillaan hänen sairautensa etenemistä ja otetaan kaikki sellaiset kokeet , mitä julkisella puolella ei edes harkita .	isäni	8	1
Jokainen levy oli myynyt edeltäjäänsä hieman paremmin .	edeltäjäänsä	4	3
Poika menetti tajuntansa 20 tuntia pelattuaan	tajuntansa	2	3
Ne laahasi sitä salkkua köyden päässä niinkun jonkinlaista punttia perässään , että santakäytävä pölisi ja jarruttivat vauhtiaan .	vauhtiaan	16	3
Kello 15.01 hän oksentaa housuilleni .	housuilleni	4	1
Mutta ehkä se olikin juuri Oskar Lafontainen avoin pyrkimys ottaa valta käsiinsä , joka sai saksalaisdemarit antamaan valtakirjan hänelle .	käsiinsä	11	3
Tiesin jo ettei Miikael tulisi matkustamaan tänne koska ei hän lähtisi tuhlaamaan tärkeää aikaansa .	aikaansa	13	3
sinäpä oletkin niin laiska , aina vaan siinä sohvalla pesit , ihme kun et selkänahastasi siihen kiinni kasva .	selkänahastasi	14	2
Eipä silti , onhan näissä nykyisissä ilmoissa hyvätkin puolensa , kun ajatellaan esimerkiksi vuoden 1987 säätä .	puolensa	8	3
Tässä sinulle hieman Nettikirjoittajakoulun palautetta tekstistäsi , joka muuten olikin melkoisen pitkä kirjoitus .	tekstistäsi	5	2
( Sillä vaikka minulla olikin baarissa erinomaisen limsani äärellä mukavaa , se ei sulje pois tylsää alkuiltaa ja yksinäistä seuraavaa aamua , kun olutta nauttinut Mies ei ollutkaan tullut yöksi meille . )	limsani	7	1
saat lihhaa palkakseis	palkakseis	2	2
Minä tiedän totuuden : perheessämme on kaksi tapausta , väite kumotaan joka yö .	perheessämme	4	1
Mahallani maaten huomasin valojen lähestymisen hidastuvan , ja sen verran mitä sateessa Mollan ahteria erotin , tajusin etteivät nämä kaksi vastakkain liikkuvaa kohdetta törmäisi .	Mahallani	0	1
Tästä syystä haluan vielä kerran pyytää teitä tukemaan tätä komission ehdotusta ja onnitella esittelijä Jarzembowskia ja koko tekstin parissa työskennellyttä ryhmää sekä teitä , hyvät parlamentin jäsenet , tarkkaavaisuudestanne .	tarkkaavaisuudestanne	28	2
Antakaa rahaa tai muutoin sukulaisesi ovat vaarassa .	sukulaisesi	4	2
Kesänaapuriemme nuorin tyttö vietti kesiä Saksassa ja jäi sinne naimisiin .	Kesänaapuriemme	0	1
Semmoinen kysymys vain putkahti päähäni , että miksei ole sinua näkynyt Uutisvuoto-ohjelmassa ?	päähäni	4	1
muutamaa päivää ennen lähtöäni Saksaan Boxsteria koeajamaan , kuulin Porschen maahantuonnin lakkauttamisesta .	lähtöäni	3	1
Lempivärini on punainen .	Lempivärini	0	1
Yliopiston luento ja kokous jäivät tänään väliin tuon kivuliaan koipeni vuoksi .	koipeni	9	1
En koskaan saavuttanut tavoitettani , tosin en enää muista miksi .	tavoitettani	3	1
Se sinun ihmeellinen Lassesi pistää rahasi kurkustaan alas ja juottaa vielä muita naisia .	rahasi	5	2
Mutta kun se väittää olevansa sinun isäs .	isäs	6	2
Olet tainnut unohtaa yhden seikan , ystäväiseni .	ystäväiseni	6	1
Toivon , että teillä kaikilla on ollut erinomainen loma , ja toivotan teille antoisaa työskentelyjaksoa tänä parlamenttimme vaalikauden viimeisenä vuonna .	parlamenttimme	16	1
Terveisiä teidän väelle ja kiitos sulle .	väelle	2	2
15-vuotias poika menetti tajuntansa ja sai kouristuksia pelattuaan 20 tuntia World of Warcraft -tietokonepeliä .	tajuntansa	3	3
Oma jääkaappini oli aivan tyhjä ja koska kauppareissu tällä jalalla ei houkuttanut sitten alkuunkaan , turvauduin ystäväni apuun .	jääkaappini	1	1
ku se esipuheessaan kato kiittää kaikkia naisia kuten tapana on , Hannaa , äitiänsä ja ketä kaikkiansa .	äitiänsä	13	3
Mutta minusta maalla ei ollut yhtään ihanaa enkä ymmärtänyt miksi äidilläkään olisi ollut , ellei sitten kauan ennen minun syntymääni .	syntymääni	19	1
Videolaitteita kuulokkeineen on yhden opetusryhmän verran .	kuulokkeineen	1	3
Tällöin eri kurssien toisistaan eroavat työmäärät voivat johtaa siihen , että opiskelija valitsee itselleen ja opinnoilleen hyödyllisimmän tai yleisesti mielenkiintoisimman kurssin sijaan sen kurssin , josta tietää opintopisteitä helpoimmin irtoavan .	opinnoilleen	15	3
Profiilimme esiintyisi tv:ssä vielä monta , monta kertaa , mutta aivan toisenlaisissa merkeissä .	Profiilimme	0	1
Maija hyppi veden pois korvastaan .	korvastaan	4	3
Käy säännöllisesti hammaslääkärilläsi poistamassa jo muodostunut hammaskivi .	hammaslääkärilläsi	2	2
Hän pitää rusinoista , kuorettomista nakeista , pianoista , hiuksistani ( ehkä ) , kukkien kastelemisesta , hyvinä päivinä töistään , karttapallosta , lapsistaan , koivuista , lämpimästä vedestä , maksalaatikosta , antiikkisista kynttilänjaloista , keltaisesta ja pihlajakaramelleista .	hiuksistani	9	1
Mikäli ette ole paikalla , kun huoneistonne patteriventtiilejä säädetään , avaa huoltomies asentajalle oven tai ovenavaus järjestetään muutoin .	huoneistonne	6	2
Luulin sinua ystäväkseni .	ystäväkseni	2	1
Sen vuoksi aiomme äänestää mietintönne kohdalla tyhjää .	mietintönne	4	2
Siinä vastustajamme ASS oli parempi ja vei pelin numeroin 8-9 .	vastustajamme	1	1
Osansa talven 1956 Kekkosen kannattajien loanheitosta sai myös SDP:n presidenttiehdokas K. A. Fagerholm .	Osansa	0	3
” Jos esimerkiksi Turkuun perustettaisiin uusi yksikkö , se tulisi erikoistumaan johonkin tiettyyn toimintamme alueeseen . ”	toimintamme	13	1
mä kuunteli iham mielelläni ku se kertoili niitä juttujaa että mitä kaikkee sitä on sit ollukki et .	juttujaa	8	3
