Baghíra sa popod fúzy usmial .	fúzy	3	Plur
Mal na sebe dlhý čierny kabát .	kabát	5	Sing
Sporenie prostredníctvom individuálnych účtov vytvorí priestor , aby v budúcnosti o čase svojho odchodu do dôchodku mohol rozhodovať sám občan .	účtov	3	Plur
Tentoraz by mohol pripomenúť pamiatku súdruha Ogilvyho .	pamiatku	4	Sing
Rodinka prašivých túlavých psov zaliezla od strachu pod haldu kobercov .	haldu	8	Sing
Ešte mu v ušiach znel smiech a potlesk divákov .	potlesk	7	Sing
Jeho základnými zložkami budú školy odborného výcviku , poddôstojnícka akadémia a akadémia obrany .	akadémia	11	Sing
Jednostaj prichádzali a odchádzali všakovakí väzni : distribútori drog , zlodeji , banditi , šmelinári , opilci , prostitútky .	opilci	16	Plur
Na ôsmich tenkých chlpatých nohách spočívalo nemotorné telo a na ňom trónila malá hlava .	hlava	13	Sing
Nakoniec si urobila z nosidiel trampolínu , začala skákať kotrmelce a nosidlá tak rozhojdala , že ich včielky sotva udržali .	nosidlá	11	Plur
Ide o unifikáciu .	unifikáciu	2	Sing
Čudné veci rozprávala Petronila o ľuďoch .	ľuďoch	5	Plur
Bronzová čaša , zdobená rúčkou s vtáčikom pripomína uctievanie vtákov u ugrofínskych národov — ak karelský poľovník zabil vtáka čakalo ho nešťastie .	vtákov	9	Plur
Posledný szabolcsský kánon , ktorý sa venuje kláštornému životu nariaďuje opátom a mníchom , aby sa nezúčastňovali na kalendových sedeniach , ale aby prijímali oblácie ich účastníkov v kláštoroch .	mníchom	12	Plur
Voš žijúca v lone vystúpi nahor , na krk , voš z vlasov sa spustí dolu , na líce .	vlasov	12	Plur
Počula som tikanie nástenných hodín a vlastný dych .	tikanie	2	Sing
Je na dva zámky .	zámky	3	Plur
Jednostaj prichádzali a odchádzali všakovakí väzni : distribútori drog , zlodeji , banditi , šmelinári , opilci , prostitútky .	distribútori	7	Plur
Výlet konfirmandov I . ročníka na Kráľovu hoľu 19 . 6 . 2004	konfirmandov	1	Plur
Pred dvermi sa objavovali košíky s prekrásnymi plodmi od výmyslu sveta .	dvermi	1	Plur
Ak drží grifon v pazúroch štyri púčky , vyjadruje sa tým jeho všadeprítomnosť .	pazúroch	4	Plur
Zvončeky popadali na zem ako vodopád .	Zvončeky	0	Plur
Čakala v sále .	sále	2	Sing
Boli to facky od mojich postáv .	postáv	5	Plur
Každá od neho však utiekla , pretože len čo otvoril ústa , ovalil ich zápach cesnaku a syra .	syra	17	Sing
V ľudských obydliach je veľa okien .	obydliach	2	Plur
Priplietol sa tam iný blázon : Plné gate .	gate	7	Plur
A v ustriciach sú perly .	perly	4	Plur
Gregor VII . , aby toto presvedčenie ešte zdôraznil a aby mohol vyžadovať poslušnosť od uhorských kráľov , vytvoril konštrukciu o Štefanovom komendovaní krajiny sv . Petrovi .	presvedčenie	6	Sing
Mohutná posteľ pri okne bola zastlaná dotrhanými prikrývkami a na poduške chýbala obliečka .	prikrývkami	7	Plur
Pozrela som na hodinky a zmocnili sa ma obavy .	hodinky	3	Plur
Na druhej strane niektoré slová poukazovali úprimne a s pohŕdaním na skutočný charakter oceánskej spoločnosti .	pohŕdaním	9	Sing
Zároveň však Cluny urobilo veľký krok na ceste k libertas , lebo vytvorilo spoločenstvo ( zväčša ) úplne slobodných kláštorov , ktoré nepodliehali laikom .	laikom	23	Plur
Lulu , ošetrovateľka v ZOO pre mláďatká , zvieratká ľúbila .	zvieratká	8	Plur
Keď preberal znova volant , prikryl mi ruky , ktoré ostali naspodu .	volant	3	Sing
Včeliu kráľovnú chcem živú .	kráľovnú	1	Sing
Ale ja som nevedel , že by zomrel niekto z domu .	domu	10	Sing
Mám kŕčové žily a päť umelých zubov . "	žily	2	Plur
Zachvátil ma jeden z mojich depresívnych stavov a prepadol som sa do hlbín absurdnosti .	absurdnosti	13	Sing
Uspokojil sa aj so zvyškami .	zvyškami	4	Plur
Zúčastnili sa jej aj chovanci ústavu .	chovanci	4	Plur
Vláda urýchli liberalizáciu trhu a vytvorí konkurenčné prostredie v energetike .	trhu	3	Sing
Podchvíľou naňho ukradomky pozriem bez toho , aby som pohla hlavou .	hlavou	10	Sing
Niekto z mojich niekdajších šéfov , vedúcich kádrového oddelenia alebo veliteľov na vojenských cvičeniach .	veliteľov	10	Plur
Dosadzovanie duchovných do úradov laikmi bolo bežnou praxou raného stredoveku .	laikmi	4	Plur
“ Mrzí ma to , “ vyhlásil Vilko , “ ale Kurt nie je nijaká osa ! “	osa	15	Sing
Vonku sa ozýval bzukot a cvrlikanie , všade poletovali motýle a slniečko krásne prehrievalo zem .	slniečko	11	Sing
Nemeckí nacisti a ruskí komunisti .	komunisti	4	Plur
Potom som oči otvorila a ponorená v tme som smerovala k odrazu mesiaca .	odrazu	11	Sing
Pojem slavico - bohemicus zo začiatku XVIII . storočia je začiatok pojmu česko ( - ) slovenský .	začiatok	10	Sing
O ' Brienov sluha ich však oboch vpustil dnu bez jediného protestu .	sluha	3	Sing
“ Čo sa s tebou deje , Amy ? “ vypytoval sa ma po pretekoch tréner August a odviedol ma nabok , kým ostatní nastupovali do autobusu .	pretekoch	14	Plur
A pred očami sa mi zjavila Lorina tvár .	tvár	7	Sing
Vydesený som si sadol do prvej lavice .	lavice	6	Sing
Ide opäť o prívesky — amulety .	prívesky	3	Plur
V druhej ruke držala zelené jabĺčko .	ruke	2	Sing
Košičanov vítali v Trnave kamene	kamene	4	Plur
Vláda bude pokračovať v transformácii železníc .	transformácii	4	Sing
S očividným uspokojením dokázal rozprávať o náletoch vrtuľníkov na nepriateľské dediny , o procesoch s ideozločincami , o ich priznaniach a o popravách v katakombách Ministerstva lásky .	dediny	10	Plur
Epizóda s uštipnutou ženou je pravdivá .	Epizóda	0	Sing
Takáto interpretácia stvorenia človeka diablom je zjednodušením .	človeka	3	Sing
Lavdima Lavdoshaja zaraďovali k príslušníkom konzervatívneho krídla .	príslušníkom	4	Plur
Keby som dal tie texty Deline , pochopila by , že ich stredobodom je ona .	texty	4	Plur
Šance na zachovanie výsledkov tunajších reforiem boli lepšie ako v Dolnom Lotrinsku , lebo tieto reformné strediská požívali citeľnú podporu svetskej aristokracie .	Šance	0	Plur
Vzápätí sa zjavila svetlovlasá hlávka a nakoniec sa z kvetu vynorilo drobučké stvorenie .	stvorenie	12	Sing
Tentoraz mu ju však pripomenula najmä dusná horúčava toho popoludnia , keď mu na čele vyrazili kropaje potu .	popoludnia	9	Sing
Ariela sa zachytila na skale .	skale	4	Sing
Veľká noc 2004 a dejinné udalosti	udalosti	5	Plur
STROMBOLI NEVERIL VLASTNÝM OČIAM , keď pred sebou zbadal dreveného panáčika .	OČIAM	3	Plur
Ide v nich napospol o reglementovanie podmienok azylu pre zlodejov , ktorí utečú do kostolov .	reglementovanie	5	Sing
Netrvalo dlho , a policajti prišli do kaviarne zatknúť zlodeja .	policajti	4	Plur
Konkrétnym príspevkom k prevencii konfliktov a k udržaniu mieru bude aj naďalej aktívna účasť v medzinárodných mierových operáciách .	operáciách	17	Plur
Bratovi farárovi prajeme v tejto funkcii múdrosť , vytrvalosť a Božie vedenie .	farárovi	1	Sing
Lulu tigra najprv prekvapene sledovala , ale po chvíli sa rozosmiala .	tigra	1	Sing
Toto spoločenstvo nám poskytlo hlboké zážitky , mnoho podnetov na zamyslenie , mnoho motivácie k modlitbám a pocit Božej prítomnosti .	zážitky	5	Plur
Vyzerala ako cievka nití .	cievka	2	Sing
Keď preberal znova volant , prikryl mi ruky , ktoré ostali naspodu .	ruky	7	Plur
Ani jej strýko nie je veľmi na beletriu .	beletriu	7	Sing
Prítomnosť nálezov kačacích príveskov sa vysvetľuje tiež importom zo Škandinávie , prostredníctvom nápodoby laponských a karelských kovolejárov .	nápodoby	12	Sing
Krútiace sa duše mŕtvych stiahli pána podsvetia medzi seba .	podsvetia	6	Sing
Od tejto chvíle si môžete ľubovoľne vytvárať fotoalbumy s neobmedzeným počtom fotiek .	fotoalbumy	7	Plur
Boli tam mravce , lykožrút Fridolín s Buchtou , aj rodinka ploštíc .	mravce	2	Plur
Sme nepriatelia Strany .	nepriatelia	1	Plur
Pritisla sa mi tam tvár Dolory .	tvár	4	Sing
Prúd mojej energie sa jej vylial na prsia .	Prúd	0	Sing
Stiahli si zo seba šaty a vliezli do mohutnej mahagónovej postele .	šaty	4	Plur
Sudcovia sa sa celkom priklonili na jej stranu .	Sudcovia	0	Plur
O malú chvíľočku si na Mauglího miesto sadla iná opica .	opica	9	Sing
Pri raňajkách som mame vyrozprávala ten sen .	mame	3	Sing
Štúrovský nový slovenský spisovný jazyk má niekoľko vrstiev .	vrstiev	7	Plur
“ Ešte si to rozmyslím , “ zahučal obor , ale už sa knísal nepriateľovi v ústrety .	obor	8	Sing
Každá štvrť mala svojich bláznov .	štvrť	1	Sing
Dosadzovanie duchovných do úradov laikmi bolo bežnou praxou raného stredoveku .	duchovných	1	Plur
Vláda vytvorí legislatívne , administratívne a kontrolné mechanizmy pre efektívne čerpanie zdrojov z fondov EÚ .	fondov	13	Plur
Mladým včielkam pripadal dážď spočiatku zábavný .	včielkam	1	Plur
Hľadel jej do tváre zo vzdialenosti niekoľkých krokov .	krokov	7	Plur
Veď je to cesta plná rôznych prekážok , zvodov a pokušení .	prekážok	6	Plur
V prúde krvi a slín mu z úst vypadli dve polovice zubnej protézy .	slín	4	Plur
Na obidvoch stranách ulice , kde sa chodci náhlili po chodníkoch , parkovali autá .	chodníkoch	10	Plur
Abuov citlivý noštek vykrúcalo od najodpornejších pachov a jeho jemné ušká urážalo nedôstojné pokrikovanie .	pachov	6	Plur
" Ste pripravení obetovať svoje životy ? "	životy	5	Plur
Na tomto mieste sa niť mojich úvah zamotala .	úvah	6	Plur
Proces optimalizácie a scivilňovania štruktúr rezortu ministerstva bude pokračovať .	Proces	0	Sing
Po rokom 1044 sa nachádza správa o narodení Vseslava , ktorému matka na radu volchvov uviazala amulet , spôsobiaci že z chlapca vyrástol krutý a nemilosrdný človek .	narodení	7	Sing
Raz si u mňa zabudol baseballovú čiapku .	čiapku	6	Sing
Vzápätí sa ozvalo ďalšie hop a koník sedel oproti Maji .	koník	6	Sing
Okolo nás pulzovala noc a ozývali sa známe zvuky okolia : tlmený hukot čerpadiel v okolitých bazénoch .	zvuky	8	Plur
Pred mojím duševným zrakom sa čosi zablyslo .	zrakom	3	Sing
Chlapci sa smiali , keď mocný pirát napol svaly na ruke , až sa mu na ramene zachvel vytetovaný pirátsky znak ‐ lebka so skríženými hnátmi .	pirát	6	Sing
Podišla som ku kuchynskej doske a zapla rádio .	doske	4	Sing
Jeho obaja starší bratia išli do škôl a Ferda mal prevziať obchod .	škôl	6	Plur
Gaston od úžasu onemel , keď uvidel , ako Bela cvála na koni cez kamenný most .	most	15	Sing
Ich vedúca im čosi nahlas rozprávala v ich jazyku .	vedúca	1	Sing
Z televíznych obrazoviek zaznievala tuctová hudba .	obrazoviek	2	Plur
Cieľom rekodifikácie trestného práva bude prísnejší postih páchateľov násilných trestných činov a moderný trestný proces , ktorý bude rýchly a efektívny .	páchateľov	7	Plur
“ Musíte tam vletieť , “ radila Petronila s plnými ústami .	ústami	10	Plur
Winston sa začal obliekať pomalými , strnulými pohybmi .	pohybmi	7	Plur
Týchto ľudí , ktorí pochádzali zo strednej triedy zamestnancov a z vyšších vrstiev robotníckej triedy , sformoval a zoradil jalový svet zmonopolizovaného priemyslu a scentralizovanej vlády .	priemyslu	22	Sing
Obrovský panter zdvihol košík a opatrne ho položil na breh .	panter	1	Sing
Po celý čas som sa díval smerom k osvetlenému pásmu , kde sa zástup žien tlačil pred skleným priečelím obchodu .	obchodu	19	Sing
Flip zvolal obyvateľov lúčky , aby sa prišli s kamarátom rozlúčiť .	kamarátom	9	Sing
Moja myseľ opäť postrehla akúsi súvislosť medzi autom a týmito dvoma mužmi .	súvislosť	5	Sing
“ Mami ! “ zvolala som .	Mami	1	Sing
Vláda predloží zákon o zdravotníckych povolaniach a zariadeniach definujúci úlohy poskytovateľov a zdravotníckych pracovníkov .	poskytovateľov	10	Plur
Rovnako pri dodaní či vyzdvihnutí fotografií ste ušetrení od úmorného vyčkávania v rade .	fotografií	5	Plur
Na obzore sa objavil čierny bod a ja som si pomyslela , že je to nejaký chrobák .	chrobák	16	Sing
Svätojánske mušky , lienky a niekoľko včiel sedelo alebo ležalo na dlážke a smutne vyčkávalo na svoj osud .	lienky	3	Plur
Svedčí o tom podobnosť pečatí č . 4 a 5 s pečaťami č . 6 až 9 patriacimi Izjaslavovým bratom Svjatopolkovi a Vsevolodovi .	podobnosť	3	Sing
Keď Shannon otvorila dvere , sprisahanecky ma objal okolo pliec a vliezol na zadné sedadlo .	dvere	3	Plur
V skutočnosti sa vyplácali iba malé sumy a výhercovia veľkých výhier neexistovali .	výhier	10	Plur
Mohlo byť len zo stromu , do ktorého sa zaťalo sekerou so zatvorenými očami .	očami	13	Plur
Ťava sa potkla o voz a všetky granátové jabĺčka popadali na zem .	jabĺčka	8	Plur
u Martina nemám čo do zvonca .	zvonca	5	Sing
A preto môže za všetky nehody on .	nehody	5	Plur
Jej vládcov nespájajú pokrvné zväzky , ale príslušnosť k spoločnému učeniu .	vládcov	1	Plur
Vtom som si uvedomila , že na druhý deň máme preteky .	preteky	10	Plur
Potom začali preteky so zaujímavými prekážkami , ktoré vymyslel Rudko .	preteky	2	Plur
Winston počul v hlave klokotanie krvi .	hlave	3	Sing
A tu i tam pre nejaký scenár .	scenár	6	Sing
Keď práve nemala v ústach štipec na bielizeň , mohutným kontraaltom spievala :	bielizeň	7	Sing
Podľa Irminých pokynov – samotná Irma vybavovala všelijaké formality – ma poprosili , aby som odišiel z domu a vrátil sa podľa možnosti až večer .	formality	8	Plur
“ Má ťažký otras mozgu , “ určila sestra diagnózu .	otras	3	Sing
Bola to kvapôčka rosy , ktorá sa v noci vytvorila na kvete .	rosy	3	Sing
Prísnosť uhorských „ protialkoholických “ kánonov a aj ich početnosť svedčia o Kolomanovej snahe vykoreniť z klerických kruhov neduh nadmerného požívania alkoholu .	kruhov	17	Plur
“ Správne , “ odvetil Džafar so zlovestným úškrnom .	úškrnom	8	Sing
Jasajúci diváci ho odniesli na pleciach domov .	pleciach	5	Plur
Títo Sosolci tiahnú proti Rusom , plienia ruský oporný bod Jurjev a útočia na Pskov .	Sosolci	1	Plur
. . . MÔJ PRIMÁRNY ZÁUJEM BOLI HUMANIÓRA .	HUMANIÓRA	7	Plur
Zamieril som k činžiaku .	činžiaku	3	Sing
Navyše technológia našich tlačiarní sa ani dnes veľmi neodlišuje od technológie z čias Gutenberga .	technológie	10	Sing
Potom sa návštevník obrátil k rámu , kde bol otec .	rámu	5	Sing
Nehovoriac o tom , že popoludní mávala stále program , chodila na súkromné hodiny angličtiny .	hodiny	13	Plur
Na rube sa nachádza postava vcelku s vladárskou korunou , kopiou a štítom , obkolesená zrkadlovým gréckym nápisom „ Dimitrij “ .	rube	1	Sing
Maja s Vilkom poprisili o kúsok smrčka a statočne ho prežúvali , len aby sa zavďačili hostiteľovi .	kúsok	5	Sing
Ministerstvo mieru sa zaoberá vojnou , Ministerstvo pravdy lžami , Ministerstvo lásky mučením a Ministerstvo hojnosti hladomorom .	lžami	8	Plur
Potom vložila ten lístok do zásuvky , vytiahla z nej kľúč s ťažkým bronzovým štítkom , na ktorom bolo číslo izby , a strčila mi ho do ruky .	kľúč	10	Sing
Aj ona sa mi zahľadela do očí .	očí	6	Plur
Jazmína si sadla na kraj fontány .	kraj	4	Sing
V lete 1948 v Prahe zažiadal o zahraničné štipendium .	štipendium	8	Sing
Jednu z tých , aké nevyvolajú reakciu v podobe telefonátov zhora .	podobe	8	Sing
Povedal som jej „ boľšoje spasibo “ a pobral som sa na koniec chodby , kde bola moja izba .	izba	18	Sing
Hodiny a hodiny zabíjam vylepovaním tých ich gebuzín po celom Londýne .	gebuzín	7	Plur
Cítila som , aké má teplé dlane .	dlane	6	Plur
Sláva a bohatstvo	Sláva	0	Sing
/ Vypitie čaše vína na schodisku chrámu pripomína obrady pohanských kolektívnych hostín , tzv . „ bratčín “ .	obrady	8	Plur
Na stole ležala strieborná tabatierka .	stole	1	Sing
Ide o autografy Kosťu a Vojatu so schematicky načrtnutými krížmi .	krížmi	9	Plur
Vonku sa ozýval bzukot a cvrlikanie , všade poletovali motýle a slniečko krásne prehrievalo zem .	motýle	9	Plur
V kapitole o Novgorode sme už rozobrali súvis tzv . Najstaršej Pravdy s protivarjažskými nepokojmi .	nepokojmi	14	Plur
Bola to tmavovláska .	tmavovláska	2	Sing
Z druhého konca dlhej , jasne osvetlenej chodby sa k nemu blížila osamelá postava .	chodby	7	Sing
Opustená strecha , kde bývali , bola na severe od trhoviska .	severe	8	Sing
Oblievala ma smrteľná hrôza a trepal som nohami zo všetkých síl .	nohami	7	Plur
Steny mojej lebky zaduneli .	Steny	0	Plur
Po dlhom období dažďov vykúklo opäť slniečko .	slniečko	6	Sing
“ Nemôžem žiť tvoj život , mami , “ šepkala som .	mami	6	Sing
Môže ísť o toporčeky s predĺženým poriskom , ktoré boli v Škandinávií predmetom symbolizujúcim hromy vrhajúceho Thora .	toporčeky	3	Plur
Vláda bude pri všetkých reformách venovať osobitnú pozornosť tomu , do akej miery navrhované zmeny prispievajú k zníženiu nezamestnanosti a finančnej náročnosti pre daňovníkov a k posilňovaniu motivácie hľadať prácu .	zníženiu	17	Sing
Česko - slovenské kultúrne kontinuum	kontinuum	4	Sing
Abu pokrčil plecami .	plecami	2	Plur
Miera tejto viny sa ďalej stupňuje s hlúposťami z fascikla číslo 3 .	hlúposťami	7	Plur
Okamžite vzlietla nad miesto nešťastia , kde topiace sa mravce zúfalo kričali o pomoc .	mravce	9	Plur
Reforma ozbrojených síl	Reforma	0	Sing
Fajčila cigaretu a čítala noviny .	noviny	4	Plur
Naki potrebovala nové barle .	barle	3	Plur
Mal pocit , že ho v žalúdku páli oheň .	oheň	8	Sing
Lietal po poli a vyhrýzal zrniečka .	zrniečka	5	Plur
Takýmito duchmi môžu byť medvede , vlky , zajace , jelene , kačky , orly , sovy a vrany .	sovy	16	Plur
Potom som oči otvorila a ponorená v tme som smerovala k odrazu mesiaca .	mesiaca	12	Sing
Sopky vreli , vyčíňali búrky a zemetrasenia , svet bol plný zmätku a veľkého zdesenia .	zemetrasenia	6	Plur
S hrôzou som otvoril oči : zvonil telefón .	telefón	7	Sing
Hefaistos kul rýchlo blesky , ktoré bohom slúžili ako zbrane .	zbrane	9	Plur
Ona ustúpila dozadu , otočila sa mu chrbtom , ale ten chlap zostal pri zástupe žien .	žien	15	Plur
Tkali od rána do večera .	rána	2	Sing
Začervenala som sa , ale s úsmevom som pokrčila plecami .	plecami	9	Plur
Veď je to cesta plná rôznych prekážok , zvodov a pokušení .	zvodov	8	Plur
Jeden z nich si sadol do vedľajšieho kresla .	kresla	7	Sing
Napriek tomu Syme odhalil uňho niečo ako nedostatok nadšenia .	nadšenia	8	Sing
A tak bocian polámal ľan zobákom .	ľan	4	Sing
Zrejme uplynuli týždne a mesiace .	týždne	2	Plur
Bez slova a bez pozdravu Martin odišiel , ticho zatvoril za sebou dvere .	dvere	12	Plur
Tentoraz mu ju však pripomenula najmä dusná horúčava toho popoludnia , keď mu na čele vyrazili kropaje potu .	popoludnia	9	Sing
V oldspeaku sa tomu celkom priamo vraví ' ovládanie reality ' .	reality	9	Sing
Prísny , spravodlivý a efektívny výber daní a odvodov bude jedným zo základných predpokladov znižovania ich sadzieb .	predpokladov	13	Plur
Zväčša to boli obyčajní zločinci , ale našla sa tam aj hŕstka politických väzňov .	hŕstka	11	Sing
Napriek maminým radám som pil .	radám	2	Plur
Pani Parsonsová priniesla kľúč na matice .	kľúč	3	Sing
Tu sú niektoré súhrnné údaje .	údaje	4	Plur
Zazrel bielko okolo dúhoviek Júliiných očí .	očí	5	Plur
Predal mi ich za cenu , aká bola uvedená na novinách .	novinách	10	Plur
lež ' aj po rokoch pri tej spomienke	spomienke	7	Sing
Prehľadal som vrecká na všetkých sakách a vo vnútornom vrecku jedného z kabátov som našiel fotografiu ženy .	vrecká	2	Plur
Rozhodila rukami .	rukami	1	Plur
Makulienka a motýľ Emanuel sklopili zrak .	zrak	5	Sing
Ministerstvo lásky nemalo okná .	Ministerstvo	0	Sing
Bola som hrdá na to , čo som za posledné týždne dokázala a chcela som sa s ním o tú radosť podeliť .	radosť	20	Sing
Pripisovala vinu mne .	vinu	1	Sing
Zrejme padla na poranenú ruku .	ruku	4	Sing
V ranoarpádovských zákonníkoch nachádzame aj ustanovenia o Božích súdoch , iracionálnom dôkaznom prostriedku , ktorý sa v stredovekom súdnom konaní hojne aplikoval .	zákonníkoch	2	Plur
To sú moji rodičia , povedala .	rodičia	3	Plur
Trendy regionálneho rozvoja vo vyspelých štátoch sú založené na využití vnútorných zdrojov regiónu .	regiónu	12	Sing
Považovala to za skvost vtipnosti a s potešením ho vzala do náručia .	vtipnosti	4	Sing
Pozrela som na hodinky .	hodinky	3	Plur
Náhradné batérie a aspoň jedna rezervná žiarovka by mali byť samozrejmosťou .	batérie	1	Plur
Po kráľovskej hostine , na ktorú mravce priniesli obrie porcie špagiet s voškovou omáčkou , si všetci políhali na slniečko , aby si oddýchli .	omáčkou	13	Sing
Vláda bude nasledovať tieto trendy .	trendy	4	Plur
Heather mu niečo zašepkala do ucha .	ucha	5	Sing
“ Ale veď sú ako dobrí priatelia , “ namietala som .	priatelia	6	Plur
Zakrátko bola unavená noha ‐ kontrabas v najlepšom poriadku .	kontrabas	5	Sing
Po vypnutí obrazovky nastalo v miestnosti hrobové ticho .	ticho	7	Sing
Zapojte sa aktívne do zborového života , príjmite pozvanie mládeže , navštevujte tento chrám , prichádzajte k Večeri Pánovej .	mládeže	9	Sing
Vláda upraví rámcové podmienky regionálneho rozvoja decentralizáciou verejných financií a zavedie nový , efektívnejší systém finančného vyrovnávania sociálno - ekonomických rozdielov vyšších územných celkov .	rozdielov	20	Plur
Recepčné sa podujali objednať taxík a zobudiť ma , kedy uznám za vhodné .	Recepčné	0	Plur
Postupne sa zdvíhanie a klesanie ich hrudí spomalilo a prešlo do normálneho rytmu a s príjemným pocitom bezmocnosti sa od seba oddelili .	bezmocnosti	17	Sing
Veselo sa prechádzali medzi hosťami , usmievali sa a povzbudzovali ich , aby sa u nich cítili ako doma .	hosťami	4	Plur
Maju pochytila ukrutná zlosť .	Maju	0	Sing
Miestne vymedzenie .	vymedzenie	1	Sing
Z okienok v plástoch vykuli rozospaté včelie hlávky .	okienok	1	Plur
O chvíľu zaspalo .	chvíľu	1	Sing
V skutočnosti sa vyplácali iba malé sumy a výhercovia veľkých výhier neexistovali .	sumy	6	Plur
“ Radšej choďte na večeru ku Kojotovi , “ pokračovala Shannon .	večeru	4	Sing
Vláda prijme opatrenia , ktoré zabránia možnosti subjektívneho rozhodovania štátneho zamestnanca vo všetkých oblastiach podnikania .	podnikania	14	Sing
Dobrovoľníci z rôznych organizácií pripravili bohatý program : divadelné , umelecké a hudobné dielne aj súťaže .	Dobrovoľníci	0	Plur
Ten medailón patril mojej mame .	medailón	1	Sing
“ Ľudské mláďa musí v záujme bezpečia odísť . “	bezpečia	6	Sing
Vláda bude preto v tomto volebnom období osobitne dbať na schopnosť komunikácie , výcvik , vyzbrojenie , zabezpečenie strategickej prepravy a udržateľnosť špeciálnych jednotiek rýchlej reakcie .	udržateľnosť	21	Sing
Scenár : Adam Rifkin , Gavin Scott	Scenár	0	Sing
Vláda vytvorí legislatívne , administratívne a kontrolné mechanizmy pre efektívne čerpanie zdrojov z fondov EÚ .	mechanizmy	7	Plur
V dvanástom storočí spolu s Vladimírom Zaleským zatienila Rostov a usilovala sa o kolonizáciu severovýchodných území .	kolonizáciu	13	Sing
O kulte jaštera svedčia už spomenuté rúčky čiaš .	čiaš	7	Plur
Zavedieme stanovenie základných štandardov na financovanie a kvalitu sociálnych služieb , systém udeľovania licencií a kontroly , zrovnoprávnenie pre všetky inštitúcie poskytujúce sociálne služby .	inštitúcie	20	Plur
Na hrebeni sa otočil a zaparkoval autom celkom pri okraji cesty .	autom	6	Sing
Mama vošla do izby mlčky .	Mama	0	Sing
Predkladaná publikácia je doplneným a čiastočne prepracovaným textom dizertačnej práce , ktorú som v odbore Všeobecné dejiny obhájil na jar roku 2000 na pôde Filozofickej fakulty Univerzity Komenského v Bratislave .	dejiny	16	Plur
Prečo by vlastne tí mimozemšťania mali byť naši priatelia alebo nepriatelia , keď sa vyvíjali s úplne iným backgroundom , v inom kontexte , majú totálne iný spôsob dorozumievania , ich ciele a motivácie nechápeme ?	mimozemšťania	4	Plur
Kasandra preto vyslala včielky popoludní na pole , aby nazbierali kukuricu .	kukuricu	10	Sing
Dievčina sa usadila .	Dievčina	0	Sing
“ Anita a ten jej nepodarený Beethoven s fajkou v ústach !	ústach	10	Plur
Prehľadal som vrecká na všetkých sakách a vo vnútornom vrecku jedného z kabátov som našiel fotografiu ženy .	kabátov	12	Plur
Zbehom a pútnikom vo filmoch a knihách trvá návrat do rodnej obce neraz celé desaťročia .	desaťročia	14	Plur
Zároveň navrhne zákonné riešenie ochrany práv detí .	práv	5	Plur
Hra na hudobné nástroje , vozy ako prostriedok na prekonávanie vzdialeností by mohli svedčiť i o narážke na potulných hudcov ‐ igricov , ktorí sú chápaní v celoeurópskom kontexte ako elementy , rušiace zabehaný poriadok .	poriadok	34	Sing
Vláda sa zároveň zaväzuje presadiť v zdravotníctve tvrdé rozpočtové obmedzenie tak , aby od roku 2004 nedochádzalo k tvorbe nového dlhu .	obmedzenie	9	Sing
Dobre som vedela , čoho sa tá dôvera týka .	dôvera	7	Sing
Keď vystúpila z pásma žltkastého svitu a na chvíľu zastala na rozhraní medzi svetlom a temnotou , nemyslel som na to , že ide priamo ku mne , aby napravila chybnú interpretáciu vecí , ktorú vyprodukoval môj mozog .	rozhraní	11	Sing
Zvonka sa ozývalo čoraz viac nespokojencov .	nespokojencov	5	Plur
Súčasné ľudské poznanie je na veľmi vysokej úrovni , stojí na prahu klonovania nového života .	úrovni	7	Sing
A Emanuel od žiarlivosti spadol z margarétky .	margarétky	6	Sing
V učebniciach dejepisu stojí , že život pred Revolúciou bol celkom iný , ako je dnes .	dejepisu	2	Sing
Do hrdinského zápasu o dva litre mlieka som sa zapojil , keď sa narodil Tom .	litre	5	Plur
“ Vieš , minulé leto som mal fantastický džob .	džob	8	Sing
Centrom vladimírskych mohýl bolo Pleščejevské jazero , osídlené zmiešaným slovansko ‐ ugrofínskym obyvateľstvom .	mohýl	2	Plur
Ide o ustanovenie o používaní latinčiny v kapitule .	ustanovenie	2	Sing
Zostalo ti deväť , desať , jedenásť zubov .	zubov	7	Plur
Nastolíme po voľbách zmenu - odhalením zbohatlíkov , mafiánov , delikventov , korupčníkov a lobistov pri stálom sledovaní blaha občana .	lobistov	14	Plur
Za veľkými stolmi sedeli princovia a šľachtici .	šľachtici	6	Plur
Vedomie más treba ovplyvňovať len negatívnym spôsobom .	más	1	Plur
Minule sa môj kolega Rado Ondřejíček fejtónovým perom pustil do problému hlupákov medzi nami .	kolega	3	Sing
Zhrozený Pinocchio lomcoval tyčami klietky .	tyčami	3	Plur
Vedela , že Erik s Arielou sa zachytili o cípy jej obrovitej koruny .	cípy	9	Plur
Na stoloch stáli všelijaké fľaštičky a v bankách bublali záhadné tekutiny .	stoloch	1	Plur
Podporíme urýchlenie legislatívneho , inštitucionálneho a administratívneho dobudovania štruktúr potrebných na výkon Spoločnej poľnohospodárskej politiky .	dobudovania	7	Sing
A táto skvelá žena vyšla v mojom prípade navnivoč ako maslo v psej koži .	koži	13	Sing
Sú tam psi ? “ spýtal sa ma , kým sa vyšvihol na múr .	psi	2	Plur
Dva mäkké , tak trochu navlhnuté vankúšiky , prikvačili Winstonovi sluchy .	sluchy	10	Plur
Potom Maja s kamarátmi pomáhala stroskotancom z vody na nové plavidlo .	stroskotancom	5	Plur
Nočné strašidlo , ktoré po nej zúfalo túži .	strašidlo	1	Sing
Zasadalo zborové presbyterstvo	presbyterstvo	2	Sing
Vytvoríme kapitálotvornú vrstvu , ktorá bude zárukou blaha ľudu , presvedčivo hlásal tvorca blaha svojich prívržencov .	vrstvu	2	Sing
Kláštory a ich opáti sú tu podriadení diecéznym biskupom , ktorých povinnosťou je kláštory často vizitovať .	Kláštory	0	Plur
Všetci , ktorých som uvidel , sa teraz premieňali na vši .	vši	10	Plur
Celú noc som ani oko nezažmúril , spal som iba chvíľu nadránom .	oko	4	Sing
Svojím typickým gestom si O ' Brien upravil na nose okuliare .	gestom	2	Sing
Pôvodným povolaním právnik .	povolaním	1	Sing
Po záhrade poletovali mištičky , servítky ba aj stoličky .	mištičky	3	Plur
Všade vládla pohoda .	pohoda	2	Sing
Obrovský vysvietený lunapark s kolotočmi , kľukatými dráhami , hudbou , zábavnými hrami a množstvom vykrikujúcich ľudí .	kolotočmi	4	Plur
Poletím za tebou , “ povedal Vilko , obrátil sa na bok a zaspal .	bok	11	Sing
V meste včiel pri starej striebornej jedli panoval čulý ruch .	včiel	2	Plur
Myšlienka , že sa môžem stať otrokom svojich postáv , mi naháňala hrôzu .	otrokom	6	Sing
Na chvíľu Winston ignoroval ciferník .	ciferník	4	Sing
Je síce pravda , že nijaký súdruh Ogilvy nikdy neexistoval , ale zopár riadkov v tlači a niekoľko vyfabrikovaných fotografií čoskoro splodia jeho existenciu .	súdruh	6	Sing
Na pery .	pery	1	Plur
" Vybudovať civilizáciu na strachu , nenávisti a krutosti nemožno .	civilizáciu	2	Sing
Okno na izbe bolo otvorené , a bol tam zápach .	Okno	0	Sing
Príčiny ochorenia úzko súvisia s nezdravým životným štýlom , svoju významnú úlohu zohrávajú alkohol , fajčenie , nedostatok pohybu , nadváha a obezita , stres , poprípade nedostatok zdravých potravín .	nedostatok	17	Sing
Vláda bude klásť dôraz na racionalizáciu nákladov spojených s realizáciou výkonov vo verejnom záujme v železničnej osobnej doprave a verejnej autobusovej doprave .	doprave	21	Sing
Rád by som v tomto poďakovaní spomenul všetkých , ktorí akoukoľvek radou či pomocou prispeli ku zrodu predkladanej publikácie .	publikácie	18	Sing
A oblial ma studený pot .	pot	4	Sing
O chvíľu sa tam zjavila i Kala .	chvíľu	1	Sing
Namiesto toho spoznala iného , prečudesného spoločníka z čeľade hmyzu .	hmyzu	9	Sing
“ Zlatúšikovia moji , “ nariekala skormútene .	Zlatúšikovia	1	Plur
Všetko prebehlo v tichosti , vedenie fakulty nevydalo nijaké oficiálne vyhlásenie .	tichosti	3	Sing
Aby Irma bola na letisku včas , odišla s dostatočným predstihom .	letisku	4	Sing
Moja trpezlivosť sa vyčerpala , keď ručičky na hodinkách stihli ukázať pol dvanástej a mne sa nikto nevenoval .	ručičky	6	Plur
Vedel som iba jedno : že sa podobám na postavy absurdného divadla .	postavy	9	Plur
Nateraz sa uzavrel pred vzdialenejšími zvukmi a počúval len kvákanie , ktoré sa valilo z obrazovky .	obrazovky	15	Sing
Nenávidím tie hodiny .	hodiny	2	Plur
Ženy aj muži .	muži	2	Plur
Keď sa mi posmievala , zmocňovala sa ma trpká zlosť , napriek tomu medzi nami nedochádzalo k scénam .	scénam	17	Plur
Winston na chvíľu prestal čítal .	chvíľu	2	Sing
Poletíš ponad strieborné jazerá a zurčiace potoky , pod jasným nebom a vysokými zelenými stromami .	jazerá	3	Plur
Polovica z nej nikdy nespoznala topánky .	Polovica	0	Sing
“ PÄŤ TELEFONÁTOV ! “ zvolala som , keď som zbadala , že doma v chodbe bliká svetielko na odkazovači .	svetielko	17	Sing
“ Za krásavicou Veronikou . “	krásavicou	2	Sing
Ordinácia je akt , ktorým kandidát svätenia ( ordinand ) získava istý stupeň svätenia .	svätenia	13	Sing
Straníčky sa nikdy nefarbili .	Straníčky	0	Plur
V ušiach mi zazneli tóny trúby .	tóny	4	Plur
Pinta je predsa polovica štvrtky a štyri štvrtky idú do galóna .	štvrtky	4	Sing
Mauglí pokrútil hlavou a chytil sa neďalekého stromčeka .	stromčeka	7	Sing
Rodinka prašivých túlavých psov zaliezla od strachu pod haldu kobercov .	psov	3	Plur
Šetrí aj pani ministerka financií , ktorá stále nevylučuje ďalšie zvyšovania cien a zodpovednosť za to prenechala na vedúcich úsekov ?	zvyšovania	10	Plur
Jednu z tých , aké nevyvolajú reakciu v podobe telefonátov zhora .	reakciu	6	Sing
V hlbinách zasa mocné morské obludy . “	obludy	5	Plur
Chvíľu tam ležal akoby omráčený , pričom mu z úst a z nosa stekal pruh tmavej krvi .	úst	9	Plur
Jednostaj prichádzali a odchádzali všakovakí väzni : distribútori drog , zlodeji , banditi , šmelinári , opilci , prostitútky .	prostitútky	18	Plur
Tentoraz mu ju však pripomenula najmä dusná horúčava toho popoludnia , keď mu na čele vyrazili kropaje potu .	horúčava	7	Sing
Strážca prižmúril oči a poobzeral sa dookola .	Strážca	0	Sing
Žiaľ , bol priťažký , lebo maškrtil kandizované datle .	datle	8	Plur
Lykožrút Fridolín potom odniesol víťaza medzi jasajúcich divákov .	divákov	7	Plur
Vláda považuje za jednu zo svojich priorít dôslednú reformu súdnictva , posilňovanie vymožiteľnosť práva a zásadnú zmenu v trestnej politike štátu .	priorít	6	Plur
Technologické spracovanie vychádza z ľahkého špeciálneho penového plastu s otvorenými pórmi , ktorý je uzatvorený vo vzduchotesnom obale .	obale	17	Sing
A hrozilo by , že sa stratí čaro našich ľúbostných stretnutí .	čaro	7	Sing
V lese som krok za krôčikom snoril pod krami a pod kameňmi .	krami	8	Plur
Vtedy mi utkveli v pamäti dátumy , mená i dôležité udalosti z minulosti , medzi ktoré bolo neskôr ľahšie dokladať nové dátumy , mená i vzťahy .	mená	23	Plur
Zákon sprehľadní pravidlá pre plnenie úloh prenesených zo štátnej správy na územnú samosprávu a doplní sústavu zákonov týkajúcich sa územnej samosprávy .	úloh	5	Plur
Zavrtela som hlavou , aby som tie myšlienky zahnala .	myšlienky	7	Plur
Chrisova mama zabalila chlebíčky po štyroch do plastovej fólie a ešte do alobalu .	fólie	8	Sing
Hravo obopínal jednou rukou celý Júliin pružný pás .	pás	7	Sing
V 11 storočí však tieto vrstvy , stelesňujúce štátnu moc zastávali postoj výrazne odlišný — čoho najpregnantnejším prejavom bol kódex svetského práva — Ruská Pravda .	prejavom	17	Sing
Len pred dvoma týždňami som ti chcel rozbiť hlavu dlaždicou .	týždňami	3	Plur
Pri každom kine , divadle , klube je aj jeho adresa a telefón .	telefón	12	Sing
Na rube sa nachádza postava vcelku s vladárskou korunou , kopiou a štítom , obkolesená zrkadlovým gréckym nápisom „ Dimitrij “ .	korunou	8	Sing
Chcela som sa spýtať , kde tie chrústy našiel .	chrústy	7	Plur
v prioritných oblastiach verejného záujmu musí byť verejný sektor schopný konkurovať súkromnému sektoru pri získavaní a udržaní kvalitných ľudských zdrojov	získavaní	14	Sing
Myšlienka , že sa môžem stať otrokom svojich postáv , mi naháňala hrôzu .	postáv	8	Plur
Len spomedzi študentov náročnej školy vzídu študenti , ktorí sa dokážu presadiť v silnej konkurencii .	študentov	2	Plur
Práve pripravujem tortu na jej narodeniny .	tortu	2	Sing
A tak sa stalo , že nakoniec som sa na jednej hodine roztriasla , keď som si predstavila niečo strašné : v budúcnosti ma čaká to isté , čo stihlo moju mamu .	mamu	31	Sing
U nás jeme to , čo sa objedná cez donášku alebo mrazené jedlá , “ povedal Chris .	jedlá	12	Plur
Sopky vreli , vyčíňali búrky a zemetrasenia , svet bol plný zmätku a veľkého zdesenia .	búrky	4	Plur
Vláda urýchli a finančne posilní zákonom regulovaný proces vysporiadania vlastníctva pôdy a pripraví komasáciu a proces definitívneho doriešenia vydávania náhradných pozemkov .	vlastníctva	9	Sing
Na tretí deň ráno spratal päť porcií raňajok a spokojne sa ponaťahoval .	raňajok	7	Plur
Bolo to , rozumie sa , pred vojnou .	vojnou	7	Sing
Nakoniec sme priniesli z kuchyne taniere , šalát a fašírku .	kuchyne	4	Sing
Ak Tichomirov vidí v povstaniach iba element sociálny , Frojanov na jeho úkor vyzdvihuje moment politický .	úkor	12	Sing
Ženu zachráni traktorista .	traktorista	2	Sing
Hlavnými aktérmi tohto procesu boli cisár Oto III . a pápež Silvester II .	aktérmi	1	Plur
V oblasti vodného hospodárstva bude vláda legislatívnymi a organizačnými opatreniami zabezpečovať racionalizáciu a efektívnosť pôdohospodárskych činností .	opatreniami	9	Plur
“ Pán Shepherd , “ povedal profesor Tayerle a kývol rukou , “ nemyslite si , že som nevidel lístok , ktorý ste dali pred chvíľou slečne Wyseovej .	slečne	26	Sing
Wilsher , blondiak s nasprostastým výrazom na tvári , ktorého takmer nepoznal , ho s úsmevom pozýval na voľné miesto pri svojom stole .	stole	22	Sing
Na slnku jej telo žiarilo .	slnku	1	Sing
Ďakujem aj jeho manželke za pochopenie , oporu a príklad ich rodiny .	oporu	7	Sing
“ Neviete , že vám piraňa za pár sekúd obžerie všetko mäso ? “	sekúd	8	Plur
Koncepciu Slovenských večerov vymyslel Igor Medlen , vtedajší tajomník Folklórneho festivalu vo Východnej .	večerov	2	Plur
“ To je bláznovstvo .	bláznovstvo	3	Sing
Každé ráno sme sa na mojom balkóne hrali hru na mačku a myš .	balkóne	6	Sing
Záujemcov o šport poteší futbalový turnaj pre dospelých a jazda na koni pre deti .	Záujemcov	0	Plur
A tak sa na Rusi v tomto období stretávame s uctievaním pohanských bohov v novom rúchu .	uctievaním	10	Sing
Ak sa raz oldspeak nahradí , posledné puto s minulosťou sa pretne .	oldspeak	3	Sing
Vzápätí si však vynadala do hlupaní .	hlupaní	5	Plur
Pokrčila plecami a usmiala sa .	plecami	1	Plur
Vzhľadom na vytrvalosť , akú prejavoval , som očakával , že takto zaboduje .	vytrvalosť	2	Sing
V ten večer sme neboli v skalnatej zátoke .	večer	2	Sing
Vláda si uvedomuje výzvy informačného veku .	výzvy	3	Plur
S ktorou krajinou je Oceánia vo vojne ? "	krajinou	2	Sing
Ako sa princ blížil k palácu , Kráľovná zla mu postavila do cesty múr z tŕňových krov .	krov	16	Plur
Dlho som býval v brečtane , ktorý rástol na záhradnom domčeku .	brečtane	4	Sing
Tak je po Jaroslavovom víťazstve položený základ novgorodských výsad , ktorí Novgorodcom garantujú ochranu pred kniežacími družiníkmi a Varjagmi / no zároveň zabezpečujú kniežaciu družinu pred ľudom / .	družiníkmi	16	Plur
V ušiach mi zazneli tóny trúby .	ušiach	1	Plur
Keď Maja začula žalostný nárek muchy , zabudla na strach pred žabami .	žabami	11	Plur
Ale špirála úvah ma vedie k nejasnému záveru .	špirála	1	Sing
Duchovné osoby boli ideálnymi parlamenármi , lebo podľa dobových predstáv majú osobitnú ochranu boha pred nebezpečím .	osoby	1	Plur
Sadla som si vedľa neho a rukami som si objala kolená .	kolená	10	Plur
Nestoja totiž v opozícií voči sebe na rovine ideí a ideológie , ale voči zástupcom orgánov svetských .	orgánov	15	Plur
Ani družka , ani sok ho nesledujú . Čo ho núti vysedávať na konári osamoteného stromu a vyludzovať hudbu do prázdna ?	konári	13	Sing
“ V Aquitare jedia červíky , otec !	červíky	4	Plur
Vzhľadom na dôležitosť kvality verejných zamestnancov a význam osobných nákladov vláda bude pokračovať v reforme verejnej a štátnej služby .	kvality	3	Sing
Ale keď veľký vlk vopchal do košíka ňufák , bábätko sa zasmialo .	vlk	3	Sing
Napokon bola ukonaná aj Maja a od vyčerpania spadla na zem .	vyčerpania	7	Sing
Starcova pamäť bola len kopa bezcenných detailov .	pamäť	1	Sing
V chodbe páchla varená kapusta a staré handrové rohožky .	rohožky	8	Plur
Televízor bol zapnutý , stále nastavený na pornografický kanál .	kanál	8	Sing
Cez kombinézu cítil jej prsníky , zrelé , ale pevné .	prsníky	4	Plur
Netrvalo dlho a obaja lavínu skyprili , takže sa párik cvrčkov ľahko dostal von .	cvrčkov	10	Plur
“ Prv ako som dopovedala , zmocnili sa ma výčitky , že som mala byť inde a venovať sa učeniu .	výčitky	9	Plur
Po prehliadke hudobných skupín sa o zábavu postarajú dídžeji .	dídžeji	8	Plur
Otvorila som oči a mimovoľne som si pošúchala pätu .	pätu	8	Sing
Mal dlhý kabát , zdvihnutý golier , okuliare so strieborným rámom , červenastú tvár a husté šedivé vlasy .	vlasy	17	Plur
Cirkevný trest spočíva v pokání .	pokání	4	Sing
Z Pobaltia pochádzajú náušnice podľa tvaru zvané vlčí zub .	náušnice	3	Plur
Radža je tiger .	tiger	2	Sing
Nasťahovali sme sa sem iba pred štyrmi dňami .	dňami	7	Plur
Natiahla sa k zásuvke na mojej strane a prehŕňala sa v nej , až kým nenašla škatuľku cigariet .	škatuľku	16	Sing
Ďalšou decentralizáciou verejných financií vláda vytvorí na úrovni obcí lepšie podmienky pre napĺňanie miestnej bytovej politiky .	napĺňanie	12	Sing
Nevedomosť je sila	sila	2	Sing
Usilovne cvičila až to uši trhalo .	uši	4	Plur
Považovala to za skvost vtipnosti a s potešením ho vzala do náručia .	náručia	11	Sing
Ten , ktorý pod jagavosť tém hodnú bestsellerov rozostavil pasce , v ktorých uviazol sám .	bestsellerov	7	Plur
Ako uviazla v lekne	lekne	3	Sing
V náručí niesol nákupnú tašku .	tašku	4	Sing
Keď po prižmúrení vytlačil z očí slzy , náhle pocítil hlad .	slzy	6	Plur
Vláda je pritom presvedčená o nevyhnutnosti zavádzať do rezortu pôdohospodárstva , pri rešpektovaní niektorých špecifík , trhové podmienky a slobodnú konkurenciu .	špecifík	14	Plur
To je sabotáž !	sabotáž	2	Sing
Brúsil si na nás zubiská a najradšej by nás zhltol ako malinu .	zubiská	4	Plur
Keď oheň začal slabnúť , drkotali mi zuby .	zuby	7	Plur
Očakávala som niečo iné , ona však nevyslovila jedinú výčitku .	výčitku	9	Sing
Autografy — nápisy obsahujúce predovšetkým meno píšuceho .	Autografy	0	Plur
Nôž by mal minimálne obsahovať : veľkú a malú čepeľ , otvárač na fľaše a konzervy , rydlo , výhodné je , ak obsahuje dierovač , pílku na drevo , vývrtku , pinzetu .	otvárač	11	Sing
Zaletela k nim , sadla na kvet a počúvala tiché zurčanie potoka .	kvet	6	Sing
Snežilo husto , padali veľké vločky .	vločky	5	Plur
Čakal som celé dve hodiny , ale šéf nechodil .	hodiny	4	Plur
Jazmína otvorila dvere .	dvere	2	Plur
Ja som však neznášal huriavk , ktorý robili ľudia čakajúci v radoch .	radoch	11	Plur
Ženské bábky aj mužské bábky .	bábky	4	Plur
Nevyzerám v plavkách smiešne ?	plavkách	2	Plur
Najskôr sa na hornej časti schodišťa objavila drobná starena v širokých nohaviciach .	schodišťa	5	Sing
Alias svietilňa alebo dokonca valcový vreckový elektrický lampáš .	svietilňa	1	Sing
Stoly a stoličky boli prevrhnuté , vázy rozbité a obrazy viseli nakrivo .	vázy	6	Plur
Vláda zabezpečí novelu Zákonníka práce a zákona o verejnej službe tak , aby umožnila individuálnu diferenciáciu miezd a mobilitu zamestnancov v zdravotníckych zariadeniach .	zamestnancov	19	Plur
Vonku zaznel dupot ťažkých čižiem .	čižiem	4	Plur
Avšak rodine malého paviána sa nepáčilo , ako sa Jane správa k ich mláďaťu a nazlostení začali dievčinu prenasledovať .	paviána	3	Sing
Bolo by hanba predstúpiť pred žiakov v takom stave .	žiakov	5	Plur
Sedel na stoličke neprirodzene vzpriamene a jeho mocné prsia sa nadúvali a zachvievali , akoby mal čeliť nárazu vlny .	nárazu	17	Sing
S očividným uspokojením dokázal rozprávať o náletoch vrtuľníkov na nepriateľské dediny , o procesoch s ideozločincami , o ich priznaniach a o popravách v katakombách Ministerstva lásky .	katakombách	24	Plur
Šetrí aj pani ministerka financií , ktorá stále nevylučuje ďalšie zvyšovania cien a zodpovednosť za to prenechala na vedúcich úsekov ?	vedúcich	18	Plur
Jan prichádza do kraja po zvestiach o zabití žien volchvami .	zvestiach	5	Plur
V otrokárskom mravenisku	mravenisku	2	Sing
“ Tu býva jeden môj známy a veľmi rád prijíma návštevy . “	návštevy	10	Plur
Rímski reformátori totiž potrebovali inštrumentárium , prostredníctvom ktorého by zdokladovali oprávnenosť svojich požiadaviek .	reformátori	1	Plur
Rýchlo vyčarila drevený kolovrátok so zradným zeleným vretenom .	vretenom	7	Sing
Márne sa prezliekala , v našej izbe sa vždy našlo niečo , čo smrdelo kravínom .	izbe	6	Sing
Mala na sebe len podprsenku a nohavičky .	podprsenku	4	Sing
Ich vedúca im čosi nahlas rozprávala v ich jazyku .	jazyku	8	Sing
Vláda urýchli a finančne posilní zákonom regulovaný proces vysporiadania vlastníctva pôdy a pripraví komasáciu a proces definitívneho doriešenia vydávania náhradných pozemkov .	zákonom	5	Sing
Niekedy sú moje znamenia klamné . “	znamenia	3	Plur
Poznali ho všetky ženy , vedeli , o čo mu ide .	ženy	3	Plur
Teraz už neboli v znehybnených pózach .	pózach	5	Plur
Mravce dovliekli celý kôš dobrôt , včielky priniesli ovocný medovník a Kasandra jazmínové želé .	dobrôt	4	Plur
Oči jej vystúpili z jamiek a z vyškerených úst vypadali všetky zuby okrem jedného .	zuby	11	Plur
Obaja sme na okamih upreli zrak na pohybujúce sa svetlo .	okamih	3	Sing
Sviečky som vložila do mosadzných svietnikov a postavila ich na stôl .	svietnikov	5	Plur
Džafar oboma rukami schmatol čarodejnú palicu .	rukami	2	Plur
Na okraji Tirany , keď sme prechádzali cez predmestie Lapraka , uviazli sme na križovatke .	predmestie	8	Sing
V prijímacej sieni to vyzeralo , akoby sa tadiaľ prehnala búrka .	sieni	2	Sing
“ Som vandrujúca kobylka a zmeškala som spojenie so svojimi spoločníkmi . “	kobylka	3	Sing
Mešec Aladinovi akosi v ruke oťažel .	ruke	4	Sing
Uložia doň Korine šteniatka .	šteniatka	3	Plur
Napokon sa striga rozhodla , že s morskou vílou skoncuje raz a navždy .	striga	2	Sing
Veľký panter pozorne nastražil uši .	panter	1	Sing
Niečo dopadlo na posteľ za Winstonovým chrbtom .	chrbtom	6	Sing
Na zlepšenie komunikácie s verejnosťou sa zavedú pravidelné stretnutia funkcionárov polície s občanmi .	funkcionárov	9	Plur
Obávam sa , že ocko nedovolí , aby sa mu po paláci potuloval tiger .	ocko	4	Sing
S odporným škrekotom z nej stúpali čarodejné výpary .	výpary	7	Plur
Ariela bola najmilšia dcéra vládcu oceánov a morí .	oceánov	5	Plur
Všetci vedeli , že na papieri sa každý kvartál vyrobili astronomické počty topánok , kým vari polovica obyvateľov Oceánie chodila bosá .	papieri	5	Sing
V oblasti nemocenského poistenia prijme vláda opatrenia zamedzujúce zneužívaniu systému .	poistenia	3	Sing
Dieťa spokojne ležalo a nič nenaznačovalo , že sa vlci chystajú vyjsť z jaskyne .	vlci	9	Plur
Slnečný svit , ktorý prenikal nespočetným lístím , ich ešte stále pálil na tvárach .	tvárach	13	Plur
Keď uplynul tretí deň a ja som sa v ten večer konečne ocitol sám , bol som na pokraji nervového vyčerpania .	večer	10	Sing
Vláda zjednotí sadzby DPH pred vstupom do EÚ .	sadzby	2	Plur
Čoskoro som však zapochybovala o svojom odhodlaní , lebo pred školou ma dobehol Chris a chytil za ruku .	ruku	17	Sing
Vláda predloží zákon o zdravotníckych povolaniach a zariadeniach definujúci úlohy poskytovateľov a zdravotníckych pracovníkov .	pracovníkov	13	Plur
Zavedenie inštitútu manažéra súdu zníži počet funkcionárov súdov , ktorí obmedzene vykonávajú súdnictvo .	funkcionárov	6	Plur
V nasledujúcej chvíli nastal obrovský rozruch .	rozruch	5	Sing
U dovážaných produktov zabezpečí elimináciu tých , ktoré nespĺňajú kritériá kvality a ktoré neprešli colným a daňovým vysporiadaním .	kritériá	9	Plur
Ekonomické a inštitucionálne nástroje	nástroje	3	Plur
Navrhli im , že ak chcú prežiť v nových podmienkach trhového hospodárstva , môžu predávať po tiranských chodníkoch cigarety alebo banány .	chodníkoch	17	Plur
Prvý raz po mnohých rokoch zabudol na všadeprítomnú televíznu obrazovku .	obrazovku	9	Sing
Jej telo akoby doňho prelievalo časť svojej mladosti a elánu .	elánu	9	Sing
Začiatkom 11 storočia bolo pomerne málo významným sídlom — nespomína sa napr . pri delení údelov Vladimírovým synom .	údelov	15	Plur
Vybrala peňaženku a znova ju dala do plecniaka .	peňaženku	1	Sing
Sultán pozrel dcére cez plece .	plece	4	Sing
Napriek všetkému úsiliu sa príbuzným Sergeja Duku nepodarilo zistiť u kompetentných orgánov nijaké podrobnosti .	orgánov	11	Plur
Avšak hoci som sa strácal v tieni režisérov a hviezd filmového plátna , netrápil som sa .	režisérov	7	Plur
Transparenty , manifestácie , heslá , hry , spoločné výlety -- a podobné gebuziny .	gebuziny	13	Plur
Vietor hvízdal v konároch a trápil sporadické , ufúľané krókusy .	konároch	3	Plur
Mnohých som už predtým veľakrát videla na štartovacích blokoch .	blokoch	8	Plur
O nich , ako aj o charakteristike ranoarpádovských zákonníkov a synodálnych uznesení hovoríme konkrétnejšie v samostatných kapitolách .	uznesení	11	Plur
Bolo tu pododdelenie televíznych programov s inžiniermi , producentmi a s celými tímami špeciálne vybraných hercov , lebo dokázali imitovať hlasy .	hercov	15	Plur
Najskôr sa na hornej časti schodišťa objavila drobná starena v širokých nohaviciach .	nohaviciach	11	Plur
Nerovnosť bola cenou za civilizáciu .	civilizáciu	4	Sing
V procese obstarávania bude vláda dbať na transparentný systém nakladania s majetkom štátu .	procese	1	Sing
Dôvodom bol práve nevyriešený problém umiestnenia štyri metre vysokého súsošia sv . Cyrila a Metoda v Komárne .	metre	7	Plur
Moji priatelia dúfali , že sudcovia a Lienka sfúknu zvyšok a ja nebudem potrestaný .	sudcovia	5	Plur
Shannon s Waynom sa hrabali vo vreckách , aby dali dokopy drobáky na prvú pizzu .	drobáky	11	Plur
Zo strachu o seba , pre svoju povýšenú zbabelosť zaprel svojho Majstra a Pána .	zbabelosť	8	Sing
Boli to dvaja muži v civilnom obleku .	muži	3	Plur
Vláda vytvorí legislatívne a ekonomické podmienky pre ochranu a sprístupnenie audiovizuálneho dedičstva v súlade s príslušnými medzinárodnými dohovormi .	dedičstva	11	Sing
Utiekla z paláca pred nekonečným zástupom nápadníkov .	zástupom	5	Sing
V prvej časti kapitoly teda najprv načrtneme ich základný argumentačný potenciál , aby sme mohli v časti druhej pristúpiť k pokusu o vlastnú interpretáciu .	interpretáciu	23	Sing
Delina nebola v Tirane , už dostala umiestenku do profesionálneho divadla v meste Fier .	divadla	10	Sing
Sadol som si k stolu , odkiaľ som mohol sledovať pohyb pred vchodom do televízie Sírius .	stolu	4	Sing
Súžitie etník tu teda fungovalo na princípe spoločenstiev v ktorých jednotlivé zložky popri sebe slobodne existovali a zároveň sa ovplyvňovali , miešali a splývali .	spoločenstiev	7	Plur
Winstonovi sa zapichla do ruky ihla .	ihla	5	Sing
Keď pozrela pod seba , zistila , že uviazla v pavúčej sieti .	sieti	11	Sing
Abu žmúril na ľudské písmo .	písmo	4	Sing
Dvere zamkla znútra na kľúč a cez temnú chodbu – svetlo nebolo zažaté – ma zaviedla do izby , kde sme zastali oproti sebe .	Dvere	0	Plur
“ Ani ja nič nedostanem zadarmo , a teraz si tú háveď pekne odveď ! “	háveď	11	Sing
Našej susedke - záhradkárke sa naše mičurinčenie ale veľmi nepáčilo .	záhradkárke	3	Sing
Hlúpy Gim sa obyčajne zdržiaval pred vchodom do predajne chleba .	vchodom	6	Sing
V obrovských presýpacích hodinách princeznú Jazmínu zatiaľ zasypával piesok .	princeznú	4	Sing
Len čo vošiel dnu , čakali ho tam Kráľovná zla a jej sluhovia .	sluhovia	12	Plur
Sprístupnením informácií o poskytnutých dotáciách výrazne obmedzí priestor pre korupciu a klientelizmus v podpornej politike štátu .	Sprístupnením	0	Sing
Zlá víla vedela , že iba on môže zrušiť kliatbu , ktorou Zorničku zakliala .	kliatbu	9	Sing
Dobre som poznal mená všetkých dobových talianskych spevákov aj všetkých futbalistov .	mená	3	Plur
Zjavilo sa mi vo sne a mne stále znie v ušiach jeho hlas .	ušiach	10	Plur
Letné prázdniny sa chýlili ku koncu .	prázdniny	1	Plur
Komár unudene pozrel do trávy .	trávy	4	Sing
Vtedy začali hasnúť svetlá .	svetlá	3	Plur
So zvyšnými dvoma tretinami som išiel do izby .	izby	7	Sing
Vôbec som im neprotirečil , postupoval som podľa inej taktiky .	taktiky	9	Sing
“ Mala som pocit , že sa vznášam ! “ vravela som mame , keď za mnou pribehla a objala ma .	mame	12	Sing
Len čo som ju uvidel , mal som pocit , že mi pripomína ktorúsi z hrdiniek klasickej ruskej literatúry .	hrdiniek	15	Plur
Na trhovisku ho zarazilo množstvo čudných vecí a kadejakých vôní .	vôní	9	Plur
Svojho času som ich spomínal pri popisovaní nosenia fotografickej tašky na ruksaku .	nosenia	7	Sing
Práve poletovala medzi bielymi jazmínovými kvetmi a nevšimla si jemnulinké a tenulinké vlákna napnuté medzi konárikmi .	konárikmi	15	Plur
Netrvalo dlho a vedľa nej sa pod veľkým černicovým kríkom zjavil tučný svetlohnedý pavúk .	kríkom	9	Sing
" Nemám na mysli priznanie .	priznanie	4	Sing
Pomaly kráčali po dlhom schodišti , ktoré viedlo na strechu , kde bývali , a boli hladní , unavení a veľmi sklamaní .	strechu	9	Sing
Ak nepočítam učebnice , až donedávna jediné knihy , ktoré držala v ruke , boli detské rozprávky .	učebnice	2	Plur
Keď som čítala posledné riadky , myslela som na mamu , ktorá robila zázraky , aby sme dajako vyšli .	riadky	4	Plur
Pred dvermi sa objavovali košíky s prekrásnymi plodmi od výmyslu sveta .	plodmi	7	Plur
Mamu som zbadala na rovine , keď sa na nebi zablyslo a rozľahol sa mocný hrom .	Mamu	0	Sing
Tešila som sa , ale zároveň mi chýbali tie chvíle , keď sme po večierkoch spolu posedeli a rozoberali každý detail .	večierkoch	14	Plur
Mama nazrela do izby , aby sa presvedčila , či spím .	izby	3	Sing
Ja som mal tajne odložené niektoré naše intímnosti .	intímnosti	7	Plur
V prvých troch kapitolách sa teda pokúsime o prieskum problematiky v celoruskom rámci , odhliadnuc od jemnejších miestnych odlišností .	prieskum	8	Sing
Uvedené komplexy sa vyznačujú zmiešaným osídlením Slovanov s inými etnikami a tvrdošijným zachovávaním archaických prežitkov rodového zriadenia , kým mestá sú čisto slovanskými sídlami , určenými na pacifikáciu a christianizáciu kolonizovaných oblastí .	zriadenia	16	Sing
Pri ďalšej skúške vymenila slák za golfovú palicu , takže Klotilda musela kričať a prišla o hlas .	hlas	16	Sing
Voda špliechala o okraje a zamočila ležadlá pri bazéne .	ležadlá	6	Plur
Je to veľmi jednoduché , vysvetlil mi doktor .	doktor	7	Sing
“ A teraz mi zaplať ! “ zhúkol na Jazmínu predavač .	predavač	10	Sing
“ Narušujú morálku našich detí , “ kričal do mikrofónu .	mikrofónu	9	Sing
Potom sa v jednej zákrute objavil ďalší stôl , za ktorým sedeli ďalšie dve ženy .	ženy	14	Plur
Zvieratká odpočívali pred svojimi príbytkami , večerali a popíjali púpavovú šťavu od cikád .	cikád	12	Plur
Kôň sa pásol so sklonenou hlavou a dýchal na Vilka teplo .	Kôň	0	Sing
Pod ním bola na fotografii Cruellina priateľka Anita , jej manžel Roger a ich kuchárka .	kuchárka	14	Sing
Vrátila mi hárky s poviedkou .	hárky	2	Plur
Namiesto toho som zašiel k predavačovi novín .	novín	6	Plur
Správy z afrického frontu boli mimoriadne znepokojujúce .	Správy	0	Plur
“ Kto je tvoj ocino ? “ spýtal sa Mauglí .	ocino	4	Sing
Ako som vychádzala zo školy , zbadala so , že sedí na trávniku pri zastávke môjho autobusu .	trávniku	12	Sing
Napriek tomu som stratil formu .	formu	4	Sing
Večer vhupli všetky včielky do postieľok a vytiahli si deky až pod nos .	postieľok	5	Plur
Niekedy jej rozprával o Oddelení záznamov a o nehanebných falzifikátoch , ktoré v ňom fabrikuje .	falzifikátoch	9	Plur
Nech ich srdce stále viac a viac poznáva hodnotu tej blaženosti , ktorú nám pripravil Tvoj jednorodený Syn .	blaženosti	10	Sing
Ukázalo sa , že v jednom stánku predávali plechové panvice .	panvice	9	Plur
Sexuálne puritánstvo Strany im nikto nevnútil .	Strany	2	Sing
Zlosyn napol luk a vystrelil .	luk	2	Sing
Nechávala ich tam , ale v šatách prinášala domov zápach kravína .	šatách	6	Plur
Jazmína pokrútila hlavou .	hlavou	2	Sing
Dôležitejším znakom oboch kategórií šamanov je , že úspech ich činov nezávisí od toho , akú obetu bohu prinesú , ale od toho v akom vzťahu sú oni sami s bohmi — tj . od ich schopností .	schopností	36	Plur
Takže teraz veľmi čakám , či niekto z mienkotvorných hláv Bútorovho elektorátu urobí sebakritickú analýzu tohto svojho fatálneho politického omylu .	hláv	9	Plur
“ Nie , ale vonku je tak krásne , “ odvetila som , i keď v hlave som mala len Chrisa .	hlave	16	Sing
Napriek týmto úžasným poznatkom vedy a techniky neexistuje zatiaľ žiadna definícia , čo je to život .	definícia	10	Sing
Toto stieranie hraníc je veľmi príjemné , pokiaľ ide o poriadneho občana , ktorý cestuje za svojím obchodom alebo za svojou dovolenkou .	dovolenkou	21	Sing
Boli to mizerné , chatrné rárohy , ale akékoľvek hrnce sa vždy ťažko zháňali .	rárohy	5	Plur
Wendy a chlapci vyjavene hľadeli , ako k oblohe stúpa čierny dym .	oblohe	8	Sing
Z jedného na mňa upierala zrak Dolora .	zrak	5	Sing
Vo vzduchu sa vznášali farebné balóniky , v pestrých stánkoch bolo množstvo všakovakých dobrôt .	dobrôt	13	Plur
Po chvíli prišli na svet štyri drobnučké šteniatka .	šteniatka	7	Plur
Pred priateľovou ordináciou čakalo zo dvadsať ľudí , lavice pri stene boli obsadené .	lavice	8	Plur
Winston sa zľahka poškrabal na nose sponkou na spisy .	nose	5	Sing
“ Páliš ? “ spýtal sa opatrne bodliak .	bodliak	7	Sing
Je veľmi pravdepodobné , že uhorskí zákonodarcovia formulovali príslušné právne normy o celibáte pod vplyvom výziev reformátorov .	zákonodarcovia	6	Plur
Pacholkovia vládnucej triedy !	Pacholkovia	0	Plur
Bolo by hanba predstúpiť pred žiakov v takom stave .	hanba	2	Sing
“ Aj ja , “ odvetil Chris a pohrával sa mi s vlasmi .	vlasmi	12	Plur
PREČ S VEĽKÝM BRATOM !	BRATOM	3	Sing
Nad fotografiou bol titulok Dvaja Albánci v putách ruského Interpolu .	putách	7	Plur
Okrem rekodifikácie trestného práva vláda dopracuje legislatívny zámer rekodifikácie súkromného práva a na jeho základe vypracuje dlhodobý plán postupného vypracovania nových právnych predpisov .	predpisov	22	Plur
Ja som vedel , že jej portrét sa nachádza medzi viečkami medailónu v skrini , kde sú uložené aj biele svadobné šaty so závojom .	skrini	13	Sing
Nestoja totiž v opozícií voči sebe na rovine ideí a ideológie , ale voči zástupcom orgánov svetských .	opozícií	3	Sing
Svojím typickým gestom si O ' Brien upravil na nose okuliare .	okuliare	10	Plur
Vláda bude hľadať spôsoby legislatívnej úpravy , aby v Národnej rade SR neboli prijímané zákony s nekrytými rozpočtovými dôsledkami .	spôsoby	3	Plur
Skôr či neskôr sa Abdullah vráti , ale dovtedy sa na Aladina usmialo šťastie .	šťastie	13	Sing
Lístok z recepcie som podal Raise .	Lístok	0	Sing
Kufor som nemal zbalený .	Kufor	0	Sing
Veci sa vyvinuli inak , než som sa obával .	Veci	0	Plur
Veľký brat je zovňajšok , v ktorom sa Strana ráči ukazovať svetu .	svetu	11	Sing
Domáci pán mal zlatý oblek s čiernymi pásikmi .	oblek	4	Sing
Prísnosť uhorských „ protialkoholických “ kánonov a aj ich početnosť svedčia o Kolomanovej snahe vykoreniť z klerických kruhov neduh nadmerného požívania alkoholu .	požívania	20	Sing
Podporením priestupnosti školského systému v oblasti prechodu žiakov na vyšší stupeň školy bez prijímacích skúšok , vláda minimalizuje podmienky na korupciu v školstve .	školstve	22	Sing
Vtom sa otvorili dvere a vošiel dnu lykožrút Fridolín .	dvere	3	Plur
Naši chirurgovia dokážu zmeniť ľudí na nepoznanie .	chirurgovia	1	Plur
Rudko im vysvetlil pravidlá a odpískal začiatok zápasu .	zápasu	7	Sing
“ Prestaň zúriť , Blythe , “ šepkala som do slúchadla , aby ma mama nepočula .	mama	14	Sing
Vybrala najligotavejšie jabĺčko a podala ho chlapcovi .	chlapcovi	6	Sing
Táto surrealistická hra trvala niekoľko nedieľ .	nedieľ	5	Plur
Zlej víle pohrával na červených perách zlovestný úsmev .	perách	5	Plur
Zastal pri Jazmíninom okne .	okne	3	Sing
Kým som tam osamote sedel , začul som na chodbe kroky a hlasy .	chodbe	9	Sing
Hostia však boli čoraz zachmúrenejší .	Hostia	0	Plur
Medzi pretekármi pravdaže nchýbal ani Flip , ktorý mal v hľadisku spústu fanúšikov .	pretekármi	1	Plur
Najprv zavládlo neprirodzené ticho .	ticho	3	Sing
Muži zo sprievodu to jednohlasne odobrili .	sprievodu	2	Sing
Vláda zlepší súčasný stav nedostatočnej ochrany slovenského spotrebiteľa a výrobkov vyrábaných na území SR .	výrobkov	9	Plur
Ostražito sa zakrádala k neznámemu miestu , keď začula plač .	plač	9	Sing
V šalátovej mise zmiešajte olej , korenie , soľ , uhorku , cibuľu , petržlenovú vňať a bazalku .	korenie	6	Sing
Vláda pripraví návrh zákona o menšinách , vrátane financovania menšinových kultúr .	financovania	8	Sing
Najvýraznejšie sa prvky predkresťanských systémov prejavil v severoruských oblastich .	oblastich	8	Plur
Neviditeľní jazdci na koňoch sú vyjadrením predstavy o zlých duchoch , schopných ubližovať človeku odnesením jeho duše do podsvetia .	jazdci	1	Plur
Teda je prirodzené , že zobrazenia dračích papúľ sú na novgorodských pamiatkach mimoriadne časté .	pamiatkach	11	Plur
Zdalo by sa teda , že Somogyvárske opátstvo bude vďaka zväzku so svojím materským opátstvom súčasťou clunyjskej „ kongregácie “ .	opátstvom	14	Sing
Typickým príkladom sú lúčové náušnice — symboly slnka a svetla .	symboly	6	Plur
Postávali v tieni lieštiny .	lieštiny	3	Sing
Jej krátke , tmavé vlasy boli neobyčajne husté a jemné .	vlasy	4	Plur
Spôsobil ju článok uverejnený na stránkach Októbra .	stránkach	5	Plur
Pozvala na ňu Blythe a Ricka a podávala moje obľúbené jedlá : zemiakovú kašu , pizzu , celozrnný chlieb , španielske chimichangas , makaróny so syrom a orechový koláč .	chimichangas	21	Plur
TARANTINO V DIVADLE	DIVADLE	2	Sing
Keď zazneli prvé tóny pomalej skladby , rozhodla som sa , že za ním pôjdem .	skladby	5	Sing
Newspeak bol oficiálnym jazykom Oceánie , vytvorený kvôli ideologickým potrebám angsocu , teda anglického socializmu .	Newspeak	0	Sing
“ Iba jedna včielka , “ odvetila Maja .	včielka	3	Sing
Nakoniec , takisto môže aj Čech čítať slovenské , keby chcel , oni však tú potrebu V ROVNAKEJ MIERE nemajú . “	potrebu	15	Sing
Na ľudskosť ?	ľudskosť	1	Sing
Chcel vzlietnuť do vzduchu , ale zamotal sa do krídel fraku .	krídel	9	Plur
Opice skákali z konára na konár a preskakovali koruny stromov , čo rástli pozdĺž brehu rieky .	stromov	9	Plur
S nami je veselo vždy , objavíš zlaté poklady !	poklady	8	Plur
Súčasťou návrhu bude aj kontrolný a monitorovací mechanizmus efektívneho využívania nástrojov podpory regionálneho rozvoja .	návrhu	1	Sing
Nálezy pečatí umožňujú určiť autorstvo , pravosť a čas vzniku dokumentu , dopĺňajú tak informácie o ňom .	autorstvo	4	Sing
Na úplný záver dlžím ešte jedno poďakovanie .	záver	2	Sing
Namiesto veľkého podnosu niesla malú tácku , na ktorej bola len jedna šálka s kávou a jeden pohár s rakijou .	pohár	17	Sing
Dôležitejším znakom oboch kategórií šamanov je , že úspech ich činov nezávisí od toho , akú obetu bohu prinesú , ale od toho v akom vzťahu sú oni sami s bohmi — tj . od ich schopností .	šamanov	4	Plur
Kým odletím do nebeského pekla , musím si odčiniť nejaké hriechy tu , v pozemskom pekle .	hriechy	10	Plur
Z Pobaltia pochádzajú náušnice podľa tvaru zvané vlčí zub .	zub	8	Sing
Makové zrniečka v nej zašušťali , ako keď sa presýpajú myšlienky .	myšlienky	10	Plur
Možno moje postavy vedia hrať šach .	postavy	2	Plur
Blythe plesla rukou po sedadle a otočila sa ku mne .	rukou	2	Sing
Vláda pripraví podmienky pre sústredenie kompetencií v oblasti regulácie a koordinácie elektronickej komunikácie a rozvoja informačnej spoločnosti z rôznych orgánov na jeden regulačný orgán .	rozvoja	14	Sing
Posledný kánon II . kolomanovskej synody o celibáte sa svojím obsahom vymyká prísnejšiemu tónu uznesení tohto cirkevného snemu .	uznesení	14	Plur
Monastická reforma mala viacero od seba nezávislých stredísk .	stredísk	7	Plur
Iba na chvíľu .	chvíľu	2	Sing
Svoju neforemnú topánku presunula o pár centimetrov a naschvál dodrúzgala konárik .	centimetrov	6	Plur
Chlapci sa smiali , keď mocný pirát napol svaly na ruke , až sa mu na ramene zachvel vytetovaný pirátsky znak ‐ lebka so skríženými hnátmi .	znak	20	Sing
Tentoraz ako režisérka a producentka .	producentka	4	Sing
“ Tak rozprávaj , “ súrila ma Blythe , keď sme nastúpili do jej džípu .	džípu	14	Sing
Nôž by mal minimálne obsahovať : veľkú a malú čepeľ , otvárač na fľaše a konzervy , rydlo , výhodné je , ak obsahuje dierovač , pílku na drevo , vývrtku , pinzetu .	pílku	26	Sing
Wilsher , blondiak s nasprostastým výrazom na tvári , ktorého takmer nepoznal , ho s úsmevom pozýval na voľné miesto pri svojom stole .	tvári	7	Sing
Nôž by mal minimálne obsahovať : veľkú a malú čepeľ , otvárač na fľaše a konzervy , rydlo , výhodné je , ak obsahuje dierovač , pílku na drevo , vývrtku , pinzetu .	fľaše	13	Plur
Aladin pritiahol stoličky a psi na ne vyskočili .	psi	4	Plur
Za jeho stiahnutými mihalnicami sa pohyboval celý les prstov v akomsi tanci , vykrúcal sa a skrúcal , strácal sa jeden za druhým a znova sa objavoval .	prstov	8	Plur
Ani tú poviedku , ani knihu Znepokojenia .	poviedku	2	Sing
Tak u mnohých národov existujú tzv . bieli šamani , spájaní s nebeskými silami a svetom hore a šamani čierni , zviazaní s podsvetím .	šamani	8	Plur
Potom nechal portrét portrétom .	portrét	2	Sing
Plávajú v ňom ryby všetkých farieb dúhy .	farieb	5	Plur
Pochybovačne zdvihla obočie , pozrela na mňa a ďalej vykladala nákup .	obočie	2	Sing
Keď bol ľan poriadne mokrý , krtko ho zaniesol na breh .	breh	10	Sing
Zdravý rozum je záležitosť štatistiky .	záležitosť	3	Sing
Chris síce prikývol , ale šibalsky mu sem ‐ tam myklo kútikmi úst .	úst	12	Plur
Vláda vytvorí podmienky pre uskutočnenie úspešného referenda o vstupe do EÚ , ktoré bude dokumentovať udržanie širokej podpory verejnosti tomuto historickému kroku .	kroku	21	Sing
Keď som v dráhe zastala a šliapala vodu , zabrzdila som ostatných plavcov .	plavcov	12	Plur
Hra na hudobné nástroje , vozy ako prostriedok na prekonávanie vzdialeností by mohli svedčiť i o narážke na potulných hudcov ‐ igricov , ktorí sú chápaní v celoeurópskom kontexte ako elementy , rušiace zabehaný poriadok .	nástroje	3	Plur
Horace a Jasper sedeli na starej pohovke obklopení tuctami šteniatok a pozerali televíziu .	televíziu	12	Sing
Po hodine na mňa Chris čakal pred triedou .	hodine	1	Sing
Sú to zbojníci a ničomníci .	zbojníci	2	Plur
Zároveň však Cluny urobilo veľký krok na ceste k libertas , lebo vytvorilo spoločenstvo ( zväčša ) úplne slobodných kláštorov , ktoré nepodliehali laikom .	spoločenstvo	13	Sing
Vyšla z kancelárií a zamierila rovno do Cerberovho brlohu .	kancelárií	2	Plur
Chris pootvoril ústa a zľahka mi hrýzol pery , ako keby ich ochutnával .	ústa	2	Plur
Šéf sa zo všetkých síl pokúšal , aby som odišiel z jeho pracovne spokojný , aj keď mi tú poviedku neuverejní .	pracovne	12	Sing
Preleteli sme cez oddelenie topánok , kozmetiky , vyhli sme sa nápadne namaľovaným predavačkám , ktoré ponúkali masky , líčidlá a vzorky kolínskej .	vzorky	21	Plur
Zavedieme stanovenie základných štandardov na financovanie a kvalitu sociálnych služieb , systém udeľovania licencií a kontroly , zrovnoprávnenie pre všetky inštitúcie poskytujúce sociálne služby .	zrovnoprávnenie	17	Sing
Všetci len oddychovali pod slnečníkmi z ďatelinových lístočkov .	slnečníkmi	4	Plur
VEĽMI KOMPLIKOVANOU ZHODOU OKOLNOSTÍ HO PO ROKU dostal a odišiel NA ROK do Nórska .	ROKU	6	Sing
Mal na sebe krátke nohavice farby kaki a športovú košeľu .	košeľu	9	Sing
“ Teraz pôjdeme na políciu ! “	políciu	4	Sing
Šaty boli dlhé , biele a viseli medzi Profesorovými oblekmi .	Šaty	0	Plur
Tentoraz na televízne obrazovky v podobe 13 - dielneho seriálu .	obrazovky	3	Plur
Svoje fotografie odteraz nájdete vždy na adrese www . fotoindex . sk vo svojom súkromnom fotoalbume .	fotografie	1	Plur
Vláda prijme opatrenia na minimalizáciu možnosti vzniku korupcie a dopracuje systém kontroly zameraný na kontrolu použitia verejných prostriedkov , vrátane prostriedkov plynúcich z EÚ .	použitia	15	Sing
V noci sme sa hodiny rozprávali , hovorili sme o všetkom , čo nám napadlo .	hodiny	4	Plur
Stavajú domy , čo plávajú na vode .	vode	6	Sing
Slovo „ idiot “ mi uviazlo v hrdle .	hrdle	7	Sing
“ A nezabudnite na vrecká , kam zabalíte psom zvyšky . “	psom	8	Plur
Zrejme odriekala modlitbu .	modlitbu	2	Sing
V šalátovej mise zmiešajte olej , korenie , soľ , uhorku , cibuľu , petržlenovú vňať a bazalku .	soľ	8	Sing
Pred niekoľkými rokmi tam bol iba parčík .	parčík	6	Sing
Pochopil som , prečo mi jej tvár pripomína niečo známe .	tvár	6	Sing
Obaja rýchlo dýchali , ale okolo kútikov úst sa jej znovu objavil úsmev .	úsmev	12	Sing
Ani predstavitelia oficiálnej kritiky .	predstavitelia	1	Plur
Skupina kánonov I . ostrihomskej synody sa venuje stanoveniu obsahu bohoslužieb a príbuzným kultovým predpisom .	bohoslužieb	10	Plur
Ale Lori pochopila zmysel mojich slov po svojom .	slov	5	Plur
Ďalším dôkazom samosprávy týchto plemien bola paralelná existencia novgorodského a vodského daňového okruhu v Koporí .	dôkazom	1	Sing
Vytvoríme kapitálotvornú vrstvu , ktorá bude zárukou blaha ľudu , presvedčivo hlásal tvorca blaha svojich prívržencov .	prívržencov	15	Plur
Vedela , že z toho má v hlave zmätok .	zmätok	8	Sing
Včielky sa držali za ruky .	ruky	4	Plur
Takto som trávieval večery , márnil som čas pred televízorom .	večery	3	Plur
Oči ma neklamali .	Oči	0	Plur
Ako som počúval otcove husle , pred očami sa mi zjavil portrét ženy z medailónu .	očami	7	Plur
Pred bránou Maju oslepilo žiarivé svetlo , až privrela oči .	bránou	1	Sing
Spal som v taxíku cestou z hotela na letisko .	cestou	4	Sing
Pri realizácii zahraničnej politiky bude vláda SR venovať stálu pozornosť otázkam ľudskej dimenzie .	otázkam	10	Plur
Trojzubec sa odchýlil iným smerom .	Trojzubec	0	Sing
V záhrade sa oslavovali narodeniny .	narodeniny	4	Plur
Na tejto biblickej platforme stojí dnes mnoho významných svetových vedcov .	vedcov	9	Plur
Všetky okná boli vysvietené .	okná	1	Plur
Šer Chán ich počúval zo svojho úkrytu z kroví .	kroví	8	Plur
Pred domom kuny Chytráčky viali pestré slepačie perá , Alfonz vystavoval lesklú kukuricu a kliešťak Drakula voňavé krvavé klobásky .	kukuricu	12	Sing
Stále v pohybe , akumulátor energie a nápadov .	nápadov	7	Plur
Winston ho pozoroval kútikom oka .	oka	4	Sing
Realita života na vidieku zatláča náboženské rozdiely do úzadia .	Realita	0	Sing
Alfonz prijal s úľavou od kamarátov ponuku , že mu pomôžu pripraviť oslavu .	kamarátov	5	Plur
Siahol do mešca a vybral z neho za hrsť zlatých mincí .	mešca	2	Sing
Akú budúcnosť by si Kalif želal ?	budúcnosť	1	Sing
Nohavičky s vreckami .	vreckami	2	Plur
Vzdelanie sa stáva kľúčom k životnému úspechu , najlepšou investíciou do budúcnosti , účinnou prevenciou pred nezamestnanosťou , zločinnosťou , drogami .	kľúčom	3	Sing
Z takýchto listín je zaujímavý predovšetkým nález , datovaný zhruba polovicou trinásteho storočia .	listín	2	Plur
Na rube sa nachádza ľudská postava v korune s insígniami v rukách .	postava	5	Sing
Jeho prítomnosť vnáša do útvaru už spomenuté prvky hrdinskej epiky — mýtický boj za odstránenie chaosu sa mení na ochranu štátu a viery proti cudzím pohanom .	prvky	7	Plur
Ordinácia je akt , ktorým kandidát svätenia ( ordinand ) získava istý stupeň svätenia .	svätenia	6	Sing
Okolo nás pulzovala noc a ozývali sa známe zvuky okolia : tlmený hukot čerpadiel v okolitých bazénoch .	čerpadiel	13	Plur
Winstona bolestne bodlo pri srdci .	srdci	4	Sing
V dome im Bibi vysvetlila , čo dáva psíkom jesť a kde majú svoje misky .	misky	14	Plur
Vypáči z pamäte pána Charringtona zvyšok tej riekanky .	riekanky	7	Sing
Tá za desaťročia sústredeného výskumu vyprodukovala stovky monografických a časopiseckých spracovaní danej témy .	spracovaní	10	Plur
Odhrnula som mokré plavky , prázdne kokakolové plechovice , ceruzky , listy vytrhnuté z notesa a knižku Kto chytá v žite so somárskymi ušami .	notesa	14	Sing
“ Khalid mi dal morské riasy ! “	riasy	5	Plur
V jednom rohu podložky je ventil , po jeho otvorení pena nasáva vzduch , nafukuje sa .	ventil	5	Sing
Bosorka si škodoradostne pomädlila ruky .	Bosorka	0	Sing
Náš kolega Mišo Hvorecký je brandista .	kolega	1	Sing
Ordinácia je akt , ktorým kandidát svätenia ( ordinand ) získava istý stupeň svätenia .	ordinand	8	Sing
Mama sa blížila spolu s ním .	Mama	0	Sing
Maju pochytila ukrutná zlosť .	zlosť	3	Sing
Vláda v spolupráci s predstaviteľmi územnej samosprávy vytvorí transparentný inštitucionálny a finančný návrh na kofinancovanie regionálneho rozvoja z prostriedkov štátneho rozpočtu a z fondov EÚ .	samosprávy	6	Sing
Rozzúreného Šuchtáka vystrieda slimák Plazivec a hra pokračuje .	slimák	3	Sing
Neváhal a rozhádzal všetky kamene , zničil všetky znamenia .	kamene	4	Plur
Takto sme priviedli kravičky do mravčích chlievov .	kravičky	3	Plur
Cieľom reforiem v sociálnom systéme je zníženie jeho zneužívania , odstraňovanie byrokracie a potláčanie korupcie .	potláčanie	13	Sing
Po celý čas som sa díval smerom k osvetlenému pásmu , kde sa zástup žien tlačil pred skleným priečelím obchodu .	žien	14	Plur
Už sa zberala preč , ale vo dverách sa otočila .	dverách	7	Plur
Máme jej celé kilo , " povedala .	kilo	3	Sing
Vlak bol plný proletov so sviatočnou náladou , ktorú v každom vyvolávalo letné počasie .	proletov	3	Plur
Vzdelanie sa stáva kľúčom k životnému úspechu , najlepšou investíciou do budúcnosti , účinnou prevenciou pred nezamestnanosťou , zločinnosťou , drogami .	zločinnosťou	18	Sing
Pri stene bola posteľ , na stole lampa s hlboko stiahnutým tienidlom .	tienidlom	11	Sing
V jednom rohu podložky je ventil , po jeho otvorení pena nasáva vzduch , nafukuje sa .	rohu	2	Sing
Podľa zoznamu posadnikov , uvedených v novgorodskom prvom letopise mladšieho vydania sa nazýval Zavid .	posadnikov	2	Plur
Avšak hoci som sa strácal v tieni režisérov a hviezd filmového plátna , netrápil som sa .	plátna	11	Sing
Dodržiaval som toto pravidlo , odkedy som napísal prvú hlúposť z toho cyklu , krátku esej s dlhým názvom Orgazmus alebo Hrôza zo sexuálneho vyčerpania .	pravidlo	3	Sing
Na zlepšenie komunikácie s verejnosťou sa zavedú pravidelné stretnutia funkcionárov polície s občanmi .	občanmi	12	Plur
Po večeri sme odpratali zo stola a vytiahla som fyziku .	stola	5	Sing
Jediným mávnutím zázračnej palice premenil reťaze na zlatú korunku .	reťaze	5	Plur
Od ľaku urobil Vilko kotrmelec .	kotrmelec	4	Sing
Nešporné služby Božie sa u nás konajú pravidelne každú prvú nedeľu v mesiaci v modlitebni .	modlitebni	14	Sing
Sopky vreli , vyčíňali búrky a zemetrasenia , svet bol plný zmätku a veľkého zdesenia .	búrky	4	Plur
Prirodzeným dôsledkom takéhoto stretu je rozbíjanie vervi a úsilie o znevoľnenie smerdov .	smerdov	11	Plur
Pacholkovia vládnucej triedy !	triedy	2	Sing
Vyzeral akoby ho oposkladali z niekoľkých plemien psov .	psov	7	Plur
Presne takúto podobu , teda jednoduché príkazy či predpisy , majú i príslušné nariadenia v sledovaných kánonickoprávnych zbierkach .	predpisy	8	Plur
Zo záhybov svojej pamäti vydoloval niekoľko ďalších úryvkov zabudnutých riekaniek .	úryvkov	7	Plur
Hrozne ma bolia kĺby a nestihla som spojenie . “	kĺby	3	Plur
So žiarivým trojzubcom v mohutnej ruke sa nad nimi týčila ako predzvesť smrteľných bleskov .	predzvesť	11	Sing
Hneď na úvod som urobil niečo veľmi nerozumné : dal som si dvojitý koňak .	úvod	2	Sing
Vzala Maju za ruku a odviedla ju do miestnosti , kde boli samé medové plásty .	miestnosti	8	Sing
Dr . Hanesová nastolila niekoľko veľmi aktuálnych problémov , s ktorými sa borí nejedna cirkevná škola na Slovensku .	škola	15	Sing
Abdullah pokrčil plecami .	plecami	2	Plur
Veľkú tašku hodil do kúta a mľaskavo ho pobozkal .	tašku	1	Sing
Vláda prijme opatrenia na minimalizáciu možnosti vzniku korupcie a dopracuje systém kontroly zameraný na kontrolu použitia verejných prostriedkov , vrátane prostriedkov plynúcich z EÚ .	kontrolu	14	Sing
Keďže kníh , ktoré mi zostali , nebolo ktovieako veľa , vrece bude ťažšie , ak pridám rukopisy svojich scenárov .	rukopisy	17	Plur
Dvere na izbe nechal otvorené .	Dvere	0	Plur
Na Majino prekvapenie bola pod ním malá jaskynka .	jaskynka	7	Sing
Z tohto hľadiska meriam obdobie svojho pobytu v Čarodejníckej vile podľa intervalov , v akých otec odpovedal na mamine listy .	pobytu	6	Sing
Takto nevyzerá ani autorka článku , ani kamarátova babka .	autorka	3	Sing
Z Odilonovho listu Štefanovi I . sa dozvedáme , že clunyjský opát a prvý uhorský kráľ boli vo vzájomnom styku už pred odoslaním tohto listu vzniknuvšieho medzi rokmi 1031 – 1038 .	listu	24	Sing
V tom omámení som zabudol na niečo podstatné .	omámení	2	Sing
Irma mala šťastie .	šťastie	2	Sing
Na hladinu šľahal dážď .	dážď	3	Sing
Kláštory a ich opáti sú tu podriadení diecéznym biskupom , ktorých povinnosťou je kláštory často vizitovať .	povinnosťou	11	Sing
Zato na perách mal akýsi poprašok .	poprašok	5	Sing
Môj zmätok bol úplný , keď ma vyzvala , aby som išiel dopredu .	zmätok	1	Sing
Na tvári som jej videla , že ju to vzalo , a keď vstala zo stoličky , bála som sa , že odíde z kuchyne .	tvári	1	Sing
Na jeho základe sa bude financovať tzv . solidárny balík , ktorého súčasťou bude aj financovanie siete rýchlej zdravotnej pomoci .	pomoci	19	Sing
Na chvíľu ožiarilo murény oslnivé hrôzostrašné svetlo , no po chvíli sa rozprskli na tisíc márnych kusov .	kusov	16	Plur
Nastal bod obratu .	obratu	2	Sing
Môj mozog zatiaľ začínal špekulovať .	mozog	1	Sing
V okne na prvom poschodí zbadala uväznenú cvrčicu .	okne	1	Sing
Pocítil som znechutenosť .	znechutenosť	2	Sing
Pri slávnostných obradoch ju potom niesol jej najuznávanejší člen .	obradoch	2	Plur
Ten , ktorý pod jagavosť tém hodnú bestsellerov rozostavil pasce , v ktorých uviazol sám .	tém	5	Plur
Tá žena mi položila ruku na hlavu a rozstrapatila mi vlasy .	vlasy	10	Plur
Ústrednou postavou poviedky aj filmu bola Delina , dedinská učiteľka .	postavou	1	Sing
Zlej víle ostávala posledná nádej — havran .	nádej	4	Sing
Mama zdvihla oči od novín a usmiala sa .	novín	4	Plur
Zostal som sedieť v kresle , aj keď sa dvere otvorili a do miestnosti vošli dvaja muži , nové tváre .	miestnosti	13	Sing
Newspeak bol oficiálnym jazykom Oceánie , vytvorený kvôli ideologickým potrebám angsocu , teda anglického socializmu .	angsocu	10	Sing
Krtko prečesával ľan až z neho vyčesal jemné vlákna .	ľan	2	Sing
Zjavila sa vo dverách , mala na sebe čierno ‐ bielu uniformu .	uniformu	11	Sing
Odložil som pohár a očami som opäť zablúdil k protiľahlým stolom , pri ktorých sedeli spomínaní ľudia .	očami	4	Plur
Od straníkov sa vyžadoval podobný názor , aký mali starovekí Židia , ktorí síce vedeli , že všetky iné národy uctievajú nepravých bohov , ale to bolo všetko , čo o nich vedeli .	straníkov	1	Plur
A urobil na dokumente tri krížiky .	dokumente	3	Sing
Od opitosti .	opitosti	1	Sing
„ Poznajú iba hlad a smäd , lásku a lopotu , sebectvo a skúposť .	skúposť	13	Sing
Urobila som adventný veniec a zavesila na dvere .	veniec	3	Sing
Pod nimi bolo viacero vkusných papierových balíčkov .	balíčkov	6	Plur
Nad lúkou sa zotmelo a svetojánske mušky sa museli postarať o osvetlenie ihriska .	mušky	6	Plur
Váhavo sme sa od seba odtrhli a Chris ma odprevadil k nášmu oknu .	oknu	12	Sing
So zlovestným úškľabkom na tvári Uršuľa chrlila na Arielu hromy ‐ blesky .	hromy	9	Plur
" Niektoré z nových trendov sú veľmi dômyselné .	trendov	4	Plur
Predavači tu núkali všeličo od výmyslu sveta — mosadzný riad , sladké datle i čerstvé ryby .	Predavači	0	Plur
Zdivočenci sa zarazili .	Zdivočenci	0	Plur
Skryl som sa za obrovitý strom .	strom	5	Sing
Nejaký neznámy súper v ľúbostných dobrodružstvách .	dobrodružstvách	5	Plur
Rád by som veril čestnosti politikov , ale realita na Slovensku je zatiaľ iná .	realita	8	Sing
Keď sa začal semester , pustil som sa pod vedením profesora SommerfelTa do čítania textov .	textov	14	Plur
Rýchlo som upratala zo stola a ponáhľala sa do svojej izby .	stola	4	Sing
Vonku opäť zaznel dupot čižiem .	čižiem	4	Plur
Ja som jeho pravá majiteľka . “	majiteľka	4	Sing
Potom vložila ten lístok do zásuvky , vytiahla z nej kľúč s ťažkým bronzovým štítkom , na ktorom bolo číslo izby , a strčila mi ho do ruky .	štítkom	14	Sing
Zavedie štátnu maturitnú skúšku na stredných školách .	školách	6	Plur
Tmavovlasé dievča sedelo ihneď za nimi .	dievča	1	Sing
Literatúra je žena , pomyslel som si .	Literatúra	0	Sing
Z kuchyne som vzala dva vínové poháre a veľkú fľašu malinovky .	kuchyne	1	Sing
Základným prvkom reformy verejných financií bude zavedenie tvrdého rozpočtového obmedzenia v celom okruhu verejných financií .	financií	4	Plur
Podstrčil mu ho redaktor z televízie , ktorá všetko nakrúcala .	televízie	5	Sing
Keď prišiel čas večere , dostal jedlo i Vilko .	jedlo	6	Sing
Prichádzali sme zozadu , a tak sme sa vyhli autobusom , autám a nápisom nad vstupom .	vstupom	15	Sing
Vláda považuje pružný trh práce schopný reagovať na hospodársky vývoj za nevyhnutnú podmienku znižovania nezamestnanosti .	znižovania	13	Sing
Voda špliechala o okraje a zamočila ležadlá pri bazéne .	bazéne	8	Sing
Z takýchto listín je zaujímavý predovšetkým nález , datovaný zhruba polovicou trinásteho storočia .	nález	6	Sing
Od rána do večera som pil čaj s citrónom , aby som sa čo najskôr uzdravil a mohol Lienke splniť jej sen .	večera	3	Sing
Dvere na izbe nechal otvorené .	izbe	2	Sing
Pôvodne sa nachádzal na freske severozápadnej veže .	freske	4	Sing
Prešlo desať období dažďov a za tie roky ľudské mláďa vyrástlo .	dažďov	3	Plur
Siahol mu do vrecka na šatách a keď vytiahol ruku , mal na dlani veľký červený rubín .	šatách	5	Plur
Jej duša odletela do neba o polnoci , keď sa striedali storočia .	neba	4	Sing
Vláda bude podporovať vývoj a šírenie výrobkov i služieb šetriacich životné prostredie a v rámci legitímnych trhových nástrojov hľadať možnosti podpory malým a stredným podnikateľom zvyšovať investície do „ čistej “ výroby a environmentálnych podnikateľských aktivít .	podnikateľom	24	Plur
Celý svet vyvalí oči , keď Belu a Gastona zbadá taký pár málokde zočí , krásavci jedna balada .	krásavci	15	Plur
Zvončeky popadali na zem ako vodopád .	vodopád	5	Sing
Bavilo ma písať kompozície a na vynikajúcom skalickom gymnáziu boli veľmi dobré podmienky pre kultúru .	kompozície	3	Plur
Zbehom a pútnikom vo filmoch a knihách trvá návrat do rodnej obce neraz celé desaťročia .	Zbehom	0	Plur
Poslušne som sa za ňou vliekla a zaháňala myšlienky na matematické rébusy , čo ma doma čakajú .	rébusy	11	Plur
Nakukol pomedzi húštinu a uvidel troch tvorov v šatách namiesto kožušiny .	šatách	8	Plur
Zajac mohol byť vykladaný v systéme predkresťanských názorov jednak ako symbol plodnosti / dodnes spájame na veľkú noc vyobrazenia zajacov s vajíčkami , Nemci počas tohto sviatku hľadajú v záhrade vajíčka ukryté veľkonočným zajacom / .	sviatku	26	Sing
Profilované karimatky sú osobitná kategória .	karimatky	1	Plur
Prítomnosť nálezov kačacích príveskov sa vysvetľuje tiež importom zo Škandinávie , prostredníctvom nápodoby laponských a karelských kovolejárov .	importom	7	Sing
V Piacenze sa stretol s novým pápežom ( Gregorom VI . ) a prijal ho s náležitými poctami .	poctami	17	Plur
Takýmito duchmi môžu byť medvede , vlky , zajace , jelene , kačky , orly , sovy a vrany .	zajace	8	Plur
Vzápätí však na votrelcov zaútočili svietniky , vešiaky , skrine , hodiny a riad .	svietniky	5	Plur
Teraz sa v noci budievam zo spánku a hrdlo mi zviera úzkosť : trápi ma nočná mora , že aj ja som v dave , ktorý ženie mamu v ústrety smrti .	spánku	6	Sing
“ Voda bola určite ako ľad . “	Voda	1	Sing
Primátor Komárna Štefan Pásztor po svojej sekretárke odkázal SME , že sa k problému nevyjadrí .	sekretárke	6	Sing
Povzbudzovalo svojich favoritov a už sa ozývali aj prvé heslá .	heslá	9	Plur
U ugrofínskych národov fungoval orol ako predok a ochranca šamanov .	šamanov	9	Plur
S takým nátreskom nerátal .	nátreskom	2	Sing
Kačka bola u ugrofínskeho národa Mordovcov posvätným zvieraťom .	zvieraťom	7	Sing
Po známej zrážke s okrajom bazéna ma boleli päty a prestala som si veriť .	bazéna	5	Sing
A strechu Džahijovej chatrče strhla púštna búrka .	búrka	6	Sing
Budete mať tri či štyri kontakty , ktoré príležitostne nahradíme novými .	kontakty	5	Plur
Minule sa môj kolega Rado Ondřejíček fejtónovým perom pustil do problému hlupákov medzi nami .	perom	7	Sing
Smutným hlasom im Kasandra oznámila , že v noci navšítvili komoru s medom zlodeji a spôsobili im veľkú škodu .	medom	12	Sing
Pečať č . 4 sa našla v dvoch exemplároch .	exemplároch	8	Plur
Začala som výčitkami , ale teraz pokračujem radami do nového roku .	radami	7	Plur
Zvíťazila som v najdôležitejších pretekoch .	pretekoch	4	Plur
Aladin sa zatiaľ usadil so skríženými nohami pred krištáľovou guľou .	nohami	6	Plur
Raz to boli gombičky , potom vlnené handry na záplaty a raz šnúrky od topánok ; a teraz to boli žiletky .	handry	7	Plur
Z maku vyšlo ako z lesa drobučké dievčatko .	lesa	5	Sing
V noci sa voľne pohybovali dedinské psy a ja som sa ich bál na smrť .	psy	6	Plur
Spomínala na všetkých kamarátov i na to , ako mohla byť aspoň na chvíľočku kapitánom mravcov .	kamarátov	3	Plur
Splývali pred mojím duševným zrakom v podobe Lori , ktorá bola ich poslednou metamorfózou .	metamorfózou	13	Sing
Po kráľovskej hostine , na ktorú mravce priniesli obrie porcie špagiet s voškovou omáčkou , si všetci políhali na slniečko , aby si oddýchli .	mravce	6	Plur
Krist , nenamáhaj sa , nepoučuj ma o tom , o čom ma stará mama poučila už dávno ‐ pradávno .	mama	14	Sing
Vláda bude naďalej podporovať účasť Ozbrojených síl SR v mierových misiách a operáciách na podporu mieru a na boji proti terorizmu , s dôrazom na operácie pod vedením NATO .	operáciách	12	Plur
Faika si nič nevšimla a nevmietla mi do tváre nijaký prívlastok .	tváre	8	Sing
A stiahol zlatý náprstok naspäť pod čiernu zem .	náprstok	3	Sing
Zmätene som zastal pri dverách izby .	dverách	4	Plur
Gregor VII . , aby toto presvedčenie ešte zdôraznil a aby mohol vyžadovať poslušnosť od uhorských kráľov , vytvoril konštrukciu o Štefanovom komendovaní krajiny sv . Petrovi .	poslušnosť	13	Sing
Čakanie na šéfa . . .	šéfa	2	Sing
Stranu nezaujímajú konkrétne činy : my si potrpíme len na myšlienky .	činy	3	Plur
Na takomto mieste prelínania sa dvoch kultúr sa ľahšie uchovávajú archaické prežitky .	prežitky	11	Plur
SLOBODA JE OTROCTVO	SLOBODA	0	Sing
Pri príležitosti svojho odchodu a ukončenia zimného obdobia som vyhlásil , že zaplatím koňak všetkým , ktorí budú od dvanástej až do tretej poobede v kaviarenskej časti obchodu .	koňak	13	Sing
Bol som Faikiným rukojemníkom .	rukojemníkom	3	Sing
A slabých bytostí , ako bola mama .	mama	6	Sing
Musím rešpektovať Marginu požiadavku , aby som deťom nič nepovedal , a zároveň musím nájsť pre Irmu nejaké presvedčivé vysvetlenie .	deťom	7	Plur
Vzápätí pribehli mandelinčatá s boľavými bruchami , takže musela ošetriť aj ich .	mandelinčatá	2	Plur
Zvláštni ľudia tam varili neznáme , no voňavé dobroty .	dobroty	8	Plur
JEDNÉHO DŇA SA PYŠNÁ KRÁĽOVNÁ SPÝTALA svojho zázračného zrkadla : “ Povedzže mi , ktože je najkrajší v našej zemi ? “	zemi	19	Sing
Bolo tu pododdelenie televíznych programov s inžiniermi , producentmi a s celými tímami špeciálne vybraných hercov , lebo dokázali imitovať hlasy .	programov	4	Plur
Horace a Jasper sedeli na starej pohovke obklopení tuctami šteniatok a pozerali televíziu .	tuctami	8	Plur
V kapitole o Novgorode sme už rozobrali súvis tzv . Najstaršej Pravdy s protivarjažskými nepokojmi .	súvis	7	Sing
Ťahal voz dovrchu naložený melónmi .	voz	1	Sing
“ Viem , “ povedala som a vystúpila z auta , “ ale ak budem myslieť len na zábavu , môžem ísť zametať chodníky . “	chodníky	23	Plur
Sexuálne puritánstvo Strany im nikto nevnútil .	puritánstvo	1	Sing
Nová Koncepcia ochrany prírody a krajiny bude obsahovať racionálny systém manažmentu chránených území , prehodnotí ich cieľový stav a navrhne opatrenia a programy starostlivosti tak , aby chránené územia slúžili aj verejnosti .	starostlivosti	23	Sing
Neviditeľní jazdci na koňoch sú vyjadrením predstavy o zlých duchoch , schopných ubližovať človeku odnesením jeho duše do podsvetia .	duchoch	9	Plur
“ Slávna trojka opäť v akcii .	akcii	5	Sing
O kulte jaštera svedčia už spomenuté rúčky čiaš .	rúčky	6	Plur
Prítomnosť nálezov kačacích príveskov sa vysvetľuje tiež importom zo Škandinávie , prostredníctvom nápodoby laponských a karelských kovolejárov .	príveskov	3	Plur
Do roku 2006 vláda dokončí plnú profesionalizáciu Ozbrojených síl SR .	profesionalizáciu	6	Sing
Gule na žonglovanie .	žonglovanie	2	Sing
Je dôležité často úkryt meniť .	úkryt	3	Sing
Tak je po Jaroslavovom víťazstve položený základ novgorodských výsad , ktorí Novgorodcom garantujú ochranu pred kniežacími družiníkmi a Varjagmi / no zároveň zabezpečujú kniežaciu družinu pred ľudom / .	výsad	8	Plur
V decembri boli služby Božie v ústave s prisluhovaním sviatosti Večere Pánovej .	ústave	6	Sing
Vláda v spolupráci s predstaviteľmi územnej samosprávy vytvorí transparentný inštitucionálny a finančný návrh na kofinancovanie regionálneho rozvoja z prostriedkov štátneho rozpočtu a z fondov EÚ .	rozvoja	16	Sing
Jej priebeh je možné zrekonštruovať zhruba takto — Pred obradom samotným bolo postavené obetisko s pôdorysom štvoruholníka so štyrmi stĺpmi v rohoch .	štvoruholníka	16	Sing
V oblasti vodovodov a kanalizácií sa vytvoria podmienky pre podporu rozvojových aktivít v regiónoch s nedostatkom prirodzených zdrojov pitnej vody .	kanalizácií	4	Plur
Zostal som sám na prvopočiatku sveta .	prvopočiatku	4	Sing
Cieľom reformy poistenia v nezamestnanosti bude posilnenie princípu zásluhovosti ( poistného princípu ) a princípu osobnej zodpovednosti občana za vlastnú pracovnú a sociálnu situáciu .	občana	17	Sing
Vytieňoval lícne kosti a tmavé obočie .	obočie	5	Sing
Vyzeral akoby ho oposkladali z niekoľkých plemien psov .	plemien	6	Plur
Stĺpy boli spojené prútím , alebo žrďovinou .	Stĺpy	0	Plur
Po štyroch dolároch starec zjavne pookrial .	dolároch	2	Plur
Vláda zabezpečí harmonizáciu a štandardizáciu informačných technológií a dátových štruktúr s cieľom vytvorenia podmienok pre prepojenie informačných systémov dopravy , pôšt a telekomunikácií s EÚ	štandardizáciu	4	Sing
Buchta láskyplne sledovala siláka Fridolína .	siláka	3	Plur
Ozýval sa stadiaľ šepot , potom rýchle kroky a napokon sa vo dverách zjavila kráľovná .	dverách	12	Plur
Prečo existuje láska ?	láska	2	Sing
Winston si zopäl ruky nad hlavou .	ruky	3	Plur
Mama zjedla otravu na myši .	myši	4	Plur
Pečate so vzývajúcou formulou v staroruštine	Pečate	0	Plur
Chodili jej normálnou poštou do školy , kde učila .	poštou	3	Sing
Svätojánska muška mala tenulinký hlások a Maja ju takmer nepočula .	muška	1	Sing
“ Hrozne sa na tých hodinách nudím .	hodinách	5	Plur
Ako kráčal k dverám , mince v mešci príjemne zacinkali .	dverám	3	Plur
Vláda zvýši mieru informovania verejnosti v oblasti regionálnej politiky .	informovania	3	Sing
Novgorodské brezové listiny .	listiny	2	Plur
Politika zameraná na zníženie deficitnosti verejných financií vytvorí spolu s reformami v najvýznamnejších výdavkových rezortoch priestor na zníženie odvodov a priamych daní .	reformami	10	Plur
Nakoniec sme priniesli z kuchyne taniere , šalát a fašírku .	taniere	5	Plur
Ocitlo sa osamote s Lori a zo svojej skrýše všetko pozorne vnímalo : tvary Lorinho tela , jej dych , vôňu jej mäsa .	skrýše	8	Sing
V oblasti prepravných povolení v cestnej doprave sa realizuje nový transparentný systém založený na princípe nárokovosti pri splnení požadovaných kritérií a podmienok	princípe	14	Sing
Z pskovských nálezov sú zaujímavé predovšetkým amulety — zajace , objavené v Gdovskej mohyle .	zajace	8	Plur
Tieto slová básne sú melódiou toho , čo sme cítili v srdciach .	melódiou	4	Sing
Vláda v spolupráci s predstaviteľmi územnej samosprávy vytvorí transparentný inštitucionálny a finančný návrh na kofinancovanie regionálneho rozvoja z prostriedkov štátneho rozpočtu a z fondov EÚ .	kofinancovanie	14	Sing
Správa a privatizácia národného majetku	privatizácia	2	Sing
Jednu z tých , aké nevyvolajú reakciu v podobe telefonátov zhora .	telefonátov	9	Plur
Ku konfliktom a nedorozumeniam výrazne prispelo aj to , že sa maďarské „ nemzet “ dá používať v oboch týchto významoch .	nedorozumeniam	3	Plur
Nestoja totiž v opozícií voči sebe na rovine ideí a ideológie , ale voči zástupcom orgánov svetských .	ideí	8	Plur
Na Makovej lúke sa nič nedialo , a tak zamierila do lesa .	lúke	2	Sing
Tieto slová básne sú melódiou toho , čo sme cítili v srdciach .	srdciach	11	Plur
Strachu z pasce ma zbavil ošetrovateľ .	Strachu	0	Sing
Moji rodičia sa báli .	rodičia	1	Plur
“ Chcete povedať , že som herec ? “ pýtal sa Pinocchio .	herec	6	Sing
Keď Jazmína vošla na chodbu , čo viedla do prijímacej siene , zjavil sa nesmierne rozrušený sultán .	chodbu	4	Sing
Maja zaviedla hostí na slávnostne vyzdobenú lúku a ponúkla im vyhliadkový let s vážkou , medové guľôčky , cukrovú vatu a mnoho iných dobrôt .	hostí	2	Plur
Džin im naliali do porcelánových šálok bez ucha .	šálok	5	Plur
Z televíznej obrazovky zaznel zúrivý , ohlušujúci rev .	obrazovky	2	Sing
Oprela som sa o čalúnené sedadlo a vtom Mustang zrýchlil .	sedadlo	5	Sing
V ten deň som sa ho nedozvedel , lebo dievčatko ku mne opäť zaujalo nepriateľský postoj drobnej šelmy .	dievčatko	9	Sing
Vlastne patril do početného týmu odborníkov , ktorý pripravoval jedenáste vydanie Slovníka newspeaku .	odborníkov	5	Plur
Za okamih boli preč a na lúčke opäť zavládol mier .	okamih	1	Sing
Potom otočil ktorýmsi vypínačom a hlasy zmĺkli .	hlasy	5	Plur
Profesor Eugen Jóna , ktorý sa dejinami spisovnej slovenčiny dlhé roky zaoberal , si uvedomil potrebu dať do rúk slovenskej i medzinárodnej vedeckej verejnosti dostatočne prístupný skutočný text tohto základného diela .	dejinami	6	Plur
Kým sa obliekala , v chodbe zazvonil telefón .	telefón	7	Sing
Na oslavu prišli všetci olympskí bohovia a priniesli množstvo nádherných darov .	darov	10	Plur
Naši žiaci a rodičia sú pobúrení .	rodičia	3	Plur
Pomyslel som si , že to musí byť nejaký omyl .	omyl	9	Sing
Srdce mu poskočilo .	Srdce	0	Sing
Priznanie bolo len formalitou , zato mučenie bolo ozajstné .	Priznanie	0	Sing
Predo mnou sa týčila iná socha , socha Vladimíra Iľjiča Lenina .	socha	5	Sing
Keby som tade išiel ako dieťa , určite by som mal chuť zavolať kamarátov z dvora a ísť sa tam hrať „ dole - dole “ .	kamarátov	13	Plur
Ostatné decká mali prísť až o polhodinu , a tak som mala celý bazén pre seba .	decká	1	Plur
Kôň sa pásol so sklonenou hlavou a dýchal na Vilka teplo .	teplo	10	Sing
Na prvý pohľad je tu zrejmá podobnosť so znením kánonov , ktoré sa týkajú rehoľníkov .	kánonov	9	Plur
Keď zástup Japoncov odišiel , v uchu sa mi opäť rozozvučal smútočný motív trúby .	zástup	1	Sing
Nádvorie zahalil obrovský tieň .	Nádvorie	0	Sing
Podráždene meditoval o materiálnych stránkach života .	stránkach	4	Plur
Od ľaku urobil Vilko kotrmelec .	ľaku	1	Sing
Viečka sa roztvorili .	Viečka	0	Plur
Okolo nej , nad ňou i pod ňou boli ďalšie davy pracovníkov s nepredstaviteľným množstvom úloh .	pracovníkov	11	Plur
Podľa N . M . Tichomirova ide len o označenie ich sociálneho postavenia , my však vyslovujeme domnienku , že ide o pozostatok matriarchátu , zvlášť silného u ugrofínskych plemien .	označenie	9	Sing
Vláda bude analyzovať možnosti zavedenia rovnej dane .	zavedenia	4	Sing
Vodné vtáky teda i kačky sú späté s kultom slnca , keďže svojim jarným príletom zvestujú vzrast jeho moci .	príletom	14	Sing
Ani Izraelci neboli na púšti naveky .	púšti	4	Sing
Má osem riadkov .	riadkov	2	Plur
Spytovaní náhodní chodci i sociológovia a ďalší odborníci sa vzácne zhodli .	chodci	2	Plur
Bol by som nerád , keby mi bezočivá penica uchmatla tučnú korisť .	penica	8	Sing
Pri rešpektovaní špecifík poľnohospodárskej výroby vláda bude podporovať rozvoj voľného trhu s agropotravinovými výrobkami a slobodnú konkurenciu v poľnohospodárskom podnikaní .	výrobkami	13	Plur
Došlo mi , že po celý čas nad nami visel oveľa výraznejší dôkaz božskosti Mira Šatana .	božskosti	13	Sing
Rovnako prirodzené bolo , že zablúdila očami k fľaši s vodkou značky Smirnoff na stole .	vodkou	10	Sing
Tisíce áut .	áut	1	Plur
Keďže mu nechceli odpovedať na otázku , Hádes sa uchýlil k lichôtkam .	lichôtkam	11	Plur
Vláda prijme strednodobý komplexný programový dokument rozvoja regiónov , zabezpečí prípravu , prerokovanie a schválenie plánovacích a programových dokumentov v oblasti regionálnej politiky s dôrazom na zlepšenie ekonomickej a sociálnej súdržnosti a prehĺbi uplatňovanie princípu partnerstva .	regiónov	7	Plur
Neveril som vlastným ušiam .	ušiam	3	Plur
Prišiel očakávaný odkaz .	odkaz	2	Sing
Oficiálne sa partneri nikdy nezmenili .	partneri	2	Plur
Miznem v temnej priepasti , v roztvorených ústach pohlcujúcich rieku času .	ústach	7	Plur
Rutherford mal mohutnú postavu , hrivu mastných , sivých vlasov , zjazvenú tvár s vačkami pod očami a hrubé negroidné pery .	vlasov	9	Plur
Návrh systému finančného vyrovnávania bude zohľadňovať princíp solidarity a motivácie .	solidarity	7	Sing
Prvým stupňom boli archeologické vykopávky svojou uchopiteľnosťou zhmotňujúce rozplývavé symboly starých povier a zároveň ich presne lokalizujúce .	vykopávky	4	Plur
Na chvíľu privrel viečka .	viečka	3	Plur
Zato na perách mal akýsi poprašok .	perách	2	Plur
Poslušne som sa za ňou vliekla a zaháňala myšlienky na matematické rébusy , čo ma doma čakajú .	myšlienky	8	Plur
Od tých čias bola mojím najvzácnejším pokladom , i keď miestami zodratým , ale na okrajoch som cítila šampónovú vôňu jeho vlasov .	okrajoch	15	Plur
Svoju neforemnú topánku presunula o pár centimetrov a naschvál dodrúzgala konárik .	topánku	2	Sing
Objavil sa pri dverách obchodu , zdvihol ruky a povystieral sa .	obchodu	4	Sing
/ Vypitie čaše vína na schodisku chrámu pripomína obrady pohanských kolektívnych hostín , tzv . „ bratčín “ .	hostín	11	Plur
Sprevádzali ho ďalší štyria strážcovia s vytasenými mečmi .	strážcovia	4	Plur
Spomenula som si na mamu , ktorá pracovala na dvoch miestach , aby vládala platiť účty .	účty	15	Plur
Vláda bude podporovať politiku multifunkčného poľnohospodárstva a jeho krajinotvorné , enviromentálne a kultúrne funkcie , podporovať rozvoj vidieckej infraštruktúry a vidieckeho turizmu .	infraštruktúry	18	Sing
V oblasti prepravných povolení v cestnej doprave sa realizuje nový transparentný systém založený na princípe nárokovosti pri splnení požadovaných kritérií a podmienok	kritérií	19	Plur
Nemôžeme sa skrývať za masu ani za tradíciu cirkvi , keď nás Kristus oslovuje na ceste nášho života .	tradíciu	7	Sing
Mladá žena sa usmiala a na lícach sa jej urobili jamky .	lícach	6	Plur
Delina by ma zaradila medzi šarlatánov .	šarlatánov	5	Plur
Vždy hulákaj s davom , to je moja zásada .	davom	3	Sing
Toto že má byť najsúcejší mladík z Aquitaru ?	mladík	5	Sing
Skvelá novinka pre fanúšikov hororej klasiky z roku 1973 .	fanúšikov	3	Plur
Sme ideozločinci .	ideozločinci	1	Plur
Na stenách viseli zaprášené police s prastarými knihami zaklínadiel a čarov .	čarov	10	Plur
Keď Tayerle povedal slovo dvojica , Chris sa otočil a spýtavo na mňa pozrel , pričom nadvihol obočie .	obočie	17	Sing
My sme mravce smelé , my sa nezľakneme .	mravce	2	Plur
Malé dieťa sedelo s ockom pri večeri .	ockom	4	Sing
Kalich zvončeka , kde strávila noc , sa knísal vo vetre a bolo tam chladno .	Kalich	0	Sing
Zaštebotal dobrý deň a cmukol mužovi na líce veľký uslintaný bozk .	mužovi	5	Sing
Od ľaku som nevládal vyriecť slova .	ľaku	1	Sing
Zmĺkol uprostred vety .	vety	2	Sing
Rovno nad hlavou !	hlavou	2	Sing
Na líci sa nachádza ruža so štyrmi lupienkami , obkolesená zložitou dekoratívnou obrubou .	ruža	4	Sing
Počul , ako sľubuje klamať , kradnúť , falšovať , vraždiť , rozširovať drogy , prostitúciu , a pohlavné choroby , liať deťom vitriol do tváre .	deťom	22	Plur
Po niekoľkých pokusoch Aziza pochopila .	pokusoch	2	Plur
Herkules medzitým navštívil v chráme Dia a predviedol milovanému otcovi svoje víťazstvá .	víťazstvá	11	Plur
Minule sa môj kolega Rado Ondřejíček fejtónovým perom pustil do problému hlupákov medzi nami .	hlupákov	11	Plur
Všetci traja sme sa hystericky rehotali na pozadí čudných tropických rastlín v plastových črepníkoch .	rastlín	10	Plur
Ležala som v posteli a po tvári mi stekali slzy .	tvári	6	Sing
Symbolickú úlohu má i výzdoba koníka — krúžky s bodkou uprostred sú ďalšou z mnohých modifikácií solárnych znakov .	modifikácií	15	Plur
Chris roztrhol jedno balenie , ale veľmi sa s ním nemaznal .	balenie	3	Sing
Bytová politika a príprava územia pre rozvoj bývania je prioritne úlohou obcí a miest .	obcí	11	Plur
Vláda sa bude usilovať o postupné zapájanie kapacít nášho obranného priemyslu do štruktúr európskeho obranného priemyslu .	priemyslu	10	Sing
Maja začala zostavovať mužstvo .	mužstvo	3	Sing
Zúril , až mu vlasy dupkom stáli .	vlasy	4	Plur
Vláda podporí dosiahnutie kritérií európskej úrovne stavania , kvalifikácie firiem , úspor energie a energetickej certifikácie budov .	úspor	11	Plur
Bzdocha a motýľ	Bzdocha	0	Sing
Pri Džafarovi sedela Jazmína so spútanými rukami .	rukami	6	Plur
Integrovaná územná ochrana	ochrana	2	Sing
Decentralizáciou kompetencií sa presunula podstatná časť zodpovednosti za rozvoj bývania na obce .	kompetencií	1	Plur
Skúsil som sa rozpomenúť na jej tvár .	tvár	6	Sing
O chvíľu ich už viedli k najlepšiemu stolu v záhrade Amirovej slávnej reštaurácie Kebab .	chvíľu	1	Sing
I ja mám občas dojem , že môj život riadia mamine nesplnené sny .	sny	12	Plur
“ Myslím na dnešné preteky , “ zaklamala som .	preteky	4	Plur
Za opáta Odona , Bernonovho nástupcu , sa potom vytvorili predpoklady , aby sa Cluny stalo strediskom skupiny kláštorov .	kláštorov	18	Plur
Vláda pripraví transformáciu štátnych zdravotných ústavov na inštitúcie verejného zdravotníctva so zvýraznením opatrení zameraných na zníženie , resp . vylúčenie rizika poškodenia zdravia .	inštitúcie	7	Plur
Očká zažmurkali .	Očká	0	Plur
Blúznivý prorok obrazov	obrazov	2	Plur
Maja s úžasom obdivovala jeho veľké krídla s červeným vzorom .	krídla	6	Plur
Ešte mu v ušiach znel smiech a potlesk divákov .	divákov	8	Plur
Podporením priestupnosti školského systému v oblasti prechodu žiakov na vyšší stupeň školy bez prijímacích skúšok , vláda minimalizuje podmienky na korupciu v školstve .	prechodu	6	Sing
“ Čakali , že aspoň jeden z nás pôjde v ich šľapajach .	šľapajach	11	Plur
Vraj pri takých veľkonočných oblievačkách chlapci najviac a najčastejšie oblievali najkrajšie dievčatá z dediny .	oblievačkách	4	Plur
Vláda bude podporovať programy v horších pôdnych a klimatických podmienkach a orientovať sa na mimoprodukčné funkcie poľnohospodárstva a agroturistiky .	agroturistiky	18	Sing
V rohu na sklápacom stole v pološere sa jasne lesklo sklené ťažidlo , ktoré tam kúpil na poslednej návšteve .	pološere	6	Sing
Zúčastniť sa mohol každý , kto mal krídla .	krídla	7	Plur
Postupne sa zdvíhanie a klesanie ich hrudí spomalilo a prešlo do normálneho rytmu a s príjemným pocitom bezmocnosti sa od seba oddelili .	rytmu	12	Sing
Cieľom rekodifikácie trestného práva bude prísnejší postih páchateľov násilných trestných činov a moderný trestný proces , ktorý bude rýchly a efektívny .	postih	6	Sing
V tejto kapitole budeme hovoriť o cirkevnoprávnych normách , ktoré reglementujú podmienky pre vznik , obsah a zánik manželstva .	normách	7	Plur
Preskúmal jej dlhé prsty , pekne vytvarované nechty , dlaň zatvrdnutú ťažkou prácou s množstvom mozoľov , hladkú pokožku pod zápästím .	prsty	3	Plur
“ Vari si môžem niekde chvíľu odpočinúť ! “ uštipačne odvetila .	chvíľu	5	Sing
Otvoril mešec a vysypal zlaté mince na zem .	mince	5	Plur
“ Ocko ! “ zvolala Ariela .	Ocko	1	Sing
Všetky zvieratká bežali do bezpečia , no Polly letela po zobák vody .	zobák	10	Sing
Takže , aké ohľady ?	ohľady	3	Plur
Ženu zachráni traktorista .	Ženu	0	Sing
Ženy a deti sledovali z úkrytu , ako sa muži skrývajú za Jumbom .	muži	9	Plur
Vláda podporí dosiahnutie kritérií európskej úrovne stavania , kvalifikácie firiem , úspor energie a energetickej certifikácie budov .	kritérií	3	Plur
Jeho kláštor musel mať dobrú povesť , lebo ako lotrinský vojvoda , tak aj flámsky markgróf mu odovzdali viaceré kláštory , aby v nich obnovil rehoľný život podľa reformných princípov .	princípov	29	Plur
Začiatkom 11 storočia bolo pomerne málo významným sídlom — nespomína sa napr . pri delení údelov Vladimírovým synom .	sídlom	7	Sing
Lulu , ošetrovateľka v ZOO pre mláďatká , zvieratká ľúbila .	mláďatká	6	Plur
Oči jej vystúpili z jamiek a z vyškerených úst vypadali všetky zuby okrem jedného .	úst	8	Plur
Mamina silueta stála vo dverách a obaja sme vycítili , že sa hnevá .	dverách	4	Plur
Z tohto hľadiska meriam obdobie svojho pobytu v Čarodejníckej vile podľa intervalov , v akých otec odpovedal na mamine listy .	intervalov	11	Plur
Posledný krok urobí na Ministerstve lásky .	Ministerstve	4	Sing
Marga neverila jej klamstvám , ja som ich prijímal .	klamstvám	3	Plur
Ešteže to spozorvali mravce a zavolali hasičov !	mravce	3	Plur
Dom bol v predstave vtedajších ľudí akýmsi mikrokozmom , svetom samým osebe s prepracovaným systémom magickej obrany pred zlými silami vonku .	mikrokozmom	7	Sing
Rímski reformátori totiž potrebovali inštrumentárium , prostredníctvom ktorého by zdokladovali oprávnenosť svojich požiadaviek .	inštrumentárium	4	Sing
Jan prichádza do kraja po zvestiach o zabití žien volchvami .	žien	8	Plur
Obzvlášť odvtedy , čo som sa presťahovala do prízemného bytu po mojej starej tete , ktorá chovala a vykrmovala túlavé mačky z celého sídliska .	mačky	20	Plur
Pozrela som na jedálny lístok vyvesený nad pultom , potom na zem a do výkladu .	lístok	4	Sing
Cez Bibliu sa ako červená niť tiahne hodnota človeka .	človeka	8	Sing
Chvíľu sa preťahovali , až napokon odlomili panvici rúčku .	Chvíľu	0	Sing
Zlá víla sa princovi Filipovi posmievala , no prezradila mu , že iba on môže zrušiť Zorničkinu kliatbu , ak ju pobozká .	princovi	3	Sing
Zaťal zuby .	zuby	1	Plur
Niečo mi zvieralo hrdlo .	hrdlo	3	Sing
Nazlostený Flip sa jediným obrovským skokom preniesol k pavučine .	pavučine	8	Sing
Na hlave mal klobúk a na krídlach vzácny vzor .	hlave	1	Sing
Si drúk , povedal som tomu ksichtovi v zrkadle .	drúk	1	Sing
Raz dostali prídel čokolády .	prídel	2	Sing
Winston ho pozoroval s akousi úctou .	úctou	5	Sing
Neskrývame však ani obavy a pochybnosti .	obavy	3	Plur
V ten večer som štyri hodiny písala prácu o intimite .	večer	2	Sing
Bol rehoľníkom v niekoľkých kláštoroch v Itálii i Hispánii , no oveľa viac ho priťahoval eremitský spôsob života .	kláštoroch	4	Plur
Odstránili sa odtiaľ všetky dvojvýznamy a významové odtiene .	dvojvýznamy	4	Plur
Vtom sa v temnici zjavili dobré víly .	víly	6	Plur
ODCHODY A návraty ĽUBOMÍRA Ďuroviča ( I . )	ODCHODY	0	Plur
To námestie bolo akousi stanicou .	námestie	1	Sing
Bála som sa , že keby som naznačila , po čom túžim , mama by si našla aj tretie zamestnanie .	zamestnanie	19	Sing
Aladin pristál na hromade šperkov .	šperkov	4	Plur
Odhrnula som mokré plavky , prázdne kokakolové plechovice , ceruzky , listy vytrhnuté z notesa a knižku Kto chytá v žite so somárskymi ušami .	ušami	23	Plur
Zasiahnutý netvor sa zmietal od bolesti a zletel zo skaly .	netvor	1	Sing
Proleti si zachovali ľudskosť .	Proleti	0	Plur
Šéf sa zo všetkých síl pokúšal , aby som odišiel z jeho pracovne spokojný , aj keď mi tú poviedku neuverejní .	Šéf	0	Sing
Negatívnych stránok je množstvo .	stránok	1	Plur
Podľa jej interpretácie sa otočila chrbtom kvôli mne .	chrbtom	5	Sing
Namiesto nich mal drobnú kartónovú škatuľku a v nej dva chrústy .	škatuľku	5	Sing
Vláda prehodnotí systém výkonu správy súdov , ktorý príliš zaťažuje sudcov administratívnymi činnosťami , osobitne pri štátnej správe jednotlivých súdov .	súdov	5	Plur
V prvom prípade po vytrhaní brady nasleduje vlečenie loďou a pomsta Janom najatých ľudí .	pomsta	10	Sing
Hra na hudobné nástroje , vozy ako prostriedok na prekonávanie vzdialeností by mohli svedčiť i o narážke na potulných hudcov ‐ igricov , ktorí sú chápaní v celoeurópskom kontexte ako elementy , rušiace zabehaný poriadok .	vozy	5	Plur
Kriminalisti dospeli k záveru , že ich napísali ženy .	Kriminalisti	0	Plur
Dej románu sa odohráva na nej alebo pri nej .	Dej	0	Sing
Novgorodské brezové listiny sú dnes uznávané ako neoceniteľný prameň pre poznanie života v tomto stredovekom meste .	listiny	2	Plur
On – Kristus je novou možnosťou orientácie , cestou znovuzrodenia , novej nádeje a lásky , ktorá hľadá tých , ktorí sú na ceste rezignácie , ubití ľudským egoizmom a hriechom .	možnosťou	5	Sing
V uplynulých rokoch ukázalo silný vzťah k demokratickým hodnotám a silu riešiť mnohé problémy .	hodnotám	8	Plur
Strana vyzýva jedinca , aby poprel svedectvo vlastných očí a uší .	uší	10	Plur
Radikálnou inováciou je hláskoslovie a tvaroslovie .	hláskoslovie	3	Sing
Bola tu celá reťaz zvláštnych oddelení , ktoré sa zaoberali proletárskou literatúrou , hudbou , dramatickým umením a vôbec zábavou .	oddelení	5	Plur
Dolnolotrinská reforma sa viaže predovšetkým k pôsobeniu Gerharda .	reforma	1	Sing
Nenadarmo platí " Sýty hladnému neverí " a zároveň neexistuje žiadne porekadlo typu " Ukojený nadržanému neverí " .	porekadlo	11	Sing
Poznala som aj všelijaké iné historky , podozvedala som sa ich , keď k mame chodili na návštevu ženy .	historky	5	Plur
Jednostaj prichádzali a odchádzali všakovakí väzni : distribútori drog , zlodeji , banditi , šmelinári , opilci , prostitútky .	drog	8	Plur
Štát tú časť pôdy , ktorá nebude potrebná ma výstavbu objektov a infraštruktúry celospoločenského významu , prevedie do vlastníctva obce .	výstavbu	9	Sing
V obvodnom kine , vzdialenom od centra , obyčajne premietali staré filmy .	filmy	11	Plur
V súlade s európskym trendom budeme podporovať rozširovanie výmery ekologického poľnohospodárstva a výroby biopotravín .	poľnohospodárstva	10	Sing
Teda je prirodzené , že zobrazenia dračích papúľ sú na novgorodských pamiatkach mimoriadne časté .	papúľ	7	Plur
Kôpka hnoja .	Kôpka	0	Sing
V ten deň , keď som sa prebudila chorá , som sledovala z obloka návrat osadenstva vily .	obloka	13	Sing
Ešteže to spozorvali mravce a zavolali hasičov !	hasičov	6	Plur
Datácia pečate vychádza z hypotetického predpokladu Izjaslavovej vlády v Novgorode v rokoch 1052 ‐ 1054 .	pečate	1	Sing
Bogomilstvo je totiž iba jednou z nepreberného množstva náuk , obsahujúcich prvky dualizmu .	náuk	8	Plur
V oblasti vodovodov a kanalizácií sa vytvoria podmienky pre podporu rozvojových aktivít v regiónoch s nedostatkom prirodzených zdrojov pitnej vody .	regiónoch	13	Plur
" To robí táto pliaga , " povedala , strhla si šarlátovú šerpu Antisexuálnej ligy mládeže a odhodila ju na konár .	konár	20	Sing
Vták opäť kývol lesklou čiernou hlavou .	hlavou	5	Sing
Malo sukničku z makových lupienkov a usmievalo sa .	lupienkov	4	Plur
Vo Zvedoch som robila vedúcu oddielu .	Zvedoch	1	Plur
Pôvodná hudba k muzikálu , alebo komédii : Princ egyptský	komédii	6	Sing
Zrakom som hľadala náš dom , ale všimla som si , že Chris sa na mňa díva .	Zrakom	0	Sing
“ Viete čo ? “ povedal Ferdo kamarátom .	kamarátom	7	Plur
Prísnosť uhorských „ protialkoholických “ kánonov a aj ich početnosť svedčia o Kolomanovej snahe vykoreniť z klerických kruhov neduh nadmerného požívania alkoholu .	kánonov	5	Plur
Neďaleko jazdil na koni mladý princ .	princ	5	Sing
Vo filiálke Petrovany sme mali koncom minulého roka dva milé zážitky .	zážitky	10	Plur
“ Musím si to prečítať odznova , “ povedala som , zúfalo listujúc v učebnici .	učebnici	14	Sing
Títo reformne naladení klerici sa stali najbližšími pápežovými spolupracovníkmi a poradcami .	klerici	3	Plur
Trkotali , sŕkali med a zapíjali ho pálenkou !	pálenkou	7	Sing
Zišlo mu na um , že až doteraz ho zrejme nevidela na voľnom priestranstve v plnom dennom svetle .	um	3	Sing
Najprv som sa rozprávala s ostatnými dievčatami , tváriac sa , že si ju nevšímam .	dievčatami	6	Plur
A ustúpil som nabok , aby mohla prejsť cez tesnú chodbičku .	chodbičku	10	Sing
V posledných mesiacoch žiletky patrili medzi nedostatkový tovar .	žiletky	3	Plur
Meg trápili starosti .	starosti	2	Plur
Vláda upraví rámcové podmienky regionálneho rozvoja decentralizáciou verejných financií a zavedie nový , efektívnejší systém finančného vyrovnávania sociálno - ekonomických rozdielov vyšších územných celkov .	celkov	23	Plur
“ Žobrákov nekŕmime , “ povedal sluha .	Žobrákov	1	Plur
Slávnosť s prekážkami	prekážkami	2	Plur
Máme tu teda ďalší argument pre to , aby sme kánony o celibáte z druhej kolomanovskej synody nepovažovali za prejav úplného príklonu k normám reformného pápežstva .	príklonu	21	Sing
Odtrhol som lesnú jahodu a položil ju ku kamennému prístrešku .	prístrešku	9	Sing
Vláda bude klásť dôraz na prehľadnosť , výkonnosť , spoľahlivosť a efektívnosť monitorovacieho a hodnotiaceho systému .	výkonnosť	7	Sing
Chodbu , po ktorej ich viedol , pokrýval jemný koberec , na stenách boli krémové tapety , biele drevené obloženie , všetko neskutočne čisté .	stenách	12	Plur
OSCAR ZA VIZUÁLNE EFEKTY	EFEKTY	3	Plur
Niekedy vzala do náručia Winstona a dlho ho bez slovíčka tisla k sebe .	náručia	3	Sing
Súčasťou reformy verejných financií bude aj zásadné sprísnenie poskytovania štátnych záruk .	poskytovania	8	Sing
Neuspokojme sa s tým , že sme poslali svojím blízkym veľkonočný pozdrav , ale ukážme im ako vyzerá život v nádeji vzkriesenia a víťazstva v Kristu .	víťazstva	23	Sing
“ Fajn , “ odvetil Chris , ale keď prechádzal okolo modelu , rozkrútil prstence Saturna .	prstence	14	Plur
Naozaj mi šťastie prialo .	šťastie	2	Sing
Mám z toho večera fotku .	večera	3	Sing
Mal som pred sebou prízraky .	prízraky	4	Plur
Keby som bol prehltol tú návnadu , moje postavy by ma boli priviedli do hrobu .	hrobu	14	Sing
V oblasti aktívnej politiky trhu práce bude vláda presadzovať princíp návratnosti a projektového financovania .	trhu	4	Sing
Zaplietla sa do niečoho neznámeho , ako keby ju lapila neviditeľná nitka .	nitka	11	Sing
Keďže ide o individuálnu záležitosť , škola v tomto dieťaťu veľmi nepomôže .	škola	6	Sing
Len čo to dopovedala , zniesol sa nad ňou modrý tieň , v ktorom stála ako v jazierku .	jazierku	17	Sing
Neváhal a rozhádzal všetky kamene , zničil všetky znamenia .	znamenia	8	Plur
V ten večer som štyri hodiny písala prácu o intimite .	hodiny	5	Plur
Z obdobia 11 storočia pochádza šestnásť kusov .	kusov	6	Plur
Šetrí aj pani ministerka financií , ktorá stále nevylučuje ďalšie zvyšovania cien a zodpovednosť za to prenechala na vedúcich úsekov ?	financií	4	Plur
Od strachu som sa schúlil v zadnej lavici .	lavici	7	Sing
Mlčky ho sledovala celá trieda .	trieda	4	Sing
“ Prevediete nás podzemnými chrobačími chodbami ? “	chodbami	5	Plur
A tak bocian polámal ľan zobákom .	zobákom	5	Sing
Páči sa mi tvoja myseľ .	myseľ	4	Sing
Rímski reformátori totiž potrebovali inštrumentárium , prostredníctvom ktorého by zdokladovali oprávnenosť svojich požiadaviek .	požiadaviek	12	Plur
Mala som tie najlepšie úmysly .	úmysly	4	Plur
Takýmito duchmi môžu byť medvede , vlky , zajace , jelene , kačky , orly , sovy a vrany .	duchmi	1	Plur
Makovej lúky sa totiž chceli zmocniť lúpežné mravce .	mravce	7	Plur
Na pomoc nám prišiel Brucháč s niekoľkými chrobákmi a onedlho sme mali obydlie pre Chuchlíka pod strechou .	chrobákmi	7	Plur
Voda špliechala o okraje a zamočila ležadlá pri bazéne .	Voda	0	Sing
Bežali kľukatými cestičkami , až prišli k prijímacej sieni .	cestičkami	2	Plur
Chris je najrýchlejší plavec v Delfíne , ale rekord v prsiach doteraz neprekonal .	prsiach	10	Plur
Chvíľu sme stáli vo dverách , pretože nás ovalil svieži závan klimatizovaného vzduchu .	závan	10	Sing
Vláda upraví rámcové podmienky regionálneho rozvoja decentralizáciou verejných financií a zavedie nový , efektívnejší systém finančného vyrovnávania sociálno - ekonomických rozdielov vyšších územných celkov .	financií	8	Plur
Slnečný svit , ktorý prenikal nespočetným lístím , ich ešte stále pálil na tvárach .	tvárach	13	Plur
Raz dokonca dostal balíček cigariet .	balíček	3	Sing
V temnej miestnosti blikalo iba svetlo sviec .	sviec	6	Plur
Tá za desaťročia sústredeného výskumu vyprodukovala stovky monografických a časopiseckých spracovaní danej témy .	desaťročia	2	Plur
Sexuálne puritánstvo Strany im nikto nevnútil .	Strany	2	Sing
Vlastne patril do početného týmu odborníkov , ktorý pripravoval jedenáste vydanie Slovníka newspeaku .	newspeaku	12	Sing
A s pocitom viny za svoju neposlušnosť som sa na ňu po celý čas díval .	viny	3	Sing
Samonafukovačky sa pýšia výbornými izolačnými schopnosťami , vysokým komfortom pri ležaní a neprepúšťaním vlhkosti .	schopnosťami	5	Plur
Rozbehla som sa a skočila , pričom sa hladina rozbúrila ako po výbuchu .	hladina	8	Sing
Postupne mu však ten príval hudby vyhnal z mysle všetky špekulácie .	špekulácie	10	Plur
Na festivale sa predstavia rómske aj nerómske hudobné zoskupenia z celého Slovenska .	zoskupenia	8	Plur
Alebo spoločne spáchajú samovraždu .	samovraždu	3	Sing
Cvrčkovia dali signál a diváci celkom zmĺkli .	Cvrčkovia	0	Plur
Počula som tikanie nástenných hodín a vlastný dych .	dych	7	Sing
Postávali v tieni lieštiny .	lieštiny	3	Sing
Nákladné autá ešte stále prechádzali okolo a ľudia ešte stále na ne hladovo civeli .	autá	1	Plur
Samozrejme , že Maja s Vilkom zablúdili v jesennej hmle ako prví .	hmle	9	Sing
Ruky ma zúfalo boleli a na krátky , ale nepríjemný okamih som nadobudla dojem , že spadnem na nesprávnu stranu .	Ruky	0	Plur
Súčasťou návrhu bude aj kontrolný a monitorovací mechanizmus efektívneho využívania nástrojov podpory regionálneho rozvoja .	rozvoja	13	Sing
Vzala Maju za ruku a odviedla ju do miestnosti , kde boli samé medové plásty .	ruku	3	Sing
Potom sa vrhol do vody a rozpleštil sa na člne , až ma od smiechu rozbolelo brucho .	smiechu	14	Sing
Založil ho Vladimír Monomach medzi rokmi 1098 a 1103 ako kniežací zámok na sútoku riek Kľazmy a Nerli .	riek	14	Plur
Areál Zväzu spisovateľov smrdí močom .	močom	4	Sing
Svet víťazstva za víťazstvom , triumfu za triumfom : nekonečný nátlak , nátlak , nátlak na nervy moci .	nervy	16	Plur
Štát tú časť pôdy , ktorá nebude potrebná ma výstavbu objektov a infraštruktúry celospoločenského významu , prevedie do vlastníctva obce .	pôdy	3	Sing
“ Z nás sa nikdy nestanú piráti , “ hrdo vyhlásila Wendy .	piráti	6	Plur
V straníckych obchodoch každú chvíľu niečo chýbalo .	chvíľu	4	Sing
Ako predpokladal , pán Charrington nerobil s prenájmom izby nijaké drahoty .	drahoty	10	Plur
Pavol , ktorý bol do Fridy zaľúbený až po uši , sa zľakol a začal ju hľadať .	uši	9	Plur
Keď sme všetko spratali , odšuchatala som sa do obývačky a prepínala kanály na televízore .	kanály	12	Plur
Mauglí nezašiel ďaleko , keď sa zrazu ocitol na rozľahlej čistinke .	čistinke	10	Sing
Chutilo jedlo vždy takto ?	jedlo	1	Sing
Kolega mi porozprával o tejto epizóde práve v čase , keď moja mama dostala ten slávny list .	mama	12	Sing
Vytvoríme kapitálotvornú vrstvu , ktorá bude zárukou blaha ľudu , presvedčivo hlásal tvorca blaha svojich prívržencov .	blaha	7	Sing
Podľa N . M . Tichomirova ide len o označenie ich sociálneho postavenia , my však vyslovujeme domnienku , že ide o pozostatok matriarchátu , zvlášť silného u ugrofínskych plemien .	plemien	29	Plur
Utiekla z paláca pred nekonečným zástupom nápadníkov .	nápadníkov	6	Plur
Je veľmi pravdepodobné , že uhorskí zákonodarcovia formulovali príslušné právne normy o celibáte pod vplyvom výziev reformátorov .	celibáte	12	Sing
Táto výsada pannonhalmského opáta mohla byť už súčasťou originálej listiny .	opáta	3	Sing
Tu dnu , to vedel inštinktívne , sa svetlá nikdy nevypínajú .	svetlá	8	Plur
U dovážaných produktov zabezpečí elimináciu tých , ktoré nespĺňajú kritériá kvality a ktoré neprešli colným a daňovým vysporiadaním .	elimináciu	4	Sing
Abu sledoval , kam pozerá , a zbadal dievča .	dievča	8	Sing
Pozvala na ňu Blythe a Ricka a podávala moje obľúbené jedlá : zemiakovú kašu , pizzu , celozrnný chlieb , španielske chimichangas , makaróny so syrom a orechový koláč .	chlieb	18	Sing
Tak je po Jaroslavovom víťazstve položený základ novgorodských výsad , ktorí Novgorodcom garantujú ochranu pred kniežacími družiníkmi a Varjagmi / no zároveň zabezpečujú kniežaciu družinu pred ľudom / .	ochranu	13	Sing
Než však stačili vzlietnuť , obkolesila ich horda zelených mužíčkov .	mužíčkov	9	Plur
Chvíľu sme stáli vo dverách , pretože nás ovalil svieži závan klimatizovaného vzduchu .	dverách	4	Plur
Tá správa bola jasná : jej telo túži po mojom tele .	tele	10	Sing
Preto neskrývame obavy , či sa nechytí aj nás táto nemoc .	obavy	2	Plur
Osobitnú pozornosť bude vláda venovať vytváraniu podmienok pre činnosť Hasičského a záchranného zboru ako základnej zložky integrovaného záchranného systému .	zložky	15	Sing
Modlime sa a pomáhajme im na ich ceste , aby sa aj ich srdce zapálilo víťazstvom lásky , pravdy , nádeje a života .	pravdy	18	Sing
Pre Lulu prišla po hre najobľúbenejšia časť dňa . . . obed !	obed	11	Sing
Naše hlasy sa donekonečna odrážali od orosených skál .	hlasy	1	Plur
I . ostrihomská synoda nariaďuje , že únosca je povinný poskytnúť postihnutým majetkovú kompenzáciu a navyše má vykonať aj pokánie .	synoda	3	Sing
" To robí táto pliaga , " povedala , strhla si šarlátovú šerpu Antisexuálnej ligy mládeže a odhodila ju na konár .	šerpu	12	Sing
Na temnú chvíľu hrôzy už sčasti zabudol .	hrôzy	3	Sing
Si drúk , povedal som tomu ksichtovi v zrkadle .	zrkadle	8	Sing
Ako s kamošom .	kamošom	2	Sing
Chris otvoril kôš a vybral dve koly .	koly	6	Plur
Bola to vysoká plavovláska s rozpustenými vlasmi a modrými očami , pery mala trochu hrubé a namaľované na tmavočerveno .	vlasmi	6	Plur
Čím dlhšie som tam šliapala vodu , tým väčšia zlosť ma chytala .	zlosť	9	Sing
Iba na začiatku textu zbierky je akýsi tematický zoznam , pri jednotlivých častiach ktorého sú uvedené čísla „ kánonov ” , vzťahujúcich sa k tomu - ktorému tematickému okruhu .	kánonov	18	Plur
Nechal som televízor zapnutý a privliekol som sa k dverám bytu .	televízor	2	Sing
Shannon s Waynom sa hrabali vo vreckách , aby dali dokopy drobáky na prvú pizzu .	vreckách	6	Plur
Opice skákali z konára na konár a preskakovali koruny stromov , čo rástli pozdĺž brehu rieky .	konára	3	Sing
Takýmito duchmi môžu byť medvede , vlky , zajace , jelene , kačky , orly , sovy a vrany .	medvede	4	Plur
“ Vráťte sa , vy zlodeji ! “ hrmel za nimi predavačov zúrivý rev .	zlodeji	5	Plur
Na Jazmínino prekvapenie predavač vytiahol obrovský ostrý dlhý nôž .	predavač	3	Sing
V prvom variante som sa sústredil na epizódu s nohavičkami .	epizódu	7	Sing
“ Počkaj , až ochutnáš Safiyinu špecialitu , “ nadšene vravel , keď sluhovia kládli na stôl ťažký strieborný podnos s polguľovitým vrchnákom .	vrchnákom	22	Sing
V oblasti prepravných povolení v cestnej doprave sa realizuje nový transparentný systém založený na princípe nárokovosti pri splnení požadovaných kritérií a podmienok	povolení	3	Plur
A pred očami sa mi zjavila Lorina tvár .	očami	2	Plur
Na chvíľu ožiarilo murény oslnivé hrôzostrašné svetlo , no po chvíli sa rozprskli na tisíc márnych kusov .	murény	3	Plur
Napokon chytil vak a hodil mi ho na kolená .	kolená	8	Plur
Potom moje potešenie vystriedala určitá zvedavosť .	potešenie	2	Sing
Potom sa obrátila k bratom .	bratom	4	Plur
Maja vyskočila a urobila zopár drepov .	drepov	5	Plur
Videla som ju zopár ráz na plaveckých pretekoch , lenže nikdy nás nikto nepredstavil .	pretekoch	7	Plur
Lákal ho nádherný palác v diaľke .	diaľke	5	Sing
Siahol mu do vrecka na šatách a keď vytiahol ruku , mal na dlani veľký červený rubín .	rubín	16	Sing
Zjavilo sa mi vo sne a mne stále znie v ušiach jeho hlas .	hlas	12	Sing
Všetci by lavínu najradšej čo najrýchlejšie odstránili , no nevedeli ako .	lavínu	2	Sing
Tamojší zdravotník i Delina prišli do tej dediny z mesta .	dediny	7	Sing
Takéto neodborné opravy boli príčinou takmer každodenných mrzutostí .	mrzutostí	7	Plur
Nakukol pomedzi húštinu a uvidel troch tvorov v šatách namiesto kožušiny .	húštinu	2	Sing
Nevyšiel som ku dverám .	dverám	3	Plur
Do tejto kapitoly sme zahrnuli problematiku vzájomných vzťahov a kompetencií medzi laikmi a cirkvou .	kompetencií	9	Plur
Sama sa predsa rozhodla , že opustí družky .	družky	7	Plur
Zazrel bielko okolo dúhoviek Júliiných očí .	dúhoviek	3	Plur
On – Kristus je novou možnosťou orientácie , cestou znovuzrodenia , novej nádeje a lásky , ktorá hľadá tých , ktorí sú na ceste rezignácie , ubití ľudským egoizmom a hriechom .	lásky	14	Sing
Najprv sme sa pomaly a opatrne zakrádali k ich domu , ale potom sme prebiehali od lampy k lampe .	lampy	16	Sing
Chcel by som s tebou prebrať istú myšlienku , ktorá ma znepokojila len pred chvíľou , keď Irma odišla na letisko .	letisko	20	Sing
Na stoloch stáli všelijaké fľaštičky a v bankách bublali záhadné tekutiny .	fľaštičky	4	Plur
Ochrana zložiek životného prostredia	Ochrana	0	Sing
Sopky vreli , vyčíňali búrky a zemetrasenia , svet bol plný zmätku a veľkého zdesenia .	Sopky	0	Plur
Vláda zjednotí sadzby DPH pred vstupom do EÚ .	vstupom	5	Sing
Vilko stál v cieli so stopkami a meral čas .	stopkami	5	Plur
Nakoniec obrazovka môjho mozgu zhasla a uprostred nej zostal jeden žiariaci bod .	obrazovka	1	Sing
Sily sú vyrovnané — a tak sa začína „ mýtická súťaž “ .	súťaž	10	Sing
Možno to bola tlmená ozvena nevedomia .	nevedomia	5	Sing
Ale pozor bez povrázkov !	povrázkov	3	Plur
Po dlhom období dažďov vykúklo opäť slniečko .	dažďov	3	Plur
Keď práve nemala v ústach štipec na bielizeň , mohutným kontraaltom spievala :	ústach	4	Plur
Preleteli sme cez oddelenie topánok , kozmetiky , vyhli sme sa nápadne namaľovaným predavačkám , ktoré ponúkali masky , líčidlá a vzorky kolínskej .	líčidlá	19	Plur
Každý zo stupňov svätenia od ordinanda vyžadoval , aby spĺňal príslušné predpoklady na jeho získanie .	svätenia	3	Sing
Položil ruku na ciferník .	ruku	1	Sing
Za jej chrbtom mi zostala v zábere Talianova tvár .	zábere	6	Sing
Vláda pripraví transformáciu štátnych zdravotných ústavov na inštitúcie verejného zdravotníctva so zvýraznením opatrení zameraných na zníženie , resp . vylúčenie rizika poškodenia zdravia .	ústavov	5	Plur
Ľúbil som všetky ženy , s ktorými som mal pomer .	ženy	3	Plur
O chvíľu tam bola upratovacia čata mravcov .	mravcov	6	Plur
“ Vždy je tu taký zmätok ? “ spýtala sa Kasandry .	zmätok	5	Sing
Takéto okrádanie pokračuje , v iných formách , aj dnes .	formách	6	Plur
Medzi pretekármi pravdaže nchýbal ani Flip , ktorý mal v hľadisku spústu fanúšikov .	hľadisku	10	Sing
Na schodisku dupotali čižmy .	čižmy	3	Plur
Schuti som sa zasmiala , keď šaškoval na trávniku .	trávniku	8	Sing
Zároveň zabezpečí včasné a úplné informácie o stave životného prostredia a o príčinách a následkoch tohto stavu .	následkoch	14	Plur
TEÓRIA A PRAX	TEÓRIA	0	Sing
Dal priniesť koše kvetov , podnosy so sladkými včelími špicmi a jazmínové koláčiky .	špicmi	9	Plur
Zrazu ich však prerušilo hlasné a falošné vrzúkanie huslí .	vrzúkanie	7	Sing
Keby som ich mohla premeniť na chrobáky , obidvoch by som bez štipky milosrdenstva zabila .	chrobáky	6	Plur
Presvedčil Záborského , že správna slovenská výslovnosť je „ ľist “ .	výslovnosť	6	Sing
V oblasti vodného hospodárstva bude vláda legislatívnymi a organizačnými opatreniami zabezpečovať racionalizáciu a efektívnosť pôdohospodárskych činností .	činností	15	Plur
Práve poletovala medzi bielymi jazmínovými kvetmi a nevšimla si jemnulinké a tenulinké vlákna napnuté medzi konárikmi .	vlákna	12	Plur
U citlivejších osôb to môže spôsobiť zbytočné bolesti hlavy .	bolesti	7	Plur
Namiesto neho som objavil dve nečakané veci : svadobné šaty aj s vencom a fotografiu akejsi ženy .	vencom	12	Sing
Keď vystúpila z pásma žltkastého svitu a na chvíľu zastala na rozhraní medzi svetlom a temnotou , nemyslel som na to , že ide priamo ku mne , aby napravila chybnú interpretáciu vecí , ktorú vyprodukoval môj mozog .	svitu	5	Sing
Výučbu tancov povedie Jano Blaho , dôstojný nástupca Štefana Nosáľa na poste choreografa Lúčnice .	tancov	1	Plur
Zostupujúc do hĺbok duševných priepastí , ( seba ) obnažuje , bičuje ( sa ) .	hĺbok	2	Plur
Žiadne údaje o prípadných ďalších tunajších aktivitách Leva IX . , napríklad o snahách presadzovť refory , k dispozícii nemáme .	aktivitách	6	Plur
Abuov citlivý noštek vykrúcalo od najodpornejších pachov a jeho jemné ušká urážalo nedôstojné pokrikovanie .	ušká	10	Plur
Urobíme nejaké rozbory , určíme liečbu . . .	rozbory	2	Plur
Do základnej školy chodil v Kukovej , kde ukončil štyri triedy .	triedy	10	Plur
A hoci tú knihu ešte nedočítal , vedel , že práve toto je konečné Goldsteinovo posolstvo .	knihu	3	Sing
Vláda v spolupráci s predstaviteľmi územnej samosprávy vytvorí transparentný inštitucionálny a finančný návrh na kofinancovanie regionálneho rozvoja z prostriedkov štátneho rozpočtu a z fondov EÚ .	fondov	23	Plur
“ V lese nie je , “ povedala ozvena z lesa .	lese	2	Sing
Všade bolo ticho , až na jemné ale prenikavé cvrlikanie .	cvrlikanie	9	Sing
Ihneď ho zaliala teplá vlna úľavy .	vlna	4	Sing
Cieľom reforiem v sociálnom systéme je zníženie jeho zneužívania , odstraňovanie byrokracie a potláčanie korupcie .	odstraňovanie	10	Sing
Odhrnula som mokré plavky , prázdne kokakolové plechovice , ceruzky , listy vytrhnuté z notesa a knižku Kto chytá v žite so somárskymi ušami .	plavky	3	Plur
Veľký panter pozorne nastražil uši .	uši	4	Plur
O týždeň sme sa dozvedeli , že ju na rok vylúčili z fakulty .	týždeň	1	Sing
Symbolika kniežacieho znaku .	znaku	2	Sing
Chvíľu sa preťahovali , až napokon odlomili panvici rúčku .	rúčku	8	Sing
Potom Maju nežne pohladila po hlávke a vraví : “ Spoznáš krásny veľký svet , Maja , hrejivé slniečko a nádherné lúky plné kvetov .	hlávke	5	Sing
Dva ostrihomské kánony ustanovujú záležitosti okolo biskupov .	kánony	2	Plur
Čas uteká !	Čas	0	Sing
Menšie rozmery potešia pri balení .	balení	4	Sing
Starec zrejme zabudol na predsudky , ktoré mal proti celému litru .	litru	10	Sing
Chcel som poprosiť aj redaktorku , aby už nevyužívala repliky mojich postáv .	repliky	9	Plur
Nezávislosť sudcov a záruky jej zabezpečenia sú jednou stranou mince .	zabezpečenia	5	Sing
Vietor hvízdal v konároch a trápil sporadické , ufúľané krókusy .	krókusy	9	Plur
Na okraji studne sedel zelený žabiak s kockovaným klobúkom na hlave .	hlave	10	Sing
Takto nevyzerá ani autorka článku , ani kamarátova babka .	babka	8	Sing
Prirodzeným krokom v napĺňaní integračných ambícií Slovenska je vstup krajiny do Európskej menovej únie .	napĺňaní	3	Sing
Protiprávna vojna v Iraku , ktorú rozpútala nesvätá aliancia náboženských fundamentalistov , megalománov a kšeftárov , je cynickým výsmechom všetkých hodnôt , ktoré naša západná civilizácia pokladá za nedotknuteľné .	fundamentalistov	10	Plur
Avšak rodine malého paviána sa nepáčilo , ako sa Jane správa k ich mláďaťu a nazlostení začali dievčinu prenasledovať .	dievčinu	17	Sing
Oba tieto kánony zodpovedajú dávnej praxi latinskej cirkvi .	kánony	2	Plur
V širších súvislostiach to zasa podľa nás poukazuje na podobnosť postavenia franských panovníkov a Štefana I . vo svojich štátnych cirkvách .	súvislostiach	2	Plur
Keď Ferdovi muži zajali celé nepriateľské vojsko , aj hlavný veliteľ otrokárov vyšiel z podzemnej chodby .	otrokárov	11	Plur
Keď zaznela hymna , po lícach vyčerpaných hráčov sa kotúľali slzy .	lícach	5	Plur
Mozog mi pracoval na plné obrátky , keď som zvažovala , ktorá z možností je správna a meravou rukou som úhľadne zakrúžkovávala odpovede ceruzkou , úplne vlhkou od potu .	ceruzkou	23	Sing
“ To mi ver , “ odvetil a postrapatil Mauglímu vlasy .	vlasy	10	Plur
Ocitlo sa osamote s Lori a zo svojej skrýše všetko pozorne vnímalo : tvary Lorinho tela , jej dych , vôňu jej mäsa .	dych	18	Sing
Nimi vysvätení kňazi teda nie sú právoplatne vysvätenými a nemôžu teda veriacim sprostredkovať dary Ducha Svätého .	kňazi	2	Plur
Celkové dojmy z výletu ?	výletu	3	Sing
Ako bábky v tom divadle .	bábky	1	Plur
Položil som slúchadlo na vidlicu a uprel som zrak na telefón .	zrak	8	Sing
Finančne podporí rozvoj ľudských zdrojov a inštitucionálnej infraštruktúry regiónov , slúžiacej na realizáciu komplexnej regionálnej politiky .	regiónov	8	Plur
Nález železného kľúča od visiaceho zámku mohol súvisieť s už spomenutou ochrannou funkciou .	funkciou	12	Sing
A predsa , po prečítaní vedel , že nie je blázon .	blázon	10	Sing
Odtrhol rožtek balíčka .	balíčka	2	Sing
Chrisova mama zabalila chlebíčky po štyroch do plastovej fólie a ešte do alobalu .	chlebíčky	3	Plur
“ Tu je diera , “ zašepkala som a vybrala trs trávy , ktorý zakrýval vyčnievajúci stupienok z palmového dreva .	trs	10	Sing
“ A reči o tvojom starkom neber vážne .	reči	2	Plur
Večer sa zakutral pod perinu a sníval o akrobatoch .	perinu	4	Sing
Viedol ma ešte asi dvadsať metrov a tam zastal .	metrov	5	Plur
Bolesť opäť pominula .	Bolesť	0	Sing
Potom som sa po špičkách odkradla do kuchyne a potichu som vypla hodiny .	špičkách	4	Plur
Aj reformný kánonista Anselm uvádza vo svojej zbierke viacero nariadení o konaní synod .	synod	12	Plur
ZOO pre mláďatká	mláďatká	2	Plur
Zakrivenosť jeho chrbtice bola ohromujúca .	Zakrivenosť	0	Sing
Patrili do minulosti , do predrevolučných časov .	časov	6	Plur
Vláda vytvorí legislatívne a ekonomické podmienky pre ochranu a sprístupnenie audiovizuálneho dedičstva v súlade s príslušnými medzinárodnými dohovormi .	dohovormi	17	Plur
Mal deravú pamäť a musel sa pýtať Maji .	pamäť	2	Sing
JEDNÉHO DŇA SA PYŠNÁ KRÁĽOVNÁ SPÝTALA svojho zázračného zrkadla : “ Povedzže mi , ktože je najkrajší v našej zemi ? “	zrkadla	8	Sing
Po chodníku kráčali ľudia sem a tam .	chodníku	1	Sing
Sankcia teda obsahuje v sebe ako hľadisko trestné , tak aj hľadisko náhrady škody pozostalým .	Sankcia	0	Sing
Terk si začala priateľa väčšmi vážiť , ale Kerchak sa zlostil .	priateľa	3	Sing
Prvý z apoštolov patril v celom kresťanskom svete k mimoriadne uctievaným svätcom .	svätcom	11	Plur
A predsa ma Faika už nevolala do školy .	školy	7	Sing
Spevák skupiny sa s deťmi rozprával a pýtal sa ich na to , čo si myslia o Bohu .	deťmi	4	Plur
Vláda bude klásť dôraz na racionalizáciu nákladov spojených s realizáciou výkonov vo verejnom záujme v železničnej osobnej doprave a verejnej autobusovej doprave .	racionalizáciu	5	Sing
Poznal som aj ich kapsy a tašky .	kapsy	4	Plur
Potom sa pohodlne oprel a napil sa z fľaše .	fľaše	8	Sing
A on stále striehol na mramorových schodoch podstavca bez sochy .	schodoch	6	Plur
Mama pila doma , nikdy sa nestalo , že by sa vrátila z kravínov a razila alkoholom .	Mama	0	Sing
“ Nastavme si rovnako hodinky , “ povedal Chris .	hodinky	4	Plur
Rýchlo ju prezrela a zistila , že sa na svet pýtajú šteniatka .	šteniatka	11	Plur
Iná obsahová náplň priláka nový typ čitateľov , to je jasné .	čitateľov	6	Plur
Neveriacky som sa na ňu dívala , cítiac , ako ma zadúša od hnevu .	hnevu	13	Sing
Dej obidvoch týchto románov sa odohráva na bengálskom vidieku .	románov	3	Plur
Naše dotyky v tme boli len rozmarom .	tme	3	Sing
Na chvíľu zavládlo ticho .	ticho	3	Sing
“ Nijaké záhady sa nekonajú , “ odvetil Chris .	záhady	2	Plur
Vláda vypracuje a realizuje projekt transformácie štátnych podnikov lesného hospodárstva v pôsobnosti Ministerstva pôdohospodárstva SR na štátnu akciovú spoločnosť založenú podľa osobitného zákona .	podnikov	7	Plur
Pocítil som úprimnú potrebu plakať .	potrebu	3	Sing
Potom vložila ten lístok do zásuvky , vytiahla z nej kľúč s ťažkým bronzovým štítkom , na ktorom bolo číslo izby , a strčila mi ho do ruky .	lístok	3	Sing
Aj tlač bola akási rozhádzaná .	tlač	1	Sing
Najprv som začula , ako čosi v kríkoch zašumelo .	kríkoch	7	Plur
Základným prvkom reformy verejných financií bude zavedenie tvrdého rozpočtového obmedzenia v celom okruhu verejných financií .	obmedzenia	9	Sing
Prečo by vlastne tí mimozemšťania mali byť naši priatelia alebo nepriatelia , keď sa vyvíjali s úplne iným backgroundom , v inom kontexte , majú totálne iný spôsob dorozumievania , ich ciele a motivácie nechápeme ?	motivácie	33	Plur
Súžitie etník tu teda fungovalo na princípe spoločenstiev v ktorých jednotlivé zložky popri sebe slobodne existovali a zároveň sa ovplyvňovali , miešali a splývali .	zložky	11	Plur
Že Mečiar , suverénny víťaz prvého kola , v druhom kole bol spektakulárne odmietnutý , je spravodlivý trest za roky jeho vládnutia .	trest	17	Sing
Dal priniesť koše kvetov , podnosy so sladkými včelími špicmi a jazmínové koláčiky .	koše	2	Plur
Tam hodili Maju do väzenia , kde boli aj iné zvieratká .	zvieratká	10	Plur
Ťahal voz dovrchu naložený melónmi .	melónmi	4	Plur
Nemala som najmenšiu chuť rozoberať pred ním svoje zmätené pocity a zbabraný test .	pocity	9	Plur
Keď som ju začal ťahať k posteli , vymanila sa mi .	posteli	6	Sing
Holeňový vred mu natreli hojivou masťou .	vred	1	Sing
Na plece mu zľahka doľahla čiasi ruka .	ruka	6	Sing
Hrebene / okrem svojej prvotnej funkcie slúžili ako amulety na ochranu od zlých síl .	amulety	8	Plur
Stále padal hustý sneh s veľkými vločkami .	vločkami	6	Plur
Bolo to účinnejšie ako putá .	putá	4	Plur
Ak muža s tvárou umrlca odviedli o polnoci , bolo ráno , ak ráno , bolo popoludnie .	popoludnie	16	Sing
" My však na všetkých stupňoch život ovládame , Winston .	stupňoch	5	Plur
Stoly a stoličky boli prevrhnuté , vázy rozbité a obrazy viseli nakrivo .	obrazy	9	Plur
Dostal novú spodnú bielizeň a čistú súpravu kombinézy .	bielizeň	3	Sing
Priplávala som ku kovovým schodíkom a s námahou som vystupovala von , keď ma striaslo .	schodíkom	4	Plur
Náš dnešný spisovný jazyk je skutočným kompromisom medzi radikálnou normou štúrovcov a požiadavkami bernolákovcov i tradíciou českou či československou .	štúrovcov	10	Plur
Kerchak bránil rodinu proti zákernej mačke , zatiaľ čo ostatní členovia ho pozorovali zo stromov .	stromov	14	Plur
“ Toto je tvoja detská izba , neskôr dostaneš večeru , “ vysvetľovala mu Maja .	izba	5	Sing
Vnútil mi liace a koč s tým divým koňom .	koč	4	Sing
Bola to vysoká plavovláska s rozpustenými vlasmi a modrými očami , pery mala trochu hrubé a namaľované na tmavočerveno .	pery	11	Plur
V rohu na sklápacom stole v pološere sa jasne lesklo sklené ťažidlo , ktoré tam kúpil na poslednej návšteve .	ťažidlo	11	Sing
Podporením priestupnosti školského systému v oblasti prechodu žiakov na vyšší stupeň školy bez prijímacích skúšok , vláda minimalizuje podmienky na korupciu v školstve .	Podporením	0	Sing
Nemecký kráľ Henrich III . sa v lete nasledujúceho roku vydal do Ríma , aby sa dal korunovať za cisára .	lete	7	Sing
Vedel , že v neďalekej jaskyni žije vlčia rodinka , ktorej sa nedávno narodili mladé vĺčatá .	vĺčatá	15	Plur
Nesmieme strácať ani chvíľočku . “	chvíľočku	3	Sing
Zamestnanci Oddelenia záznamov nerozprávali o svojej práci radi .	záznamov	2	Plur
“ Podávajú sa raňajky , “ povedal .	raňajky	3	Plur
Keď sa zasa vrátili do triedy , pani učiteľka im prečítala zaujímavú rozprávku .	učiteľka	8	Sing
Postav ho na okrúhly stôl .	stôl	4	Sing
Rozhodol sa letieť za nimi a za trest , že naňho zabudli , vzal so sebou všetkých susedov .	susedov	17	Plur
Úzky ružový pás na oblohe ohlasoval príchod nového dňa .	príchod	6	Sing
Všetko som doň nahádzal bez ladu a skladu .	ladu	5	Sing
Chris ma chytil za ruku a kľúčik sme zvierali medzi dlaňami .	dlaňami	10	Plur
Vtedy som nemohol tušiť , že to mesto mi vybrala prozreteľnosť .	prozreteľnosť	10	Sing
Jej priebeh je možné zrekonštruovať zhruba takto — Pred obradom samotným bolo postavené obetisko s pôdorysom štvoruholníka so štyrmi stĺpmi v rohoch .	stĺpmi	19	Plur
Sopky vreli , vyčíňali búrky a zemetrasenia , svet bol plný zmätku a veľkého zdesenia .	zemetrasenia	6	Plur
Navrhli im , že ak chcú prežiť v nových podmienkach trhového hospodárstva , môžu predávať po tiranských chodníkoch cigarety alebo banány .	cigarety	18	Plur
Po analýze a vyhodnotení doterajších skúseností s pilotnými prevádzkami vláda vytvorí podmienky na jeho rozšírenie na všetky súdy .	prevádzkami	8	Plur
Pomaly , sotva lapajúc dych , kráčali vpred .	dych	4	Sing
Potom začul ďalší zvuk — ľudské hlasy !	hlasy	6	Plur
Navrhujem poradu skončiť .	poradu	1	Sing
Stále mala na sebe služobnú uniformu , čiernu sukňu a letnú bielu blúzku s krátkymi rukávmi .	blúzku	12	Sing
Levíčatá našli horiace ohnisko .	Levíčatá	0	Plur
Sedel na stoličke neprirodzene vzpriamene a jeho mocné prsia sa nadúvali a zachvievali , akoby mal čeliť nárazu vlny .	prsia	8	Plur
Jej priebeh je možné zrekonštruovať zhruba takto — Pred obradom samotným bolo postavené obetisko s pôdorysom štvoruholníka so štyrmi stĺpmi v rohoch .	rohoch	21	Plur
Tieto kulty a božstvá sú dedičstvom ich rasy , sú dôležitou súčasťou ich každodenného života na vidieku .	kulty	1	Plur
Nepočetní mladí muži v našom prefeminizovanom ročníku boli zväčša básnici .	muži	2	Plur
“ Často som brával Mauglího na potulky džungľou .	potulky	6	Plur
Aj reformný kánonista Anselm uvádza vo svojej zbierke viacero nariadení o konaní synod .	nariadení	9	Plur
Na inštalovanie sochy podobných rozmerov treba aj súhlas mesta .	súhlas	7	Sing
Ten nežiadal , aby som mu podal pomocnú ruku .	ruku	8	Sing
Rovnako pri dodaní či vyzdvihnutí fotografií ste ušetrení od úmorného vyčkávania v rade .	vyzdvihnutí	4	Sing
Rovnako prekvapujúco dobre vedela rozprávať bez pohybovania perami .	perami	7	Plur
Reforma verejných financií	financií	2	Plur
Na jeho základe sa bude financovať zdravotná starostlivosť nad rámec tzv . solidárneho balíka .	starostlivosť	7	Sing
Každá štvrť mala svojich bláznov .	bláznov	4	Plur
Pôjde najmä o precíznejšiu personálnu prácu , efektívnejšie využitie ich vlastných kontrolných a inšpekčných mechanizmov , ale tiež o uplatňovanie nových špecifických protikorupčných postupov .	mechanizmov	14	Plur
Zaujímavým náleziskom sú timerevské mohyly .	náleziskom	1	Sing
Jej učiteľka Kasandra hovorila o ľuďoch oveľa prívetivejšie .	ľuďoch	5	Plur
Mladí tancovali takmer v objatí a ja som musel chvíľu čakať .	Mladí	0	Plur
Zaburácal silný výbuch , ktorý akoby zodvihol vydláždený chodník ; na chrbát mu dopadla spŕška ľahkých predmetov .	predmetov	16	Plur
Vláda bude podporovať vývoj a šírenie výrobkov i služieb šetriacich životné prostredie a v rámci legitímnych trhových nástrojov hľadať možnosti podpory malým a stredným podnikateľom zvyšovať investície do „ čistej “ výroby a environmentálnych podnikateľských aktivít .	investície	26	Plur
Mal som koníka , mal som aj koč .	koníka	2	Sing
“ Vidíte , čo ste spravili ? “ zabzučala a starostlivo si kefovala jemné chĺpky na tele .	chĺpky	14	Plur
Chrobáčiky ju najprv utešovali , no potom sa rozhodli , že to povedia Maji .	Chrobáčiky	0	Plur
Nasleduje objavenie sa volchva v Rostove , udalosti v Polocku , sucho a Polovci .	udalosti	7	Plur
Prehľadal som vrecká na všetkých sakách a vo vnútornom vrecku jedného z kabátov som našiel fotografiu ženy .	sakách	5	Plur
“ Neskáč ! “ kričali naňho ženy a deti a muži zatiaľ uzatvárali stávky .	muži	10	Plur
Mama zdvihla hlavu a ja som uvidela jej vystrašenú tvár .	tvár	9	Sing
Dievča sa pozviechalo na kolená .	kolená	4	Plur
Jednostaj prichádzali a odchádzali všakovakí väzni : distribútori drog , zlodeji , banditi , šmelinári , opilci , prostitútky .	šmelinári	14	Plur
Nijaké šteklenie .	šteklenie	1	Sing
Po obidvoch stranách chodby boli dvere vedúce do izieb so štvorcifernými číslami .	izieb	8	Plur
Chúďa Maja ronila trpké slzy .	slzy	4	Plur
Vystúpenie veľkého množstva jeho bojových oddielov sa dalo chápať i ako pohanský nepokoj — prežitky predkresťanskej viery sa u Estóncov udržali neobvykle dlho .	prežitky	14	Plur
Následky nárazu bývali rovnako kruté .	Následky	0	Plur
Nechodieval k nemu nikto okrem stareny v širokých nohaviciach .	nohaviciach	8	Plur
Veď nás Duchom Svätým a pomáhaj nám prekonávať všetko , čo v EÚ a našom svete bude slúžiť smrti a zániku .	zániku	20	Sing
Spomenul som si na dve veci : na hysterickú eufóriu učiteľov po incidente , pri ktorom sa spomenulo meno mytologického božstva záhrobného sveta .	incidente	12	Sing
Ide o autografy Kosťu a Vojatu so schematicky načrtnutými krížmi .	autografy	2	Plur
Zavedieme stanovenie základných štandardov na financovanie a kvalitu sociálnych služieb , systém udeľovania licencií a kontroly , zrovnoprávnenie pre všetky inštitúcie poskytujúce sociálne služby .	financovanie	5	Sing
V Tayerleho teste nemala romantika miesto .	teste	2	Sing
“ Mal som iba dvoch zákazníkov , ženu a muža .	zákazníkov	5	Plur
Predavači tu núkali všeličo od výmyslu sveta — mosadzný riad , sladké datle i čerstvé ryby .	datle	12	Plur
Jedna ruka jej ovisla nabok , telo sa jej uvoľnilo .	ruka	1	Sing
Ministerstvo lásky nemalo okná .	okná	3	Plur
Zmĺkla som , lebo som si spomenula , ako sa moja mama pustila do pečenia aj po dvoch šichtách .	šichtách	18	Plur
“ Prosím , ja uznávam , že Ferdo je jednotka .	jednotka	9	Sing
Náš dnešný spisovný jazyk je skutočným kompromisom medzi radikálnou normou štúrovcov a požiadavkami bernolákovcov i tradíciou českou či československou .	požiadavkami	12	Plur
Hrebene / okrem svojej prvotnej funkcie slúžili ako amulety na ochranu od zlých síl .	Hrebene	0	Plur
Soni by ho zaradila do kategórie dedinských nafúkancov .	nafúkancov	7	Plur
Zahľadela sa mi do očí a spýtala sa , či ju beriem .	očí	4	Plur
Koordináciu európskej politiky štátu ako súčasti zahraničnej politiky bude zabezpečovať MZV SR v úzkej spolupráci s ostatnými ústrednými orgánmi štátnej správy .	orgánmi	18	Plur
Raňajky sa podávajú na prízemí , do deviatej .	prízemí	4	Sing
A uzlovým bodom všetkých právnych formúl , ktoré sa týkajú rozoberaných hnutí , je vzťah tohto spoločenstva k štátnej moci , t . j . stret sveta šamanistického dualizmu s predstaviteľmi kniežacej moci , zjednocujúcimi krajinu .	spoločenstva	16	Sing
Aj reformný kánonista Anselm uvádza vo svojej zbierke viacero nariadení o konaní synod .	konaní	11	Sing
“ Nádherne ti pristane k vlasom , “ dodala Blythe .	vlasom	5	Plur
Spory spoločenstva a okolia .	spoločenstva	1	Sing
Pod bielym strniskom starcova tvár očervenala .	strniskom	2	Sing
V dôsledku rímsko - centralistickej tendencie zbierok prevzali do nich zostavovatelia i viaceré úplne alebo čiastočne sfalšované texty , ktoré však svojím obsahom zodpovedali stanoviskám a snaženiam reformátorov .	zostavovatelia	10	Plur
V ranoarpádovských zákonníkoch nachádzame aj ustanovenia o Božích súdoch , iracionálnom dôkaznom prostriedku , ktorý sa v stredovekom súdnom konaní hojne aplikoval .	súdoch	8	Plur
Dochádza k revitalizácií pohanstva v bojarských kruhoch .	pohanstva	3	Sing
Obyčajne majú väčší objem ako klasické karimatky .	karimatky	6	Plur
Obrovský vysvietený lunapark s kolotočmi , kľukatými dráhami , hudbou , zábavnými hrami a množstvom vykrikujúcich ľudí .	dráhami	7	Plur
Pre svoju krátkosť a úryvkovitosť sa nedajú podrobiť podrobnejšej analýze .	analýze	9	Sing
Na chrbtici mu vystúpili kropaje potu .	kropaje	4	Plur
Stiahol páku a pokračoval :	páku	1	Sing
Nateraz sa uzavrel pred vzdialenejšími zvukmi a počúval len kvákanie , ktoré sa valilo z obrazovky .	zvukmi	5	Plur
Vďaka týmto skúsenostiam pre mňa teoreticky neexistovalo nijaké tajomstvo súvisiace s túžbami , ktoré nútia muža pokúšať sa o zblíženie so ženou .	skúsenostiam	2	Plur
Vtedy mi utkveli v pamäti dátumy , mená i dôležité udalosti z minulosti , medzi ktoré bolo neskôr ľahšie dokladať nové dátumy , mená i vzťahy .	mená	7	Plur
Štefan bol prinajmenšom od kanonizácie roku 1083 uctievaný ako apoštol svojho ľudu .	ľudu	11	Sing
Správu aktív bude v tomto systéme zabezpečovať súkromný sektor , výber správcu bude v plnej kompetencii občana .	aktív	1	Plur
Ide opäť o prívesky — amulety .	amulety	5	Plur
" Nemám na mysli priznanie .	mysli	3	Sing
Na druhej strane všetky špinavé práce robia politickí väzni .	väzni	8	Plur
Žena sa postavila na stupienok s katedrou , otvorila triednu knihu a začala čítať naše mená .	katedrou	6	Sing
Na druhej strane slovo Kominterna vnuká predstavu prísne štruktúrovanej organizácie a dobre zoštylizovanej ideologickej doktríny .	Kominterna	4	Sing
Vláda pripraví komplexnú analýzu zadlženosti verejného sektora .	sektora	6	Sing
Zaleteli k lesu , kde Svetlanka ukázala na uzučkú škárku v zemi .	zemi	11	Sing
Uprene si navzájom hľadeli do očí .	očí	5	Plur
Vo Zvedoch som robila vedúcu oddielu .	vedúcu	4	Sing
Zopár minút preskakovali z témy na tému , keď vtom ich rev z televíznej obrazovky vyzval , aby držali jazyk za zubami .	rev	11	Sing
Všimnime si audiotextové reklamy .	reklamy	3	Plur
Pri ceste postávali stopári a z fľašiek popíjali osviežujúce nápoje .	fľašiek	6	Plur
Abdullah pokrčil plecami .	plecami	2	Plur
“ Pravdaže , “ odvetila svätojánska muška a zasvietila jasnejšie .	muška	6	Sing
“ Má ťažký otras mozgu , “ určila sestra diagnózu .	mozgu	4	Sing
Do toho domčeka prichádzal každý večer človek .	domčeka	2	Sing
Odhrnula som mokré plavky , prázdne kokakolové plechovice , ceruzky , listy vytrhnuté z notesa a knižku Kto chytá v žite so somárskymi ušami .	plechovice	7	Plur
Chlapec mu prebehol prstom po hrdle .	hrdle	5	Sing
Prúd áut sa zastavil .	áut	1	Plur
Najmenšia drobnosť vás mohla prezradiť .	drobnosť	1	Sing
Maja zaviedla hostí na slávnostne vyzdobenú lúku a ponúkla im vyhliadkový let s vážkou , medové guľôčky , cukrovú vatu a mnoho iných dobrôt .	guľôčky	16	Plur
Áno , jej zmiznutie sa dá vysvetliť jednoducho a logicky .	zmiznutie	3	Sing
Znehybnel som s pohárom whisky v ruke .	pohárom	3	Sing
Vláda bude presadzovať zásady efektívneho a civilného riadenia ozbrojených síl .	zásady	3	Plur
Vytvorí podmienky pre elektronický obchod a bude posilňovať dôveru verejnosti k elektronickému obchodovaniu .	obchod	4	Sing
Všetky zvieratká bežali do bezpečia , no Polly letela po zobák vody .	bezpečia	4	Sing
Zvyšné zuby mu vytrhli a dali mu nové protézy .	zuby	1	Plur
Ja som vedel , že jej portrét sa nachádza medzi viečkami medailónu v skrini , kde sú uložené aj biele svadobné šaty so závojom .	viečkami	10	Plur
Na schodišti som mal opäť zvláštny pocit , že ma niekto sleduje , a znova som rýchlym pohybom otočil hlavu , akoby som ho chcel nečakane prekvapiť .	schodišti	1	Sing
Napokon usúdil , že najbezpečnejším miestom je kantína .	kantína	7	Sing
Zachvátil ma jeden z mojich depresívnych stavov a prepadol som sa do hlbín absurdnosti .	stavov	6	Plur
Na hlave mal klobúk a na krídlach vzácny vzor .	klobúk	3	Sing
“ Z očí mi vyhŕkli slzy .	slzy	5	Plur
Jeho obyvatelia odišli a ich odchod sledoval veľký zástup zvedavcov , obyvateľov našej štvrte .	štvrte	13	Sing
Toto pápežské privilégium bolo vlastne uznaním , že Cluny sú centrom okolo neho vytvorenej skupiny kláštorov , teda právnym podkladom existencie takéhoto spoločenstva rehoľných domov .	spoločenstva	22	Sing
Pršalo , slnko sa schovalo za mraky .	mraky	6	Plur
Nazvem ju Delina , podľa mena hrdinky .	hrdinky	6	Sing
Prísnosť uhorských „ protialkoholických “ kánonov a aj ich početnosť svedčia o Kolomanovej snahe vykoreniť z klerických kruhov neduh nadmerného požívania alkoholu .	početnosť	9	Sing
V úvode pasáže volchvi symbolizujú bielych šamanov , vysporiadávajúcich sa s čiernymi šamanmi .	šamanov	6	Plur
“ Strach z fyziky ? “ spýtal sa , akoby som povedala najväčšiu hlúposť .	Strach	1	Sing
Mauglí so supmi sa smiali , keď im tiger zmizol z dohľadu .	supmi	2	Plur
Z Odilonovho listu Štefanovi I . sa dozvedáme , že clunyjský opát a prvý uhorský kráľ boli vo vzájomnom styku už pred odoslaním tohto listu vzniknuvšieho medzi rokmi 1031 – 1038 .	odoslaním	22	Sing
Väčšie zlá sústavne unikali ich pozornosti .	pozornosti	5	Sing
Schmatol jeden z Winstonových zostávajúcich predných zubov palcom a ukazovákom .	ukazovákom	9	Sing
Silného človeka .	človeka	1	Sing
Boli tu velikánske depozitáre na uskladňovanie opravených dokumentov a skryté pece na ničenie pôvodných výtlačkov .	ničenie	12	Sing
Dobrovoľníci z rôznych organizácií pripravili bohatý program : divadelné , umelecké a hudobné dielne aj súťaže .	súťaže	15	Plur
“ Ty to dievča poznáš ? “	dievča	3	Sing
Vtedy mi utkveli v pamäti dátumy , mená i dôležité udalosti z minulosti , medzi ktoré bolo neskôr ľahšie dokladať nové dátumy , mená i vzťahy .	dátumy	5	Plur
Vo Winstonovi zápasili zvláštne pocity .	pocity	4	Plur
Predavači tu núkali všeličo od výmyslu sveta — mosadzný riad , sladké datle i čerstvé ryby .	ryby	15	Plur
Keď Šer Chán nenašiel v záhyboch Káaovho tela nič , zavrčal .	záhyboch	5	Plur
Vláda pripraví legislatívny rámec inštitucionálneho vzdelávania zdravotníckych pracovníkov prostredníctvom rezortu školstva s možnosťou postgraduálnej prípravy pracovníkov v zdravotníctve v školách a inštitúciách , ktoré získajú akreditáciu pre príslušný typ vzdelávania .	školách	19	Plur
Počul som , že noviny platia dobre , keď chcú .	noviny	4	Plur
V svetle lampy som uvidel agresívnu formu jej pŕs .	pŕs	8	Plur
Uchopil Winstona za rameno a obrátil ho tak , aby si hľadeli tvárou v tvár .	rameno	3	Sing
Inštitúciou , ktorej človek vďačí za to , že ho vo dne i v noci obklopujú dôverne informovaní špicli .	špicli	18	Plur
Kým som si to stačila uvedomiť , po tvári mi tiekli slzy a potichu som vzlykala .	slzy	11	Plur
V prípade , že z manželstva nevzišli deti , Strana nepovoľovala rozvod , zato podporovala odlúčenie .	Strana	9	Sing
Vtedy víly pochopili , že je načase , aby dievčine povedali pravdu .	víly	1	Plur
“ Pomôžem ti , “ povedala Chris , keď som sa snažila udržať rovnováhu na okennom parapete .	parapete	16	Sing
S korytnačkami .	korytnačkami	1	Plur
Zrazu od úžasu onemela .	úžasu	2	Sing
Vtom Stromboliho dobrá nálada akoby zázrakom zmizla .	nálada	3	Sing
Keď boli sviatky , chodil z domu do domu a oznamoval ľuďom , že majú ísť na mítingy .	mítingy	17	Plur
Karimatky Sú ľahké a praktické .	Karimatky	0	Plur
Zastavil sa pri lieskach a zbadal tam veveričku Barku .	veveričku	7	Sing
Majine jemné krídelká sa jagali ako perly a zlatisté telíčko na slnku len tak žiarilo .	telíčko	9	Sing
Môže ísť o toporčeky s predĺženým poriskom , ktoré boli v Škandinávií predmetom symbolizujúcim hromy vrhajúceho Thora .	hromy	14	Plur
Prvým príznakom jej existencie je pasáž o stvorení sveta . . .	pasáž	5	Sing
Výsady sice majú formu udeľovanej listiny , no v skutočnosti ide o zmluvný zápis , tvoriaci kostru tzv . najstaršej Pravdy .	listiny	5	Sing
Vodné vtáky teda i kačky sú späté s kultom slnca , keďže svojim jarným príletom zvestujú vzrast jeho moci .	kačky	4	Plur
Vnútri sa krásna kobylka rozdvojila a vyskočili z nej Bôľ a Zmätok .	kobylka	3	Sing
Mauglí tancoval Balúovi pred nosom a zrazu ho nečakane zasiahol do ňufáka .	nosom	4	Sing
Bolo tu pododdelenie televíznych programov s inžiniermi , producentmi a s celými tímami špeciálne vybraných hercov , lebo dokázali imitovať hlasy .	inžiniermi	6	Plur
Škola sa musí stať v regióne kultúrnym , športovým a spoločenským centrom obecnej komunity .	komunity	13	Sing
Vtáky spievajú , proleti spievajú , Strana nespieva .	Vtáky	0	Plur
Pokúsime sa teraz vyčleniť takéto opozície v rozoberaných úryvkoch .	opozície	5	Plur
Posledný szabolcsský kánon , ktorý sa venuje kláštornému životu nariaďuje opátom a mníchom , aby sa nezúčastňovali na kalendových sedeniach , ale aby prijímali oblácie ich účastníkov v kláštoroch .	sedeniach	19	Plur
Nepočetní mladí muži v našom prefeminizovanom ročníku boli zväčša básnici .	ročníku	6	Sing
VOJNA JE MIER	MIER	2	Sing
Alebo neprítomnosť .	neprítomnosť	1	Sing
Radža v košíku ticho zavrčal .	košíku	2	Sing
Ostatné včely pobijeme .	včely	1	Plur
Hrabala som sa vo vaku a hľadala som bundu .	vaku	4	Sing
“ Pomôžem ti , “ povedala Chris , keď som sa snažila udržať rovnováhu na okennom parapete .	rovnováhu	13	Sing
Naším zámerom je odstrániť najmä deformácie , ktoré zakladajú neopodstatnené nerovnosti medzi občanmi alebo zavádzajú do sociálneho systému cudzorodé prvky , akým je napríklad nesystémové včlenenie kúpeľnej starostlivosti do sociálneho poistenia .	deformácie	5	Plur
Zbadala ho na steble trávy , práve z orlíčka popíjal sladký nektár .	trávy	4	Sing
Vytvorí mechanizmy na získavanie a vyhodnocovanie informácií a odhaľovanie týchto prípadov .	informácií	6	Plur
Potom si ukryla tvár do dlaní .	dlaní	5	Plur
“ Môjmu kráľovskému uchu sa donieslo , že chceš ostať v džungli . “	uchu	3	Sing
Začala som výčitkami , ale teraz pokračujem radami do nového roku .	výčitkami	2	Plur
Protiprávna vojna v Iraku , ktorú rozpútala nesvätá aliancia náboženských fundamentalistov , megalománov a kšeftárov , je cynickým výsmechom všetkých hodnôt , ktoré naša západná civilizácia pokladá za nedotknuteľné .	hodnôt	20	Plur
Spoločne vyrazili jabĺčko babizne z ruky .	jabĺčko	2	Sing
VOJNA JE MIER	VOJNA	0	Sing
Zákon sprehľadní pravidlá pre plnenie úloh prenesených zo štátnej správy na územnú samosprávu a doplní sústavu zákonov týkajúcich sa územnej samosprávy .	pravidlá	2	Plur
Znak potom môžme vykladať ako zobrazenie vtáka s roztiahnutými krídlami a hlavou vysunutou dopredu .	Znak	0	Sing
Usadili sme sa pripravení sledovať oblohu .	oblohu	5	Sing
Myšiak v pasci	pasci	2	Sing
Ako prišiel krtko k nohavičkám	nohavičkám	4	Plur
Príčiny ochorenia úzko súvisia s nezdravým životným štýlom , svoju významnú úlohu zohrávajú alkohol , fajčenie , nedostatok pohybu , nadváha a obezita , stres , poprípade nedostatok zdravých potravín .	fajčenie	15	Sing
Medzitým prišlo na plaváreň zopár deciek z oddielu a ich hlasy sa ozývali po vykachličkovanom priestore .	deciek	5	Plur
Barbie ich s úsmevom sledovala .	úsmevom	3	Sing
Brat kantor pre vážne osobné dôvody nemohol prísť , preto brat farár sprevádzal nábožný spev na gitare spolu s mládežníkmi , ktorí poslúžili programom a vystúpili aj s osobným vyznaním .	mládežníkmi	19	Plur
Ja som vedel , že jej portrét sa nachádza medzi viečkami medailónu v skrini , kde sú uložené aj biele svadobné šaty so závojom .	závojom	23	Sing
V prúde krvi a slín mu z úst vypadli dve polovice zubnej protézy .	úst	7	Plur
Prsty sa jej skrivili a nechty sa premenili na zahnuté pazúriská .	Prsty	0	Plur
Z nálezov na Gorodišti sú zaujímavé predovšetkým miniatúrne toporčeky — amulety , známe zo Suzdaľa .	amulety	10	Plur
Základnými požiadavkami na všetky druhy podložiek na spanie sú tepelná izolácia a izolácia od vlhkosti .	požiadavkami	1	Plur
Sama zájdem do chalúpky k siedmim trpaslíkom .	chalúpky	3	Sing
Väčšina neskorších bádateľov sa uspokojila s jednoduchým reprodukovaním tohto zistenia .	reprodukovaním	7	Sing
Podišiel som k oknu , že sa spýtam svojich postáv , čo si o tom myslia .	postáv	9	Plur
Konečne nastal veľký deň a porota si obchádzala vystavené košíky .	košíky	9	Plur
Skvelý psychológ , vyvolávač hrôzy , zaklínač šialenstva .	šialenstva	7	Sing
Nie je jasné , či ide o hračky , alebo o idolčeky .	idolčeky	11	Plur
Vláda podporí dosiahnutie kritérií európskej úrovne stavania , kvalifikácie firiem , úspor energie a energetickej certifikácie budov .	budov	16	Plur
Usmiala sa na Kalifa , až sa jej na lícach zjavili jamky .	lícach	9	Plur
Nálezy pečatí umožňujú určiť autorstvo , pravosť a čas vzniku dokumentu , dopĺňajú tak informácie o ňom .	pečatí	1	Plur
Protiprávna vojna v Iraku , ktorú rozpútala nesvätá aliancia náboženských fundamentalistov , megalománov a kšeftárov , je cynickým výsmechom všetkých hodnôt , ktoré naša západná civilizácia pokladá za nedotknuteľné .	kšeftárov	14	Plur
V niektorých ohľadoch bola oveľa kritickejšia ako Winston a oveľa menej ochotná prijímať stranícku propagandu .	ohľadoch	2	Plur
Jediná nádej , že ju uvidím , bola virtuálna , závisela od toho , či sa rozhodne trápiť ma vo sne .	nádej	1	Sing
“ Ty nemáš otca alebo mamu ? “ spýtal sa Dizzy .	mamu	5	Sing
Tatko sa hneval na deti , lebo ukrutne vyvádzali , a mamka sa hnevala na tatka , že je precitlivený .	mamka	11	Sing
Na jednom z programov Českej televízie sa momentálne dá vidieť skvelá séria ľahkých , avšak nebulvárnych reportáží zo života s názvom Ta naše povaha česká .	séria	11	Sing
Zber uskutočňoval pomocou siete platených agentov .	Zber	0	Sing
Povrávalo sa , že aj samotného Goldsteina tam pred rokmi a desiatkami rokov niekoľkokrát videli .	desiatkami	11	Plur
Keďže sa prvýkrát vyskytuje počas Jaroslavovho námestníctva v Novgorode , nie je vylúčená možnosť nápodoby všemocného novgorodského vodného jaštera .	námestníctva	6	Sing
Ide v nich napospol o reglementovanie podmienok azylu pre zlodejov , ktorí utečú do kostolov .	zlodejov	9	Plur
Nastolíme po voľbách zmenu - odhalením zbohatlíkov , mafiánov , delikventov , korupčníkov a lobistov pri stálom sledovaní blaha občana .	delikventov	10	Plur
Herkules má ťažkosti ! “ vravela mu , keď ho odväzovala .	ťažkosti	2	Plur
Vláda pripraví stratégiu riadenia štátneho dlhu , ktorej realizáciou príde k zníženiu nákladov štátneho rozpočtu .	dlhu	5	Sing
Hltači mečov súperili s predavačmi šperkov o jej pozornosť .	mečov	1	Plur
“ Ako bolo včera večer ? “ vyhŕkla nahlas , keď som otvorila kuchynské dvere .	dvere	14	Plur
Unaveným krokom som vyšiel po schodoch nášho domu .	schodoch	5	Plur
Konkrétnym príspevkom k prevencii konfliktov a k udržaniu mieru bude aj naďalej aktívna účasť v medzinárodných mierových operáciách .	príspevkom	1	Sing
Takže väčšina účastníkov oslavy si nemohla uvedomiť súvislosti .	oslavy	3	Sing
Ani nemukla a bez pohnutia sa dívala na spiace dieťa .	pohnutia	4	Sing
Satan Krista na púšti pokúšal troma pokušeniami .	pokušeniami	6	Plur
Najprv Maja spoznala dobrého kamaráta , ktorý jej pripadal veľmi zvláštny .	kamaráta	4	Sing
Aby som sa dostal k vencu , musel som si vziať stoličku .	stoličku	11	Sing
Winston počul v hlave klokotanie krvi .	klokotanie	4	Sing
Odteraz sme jej rodičia , tak ju musíme niesť , “ povedala potom Vilkovi .	rodičia	3	Plur
Uhorskí zákonodarcovia vytvárali zákony a kánony v prvom rade s ohľadom na konkrétne domáce podmienky a snaženia reformátorov boli pre nich druhoradé .	zákonodarcovia	1	Plur
V estónskej rozprávke Hromovládcové gajdy je zasa zachovaný obraz starobylého dualizmu v postavách vládcu hromov Pikneho a vrchného čerta Vanatuhiho .	hromov	14	Plur
Vláda sa zaväzuje v praxi realizovať už schválenú dikciu Európskej charty regionálnych alebo menšinových jazykov .	dikciu	8	Sing
Arielini priatelia sú bezvýznamné morské červy !	červy	5	Plur
Vytvoríme kapitálotvornú vrstvu , ktorá bude zárukou blaha ľudu , presvedčivo hlásal tvorca blaha svojich prívržencov .	tvorca	12	Sing
Mám kŕčové žily a päť umelých zubov . "	zubov	6	Plur
Vláda bude pokračovať v znižovaní miery prerozdeľovania prostredníctvom verejných financií .	prerozdeľovania	6	Sing
Miesto pravdy ponúka nejasné , ale presvedčivé prísľuby .	pravdy	1	Sing
Len čo som ju uvidel , mal som pocit , že mi pripomína ktorúsi z hrdiniek klasickej ruskej literatúry .	pocit	8	Sing
So zábleskom nádeje častejšie myslel na O ' Briena .	zábleskom	1	Sing
Všetci vedeli , že na papieri sa každý kvartál vyrobili astronomické počty topánok , kým vari polovica obyvateľov Oceánie chodila bosá .	kvartál	8	Sing
Možnosť , že uverejním nejaký cyklus básní , som okamžite zavrhol .	Možnosť	0	Sing
Zodvihol pohár a opäť vystrel ramená .	ramená	5	Plur
kríž zo štyrmi bodkami na prekrížení znamená zasiate pole , symbol plodnosti .	bodkami	3	Plur
Tie obleky mi poskytli kľúč k riešeniu .	riešeniu	6	Sing
Deti sa veľmi tešili , keď Lulu kŕmila mláďatká .	mláďatká	8	Plur
Ako vlak , ktorý zišiel z koľají .	koľají	6	Plur
V ich národnom epose Kalevala nájdeme napr . starobylý výklad o pôvode sveta z vajca .	výklad	9	Sing
I . ostrihomská synoda rieši sčasti aj otázku práv a povinností opáta .	opáta	11	Plur
Na stole ležala strieborná tabatierka .	tabatierka	4	Sing
Winston zdvihol šálku džinu , chvíľku naberal odvahu a potom obrátil do seba to tekuté svinstvo , ktoré malo pachuť oleja .	šálku	2	Sing
Otočila som sa a medzi divákmi som zazrela Jilliných rodičov .	rodičov	9	Plur
Tá myšlienka mu v skutočnosti v mysli skrsla v podobe vidiny , skleného ťažidla , ktoré sa zrkadlilo na povrchu sklápacieho stola .	stola	21	Sing
V období vzniku uhorskej cirkevnej organizácie problém , či si uhorský kráľ uzurpoval práva prináležiace Apoštolskému stolcu , ešte nehral rozhodujúcu úlohu .	stolcu	16	Sing
Petrovi Tvorjata / list dvoch spolupracovníkov /	spolupracovníkov	5	Plur
“ Som včela , pane ! “ zvolala výhražne .	včela	2	Sing
Prvým stupňom boli archeologické vykopávky svojou uchopiteľnosťou zhmotňujúce rozplývavé symboly starých povier a zároveň ich presne lokalizujúce .	symboly	9	Plur
Kresťanská cirkev nemala v prvom storočí svojej existencie nejaký jednotný právny systém .	existencie	7	Sing
Ak ťažké kvapky zasiahnu jej jemné krídelká , môžu ju poraniť .	krídelká	6	Plur
Rudko mal hlavu na prasknutie .	prasknutie	4	Sing
Keď dedinskí nafúkanci z môjho ročníka uverejnili na jeho stránkach nejakú báseň , naparovali sa celý mesiac .	nafúkanci	2	Plur
Vtom si v prachu na cestičke všimol drobné šľapaje .	šľapaje	8	Plur
Vtom medzi nich skočil zo stromov Tarzan .	stromov	5	Plur
V procese obstarávania bude vláda dbať na transparentný systém nakladania s majetkom štátu .	obstarávania	2	Sing
Sadla som si vedľa neho a rukami som si objala kolená .	rukami	6	Plur
Namiesto nich mal drobnú kartónovú škatuľku a v nej dva chrústy .	chrústy	10	Plur
Pri príležitosti svojho odchodu a ukončenia zimného obdobia som vyhlásil , že zaplatím koňak všetkým , ktorí budú od dvanástej až do tretej poobede v kaviarenskej časti obchodu .	obchodu	27	Sing
Aj to mu naháňalo strach .	strach	4	Sing
Opice , čo držali Mauglího , sa zaškerili a pustili ho .	Opice	0	Plur
Slová týchto popevkov písal bez akéhokoľvek ľudského zásahu prístroj známy pod názvom " veršovač " .	zásahu	7	Sing
Od straníkov sa vyžadoval podobný názor , aký mali starovekí Židia , ktorí síce vedeli , že všetky iné národy uctievajú nepravých bohov , ale to bolo všetko , čo o nich vedeli .	národy	19	Plur
Takéto obavy som rázne zavrhol .	obavy	1	Plur
Šance na zachovanie výsledkov tunajších reforiem boli lepšie ako v Dolnom Lotrinsku , lebo tieto reformné strediská požívali citeľnú podporu svetskej aristokracie .	strediská	16	Plur
Vlci sa zhromaždili na Veľkej skale .	Vlci	0	Plur
Potom som oči otvorila a ponorená v tme som smerovala k odrazu mesiaca .	tme	7	Sing
Vláda bude presadzovať zrušenie systému maximálnych cien a zmenu kategorizácie úhrady liekov tak , aby obsahom solidárneho balíka bola v každej anatomicko - terapeutickej skupine aspoň jedna účinná látka .	úhrady	10	Sing
Všetky ďalšie uhorské právne normy , ktoré reglementujú život kláštorných spoločenstiev nachádzame potom až medzi kánonmi I . ostrihomskej synody .	normy	4	Plur
Po prehliadke hudobných skupín sa o zábavu postarajú dídžeji .	zábavu	6	Sing
Drobné žieňa s pieskovými vlasmi sa vrhlo na operadlo stoličky pred ňou .	žieňa	1	Sing
Omar odvrátil zrak .	zrak	2	Sing
Ten , ktorý pod jagavosť tém hodnú bestsellerov rozostavil pasce , v ktorých uviazol sám .	pasce	9	Plur
Vzdelanie sa stáva kľúčom k životnému úspechu , najlepšou investíciou do budúcnosti , účinnou prevenciou pred nezamestnanosťou , zločinnosťou , drogami .	investíciou	9	Sing
Prvý štvorec čokolády sa Winstonovi rozpustil na jazyku .	štvorec	1	Sing
Drôtené dvierka delila od jeho tváre len šírka niekoľkých dlaní .	dvierka	1	Plur
V širších súvislostiach to zasa podľa nás poukazuje na podobnosť postavenia franských panovníkov a Štefana I . vo svojich štátnych cirkvách .	panovníkov	12	Plur
Zmeny budú navrhnuté v súlade s európskou legislatívou tak , aby tieto zákony neboli prekážkou zvyšovania zamestnanosti a ekonomického rastu a zvýšili flexibilitu trhu práce .	Zmeny	0	Plur
Trávniky sa premenia na oceány bahna a autá uviaznu pred domami .	autá	7	Plur
Pošlem ťa do soľných baní . "	baní	4	Plur
Jednostaj prichádzali a odchádzali všakovakí väzni : distribútori drog , zlodeji , banditi , šmelinári , opilci , prostitútky .	väzni	5	Plur
Uvedomujem si to , takáto obhajoba prezrádza určitý komplex .	obhajoba	5	Sing
Pritom je známe , že remeslo kováčske bolo spájané s magickými šamanskými praktikami u mnohých národov — kováč a šaman sú z jedného rodu hovorí jakutské príslovie .	šaman	19	Sing
Znamenalo to , že mama ma nepustí do školy .	mama	4	Sing
Po špičkách som zišiel do salóna na prízemí , kde som na chvíľu zastal so zatajeným dychom .	chvíľu	12	Sing
Vláda pripraví legislatívne a finančné predpoklady pre vznik povinného kapitalizačného piliera dôchodkového systému .	predpoklady	5	Plur
Chodbu , po ktorej ich viedol , pokrýval jemný koberec , na stenách boli krémové tapety , biele drevené obloženie , všetko neskutočne čisté .	tapety	15	Plur
V súlade s európskym trendom budeme podporovať rozširovanie výmery ekologického poľnohospodárstva a výroby biopotravín .	trendom	4	Sing
Aladin však strčil nohu do dverí .	nohu	3	Sing
Gaston sa obrátil k zástupu dedinčanov , ktorí sa medzitým zhromaždili okolo neho .	dedinčanov	5	Plur
Chvíľu leteli , až pristáli v spustnutej záhrade , kde bola pod obrovskou smutnou vŕbou hlbočizná studňa .	vŕbou	14	Sing
“ Mauglí je v bezpečí , “ zakričal Dizzy Balúovi .	bezpečí	4	Sing
Šikovne využil pobyt folklórnych skupín a súborov z celého Slovenska v Bratislave , ktoré sem chodili na náklady Opusu alebo rozhlasu nahrávať platne .	platne	22	Plur
“ Kedykoľvek , “ odvetil Chris s úsmevom , zvrtol sa a plával k trénerovi .	úsmevom	7	Sing
Bežné prachovky naňho nestačia ” .	prachovky	1	Plur
Sú náznaky , že po duševnej stránke prežíva veľmi pochybné obdobie .	náznaky	1	Plur
Ženské bábky aj mužské bábky .	bábky	1	Plur
Lavdim Lavdoshaj sa konečne rozhodol , že mi uverejní jednu poviedku v poslednom septembrovom čísle .	čísle	14	Sing
Mravce roztiahli plachtu a razom všetko stíchlo .	Mravce	0	Plur
Bola špička a cez okienka som videla , že všetky sedadlá obsadili ľudia , čo pracujú v centre .	okienka	4	Plur
Ľudstvo svojou usilovnosťou prispelo k zrodu dvoch svetových vojen , ba v niektorých kútoch Zeme vojny pokračujú .	kútoch	13	Plur
Mal som pocit , že za známymi črtami tváre , ktorých som sa vo sne neraz dotýkal , sa skrýva akési tajomstvo .	sne	14	Sing
Slovná zásoba A sa vôbec nedala použiť na literárne účely a na politické a filozofické dišputy .	účely	9	Plur
Ochrannú funkciu mal krížik , zakončujúci ihlicu z mosadze .	mosadze	8	Sing
Chichúňala sa a s džbánom na hlave sa pobrala do osady .	džbánom	4	Sing
“ Ale keď kapitán Hook na tom trvá ! “ vysvetľoval John , starší z Wendiných bratov .	bratov	16	Plur
Ako starý priateľ tvojho nebohého otca považujem za potrebné , aby sme sa porozprávali celkom otvorene .	priateľ	2	Sing
Tradičnú retrospektívnu sekciu programovo každý rok napĺňajú filmy zástupcov jednotlivých krajín všetkých troch zúčastnených kinematografií .	filmy	7	Plur
“ No , dovoľte ! “ zvolal chrobák a ukázal svaly .	svaly	10	Plur
O ' Brien mu položil ruku na rameno takmer priateľsky .	ruku	5	Sing
Na nič spred začiatku šesťdesiatych rokov sa nepamätala a ( zo všetkých známych ) jediný človek , ktorý často rozprával o rokoch pred Revolúciou , bol jej starý otec .	Revolúciou	23	Sing
Vzájomné porovnanie takto vytvorených jednotiek umožní plastickejší pohľad na danú problematiku a odhalí nové súvislosti dávno známych faktov .	faktov	17	Plur
V džungli by ste nenašli šťastnejšieho tvora .	džungli	1	Sing
Fakt spomínaný oboma bádateľmi .	Fakt	0	Sing
Zrazu sa ma zmocnilo presvedčenie , že som to zbabrala , ani kytička sedmokrások ma nemohla utešiť .	sedmokrások	13	Plur
Netušila som , že počúvajú , ale zrazu všetci hýrili nápadmi .	nápadmi	10	Plur
Ja som si nemohla dovoliť také neprístojnosti .	neprístojnosti	6	Plur
Pred dvermi sa objavovali košíky s prekrásnymi plodmi od výmyslu sveta .	košíky	4	Plur
Baghíra prebehol po oboch brehoch rieky , až natrafil na topiaci sa člnok .	člnok	12	Sing
Zároveň dochádza k postupnému vyprázdňovaniu symboliky pohanských obyčajov .	vyprázdňovaniu	4	Sing
Jeden z najkrajších zážitkov bol neplánovaný , no o to milší .	zážitkov	3	Plur
Vtom si spomenula na poštového poslíčka Pavla , ktorý okrem správ roznášal po lúke dobrú náladu .	poslíčka	5	Sing
Oblečené mala nohavice a rolák .	nohavice	2	Plur
Veľká letecká súťaž	súťaž	2	Sing
Rozrývalo mi to dušu a ničilo nervy .	nervy	6	Plur
Začal som chodiť po izbe s telefónom v ruke .	ruke	8	Sing
Dostal novú spodnú bielizeň a čistú súpravu kombinézy .	súpravu	6	Sing
Jednou z najvýznamnejších úloh vlády bude reforma verejných financií .	úloh	3	Plur
Mal som pocit , že za známymi črtami tváre , ktorých som sa vo sne neraz dotýkal , sa skrýva akési tajomstvo .	črtami	7	Plur
Do slovenských častí Uhorska sa vtedy utiahla jedna časť českých emigrovaných protestantov a tu našli v používaní svoj vlastný spisovný jazyk presne tak , ako vo svojej českej vlasti .	protestantov	11	Plur
“ Určite hľadáte Fawada , obchodníka so šperkami , “ povedala , keď k nej podišli .	obchodníka	5	Sing
Mal na sebe krátke nohavice farby kaki a športovú košeľu .	nohavice	4	Plur
Vláda zabezpečí harmonizáciu a štandardizáciu informačných technológií a dátových štruktúr s cieľom vytvorenia podmienok pre prepojenie informačných systémov dopravy , pôšt a telekomunikácií s EÚ	telekomunikácií	22	Plur
Parsons , ktorého to bombardovanie číslami priviedlo až do akéhosi nedefinovateľného nadšenia , si vytiahol fajku z úst .	bombardovanie	4	Sing
Na stoloch stáli všelijaké fľaštičky a v bankách bublali záhadné tekutiny .	bankách	7	Plur
Napokon sme z kríkov vybrali Chrisov bicykel a pomaly sme vyšli na ulicu .	kríkov	3	Plur
Vláda prehodnotí systém výkonu správy súdov , ktorý príliš zaťažuje sudcov administratívnymi činnosťami , osobitne pri štátnej správe jednotlivých súdov .	správe	17	Sing
A slabých bytostí , ako bola mama .	bytostí	2	Plur
Urobíme nejaké rozbory , určíme liečbu . . .	liečbu	5	Sing
Otvorila som dvere .	dvere	2	Plur
Na plece mu zľahka doľahla čiasi ruka .	ruka	6	Sing
“ PÄŤ TELEFONÁTOV ! “ zvolala som , keď som zbadala , že doma v chodbe bliká svetielko na odkazovači .	chodbe	15	Sing
Naháňalo mi to strach .	strach	3	Sing
K tejto problematike patria podľa nášho názoru i právne normy , ktoré upravujú niektoré procesné záležitosti .	normy	9	Plur
Odpočívala na kraji bazéna a hompáľala nohami .	bazéna	3	Sing
Bronzová čaša , zdobená rúčkou s vtáčikom pripomína uctievanie vtákov u ugrofínskych národov — ak karelský poľovník zabil vtáka čakalo ho nešťastie .	uctievanie	8	Sing
Výsledkom bude , že v nijakej oblasti sa nespotrebuje viac zdrojov , ako na ňu bude vyčlenených v rozpočtoch , ktoré schváli NR SR , resp . jednotlivé samosprávne orgány .	rozpočtoch	18	Plur
Do ôsmej som vypil tretinu fľaše .	fľaše	5	Sing
Moja rodina má rôzne priezviská : Križiak , Kosec rožkatý , ale najčastejšie nám hovoria Kútnik .	priezviská	4	Plur
Svedčí o tom podobnosť pečatí č . 4 a 5 s pečaťami č . 6 až 9 patriacimi Izjaslavovým bratom Svjatopolkovi a Vsevolodovi .	pečaťami	11	Plur
Spratal neuveriteľné množstvo kukuričných placiek a mľaskal pritom a navyše ich zlostil híkavým smiechom .	placiek	4	Plur
Tamojší zdravotník i Delina prišli do tej dediny z mesta .	zdravotník	1	Sing
Je síce pravda , že nijaký súdruh Ogilvy nikdy neexistoval , ale zopár riadkov v tlači a niekoľko vyfabrikovaných fotografií čoskoro splodia jeho existenciu .	riadkov	13	Plur
Maja zaviedla hostí na slávnostne vyzdobenú lúku a ponúkla im vyhliadkový let s vážkou , medové guľôčky , cukrovú vatu a mnoho iných dobrôt .	let	11	Sing
Na dne oceána sa otriasali vraky lodí a potopené poklady .	vraky	5	Plur
Preto je väčšinou lepšie neplytvať energiou a vziať na vedomie cudziu paradigmu .	energiou	5	Sing
Čakal som v obývačke , mal som na sebe oblek s kravatou .	oblek	9	Sing
Stál tam v otrhaných šatách , aké nosieval , keď sa túlal po uliciach .	šatách	4	Plur
Sultána odhodilo nabok .	Sultána	0	Sing
Podpora podnikania a konkurencieschopnosti ekonomiky	konkurencieschopnosti	3	Sing
Aladin sa na chvíľu zamyslel .	chvíľu	3	Sing
Potom dodala známu vec s ujom a v priestore môjho mozgu zaburácalo slovo „ impotent “ .	mozgu	10	Sing
Jan prichádza do kraja po zvestiach o zabití žien volchvami .	zabití	7	Sing
“ To je lev .	lev	3	Sing
Jedného dňa povysávala všetky kancelárie s vypnutým vysávačom .	kancelárie	4	Plur
Svedčí o tom podobnosť pečatí č . 4 a 5 s pečaťami č . 6 až 9 patriacimi Izjaslavovým bratom Svjatopolkovi a Vsevolodovi .	bratom	19	Plur
Opice skákali z konára na konár a preskakovali koruny stromov , čo rástli pozdĺž brehu rieky .	Opice	0	Plur
Jediný , kto môže byť so mnou pred oltárom , si ty .	oltárom	8	Sing
Nikdy nebudú svoji .	svoji	2	Plur
Napokon chytil vak a hodil mi ho na kolená .	kolená	8	Plur
“ Sme kamoši .	kamoši	2	Plur
Chlap pochopí , že vlky môžu prísť každú chvíľu .	chvíľu	8	Sing
Bližšie pozri Dodatok . Ponoril pero do atramentu a potom chvíľu váhal .	chvíľu	10	Sing
Winstonovu čeľusť zovrela bodavá bolesť .	bolesť	4	Sing
Chcel som povedať tým civilistom , aby mi aspoň vysvetlili , čo odo mňa chcú .	civilistom	4	Plur
Základnými požiadavkami na všetky druhy podložiek na spanie sú tepelná izolácia a izolácia od vlhkosti .	podložiek	5	Plur
N . P . Lichačev bol tiež autorom jednej z prvých teoretických prác o uvedených pečatiach .	pečatiach	15	Plur
Jazmína sa vyštverala na vysokánsky štíhly kmeň jednej z najvyšších datľových paliem v kráľovskej záhrade .	paliem	11	Plur
Mal ohromnú prax zo školských novín Hrom .	novín	5	Plur
V svetle lampy som uvidel agresívnu formu jej pŕs .	formu	6	Sing
Vláda bude i naďalej venovať sústredenú pozornosť podpore efektívnych programov boja proti drogám .	programov	9	Plur
Bola som hrdá na to , čo som za posledné týždne dokázala a chcela som sa s ním o tú radosť podeliť .	týždne	10	Plur
Spojil ruky a ja som sa na ne postavila .	ruky	1	Plur
Aladin si všimol dve veľké mosadzné vázy .	vázy	6	Plur
Cez deň prichádzala do triedy a patrila mne .	triedy	4	Sing
Mala pravdu a ja som to dobre vedel .	pravdu	1	Sing
Podstatou clunyjskej reformy bolo spočiatku ( za Bernona ) obnovenie bezvýhradného dodržiavania princípov Regule sv . Benedikta .	princípov	12	Plur
O chvíľu prišiel k stánku chlapec v otrhaných zaplátaných šatách .	šatách	9	Plur
Dobre som poznal mená všetkých dobových talianskych spevákov aj všetkých futbalistov .	futbalistov	10	Plur
Za jeho stiahnutými mihalnicami sa pohyboval celý les prstov v akomsi tanci , vykrúcal sa a skrúcal , strácal sa jeden za druhým a znova sa objavoval .	tanci	11	Sing
Stalo sa to len včera večer a Rick sa určite pred chalanmi nevyťahoval , ako vlažne som ho odbila .	chalanmi	11	Plur
V niekoľkých sekundách po prebudení sen i spomienka , ktorá ho podnietila , splynuli v jeho mysli v jedno .	sekundách	2	Plur
Sklo je prirodzene náchylné rozbiť sa a plech nezaručuje odolnosť voči vlhkosti .	plech	7	Sing
Veľa včiel opustilo mesto s novou kráľovnou , aby niekde vo veľkom šírom svete založili nové včelstvo .	včiel	1	Plur
Toto spoločenstvo nám poskytlo hlboké zážitky , mnoho podnetov na zamyslenie , mnoho motivácie k modlitbám a pocit Božej prítomnosti .	modlitbám	15	Plur
Po skončení vlády prvého stredovekého západného cisára totiž v krajine ochabli štátne garancie dodržiavania zákonnosti .	garancie	12	Plur
Napokon ďakujem za vaše modlitby za zbor i nás duchovných pastierov .	pastierov	10	Plur
Potom zdvihol hlavu a pozrel sa do okna , pri ktorom som bol ja .	okna	7	Sing
Nálože jeho nenávisti explodujú .	Nálože	0	Plur
“ Neskáč ! “ kričali naňho ženy a deti a muži zatiaľ uzatvárali stávky .	stávky	13	Plur
U ugrofínskych národov fungoval orol ako predok a ochranca šamanov .	orol	4	Sing
Priplával k okraju a stiahol polystyrénovú dosku .	dosku	6	Sing
Keď víly nechali princeznú na chvíľočku v paláci osamote , zjavilo sa pred ňou jagavé svetlo .	víly	1	Plur
Zber uskutočňoval pomocou siete platených agentov .	agentov	5	Plur
Telo by malo mať šiju Jenny Elfman , ramená Courtney Love , zadok Jennifer Lopez , pupok Sandry Bullock a nohy Miry Sorvino .	šiju	4	Sing
Nastolíme po voľbách zmenu - odhalením zbohatlíkov , mafiánov , delikventov , korupčníkov a lobistov pri stálom sledovaní blaha občana .	zbohatlíkov	6	Plur
Svätá pravda .	pravda	1	Sing
“ Kým nebude jeho hlava visieť na múre môjho domu , dovtedy nebudeme v bezpečí . “	hlava	4	Sing
Všetky straníčky boli na jedno kopyto .	straníčky	1	Plur
Počas výletu bolo ponechané dosť času na voľno a osobné rozhovory .	rozhovory	10	Plur
Takýmito duchmi môžu byť medvede , vlky , zajace , jelene , kačky , orly , sovy a vrany .	vlky	6	Plur
A plagát s akousi kubistickou maľbou .	plagát	1	Sing
“ To je bomba ! “ povedal udivene .	bomba	3	Sing
Vláda pripraví legislatívny rámec pre zabezpečenie efektívnej činnosti zahraničnej služby , čo predpokladá aj zohľadnenie jej špecifík .	špecifík	16	Plur
Žije šťastne , nemá povinnosti a nič jej nechýba .	povinnosti	4	Plur
Tradičnú retrospektívnu sekciu programovo každý rok napĺňajú filmy zástupcov jednotlivých krajín všetkých troch zúčastnených kinematografií .	zástupcov	8	Plur
Je celkom možné , že ho pri odchode hliadka chytí ; možno už teraz naňho vonku čakajú .	hliadka	8	Sing
Zatiaľ čo silnejšie uviazal stužku a zavesil mi ju na krk , stála som na mieste .	stužku	4	Sing
Niekoľko dvojíc tancovalo , iní sa bavili pri stoloch a bolo tam veselo i príjemne .	stoloch	8	Plur
Zasa sa ukáže slniečko .	slniečko	3	Sing
Aladin pokrčil plecami .	plecami	2	Plur
Režíruje ho holandský režisér Dick Maas .	režisér	3	Sing
Pohanské povstania na Rusi v 11 storočí	povstania	1	Plur
Keď dedinskí nafúkanci z môjho ročníka uverejnili na jeho stránkach nejakú báseň , naparovali sa celý mesiac .	stránkach	9	Plur
Len čo stačil dobehnúť do úkrytu , z jaskyne vytrielila svorka vĺčat .	úkrytu	5	Sing
Snažila som sa zachovať rozvahu , ale u Favatovcov sa zažínalo jedno svetlo za druhým .	rozvahu	4	Sing
Mäso je neuveriteľne vynikajúco ochutené , mäkké , obloha čerstvá , hranolky " křupavé " .	hranolky	11	Plur
V prúde krvi a slín mu z úst vypadli dve polovice zubnej protézy .	polovice	10	Plur
Zrýchlil sa mi pulz a spomenula som si na sen , v ktorom ma bozkával .	sen	9	Sing
V oblasti vodovodov a kanalizácií sa vytvoria podmienky pre podporu rozvojových aktivít v regiónoch s nedostatkom prirodzených zdrojov pitnej vody .	vodovodov	2	Plur
V domčeku si odpočiniem .	domčeku	1	Sing
Prvky prírodného polyteizmu v Pateriku kyjevsko ‐ pečerského kláštora .	polyteizmu	2	Sing
Bojoval proti vykorisťovaniu v indickej spoločnosti , proti krviprelievaniu medzi hinduistami a moslimami , proti vojne , za politickú nezávislosť svojej krajiny .	moslimami	12	Plur
Zakrátko pochopil , že sú to zlodeji , čo im ukradli med .	zlodeji	6	Plur
Vláda bude pokračovať v transformácii železníc .	železníc	5	Plur
Vláda zruší poplatky za vyňatie pôdy z poľnohospodárskeho pôdneho fondu .	poplatky	2	Plur
Straníčky sa nikdy nefarbili .	Straníčky	0	Plur
Symbolickú úlohu má i výzdoba koníka — krúžky s bodkou uprostred sú ďalšou z mnohých modifikácií solárnych znakov .	krúžky	7	Plur
To je MOŽNO tá pozitívna stránka ROZDELENIA REPUBLIKY .	ROZDELENIA	6	Sing
Čiapky a iné prikrývky hlavy	prikrývky	3	Plur
Dlho som býval v brečtane , ktorý rástol na záhradnom domčeku .	domčeku	10	Sing
Spoza stola ma vytiahol smútočný pochod dychovej kapely .	kapely	7	Sing
Ďalším charakteristickým znakom gramatiky newspeaku bola jej pravidelnosť .	gramatiky	3	Sing
Hefaistos kul rýchlo blesky , ktoré bohom slúžili ako zbrane .	blesky	3	Plur
Blythe dobre vedela , že mama by ma pustila .	mama	5	Sing
Čarodejnica odhrnula vejúci plášť a dobré víly onemeli od hrôzy , keď zbadali Zorničku .	Čarodejnica	0	Sing
To malo obrovský národnozáchovný význam v druhej polovici XIX . storočia , keď maďarizácia reálne ohrozovala samotnú existenciu slovenského národa .	existenciu	17	Sing
Prehľad najvýznamnejších centier severnej Rusi .	centier	2	Plur
V dôsledku rímsko - centralistickej tendencie zbierok prevzali do nich zostavovatelia i viaceré úplne alebo čiastočne sfalšované texty , ktoré však svojím obsahom zodpovedali stanoviskám a snaženiam reformátorov .	texty	17	Plur
Namiesto toho urobila večeru , ako na zmierenie , a celú večnosť čakala , že sa vrátim .	večeru	3	Sing
Hmla je vlastne len jednou z podôb pary , vznikajúcej v parnom kúpeli , spomínanom v rozprávaní o vzniku sveta .	podôb	6	Plur
Pod gaštanom stálo niekoľko stolov a stoličiek a za živým plotom presvitala tehlová budova hostinca .	stolov	4	Plur
“ Nepoznám nikoho , kto dosiahol taký vysoký počet bodov .	bodov	9	Plur
Z toho človeka nevravel mozog , ale hrtan .	hrtan	7	Sing
HVIEZDY V HOLANDSKU	HVIEZDY	0	Plur
Mimoriadne príjemným spestrením je izolácia od terénnych nerovností .	nerovností	7	Plur
“ Tu opice hniezdia .	opice	2	Plur
Môj otec po jeho rozpade niekoľko týždňov nespal . . .	týždňov	6	Plur
Po záhrade poletovali mištičky , servítky ba aj stoličky .	servítky	5	Plur
Čo sa týka vzťahov Novgorodcov a podmanených ugro ‐ fínskych plemien , formálne podriadené kmene si zachovávali značnú dávku nezávislosti .	plemien	10	Plur
Kúsok chleba ešte stále ležal tam , kam ho odhodil muž bez brady .	chleba	1	Sing
Urobila som adventný veniec a zavesila na dvere .	dvere	7	Plur
Chvíľami mu na náprsenku kombinézy kvapol pramienok krvi .	náprsenku	3	Sing
Prišla i Maja , ktorá cítila zodpovednosť za Vilka .	zodpovednosť	6	Sing
Bratia Badunovci ustráchane prikývli .	Bratia	0	Plur
Považovala to za skvost vtipnosti a s potešením ho vzala do náručia .	skvost	3	Sing
A odišiel s tavlou pod pazuchou .	tavlou	3	Sing
Prívesky podobného typu boli nájdené vo vladimírskych kurganoch a v Jaroslavli .	Prívesky	0	Plur
Jedného dňa sa Gim objavil pri vchode do školy .	vchode	6	Sing
Bogomilstvo je totiž iba jednou z nepreberného množstva náuk , obsahujúcich prvky dualizmu .	prvky	11	Plur
Podala Aladinovi mincu .	mincu	2	Sing
Chvíľu ho nechali metať sa vo vode , no potom prilákali k studni muža , čo okopával záhradku .	Chvíľu	0	Sing
Obrovský vysvietený lunapark s kolotočmi , kľukatými dráhami , hudbou , zábavnými hrami a množstvom vykrikujúcich ľudí .	lunapark	2	Sing
“ Už sme v bezpečí ? “	bezpečí	4	Sing
Tí vo väčšine prípadov velebili filmy nakrútené podľa mojich scenárov .	filmy	5	Plur
Keď pred správami zaznela trúbka , vždy to znamenalo víťazstvo .	správami	2	Plur
Reformátori 11 . storočia však už dospeli k precíznejšej formulácii , ktorá , podľa nás , reprezentuje nimi presadzovanú snahu o čo najpresnejšie vymedzenie sfér vplyvu svetskej a cirkevnej moci .	Reformátori	0	Plur
V ruke mal obálku .	obálku	3	Sing
Začínali sa aj pochôdzky chlapa v zelenom vojenskom kabáte .	pochôdzky	3	Plur
Isté výhrady voči Závodszkého dielu sme pojali aj my .	výhrady	1	Plur
Transparenty , manifestácie , heslá , hry , spoločné výlety -- a podobné gebuziny .	výlety	9	Plur
Pečate so vzývajúcou formulou v staroruštine	staroruštine	5	Sing
Robili tak skôr mocní šľachtici , usilujúci sa o odtrhnutie časti krajiny / najpríhodnejším príkladom je tu uhorské povstanie Vathu roku 1046 v Bekeszi / .	šľachtici	4	Plur
Potrebujeme ľudí , ktorí budú ochotní počúvať svojho partnera , budú dostatočne vzdelaní na to , aby dokázali zaujať jasné stanovisko k mnohým problémom súčasnosti .	partnera	8	Sing
Prišli pokušenia , zvody a ony podľahli .	zvody	3	Plur
A uzlovým bodom všetkých právnych formúl , ktoré sa týkajú rozoberaných hnutí , je vzťah tohto spoločenstva k štátnej moci , t . j . stret sveta šamanistického dualizmu s predstaviteľmi kniežacej moci , zjednocujúcimi krajinu .	formúl	5	Plur
Bohatstvo a privilégiá sa najľahšie ochraňujú , keď majú spoločného vlastníka .	privilégiá	2	Plur
Rozoberané nepokoje sa odohrávajú v Beloozere , Novgorode , Suzdali , roku 1091 sa objavuje volchv i v Rostove .	nepokoje	1	Plur
Výsady sice majú formu udeľovanej listiny , no v skutočnosti ide o zmluvný zápis , tvoriaci kostru tzv . najstaršej Pravdy .	formu	3	Sing
A tu či inde sa v úplnej tajnosti nachádzali riadiace mozgy , ktoré koordinovali toto úsilie a určovali politickú líniu : rozhodovali o tom , že tento fragment minulosti sa zachová , tento sa sfalšuje a ďalší prestane jestvovať .	mozgy	10	Plur
Súžitie etník tu teda fungovalo na princípe spoločenstiev v ktorých jednotlivé zložky popri sebe slobodne existovali a zároveň sa ovplyvňovali , miešali a splývali .	etník	1	Plur
Smolenské kniežatstvo .	kniežatstvo	1	Sing
Táto kralická norma je dodnes základom spisovnej češtiny .	norma	2	Sing
Blythe mi požičala prekrásne hodvábne modré šaty a v trojici sme sa zjavili v piatok večer na plese .	šaty	6	Plur
Kaviareň preťal akýsi elektrický náboj .	náboj	4	Sing
Kvalitná a pevná čepeľ musí byť samozrejmosťou .	čepeľ	3	Sing
Princezná vzala tigríča do svojej postele .	postele	5	Sing
“ Ďakujem , pani Hutchinsonová , “ odvetila som naradostene .	pani	3	Sing
Naučil ju i zopár tónov a zakrátko už Jazmína zabávala hostí jednoduchou melódiou .	hostí	10	Plur
Srdce mu divoko bilo .	Srdce	0	Sing
Bolo to to dievča s tmavými vlasmi .	vlasmi	6	Plur
Prednosta podzemnej dráhy náhodou našiel starú čižmu , ktorá sa na tento účel výborne hodila .	Prednosta	0	Sing
Na lúke vrcholili prípravy na dožinkovú slávnosť .	prípravy	3	Plur
V prvom variante som sa sústredil na epizódu s nohavičkami .	nohavičkami	9	Plur
Poviedky typu Sexuálny nenásytník ani eseje ako Esej o vši nemali budúcnosť .	vši	9	Sing
Cieľom Strany nebolo len to , aby medzi mužmi a ženami nevznikali vzťahy vernosti , nad ktorými nemala moc .	ženami	10	Plur
Sám som zostal pri dverách od bytu .	dverách	4	Plur
Vláda podporí rozvoj základného a aplikovaného výskumu na vysokých školách ako nevyhnutnej podmienky na poskytovanie kvalitného vysokoškolského vzdelávania a na zabezpečenie dlhodobo udržateľného rozvoja spoločnosti .	výskumu	6	Sing
Po štyroch dolároch starec zjavne pookrial .	starec	3	Sing
Preskúmal jej dlhé prsty , pekne vytvarované nechty , dlaň zatvrdnutú ťažkou prácou s množstvom mozoľov , hladkú pokožku pod zápästím .	dlaň	9	Sing
Články , zaujímavosti , recenzie .	zaujímavosti	2	Plur
Vláda pripraví nový zákon o prírodných liečivých zdrojoch , o prírodných liečebných kúpeľoch a o prírodných minerálnych vodách .	zdrojoch	7	Plur
Po príchode „ trestnej výpravy “ však nepokoje už opadli a všetko bolo v poriadku — no príchodzích museli kolonisti živiť .	kolonisti	19	Plur
Spory spoločenstva a okolia .	Spory	0	Plur
Domorodcom prišlo vhod , že som sa ubytoval v tej izbe .	Domorodcom	0	Plur
Putá sa uvoľnili .	Putá	0	Plur
Začul prekrásny hlas Šípkovej Ruženky , ktorý sa niesol lesom .	lesom	9	Sing
Zostal som so slúchadlom v ruke a pozoroval som deti .	ruke	5	Sing
Jeho základnými zložkami budú školy odborného výcviku , poddôstojnícka akadémia a akadémia obrany .	školy	4	Plur
Naše prvé dobrodružstvo vtedy trvalo až do septembra .	dobrodružstvo	2	Sing
Ocitla sa v spleti úzkych uličiek , ktoré sa ponášali ako vajce vajcu .	uličiek	5	Plur
Pojem slavico - bohemicus zo začiatku XVIII . storočia je začiatok pojmu česko ( - ) slovenský .	pojmu	11	Sing
Euroázia je spojenec .	spojenec	2	Sing
Vláda vytvorí systémové legislatívne a inštitucionálne predpoklady pre riešenie medzipodnikovej zadlženosti a s ňou súvisiacich pohľadávok štátu a verejných inštitúcií .	pohľadávok	15	Plur
Mal som príležitosť poznať dievčinu , ktorá sa volala Lori , ale ona sa stratila .	dievčinu	4	Sing
Ministerstvo lásky nemalo okná .	lásky	1	Sing
V Teklinej pavučine	pavučine	2	Sing
Marketing deformuje naše vnímanie a chápanie pravdy .	vnímanie	3	Sing
Slovo „ idiot “ mi uviazlo v hrdle .	Slovo	0	Sing
Srdce mu v prsiach búchalo hrôzostrašne hlasito .	prsiach	3	Plur
Transparenty , manifestácie , heslá , hry , spoločné výlety -- a podobné gebuziny .	heslá	4	Plur
Prvým výskumníkom , zaoberajúcim sa novgorodskými pečaťami bol P . Lichačev , ktorý do roku 1917 objavil šesťsto kusov .	kusov	18	Plur
A už miešala v kotli vriacu tekutinu .	kotli	4	Sing
Zároveň svetská časť vládnúcej vrstvy prestáva mať záujem o monoteizmus vyjadrujúci myšlienku — jeden boh , jeden panovník .	boh	14	Sing
Preto szabolcsská synoda schválila niekoľko kánonov , ktoré ich mali brániť pred takouto ujmou .	kánonov	5	Plur
Vláda vytvorí systémové legislatívne a inštitucionálne predpoklady pre riešenie medzipodnikovej zadlženosti a s ňou súvisiacich pohľadávok štátu a verejných inštitúcií .	predpoklady	6	Plur
Opantal ho pocit únavy .	pocit	2	Sing
Išlo to ako na bežiacom páse .	páse	5	Sing
Zobrala ďalšie dve dievčatá , ostatných nechala tak a celé popoludnie špehovali dajakého čudáka .	popoludnie	10	Sing
Vtom dostal Aladin vynikajúci nápad .	nápad	4	Sing
Bola to esej o vši .	vši	4	Sing
Za slovenskú stranu sa tradične na organizácii prehliadky podieľa Slovenský filmový ústav a Asociácia slovenských filmových klubov , ktorá prostredníctvom MK SR udeľuje na prehliadke Hlavnú cenu Zlatý debut .	klubov	16	Plur
Ale aj hlupáci a blbci vedia na seba vziať rôznu podobu .	hlupáci	2	Plur
Niekto z mojich niekdajších šéfov , vedúcich kádrového oddelenia alebo veliteľov na vojenských cvičeniach .	cvičeniach	13	Plur
Pustil bicykel a vbehol na rozmoknutú trávu .	trávu	6	Sing
Nôž by mal minimálne obsahovať : veľkú a malú čepeľ , otvárač na fľaše a konzervy , rydlo , výhodné je , ak obsahuje dierovač , pílku na drevo , vývrtku , pinzetu .	rydlo	17	Sing
Bola noc a biele tváre a šarlátové transparenty zalievalo zlovestné svetlo .	transparenty	7	Plur
“ Pravdaže , poklad môj , “ odvetila mamička .	poklad	3	Sing
S úsmevom vstal a oprašoval si zodraté , vyblednuté levisky .	levisky	9	Plur
Winston dojedol chlieb so syrom .	chlieb	2	Sing
Sledoval som ju pohľadom , až kým sa nestratila v dave .	dave	10	Sing
Aladin sa zakrádal hore po schodoch s Abuom na pleci .	schodoch	5	Plur
Na všeobecné počudovanie sa prihlásil leňoch Vilko .	leňoch	5	Sing
Ku konfliktom a nedorozumeniam výrazne prispelo aj to , že sa maďarské „ nemzet “ dá používať v oboch týchto významoch .	konfliktom	1	Plur
Nastal bod obratu .	bod	1	Sing
U ugrofínskych národov fungoval orol ako predok a ochranca šamanov .	predok	6	Sing
Dochádza k revitalizácií pohanstva v bojarských kruhoch .	kruhoch	6	Plur
Nečakal som nijaké telefonáty .	telefonáty	3	Plur
“ Mal som iba dvoch zákazníkov , ženu a muža .	ženu	7	Sing
Vzdelanie sa stáva kľúčom k životnému úspechu , najlepšou investíciou do budúcnosti , účinnou prevenciou pred nezamestnanosťou , zločinnosťou , drogami .	nezamestnanosťou	16	Sing
Lístok do kina ?	Lístok	0	Sing
Chichúňala sa a s džbánom na hlave sa pobrala do osady .	hlave	6	Sing
Obaja rýchlo dýchali , ale okolo kútikov úst sa jej znovu objavil úsmev .	kútikov	6	Plur
Tentoraz oveľa viac sníval a vždy to boli príjemné sny .	sny	9	Plur
V Policajnom zbore sa zmení systém hodnotenia práce , ktorý bude akcentovať mieru spokojnosti občanov s činnosťou polície .	občanov	14	Plur
