وقد كانت الابحاث انطلقت عندما تشابهت التشكيات التي تقدم بها تجار افادوا انهم باعوا سلعا لثلاثة تجار استعملوا صكوكا بنكية كوسيلة للخلاص واتضح في ما بعد انها دون رصيد ومــزورة .	باعوا	13	Plur
وقال سوتومايور عندما تلقى نبأ تخفيف العقوبة : " كنت سعيدا للغاية واحتفلت مع بعض الاصدقاء ، ولم اكن اشك ابدا في براءتي " .	اشك	19	Sing
وكشفت الصحيفة ان موظفا كبيرا في وزارة الخارجية الفرنسية زار طرابلس مطلع الشهر الجاري وبحث مع القذافي تدخله مقابل " بادرة سياسية قوية " من قبل فرنسا .	زار	9	Sing
خال نفسه بمنأى عن الرياح نام على حرير الخصوصية ورفض أن يتغير .	خال	0	Sing
عاجل : الصين ترحب بالاعلان عن " خريطة طريق " الشرق الاوسط	ترحب	3	Sing
" اننا نطلب من اصدقائنا اعطاءنا فرصة كي نستكمل ما بدأناه ونفي بالتزاماتنا ، فمن باب اولى ان نساعد انفسنا ( . . . ) واننا نطلب منهم ان يثقوا بنا ومن باب اولى ان نثق بانفسنا .	نثق	35	Plur
ووصفت هذه المصادر الموقف السوري بأنه يتسم بديناميكية واضحة ربما ترسم صورة جديدة للسياسة السورية إزاء ملفات الإرهاب ، ومرحلة ما بعد الحرب العراقية ، والعلاقة مع المنظمات الفلسطينية ، والوجود السوري في لبنان وملف أسلحة الدمار الشامل .	يتسم	6	Sing
وذكرت الانباء ان الباب الخلفى للطائرة انفتح فجأة على ارتفاع 2200 متر فوق مدينة مبوجى - مايى .	انفتح	6	Sing
لقد بدا رئيس الحكومة في حديثه اول من امس كمن يقود سيارة تعج بسيّاح وسط ارض تحبل بالمفاجآت وتتهددها الهزات ، وعليه اقناع السائحين من اهل باريس - 2 بانهم في " الارض " الاكثر هدوءاً واستقرارا وثباتا .	تحبل	16	Sing
وتابع " لا نستطيع ان نتحمل هذا الامر اكثر من ذلك وفي حال لم تحرك السلطات ساكنا عليها ان تعلم ان لصبر السكان حدودا " .	تعلم	19	Sing
لكن مساعده اوضح للصحافيين " لن تحصل عملية افراج غدا ( الاربعاء ) " من دون ان يوضح ما هو " العائق البسيط الذي يجب تسويته قبل ذلك " .	يوضح	17	Sing
لأنه استبعد القوى الرئيسية المعارضة في المجتمع المصري ، وهي القوى الإسلامية في تيارات وأطياف مختلفة " .	استبعد	1	Sing
كل هذــه المـــعلومات جعلت اعـــوان الامــن يكثفــون من ابحاثهم وتحرياتهم الامر الذي مكـــنهم من حــصر الشــبهات في ثلاثة شبان تمر تجـــارتهم بضـــائقة مالية منذ مدة الا انهم استطاعوا خلال الفترة الاخيرة ايجاد حل ما لمشاكلهم المادية المتراكمة	يكثفــون	6	Plur
وكان افينتاخادو قال في وقت سابق من اليوم ان المتمردين قد يباشرون الافراج عن الرهائن اعتبارا من الاربعاء .	يباشرون	11	Plur
وشدد شارون على ان " القدس مقدسة بالنسبة لليهود اكثر منها للمسيحيين والمسلمين لاننا لم نعرف عاصمة اخرى او مدينة مقدسة اخرى " .	نعرف	15	Plur
والعام الماضي ، تسبب تسلل متمردين اسلاميين من آب / اغسطس الى تشرين الاول / اكتوبر بتزايد حدة التوتر في دول آسيا الوسطى الثلاث الاكثر عرضة لعدم الاستقرار وهي قرغيزستان واوزبكستان وطاجيكستان .	تسبب	3	Sing
يهود في أمريكا يقاضون القذافي في مسعى لاستعادة أملاكهم في ليبيا	يقاضون	3	Plur
وشدد على ان " الكتاب سيرة امينة ومتوازنة ويهدف الى خدمة الامير الراحلة والذين عملوا لحسابها " .	عملوا	14	Plur
وذكرت وكالة أنباء برس ترست الهندية ان المسلحين القوا القنبلة مستهدفين مركبة شرطة كانت تقف بالقرب من محطة الاتوبيس ولكنها اخطأت الهدف وانفجرت فى الطريق فأصابت 11 من المشاة بعد ظهر اليوم .	اخطأت	20	Sing
واضاف المكتب الصحافي ان الفحص والاتصالات الصوتية مع الطاقم لم تتح معرفة ما اذا كان هناك قتلى او جرحى على متنها .	تتح	10	Sing
واشار المصدر نفسه الى ان سائقي الباص الثلاثة وهم مواطنان تركيان ومقدوني ، اوقفوا وتم فتح تحقيق .	اوقفوا	13	Plur
إذ أصدر " مجمع البحوث الإسلامية " وهو أعلى سلطة في الأزهر ، قراراً قضى بمنع تداول كتاب أبو زيد " الخطاب والتأويل " في مصر ومصادرة ما وزع من نسخه في الأسواق .	قضى	14	Sing
واعتبر فضل الله أن " فرنسا هي بلد الحريات في التاريخ ومن حق المسلمين أن يمارسوا حريتهم في النقاش الموضوعي والاعتراض السلمي كمواطنين في فرنسا أو كأصحاب فكر يثير الآخرون الجدل فيه " .	يمارسوا	15	Plur
الباز : مبارك لا يثأر من " الإخوان "	يثأر	4	Sing
لديه أفكار سلمية حقيقية تجاه إسرائيل والعالم وأنا أصدقه عندما يقول " إنه يريد عالماً خالياً من السلاح ، وهو يخطط برامجه وأفكاره بدقة ويريد فعلاً السلام مع إسرائيل " .	يخطط	20	Sing
وتابعت أن وزير التجارة الخارجية المصري يقوم بمراجعة حزمة اقتراحات تهدف إلى عقد اتفاق اقتصادي شامل مع المملكة لتنمية العلاقات في مجالات التجارة والاستثمار والسياحة والعمالة وغيرها .	تهدف	10	Sing
القاهرة - » الحياة « - توقع وزير الدولة المصري للتخطيط احمد الدرش ان تتراجع المعونات الخارجية والمساعدات الى البلاد .	تتراجع	14	Sing
واضاف ان الرئيس العراقي صدام حسين والزعيم الليبي معمر القذافي والملك السعودي فهد وامير الكويت الشيخ جابر الاحمد الصباح اعتذروا عن الحضور شخصيا ولكنهم سيرسلون وفودا " على اعلى المستويات " .	اعتذروا	19	Plur
ولا تلوموا " أوبك "	تلوموا	1	Plur
وأكد عضو المجمع الدكتور عبد المعطي بيومي أن الأزهر " لا يصادر حرية الفكر والإبداع ، وإنما يحمي ثوابت المجتمع من أي انحرافات فكرية تهدد عقيدة المجتمع وثقافته " .	يحمي	17	Sing
من جهة اخرى اعلن الجنرال غابي اشكينازي قائد المنطقة الشمالية التى تشمل الحدود مع لبنان اليوم الثلاثاء ان اسرائيل " تبذل ما تستطيع لتجنب التصعيد فى لبنان " على الرغم مما يسببه رشق الحجارة من اذى .	تبذل	20	Sing
ولم تحصل سيرينا على عدد كبير من النقاط كونها حاملة اللقب لكنها قلصت الفارق الذي يفصلها عن الاسبانية كونشيتا مارتينيز السادسة الى 71 نقطة بعد ان كان 111 الاسبوع الماضي .	تحصل	1	Sing
1948 - الحرب العربية الاسرائيلية : مجلس الامن الدولي يتبنى مشروع قرار اميركي يرى في الحرب " خطرا على السلام العالمي ويدعو الى وقف القتال خلال ثلاثة ايام تحت طائلة فرض عقوبات اقتصادية وعسكرية على من يخالف ذلك " .	يتبنى	9	Sing
اليونان ترحب بالمبادرة الخاصة بالدفاع الأوربى	ترحب	1	Sing
جدة 15 - 8 ( اف ب ) - عاد وزير الداخلية السعودي الامير نايف بن عبد العزيز اليوم الثلاثاء الى بلاده في اعقاب زيارة لليمن خصصت للبحث في وسائل تطبيق الاتفاق الحدودي الذي وقعه البلدان .	خصصت	26	Sing
التصفيات الآسيوية الحاسمة لمونديال 2002 : ابو شقير والعتيبي والصقري وزايد خارج » الاخضر « واصابة المشعل . . . والاقالات تطاول ستانغ وحجي	تطاول	21	Sing
فيما يلى أهم الانباء التى نشرتها كبريات الصحف الالمانية اليوم .	يلى	1	Sing
وقال المسئول الأمريكي إن مبالغ المعونة المخصصة لمصر لن تستطيع خلال الأعوام القادمة تمويل مشروعات الكهرباء والصرف الصحي والمياه والاتصالات والتي كانت تمولها في الماضي .	تستطيع	9	Sing
وظهر أيضــاً أن الحـــب ليس مرتبطاً بسن معينة في سويسرا ، بل أن المسنين يشعرون به كما يشعر به الشباب ، ويحاولون أن يعيشوا كل طــقوسه .	يشعرون	14	Plur
إلى ذلك أوشك بنك الإسكان والتعمير المصري على إنهاء مفاوضاته التي بدأت منذ نحو شهرين مع عدد من البنوك الخليجية الكبيرة في ما يتعلق بتفعيل خطة الترويج للعقارات المصرية الفاخرة في دول الخليج العربي .	أوشك	2	Sing
وزير النفط السعودي : لم تقترح أي من دول الأوبك رفع السعر المستهدف للنفط بعد انخفاض الدولار	تقترح	5	Sing
الاستثمارات الخاصة بالعقارات تنجح وتكون مربحة للغاية .	تنجح	3	Sing
وسوف تأخد الدورة الجديدة لمهرجان الخيول بعدا ثقافيا وفكريا وذلك من خلال تنظيم ندوة علمية حول الخيل فى المدونة العربية بالمعهد العلمى بسيدى ثابت يشارك فيها عدد من الاساتذة والمتخصصين فى التاريخ والثقافة والموروث الشعبى .	يشارك	24	Sing
وقال هشام رامز رئيس مجلس إدارة البنك المصري الخليجي إن زيادة الاستثمار تحكمه العديد من الاعتبارات التي تتمثل في زيادة الجمارك والضرائب والثقة في مناخ الاستثمار بجانب سعر الفائدة .	تتمثل	17	Sing
شهدت الفترة الماضية تراجعاً واضحاً من جانب البنوك بالنسبة لتمويل ودعم الأنشطة الصناعية .	شهدت	0	Sing
وكانت توضع في حساب سري ولا يظهر في حساب الموازنة العامة للدولة بالاتفاق مع صندوق النقد الدولي .	توضع	1	Sing
وهناك حزب التحرير الإسلامي ، الذي يصنف ضمن الحركات الراديكالية لكنه لا يستخدم العنف في عمله .	يستخدم	12	Sing
واكتفى رؤساء الدول المجتمعون منذ امس في لوساكا بممارسة الضغوط على رئيس الكونغو لوران ديزيريه كابيلا لكن من دون ان يتوصلوا الى اي ضمانات ، بحسب المراقبين الذين اعتبروا البيان " ضعيف اللهجة " .	يتوصلوا	20	Plur
وقد عثر على هؤلاء وبحوزتهم متفجرات وذخيرة وهو الامر الذى اثار المخاوف من احتمال ان يكونوا اعضاء فى شبكة الجماعة الاسلامية الارهابية او جماعات متمردة اسلامية فى الفلبين .	يكونوا	15	Plur
قال البروفيسور تشو هونغ بالجامعة ان عمل رسم الملامح الاصلية لرأس جثة جافة اصعب كثيرا من رسم الملامح الاصلية حسب الجمجمة لانه يصعب كثيرا قياس شكل جمجمة الجثة الجافة ذات مختلف الأنسجة اللينة الجافة وغير المنتظمة .	يصعب	22	Sing
ومنذ ذلك الحين بذلت مصر جهوداً كبيرة من أجل رفع اسمها من على القائمة .	بذلت	3	Sing
وقال شيخ الأزهر " إذا كانت المرأة المسلمة تعيش في دولة غير إسلامية تتعارض قوانينها مع الحجاب ، فإنها باستجابتها لهذه القوانين تكون من الناحية الشرعية الإسلامية في حكم المضطرة " .	تتعارض	13	Sing
بعث الرئيس الصينى والسكرتير العام للجنة المركزية للحزب الشيوعى الصينى هو جين تاو برسائل تعازى اليوم الى اسر بحارة البحرية الذين لقوا مصرعهم فى حادث غواصة وقع امس الجمعة .	لقوا	21	Plur
تريد قبرص من الامم المتحدة تقديم كافة الاحتجاجات لدى النظام القبرصى التركى لضمان احترام حقوق الانسان الخاصة بالقبارصة اليونانيين الذين يدخلون الشمال حسبما ذكر بيان صحفى لوزارة الخارجية القبرصية اليوم .	يدخلون	20	Plur
وتردد انهم جلبوا معهم المتفجرات والذخيرة لأن ذلك جزء من العادات المتبعة فى قريتهم حيث اعتاد سكانها اطلاق النار فى الهواء خلال هذه الاحتفالات .	اعتاد	15	Sing
لكن مراقبين توقعوا أن تسرع السلطات بتصفية أوضاع جميع المعتقلين من المنتمين إلى الجماعات الإسلامية في غضون الشهور المقبلة .	توقعوا	2	Plur
دراسة : العنف المنزلي في الولايات المتحدة يطال 25 % من النساء و 7،5 من الرجال	يطال	7	Sing
توجه فريق خاص من صحفيى وكالة انباء شينخوا بعد ظهر اليوم الى احدى المستشفيات بغرب بكين خصصت لعلاج عرض الالتهاب الرئوى الحاد / سارس / .	توجه	0	Sing
وقال ان ستة رؤساء دول اعضاء في منظمة اوبك اكدوا حضورهم القمة المقبلة في كراكاس .	اكدوا	9	Plur
قد تلتقي بالشخص الذي تبحث عنه إذا حضرت بعض الأنشطة الخيرية .	حضرت	7	Sing
إسرائيليون يبحثون عن النفط شمالي العراق	يبحثون	1	Plur
من جانبه اعترف الدكتور مدحت حسانين وزير المالية بعدم وجود معلومات دقيقة حول حجم المخزون الحكومي .	اعترف	2	Sing
وحمل عدد اخر ممن قدموا استقالاتهم القوات الامريكية مسؤولية تردي الاوضاع الامنية في المدينة بسبب محاصرتها لها وتمركزها في مركز الشرطة الواقع بوسط المدينة مما ادى الى قطع الطريق الرئيسي في المدينة والطرق الفرعية المحيطة بمركز الشرطة .	قدموا	4	Plur
علم ان هذه الحجرة مصممة طبقا لنظرية الضغط السالب وبمقدورها ان تتجنب العدوى المتبادلة بين مرضى السارس والطبيين .	تتجنب	11	Sing
وأخبر العاملين فى خط الموجهة أنه مهتم جدا بالعمل الوقائى بين كبار السن قائلا " علينا أن نكثف اهتمامنا بمنازل كبار السن . " وعند نقطة لمراقبة الهجرة سأل تونغ عن كيفية سير قياس درجة حرارة المسافرين .	سأل	28	Sing
الجمارك الاردنية تضبط تماثيل ومخطوطات مسروقة من متحف بغداد	تضبط	2	Sing
لوحظ أن مسؤولين مصريين رفيعي المستوى بينهم رئيس الحكومة الدكتور عاطف عبيد بعثوا ببرقيات عزاء إلى أسرة قيادي بارز في جماعة " الإخوان المسلمين " توفي أخيراً ، وذلك وسط حملات أمنية حكومية تتعرض لها " الجماعة " .	بعثوا	12	Plur
وأضاف أن الحزب " يعتز بأخوة العرب في الإسلام ، ولكننا نقر بضرورة العودة للجذور " .	يعتز	4	Sing
» غلف انفست « تتملك أراضيا سكنية في دوكلاند	تتملك	4	Sing
أسعار الحديد الصاج تقفز 350 جنيها في شهر واحد	تقفز	3	Sing
أخطأ الذين اعتقدوا أن هجمات 11 سبتمبر طلقة مدوية في حرب بعيدة .	أخطأ	0	Sing
ولا يستطيع احد القول ان حظوظ منتخب الامارات انعدمت ، لكنها بالتاكيد تضاءلت لأسباب مجهولة لم تتناسب مع الآمال الكبيرة التي عقدت عليه .	تتناسب	16	Sing
وهم لا يدينون بالإسلام أو المسيحية . .	يدينون	2	Plur
وبدأت تكثر التحركات الاجتماعية في ايران التي تضم اكثر من مليوني عامل .	تكثر	1	Sing
إلا أن اللاجئين يزعمون أن منطقة غرب النيل غير آمنة ، وهو ما ينكره مسئولو الحكومة المركزية والحكومة المحلية والمجلس المحلى .	يزعمون	3	Plur
كما رصد البيان ارتفاعاً في الناتج المحلي الإجمالي في العام المالي 2002 / 2003 بلغ 35.9 مليار جنيه عن العام الذي سبقه متوقعا أن يصل الناتج الإجمالي العام القادم إلى 450 مليار جنيه بزيادة مماثلة .	رصد	1	Sing
وقال اللواء سمير توفيق رئيس قطاع النقل النهري إن تنفيذ المشروع يستغرق عامين ويساهم الجانب الهولندي بنحو 3 ملايين يورو في حين تتحمل وزارة النقل باقي التكلفة التي تعادل 5 ملايين يورو .	تتحمل	22	Sing
لكن مراقبين يستبعدون حصول ذلك من دون ضوء أخضر من جهات عليا ، مما يفتح مجالاً للحديث عن تناقضات في الطريقة التي تتعاطى معها الحكومة المصرية مع " الإخوان المسلمين " .	يفتح	14	Sing
/ / سوديتش تسيتونج / / : - - توحد دول الاتحاد الاوروبى نفسها بحلول يونيو بشأن العناصر الاساسية " لمبدأ امن اوروبى " موجه عالميا وستعيد تعريف علاقاتها مع الولايات المتحدة .	توحد	9	Sing
ويرى خبراء أن برنامج التخصيص ساهم بشكل كبير في تكريس السمة الأساسية للطبقة الرأسمالية المصرية كطبقة تفتقد الى روح المبادرة ، إذ أن عملية التخصيص برمتها هي بيع لمشاريع جاهزة وغالبيتها تحقق ارباحاً ولا تنطوي على مخاطرة .	ساهم	5	Sing
وناشد محمود شعيب شباب القاعة أن يفيئوا إلى رشدهم ـ وأن يعودوا إلى عقولهم ويراجعوا ضمائرهم ويكفوا عن ذلك ويضعوا السلاح ، فالسعودية بلد كل المسلمين وهي الملاذ الآمن لكل خائف والملجأ لكل لاجئ .	يفيئوا	6	Plur
تفاقمت أزمة صناعة النسيج بسبب وجود نقص شديد في احتياجات الشركات والمصانع من الأقطان والألياف الصناعية .	تفاقمت	0	Sing
واكدت الصحيفة انه يحتمل ان تكون القنبلة وضعت خلال هذا الوقت وسط الحقائب التي جرى التدقيق فيها وكانت في انتظار تحميلها على متن الطائرة . وانفجرت الطائرة بعد اقلاعها بقليل من لندن ، مما ادى الى مقتل 270 شخصا .	ادى	34	Sing
شملت مذكرة التفاهم مجالات التعاون الفني بإنشاء آليات ثابتة لتبادل المعلومات في المجالات التي تهم قطاع البترول والاستكشاف والإنتاج وتوريد المعدات والخدمات وإعداد وتطوير الدراسات المشتركة والبرامج والمشروعات لتسهيل تخطيط السياسة التي تهتم بمجالات الإنتاج واستخدامات المنتجات البترولية .	تهم	14	Sing
وقد غرقت كورسك وهي من احدث قطع البحرية الروسية على بعد 150 كلم تقريبا من قاعدة سيفيرومورسك على بعد 69،4 درجات شمالا و 37،5 درجات جنوبا ، في منطقة دولية تقع بين روسيا والنروج .	غرقت	1	Sing
وقد غرقت الغواصة " كورسك " في منطقة تبعد 150 كلم عن قاعدة سيفيرومورسك الواقعة على 69،4 درجة شمال و 37،5 درجة شرق ، في منطقة دولية بين روسيا والنروج .	غرقت	1	Sing
وبجلبهم الى المقر الأمني لم يجنح المشتبه بهم الى المراوغة أو التنصل من المسؤولية خاصة وأن القرينة المادية لإدانتهم متوفرة فاعترفوا مباشرة بما نسب لهم .	يجنح	5	Sing
واكد افينتاخادو انه سيتوجه الى جزيرة خولو في الساعات المقبلة يرافقه الوسيط الليبي رجب الزروق للتأكد من الافراج عن " جميع " الرهائن الغربيين المحتجزين بمن فيهم الصحافيون الفرنسيون الثلاثة الذين اسروا الشهر الماضي بينما كانوا يقومون بتغطية الازمة .	اسروا	31	Plur
صرح يانوس بابانتونيو وزير الدفاع اليونانى للصحفيين عقب اجتماع ترأسه لبحث " قمة الأربعة " الأوربية التى عقدت بين فرنسا وألمانيا والدنمارك ولكسمبورج حول الدفاع الأوربى بأن المبادرة تعزز جهود رئاسة اليونان للاتحاد الأوربى من أجل دفاع أوربى مشترك .	تعزز	28	Sing
" أما بالنسبة إلى الديموقراطية فنحن الدولة التي تتمتع بالديموقراطية في هذا الجزء من العالم " .	تتمتع	8	Sing
كما تقصر المادة الحوافز على الشركات الأجنبية دون الشركات المصرية التي لها شهرة عالمية وتصدر للعديد من الدول الأجنبية .	تقصر	1	Sing
وصرح كلينتون للصحافيين " علينا الانتظار . الجميع يعمل بكد ولا اختراق مهم الا ان ذلك ليس سببا للتفاؤل او التشاؤم فهم يعلمون بان امامهم القليل من الوقت لكن ليس لدي ما اعلنه " .	يعلمون	22	Plur
حصلت المشاركة المنتظرة لمدة طويلة لشركة تشاينا ايرلاينز التايوانية فى شركة الطيران الصينية للبضائع بالبر الصينى على الموافقة من قبل مجلس الدولة / مجلس الوزراء / الصينى .	حصلت	0	Sing
وتابع الضابط " كل يوم يمر يؤدي الى تفاقم الوضع الانساني في شمال قطاع غزة والفلسطينيون يدرسون في هذا الوقت وسائل تحرك الجيش والمواقع التي يحتلها في جباليا وبيت لاهيا وبيت حانون ما يمكن ان يعرض جنودنا لهجمات " .	يدرسون	16	Plur
كما اعلن باول فى المؤتمر الصحفى ان المسؤولين السوريين ابلغوه خلال محادثاته معهم في دمشق ، انهم اقفلوا مكاتب لعدد من المنظمات المناهضة لاسرائيل ، من دون ان يحدد ما هي هذه المنظمات .	اقفلوا	17	Plur
ضبط محققو مركز الأمن العمومي بسليمان خلال الليلة الفاصلة بين الأحد والاثنين المنقضيين أربعة كهول بصدد البحث عن كنوز يعتقدون أنها مدفونة في التراب وسط ضيعة فلاحية كائنة بأحواز المدينة .	ضبط	0	Sing
وقال والد الرهينة الفرنسية سونيا ويندلينغ لوكالة فرانس برس انه لم يتلق اي اتصال من طرابلس .	يتلق	11	Sing
واليوم الثلاثاء احتج العراق بشدة لدى الامم المتحدة على الغارات الاميركية البريطانية التي استهدفت منشآت مدنية في جنوب العراق واسفرت الجمعة والسبت عن سقوط قتيلين و 23 جريحا على حد ما ذكرت وكالة الانباء العراقية الرسمية .	احتج	2	Sing
ندوة صحفية . يعقد السيد الهادي مهني وزير الداخلية والتنمية المحلية على الساعة الحادية عشرة من صباح يوم غد ندوة صحفية بمقر الوزارة حول الاستعدادات للانتخابات الرئاسية والتشريعية المقررة ليوم 24 اكتوبر الجاري .	يعقد	3	Sing
واستقال جيفسون من منصبه بعدما اعترفت ديانا خلال برنامج تلفزيوني لم تحدثه عنه مسبقا ، انها خانت زوجها مع ضابط في الجيش .	خانت	16	Sing
ساعد قريباً أو صديقاً مقرباً لك في إعداد ميزانية له .	ساعد	0	Sing
لكنه أضاف " الولايات المتحدة هي القوة العظمى في العالم والقوة الوحيدة التي تملك القدرة ألفعلية " .	تملك	13	Sing
كانت قبرص الواقعة فى شرق البحر المتوسط قد انقسمت الى جنوب قبرصى يونانى وشمال قبرصى تركى منذ عام 1974 اثر غزو القوات التركية لثلثها الشمالى واحتلاله فى اعقاب محاولة انقلاب فاشلة موالية لاثينا .	انقسمت	8	Sing
مع بداية الموسم الدراسي الجديد ، فوجئ طلاب السنة الرابعة من قسم الإعلام في كلية الآداب جامعة دمشق بإدراج مقرر اللغة العبرية في منهاجهم الدراسي .	فوجئ	6	Sing
واعرب نواب اخرون عن رغبتهم في عقد اجتماع موسع بحضور الزعماء التقليديين ومندوبي مؤتمر المصالحة الوطنية لكي يجعلوا انتخابهم وانتدابهم للمهمة رسميا وفقا للتعهدات التي سبق واتخذت .	يجعلوا	17	Plur
واوضحت تلك المصادر أن افراد الشرطة القتلى تعرضوا لكمين عندما كانوا يستقلون حافلة ركاب صغيرة في المنطقة ، التي تبعد نحو 35 كيلومترا إلى الجنوب من العاصمة العراقية .	يستقلون	11	Plur
حاول أن تتجنب أي مناقشات جادة مع من تحبهم .	تتجنب	2	Sing
لا تهمل المشاكل الصحية التي قد تراها تافهة نتيجة للضغط الذي تتعرض له .	تهمل	1	Sing
إذا وصفوني بالخيانة فهل تستبعد أن أقول إنهم جهلاء ؟	تستبعد	4	Sing
وذكرت صحيفة / الاقتصاد اليومية / ان جميع المنتجات الطبية للوقاية ومعالجة السارس يجب ان تكون ذات معايير عالية الجودة حسبما قال نائب رئيس مجلس الدولة هوانغ جيو وهو يتفقد المؤسسات ببكين يوم الجمعة .	يتفقد	29	Sing
فقد احتدت آثار " الأنفلونزا " اللعينة . .	احتدت	1	Sing
قفزت أسعار الحديد الصاج المستخدم في الصناعات الهندسية والمنزلية وأنابيب البوتاجاز وأوعية الضغط وطفايات الحريق لتصل إلى 2650 جنيهاً للطن بنسبة زيادة أكثر من 150 % خلال عام واحد .	قفزت	0	Sing
وقال إن أثار خفض سعر الفائدة مع الودائع بالبنوك لم تتضح بالسوق " لم تؤثر سلباً على السوق " بل زادت أسعار الانتربنك الداخلي " بين البنوك " من 6 إلى 7 % .	تتضح	10	Sing
وقال اليوم الثلاثاء لوكالة فرانس برس " هذا الامر يشكل نجاحا للمندوبين الصوماليين وللوسطاء الجيبوتيين " .	يشكل	9	Sing
توجهت الانظار اليوم السبت الى العاصمة السورية دمشق حيث اجرى وزير الخارجية الامريكي كولن باول مباحثات مع المسؤولين السوريين في زيارة وصفت بانها هامة وحاسمة .	اجرى	9	Sing
200 من زعماء العشائر في العراق يتلقون دروساً في الديموقراطية	يتلقون	6	Plur
الأستاذ الأمريكي عبد الله طالب دونالد كول نطق بالشهادتين أمام شيخ الأزهر وأسلم وأسلم	نطق	7	Sing
يخشى ان يكون حوالى 160 شخصا قد لقوا مصرعهم بينما نجا 40 اخرون اثر انفتاح مفاجئ للباب الخلفى لطائرة بضائع كانت تحلق فى اجواء الكونغو ، وفقا لما ذكرته مصادر عسكرية .	لقوا	7	Plur
وحددت الدراسة هذه الإجراءات في السعي لتنفيذ نظام المناطق الصناعية المؤهلة التي تضمن معاملة تفضيلية للصادرات المصرية من المنسوجات والملابس الجاهزة عند دخولها لأسواق الولايات المتحدة الأمريكية التي تستوعب معظم الصادرات المصرية في هذا القطاع .	تستوعب	28	Sing
اتصل باول بسينها من دمشق بسوريا حيث يقوم بزيارة لها واستمرت المكالمة 15 دقيقة ، وفقا لما ذكر تافتيج سارنا المتحدث باسم وزارة الخارجية لوسائل الاعلام هنا .	اتصل	0	Sing
ذكرت وكالة الانباء الفلبينية ان ماليزيا افرجت اليوم عن 22 فلبينيا كانوا قد اعتقلوا داخل المياه الاقليمية الماليزية وبحوزتهم متفجرات فى الشهر .	افرجت	6	Sing
تنشغل كثيراً بالأطفال .	تنشغل	0	Sing
كان أجداد كول بين المستوطنين الأوروبيين الأولّ في فيرجينيا وقد فروا من الاضطهاد الديني والكبت السياسي ، وجاهدوا لتأسيس مجتمع جديد يرتكز على احترام الحرية " وأنا أسير على خطاهم لقد هاجروا عبر المحيطات والقارات ، وكذلك أنا .	فروا	10	Plur
ودعت لرفع الحصانة عن المتهمين بقتل الصحفيين ، مشيرة الى ان اغلب الذين قتلوا خلال قيامهم بعملهم لم يقتلوا خلال الحرب بل قتلوا عمدا بسبب مصالح خاصة .	يقتلوا	18	Plur
واضاف حمدين ان " مثيرين للشغب " لم يحدد عددهم اوقفوا و " ستجري محاكمتهم فورا " .	اوقفوا	10	Plur
وأشار ماهر الى " أن خريطة الطريق تتطلب من جميع الاطراف أن تتعاون لبناء عملية سلام جديدة وأن تتحرك نحو اقامة الدولة الفلسطينية المستقلة " .	تتحرك	18	Sing
وكان 120 أديباً وقعوا على بيان دعماً للشهاوي ، طالبوا الدولة بالتدخل لوقف إحالة الأعمال الأدبية على الأزهر لأخذ رأيه فيها .	طالبوا	9	Plur
تويوتا تعزز تواجدها فى الصين	تعزز	1	Sing
فـ " الجماعة الإسلامية " نبذت العنف منذ سنوات وقاد زهدي ولا يزال يقود التحول السلمي .	نبذت	5	Sing
مديرو الفنادق بمصر يحتجون على قرار يمنع وصلات الرقص الشرقي خلال رمضان	يحتجون	3	Plur
وقال " اننا نتوجه للمشاركة فى مؤتمر ثان . واعتقد انه سيكون فى 8 او 9 مايو . " واضاف ان ضابطا برتغاليا بارزا شارك فى المؤتمر الاول الذى عقد الاربعاء الماضى .	نتوجه	3	Plur
وسيقوم مركز السلع ببناء أبراج للبورصات الثلاث ، حيث كشف يوم 20 / 9 عن برج الماس الذي يدل اسمه على أنه سيكون مقرا لبورصة التعامل به وسيرتفع إلى 56 طابقاً .	يدل	18	Sing
الا ان قائد البحرية الروسية الاميرال فلاديمير كوروييدوف اوضح للتلفزيون ان عمليات " التحضير للانقاذ " جارية في ظل هدوء العاصفة التي هبت في بحر بارنتس .	اوضح	8	Sing
طائرات اميركية وبريطانية تقصف شمال العراق	تقصف	3	Sing
وقال شارون من منصة الكنيست متوجها الى نواب حزب العمل " لقد تخليتم حتى عن القسم الاكبر من المدينة القديمة " .	تخليتم	12	Plur
واشار الى ان ماليزيا عارضت دائما العقوبات التى فرضت على مدى اكثر من 12 عاما عقب غزو العراق للكويت ، كما تشعر بان العقوبات تسببت فى صعاب ومآس للشعب العراقى البريء .	تشعر	21	Sing
ومن الموضوعات التي تطرقت إليها الدورة أيضاً الميراث عند نساء الأقباط .	تطرقت	3	Sing
وقال خبراء في النفط " ان الزعيم الليبي معمر القذافي الذي تتركز ثروات بلاده في النفط والغاز يرى أن للدولار الأميركي جإذبية أكبر من الجنيه الاسترليني " .	تتركز	11	Sing
وندد الجنرال اشكينازي باستمرار رشق الحجارة على بوابة فاطمة مشيرا الى ان وحدات من المظلييين نشرت فى المنطقة وهي مزودة باوامر لضبط النفس .	رشق	4	Sing
وقد حالت العاصفة التي يشهدها بحر بارنتس دون بدء اي عملية انقاذ حتى الان .	حالت	1	Sing
وقال سيرغييف انه لم يتضح بعد ما اذا كان هناك ضحايا في صفوف طاقم الغواصة التي غرقت الى قعر البحر نهاية الاسبوع الماضي اثر انفجار على ما يبدو .	يتضح	4	Sing
وكانت عملية اجلاء طاقم الغواصة ارجئت منذ الاثنين بسبب هبوب عاصفة . واستغلت فرق الانقاذ تراجع قوة الرياح بعد ظهر اليوم لمباشرة العملية .	ارجئت	5	Sing
وذكرت وكالة أنباء برس ترست الهندية ان المسلحين القوا القنبلة مستهدفين مركبة شرطة كانت تقف بالقرب من محطة الاتوبيس ولكنها اخطأت الهدف وانفجرت فى الطريق فأصابت 11 من المشاة بعد ظهر اليوم .	القوا	8	Plur
وردد البابا الكلمة التي القاها لدى تعيينه خليفة للقديس بطرس في تشرين الاول / اكتوبر 1978 قائلا " لا تخافوا ، افتحوا ابواب المسيح واسعة ، افتحوا قلوبكم وحياتكم وشكوككم ومشاكلكم وافراحكم ودعوه يدخل في قلوبكم " .	افتحوا	21	Plur
لاغوس 15 - 8 ( اف ب ) - لقي 18 شخصا مصرعهم عند انفجار انبوب نفط في جنوب شرق نيجيريا السبت بينما كانوا يشفطون النفط منه بطريقة غير قانونية ، حسبما اوردت الصحف الصادرة اليوم الثلاثاء .	يشفطون	24	Plur
* * الحرب الحتمية هل تنوي إسرائيل فعلاً شن غارات جوية واسعة داخل دمشق نفسها وليس على الأطراف كما فعلت عندما ضربت هدفاً لها في عين الصاحب .	تنوي	5	Sing
وأضافت ان بناء المستوطنات يشكل عقبة أمام السلام وكما أوضح الرئيس بوش مرارا انه يمكن التوصل الى حل يعتمد على اقامة دولتين اسرائيل وفلسطين مشيرة الى " اننا نرى أن حل اقامة دولتين هو فى مصلحة أبناء الشعبين " .	يشكل	4	Sing
واكد ان المانيا لن تتخلى عن مسئولياتها العالمية ، لكن تاريخها وجغرافيتها يشيران الى انها ستسعى فى المقام الاول الى دور نشط ينحصر فى اوربا .	ينحصر	22	Sing
واضاف : " ان احد اهم عوامل نجاح المؤتمر هو نجاح الحكومة في هذا البرنامج مما اعطى صدقية للبنان امام العالم بأننا بلد يلتزم " .	اعطى	16	Sing
يحمّلون الطوائف وزر النفر من المحسوبين عليها ، والدين منهم براء وهو يردد : لا تخف من لقاء الاشرار ، انهم يجفّون كالعفن تحت خيوط الشمس .	يحمّلون	0	Plur
من جهة اخرى اعلن الجنرال غابي اشكينازي قائد المنطقة الشمالية التى تشمل الحدود مع لبنان اليوم الثلاثاء ان اسرائيل " تبذل ما تستطيع لتجنب التصعيد فى لبنان " على الرغم مما يسببه رشق الحجارة من اذى .	رشق	32	Sing
وكان رئيس الوزراء السوري محمد ناجي عطري وعشرة من أعضاء حكومته حضروا حفلة الاستقبال الرسمية لفاجبايي باعتباره أول رئيس وزراء هندي يزور البلاد منذ 15 سنة .	حضروا	11	Plur
فإن الأبناء ـ على الجانب المقابل ـ يجدون في حضنه الدافئ . .	يجدون	7	Plur
وقد حضر هذا المعرض 23128 تاجرا من 167 دولة ومنطقة بالعالم ومن ضمنهم 6973 تاجرا جديدا . وجدير بالذكر انه لم تظهر أية حالة سارس وسط عاملى المعرض ورجال الاعمال المشاركين فيه .	حضر	1	Sing
ونقلت الصحيفة عن مصادر سياسية إسرائيلية رفيعة المستوى قولها إن مصر " أعادت النظر في سياستها إزاء إسرائيل أخيراً وقررت التقرب من الدولة العبرية وتغيير سياستها تجاهها " .	أعادت	12	Sing
وقال إن نسبة 17 % من الاستثمارات الأوروبية الموجهة لدول البحر المتوسط تأتي إلى مصر ، " وهو رقم لا يزال ضئيلاً لا يتناسب مع إمكانات مصر في مجال الاستثمار " .	يتناسب	23	Sing
واوضح " اعتقد ان حس المسؤولية عند جميع الفرقاء سيجلعهم يعملون لانجاز الاعمال لان سمعة لبنان على المحك " .	يعملون	10	Plur
وقال " لا أدري لماذا لا يلتفت شيخ الأزهر إلى الكاثوليك واليهود الفرنسيين الذين قالوا للحكومة : ليس ذلك من حقها ، أو أن يلتفت إلى أمريكا وبريطانيا وغيرهما من الدول الغربية التي رفضت هذا القرار " .	قالوا	14	Plur
المانيا تبحث عن تلميع صورتها ضد اسبانيا وفرنسا تريد تأكيد سمعتها ضد نجوم العالم	تبحث	1	Sing
واستحدثت الحكومة تشريعات عدة لتشجيع الاستثمار وتذليل العقبات التي تعترض طريق المستثمرين ، كما نفذت برنامجاً للتخصيص تضمن بيع 182 شركة ومصنعاً حتى الآن بقيمة إجمالية تجاوزت 16 بليون جنيه من أصل 314 شركة شملها البرنامج في بدايته .	تضمن	17	Sing
وأضاف المفتي : من أعطى هؤلاء الذين وقّعوا على الوثيقة اللعينة الحق بتسليم حائط البراق لسلطات الاحتلال " ، موضحاً أن " الأمر الواقع لا يغير من الأحكام الشرعية .	وقّعوا	7	Plur
وافق مجلس إدارة المؤسسة المصرفية العربية ABC " البحرين " في اجتماعه الأخير علي منح تمويل لوزارة البترول المصرية قيمته 1.4 مليار دولار لتمويل الاكتشافات الجديدة للغاز المصري التي تشمل التسييل والبحث والتصدير للأردن .	تشمل	29	Sing
ما دام لا خلاف بين أميركا وسوريا حول لبنان هل يُعقل أن يراهن مسيحيون على واشنطن ؟	يُعقل	10	Sing
فقد جاءت دعوة الكلدان والآشوريين هذه بعد سلسلة مطالب كان من أبرزها المطالب الكردية التي أكدت ضرورة أن يتضمن الدستور العراقي المقبل نصاً صريحاً يقر بالفيدرالية التي تلبي الحقوق القومية الكاملة لأكراد العراق .	يتضمن	18	Sing
وامتلأ مستشفى المدينة بالأكياس السوداء التي عبئت بها جثث القتلى العراقيين الذين سقطوا خلال معارك اليومين الماضيين والذين قالت القوات الامريكية ان عددهم بلغ اكثر من 150 قتيلا " بينهم 10 % من المدنيين " ونحو 88 جريحا .	سقطوا	12	Plur
الحكومة لا تنوي تصفيتها والبنوك ترفض التسوية . مصر : محاولة أخيرة لإنقاذ » شركة الحديد والصلب «	تنوي	2	Sing
يكد ، ويجتهد من أجل توفير حياة كريمة لأبنائه . .	يكد	0	Sing
وتشهد طهران او المناطق الاخرى يوميا تجمعات لعمال لم يتلقوا رواتبهم منذ سنة احيانا ، امام مقار الوزارات والهيئات المعنية .	يتلقوا	9	Plur
وأشار النواب إلى أن هذا المبلغ الضخم يمثل 20 % من موازنة الدولة ، وقررت الحكومة المصرية القيام فوراً بمراجعة بيانات جميع المخازن الحكومية لاستخدام ما يصلح من المخزون ، وتجديد مخزون الأساس وإعادة استخدامه .	يصلح	26	Sing
وفى رد حذر ومتأن على جمالى أعرب فاجبايى عن أمله أن ترد باكستان " على نحو إيجابى " على إعلانه أمام البرلمان أمس الجمعة .	أعرب	6	Sing
واشاد بالدعوة لترشيد العمليات الاستشهادية اذ " ليس هناك من هو احواج من المقاومة الى النصح من جانب من يؤمن اساساً بعظمة المقاومة وروحها الاستشهادية " .	يؤمن	19	Sing
وعلمت " الشرق الأوسط " أن شكيد فشل في استقطاب 3 من المثقفين وجه لهم دعوات تعارف .	تعارف	16	Sing
عليها اليوم أن تخشى من الهزيمة الأمريكية هناك .	تخشى	3	Sing
وإذا كنا لا نريد للحوار الفلسطيني أن ينتهي لهذه النتيجة ، فإن الفصائل الأثنتى عشرة ليس عليها سوى التفكير في إجابة سؤال واحد فقط هو : كيف تتحول أحرف كتابة البيانات الختامية إلى فعل حقيقي على أرض الواقع ؟	ينتهي	7	Sing
واضاف المصدر ان ذلك ادى الى اصابة ضابط واحد عناصر الامن الفلسطيني في الراس نتيجة ضربهما باعقاب البنادق من قبل الجنود الاسرائيليين . واصيب ايضا جندي اسرائيلي بجروح .	ادى	4	Sing
وهم يحاولون الإجابة على تساؤلات من نوع مثل ماذا لو حدث الطلاق النهائي .	يحاولون	1	Plur
يذكر ان المملكة العربية السعودية والمملكة الاردنية الهاشمية كانتا قد ارسلتا مستشفيين متنقلين الاول في منطقة " البياع " وسط بغداد والثاني في منطقة " ابو غريب " التي تبعد حوالى عشرين كيلومترا غرب بغداد لاخلاء وعلاج الجرحى العراقيين .	تبعد	29	Sing
واكد انه " من المستحيل عمليا ان تلتحم كبسولة بفتحة الانقاذ في مثل هذا الانحناء " .	تلتحم	7	Sing
واضاف ان ماليزيا تصر ايضا على ضرورة ان يعكس اى مشروع قرار يقدم الى الامم المتحدة مصلحة الشعب العراقى فى السيطرة على حقوله البترولية واصوله الاخرى .	تصر	3	Sing
ومن جانبها حرصت كاواجوتشي على أن تشير إلى أن العلاقات الثنائية بين مصر واليابان " دخلت في منعطف جديد عقب اللقاء الذي جمع الرئيس مبارك برئيس وزراء اليابان جونيشيور كويزومي بالقاهرة في يونيو الماضي " .	حرصت	2	Sing
إعلاميون ناقشوا بيان البطاركة في المركز الكاثوليكي : يشكــل مدخــلاً صحيحــاً لترسيــخ الحــوار مونس	ناقشوا	1	Plur
واكد وانغ ان من الاقسام الاربعة ينفصل عن الاخر بأحزمة من الاشجار والاعشاب وطرق عريضة . وتبلغ نسبة غطاء الاشجار فى المستشفى 60 بالمائة من الاجمالى .	ينفصل	6	Sing
فكر في الحصول على الطلاق من خلال المحكمة في حالة عدم التوصل إلى حل ودي مع شريك الحياة .	فكر	0	Sing
ويرى المراقبون ان هذه الزيارة لها اهمية استثنائية لكونها تأتي في ظروف معقدة ودقيقة تمر بها المنطقة ولخصوصية العلاقة بين واشنطن ودمشق في هذا التوقيت حيث توترت العلاقات بينهما بعيد بدء الحرب على العراق على خلفية التهديدات الامريكية لسورية .	توترت	26	Sing
وكان لافتاً أن هذا التطور جاء بعد أسبوعين من مشاركة أعضاء في الحزب الوطني في إفطار أقامته " الجماعة " أخيراً ، تحدثوا فيه عن أخطاء في سياسات الحزب الذي ينتمون إليه ، في شأن التعامل معها .	ينتمون	30	Plur
واكد ان " الاطفال والكبار يمكن ان يصابوا بادمان على المشروبات التي تحتوي الكافيين وان يشعروا باعراض النقص جسديا ونفسيا اذا توقفوا عن شربها " .	يشعروا	15	Plur
وانطلاقاً من هذه الأهداف جاء اهتمام الولايات المتحدة بنفط منطقة بحر قزوين ، ولذا دعمت الولايات المتحدة بناء اكبر خط أنابيب في العالم الذي يتم حاليا تشييده بمساعدة شركة بريتش بيتروليوم البريطانية .	دعمت	14	Sing
وذكر المحللون ان العديد من البريطانيين ابدوا تذمرهم من الضرائب المحلية على الخدمات مثل المدارس وجمع النفايات التى ازدادت بشكل متواصل , لكن محاولات بلير لتحسين خدمات الصحة والتعليم والنقل العام ما زالت محدودة .	ابدوا	6	Plur
وأشار إلى أن جميع مرضى سارس فى 13 مقاطعة منها لياونينج وانخوى وشهجيانج أصيبوا بعدوى المرض خارج المناطق التى يقيمون فيها .	أصيبوا	13	Plur
وصرحت المتحدثة باسم المفوضية رون ريدموند فى مؤتمر صحفى ان المفوضية بعثت بقافلة مساعدات للاسهام فى توفير الاحتياجات العاجلة للاجئين الفلسطينيين فى العاصمة العراقية .	بعثت	11	Sing
وذكرت صحيفة " دي فلت " الالمانية اليوم الثلاثاء ان الجمعية الخيرية التي يديرها سيف الاسلام نجل الزعيم الليبي العقيد معمر القذافي دفعت 25 مليون دولار للافراج عن 17 رهينة .	دفعت	22	Sing
اسيا 2000 : الهويدي يستبعد المشاركة في النهائيات	يستبعد	4	Sing
وأضاف العثماني الذي كان يتحدث لـ " الشرق الأوسط " قائلا : " ترجمة معاني القرآن قد تساعد الإنسان الذي لا يتحدث العربية لكي يتعامل مع القرآن عن وعي .	يتعامل	24	Sing
ورحب المحللون بتصريحات محيي الدين ، لكنهم قالوا إنه طالما أعرب عن هذه الآراء الإصلاحية وإنه من غير الواضح بعد ما هي الصلاحيات التي يتمتع بها المجلس الجديد ومحافظ المركزي الجديد فيما يتعلق بوضع السياسات .	قالوا	7	Plur
واوضح انه يتعين على حكومات البلدات ولجان القرى مواصلة مراقبة عمالهم الذين عادوا من مدن مصابة بالسارس والاستمرار فى اعمال مراقبة السارس والوقاية منه .	عادوا	12	Plur
وأشار إلى أن " عصبة الأمم المتحدة اعترفت قبل نحو 70 عاماً بملكية حائط البراق للمسلمين باعتباره وقفاً إسلامياً وجزءاً من الأقصى ، ثم يأتي هؤلاء ليسلموه لليهود ويطلقون عليه زوراً وبهتاناً اسم حائط المبكى ؟ " .	اعترفت	7	Sing
وقالت " نشاهد يوميا الاف حالات الفساد في طهران . ان اكشاك الهاتف تحولت الى نقطة لنشر فساد الاخلاق " .	نشاهد	2	Plur
ابحث عن بعض التغيرات الشخصية .	ابحث	0	Sing
وقامت السفارة الإسرائيلية في أنقرة ، بتحويل تقرير إلى القدس ، أفادت فيه أن النشر عن الموضوع في تركيا يلامس العداء لإسرائيل وإن السفارة تنوي التوجه إلى وزارة الخارجية التركية لفحص مدى صحة المعلومات المنشورة .	تنوي	24	Sing
واوضح الوزير ان مجمعات المستوطنات التي تعتزم اسرائيل ضمها للاحتفاظ ب 80 % من المستوطنين في الضفة الغربية " ستضم خصوصا قطاعات ارييل وغوش اتزيون ومناطق محيطة بالقدس باتجاه البحر الميت " .	تعتزم	6	Sing
ولدى المستشفى حاليا 17 سريرا لمرضى السارس من الاجانب كما ان الاطباء المعالجين والمرضى يتحدثون الانجليزية بطلاقة .	يتحدثون	14	Plur
اعلنت السلطة الفلسطينية انها ستقوم بدعوة مجلس الامن الدولى لعقد جلسة عاجلة لبحث المجزرة الاسرائيلية فى منطقة الشجاعية بشرق قطاع غزة امس والتى راح ضحيتها العشرات من القتلى والجرحى .	راح	23	Sing
كما أكدت أن الموقف العربي لن يقف سلبياً إذا مضت إسرائيل في انتهاكاتها بالنسبة لمصر وسورية ولبنان .	أكدت	1	Sing
ومن التنظيمات الأخرى التي طالبت بالفيدرالية ، الجبهة التركمانية العراقية وكذلك بعض التنظيمات الدينية الشيعية والسنة في إطار القول إن بعض المناطق العراقية تحتاج إلى مثل هذه الخصوصية الإدارية والاقتصادية التي توفرها الفيدرالية .	طالبت	4	Sing
وقد اختير هذا الاسم " العالمي " للتنظيم ، كونه يضم قسماً من الليبيين الذين هاجروا من إسرائيل ويعيشون اليوم في دول أوروبية أخرى ، خصوصاً فرنسا وإيطاليا .	هاجروا	15	Plur
وكانت السعودية فازت في نصف النهائي امس الاثنين على قطر 24 - 20 ، فيما تخطت الكويت سوريا 27 - 24 . ويلعب الخاسران على المركز الثالث .	فازت	2	Sing
مصر تحتل المرتبة الأولى عربياً في استخدام بطاقات الائتمان	تحتل	1	Sing
الخطر كل الخطر أن يعتمد الاحتياطي على الدولار فقط لأنه ينخفض عملياً بنفس انخفاض قيمة الدولار وهذا يجب تداركه .	يعتمد	4	Sing
لكن الجزائر الدولة العربية الوحيدة في المجلس تولت قيادة المعارضة لهذا البيان .	تولت	7	Sing
فقد جاءت دعوة الكلدان والآشوريين هذه بعد سلسلة مطالب كان من أبرزها المطالب الكردية التي أكدت ضرورة أن يتضمن الدستور العراقي المقبل نصاً صريحاً يقر بالفيدرالية التي تلبي الحقوق القومية الكاملة لأكراد العراق .	تلبي	27	Sing
اتفاق التجارة الحرة بين مصر والولايات المتحدة في مراحله النهائية أنجزت مصر ملفها الاقتصادي الذي ستعرضه على الإدارة الأمريكية خلال زيارة الرئيس مبارك لواشنطن في أبريل أو مايو المقبل .	أنجزت	10	Sing
* * استقرار أسواق النقد : ولم تتأثر أسواق النقد بالتغييرات واستمرار أسعار الجنيه المصري أمام غالبية العملات الأخرى من دون تغيير يذكر سواء في السوق الرسمية أو غير الرسمية .	تتأثر	7	Sing
ورغم نوايا عدد كبير من أعضاء حركة فتح بإقالة الحكومة ، إلا أنه تقرر في نهاية الاجتماع تفعيل لجنة التسوية التابعة للمجلس التشريعي التي ستعمل على ربط الجسور مرة أخرى بين أبو علاء وياسر عرفات .	تقرر	13	Sing
وقال " إن إسرائيل تريد لنا اقتتالا داخليا وحربا أهلية نعيش فيها لسنوات طويلة " ، مضيفا أن " أبو مازن يدرك ذلك ولن يقبل أن يسجل له فى التاريخ انه كان سببا فى حدوث مثل هذه الحرب " .	يدرك	21	Sing
ولم يستبعد أن يكون هناك سعي لعقد اتفاق المناطق الصناعية المؤهلة كخطوة بداية لعقد اتفاقية التجارة الحرة مع أمريكا كما حدث مع الأردن .	يستبعد	1	Sing
وتوفي ديانكو ديانكوف ( 66 عاما ) ليل الجمعة السبت في مستشفى مدينة بورغاس ( جنوب شرق ) متاثرا بجروحه التي غطت 90 % من جسده اثر حريق اندلع الخميس في منطقة هاسكوفو ( جنوب ) .	اندلع	28	Sing
وزير خارجية ماليزيا : رفع العقوبات عن العراق لا يعطى شرعية للغزو للغزو	يعطى	9	Sing
واضافت ان كل تلك التطورات الايجابية تؤكد ان السودان يبذل الجهود كعضو مسئول فى المجتمع الدولى لجعل العالم خاليا من الارهاب والحروب والحفاظ على الامن والسلام الدوليين .	يبذل	9	Sing
مشكلتنا في لبنان ( الى سوء البنية الفوقية الزمني ) ان الحسد ينهش غير الواصلين ، فيرمون الواصلين برياح الحقد والاشاعات والتهم ، كي يسقطوا عنهم الهالة ، ولو انهم هم ، لن يستطيعوا بلوغ نعمة الهالة .	يستطيعوا	33	Plur
وقال سوتارتو " دعوا المتمردين يواجهون القوات المسلحة الوطنية وحدها ، وليس اى طرف اخر " وقال ان نشاط الصناعات المستهدفة يجب ان يستمر .	دعوا	3	Plur
وغزو الأسواق العراقية التي بدأت تستقبل منتجات إسرائيلية منها أجهزة لتنقية المياه وحلوى للأطفال .	تستقبل	5	Sing
وتوقع طارق حلمي أن يستمر خفض سعر الفائدة على الإيداعات في ظل استمرار عدم إتاحة الاستثمارات أو قصرها على التجزئة المصرفية فقط للأفراد أو أذون الخزانة وودائع المركزي كلما قل العائد على الاستثمار .	قل	29	Sing
تبلغ تكلفة المشروع التجريبي 180 ألف دولار يتحمل منها الاتحاد الأوروبي 100 ألف دولار عن طريق صندوق دعم كفاءة الخدمة التابع له بينما تتحمل الهيئة تكلفة الأجهزة والمعدات والشبكة .	تتحمل	23	Sing
الفوضى مستمرة والبلاد غير امنة ولا توجد حكومة والسلاح متوفر فى كل مكان وما زال اللصوص والمخربون يواصلون عملياتهم الاجرامية وما تزال الدبابات الامريكية تجوب الشوارع تزرع الرعب ولكنها فى الوقت نفسه اصبحت هدفا للعراقيين الذين يرفضون استمرار الاحتلال .	يرفضون	36	Plur
استعد لدخول دائرة الضوء إذا كنت ترغب في تنمية طموحاتك .	استعد	0	Sing
ومن جانبه انتقد السفير جمال بيومي مهندس اتفاقية المشاركة المصرية ـ الأوروبية مبدأ التدفقات التجارية التقليدية .	انتقد	2	Sing
تركيا تراهن على شراكتها الاستراتيجية مع أميركا لتحقيق مصالحها . أجاويد يهدد بإلحاق شمال قبرص إذا ضم جنوبها إلى الاتحاد الأوروبي	تراهن	1	Sing
ومن ثم فلو أنتجتم كمية أكبر من النفط الخام ولكن لا تستطيعون تكريرها فلن يتحول ذلك إلى بنزين " .	تستطيعون	11	Plur
وأوضـح ان عدداً من المســــؤولين الاتراك أعلــنوا رسمياً ان تركيا » لا تأمل ولا تؤيد توجيه ضربة اميركية الى العراق ، لكن ظروفاً وشروطاً جديدة قد تجبرنا على اعادة النظر في موقفنا « .	تؤيد	14	Sing
وتقع هذه الحوادث امام انظار الناس الذين لا يستطيعون ان يفعلوا شيئا على الفور فى مواجهة قوات الاحتلال المدججة بالسلاح لكنهم بالتأكيد يضمرون الحقد لهؤلاء المحتلين الاجانب .	يستطيعون	8	Plur
لكن تعيين محتشمي جاء مفاجئا لان معظم المراقبين كانوا يتوقعون ان يكون محمد رضا خاتمي شقيق الرئيس زعيما لهذه الغالبية وهو الذي احتل مقدمة لائحة الاصلاحيين فى الانتخابات التشريعية فى العاصمة .	يتوقعون	9	Plur
الا ان خاتمي اشترط قبل اقامة علاقات دبلوماسية مع واشنطن ان تقدم الولايات المتحدة اعتذارا عن تأييدها لانقلاب 1953 الذي ادى الى وصول الشاه الى السلطة بالاضافة الى اجراءات تعاون ملموسة .	ادى	20	Sing
قال مسئول في الشركة بصراحة نعرف جميعاً أن السيدات يحتكرن مناصب بعينها في القطاع الخاص ـ السكرتيرات التنفيذيات مثلا ـ وهن منتشرات في المهن الخاصة المتميزة .	يحتكرن	9	Plur
واشار الى ان فرق الانقاذ تتفحص حاليا خارج الغواصة " اذ لم تعرف بعد اسباب غرق الغواصة " التي رجحت مصادر البحرية ان يكون ناجما عن اصطدامها بسفينة اخرى .	رجحت	19	Sing
القدس 15 - 8 ( اف ب ) - اتهم زعيم المعارضة اليمينية في اسرائيل ارييل شارون اليوم الثلاثاء رئيس الوزراء ايهود باراك بالتفريط بالقدس ، وذلك خلال نقاش خاص في البرلمان نظم خلال العطلة البرلمانية .	نظم	32	Sing
وخلال خطابها وقعت حوادث بين الشرطة ومتظاهرين يشاركون في حفلة لموسيقى الروك قرب ستايبلز سنتر حيث يعقد المؤتمر . وكان خمسة الى ستة الاف شخص متواجدين في منطقة الحادث .	يشاركون	7	Plur
وحاول بعض المعلمين تجاوز هذه المشاكل وجلس التلاميذ على الارض لتلقي الدروس لكنهم لم يستطيعوا اكمال حصصهم اليوم على امل ان يجدوا طريقة لتحسين الوضع في الايام القادمة .	يستطيعوا	14	Plur
كان صحفى يابانى قد أحضر قطعة الذخيرة من بغداد كتذكار دون ان يعرف ماهيتها ووضعها فى حقيبته لكنها انفجرت فى المطار أثناء تفتيش حقيبته مما أدى الى مصرع رجل الأمن واصابة ثلاثة أخرين بجراح .	أحضر	4	Sing
وأشار الخبراء إلى أن الأثر سيظهر جلياً على البورصة المصرية في ظل التوقعات بأن يؤدي القرار إلى تضاعف تعاملات المستثمرين الأجانب مع زيادة دخول صناديق الاستثمار والمحافظ المالية الأجنبية وهو ما ينعكس إيجابيا على معدلات التداول والأسعار .	ينعكس	31	Sing
وقال محيي الدين وهو أيضاً رئيس اللجنة الاقتصادية في الحزب الوطني الديموقراطي الحاكم في مصر أعلنا عن تعويم حر في يناير لكنه لم ينفذ بعد ، ما لدينا هو تعويم محكوم وليس تعويماً حراً .	ينفذ	23	Sing
كما واصلت قوات الاحتلال ملاحقة كوادر المقاومة الفلسطينية بالضفة الغربية حيث فجرت في مدينة الخليل منزل عائلة نسيم الجعبري ، أحد منفذي العملية الفدائية المزدوجة التي جرت في بئر السبع الشهر الماضي .	فجرت	11	Sing
* * متحرر أمريكي الأهواء : ويعتبر العقدة من الخبراء المصرفيين الذين يتبعون المدرسة الأمريكية في العمل المصرفي التي تعتمد على السياسات التحررية .	يتبعون	12	Plur
وقال احد ضباط الحرس الوطني في منطقة الضلوعية التي تبعد 30 كيلومترا الى الجنوب من مدينة سامراء ان 13 منتسبا من عناصر الحرس الوطني العراقي قدموا استقالتهم بسبب عدم اكتراث القوات الامريكية بارائنا وما نقوله .	قدموا	25	Plur
وأشار الى ان القيمة الاجمالية للشقق والوحدات السكنية تُقدر بنحو 93 مليون استرليني . وتم التعاقد مع شركة » كاناري سنترال « على شراء ما قيمته 84 مليون استرليني من الشقق ومن ثم اعادة بيعها او تأجيرها الى العملاء .	تُقدر	8	Sing
ابرزت الصحف الصادرة صباح اليوم ببكين وعلى صفحاتها الاولى المحادثة الهاتفية التى تمت يوم الجمعة بين الرئيس الصينى هو جين تاو والرئيس الكورى الجنوبى روه مو هيون .	ابرزت	0	Sing
فالجماهير حينما اختارت " الرجل " ليتولى زمام القيادة . .	اختارت	2	Sing
أصوليون مصريون ينتقدون استبعاد الإسلاميين من الحوار الوطني بين الحزب الحاكم وأحزاب المعارضة	ينتقدون	2	Plur
ولا يستطيع احد القول ان حظوظ منتخب الامارات انعدمت ، لكنها بالتاكيد تضاءلت لأسباب مجهولة لم تتناسب مع الآمال الكبيرة التي عقدت عليه .	تضاءلت	12	Sing
وكانت عملية اجلاء طاقم الغواصة ارجئت منذ الاثنين بسبب هبوب العاصفة . واستغلت فرق الانقاذ تراجع قوة الرياح بعد ظهر اليوم الثلاثاء لمباشرة العملية التي لم تتوفر تفاصيل حول طبيعتها .	ارجئت	5	Sing
وكانت السوق شهدت جدالاً حاداً منذ إعلان حصول الشركة الحكومية على الرخصة الثالثة بعد انتهاء اتفاقيتي احتكار الشركتين القائمتين .	شهدت	2	Sing
ونقلت الوكالة عن بيان لوزارة الشؤون الخارجية قوله انه جرى تسليم الفلبينيين الى فريق يعمل بالقنصلية الفلبينية وانه تم نقلهم بعد ذلك الى مدينة سانداكان في ولاية سابا الشرقية لركوب عبارة لنقلهم الى مدينة زامبوانجا فى جنوبي الفلبين .	جرى	9	Sing
كما اوضح ان قضية اصدار بطاقة هوية للمرأة بحثت مع وزير الداخلية الأمير نايف بن عبدالعزيز و » وعد بخير ، هذه امور صحيح حساسة لإثبات شخصية المرأة وان شاء الله سائرون فيها «	اوضح	1	Sing
كما حذر من ان ايران لن تظل غير مكترثة اذا اعتزمت الولايات المتحدة البقاء فى تلك البلاد .	اعتزمت	10	Sing
جرت اليوم السبت محاولة غير ناجحة لأستئناف الدراسة في المدارس العراقية عندما واجه التلاميذ ومعلموهم العديد من المشاكل التي تعيق التعليم .	واجه	12	Sing
ونقلت وكالة ايتار - تاس عن متحدث باسم اسطول الشمال الذي تنتمي اليه الغواصة ان اجلاء الطاقم سيبدأ بعد الظهر اذا تأكد تحسن الاحوال الجوية .	تنتمي	11	Sing
كما اوضح ان قضية اصدار بطاقة هوية للمرأة بحثت مع وزير الداخلية الأمير نايف بن عبدالعزيز و » وعد بخير ، هذه امور صحيح حساسة لإثبات شخصية المرأة وان شاء الله سائرون فيها «	شاء	29	Sing
وقال المسئول الذى اشترط عدم ذكر اسمه , ان العراق سيقسم الى ثلاثة قطاعات تقودها هذه الدول الثلاث بشكل منفصل .	اشترط	3	Sing
وبدوره ، عين الاتحاد القطري برئاسة سعود المهندي البرازيلي باولو كامبوس ، مدرب فريق الريان ، مدرباً للمنتخب خلفاً للبوسني جمال حاجي المستقيل من منصبه .	عين	2	Sing
وعلى الجانب الآخر شهدت تحويلات المصريين في الخارج انخفاضاً نسبته 5.2 % عن العام السابق .	شهدت	3	Sing
اعربت مفوضية الامم المتحدة للاجئين اليوم عن قلقه ازاء تزايد عدد اللاجئين الفلسطينيين الذين طردوا من منازلهم فى بغداد .	طردوا	14	Plur
واعتبر ان القرار الذي اتخذه منظمة الدول المصدرة للنفط بزيادةانتاجها 800 الف برميل يوميا والاجراءات التي اتخذت منذ ذلك الحين " ليست كافية حتى الان للسماح للاسواق باستيعاب " الوضع الجديد .	اتخذت	16	Sing
وقال إن " بعضهم التف حول قيادات بعينها في الحزب مؤخرا ، وتسببوا في الإساءة لمرحلة الإصلاح والتجديد التي بدأها الحزب في السنوات الأخيرة " .	التف	4	Sing
ظهرت بوادر أزمة بين الكويت ومصر ، بسبب إعلان نشره الصندوق الكويتي للتنمية في صحف عدة يتناول مسابقة تتضمن جوائز للذين يجيبون عن أسئلة تتعلق بقيمة المساعدات التي قدمتها الكويت إلى مصر .	يجيبون	21	Plur
رقصة التانجو تحتاج إلى اثنين والرقص مع شارون يشبه الرقص بين الألغام .	يشبه	8	Sing
واكد على اهمية ازالة المعوقات التى تعوق التجارة والتجارة البينية بين الدول العربية التى مازالت دون الطموح ، مشيرا الى ان معدلات التجارة البينية بين الدول العربية باستثناء البترول سجلت 23 فى المائة عام 2002 .	تعوق	6	Sing
نيويورك ( فب ) - اعلن ديبلوماسيون في الامم المتحدة ان فرنسا دعت الى اجراء تصويت امس في مجلس الامن الدولي على قرار يطلب من سوريا سحب قواتها من لبنان .	يطلب	23	Sing
وشارك في صلاة الجمعة في المسجد الجديد العضو المسلم في الرئاسة الثلاثية للبوسنه علي عزت بيغوفيتش الذي عاد امس من نيويورك حيث عولج من التهاب في الرئتين .	عولج	22	Sing
وأشارت هذه المصادر الى أن التعديل استهدف ضغط النفقات الخاصة بادارة وتشغيل الأجهزة الحكومية مع عدم الاضرار بالعاملين فى الوزارات التى تم الغاؤها أو دمجها أو تعديل مسمياتها .	استهدف	6	Sing
تأثر اكثر من 200 هكتار من الغابات بهذا الحريق الا انه لم ترد انباء عن اصابات ووفيات .	تأثر	0	Sing
وقال البابا متوجها بكلامه لنحو 300 الف شاب ايطالي استقبلوه بحرارة امام كنيسة القديس يوحنا في روما " دعوا المسيح يحكم وجودكم الشاب ، اخدموه بحب . اخدموا المسيح والحرية " .	اخدموا	27	Plur
ومع ذلك يظل اللجوء إلى خيار جذب الاستثمارات الأجنبية هو الاجتهاد الأكثر قبولا ، والأقل كلفة .	يظل	2	Sing
وبعد ان القى خطابه القصير غادر على متن سيارته الزجاجية " باباموبيل " باتجاه الفاتيكان القريب حيث ينتظره نحو مئتي الف شاب من كافة انحاء العالم .	القى	2	Sing
الفوضى مستمرة والبلاد غير امنة ولا توجد حكومة والسلاح متوفر فى كل مكان وما زال اللصوص والمخربون يواصلون عملياتهم الاجرامية وما تزال الدبابات الامريكية تجوب الشوارع تزرع الرعب ولكنها فى الوقت نفسه اصبحت هدفا للعراقيين الذين يرفضون استمرار الاحتلال .	يواصلون	17	Plur
في نابل اطلق عيارا ناريا . وتسبب لنفسه في كارثة	اطلق	2	Sing
كما ستقام امسية شعرية يتغنى خلالها الشعراء بالخيل ومزاياه وذلك بمركز الخيل بسيدى ثابت .	يتغنى	4	Sing
اعتقلت وكالات تنفيذ القانون الباكستانية ستة ارهابيين يشتبه فى علاقتهم بشبكة القاعدة فى كراتشى يوم الاربعاء .	اعتقلت	0	Sing
والقى أجويلار اللوم على قوات الاحتلال لعدم التوصل الى قرار بشأن اعادة أعمار العراق , داعيا اياها الى تقديم مقترحات تستند الى مبدأ أن العراقيين هم الذين يقررون مستقبلهم بأنفسهم .	يقررون	27	Plur
مثقفون يسعون لتأسيس حزب يدعو لفصل مصر عن العروبة والعودة للفرعونية للفرعونية	يسعون	1	Plur
واكد كورويودوف صباح اليوم ان فرضية الاصطدام " من بين الاحتمالات " التي قد تفسر الحادث .	تفسر	14	Sing
واضاف كلينتون قبل محادثات في المكتب البيضاوي مع رئيس الوزراء الهندي اتال بيهاري فاجبايي ، " يجب ان تتشجعوا لرؤيتهم منكبين على العمل وبانه لا يوجد اي باعث الى الامل او اليأس " .	تتشجعوا	18	Plur
مثل هذا " الترف " قد يكون مفهوماً عندما كان الأمريكيون يتولون الحكم مباشرة .	يتولون	11	Plur
لكن تعيين محتشمي جاء مفاجئا لان معظم المراقبين كانوا يتوقعون ان يكون محمد رضا خاتمي شقيق الرئيس زعيما لهذه الغالبية وهو الذي جاء فى مقدمة لائحة الاصلاحيين فى الانتخابات التشريعية فى العاصمة .	يتوقعون	9	Plur
وكان اكثر من 150 الفا من القوات الامريكية والبريطانية قد عبروا من الصحراء الشمالية الكويتية في 20 مارس في عملية وصفها رامسفلد امس في بغداد بانها " ربما تكون اسرع دخول لعاصمة في التاريخ العسكري الحديث " .	عبروا	10	Plur
وبدا أن التصريحات التي تشبه القرار فتحت الباب واسعاً لإعادة ترتيب الوضع السياسي للمرحلة المقبلة .	فتحت	6	Sing
وكان لافتاً أن هذا التطور جاء بعد أسبوعين من مشاركة أعضاء في الحزب الوطني في إفطار أقامته " الجماعة " أخيراً ، تحدثوا فيه عن أخطاء في سياسات الحزب الذي ينتمون إليه ، في شأن التعامل معها .	تحدثوا	22	Plur
شعب مصر الذي يتزايد بطريقة غير مسبوقة ، لابد أن تتزايد مع مواليده الظواهر الغريبة والمتباينة ، وأهمها ظاهرة " التوائم " التي تكاد تصبح ظاهرة مصرية خالصة .	تكاد	23	Sing
واستحدثت الحكومة تشريعات عدة لتشجيع الاستثمار وتذليل العقبات التي تعترض طريق المستثمرين ، كما نفذت برنامجاً للتخصيص تضمن بيع 182 شركة ومصنعاً حتى الآن بقيمة إجمالية تجاوزت 16 بليون جنيه من أصل 314 شركة شملها البرنامج في بدايته .	تعترض	9	Sing
يُشار إلى أن مصر بدأت برنامجاً طموحاً للإصلاح الاقتصادي في العام المالي 1990 / 1991 استهدف توسيع قاعدة الملكية وتحقيق تنمية مستدامة وزيادة النشاط الاقتصادي من خلال تغيير انماط الادارة وتعظيم دور القطاع الخاص واستقطاب المزيد من الاستثمارات الاجنبية .	استهدف	15	Sing
إذ أصدر " مجمع البحوث الإسلامية " وهو أعلى سلطة في الأزهر ، قراراً قضى بمنع تداول كتاب أبو زيد " الخطاب والتأويل " في مصر ومصادرة ما وزع من نسخه في الأسواق .	وزع	28	Sing
واختفت الموائد بعد ذلك في العصر الأيوبي ، لتعود في العصرين المملوكي والعثماني عامرة بأصناف اللحوم والحلوى وكان الأمراء يحرصون على الظهور فيها بمظهر الأسخياء أمام الرعية والفقراء ويتنافسون على تجهيزها .	يحرصون	19	Plur
قوة من الشرطة القضائية والجيش اللبناني تقتل رئيس عصابة اجرامية في تبادل اطلاق نار	تقتل	6	Sing
تجدر الإشارة إلى أن مجلس الإدارة الذي صدر قرار تشكيله من الدكتور عاطف عبيد رئيس مجلس الوزراء الشهر الماضي بضم عدد من المستثمرين وخبراء المال والقانون ، بالإضافة إلى ممثلي 10 وزارات معنية بشئون الاستثمار المحلي والأجنبي .	تجدر	0	Sing
واشار الى ان الشعب العراقى لن يسمح للمسئولين الامريكيين بان يحكموا بلاده ، وحث المسلمين على مساعدة العراقيين فى انهاء الوجود الامريكى فى بلادهم .	يحكموا	10	Plur
4 صحفيين من وكالة شينخوا يتمركزون فى مستشفى لعلاج السارس	يتمركزون	5	Plur
ففرنسا تتحرك باتجاه الادارة الأميركية لإقناعها بأنه ليس بوسعها البقاء على هذا الوضع ، لأنها بذلـــك تضـــع أصـــدقاءهــــا في العالــــم العربـــي ومصالحهـــا في خطــر .	تضـــع	16	Sing
امرت ادارة التعليم بالمدينة باغلاق المدارس لمنع انتقال السارس بين 1.37 مليون طالب وطالبة .	امرت	0	Sing
ورحب المحللون بتصريحات محيي الدين ، لكنهم قالوا إنه طالما أعرب عن هذه الآراء الإصلاحية وإنه من غير الواضح بعد ما هي الصلاحيات التي يتمتع بها المجلس الجديد ومحافظ المركزي الجديد فيما يتعلق بوضع السياسات .	يتمتع	24	Sing
وكان قد تردد في وقت لاحق وجود خلاف بين السلطتين المالية والنقدية تجاه قضية سعر الفائدة إلا أن التطورات الأخيرة تشير إلى حدوث شبه اتفاق على الرفع التدريجي للفائدة بهدف عودة الاستقرار لسوق الصرف وزيادة معدلات الادخار .	تشير	20	Sing
ويعتقد مديروها أن حجم المشكلة وأسبابها المستعصية والمخاوف منها قد يغري بعائد مالي كبير .	يغري	10	Sing
وكم عدد العمال المصريين الذين ساهموا في بناء الكويت وتعميرها فتحولت من صحراء جرداء إلى ما هي عليه الآن ؟	ساهموا	5	Plur
" اننا نطلب من اصدقائنا اعطاءنا فرصة كي نستكمل ما بدأناه ونفي بالتزاماتنا ، فمن باب اولى ان نساعد انفسنا ( . . . ) واننا نطلب منهم ان يثقوا بنا ومن باب اولى ان نثق بانفسنا .	يثقوا	29	Plur
قدم مشروع القانون عضوا مجلس الشيوخ تشارلز شومر الديمقراطى عن نيو يورك وجون كيل الجمهورى عن اريزونا . وينتظر المشروع موافقة مجلس النواب ايضا .	قدم	0	Sing
واشار الى ان فرق الانقاذ تتفحص حاليا خارج الغواصة " اذ لم تعرف بعد اسباب غرق الغواصة " التي رجحت مصادر البحرية ان يكون ناجما عن اصطدامها بسفينة اخرى .	تتفحص	5	Sing
فكم جفّت عفون فيك يا لبنان ؟ وخلدت روح الايمان ! " الروح يحيي والحرف يميت " ( السيد المسيح ) .	يحيي	13	Sing
يحمّلون الطوائف وزر النفر من المحسوبين عليها ، والدين منهم براء وهو يردد : لا تخف من لقاء الاشرار ، انهم يجفّون كالعفن تحت خيوط الشمس .	يجفّون	21	Plur
واوضحت الصحيفة البريطانية ان افادة الحارس في مطار هيثرو ارفقت بملف الاستئناف الذي سيقدمه محامو المقرحي ، والذي يدرسه القضاء الاسكتلندي لوكالة في جلسة الاستماع التمهيدية في 15 تشرين الاول ( اكتوبر ) المقبل في كامب زايست في هولندا .	ارفقت	9	Sing
وزراء عمل دول الاسيان يجتمعون فى اندونيسيا	يجتمعون	4	Plur
ومن ثم فلو أنتجتم كمية أكبر من النفط الخام ولكن لا تستطيعون تكريرها فلن يتحول ذلك إلى بنزين " .	أنتجتم	3	Plur
ويقول " إن الرجل أكثر ذكاء مما تعتقدون وهو ليس متقلب الآراء كما تحسبون ، إنه إنسان براجماتي ، صاحب خط منهجي للاعتدال .	تعتقدون	7	Plur
زار تساو قانغ تشيوان ، نائب رئيس اللجنة العسكرية المركزية ووزير الدفاع مستشفى شياوتانغشان بعد ظهر اليوم لنقل تحياته واعجابه للعاملين الطبيين فى المستشفى الجديد الذى شيد لعلاج عرض الالتهاب الرئوى الحاد / السارس / .	زار	0	Sing
بالتالي ليس هناك ما يلزم مصر بأن تخفض الرسوم الجمركية .	تخفض	7	Sing
يذكر ان سوريا بادرت في اواخر سبتمبر الى تنفيذ اعادة انتشار جديدة لقواتها في لبنان سحبت خلالها نحو ثلاثة الاف جندي وبقي في لبنان نحو 15 الفا من جنودها .	سحبت	15	Sing
2 - اليهود الذين لم يقبلوا يسوع كمسيا ( المسيح ) خسروا بركات العهد ومنافعه .	يقبلوا	5	Plur
قد لا يتفهم شريكك في العمل تقلب حالتك المزاجية ولكن بعد أن تخبره بالسبب من ذلك فإنك قد تتفادى كثير من الخلافات بينكما .	يتفهم	2	Sing
كما ارتفعت الصادرات من المواد الكيماوية والأدوية والمستلزمات الطبية بنسبة 21 % لتصل إلى 299 مليون دولار ، نتيجة زيادة الصادرات من راتنجات ولدائن صناعية ، ومنتجات كيماوية عضوية وغير عنصرية .	ارتفعت	1	Sing
وعلم من مصادر مطار بيروت ان طائرة خاصة من نوع بوينغ 720 استاجرتها السفارة الليبية اقلت الوفد اللبناني وعددا من الصحافيين اضافة الى والدة الرهينة .	اقلت	15	Sing
أشاد المجلس بتصريح فاجبايى أمام البرلمان الذى ذكر فيه أن قضية استئناف علاقات الكريكيت مع باكستان يتعين أن يعتبرها القائمون على الرياضة " مؤشرا إيجابيا " .	يتعين	16	Sing
وبعدما لفت التقرير إلى مقدمة الكتاب وقعها سرحان نفسه لاحظ أن في الكتاب " تمجيداً للذة الجسدية . .	لفت	1	Sing
لكن هذا الاعلان لن يقنع على الارجح الامير تشارلز والملكة اليزابيث الثانية اللذين سيصدران اليوم ايضا بيانا يعربان فيه عن معارضتها صدور الكتاب .	يقنع	4	Sing
وأشارت هذه المصادر إلى أنه من المنتظر أن يتم الإعلان عن ضوابط خاصة لمنح الجنسية لتجنب الحالات الإجرامية من هؤلاء الذين يتهمون في قضايا مخدرات أو اختلاس أو دعارة أو غيرها في إطار الحفاظ على مقومات المجتمع المصري .	يتهمون	21	Plur
واضاف الحلف ان موسكو لم تتقدم بطلب رسمي ، مشيرا الى ان الضباط الروس تحادثوا طوال نصف ساعة ايضا عبر حوار تلفوني مع المتخصصين في مسائل الغواصات في الحلف الاطلسي في نورثوود ( بريطانيا ) .	تتقدم	5	Sing
ورفض زعماء فصائل صومالية عدة يتقاسمون السيطرة على الصومال ، البرلمان الانتقالي .	يتقاسمون	5	Plur
واخيرا ، اعرب بن عامي عن الامل في ان لا يقفل اجتماع لجنة القدس التابعة لمنظمة المؤتمر الاسلامي في 28 آب / اغسطس في المغرب " الباب امام التفاوض " .	يقفل	10	Sing
1948 - الحرب العربية الاسرائيلية : مجلس الامن الدولي يتبنى مشروع قرار اميركي يرى في الحرب " خطرا على السلام العالمي ويدعو الى وقف القتال خلال ثلاثة ايام تحت طائلة فرض عقوبات اقتصادية وعسكرية على من يخالف ذلك " .	يخالف	36	Sing
ويعتبر باقري اللاعب الايراني الاول الذي يحترف في انكلترا ، وهو كان اختبر اللعب في اوروبا وتحديدا في الدوري الالماني بعد ان لعب لموسمين في صفوف ارمينيا بيليفيلد .	اختبر	12	Sing
واضاف " ان كل من يتصور انه يعرف المدة التى سيستغرقها هذا الامر ، انما يخدع نفسه . انه امر غير معروف " .	يخدع	15	Sing
كما أشارت تلك المصادر إلى أن الحكومة الأمريكية سوف تدعم المشروع بنحو 25 بليون دولار ، بهدف تحقيق غايات اقتصادية وسياسية ، وكذلك تنشيط التبادل التجاري الحر بين دول الاندماج .	أشارت	1	Sing
وللاسطول الاميركي غواصة صغيرة تسمى مركبة الانقاذ في المياه العميقة قادرة على انقاذ 24 بحارا دفعة واحدة ، كما يقول المسؤولون في البحرية .	تسمى	4	Sing
يأتي ذلك في وقت أعلن الأمين العام للأمم المتحدة كوفي عنان أن إسرائيل لم تذعن لطلب الجمعية العامة بوقف بناء " الجدار الفاصل " .	يأتي	0	Sing
واوضح الصندوق في تقريره ان رواتب المسؤولين فيه " ستخضع لسلسلة من المراجعات البنوية يجريها مجلس الادارة بالاضافة الى المراجعات السنوية " . مضيفا ان هذه التركيبة " ستظل مستقلة ولن ترتبط رسميا برواتب منظمات دولية اخرى " .	ترتبط	31	Sing
وقال كيم " ان القوات الاميركية تلعب دورا في غاية الاهمية ليس فقط لجهة تفادي وقوع حرب بل ايضا على صعيد استقرار المنطقة في شمال شرق اسيا " .	تلعب	6	Sing
وذكرت وكالة الانباء السعودية ان الامير نايف ترأس وفدا سعوديا الى اجتماعات اللجنة العليا المشتركة السعودية اليمنية لتنسيق مواقف الرياض وصنعاء من اجل تطبيق الاتفاق الموقع في 12 حزيران / يونيو الماضي .	ترأس	7	Sing
يذكر ان مصر قبل الحرب العراقية كانت تعد حليفا رئيسيا للولايات المتحدة فى منطقة الشرق الاوسط وكانت تتلقى سنويا حوالى مليارى دولار امريكى من الادارة الامريكية فى المجالات الاقتصادية والعسكرية .	تتلقى	17	Sing
واشار الى ان المسالة تتعلق ب " الدفاع عن مصالح شعوبنا " وان اوبك " استراتيجية بالنسبة الينا ولتنمية دول العالم الثالث " ، واكد انه " لا ينبغي ان ندع الغير يسحب منا هذا السلاح " .	يسحب	32	Sing
وقد ثارت ازمة سياسية جديدة بين الرئيس عرفات ورئيس وزراءه احمد قريع حول التعديل الوزاري والاطاحة بوزراء كبار ، وهدد نواب فتح بحجب الثقة عن حكومته واتخاذ خطوات تقود الى اجراء تصويت بحجب الثقة واسقاط الحكومة .	تقود	28	Sing
توجهت الانظار اليوم السبت الى العاصمة السورية دمشق حيث اجرى وزير الخارجية الامريكي كولن باول مباحثات مع المسؤولين السوريين في زيارة وصفت بانها هامة وحاسمة .	وصفت	21	Sing
قال أمام مؤتمر إدارة المخزون الحكومي 6 / 12 إن الحكومة اشترت أصولاً ثابتة قيمتها نحو 333 مليار جنيه ساهمت في تكوين هذا المخزون حيث لم تكن هناك حاجة إليها .	اشترت	11	Sing
ولا يستطيع احد القول ان حظوظ منتخب الامارات انعدمت ، لكنها بالتاكيد تضاءلت لأسباب مجهولة لم تتناسب مع الآمال الكبيرة التي عقدت عليه .	يستطيع	1	Sing
تستمتع كثيراً بمشاركتك للمؤسسات التي تقدم إعانات خيرية .	تستمتع	0	Sing
وتحت عنوان " إسرائيل تمتلك مناطق النفط .	تمتلك	4	Sing
وتخشى الإدارة من أن يلجأ بعض الأزواج إلى التحايل أي الطلاق الصوري لتحصيل قيمة التأمين .	يلجأ	4	Sing
عضو في " الإخوان " يسأل الهضيبي : متى ننادي حي على الجهاد !	يسأل	5	Sing
كما تطرق الملك عبد الله والرئيس بوش الى الوضع فى العراق والخطوات المقبلة بشان تمهيد الطريق امام تشكيل حكومة وطنية يختارها الشعب العراقى وتتولى زمام الامور فى العراق .	تطرق	1	Sing
كشف التقرير أن عام 2002 قد شهد زيادة في معدل قضايا الفساد بأجهزة الحكومة بلغت 10 آلاف قضية عن عام 2001 بما يعكس حالات التردي التي وصلت إليها المصالح والوزارات والشركات الحكومية .	يعكس	22	Sing
من جهة اخرى ، ابعد مناف ابو شقير ومبروك زايد وصالح الصقري ومرزوق العتيبي عن التشكيلة ، في حين استدعى الجهاز الفني للمنتخب بقيادة ناصر الجوهر ظهير الاهلي الايسر اسامة برناوي بعدما كان استبعد قبل اسبوع .	ابعد	4	Sing
أكد المجلس أن هذا التدريب لا يلبي البرامج التدريبية التي وضعتها النقابة .	يلبي	6	Sing
وتبلغ القيمة الاسمية للشركة 17 بليون جنيه ( 4 بلايين دولار ) والسوقية 27 بليون جنيه ( 3،6 بليون دولار ) وهي أول شركة عملاقة تُطرح في هذا الاطار .	تُطرح	25	Sing
وانتقد قطب الاتجاه الحالي لإنشاء 7 مصانع جديدة للأسمدة بمصر ، مؤكداً أن 3 مصانع تكفي فقط للاستهلاك المحلي والتصدير .	تكفي	15	Sing
وبدأت اعمال العنف فيما كان الزقاقيون يحاولون نهب المحلات التجارية بحجة انهم يبحثون عن سارق .	يحاولون	6	Plur
* * وإذا كانت العديد من الأسباب السياسية والاقتصادية والدينية تتضافر لتبرير التدخل العسكري الإسرائيلي في العراق ، فإن المقاومة العراقية ستضطر إلى دخول جبهة جديدة في معاركها من أجل التحرير . .	تتضافر	10	Sing
وردد البابا الكلمة التي القاها لدى تعيينه خليفة للقديس بطرس في تشرين الاول / اكتوبر 1978 قائلا " لا تخافوا ، افتحوا ابواب المسيح واسعة ، افتحوا قلوبكم وحياتكم وشكوككم ومشاكلكم وافراحكم ودعوه يدخل في قلوبكم " .	افتحوا	26	Plur
5 - الكتاب المقدس لا يعطينا مشاهد مفصلة عن كيفية تطور التاريخ . على المسيحيين ان يعملوا من اجل العدالة والسلام عوض ان يتكهنوا حول المستقبل " .	يتكهنوا	23	Plur
وبينت نتائج الاستطلاع أن واحدة من كل خمس أسر فلسطينية تتطلع إلى أن يكون أبنها شهيداً ، في حين أكد 80 % من الفلسطينيين أنهم ممتلئون بمشاعر الثأر في أعقاب الانتفاضة .	تتطلع	10	Sing
وذكرت السلطات الفلبينية فيما بعد ان المعتقلين الفلبينيين كانوا فى طريقهم الى حفل زفاف فى جزيرة جنوبية بالقلبين بالقرب من الحدود البحرية بيد انهم ضلوا طريقهم داخل المياه الماليزية .	ضلوا	24	Plur
وقامت السفارة الإسرائيلية في أنقرة ، بتحويل تقرير إلى القدس ، أفادت فيه أن النشر عن الموضوع في تركيا يلامس العداء لإسرائيل وإن السفارة تنوي التوجه إلى وزارة الخارجية التركية لفحص مدى صحة المعلومات المنشورة .	يلامس	19	Sing
لكن الواضح أن كل ذلك لا يعني السماح للجماعة بكيان سياسي شرعي ، فـ " الإخوان " ، وهم أصحاب الجماعة الأكثر عدداً وربما نفوذاً ، يستبعدون ذلك وإن كانوا يأملون به .	يأملون	30	Plur
اشادت موسكو اليوم بتصريح رئيس الوزراء الهندى اتال بيهارى فاجبايى حول التزام بلاده بتسوية العلاقات مع باكستان ، ودعت اسلام اباد الى القيام بخطوات ايجابية مناسبة .	اشادت	0	Sing
وقال سعد الدين العثماني ، نائب الأمين العام لحزب العدالة والتنمية " لا يمكن إلا أن نرحّب بهذه الترجمة باعتبارها عملاً يستحق التنويه وضرورة دينية مادام القرآن قد ترجم إلى مئات من اللغات واللهجات " .	نرحّب	16	Plur
ويشار إلى أن اللطيفية تعتبر احد المناطق التي تكثر فيها النشاطات المسلحة المناوئة للوجود الاجنبي في العراق .	تكثر	8	Sing
لكن مراقبين يستبعدون حصول ذلك من دون ضوء أخضر من جهات عليا ، مما يفتح مجالاً للحديث عن تناقضات في الطريقة التي تتعاطى معها الحكومة المصرية مع " الإخوان المسلمين " .	تتعاطى	22	Sing
مكتبة الإسكندرية تسحب كتاب " بروتوكولات حكماء صهيون " من العرض . .	تسحب	2	Sing
رفيقك سيدفعك للقيام بأمور لا ترغب بالفعل في تنفيذها .	ترغب	5	Sing
وقال بعض من شاركوا في هذه الممارسات إنهم تحدثوا عنها بسبب الغضب من الأوامر الصادرة لهم بشأن أسلوب معاملة سجناء غوانتانامو .	تحدثوا	8	Plur
وحاول بعض المعلمين تجاوز هذه المشاكل وجلس التلاميذ على الارض لتلقي الدروس لكنهم لم يستطيعوا اكمال حصصهم اليوم على امل ان يجدوا طريقة لتحسين الوضع في الايام القادمة .	يجدوا	21	Plur
واكد مصدر مطلع على ملف تشكيل الحكومة ان لحود يريد تشكيلة موسعة تضم معظم القوى التي دعمت تمديد ولايته فيما يسعى الحريري الذي لم يتوصل الى اقناع المعارضة بالمشاركة الى ان تكون الحكومة حكومة مصغرة .	دعمت	16	Sing
وتندد بغداد باستمرار بالتاخر في تسلم المشتريات التي تتعاقد عليها في اطار هذا البرنامج وبقيام لجنة العقوبات بتجميد العقود المبرمة بايعاز من الممثلين الاميركيين والبريطانيين في هذه اللجنة خصوصا .	تتعاقد	8	Sing
مشكلتنا في لبنان ( الى سوء البنية الفوقية الزمني ) ان الحسد ينهش غير الواصلين ، فيرمون الواصلين برياح الحقد والاشاعات والتهم ، كي يسقطوا عنهم الهالة ، ولو انهم هم ، لن يستطيعوا بلوغ نعمة الهالة .	ينهش	12	Sing
يعرف عمر سليمان كل ذلك ، لهذا يحاول المساعدة في اختراع الآمال والتليين والتحذير لدفع الفلسطينيين إلى الانتظار في ظل صيغة تخفض الأضرار وتبقي الباب مفتوحاً ، خصوصاً أن شيئا ما يتحرك في إسرائيل .	تخفض	21	Sing
وكانت منظمة ( فاتف ) قد أدرجت مصر على قائمة الدول غير المتعاونة في مكافحة غسل الأموال في يونيو عام 2001 .	أدرجت	6	Sing
وقال وزير النفط السوري إبراهيم حداد : " في حال خرجت الشركات الأمريكية ، تأتي شركات عالمية أخرى " ، لافتاً إلى وجود شركات من دول عدة تستثمر في سورية .	تستثمر	27	Sing
واعلن الترابي في حديث الى صحيفة " الوان " نشرته اليوم ان تظاهرات الطلاب اتت " تعبيرا عن الرفض " الشعبي للسياسية الحكومية مشيرا الى التظاهرات كانت نتيجة " تدهور الوضع الاقتصادي وغلاء الاسعار ومشاكل المعلمين والطلاب " .	اتت	14	Sing
حماسك يلهم كل من حولك .	يلهم	1	Sing
ملامح رقمية اصلية لجثتين جافتين قديمتين / اضافة ثانية واخيرة / واضاف تشو هونغ ان العلماء وجدوا طريقا لقياس أبعاد الجمجمتين يتمثل فى سبر سماكة الانسجة اللينة بالابر على رأسى الجثتين .	وجدوا	16	Plur
واليوم ، غاب جبران والريحاني ، وبقي لنا منهما حنين دائم الى لبنان ( لبنانهما الخاص ) ، وأدب رائع عن ذلك الحنين ، عزاؤنا ان يعوّض عن ترهات ما كانا ينتقدانه في ساعات الغضب .	غاب	2	Sing
وتعهد دو فيلبان بذلك عقب اختتام جولة له شملت سبع دول فى الشرق الأوسط .	شملت	8	Sing
وقال " لا أدري لماذا لا يلتفت شيخ الأزهر إلى الكاثوليك واليهود الفرنسيين الذين قالوا للحكومة : ليس ذلك من حقها ، أو أن يلتفت إلى أمريكا وبريطانيا وغيرهما من الدول الغربية التي رفضت هذا القرار " .	يلتفت	6	Sing
وقال باراك الذي يمضى حاليا اجازة فى شمال اسرائيل ان الدولة العبرية لم تكن تسمح حتى الان بمثل هذه اللقاءات في المنطقة التى تعتبرها " منطقة عسكرية مقفلة " .	يمضى	3	Sing
ويقوم الفريق بتتبع العاملين الطبيين وتقديم تقارير للعالم الخارجى عن المعركة الشاقة ضد المرض الذى يشبه الانفلوانزا . كما يخبر القراء بقصص التضحية والشجاعة للاطباء والممرضات " ملائكة الرحمة " الذين يواجهون المرض .	يشبه	15	Sing
فاجبايى يعاود الكتابة لرئيس الوزراء الباكستانى	يعاود	1	Sing
تقرر تنظيم مهرجان الخيول العربية الاصيلة فى دورته الثالثة يومى 24 و 25 مايو الحالى بمعتمدية سيدى ثابت بولاية اريانة بتونس , حسبما ذكرت تقارير صحفية محلية .	تقرر	0	Sing
ومنذ عام 1993 نما حجم المعروض من الاسكان الفاخر والسياحي مع تقلص حاد في حجم المعروض من الاسكان المتوسط والشعبي خصوصاً مع اتجاه الدولة لإدراج شركات الاسكان الحكومية على قائمة الشركات التي سيتم البدء في تخصيصها .	نما	3	Sing
احتلال ثان للعراق " ، قالت صحيفة تركية إن الإدارة الأمريكية المؤقتة في العراق أصدرت تراخيص تتيح لشركات إسرائيلية امتلاك الأراضي .	تتيح	16	Sing
واضاف " استطيع ان اؤكد الان بان المسؤولين عن الاشغال لديهم ما يكفي من التصميم والجدية لكي يعوضوا التأخير الحاصل حتى لو اقتضى الامر تأمين فرق اضافية تعمل 24 ساعة على 24 " .	يعوضوا	17	Plur
< تبادل مسؤولون اقتصاديون سعوديون ومصريون ، أمس في جدة ، الشكاوى والشكاوى المضادة من المعوقات التي تعترض زيادة التبادل التجاري بين السعودية ومصر ، خلال زيارة إلى السعودية يقوم بها وزير مصري وبرفقته عدد من رجال الأعمال .	تعترض	17	Sing
وزراء خارجية الاتحاد الاوربى يبحثون عودة البعثات الدبلوماسية الى العراق اثينا 2 مايو / شينخوا / يبحث الاتحاد الاوربى مسألة عودة البعثات الدبلوماسية الى بغداد كأحدى الخطوات الاولى التى يبحثها الاتحاد فى اعقاب الحرب العراقية .	يبحثون	4	Plur
ويزور اهالي جنوب لبنان هذه المنطقة حيث يوجد ، بحسب التقليد ، مزار الشيخ العباد الذي توفي منذ 500 عام . ويقدس الاسرائيليون من جهتهم هذا المكان ايضا حيث عاش ، حسبما يقولون ، الحاخام عاشي في القرن الخامس .	يقولون	32	Plur
ارتفعت الواردات المحلية من الياميش إضافة إلى سلع أخرى تستهلك بكثرة في الشهر الكريم مثل الفوانيس والبيض والعسل والزبادي ! !	تستهلك	9	Sing
وعلى رغم أن الطلب لم يبت ، إلا أن الخيار لم يستبعد علماً أن الحكومة لا ترغب في اللجوء إليه .	يبت	5	Sing
نفى الرئيس حسني مبارك تعرض مصر لأي ضغوط تربط بين المساعدات وبين فرض الديموقراطية .	تربط	8	Sing
وفي تطور ميداني سابق تحطمت مروحيتان للجيش الأمريكي جنوب غرب بغداد مساء اول امس ، مما أسفر عن مقتل جنديين أمريكيين وجرح اثنين آخرين من أفراد طاقميهما .	أسفر	16	Sing
وقال رئيس اتحاد المقاولين المصريين المهندس أحمد السيد إن نسبة التعويض التي أقرتها الحكومة أخيراً لموازنة العقود والبالغة 10 % قلصت من حجم خسائر شركات المقاولات نسبيا غير أن استمرار ارتفاع أسعار مواد البناء يهدد بتفاقم هذه الخسائر مجدداً .	يهدد	34	Sing
وبين المشاركين من لا يؤمن أصلا بعملية التفاوض ويرى فيها قدراً من التفريط أو يعتبرها ثمرة لقصور في الرؤية يستدرج صاحبه إلى رهانات فاشلة .	يستدرج	19	Sing
ونفى بيان لوزارة العمل والشؤون الاجتماعية السعودية اليوم ما تردد مؤخراً عن معدل البطالة أنها بين 14 و 30 % من قوة العمل واعتبرها تفتقد للدقة والصحة على الإطلاق .	تفتقد	24	Sing
وهاجم بيومي من يشككون في نزاهة علماء الأزهر وحيادهم لدرجة اتهامهم بأنهم يشبهون محاكم التفتيش ، مؤكدا أن من حق المتضررين أن يلجأوا إلى القضاء " إذا شعروا أن هناك أي ظلم أو مصادرة للفكر " .	يشبهون	12	Plur
وبدلاً من أن يراعي مسؤولو البنك المركزي هذه الأجواء القائمة ويدعموا الشركات التي يعمل بها ما يقرب من ألف عامل استمروا في تهديدها بالإغلاق ورفضوا مطالبات الصيارفة بتأجيل سريان النص القانوني الخاص برفع رأس المال إلى 20 مليون جنيه .	استمروا	20	Plur
وفي المقابل ، اعتبر وزير الخارجية اليوناني اندرياس باباندريو في مقابلة مع صحيفة » اليفتيروس تيبوس « نشرت أمس ، أن أثينا وأنقره لا يمكنهما سوى اتباع طريق السلام حتى وإن اختلفت مواقفهما حول مسألة قبرص .	اختلفت	31	Sing
فقد اقتصرت الرؤية في بحر بارنتس على بعد مترين اثنين فقط ، ولم يتوصل الضباط الذين يوجهون الكبسولة من على متن سفينة عسكرية ، من توجيهها نحو احد منافذ الخروج .	يوجهون	16	Plur
وقال إن أثار خفض سعر الفائدة مع الودائع بالبنوك لم تتضح بالسوق " لم تؤثر سلباً على السوق " بل زادت أسعار الانتربنك الداخلي " بين البنوك " من 6 إلى 7 % .	تؤثر	14	Sing
وفي هذه الأثناء ، استدعى دبلوماسي إسرائيلي رفيع المستوى إلى وزارة الخارجية التركية ، حيث أعرب أحد المسؤولين الكبار أمامه عن قلق تركيا إزاء النشاط الإسرائيلي في شمال العراق .	استدعى	4	Sing
قللت إدارة هيئة قناة السوس من أهمية تصريحات وزير المالية الإسرائيلي بنيامين نتنياهو لصحيفة " لوفيجارو " الفرنسية يوم 17 / 11 الحالي بأنه يأمل في إنشاء خط لسكك الحديد ينافس قناة السويس ويربط بين مرفأي اشدود وإيلات الإسرائيليين .	قللت	0	Sing
اشادت شركة سيمنز الالمانية بشفافية السياسات التى تتمسك بها حكومة بلدية شانغهاى فى مجال مكافحة السارس مؤكدة ان الشركة قد اتخذت اجراءات فعالة للوقاية عن هذا الوباء بفضل هذه السياسات .	اشادت	0	Sing
وقال احد اولئك اللبنانيين للصحافيين الذين احتشدوا على الجانب اللبناني من الحدود " لقد اتينا لنطلب من العذراء التي يصادف عيدها اليوم ان تخفف من الامنا " .	تخفف	23	Sing
وستقوم لجنة يرأسها الشيخ فوزي الزفزاف بإعداد رؤية شرعية شاملة عن الأفكار البهائية التي جعلت بعض شيوخ الأزهر والمسؤولين عن الإفتاء في مصر يحكمون على البهائيين بالكفر والخروج من الملة .	يحكمون	23	Plur
اعتبارا من اواخر عام 2002 سجلت المقاطعة 208140 علامة تجارية صالحة اى ما يشكل اكثر من ثمن الاجمالى الوطنى . ومن ذلك اصبحت 309 علامات تجارية مشهورة .	اصبحت	22	Sing
وقد غرقت الغواصة " كورسك " السبت نتيجة انفجار على ما يبدو . ويقول الاميرال كوروييدوف ان " انفجارا في مقصورة الطوربيدات الاولى " اصاب الغواصة باضرار وادى الى غرقها الى القاع .	اصاب	24	Sing
وقال رمضان : » يريدون ان يجعلوا بعض العاملين من مراقبي برنامج » النفط للغذاء « مرادفين للجواسيس المفتشين « .	يجعلوا	6	Plur
اطوار القضية تفيد ان مكالمة هاتفية وردت على اعوان الامن يفيد فيها الاطار الاداري لاحدى المؤسسات الاستشفائية بنابل قبول مواطن مصاب بطلق ناري ـ وفقا لمعلومات طبية .	يفيد	10	Sing
أما بالنسبة للسوق المصري فيرى محمد أوزالب أن الجنيه المصري له علاقة مباشرة بالدولار ، فإذا صعد الدولار أو هبط أمام العملات الآسيوية مثلا ، فإن الجنيه يصعد أو يهبط أمامها .	يهبط	29	Sing
الأزهر يصادر كتاباً جديداً لنصر أبو زيد لاتهامه بـ " الطعن في صحيح العقيدة "	يصادر	1	Sing
ولكي لا يظل الحوار دائراً في سياق أهداف الحزب الوطني دون سواها ، فعلى أحزاب المعارضة أن تتمسك بوقت زمني مجدد لإنهائه ، وببرنامجها للإصلاح السياسي والدستوري كهدف له لكي ترفع الالتباس بشأن مشاركتها فيه أمام الرأي العالم .	ترفع	30	Sing
من جهة اخرى ، ابعد مناف ابو شقير ومبروك زايد وصالح الصقري ومرزوق العتيبي عن التشكيلة ، في حين استدعى الجهاز الفني للمنتخب بقيادة ناصر الجوهر ظهير الاهلي الايسر اسامة برناوي بعدما كان استبعد قبل اسبوع .	استبعد	33	Sing
وفي مقابلة نشرت في 26 تموز / يوليو الماضي ، اعلن نائب الرئيس العراقي طه ياسين رمضان ان بلاده تعتزم اعادة النظر في تطبيق الاتفاق الذي شكك في فائدته .	تعتزم	19	Sing
وقال إن " المسلمين يرفضون سائر المبادرات التي تمس حق العودة للاجئين الفلسطينيين وتساوم على القدس ومقدساتها . .	يرفضون	4	Plur
من جهة اخرى اعلن الجنرال غابي اشكينازي قائد المنطقة الشمالية التى تشمل الحدود مع لبنان اليوم الثلاثاء ان اسرائيل " تبذل ما تستطيع لتجنب التصعيد فى لبنان " على الرغم مما يسببه رشق الحجارة من اذى .	تشمل	11	Sing
السياح يمتنعون عن القدوم بسبب كثرة الأعباء والرسوم . مصر تخسر عوائد سياحة اليخوت بسبب البيروقراطية	يمتنعون	1	Plur
ولم يشر بن عامي لا الى مستوطنات قطاع غزة ولا الى الحي اليهودي التي تسيطر عليه اسرائيل في الخليل حيث الحرم الابراهيمي ، احد الامكنة المقدسة لدى اليهود والمسلمين .	يشر	1	Sing
منح الاتحاد الاوروبى 37 مليون يور / حوالى 350 مليون يوان صينى / الى الصين لتنفيذ مشروع بيئى شامل بين الاتحاد الاوروبى ولياونينغ الصينية . واستثمرت الصين ايضا 11.5 مليون يورو فيه ايضا على تقسيط خلال 5 سنوات .	منح	0	Sing
ويشترك مرفأ البصرة ومرفأ خور العمية في بعض قطاعات البنية الاساسية لضخ النفط وتقول المصادر ان ذلك قصر الصادرات الاجمالية من الجنوب حتى الان على 1.8 مليون برميل في اليوم تقريبا .	قصر	17	Sing
ووعد ديك براس القراء بقوله " سنضع بين ايديكم كتبا تحكي . وستجدون فيها الصوت والصورة والنص " .	تحكي	10	Sing
وتؤكد أرقام مصلحة الضرائب أن نشاط الدروس الخصوصية يزيد عن 6 مليارات جنيه سنوياً لا تزيد حصة الضرائب منها عن نصف مليون جنيه بسبب تهرب المدرسين وأصحاب مراكز الدروس الخصوصية من دفع حقوق خزانة الدولة .	تزيد	15	Sing
بغداد 15 - 8 ( اف ب ) - اعلن وزير التجارة العراقي محمد مهدي صالح اليوم الثلاثاء ان العراق خسر اكثر من 140 مليار دولار بسبب الحصار المفروض عليه منذ آب / اغسطس 1990 .	خسر	20	Sing
وأكدت على ان الاجراءات الفعالة للسيطرة على المرض من شأنها ان تقلل الى حد كبير من خطر العدوى , مع انها اعترفت بانه " ليس هناك ما يعرف بعدم وجود خطر على الاطلاق " فى مجال الصحة .	تقلل	11	Sing
وقد استطاع القبارصة الأتراك واليونانيون عبور خط التقسيم للقيام بزيارات على مدار الأسبوعين الماضيين ، بعد أن خفف نظام حكم القبارصة الأتراك القيود المفروضة على حرية حركة المواطنين .	خفف	17	Sing
وقد تجمع عشرون لبنانيا مسيحيا بينهم نساء واطفال كانوا فروا الى اسرائيل بعد الانسحاب الاسرائيلي اليوم للصلاة على الحدود بين البلدين .	فروا	9	Plur
ويبدو ان التنسيق بين لجنة المتابعة وقيادة الحزب لم تتم بالشكل الكافي ، بحيث دفعت الحزب الى اتخاذ هذا الموقف من البيان الانتخابي بالرغم من ان الادارة اكتفت بالتعديلات الثانية التي ادخلت على البيان الانتخابي .	دفعت	14	Sing
ولا يجوز إسباغ وصف الأثر الإسلامي والقبطي على هذه المقابر . .	يجوز	1	Sing
ونقلت وكالة ايتار تاس عن المكتب الصحافي لاسطول الشمال ان نتائج الفحص الاولي لهيكل السفينة لم يتح تاكيد حدوث انفجار داخلها .	يتح	16	Sing
" بلاش تفتكر إنك حصلت على سبق صحفي وتثير الرأي العام فالبيزنس ليس له علاقة بإسرائيل أو مصر ورأس المال ليس له وطن ولا دين " . .	حصلت	4	Sing
ووصفت هذه المصادر الموقف السوري بأنه يتسم بديناميكية واضحة ربما ترسم صورة جديدة للسياسة السورية إزاء ملفات الإرهاب ، ومرحلة ما بعد الحرب العراقية ، والعلاقة مع المنظمات الفلسطينية ، والوجود السوري في لبنان وملف أسلحة الدمار الشامل .	ترسم	10	Sing
واشارت الصحيفة الى ان لندن لا تسمح لمسؤولين صينيين بالدخول الى بريطانيا بسبب احتمال القيام باعمال انتقامية ضد اعضاء من عائلات الناجين لا يزالون في الصين .	يزالون	23	Plur
وحسب الصحيفة التي لم تذكر مصادرها فان " كل شيء يدل على ان فرنسا طلبت من الليبيين دفع فدية مكانها " . ومقابل ذلك " تعهدت باريس بمساعدة ليبيا على العودة الى الساحة الدبلوماسية " في العالم .	تعهدت	25	Sing
وفى بلدة يطا جنوب الخليل قالت مصادر فلسطينية ان فلسطينيين قتلا برصاص الجيش الإسرائيلى خلال عملية اقتحام مماثلة للبلدة فى وقت متأخر من ليلة الأربعاء الخميس ، مضيفة ان عملية الاقتحام استهدفت اعتقال عدد من المطلوبين .	استهدفت	31	Sing
وكم عدد جنود الجيش المصري الذين ساهموا في تحرير الكويت ؟	ساهموا	6	Plur
وقال عضو الكتلة البرلمانية لـ " الإخوان المسلمين " الدكتور حمدي حسن إن المشروع سيوقعه نواب مستقلون وآخرون ينتمون إلى أحزاب المعارضة وسيقدم في جلسات البرلمان التي ستبدأ يوم 13 / 12 الحالي .	ينتمون	18	Plur
وقال طنطاوي بعد استقباله وزير الداخلية الفرنسي نيكولا ساركوزي " إذا كانت المرأة المسلمة في غير دولة الإسلام ، كدولة فرنسا مثلا ، وأراد المسؤولون فيها أن يقرروا قوانين تتعارض مع مسألة الحجاب للمرأة المسلمة فهذا حقهم . .	تتعارض	29	Sing
تُعيد الحكومة المصرية النظر في تنفيذ مشاريع الـ » بي أو تي « بعد تسريب تقارير عن أن بعض الشركات الدولية المتقدمة خالف العقود فيما تقرر تأجيل تخصيص شركة الاتصالات الحكومية وطرح أسهمها في البورصات الدولية لأجل غير مسمى .	خالف	22	Sing
قال / / ايتسو هاتور / / كبير مندوبى تويوتا بالصين فى بكين قال لصحيفة / تشايناديلى / ان تويوتا تتوقع ان تبيع مائة الف سيارة فى الصين هذا العام بما فى ذلك سيارات مصنعة محليا او مستوردة .	تتوقع	20	Sing
واعتبر ان ضم هذه المناطق والاعتراف الدولي بالسيادة الاسرائيلية على احياء يهودية اقيمت منذ 1967 في القدس الشرقية ، سيشكل " نجاحا كبيرا " .	اقيمت	12	Sing
واعلن ممثلو شركة النفط الوطنية النيجيرية ان الفي شخص تقريبا كانوا يحاولون شفط النفط من الانبوب بعد ثقبه لبيعه لاحقا عندما وقع الانفجار .	يحاولون	11	Plur
موسكو 15 - 8 ( اف ب ) - قال وزير الدفاع الروسي ايغور سيرغييف ان البحرية الروسية باشرت اليوم الثلاثاء عملية اجلاء 116 بحارا عالقين في الغواصة النووية الروسية كورسك في قعر بحر بارنتس .	باشرت	18	Sing
وكان وزير الدفاع الروسي ايغور سيرغييف اعلن بعد ظهر اليوم ان البحرية الروسية باشرت " عملية اجلاء " افراد طاقم الغواصة " كورسك " ال 116 .	باشرت	13	Sing
وما زال هذا الملف أحد أبرز المؤشرات الى انفراج في العلاقة الايرانية - العراقية أو تأزمها ، نظراً الى طابعه الانساني والسياسي . واتهمت بغداد طهران أخيراً بالضلوع في انفجار وقع في العاصمة العراقية .	وقع	30	Sing
وقد ألقى محام قبطي شهير محاضرة بالدورة حول علاقة نساء الأقباط بالكنيسة ، وطالب فيه بفتح باب للحوار بين الكنيسة والنساء القبطيات اللاتي طلبن الخلع حتى يتم الاعتراف بالخلع .	طلبن	23	Plur
ولا تخضع رواتب مسؤولي صندوق النقد الدولي الذي يتخذ من واشنطن مقرا له للضرائب في الولايات المتحدة ، واعلن متحدث باسم الصندوق لمراسل وكالة فرانس برس انه لا يعلم ما اذا كان يتعين على كوهلر تسديد ضرائب في المانيا .	يتعين	32	Sing
كيف يمكن الدولة ان تقيم حواراً انقاذيا تقريبا مع الدول والمؤسسات الغريبة ، وهي لا تقيم حوار - الحد الادنى من التفاهم مع بعض القوى اللبنانية ؟	تقيم	4	Sing
وكان الاتحاد الدولي اوقف اوتي في 5 تموز / يوليو عام 1999 لثبوت تناولها منشطات من مادة الناندرولون خلال الفحص الذي خضعت له بعد لقاء لوسيرن السويسري ، لكنها اكدت مرارا براءتها مشيرة الى وجود تلاعب في عينة البول .	اوقف	3	Sing
وهاجم بيومي من يشككون في نزاهة علماء الأزهر وحيادهم لدرجة اتهامهم بأنهم يشبهون محاكم التفتيش ، مؤكدا أن من حق المتضررين أن يلجأوا إلى القضاء " إذا شعروا أن هناك أي ظلم أو مصادرة للفكر " .	شعروا	27	Plur
ومن جهة اخرى ، هناك ضحايا يتعرضون لاعمال عنف مرات عدة في السنة ، فالنساء يتعرضن لمثل هذه الاعمال 4،9 ملايين مرة تقريبا والرجال 2،9 مليون مرة في السنة .	يتعرضون	6	Plur
في موسكو برهن رئيس الوزراء الاسرائيلي مجدداً ان عداءه للحقيقة اصيل ، واثبت ان السلام بالنسبة اليه كما القُماشة الحمراء للثور ، واكد انه اكتسب لقب » البلدوزر « عن جدارة واستحقاق .	برهن	2	Sing
قام العاهل الأردنى فور عودته من لندن مساء اليوم بزيارة الى المدينة الطبية حيث اطمأن على حالة الجرحى الثلاثة الذين أصيبوا فى الانفجار .	أصيبوا	20	Plur
علمنا ان المرصد الوطني للانتخابات ضبط استمارات لكل مرحلة من مراحل الانتخابات سيتم عرضها على المعنيين بالاستحقاق الانتخابي .	ضبط	5	Sing
وانتقد الاسد بشدة السبت جنبلاط بدون ان يسميه مؤكدا ان سوريا تدخلت عام 1976 في بداية الحرب اللبنانية لانقاذ المسيحيين من " المجازر " التي كانوا يتعرضون لها " باسم الاشتراكية والعدالة واصلاح النظام السياسي " .	يتعرضون	26	Plur
هم اتبعوا الإنجيل المقدس ، لكنهم لم يعرفوا القرآن ، أما أنا فعرفته ، ومهمتي حالياً هي نشره " .	اتبعوا	1	Plur
يقدم المعرض نخبة رائعة من المعروضات تصل الى مائة لوحة توضح أهتمام رايدر بعنصرى اللون والضوء لتوظيفهما للتعبير عن المشاعر الفياضة التى غلفت أفكاره .	غلفت	22	Sing
عرفات يلتقى بوفد من القضاة فى فلسطين	يلتقى	1	Sing
تتصدر مقاطعة قوانغدونغ غيرها بالصين من حيث عدد تكنولوجيا براءات الاختراع والعلامات التجارية المسجلة , علما ان هذه المقاطعة مركز اقتصاد هامى وهى ايضا بوابة الصين الجنوبية .	تتصدر	0	Sing
ويبدو ان ركاب الطائرة سقطوا من الطائرة عندما فتح الباب الخلفى للطائرة على ارتفاع 7 الاف قدم / 2200 متر / تقريبا فى منتصف الطريق بين كينشاسا ولوبومباشى ليلة امس الخميس .	سقطوا	4	Plur
* * احتمالات الحرب ولكن هل يمكن أن تجازف إسرائيل بشن حرب ضد مصر برغم السلام الموقع بينهما ووجود سفارة إسرائيلية في القاهرة ؟	تجازف	8	Sing
وطالب الحزب بتنظيم مسابقة مصرية تتضمن الأسئلة التالية : " كم عدد المدرسين المصريين الذين ساهموا في محو أمية الشعب الكويتي قبل اكتشاف النفط وبعده ؟	ساهموا	15	Plur
كما أطلع المسئولون تونغ فى وقت سابق صباح اليوم على عمل فريق استجابة متعدد التخصصات فى مختلف المجالات من بينها الإجراءات الخاصة بتعقب الاتصال بالمرضى واجراءات التنظيف والتطهير داخل المجتمع .	أطلع	1	Sing
وتأمل دبي في أن تصبح مقراً إقليميا لتجارة المعادن الثمينة بعد أن رسخت نفسها في السنوات الأخيرة في تجارة المعدن الأصفر .	رسخت	12	Sing
وقد تخطى حجم التبادل التجاري بين مصر والصين للمرة الأولى سقف المليار دولار مسجلاً في نهاية العام الماضي ملياراً و 90 مليون دولار بزيادة نسبتها 15.4 % مقارنة بالعام السابق .	تخطى	1	Sing
وقد يكون احتكاك كهربائي ادى الى اندلاع حرائق عدة وحتى الى وقوع انفجار ادى الى غرق المفاعل النووي للغواصة . وعلى الارجح ان قبطان الغواصة اعطى الامر باطفاء كل الالات على متنها .	ادى	13	Sing
وقال مواطنون في القرية إن قوات معززة من الجيش الاسرائيلى اقتحمت القرية في وقت سابق واشتبكت مع عدد من المسلحين الفلسطينيين كما داهمت العديد من المنازل بحثا عن " مطلوبين " .	اقتحمت	10	Sing
وكان لافتاً أن شيخ الأزهر أصر أن يكون حديثه أمام وكالات الأنباء العالمية حتى ينقلوا رأيه من دون أي مزايدات أو مغالطات ، وذلك بعدما عقد جلسة مع ساركوزي اقتصرت عليهما .	أصر	5	Sing
وقال كلينتون امام الاف المندوبين الديموقراطيين " قبل اربعين عاما في لوس انجليس اطلقنا جون اف . كينيدي والحدود الجديدة . واليوم نحن هنا لنطلق الرئيس الاول للقرن المقبل ، آل غور " المرشح الديموقراطي للانتخابات الرئاسية .	اطلقنا	13	Plur
وكان ماجد المطيري ( 35 سنة ) الذي يعمل في وزارة الداخلية أعلن عبر محاميه أنه سيقدم دعوى ضد عناصر المباحث الذين اساؤوا معاملته .	اساؤوا	22	Plur
ويقول " إن الرجل أكثر ذكاء مما تعتقدون وهو ليس متقلب الآراء كما تحسبون ، إنه إنسان براجماتي ، صاحب خط منهجي للاعتدال .	تحسبون	13	Plur
مسئول ايرانى : طهران لن تتدخل فى الشئون الداخلية للعراق للعراق	تتدخل	5	Sing
فقد اقتصرت الرؤية في بحر بارنتس على بعد مترين اثنين فقط ، ولم يتوصل الضباط الذين يوجهون الكبسولة من على متن سفينة عسكرية ، من توجيهها نحو احد منافذ الخروج .	يتوصل	13	Sing
وقالت مصادر سعودية ان الزيارة التي كان مقرراً ان تستمر ساعات تقرر تمديدها الى صباح اليوم .	تقرر	11	Sing
واكد ان " الاطفال والكبار يمكن ان يصابوا بادمان على المشروبات التي تحتوي الكافيين وان يشعروا باعراض النقص جسديا ونفسيا اذا توقفوا عن شربها " .	توقفوا	21	Plur
وقال ان حادث الغواصة رقم 361 كان خسارة فادحة لبحرية جيش التحرير الشعبى الصينى مشيدا بشجاعة البحارة السبعين جميعا الذين كانوا فى الغواصة والذين اثبت سلوكهم وطنيتهم الحقيقية .	اثبت	24	Sing
الهضيبي يحث مسيحيي العالم على التصدي للسياسات الأمريكية	يحث	1	Sing
واشارت صحيفة الاحد الى ان المستشار شرودر يعتبر ان حصول المجموعة الاميركية على رخصة تصنيع ليوبارد 2 يعرض للخطر المصالح التكنولوجية الاساسية لالمانيا وطلب من وزير الدفاع رودولف شاربينغ التوجه الى اسبانيا .	يعرض	17	Sing
وتوقع الطويهر أن تحوز المنتجات والسلع والخدمات السعودية في المعرض إعجاب المسؤولين ومنظمات الأعمال والسوق المصرية وأن يساهم ذلك في تعزيز العلاقات الاقتصادية بين البلدين .	تحوز	3	Sing
عبيد ووزراء يعزون بوفاة قيادي في الإخوان	يعزون	2	Plur
كما يطلب مشروع القرار من الامين العام للامم المتحدة كوفي انان رفع تقرير الى المجلس كل ثلاثة اشهر حول وضع امتثال سوريا .	يطلب	1	Sing
وبالطبع لا تطمع الشركة الأجنبية الجديدة في أن يتوفر لديها ستة ملايين امرأة مشتركة في التأمين ضد الطلاق إلا أنها تتوقع عدداً كبيراً تخشى طبعاً أن يتعرض لهذه المحنة حيث سيكلفها ذلك الكثير .	يتوفر	8	Sing
مطالبات بوقف برنامج التخصيص . مصر تنوي بيع الحصص الباقية في الشركات التي تم تخصيصها تخصيصها	تنوي	6	Sing
رفضت المصارف المصرية نهائياً مقايضة ديون المتعثرين بمشاريعهم العقارية خصوصاً ان قيمتها تتجاوز 5.6 بليون جنيه ( 6،1 بليون دولار ) ديون رجال أعمال ومستثمرين يعملون في مجال العقارات لم يسدد أي جزء منها بسبب أوضاع السوق .	تتجاوز	12	Sing
كما شهدت الأيام الماضية انتعاشاً ملحوظاً في دور الوسطاء الذين ينتمون إلى كبار التجار والمتعلق ببيع الحديد على أرض المصانع دون الانتقال للمخازن .	ينتمون	10	Plur
رجاؤنا أن يسود العالم الوفاق والسلام وتتعمّق روح التعاون والتضامن والتضامن	يسود	2	Sing
وتأتي هذه الزيارة بعد أيام على إقرار " قانون المحاسبة " الذي يقترح عقوبات اقتصادية وسياسية .	يقترح	12	Sing
واكد بن عامي من جهة اخرى ان اسرائيل اعلنت " انها لا يمكن ان تتخلى عن ارثها في جبل الهيكل " في القدس حيث يوجد الحرم القدسي .	تتخلى	14	Sing
واضاف " استطيع ان اؤكد الان بان المسؤولين عن الاشغال لديهم ما يكفي من التصميم والجدية لكي يعوضوا التأخير الحاصل حتى لو اقتضى الامر تأمين فرق اضافية تعمل 24 ساعة على 24 " .	اقتضى	22	Sing
وتابع الوزير الذي كان يرد على اسئلة الاذاعة من كندا التى يزورها حاليا " ان الطرفين يعرفان بشان مسالة القدس واللاجئين ايضا ، الى اين يتجهان واين هي الخطوط الحمر لكل طرف " .	يرد	4	Sing
وكان ستة الاف لبناني تقريبا غالبيتهم من عناصر الجنوبي وعائلاتهم فروا من لبنان في 24 ايار / مايو الماضي خلال انسحاب الجيش الاسرائيلي خوفا من عمليات انتقامية من جانب حزب الله الشيعي الاصولي .	فروا	10	Plur
الأزهر يعيد فتح ملف البهائية	يعيد	1	Sing
1968 - انقلاب عسكري في العراق يطيح نظام عبد الرحمن عارف ومجلس قيادة الثورة يختار احمد حسن البكر رئيسا للجمهورية .	يختار	14	Sing
عشرون لبنانيا فروا الى اسرائيل اتوا للصلاة على الحدود	اتوا	5	Plur
وقال الجيش الروسي ان المتمردين يفقدون شيئا فشيئا نفوذهم في المناطق الجبلية من الشيشان وانهم " شنوا حملة ترهيب ضد السكان المحليين الذين يؤيدون احلال النظام " .	يفقدون	5	Plur
تُعيد الحكومة المصرية النظر في تنفيذ مشاريع الـ » بي أو تي « بعد تسريب تقارير عن أن بعض الشركات الدولية المتقدمة خالف العقود فيما تقرر تأجيل تخصيص شركة الاتصالات الحكومية وطرح أسهمها في البورصات الدولية لأجل غير مسمى .	تُعيد	0	Sing
وموازاة مع ذلك اصدر حاكم التحقيق المكلف بالبحث في ملف القضية انابة عدلية تعهد بمقتضاها محققو فرقة الابحاث العدلية للحرس الوطني بنابل بمواصلة البحث في الموضوع .	اصدر	3	Sing
تنتحل صفة خادمة لتتسلل للمنازل للمنازل	تنتحل	0	Sing
واما المتهمة في هذه القضية فهي وكما اشرنا امرأة متزوجة ولها رضيع يبلغ من العمر حوالي شهرين وسبق لها ان ترددت كثيرا على السجون منذ كان عمرها 13 سنة .	يبلغ	12	Sing
ويرى رجل الأعمال المصري محمد المصري أن الأوضاع الراهنة تحتم الاتفاق على آلية جديدة تنظم التبادل التجاري السعودي ـ المصري من دون إخلال بارتباطات واتفاقات البلدين المبرمة مع دول وتجمعات أخرى .	تحتم	9	Sing
كما استفسر أعضاء هيئة التدريس عن مدى صحة ما يتردد أيضا بأن الجامعة قد تبرعت بملغ يقدر بالملايين لجمعية المستقبل .	يتردد	9	Sing
مراسلو شينخوا يدخلون مستشفى لعلاج السارس	يدخلون	2	Plur
وقد كانت الابحاث انطلقت عندما تشابهت التشكيات التي تقدم بها تجار افادوا انهم باعوا سلعا لثلاثة تجار استعملوا صكوكا بنكية كوسيلة للخلاص واتضح في ما بعد انها دون رصيد ومــزورة .	استعملوا	17	Plur
ذكرت وكالة الانباء الفلبينية ان ماليزيا افرجت اليوم عن 22 فلبينيا كانوا قد اعتقلوا داخل المياه الاقليمية الماليزية وبحوزتهم متفجرات فى الشهر .	اعتقلوا	13	Plur
ويمنع المخطط الاستيطاني الجديد أي تمدد أو تواصل بين بيت لحم وبيت ساحور من جهة ، ويؤمن تواصلاً بين المستوطنات في هذه المنطقة ، ما يقطع الطريق أمام أي إمكانية حقيقية لاستعادة ولو أجزاء من القدس الشرقية .	يقطع	25	Sing
أعلن مستشفى اتحاد كليات الطب في بكين أمس السبت أن المرضى الستة من الاجانب المصابين بوباء الالتهاب الرئوى الحاد / سارس / قد غادروا المستشفى بعدما تماثلوا للشفاء .	تماثلوا	26	Plur
وكان قريع أمهل منذ بدء الأزمة الأخيرة في نهاية الشهر الماضي ، عرفات خمسة أسابيع للاستجابة لمطالبه ، والتي ستنتهي هذا الأسبوع .	أمهل	2	Sing
يحمّلون الطوائف وزر النفر من المحسوبين عليها ، والدين منهم براء وهو يردد : لا تخف من لقاء الاشرار ، انهم يجفّون كالعفن تحت خيوط الشمس .	تخف	15	Sing
ويوجد 116 رجلا على متن الغواصة الراقدة منذ الاحد في بحر بارنتس شمال غرب روسيا حيث لا تزال العواصف تعيق اجلاءهم .	تعيق	19	Sing
وذكر البيان ان الاثنين والعشرين فلبينيا قد اعتقلوا فى 27 ابريل عندما ضل قاربهم طريقه فى الماليزية بسبب سوء حالة الملاحة الليلية .	ضل	12	Sing
اكد كمال سناده مدير ادارة التجارة والتنمية بالامانة العامة لجامعة الدول العربية ان السودان سيجذب المزيد من الاستثمارات العربية والاجنبية نظرا للامكانات والموارد الهائلة التى يذخر بها .	يذخر	25	Sing
واوضج صبري ان تجديد الفتوى جاء بعد صدور تقارير عن وزارة الداخلية الاسرائيلية تفيد ان 183 فلسطينيا مقدسيا تقدموا للحصول على الجنسية الاسرائيلية خلال العام الحالي مقابل 98 خلال نفس الفترة من العام الماضي .	تقدموا	18	Plur
الكويت تقرر ارسال ثمانى وحدات لتحلية المياه الى العراق	تقرر	1	Sing
وكان الشيخ حمد زار اليمن الاسبوع الماضي ثم السودان واريتريا اللذين يسعى للتقريب بينهما اثر تدهور علاقاتهما .	زار	3	Sing
وقد تعذر الاتصال صباحا بممثلي شركة النفط الوطنية والحكومة في كالابار للحصول على تعليق على الحادث .	تعذر	1	Sing
واعلن رسميا ان انفجار وسط موسكو الثلاثاء الماضي اوقع 120 ضحية بينهم 12 قتيلا وخمسون جريحا لا يزالون في المستشفيات .	يزالون	17	Plur
وبالطبع لا تطمع الشركة الأجنبية الجديدة في أن يتوفر لديها ستة ملايين امرأة مشتركة في التأمين ضد الطلاق إلا أنها تتوقع عدداً كبيراً تخشى طبعاً أن يتعرض لهذه المحنة حيث سيكلفها ذلك الكثير .	يتعرض	26	Sing
لكن ستيفن الذي تابع العملية التي قادت الى مؤتمر المصالحة في عرتا ( جيبوتي ) الذي افتتح في الثاني من ايار / مايو ، شدد على ان المجتمع الدولي لن يعطي توقيعا على بياض الى المؤسسات الانتقالية التي ستعين .	يعطي	30	Sing
المصرفيون أرجعوا السبب في ذلك إلى عدم استقرار سعر الصرف ووجود اختلافات جوهرية عند تطبيق دراسات الجدوى الخاصة بهذه المشروعات .	أرجعوا	1	Plur
كيف يمكن الدولة ان تقيم حواراً انقاذيا تقريبا مع الدول والمؤسسات الغريبة ، وهي لا تقيم حوار - الحد الادنى من التفاهم مع بعض القوى اللبنانية ؟	تقيم	15	Sing
أعلن فضيلة الشيخ الدكتور محمد سيد طنطاوي شيخ الأزهر الشريف ، أن من حق فرنسا إصدار قانون يحظر ارتداء الحجاب .	يحظر	17	Sing
وقد قصف مساء اول امس مبنى اخر في ضواحي الفلوجة يزعم الجيش الامريكي انه يؤوي ما بين 15 و 20 مقاتلا سبق وان اكد انهم كانوا يجرون تدريبات ذات طابع عسكري فيه .	قصف	1	Sing
فيما يلى ابرز العناوين الخاصة بالشؤون العربية فى الصحف الصينية الصادرة اليوم السبت .	يلى	1	Sing
تقرير اخباري : الانظار تتوجه الى دمشق حيث يزورها كولن باول	تتوجه	4	Sing
واضاف البيان ان " اثني عشر خائنا يتعاملون مع ادارة احمد قديروف ( الذي عينته موسكو ) قتلوا خلال شهر ، منهم سبعة من كبار الموظفين " ، تنفيذا لاحكام اصدرتها محكمة الشريلتعامل مع الادارة الموالية لروسيا .	يتعاملون	7	Plur
أما أحمد ماهر وزير الخارجية المصري فقد أوجز رد الفعل المصري على التصريحات الإسرائيلية المستفزة في كلمات قليلة وقوية حين قال إن مصر قادرة على الدفاع عن نفسها وحماية أراضيها ضد أي عدوان .	أوجز	7	Sing
يعرف عمر سليمان كل ذلك ، لهذا يحاول المساعدة في اختراع الآمال والتليين والتحذير لدفع الفلسطينيين إلى الانتظار في ظل صيغة تخفض الأضرار وتبقي الباب مفتوحاً ، خصوصاً أن شيئا ما يتحرك في إسرائيل .	يتحرك	31	Sing
اذ ستكون كل بلدية مطالبة بانجاز مسلك صحي على الاقل لمواطنيها يمارسون نشاطهم البدني اليومي من ركض او مشي او حركات رياضية على غرار ما يتوفر في البلدان المتقدمة اضافة لتطوير السكن بما يسمح بظروف اقامة طيبة .	يمارسون	11	Plur
وأشاروا إلى اشتباكات مسلحة وقعت فى وسط البلدة بين مسلحين فلسطينيين وقوات الجيش الإسرائيلى مما أسفر عن إصابة فلسطينيين بجراح .	أسفر	15	Sing
واعتبر شافيز في الجزائر ان " نجاح قمة كراكاس مضمون " لان نتيجة الاتصالات مع الدول الاعضاء " فاقت ما كنا نتوقعه " .	فاقت	18	Sing
وتصادف أن جاءت الأنباء عن اتصالات إسرائيلية ـ ليبية عندما كان الليبيون اليهود يحتفلون في الكنيست بمناسبة مرور 100 سنة على بدء الهجرة اليهودية لإسرائيل و 50 سنة على إتمامها .	يحتفلون	13	Plur
تعهدت ايران امس تقديم دعم غير محدود لسورية في حال تعرضت لهجوم اسرائيلي ، ولم يستبعد نائب الرئيس السوري عبدالحليم خدام حرباً اسرائيلية تطاول بلاده ، لكنه نبّه الى ان » اي حرب ستكلّف الاسرائيليين غالياً كما ستكلّفنا « .	تطاول	23	Sing
واوضح المتحدث باسم قيادة الجمارك البلغارية ايفان كوتيفسكي ، ان الهيرويين كانت في 76 علبة موضوعة في مخبأ اعد في سقف الباص .	اعد	18	Sing
وقال باراك في بيان صادر عن رئاسة الحكومة " ان الوقت يضيق ونعيش فترة حرجة جدا . آمل بان تكون الغلبة لبعد النظر وبان يظهر الفلسطينيون مرونة تتيح لنا التوصل قريبا الى اتفاق " .	يضيق	11	Sing
واكتفى رؤساء الدول المجتمعون منذ امس في لوساكا بممارسة الضغوط على رئيس الكونغو لوران ديزيريه كابيلا لكن من دون ان يتوصلوا الى اي ضمانات ، بحسب المراقبين الذين اعتبروا البيان " ضعيف اللهجة " .	اعتبروا	28	Plur
واشار الى ان حياة البحارة ترتبط " بسلسلة من العناصر " ، منها " عدد المقصورات الغارقة وارتفاع الضغط الجوي والحرارة ووضع احتياطات الهواء " .	ترتبط	5	Sing
يرجع إلى أن الإنفاق الخارجي للولايات المتحدة الأمريكية عال جداً بسبب إنفاقها العسكري أخيراً في عدد من الدول بدعوى محاربة الإرهاب ، لدرجة أن بعض الاقتصاديين الأمريكيين يرون أن الموازنة العامة للولايات المتحدة تحدد خارج الحدود الأمريكية .	يرجع	0	Sing
واضاف انه لم يعد يطلب من طواقم الخطوط الجوية المبيت فى البلدان التى يمكن ان يتعرضوا فيها لخطر الاصابة بالسارس , مشيرا الى ان طائرات / تاى / يتم رشها بالمطهرات كل يوم ويجرى تغيير مرشحات الهواء على الدوام .	يتعرضوا	15	Plur
اعتقلت شرطة تل أبيب يوم 19 / 11 الحالي رجل الدين اليهودي ، الحاخام ديفيد أهرون ، 43 عاما ، بعد أن تلقت عدة شكاوى عنه تفيد بأنه يبيع اليهود الذين يصلون وراءه " قطع أرض في الجنة " .	يصلون	31	Plur
وسوف تعمل جميع المشروعات الجديدة تقريبا فى المقاطعات والمدن الواقعة جنوبى البلاد ، فى حين أن نصيب المقاطعات والمدن الشمالية هو 52 مشروعا فقط برأسمال استثمارى مجمع يبلغ 120 مليون دولار .	يبلغ	27	Sing
ان هذه الاجراءات القادمة التي تنبع من النقطة 13 لبرنامج الرئيس بن علي الانتخابي ترمي فيها الى ضمان نوعية افضل لمقومات العيش يكون فيها لعديد الاطراف دور . . .	تنبع	5	Sing
اختتم معرض الصادرات الصينية ال 93 يوم الاربعاء فى مدينة قوانغتشو عاصمة مقاطعة قوانغدونغ بجنوب الصين .	اختتم	0	Sing
ويؤكد الجيش الامريكي ان 10 او 15 مقاتلا يشتبه بعلاقتهم بالزرقاوي الذي يتصدر قائمة المطلوبين كانوا موجودين في المكان عند وقوع الانفجار في الساعة 1.00 بالتوقيت المحلي امس لكنه لم يحدد عدد الضحايا .	يحدد	30	Sing
ويبدأ النشاط المحلي ببطولة قطر المشتركة التي تنطلق بعد غد الخميس وتستمر حتى 28 ايلول / سبتمبر المقبل ، تليها كأس الشيخ قاسم التنشيطية في الاول من تشرين الاول / اكتوبر وتستمر حتى 23 منه .	تنطلق	7	Sing
ويرى مراقبون في العاصمة العراقية أن التنظيمات السياسية الكردية التي تغذي الدعوة إلى الفيدرالية تنظر بأهمية خاصة إلى مطالب بعض التنظيمات السياسية بشأن الفيدرالية لأن من شأن ذلك أن يوفر الغطاء اللازم لتبني الدعوة إلى الفيدرالية على نطاق عام .	تغذي	10	Sing
وأضافوا أنهم اتفقوا مع منظم رحلات ابحار خلسة على تهريبهم فسلمه كل واحد منهم الف دينار وتجمعوا في الموعد المحدد قرب شاطئ قربة قبل ان تنطلق الرحلة ويلقى عليهم القبض لاحقا .	اتفقوا	2	Plur
قال مسئول في الشركة بصراحة نعرف جميعاً أن السيدات يحتكرن مناصب بعينها في القطاع الخاص ـ السكرتيرات التنفيذيات مثلا ـ وهن منتشرات في المهن الخاصة المتميزة .	نعرف	5	Plur
توقع الدكتور فاروق العقدة محافظ البنك المركزي زيادة الفائض في ميزان الحساب الجاري بنسبة 4 % من الناتج المحلي الإجمالي للعام الحالي .	توقع	0	Sing
كما حذر من ان ايران لن تظل غير مكترثة اذا اعتزمت الولايات المتحدة البقاء فى تلك البلاد .	تظل	6	Sing
ومن المتوقع ان يبذل اكثر من الف عامل من ثلاثة شركات بناء بالمنطقة الجهود لاكمال المرحلة الاولى للمشروع الذى يضم مرحلتين خلال 20 يوما وبذلك يمكن استقبال المصابين بالسارس فى حينه .	يبذل	3	Sing
وقال السفير حجازي ان هذا المشروع في مرحلته الثانية يعد من اهم مشروعات التكامل العربي ويمتد من مدينة العقبة حتى الحدود السورية بطول 380 كيلومترا بكلفة تزيد عن 350 مليون دولار .	تزيد	26	Sing
ونقل عن فليكس كازاهورا المختص بشئون اللاجئين بمكتب رئيس الوزراء قوله إنه تم اتخاذ ترتيبات لاعادة توطين اللاجئين الذين نزحوا بسبب غارة شنها المتمردون على معسكرهم فى اشول / بيل بمنطقة بادر الشمالية فى أغسطس من العام الماضى .	نزحوا	19	Plur
تونس ـ الصباح : سيشهد القطاع الصحي تطورات هامة خلال المرحلة القادمة والى حدود ســـــنة 2009 حيث يتوقع ان تتطور نسبة التغطية الاجتماعية الفعليــــة لتشــــمل 95 % من سكان البلاد وهو ما معناه ان تكون التغطية الصحية افضــــل .	تتطور	19	Sing
قال التاجر وانغ جيان ينغ من المناطق الداخلية الصينية ان الارتباطات الموقعة فى هذا المعرض أفضل من المنشود , ومن شأنها ان تفى بحاجة الانتاج فى النصف الاول من هذا العام .	تفى	22	Sing
في حين أن أحدث أفلام عمر الشريف " العم ابراهيم " تقرر عرضه بالقاعات التونسية بداية من عطلة عيد الفطر المبارك القادمة .	تقرر	11	Sing
لقاء مونتوبان : عودة سوتومايور تتكلل بالنجاح بالنجاح	تتكلل	5	Sing
اعتبارا من اواخر عام 2002 سجلت المقاطعة 208140 علامة تجارية صالحة اى ما يشكل اكثر من ثمن الاجمالى الوطنى . ومن ذلك اصبحت 309 علامات تجارية مشهورة .	سجلت	5	Sing
ومن ثم فإن خبراء يعكفون على وضع شروط دقيقة وحازمة في عقود التأمين المتوقعة .	يعكفون	4	Plur
وقال احد المسئولين العسكريين اشترط عدم ذكر اسمه انه يبدو ان الطائرة اصطدمت بخطوط الكهرباء قبل ان تسقط فى نهر دجلة بالقرب من مدينة سامراء العراقية .	اصطدمت	12	Sing
وذكرت قناة فلسطين الفضائية مساء اليوم ان الوفد اطلع الرئيس عرفات على اوضاع وسير عمل المحاكم .	اطلع	8	Sing
وكانت شل من الشركات الرئيسية العاملة في ليبيا حتى أممت أصولها في السبعينات .	أممت	9	Sing
صوفيا 16 - 7 ( اف ب ) - ضبط رجال الجمارك البلغارية امس السبت في مركز " كابيتان اندرييفو " على الحدود البلغارية التركية ، على 39،56 كيلوغراما من الهيرويين ، كما اعلن متحدث باسم الجمارك .	ضبط	9	Sing
وقال مصدر موثوق إن البعض من رجال الأعمال في الحزب تجرأوا على التدخل لمنع استيراد بعض السلع من الخارج ليتمكنوا من بيع منتجاتهم بأسعار مبالغ فيها للمواطنين في السوق المحلي .	تجرأوا	10	Plur
لا تدع الآخرين يضغطون عليك كي تتفق مع آرائهم .	يضغطون	3	Plur
حسب الأرقام المعلنة حيث تم استيراد 400 ألف فانوس من الصين هذا العام بقيمة 250 ألف دولار أي ما يوازي مليوناً و 532 ألفا و 500 جنيه " ! "	يوازي	19	Sing
وجاء هذا التقرير بعد ان أكدت الاوبك فى الاسبوع الماضى تصميمها على وقف انخفاض الاسعار الى اقل من المستوى المحدد .	أكدت	5	Sing
وأشار عدد من الذين شملهم الإستطلاع الى أن الحب الذي يفرحهم ينعكس على مظهرهم الخارجي ، فيشعرون أنهم أكثر جمالاً .	ينعكس	11	Sing
وانتقد انصاري الذي اوردت تصريحه وكالة الانباء الايرانية الرسمية المحافظين متهما اياهم " بعرقلة عمل الحكومة " مضيفا " يجب الا ننسب كل شيء الى الاعداء الخارجيين " من دون ان يعطي اي تفاصيل اخرى .	اوردت	3	Sing
تنص المذكرة على تكوين لجنة تجتمع مرتين سنوياً لمتابعة أنشطة التعاون المشترك .	تجتمع	5	Sing
وعلمنا ان طاقم الخافرة ادخل المشاركين في هذه الرحلة البحرية غير الشرعية الى ميناء الصيد البحري بقليبية قبل ان يسلموا لاحقا الى فرقة الأبحاث العدلية للحرس الوطني بنابل لمواصلة التحريات واتخاذ الاجراءات المتبعة في هذا الشأن ضدهم .	يسلموا	19	Plur
وكان قادة الحزب الحاكم التقوا ممثلي حزب التجمع اليساري في نهاية الأسبوع الماضي ، على أن يلتقوا رئيس الحزب الناصري ضياء الدين داود خلال أيام .	التقوا	4	Plur
ومن العقبات التي تواجه استئناف الدراسة ان المعلمين لم يتسلموا رواتبهم الشهرية ولا يعرفون متى يتقاضون هذه الرواتب رغم الوعود الامريكية بدفع 20 دولارا لكل موظف يلتحق بوظيفته كدفعة طوارئ .	يتسلموا	9	Plur
إشهار " عبد الله طالب كول " إسلامه كان مفاجأة للكثيرين من طلابه ومعارفه ، لكن أصدقاءه القريبين توقعوا ذلك ، وإن كان توقعهم تأخر بعض الشيء .	توقعوا	18	Plur
لا تغضب ولكن حاول أن تتوخى حذرك جيداً .	تغضب	1	Sing
وقال رئيس الوزراء التركى الزائر أن بلاده تعتزم مواصلة الجهود للتوصل الى حل للمشكلة القبرصية ، وتؤيد وساطة الأمم المتحدة فيها " .	تعتزم	7	Sing
الا ان صحيفة " سيغودنيا " ذكرت بان " طاقم الغواصة كي - 429 التابع لاسطول المحيط الهادئ عجز عن الصعود من عمق ستين مترا في العام 1983 " .	عجز	18	Sing
وبدلاً من أن يراعي مسؤولو البنك المركزي هذه الأجواء القائمة ويدعموا الشركات التي يعمل بها ما يقرب من ألف عامل استمروا في تهديدها بالإغلاق ورفضوا مطالبات الصيارفة بتأجيل سريان النص القانوني الخاص برفع رأس المال إلى 20 مليون جنيه .	يقرب	16	Sing
وطلب نواب يمينيون اخرون من الكنيست ان توصي بوقف المفاوضات مع الفلسطينيين بعد قمة كامب ديفيد التي فشلت في 25 تموز / يوليو الماضي .	توصي	7	Sing
ووصف الضجة التي اثيرت حول امكان سحب الاتحاد الاسيوي البطولة من لبنان بانها " كانت ايجابية لانها احدثت صدمة وجعلت المسؤولين يدركون خطورة الوضع ويتحملون المسؤولية " .	احدثت	17	Sing
وأوضح أنه لا يمكن ضمان وقف النار من جانب الفلسطينيين إذا لم يتلقوا ضمانات في مقابل خطوتهم هذه .	يتلقوا	12	Plur
وأكد عضو المجمع الدكتور عبد المعطي بيومي أن الأزهر " لا يصادر حرية الفكر والإبداع ، وإنما يحمي ثوابت المجتمع من أي انحرافات فكرية تهدد عقيدة المجتمع وثقافته " .	يصادر	11	Sing
ويتوقع أن تطلق الحكومة حملة تشكيل مدارس نموذجية دينية في كل أرجاء باكستان وتدعى » دار العلوم « ، وان يصار إلى إقامة مدرسة واحدة في كل مدينة رئيسية .	يصار	20	Sing
والحال أن الشكوك تحاصر كل شيء ، فما جدوى النتائج من التطمينات أو الوثائق أو الحوارات إن كانت تلك النتائج لا تتجاسر على الامتداد جغرافياً إلى ما هو أبعد من غرف اللقاءات والحوارات واجتماعات التوقيع على الوثائق .	تحاصر	3	Sing
وأشار التقرير إلى أن إبعاد الرئيس الفلسطيني من شأنه أن " يعزز نفوذه .	يعزز	11	Sing
وهذه المرة الأولى التي يتحدث المسؤولون الأتراك بوضوح عن إلحاق شمال قبرص بتركيا ، بعدما كانوا يكتفون في الماضي بالتلميح الى ذلك من دون ذكره علناً خلال محادثاتهم مع الاتحاد الأوروبي حول مستقبل الجزيرة القبرصية .	يكتفون	16	Plur
وكان حنفي دخل في مشادة كلامية حادة مع تسوبيل في المباراة ذاتها امام الجماهير .	دخل	2	Sing
كما يمكّن المشروع إسرائيل من المشاركة ، بشكل مباشر وغير مباشر بعمليات إعادة الإعمار في العراق .	يمكّن	1	Sing
ويعتقد المحللون ان الاقتراح قد يواجه طريقا صعبا فى مجلس الامن الذى يضم 15 دولة عضوا	يضم	12	Sing
ذكرت السفارة النرويجية هنا انه من المقرر ان يغادر انطون بالاسينجام كبير مفاوضى نمور التاميل بسريلانكا هنا صباح الاثنين الباكر الى لندن لتلقى العلاج هناك .	يغادر	8	Sing
عقد وزير الخارجية الصينى لى تشاو شينغ ونظيره الروسى ايجور ايفانوف مشاورات عبر التليفون مساء اليوم دارت حول القضية العراقية .	دارت	16	Sing
وقالت صحيفة / قوانغمينغ اليومية / ان مصلحة الدولة للسياحة قد اصدرت تعميما عاجلا فى الاونة الاخيرة يدعوا وكالات السفريات بالبلاد الى وقف قبول وثائق من الافواج المحلية والاجنبية للحصول على تصاريح لزيادرة التبت .	اصدرت	11	Sing
وتتعرض مدينة الفلوجة - التي تفرض عليها القوات الأمريكية والعراقية الخاصة طوقا أمنيا - لقصف أمريكي يومي بدعوى استهداف مواقع تابعة لجماعة الأردني أبومصعب الزرقاوي .	تفرض	5	Sing
وهي تنظيمات سرية ، صغيرة ، تتوزع إلى خلايا وتمارس العنف المسلح في صراعها مع الدولة العلمانية في تركيا وتهدف إلى هدم العلمانية وإتاحة نظام إسلامي معاد للغرب .	تتوزع	6	Sing
كشف مسؤولون أمريكيون أن إدارة الرئيس الأمريكي جورج بوش أقرت تشكيل وكالة استخبارات عراقية للتجسس .	أقرت	9	Sing
اتهم المستثمرون وأعضاء منظمات الأعمال الحكومة بالإخلال بمبادئ العدالة والمساواة وتكافؤ الفرص بين الشركات الاستثمارية .	اتهم	0	Sing
بل قالت جهات رسمية إنها لا تملك معلومات حول قيام شركات إسرائيلية بالعمل في شمالي العراق ، في مجال التنقيب عن النفط .	تملك	6	Sing
وعلى الرغم من ذلك , اعترف السفير بأنه كان يستحيل على مجلس الأمن فى ذلك الحين التوصل الى اتفاق بشأن ارساء اسس عملية اعادة أعمار عراق ما بعد الحرب .	اعترف	5	Sing
وقد أشاد الملك عبد الله بأفراد وحدة الامن والحماية الذين حالوا دون حدوث كارثة لو تمكن الصحفى من الصعود الى الطائرة التابعة لشركة مصر للطيران وبحوزته قطعة الذخيرة التى كان احضرها من العراق كتذكار .	حالوا	10	Plur
كما أكدت أن الموقف العربي لن يقف سلبياً إذا مضت إسرائيل في انتهاكاتها بالنسبة لمصر وسورية ولبنان .	مضت	9	Sing
وقال " لم تبن مصفاة واحدة في أميركا خلال العشرين سنة الماضية " .	تبن	3	Sing
واوضح الدكتور غريفيث ان " ذلك يتناقض مع اقوال المنتجين الذين يدعون انهم يضيفون الكافيين لاكساب هذه المشروبات النكهة فحسب " .	يدعون	11	Plur
الأف بى آى يحث مصانع الطاقة النووية على التزام الحذر	يحث	3	Sing
ضبط محققو مركز الأمن العمومي بسليمان خلال الليلة الفاصلة بين الأحد والاثنين المنقضيين أربعة كهول بصدد البحث عن كنوز يعتقدون أنها مدفونة في التراب وسط ضيعة فلاحية كائنة بأحواز المدينة .	يعتقدون	19	Plur
كما أن نفيه لهذا الاتجاه يأتي قبل أسابيع من زيارة مقررة لواشنطن ، مما يرجح أنه أراد أيضا أن ينفي تلك الإشاعات عن صفقة مع الأمريكيين تضمن التوريث في مقابل سياسة مصرية معينة في قضايا إقليمية ودولية .	أراد	16	Sing
ومن جانبه , قال بوتين الذى وصل الى يالطا يوم الاربعاء فى زيارة لاوكرانيا تستغرق خمسة ايام , انه يؤيد توثيق التعاون فى مجال الطاقة بين روسيا واوكرانيا .	تستغرق	14	Sing
وقالت مصادر مطلعة : " من المنتظر أن يطلع حجاني الأمين العام للجامعة العربية ، كما أطلع المسؤولين المصريين ، على موقف بلاده من موضوع الملف النووي ، والضغوط الأمريكية عليها ، بجانب المخاوف من تصعيد هذه القضية " .	أطلع	16	Sing
إنك غير صريح تماماً مع نفسك والوقت يكون مناسب الآن لكي تعيد التفكير في مشاعرك ودوافعك من جديد .	تعيد	11	Sing
أفاد مسؤول أمني امس ان اليمن رفض طلباً قدمه 116 سريلانكياً للسماح لهم بمغادرة ميناء عدن ، على متن سفينتين مكتظتين ، بسبب مخاوف على سلامة الركاب .	أفاد	0	Sing
في حين تتولى اللجنة الرابعة الموجه نشاطها اساسا للمنشآت الرياضية درس واقتراح افضل الوسائل المتعلقة باختيار مواقع ومواصفات المنشآت الرياضية وطرق تسييرها واستغلالها وضبط تراتيب صيانتها .	تتولى	2	Sing
وتقترح الدراسة وجوب الاهتمام المصري بالمناطق خارج مثلث مدن » جدة ، المدينة المنورة ، مكة المكرمة « والقيام بحملة دعائية للمنتجات التي تنوي تصديرها من خلال تشجيع المعارض الدائمة بين البلدين وغيرها من المبادرات .	تنوي	23	Sing
وأشار الشهود الى أن الجنود الإسرائيليين تقدموا بعد ذلك باتجاه المكان ، وفحصوا المكان ، واستدعوا سيارة إسعاف أقلت الجريح إلى أحد المواقع العسكرية القريبة " .	تقدموا	6	Plur
يبقى اذن الوضع القائم في المنطقة . . . اي " ستاتوكو " الانظمة السياسية المستقرة عمليا منذ اواخر الستينات . . . وفي مقدمها الحالة التي اصبحت " فضائحية " للنظام العراقي منذ العام . . . 1991	اصبحت	27	Sing
عاطف عبيد بضرورة إعلان موقف جماعي من الدول العربية للدعوة الأمريكية لتمويل إصدار صحف في عدد من الدول العربية أو بث إذاعات بتمويل أمريكي تعكس محاولات أمريكية لفرض صيغة إعلامية تخدم أهدافاً خفية لصالح إسرائيل !	تخدم	30	Sing
وفي الداخل تفطنت المتضرة للواقعة فأعلمت اعوان الامن وادلت بأوصاف الفتاة التي تم ايقافها في اليوم الموالي بعد حصر الشبهة فيها وقد اعترفت بما نسب لها فتمت احالتها على العدالة بعد ارجاع المسروق لصاحبته .	تفطنت	2	Sing
ويرى مراقبون في العاصمة العراقية أن التنظيمات السياسية الكردية التي تغذي الدعوة إلى الفيدرالية تنظر بأهمية خاصة إلى مطالب بعض التنظيمات السياسية بشأن الفيدرالية لأن من شأن ذلك أن يوفر الغطاء اللازم لتبني الدعوة إلى الفيدرالية على نطاق عام .	يوفر	29	Sing
الغواصة كورسك : ضباط روس استشاروا خبراء من الحلف الاطلسي	استشاروا	5	Plur
يذكر ان سوريا بادرت في اواخر سبتمبر الى تنفيذ اعادة انتشار جديدة لقواتها في لبنان سحبت خلالها نحو ثلاثة الاف جندي وبقي في لبنان نحو 15 الفا من جنودها .	بادرت	3	Sing
اعترض عدد كبير من أعضاء هيئة التدريس بجامعة القاهرة على تخصيص أحد مباني الجامعة لجمعية جيل المستقبل .	اعترض	0	Sing
1918 - الثورة البلشفية تعدم قيصر روسيا نيكةلاس اتلثاني وافراد عائلته .	تعدم	4	Sing
واكد ان المانيا لن تتخلى عن مسئولياتها العالمية ، لكن تاريخها وجغرافيتها يشيران الى انها ستسعى فى المقام الاول الى دور نشط ينحصر فى اوربا .	تتخلى	4	Sing
واعترف الذين أجريت عليهم الدراسة بانتشار العلاقات العاطفية بينهم ، وقال ثلث الشباب وربع الفتيات إنهم يرون أن أهم مميزات هذه العلاقات أنها يمكن أن تتطور إلى زواج .	يرون	16	Plur
وقال النواب أول امس انهم جمعوا توقيعات كافية على طلب يرغم رئيس المجلس التشريعي الفلسطيني على الدعوة لعقد جلسة استثنائية ربما في اوائل اكتوبر بشأن مستقبل رئيس الوزراء الفلسطيني احمد قريع وحكومته .	جمعوا	5	Plur
هكذا فاجأني أحد كبار مصدري الملابس الجاهزة للسوق الأمريكي عندما قرأت عليه نص الخبر مؤكدا أن مضمون الخبر صحيح . .	قرأت	10	Sing
ويقوم الفريق بتتبع العاملين الطبيين وتقديم تقارير للعالم الخارجى عن المعركة الشاقة ضد المرض الذى يشبه الانفلوانزا . كما يخبر القراء بقصص التضحية والشجاعة للاطباء والممرضات " ملائكة الرحمة " الذين يواجهون المرض .	يخبر	19	Sing
ونقلت صحيفة كيهان المحافظة اليوم الثلاثاء عن رجل الدين قوله " منذ اشهر عدة تنتشر بشكل واسع كل انواع الفساد في مقاطعتنا من افلام وصور واقراص + سي دي روم + اباحية اضافة الى المخدرات والكحول " .	تنتشر	14	Sing
رفضت شركات المقاولات تحديد أسعار الشقق نتيجة الارتفاع المستمر في سعر الحديد والأسمنت ووضعت بنوداً جديدة في العقود تنص على جواز زيادة أسعار الوحدات السكنية وفقاً لمتغيرات التكلفة .	تنص	18	Sing
فؤاد كنعان ، رائد القصة القصيرة في لبنان رحل مساء أمس عن 81 عاماً .	رحل	8	Sing
وصرح نائب رئيس الوزراء الروسي ايليا كليبانوف الذي يرئس اللجنة التي شكلتها الحكومة للتحقيق في حيثيات الحادث ان التوقعات تشير الى تحسن في الطقس خلال الساعات المقبلة و " سنبدأ عندها عمليات الانقاذ " ، حسبما اوردت وكالة انترفاكس .	تشير	19	Sing
وختم الكوبي الطائر حامل ذهبية اولمبياد برشلونة عام 1992 : " يتمثل الحلم في احراز ذهبية اولمبياد سيدني ، على اي حال فان احتلال احد المراكز الثلاثة الاولى يؤكد بانني استعيد مستواي السابق تدريجيا " .	يتمثل	11	Sing
واضاف ان " القمة باستثناء حكومة الكونغو تجدد دعمها للمنسق كيتوميلي ماسيري الذي عينته منظمة الوحدة الافريقية ورفضته كينشاسا " .	تجدد	7	Sing
يرجع إلى أن الإنفاق الخارجي للولايات المتحدة الأمريكية عال جداً بسبب إنفاقها العسكري أخيراً في عدد من الدول بدعوى محاربة الإرهاب ، لدرجة أن بعض الاقتصاديين الأمريكيين يرون أن الموازنة العامة للولايات المتحدة تحدد خارج الحدود الأمريكية .	يرون	27	Plur
أوروبا تتراجع عن أحد تعهداتها التجارية لمصر لمصر	تتراجع	1	Sing
وتعكس هذه المآسي المتكررة سوء التنمية المتكرر الذي يصيب منطقة الدلتا على الرغم من غناها بالموارد النفطية فهي تؤمن 90 % من مجمل النفط الخام المنتج في نيجيريا .	تؤمن	18	Sing
من جهة اخرى دعا تيم كروس نائب مدير مكتب اعادة الاعمار والمساعدات الانسانية الجنرال المتقاعد جي جارنر الشرطة ان يعتمدوا الشفافية في عملهم بحيث يمكن لابناء الشعب رفع شكاواهم من الشرطة في حالات سوء السلوك والتصرف .	يعتمدوا	19	Plur
قمة لوساكا لم تتوصل الى اطلاق عملية السلام في جمهورية الكونغو	تتوصل	3	Sing
كما أن الإصلاحات الاقتصادية ترضي الفقراء خصوصاً في الصعيد وزهدي واحد من أبناء تلك المناطق التي ظلت أرضاً خصبة لتفريخ الأصوليين الراديكاليين .	ترضي	4	Sing
يشار الى ان الجبهة الشعبية والحزب القريب من حماس كانا شاركا في اجتماعات المجلس المركزي الفلسطيني الذي اتخذ قرارا بتجميد اعلان الدولة الفلسطينية المستقلة في 13 ايلول / سبتمبر المقبل .	اتخذ	17	Sing
وكان مدرب المنتخب التشيكي دوشان يورين اختار الهويدي ضمن التشكيلة التي ستغادر الى معسكر في المانيا من 2 الى 23 ايلول / سبتمبر المقبل رغم عدم جهوزيته لخوض المباريات .	اختار	6	Sing
وتعتبر الهند ان ولاية جامو وكشمير هي جزء لا يتجزأ من اراضيها وان اي انفصال مستحيل لانه يتناقض مع الدستور الهندي .	يتجزأ	9	Sing
يوم هزت الانفجارات اسرائيل من الشمال الى الجنوب الأحد ، صدرت الصحف الاسرائيلية في الصباح وهي تضم أخباراً أكاد أقول انها تقليدية عن الوضع الأمني . وقرأت :	هزت	1	Sing
ومن المقرر ان يزور روس الشرق الاوسيط في نهاية الاسبوع . ولم تتوافر اليوم معلومات عن برنامج زيارته .	تتوافر	12	Sing
وهذا الحادث الذي تعرضت له الغواصة التي بدأ العمل بها في 1995 ، هو الاخطر منذ غرق الغواصة السوفياتية كومسوموليتس قبالة سواحل النروج في 1989 مما اسفر عن مقتل 42 شخصا .	اسفر	26	Sing
وفي فبراير من العام نفسه تأسس حزب الفضيلة كامتداد لحزب الرفاه المحظور ، بزعامة رجائي قوطان وتراجعت أصوات الحزب في انتخابات أبريل 1999 من 21 % عام 1995 إلى 15 % .	تأسس	5	Sing
اسرائيل تقترح ترتيبات للقاء العائلات على الحدود مع لبنان	تقترح	1	Sing
باريس 15 - 8 ( أ ف ب ) - تفتتح استونيا واندورا ( المجموعة الثانية ) غدا الاربعاء في تالين تصفيات القارة الاوروبية المؤهلة الى نهائيات كأس العالم لكرة القدم التي تستضيفها اليابان وكوريا الجنوبية معا عام 2002 .	تفتتح	10	Sing
موظفو اليونيسيف يبدأون العودة الى بغداد	يبدأون	2	Plur
» غموض « في الموقف الروسي وتحفظ فرنسي - الماني - ياباني . تركيا تؤيد ضرب العراق » إذا تغيرت الظروف «	تؤيد	14	Sing
واوضح الدكتور غريفيث ان " ذلك يتناقض مع اقوال المنتجين الذين يدعون انهم يضيفون الكافيين لاكساب هذه المشروبات النكهة فحسب " .	يتناقض	6	Sing
الخطوط الجوية التايلاندية تتعاون مع 25 خطوط جوية اجنبية لاحتواء السارس	تتعاون	3	Sing
ناشدت الجماعة الإسلامية في مصر ، تنظيم القاعدة إلقاء السلاح ، والتوقف عن عمليات القتل الإجرامية .	ناشدت	0	Sing
تمكن اعوان الامن بفرقة الشرطة العدلية بمنطقة القيروان مؤخرا من ايقاف فتاة تبلغ من العمر حوالي 19 سنة ثبت تورطها في قضية سرقة من داخل محل مسكون وتشير المعطيات الاولى الى انها ليست العملية الاولى .	ثبت	18	Sing
فيتنام وافقت على 184 مشروعا باستثمارات أجنبية فى الشهور الأربعة الماضية هانوى 3 مايو / شينخوا / منحت فيتنام تراخيص ل 184 مشروعا باستثمارات أجنبية برأسمال مسجل بلغ 382 مليون دولار خلال الشهور الأربعة الأولى من العام الجارى .	منحت	17	Sing
وظهر أيضــاً أن الحـــب ليس مرتبطاً بسن معينة في سويسرا ، بل أن المسنين يشعرون به كما يشعر به الشباب ، ويحاولون أن يعيشوا كل طــقوسه .	يعيشوا	23	Plur
مصر تجدد مقايضتها للسعودية . .	تجدد	1	Sing
خطة شاملة لتطوير قطاع الصناعة المصرية تنفذ في 20 عاما	تنفذ	6	Sing
وسبق للجمهوريين ان نظموا مؤتمرهم العام قبل اسبوعين في فيلادلفيا .	نظموا	3	Plur
لاغوس 15 - 7 ( اف ب ) - ذكرت الشرطة النيجيرية اليوم السبت ان ما لا يقل عن 12 شخصا قتلوا في مواجهات استمرت يومين في سوق في لاغوس بين تجار وزقاقيين .	يقل	17	Sing
انتقدت دراسة اقتصادية تواضع حصة مصر من السوق العالمية للمنتجات النسيجية رغم تجاوز نصيب مصر حاجز المليار دولار .	انتقدت	0	Sing
أكد النواب على ضرورة استحداث نظم جديدة في إدارة الطرق في مصر تقدم على أساس إغلاق الطرق في حالة تعزر الرؤية أسوة بما يتم في المطارات وحركة الطيران لتجنب وقوع الحوادث .	تعزر	19	Sing
واضافت ان الترتيبات ستتيح للعائلات خصوصا الفلسطينية ان تلتقي بطريقة اكثر انسانية مع توفير الحد الادنى من الراحة .	تلتقي	8	Sing
واوضح المكتب الصحافي ان فرق الانقاذ بدات حوالى الساعة 21،00 ( 17،00 ت غ ) محاولة جديدة لانزال كبسولة انقاذ تلتحم بالغواصة التي ترقد على عمق مائة متر في قاع بحر بارنتس .	ترقد	23	Sing
وحذرت المصادر من إجهاض قانون التمويل العقاري بسبب حالة الفوضى التي تجتاح الأسواق وفشل كافة الإجراءات الحكومية في السيطرة على أسعار مواد البناء .	تجتاح	11	Sing
أن حسني مبارك هو القائد الذي وثق بنا . .	وثق	6	Sing
ومن هنا يجد المسؤولون المصريون أنفسهم في وضع بالغ الحساسية ، فهم لا يستطيعون تجاهل التهديدات المتلاحقة لسورية ، خصوصاً في ظل احتلال العراق وما يعنيه من حصار لسورية بين فكي كماشة الجيش الأمريكي والجيش الإسرائيلي .	يستطيعون	13	Plur
احرص ألا تسرف في إنفاقك للمال هذا الأسبوع .	احرص	0	Sing
ويرى خبراء أن برنامج التخصيص ساهم بشكل كبير في تكريس السمة الأساسية للطبقة الرأسمالية المصرية كطبقة تفتقد الى روح المبادرة ، إذ أن عملية التخصيص برمتها هي بيع لمشاريع جاهزة وغالبيتها تحقق ارباحاً ولا تنطوي على مخاطرة .	تنطوي	34	Sing
وقال الجيش الروسي ان المتمردين يفقدون شيئا فشيئا نفوذهم في المناطق الجبلية من الشيشان وانهم " شنوا حملة ترهيب ضد السكان المحليين الذين يؤيدون احلال النظام " .	شنوا	16	Plur
يذكر ان السودان انضم لمنطقة التجارة العربية الحرة الكبرى التابعة للامانة الاقتصادية والاجتماعية بجامعة الدول العربية فى سبتمبر 2002 .	انضم	3	Sing
ومنذ تلك المحادثة ، يحاول المسؤولون في السفارة الإسرائيلية في أنقرة ، فحص مصدر قلق الحكومة التركية ، لكنهم لم ينجحوا بتلقي أجوبة واضحة .	يحاول	4	Sing
موسكو 15 - 8 ( اف ب ) - اكد قائد الاسطول الروسي الاميرال فلاديمير كورويدوف مساء اليوم الثلاثاء ان فرق الانقاذ لا تعلم شيئا عن الوضع داخل الغواصة كورسك سوى انه " يوجد احياء داخلها " .	تعلم	23	Sing
الخطر كل الخطر أن يعتمد الاحتياطي على الدولار فقط لأنه ينخفض عملياً بنفس انخفاض قيمة الدولار وهذا يجب تداركه .	ينخفض	10	Sing
مؤكداً أن منح البنوك لقروض جديدة لتمويل القطاع الصناعي لم يتوقف ، ولكن كل ما في الأمر أن معدلات الإقراض انخفضت ، نظراً لتراجع عدد المستثمرين في مجال التصنيع .	انخفضت	20	Sing
وانشد اللبنانيون الذين حملوا كتب صلاة ورفعوا العلم اللبناني ، النشيد الوطني اللبناني .	حملوا	3	Plur
وأكد تقرير حديث صدر عن البنك المركزي المصري أن تراجع صادراتنا للدول العربية جاء استثناء حيث ارتفعت خلال الفترة ذاتها الصادرات المصرية لجميع أسواق العالم الخارجي .	ارتفعت	16	Sing
وجاء العدوان الإسرائيلي على سورية بموافقة صريحة من الولايات المتحدة التي رفضت إدانته في الأمم المتحدة أو مجلس الأمن الدولي .	رفضت	11	Sing
سراييفو 15 - 9 ( اف ب ) - دشن امير منطقة الرياض الامير سلمان بن عبد العزيز اليوم الجمعة في سراييفو مسجدا ومركزا اسلاميا كلف بناؤهما 9،7 ملايين دولار قدمتها المملكة السعودية .	دشن	9	Sing
كتب عبد الله إسكندر مدير تحرير الحياة يقول : تلقّت قوات الاحتلال في العراق ضربات مؤلمة .	تلقّت	9	Sing
وقال ان الاقتراح يتطلب الدراسة قبل اصدار اى حكم ، وان المجلس سيبحث القضية فى وقت ما الاسبوع القادم .	يتطلب	3	Sing
العبوات ستعود إلى الانفجار ولن تطول أجازتها .	تطول	5	Sing
واضاف لحود " هناك بعض السياسيين المستعدين للمضي في مشروع التوطين وان كانوا يعلنون عكس ذلك " .	يعلنون	13	Plur
كما أن نفيه لهذا الاتجاه يأتي قبل أسابيع من زيارة مقررة لواشنطن ، مما يرجح أنه أراد أيضا أن ينفي تلك الإشاعات عن صفقة مع الأمريكيين تضمن التوريث في مقابل سياسة مصرية معينة في قضايا إقليمية ودولية .	ينفي	19	Sing
وكشف التقرير أيضا أن خسائر مصر اكستريور في ديسمبر 2002 بلغت 198 مليون جنيه بخلاف العجز في مخصص القروض وانخفاض القيمة العادلة للأصول التي آلت ملكيتها للبنك .	آلت	24	Sing
كان صحفى يابانى قد أحضر قطعة الذخيرة من بغداد كتذكار دون ان يعرف ماهيتها ووضعها فى حقيبته لكنها انفجرت فى المطار أثناء تفتيش حقيبته مما أدى الى مصرع رجل الأمن واصابة ثلاثة أخرين بجراح .	انفجرت	18	Sing
وختم قائلا " لا ، لا تخافوا . . هكذا قلت في الثاني والعشرين من تشرين الاول / اكتوبر 1978 . اكرره اليوم بنفس القوة وانا ارى آمال الكنيسة والعالم تخفق في قلوبكم " .	تخفق	30	Sing
وقال " ان الوضع صعب " لكنه رفض عرض المساعدة الذي تقدمت به واشنطن موضحا " لدينا كل الوسائل الفنية اللازمة وهي ليست اقل مما لدى الاميركيين " .	تقدمت	11	Sing
طالب نواب في البرلمان المصري يوم 19 / 11 الحالي بإحياء ملف المطلب المصري باسترداد مدينة إيلات ، والتي كانت تسمى " أم الرشراش المصرية " .	تسمى	20	Sing
وقال النواب أول امس انهم جمعوا توقيعات كافية على طلب يرغم رئيس المجلس التشريعي الفلسطيني على الدعوة لعقد جلسة استثنائية ربما في اوائل اكتوبر بشأن مستقبل رئيس الوزراء الفلسطيني احمد قريع وحكومته .	يرغم	10	Sing
وقال ان " الخلافات التي ما زالت قائمة يمكن تجاوزها ( . . . ) لذلك يتعين الان اغتنام الفرصة " .	يتعين	16	Sing
ووقع الزلزال التى تراوحت التقديرات الاولية لقوته بين 6 ـ 6.5 درجة , فى حوالى الساعة الثالثة والنصف فجرا .	تراوحت	3	Sing
استمتعوا بالسيئ . .	استمتعوا	0	Plur
القت مباحث الجيزة القبض على المصري وائل محمد اسماعيل ( 27 سنة ) الذي يعمل سمساراً ، بعدما خطف طفل زوجته هدية سعيد عبدالمجيد ( 26 سنة ) ليجبرها على العودة اليه بعد إصرارها على الانفصال عنه .	القت	0	Sing
كشفت مصادر مقربة من " القاعدة " عن أحدث صيحة للبحث عن عناصر جديدة تقوم بعمليات انتحارية عبر السعي الحثيث لإنشاء " جامعة تهتم بالعلوم الجهادية على الإنترنت " .	تهتم	23	Sing
ومن العقبات التي تواجه استئناف الدراسة ان المعلمين لم يتسلموا رواتبهم الشهرية ولا يعرفون متى يتقاضون هذه الرواتب رغم الوعود الامريكية بدفع 20 دولارا لكل موظف يلتحق بوظيفته كدفعة طوارئ .	يعرفون	13	Plur
تلقى تقديراً كبيراً إذا التزمت بالموعد المحدد للانتهاء من إحدى الأعمال .	التزمت	4	Sing
وقالت المنظمات ، في تقارير رصدت الاسواق منذ 11 ايلول ( سبتمبر ) الماضي وحتى الآن ، ان الاوضاع في البلاد سيئة وقد تصل الى أزمة إذا لم تتخذ الحكومة اجراءات عملية للحد من تداعيات الأزمة على قطاعات معينة .	تتخذ	28	Sing
ويؤكد الجيش الامريكي ان 10 او 15 مقاتلا يشتبه بعلاقتهم بالزرقاوي الذي يتصدر قائمة المطلوبين كانوا موجودين في المكان عند وقوع الانفجار في الساعة 1.00 بالتوقيت المحلي امس لكنه لم يحدد عدد الضحايا .	يتصدر	12	Sing
يشار الى ان الاجواء المأزومة التي يشهدها لبنان - والتي تبدت في محاولة الاغتيال الفاشلة التي تعرض لها مؤخرا الوزير المستقيل مروان حمادة - وكذلك التجاذب بين رئيسي الجمهورية والحكومة اميل لحود ورفيق الحريري يؤخران تشكيل حكومة جديدة .	تبدت	10	Sing
وردا على سؤال قالت تشانغ تشى يويه المتحدثة باسم وزارة الخارجية الصينية ان الصين ترحب بالاعلان رسميا عن " خريطة طريق " الشرق الاوسط .	ترحب	14	Sing
اختارت كوريا الرخام المصري تام الصنع من بين الرخام المقدم من 12 شركة عالمية من 6 دول هي إيطاليا وأسبانيا وتركيا والهند وإيران وإسرائيل وذلك للتركيب في المتحف القومي الكوري .	اختارت	0	Sing
أفادت وكالة برس تراست الهندية أن الخطاب قيد الدراسة ويتوقع المجلس ردا إيجابيا من الحكومة .	أفادت	0	Sing
وأوضح أن القطاع الخاص يستورد احتياجاته المطلوبة من الأقطان بجانب شراء كميات من الإنتاج المحلي .	يستورد	4	Sing
ومعروف أن الموقف الرسمي يستند إلى رفض منح " الإخوان " حق تشكيل حزب سياسي أو توسيع مساحة الحرية التي يتحركون فيها .	يتحركون	20	Plur
استقبل خادم الحرمين الشريفين الملك فهد بن عبدالعزيز الرئيس السوداني الفريق عمر البشير الذي يزور السعودية على رأس وفد رفيع المستوى للمرة الثانية خلال فترة قصيرة بهدف درس التطورات السودانية والقضية الفلسطينية والقضايا الدولية والعربية محل الاهتمام المشترك .	استقبل	0	Sing
1953 - شاه ايران محمد رضا بهلوي يفر الى بغداد ومنها الى روما بعد انقلاب قاده رئيس الحكومة محمد مصدق . وبعد ثلاثة ايام يقوم ضباط مقربون من الشاه بانقلاب يعيد الشاه ويجبر مصدق على الاختباء .	يفر	7	Sing
وتستهدف المجموعة التي تنوي استثمارا أكثر من 25 مليون جنيه في المشروع الذي يشمل خدمات تأمينية أخرى للأسرة المتوسطة والصغيرة النساء عموماً .	تنوي	3	Sing
بالمقابل ارتفعت في المناطق المسيحية لافتات ترحيب بالقرار 1559 وقد كتبت عليها عبارة " حرية سيادة استقلال " وهو الشعار الذي يردده انصار العماد ميشال عون المعارض لسوريا والمقيم في منفاه في فرنسا .	ارتفعت	1	Sing
ورأى معدو الاســـتطلاع أنه يــؤكد أن المـــال لا يجـــلب السعادة ، فلــم ترد فيه إشارة إلى الثراء كمصدر لهذه الحال .	ترد	12	Sing
بعض اللبنانيين يناقشون اليوم بالافكار والفرضيات . بعضهم الآخر يناقش بالوقائع والارقام . وهذا من غير استبعاد الناطقين بلسان مصالحهم في الجانبين ، وهم اكبر في الفئـة الأولى منهم في الثانية لأنها أقــرب الى مواقع السلطـــة والنفـــوذ والمنافـــع .	يناقشون	2	Plur
أما الدين الخارجي فقد قالت الحكومة إنه لم يتغير عن حدود 28.7 مليار دولار في حين رصد المركزي منذ أيام ارتفاعاً له ليصل إلى 29 مليار دولار .	رصد	16	Sing
كما اقترح الخبراء إلغاء رسوم الإغراق المفروضة على واردات الحديد من بعض الدول ، وكذلك خفض الجمارك على مستلزمات الإنتاج وتعديل لجنة المتابعة التي أعلنت الحكومة عنها لمراقبة السوق وضبط تعاملات وكشف أي تلاعب من جانب المنتجين أو التجار .	أعلنت	24	Sing
كان المتمردون قد هاجموا شركة اكسون موبيل عدة مرات مما تسب فى وقف عمل عملاقة البترول هناك .	اكسون	5	Plur
القدس 15 - 8 ( اف ب ) - اقترح رئيس الوزراء الاسرائيلي ايهود باراك اليوم الثلاثاء ان تعمل اسرائيل ولبنان على تنظيم نقاط تتم عندها اللقاءات العائلية على الحدود بينهما .	اقترح	9	Sing
واضاف " وبالمقابل افقد ( الحصار ) الدول التي تتعامل مع العراق فرصة بمقدار 140 مليار دولار من السلع والخدمات " .	افقد	3	Sing
واعترفت واشنطن الشهر الماضي بأن أحد الصواريخ العراقية انفجر قرب احدى طائرات المراقبة الجوية » أواكس « .	انفجر	8	Sing
علمت " الحياة " أن الإدارة الأمريكية تعد لمبادرة تسميها " الشرق الأوسط الأوسع " ، ويفترض أن يعلن عنها الرئيس جورج بوش قريباً .	علمت	0	Sing
وصرح كوتشما فى مؤتمر صحفى مشترك عقده مع نظيره الروسى فلاديمير بوتين فى منتجع يالطا على ساحل البحر الاسود , ان اجتماعه مع بوتين سوف يحسن مستوى التعاون بين البلدين .	يحسن	25	Sing
ويشمل مشروع القانون المقترح باسم تبسيط إجراءات الاستثمار 16 مادة بينها المادة 63 التي فجرت الغضب في منظمات الأعمال وتنص على أنه يجوز لمجلس الوزراء تقرير حوافز إضافية للشركات الأجنبية ذات الشهرة العالمية !	فجرت	14	Sing
أكد الوزير الروماني أن ممثلي الشركات الرومانية لبناء محطات الكهرباء وتصنيع المحولات وشركات تصنيع العدادات وأجهزة القياس زاروا الشركات المصرية ، وأعرب عن أمله في مشاركة الجانب الروماني في المناقصات الدولية الخاصة بمشروعات الطاقة في مصر .	زاروا	17	Plur
وفى حوار مع الوكالة ذكر ك . ب . س . جيل رئيس اتحاد الهوكى أنه اذا تم الاخذ بتصريحات فاجبايى يمكن للهند أن تلعب المزيد من المباريات ضد باكستان .	تلعب	24	Sing
من جهة اخرى قال ايغور بارانوف كبير مهندسي مكتب الدراسات الذي صمم الغواصة ان طاقم كورسك يمكنه ان يبقى على قيد الحياة ليومين اضافيين موضحا ان الغواصة تتضمن عدة انظمة تسمح ببقاء الطاقم على قيد الحياة .	تتضمن	27	Sing
ثم عاد سرحان في اليوم التالي وأمر برفع التحفظ عن الكتاب بعدما أوضح أن لجنة تابعة للهيئة قرأته وأقرته ولم تجد فيه ما يسيء إلى الدين .	يسيء	23	Sing
كانت الهند قد فقدت فرصة اللعب مع باكستان فى إطار دورة رئيسية للهوكى فى الشهر الماضى حينما طلبت الحكومة من الفريق أن ينسحب من المنافسة .	ينسحب	22	Sing
وكان المتحدث الاميركي اشار امس الى ان محادثات قمة كامب ديفيد اتسمت بطابع اقل رسمية من الايام السابقة بسبب العطلة الاسبوعية لدى اليهود .	اتسمت	11	Sing
وتعتبر الهند ان ولاية جامو وكشمير هي جزء لا يتجزأ من اراضيها وان اي انفصال مستحيل لانه يتناقض مع الدستور الهندي .	يتناقض	17	Sing
كل هذــه المـــعلومات جعلت اعـــوان الامــن يكثفــون من ابحاثهم وتحرياتهم الامر الذي مكـــنهم من حــصر الشــبهات في ثلاثة شبان تمر تجـــارتهم بضـــائقة مالية منذ مدة الا انهم استطاعوا خلال الفترة الاخيرة ايجاد حل ما لمشاكلهم المادية المتراكمة	استطاعوا	27	Plur
وأكد لحود امام الوفد » ضرورة تصحيح الانحراف الذي اصاب العملية السلمية في المنطقة ، نتيجة السياسة الاسرائيلية المعادية التي حولت المسألة من عملية سلام الى خطط امنية تحاول فرضها على كل من لبنان وسورية والفلسطينيين « .	اصاب	9	Sing
وقال ان وزارة التجارة ستستغل الفرصة لمناقشة القضايا التجارية المتعلقة بالمخاوف الصحية للاتحاد الاوروبى ، وخاصة الاثار الكيماوية فى منتجات الدجاج والجمبرى التايلاندى . واضاف ان الوفد التايلاندى سوف يقترح اجراء عمليات فحص قبل التصدير .	يقترح	29	Sing
وقد كانت الابحاث انطلقت عندما تشابهت التشكيات التي تقدم بها تجار افادوا انهم باعوا سلعا لثلاثة تجار استعملوا صكوكا بنكية كوسيلة للخلاص واتضح في ما بعد انها دون رصيد ومــزورة .	افادوا	11	Plur
وأحد هؤلاء هو رفائيلو فلاح ، وهو رجل أعمال كبير وناجح ، يفسر ذلك بالقول " إن الليبيين اليهود يؤمنون بالقذافي ويرفضون التعامل الإسرائيلي ، المتبجح حيناً والمستهتر حيناً آخر ، تجاهه " .	يؤمنون	19	Plur
وبدأت اعمال العنف فيما كان الزقاقيون يحاولون نهب المحلات التجارية بحجة انهم يبحثون عن سارق .	يبحثون	12	Plur
وقال شارون من منصة الكنيست متوجها الى نواب حزب العمل " لقد تخليتم حتى عن القسم الاكبر من المدينة القديمة " .	تخليتم	12	Plur
وينتمي محتشمي الى جمعية العلماء المجاهدين ( روحانيون مبارز ) الراديكالية ونواة التيار الاصلاحي التى سبق لها ان تولت رئاسة مجلس الشورى حتى عام 1992 .	تولت	18	Sing
وتردد انهم جلبوا معهم المتفجرات والذخيرة لأن ذلك جزء من العادات المتبعة فى قريتهم حيث اعتاد سكانها اطلاق النار فى الهواء خلال هذه الاحتفالات .	جلبوا	2	Plur
اجتاحت حالة من الشلل والارتباك سوق العقارات بسبب عدم استقرار أسعار مواد البناء .	اجتاحت	0	Sing
وأفاد مسؤول عسكري طلب عدم كشف هويته ان الاتصال بالطائرة انقطع بينما كانت تحلق قرب مدينة البصرة ، وقال الأميرال كريغ كويغلي الناطق باسم البنتاغون ان » الوضع شبيه جداً بما حدث قبل اسبوعين « .	تحلق	13	Sing
ولم تكشف هوية او جنسية المعتقلين .	تكشف	1	Sing
واضاف باول ان الولايات المتحدة تسعى لتحقيق السلام لجميع دول الشرق الاوسط مشيرا الى انه يجب ان يحل السلام فى المنطقة .	يحل	17	Sing
الجزائر / عنف - ذكرت الصحف اليوم ان اربعة اشخاص اغتيلوا الاحد في الجزائر على يد مجموعات اسلامية مسلحة في منطقتي بومرداس ( 50 كيلومترا شرق العاصمة ) وتيبازه ( 70 كيلومترا الى الغرب ) .	اغتيلوا	10	Plur
فرانكس يمنع التعذيب والاعدام في العراق	يمنع	1	Sing
ورفض التجار للاتهام بأنهم السبب وراء الزيادة في الأسعار موضحاً أن هامش الربح لم يختلف وأن الأسعار زادت من المصانع نفسها .	يختلف	14	Sing
5 - الكتاب المقدس لا يعطينا مشاهد مفصلة عن كيفية تطور التاريخ . على المسيحيين ان يعملوا من اجل العدالة والسلام عوض ان يتكهنوا حول المستقبل " .	يعملوا	16	Plur
كان أجداد كول بين المستوطنين الأوروبيين الأولّ في فيرجينيا وقد فروا من الاضطهاد الديني والكبت السياسي ، وجاهدوا لتأسيس مجتمع جديد يرتكز على احترام الحرية " وأنا أسير على خطاهم لقد هاجروا عبر المحيطات والقارات ، وكذلك أنا .	هاجروا	31	Plur
تشير الإحصاءات إلى أن السوق المحلي استهلك عام 2001 ما يقرب من 24 ألفا و 904 أطنان من اليامش بقيمة 27 مليوناً و 716 ألف دولار .	استهلك	6	Sing
غير ان عددا قليلا من المدارس التي سلمت من السرقة في بغداد والمدن الاخرى باشرت الدراسة رغم انقطاع التيار الكهربائي الذي تبذل الان الجهود لاصلاح الاضرار التي لحقت بشبكة الكهرباء جراء القصف الامريكي .	باشرت	14	Sing
تأكدت إصابة عشرة مرضى بمرض الإلتهاب الرئوى الحاد / سارس / بينما توفى 9 أخرون بالمرض فى هونج كونج وفقا للاعلان الصادر إدارة الصحة وهيئة المستشفيات فى هونج كونج اليوم السبت .	توفى	12	Sing
وحسب عينة عشوائية استطلعت مؤسسة للأبحاث وقياس الرأي العام آراءها في هذا الشأن لحساب الشركة ، ظهر أن نسبة الطلاق في مثل هذه الأوساط يمكن أن تصل إلى نحو 50 % .	استطلعت	3	Sing
جاءت الدعوة بعد يوم من اعلان فاجبايى فى البرلمان الهندى ان بلاده ستستأنف العلاقات الدبلوماسية الكاملة وتعيد الاتصالات الجوية مع باكستان .	جاءت	0	Sing
ويؤكد جيفسون الذي كان سكرتيرا ايضا للامير تشارلز خلال سنتين ، ان الاميرة اسرت له بالكثير من الامور ولا سيما خلال السنوات التي سبقت طلاقها من ولي العهد في 1996 .	اسرت	13	Sing
ويبدو ان التنسيق بين لجنة المتابعة وقيادة الحزب لم تتم بالشكل الكافي ، بحيث دفعت الحزب الى اتخاذ هذا الموقف من البيان الانتخابي بالرغم من ان الادارة اكتفت بالتعديلات الثانية التي ادخلت على البيان الانتخابي .	اكتفت	27	Sing
وبدورهم اشتكى السعوديون من ان الاستثمارات المصرية تعد متواضعة اذا ما قيست بالاستثمارات السعودية في مصر ، ففي حين ان استثمارات الأخيرة لا تزيد على 108 ملايين دولار تصل الاستثمارات السعودية في مصر إلى اكثر من بليون دولار .	اشتكى	1	Sing
ونظرا لأهمية الموضوع فقد تحول المحققون على جناح السرعة الى الموقع المشار إليه حيث حاصروا المظنون فيهم وألقوا عليهم القبض بحالة تلبس وحجزوا لديهم 15 قطعة أثرية لم يعرف مصدرها بعد أو معدنها وأجهزة وطلاسم وأشياء أخرى .	حاصروا	14	Plur
واطلع ايفانوف نظيره الصينى على وجهة نظر روسيا فى مشروع القرار الخاص بالعراق الذى ستقدمه الولايات المتحدة ودول أخرى لمجلس الأمن الدولى ، وأضاف أن الأمم المتحدة يجب أن تلعب دورا مهما فى هذه القضية الهامة .	تلعب	29	Sing
وهم يبيعون الدولار لتوفير احتياجاتهم الأساسية ، أما بالنسبة لعمليات المضاربة فهي منخفضة جدا الآن بسبب حالة الترقب كما ذكرت لأنهم لا يتوقعون رد فعل البنك المركزي على أي عملية للمضاربة لصالح الدولار على حساب الجنيه المصري .	يتوقعون	22	Plur
من ناحية أخرى رفضت أعداد كبيرة من شركات المقاولات إبرام عقود جديدة مع الوزارات بسبب ظاهرة عدم استقرار أسعار مواد البناء ورفض الحكومة دفع التعويضات الكافية للمقاولين عن فروق الأسعار التي شهدتها الأسواق مؤخراً .	رفضت	3	Sing
وقال البابا متوجها بكلامه لنحو 300 الف شاب ايطالي استقبلوه بحرارة امام كنيسة القديس يوحنا في روما " دعوا المسيح يحكم وجودكم الشاب ، اخدموه بحب . اخدموا المسيح والحرية " .	دعوا	18	Plur
/ يتبع /	يتبع	1	Sing
أوغندا تعيد توطين 15 ألف لاجئ سودانى	تعيد	1	Sing
الحكومة الاسبانية تستبعد وجود السارس فى اسبانيا	تستبعد	2	Sing
قد لا تحصل على التوافق الذي تحلم به هذا الأسبوع مع الأصدقاء وزملاء العمل .	تحلم	6	Sing
وقالت مصادر مصرية وإيرانية إن إزالة اسم الإسلامبولي يفتح الطريق أمام زيارة تاريخية للرئيس المصري حسني مبارك إلى إيران .	يفتح	8	Sing
1945 - الولايات المتحدة تقوم باختبار اول قنبلة نووية في نيومكسيكو .	تقوم	4	Sing
أولت إسرائيل أهمية قصوى للزيارة التي يقوم بها وزير خارجيتها سلفان شالوم لأثيوبيا واعتبرتها اختراقاً للقارة السوداء التي لم يزر وزير خارجية إسرائيلي أياً من بلدانها منذ 12 عاماً .	يزر	19	Sing
وكانت الجزائر قطعت علاقاتها الدبلوماسية مع ايران عام 1993 بعد ان اتهمت طهران بتقديم دعم صريح للحركات الاسلامية المسلحة في الجزائر .	قطعت	2	Sing
والى جانب العناية بالاطفال ستولى العناية بالمسنين اهمية خاصة من خلال تعزيز الاختصاص الطبي الذي يعنى بهم وهو ما يسمى بطب الشيخوخة اضافة للاختصاص شبه الطبي في المجال بما يوفر مساعدين متخصصين في رعاية المسنين .	يوفر	29	Sing
وقد اختير هذا الاسم " العالمي " للتنظيم ، كونه يضم قسماً من الليبيين الذين هاجروا من إسرائيل ويعيشون اليوم في دول أوروبية أخرى ، خصوصاً فرنسا وإيطاليا .	يضم	10	Sing
مفتي الديار المصرية يتخوف من ضرب الوجود الإسلامي	يتخوف	3	Sing
صندوق النقد الدولي يقر قرضاً قدره 395 مليون دولار لاندونيسيا لاندونيسيا	يقر	3	Sing
ورأى معدو الاســـتطلاع أنه يــؤكد أن المـــال لا يجـــلب السعادة ، فلــم ترد فيه إشارة إلى الثراء كمصدر لهذه الحال .	يــؤكد	4	Sing
وقال التقرير إن غالبية المخالفات تركزت في اشتراطات الأمن والمتابعة والفرامل وأحزمة الأمان ووسائل التحكم .	تركزت	5	Sing
وحذر الموساد بشكل خاص رجال الأعمال الإسرائيليين ممن تربطهم بهذه الدول مصالح تجارية ، وبالذات ممن انهوا الخدمة العسكرية برتب عالية .	انهوا	16	Plur
فجر السبت 23 / 11 / 2002 أغمض فؤاد قُزح بك عينيه الى اجل غير مسمى .	أغمض	7	Sing
يخشى ان يكون حوالى 160 شخصا قد لقوا مصرعهم بينما نجا 40 اخرون اثر انفتاح مفاجئ للباب الخلفى لطائرة بضائع كانت تحلق فى اجواء الكونغو ، وفقا لما ذكرته مصادر عسكرية .	تحلق	21	Sing
ومعظم المرضى الموجودين فى المستشفيات حاليا يستجيبون لنظام العلاج الجديد ، ويتلقى 80 مريضا العلاج فى وحدة العناية المركزة .	يستجيبون	6	Plur
واخيرا اشارت الدراسة الى ان 41،5 % من النساء اللواتي يتعرضن للعنف الجسدي من قبل شريك حميم ، اصبن بجروح خلال تعرضهن للاعتداء الاخير مقابل 19،9 % للرجال .	يتعرضن	10	Plur
قادة العالم يبعثون بتعازيهم لقادة الصين فى كارثة الغواصة	يبعثون	2	Plur
قد تصاب بعدوى بسيطة في حالة السماح بذلك .	تصاب	1	Sing
حاول أن تقنع صديق مقرب لك أن يطلب إجازة ويقضيها معك .	يطلب	7	Sing
أراد رئيس الوزراء ، أن يقول للمصريين ، استمتعوا بالسيئ . .	أراد	0	Sing
استقبلت باريس بارتياح تصريحات جديدة لشيخ الأزهر محمد سيد طنطاوي أكد فيها " حق " الدولة الفرنسية في إصدار قانون يحظر ارتداء المرأة الحجاب .	استقبلت	0	Sing
وقال ان هنالك اجماعا مشتركا بين الصين والسعودية فى هذا الشأن وان الصين سوف تتعاون مع الاطراف المعنية بما فيها السعودية وسوف تضطلع بدور نشط فى اعادة الاعمار فى عراق ما بعد الحرب .	تتعاون	14	Sing
قال الكيميائي يحيي قطب رئيس الشركة إن مساهمة الشركة في رأس مال المصنع الجديد تصل إلى نحو 99.2 % بينما تتوزع الـ 0.8 % الباقية على 10 مساهمين من رجال الأعمال .	تتوزع	20	Sing
وذكر البيان ان الاثنين والعشرين فلبينيا قد اعتقلوا فى 27 ابريل عندما ضل قاربهم طريقه فى الماليزية بسبب سوء حالة الملاحة الليلية .	اعتقلوا	7	Plur
1953 - شاه ايران محمد رضا بهلوي يفر الى بغداد ومنها الى روما بعد انقلاب قاده رئيس الحكومة محمد مصدق . وبعد ثلاثة ايام يقوم ضباط مقربون من الشاه بانقلاب يعيد الشاه ويجبر مصدق على الاختباء .	يعيد	30	Sing
كما استعرض المعشر نتائج جولته التى شملت الولايات المتحدة وبريطانيا ولقائه مع الامين العام للامم المتحدة كوفى عنان .	شملت	6	Sing
وقع المهندس سامح فهمي يوم 16 / 3 الحالي مع نظيره الفنزويلي رفائيل ريميرز مذكرة تفاهم بين البلدين للتعاون في مجال صناعة الغاز والبترول والعمل على استحداث مجموعة آليات تساعد على تطوير هذا التعاون .	وقع	0	Sing
وأن معظمهم يدير مشروعات مالية و " استثمارية استهلاكية " مثل الصناعات الغذائية والملابس ، بالإضافة لاستغلال جانب منهم لمواقعهم ( السياسية ) في جميع الأرباح من احتكار بعض المنتجات الصناعية والاستراتيجية والمشروعات العقارية .	يدير	2	Sing
واعلن الاميرال كورويدوف ان " البحر شديد الموج وفرق الانقاذ لا تستطيع ان تلقي مراسيها " .	تستطيع	11	Sing
شرودر يدافع عن موقفه المعارض للحرب على العراق	يدافع	1	Sing
لن يضيع أسامة بن لادن الفرصة .	يضيع	1	Sing
وقتل ولدان ذبحا الاحد في الحطاطبة قرب تيبازه على يد مجموعة اسلامية مسلحة فر عناصرها باتجاه غابة قريبة على ما ذكرت صحيفة " لو كوتيديان دوران " .	فر	13	Sing
يعلنون من جديد بإرادتهم البحتة . .	يعلنون	0	Plur
أودى المرض بحياة 9 أشخاص ليرتفع بذلك عدد المتوفين جراء الإصابة بهذا المرض إلى 179 مريضا .	أودى	0	Sing
منظمة العمل المالي تشيد بجهود مصر لمكافحة غسل الأموال	تشيد	3	Sing
واضاف الحلف ان موسكو لم تتقدم بطلب رسمي ، مشيرا الى ان الضباط الروس تحادثوا طوال نصف ساعة ايضا عبر حوار تلفوني مع المتخصصين في مسائل الغواصات في الحلف الاطلسي في نورثوود ( بريطانيا ) .	تحادثوا	14	Plur
أكدت مصادر اقتصادية مسئولة بدء عملية ترقيم الأراضي والأحواض الزراعية في إطار الاستعداد لتطبيق الاشتراطات الأوروبية .	أكدت	0	Sing
وفيما يلى اهم النقاط التى وردت فى مشروع القرار : - تطالب الولايات المتحدة وبريطانيا برفع كافة العقوبات التجارية والمالية التى فرضت ضد العراق عقب غزوه الكويت ، باستثناء حظر السلاح .	وردت	5	Sing
شافيز يختتم جولته في الجزائر واثقا من نجاح قمة كراكاس	يختتم	1	Sing
وقال إن الجانبين اتفقا على خطوات محددة سيتم تنفيذها قريباً جداً تتمثل في إقامة معارضة متخصصة للمنتجات المصرية في العراق والبحث في تنفيذ مشاريع مشتركة لإعمار العراق .	تتمثل	11	Sing
الأخطر من ذلك ، أن طلبات عناصر من " منظمة بدر " وأحزاب وطنية وإسلامية للانضمام إلى وزارة الداخلية وقوات الجيش العراقي الجديد قوبلت بالرفض بتوصية من الأمريكيين .	قوبلت	23	Sing
وفي 31 كانون الثاني ( يناير ) الماضي حكمت محكمة اسكتلندية اقيمت في كامب زايست ( هولندا ) على المقرحي ( 49 عاما ) بالسجن المؤبد فيما برأت المتهم الاخر الليبي الامين خليفة فحيمة .	حكمت	8	Sing
تعليقاً على الوعكة الصحية التي ألمت بالرئيس أثناء إلقائه خطابه بمجلس الشعب كتب سمير رجب رئيس تحرير الجمهورية يقول : العلاقة التي تربط " حسني مبارك " بكل أبناء شعب مصر . .	تربط	22	Sing
ومن جهة اخرى ، هناك ضحايا يتعرضون لاعمال عنف مرات عدة في السنة ، فالنساء يتعرضن لمثل هذه الاعمال 4،9 ملايين مرة تقريبا والرجال 2،9 مليون مرة في السنة .	يتعرضن	15	Plur
وكشفت التقارير أن نحو 150 ألف معلم مصري من بين 450 ألف معلم فقط ، هم الذين أبلغوا مصلحة الضرائب عن نشاطهم في الدروس الخصوصية ، ولهم ملفات في مصلحة الضرائب ، أي ثلث المعلمين فقط .	أبلغوا	17	Plur
كما يريد القذافي من باريس ان تستخدم نفوذها لدى الامم المتحدة " لتسريع تطبيق رفع العقوبات الاقتصادية المفروضة " على بلاده وان " تهدىء قليلا القاضي بروغيير " الذي يتولى ملف الاعتداء على طائرة يوتا .	تهدىء	23	Sing
واضاف الضابط طالبا عدم ذكر اسمه انه قدم هو الاخر استقالته وقال اصبحنا بين نارين . بين التهديد بالقتل من قبل عناصر المقاومة وبين الاستجابة لاوامر القوات الامريكية التي لا يمكننا باي حال من الاحوال تنفيذها .	اصبحنا	12	Plur
4 - تأكيدهم استمرار الوعد الالهي بالعودة الى فلسطين رغم تحقق هذا الوعد عام 536 ق . م . وبعض المسيحيين يؤمنون ان هذه الوعود تحققت ثانية في عودة اليهود الى ارض فلسطين منذ عام . 1880	يؤمنون	21	Plur
وقال مواطنون في القرية إن قوات معززة من الجيش الاسرائيلى اقتحمت القرية في وقت سابق واشتبكت مع عدد من المسلحين الفلسطينيين كما داهمت العديد من المنازل بحثا عن " مطلوبين " .	داهمت	22	Sing
رامسفيلد يقول انه لا يستطيع التكهن بمدة بقاء الولايات المتحدة فى العراق	يستطيع	4	Sing
ومن العقبات التي تواجه استئناف الدراسة ان المعلمين لم يتسلموا رواتبهم الشهرية ولا يعرفون متى يتقاضون هذه الرواتب رغم الوعود الامريكية بدفع 20 دولارا لكل موظف يلتحق بوظيفته كدفعة طوارئ .	يتقاضون	15	Plur
ظهرت بوادر أزمة بين الكويت ومصر ، بسبب إعلان نشره الصندوق الكويتي للتنمية في صحف عدة يتناول مسابقة تتضمن جوائز للذين يجيبون عن أسئلة تتعلق بقيمة المساعدات التي قدمتها الكويت إلى مصر .	يتناول	16	Sing
واشار الى اعتزام الولايات المتحدة وحليفتاها بريطانيا واسبانيا تقديم مشروع قرار الى الامم المتحدة لرفع العقوبات الاقتصادية قائلا ، ان الدول التى تعتزم انهاء هذه العقوبات هى نفس الدول التى اعترضت بشدة من قبل على رفع هذه العقوبات .	اعترضت	30	Sing
مصابون عراقيون يصلون الى السعودية	يصلون	2	Plur
نقابة الصحفيين ترفض معونة أمريكية مشروطة لتدريب أعضائها أعضائها	ترفض	2	Sing
من ناحية اخرى يتعين على مختلف المحليات والادارات الحكومية التى تستخدم الفلاحين كعمال بذل جهود اكبر لابقاء هؤلاء العمال فى مواقعهم بالمدن .	يتعين	3	Sing
وأفادت مصادر المعلومات أن المشروع الأوروبي المقترح ليكون موضع تفاوض مع الجانب المصري يدعو إلى الاستناد إلى مبدأ التدفقات التجارية التقليدية في تقرير المزايا التجارية التي ستنشأ لمصر في إطار العلاقات مع الاتحاد الأوروبي بعدما ينضم إليه الأعضاء الجدد .	ينضم	35	Sing
وتخشى السلطات من ارتفاع عدد الضحايا اذ ان رجال الاسعاف الذين ارسلوا الى مكان الكارثة وعددهم يزيد عن المائة ، لم يتمكنوا عند منتصف النهار امس الا من تمشيط ربع المخيم بحثا عن الضحايا بين الانقاض .	ارسلوا	11	Plur
بل بدأ يتراجع الدولار قليلاً وأعتقد أن الضغط على الجنيه المصري بدأ يقل ، ويرجع ذلك إلى زيادة نسبة في الصادرات المصرية وكذلك زيادة الإيرادات من السياحة .	يقل	12	Sing
اشادت شركة سيمنز الالمانية بشفافية السياسات التى تتمسك بها حكومة بلدية شانغهاى فى مجال مكافحة السارس مؤكدة ان الشركة قد اتخذت اجراءات فعالة للوقاية عن هذا الوباء بفضل هذه السياسات .	تتمسك	7	Sing
يذكر ان البرنامج قد توقف قبل سنتين عندما اخطأت طائرة قتالية بيروفية فى اسقاط طائرة مدنية مما ادى الى مقتل مبشرة امريكية وابنتها فى بيرو .	ادى	17	Sing
وبعث وزير الدفاع الاميركي وليم كوهن رسالة الى نظيره الروسي ايغور سيرغييف عارضا عليه تقديم مساعدة اميركية لكنه لم يتلق ردا حتى الان ، كما قال الاميرال كويغلي .	يتلق	19	Sing
اتصل وزير الخارجية الامريكى كولين باول بوزير الشئون الخارجية الهندى ياشوانت سينها اليوم ، حيث اعرب عن ترحيبه بمبادرات السلام الهندية تجاه باكستان .	اتصل	0	Sing
وختم الكوبي الطائر حامل ذهبية اولمبياد برشلونة عام 1992 : " يتمثل الحلم في احراز ذهبية اولمبياد سيدني ، على اي حال فان احتلال احد المراكز الثلاثة الاولى يؤكد بانني استعيد مستواي السابق تدريجيا " .	استعيد	30	Sing
إلا أن المصدر رفض الإدلاء بموعد الانتهاء من الصفقة وإعلانها أو السعر النهائي الذي تم التوصل إليه بين الطرفين واكتفى بالقول إن هناك مشاورات تتم بين الجهاز المركزي للمحاسبات وبنك القاهرة .	تتم	24	Sing
وقال بن عامي امام اللجنة السياسية لحزب العمل " ان الوقت ناضج لاجراء مفاوضات جدية مع الفلسطينيين بعد ان ارجئت مسالة اعلان الدولة الفلسطينية ، واثر الحملات الدولية لياسر عرفات ( الرئيس الفلسطيني ) واسرائيل " .	ارجئت	19	Sing
كما أشارت إلى " الجانب الاقتصادي المهم " في زيارة شالوم الذي يرافقه وفد يضم رجال أعمال يمثلون شركات في مجالات التكنولوجيا والزراعة والسياحة لبحث توطيد العلاقات الاقتصادية الثنائية بعد ارتفاع هائل في صادرات التكنولوجيا المتطورة إلى أثيوبيا .	أشارت	1	Sing
واشار خطاب الى أنه تم البدء فعلياً في أولى مراحل الإصلاح بخروج 3500 عامل بنظام المعاش المبكر بكلفة 160 مليون جنيه ، وذلك من أصل نحو 20 ألف عامل يعملون في الشركة .	يعملون	29	Plur
ويقول مشروع القرار الذي قدمه السيناتور الجمهوري آرلن سبكتر إن الرئيس بوش " يجب أن يقدم شهادة بأن السعودية تقوم بمحاربة الإرهاب وتتعاون مع الولايات المتحدة في حربها ضد المتشددين وإلا واجهت المملكة عدداً من العقوبات الأمريكية " .	يقدم	15	Sing
وكان والاس نفسه اشار الى امكانية مشاركة اوتي في سيدني بدلا من بيفيرلي ماكدونالد صاحبة المركز الثالث ، التي " تشارك عادة في سباق 200 م " .	اشار	3	Sing
ونسبت صحيفة " نيويورك تايمز " إلى جنود بالقاعدة ومصادر استخبارية أن المعتقلين غير المتعاونين في التحقيقات يتعرضون بشكل منتظم لمعاملة سيئة وانتهاكات لفترات طويلة .	يتعرضون	17	Plur
ويرى محلل سياسي عراقي أن الإسراف في الترويج للفيدرالية سلاح خطير يخدم الداعين إلى تقسيم العراق لأن المطالبة بالفيدرالية تدفع أية أقلية عرقية ودينية إلى أن تطالب بما حصلت عليه أقليات أخرى .	تدفع	19	Sing
تبلي بلاء حسنًا أمام الناس وبينك وبين نفسك , والخيار لك .	تبلي	0	Sing
وأكد الخبراء أن الأسعار ستواصل الارتفاع حال استمرار الأوضاع الراهنة وعدم تدخل الحكومة لحسم هذه الأزمة من خلال آليات تحديد السعر العادل لطن حديد التسليح يرضي كل الأطراف وينهي شبهات الاحتكار .	يرضي	25	Sing
وزراء خارجية الاتحاد الاوربى يبحثون عودة البعثات الدبلوماسية الى العراق	يبحثون	4	Plur
أو يصادف الأمر ويستيقظ ذات صباح . .	يصادف	1	Sing
لكن قيادياً بارزاً في " الإخوان " قال لـ " الحياة " إن " الجماعة تعلم أن هؤلاء سيسعون في أول محك سياسي إلى طلب ود الإخوان وكسب أصوات ناخبيهم " .	تعلم	15	Sing
مثل نظرائه الستة الذين سبقوه ، بدأ السفير الإسرائيلي الجديد في القاهرة إيلي شكيد يعاني من العزلة التي أحاطت بكل سفراء إسرائيل في القاهرة .	أحاطت	18	Sing
تونس / الصباح يبدو ان ما يشبه عدم التنسيق حصل بين دوائر القرار صلب الحزب الديموقراطي التقدمي ، فيما يخص البيان الانتخابي والتعديلات التي حصلت مفاوضات بشأنها بين الحزب والادارة .	حصلت	24	Sing
لكن هذه التبسيطية لم تلحظ المرحلة اللاحقة لمثل هذا السيناريو ، في حال افترضنا نجاح تحقيقه .	تلحظ	4	Sing
- احتج العراق بشدة لدى الامم المتحدة على الغارات الاميركية البريطانية التي استهدفت منشآت مدنية في جنوب العراق واسفرت عن سقوط قتيلين و 23 جريحا .	استهدفت	12	Sing
يلقي رئيس الوزراء الدكتور عاطف عبيد بيان الحكومة يوم 28 / 12 الحالي أمام مجلس الشعب متضمناً تقييماً لأداء حكومته في العام الماضي ورصداً للسياسات المتوقع تنفيذها في العام القادم لرفع أداء الاقتصاد المصري .	يلقي	0	Sing
وقال ان " ان عدد الحجرات التي غمرتها المياه وارتفاع الضغط الجوي ودرجات الحرارة ووضع مخزون الهواء ، كلها عوامل تؤثر على المهلة المتاحة امامهم للبقاء على قيد الحياة " .	تؤثر	20	Sing
كما نوقشت قضية اخرى هى مشاركة البرازيل فى تشغيل مناجم ماوتيز للفحم فى مقاطعة تيت بغرب موزمبيق .	نوقشت	1	Sing
الفوضى مستمرة والبلاد غير امنة ولا توجد حكومة والسلاح متوفر فى كل مكان وما زال اللصوص والمخربون يواصلون عملياتهم الاجرامية وما تزال الدبابات الامريكية تجوب الشوارع تزرع الرعب ولكنها فى الوقت نفسه اصبحت هدفا للعراقيين الذين يرفضون استمرار الاحتلال .	اصبحت	32	Sing
واكد باول ان المسؤولين السوريين ابلغوه خلال محادثاته معهم في دمشق انهم اقفلوا مكاتب لعدد من المجموعات المناهضة لاسرائيل ، وهو ما تطالب به الولايات المتحدة .	اقفلوا	12	Plur
وقال مصدر مطلع لـ " الحياة " إن أحد الحاضرين سأل رايس " هل الفكرة هي تحرير هذه الدول من الإسلام " ، فنفت قائلة إن الإدارة الأمريكية " تحترم الإسلام " .	تحترم	29	Sing
وقال راشد إن الشركات العالمية بررت زيادة رسوم الشحن بارتفاع أسعار الوقود وتغطية خدمات الأمان على طائراتها .	بررت	5	Sing
واضاف " نحن على استعداد لتزويد الابناء فى العراق بما يحتاجونه بناء على عقد مقدم ما لم يجدوا البديل داخل النفط العراقى " .	يجدوا	17	Plur
وأكد أن قضية السكان " هي قضية محورية لمصر " ، مشيراً إلى أن العديد من المشاكل مثل البطالة وزيادة الأسعار والتعليم " ترجع إلى قضية زيادة السكان " .	ترجع	23	Sing
أكدت الحكومة المصرية انها لا تنوي تصفية » شركة الحديد والصلب « نظراً لوضعها الاستراتيجي ، إذ تتعامل مع 700 مصنع أبرزها » شركة الكوك « التي تنتج فحم الكوك .	تنتج	27	Sing
يعتبر المجلس هذا التصريح مؤشرا قويا باتجاه حدوث تغير فى موقف الحكومة من شأنه أن يسهل مشاركة الندين التقليديين فى كأس آسيا المقبل .	يسهل	15	Sing
ويبدو ان التنسيق بين لجنة المتابعة وقيادة الحزب لم تتم بالشكل الكافي ، بحيث دفعت الحزب الى اتخاذ هذا الموقف من البيان الانتخابي بالرغم من ان الادارة اكتفت بالتعديلات الثانية التي ادخلت على البيان الانتخابي .	ادخلت	31	Sing
وعن أهم المحاصيل التي ستنتجها هذه المزرعة القمح ، فول الصويا ، الذرة ، عباد الشمس ، الخضر ، نباتات الزينة كما توجد بها أحواض خاصة كمزارع سمكية .	توجد	22	Sing
يعرف عمر سليمان كل ذلك ، لهذا يحاول المساعدة في اختراع الآمال والتليين والتحذير لدفع الفلسطينيين إلى الانتظار في ظل صيغة تخفض الأضرار وتبقي الباب مفتوحاً ، خصوصاً أن شيئا ما يتحرك في إسرائيل .	يعرف	0	Sing
التقديرات تقول إن الأتراك يتخوفون من قيام إسرائيل بمساعدة الأكراد .	يتخوفون	4	Plur
قالت مصادر إسرائيلية بأن إسرائيليين امتلكوا من الأكراد ، قطع أرض غنية بالنفط ، في منقطة الموصل .	امتلكوا	5	Plur
واللعبة باختصار تتمثل في ايجاد الطريق الاكثر امنا للحصول على ذلك النفط وايصاله بسرعة إلى الاسواق العالمية .	تتمثل	2	Sing
كما أن الإصلاحات الاقتصادية ترضي الفقراء خصوصاً في الصعيد وزهدي واحد من أبناء تلك المناطق التي ظلت أرضاً خصبة لتفريخ الأصوليين الراديكاليين .	ظلت	16	Sing
بينما ما زالت هناك أعداد متهربة من تسجيل نفسها ضريبياً وإن كانت تمارس العمل في الخفاء وتندرج دخولهم في هذه الحالة تحت بند الاقتصاد السري في مصر .	تمارس	12	Sing
أجّلت الحكومة المصرية الى اجل غير مسمى طرح أسهم شركة الاتصالات الحكومية في البورصات الدولية الى حين استعادة الاقتصاد الدولي عافيته بعد أحداث أيلول ( سبتمبر ) الماضي .	أجّلت	0	Sing
2 - اليهود الذين لم يقبلوا يسوع كمسيا ( المسيح ) خسروا بركات العهد ومنافعه .	خسروا	11	Plur
ومن المتوقع ان يغادر بيروت فى اعقاب انتهاء هذا المؤتمر الصحفى المشترك .	يغادر	3	Sing
وقال ناطق بلسان وزارة الخارجية في القدس ، نقل هذا التحذير إن الخطر يواجه الإسرائيليين حاليا في كل من إريتريا وإثيوبيا وكينيا والصومال وتنزانيا ففي هذه الدول تتنامى قوة التنظيمات الأصولية الإسلامية .	تتنامى	27	Sing
وجاء اعتراف الوزير وسط تصاعد اتهامات أعضاء مجلس الشعب للوزراء وكبار المسئولين بالتواطؤ مع بعض رجال الأعمال الذين يحتكرون سوق الحديد بهدف تحقيق مصالح شخصية على حساب مصلحة الاقتصاد القومي .	يحتكرون	18	Plur
وهم كانوا يحتاجون إلى رسالة ربما وصلتهم بإطلاق زهدي وزملائه مفادها أن الإصلاحات يمكن أن تشملهم ، حتى وإن لم تكن الرسالة صريحة وواضحة .	يحتاجون	2	Plur
وإلى أي مستوى وصلنا ، هذه هي مفاتيح المواقف العملية التي يقفها الشعب المسلم المتفاعل بإسلامه العامل به ، والساعي للبذل والتضحية في سبيله " .	وصلنا	3	Plur
مصادر أميركية تكشف شيوع التعذيب ب غوانتانامو	تكشف	2	Sing
الفوضى مستمرة والبلاد غير امنة ولا توجد حكومة والسلاح متوفر فى كل مكان وما زال اللصوص والمخربون يواصلون عملياتهم الاجرامية وما تزال الدبابات الامريكية تجوب الشوارع تزرع الرعب ولكنها فى الوقت نفسه اصبحت هدفا للعراقيين الذين يرفضون استمرار الاحتلال .	تزرع	26	Sing
وقع الانفجار فى قاع احد المناجم حيث كان يعمل الضحايا الاربعة .	وقع	0	Sing
اوضحت الشرطة ان المقداد مطلوب بموجب 177 مذكرة عدلية بجرائم سرقة سيارات واتجار بالمخدرات وقتل واتجار بالسلاح وترويج عملات مزورة وتشكيل عصابات منظمة ومقاومة رجال قوى الامن .	اوضحت	0	Sing
فقاموا بعدة تحريات مكنتهم من الايقاع ببعض المظنون فيهم وقد بلغ عدد الموقوفين العشرة واعترفوا جميعا بما نسب اليهم وحدد كل واحد منهم الدور الذي قام به ومن المنتظر ان يحالوا في قادم الايام على انظار السلط القضائية .	يحالوا	30	Plur
وتعتزم الهند من جهتها شراء حاملة الطائرات الروسية " اميرال غورشكوف " وستشتري طائرات ميغ - 29 الوحيدة التي تتلاءم مع حاملة الطائرات هذه . وقد يشمل العقد شراء 60 طائرة .	تتلاءم	19	Sing
أضاف أن حالة عدم استقرار أسعار الحديد تفرض على البنوك التريث في منح تسهيلات جديدة لمنتجي حديد التسليح .	تفرض	7	Sing
وقال إن " المسلمين يرفضون سائر المبادرات التي تمس حق العودة للاجئين الفلسطينيين وتساوم على القدس ومقدساتها . .	تمس	8	Sing
المصرية للاتصالات تتنازل عن إنشاء شركة ثالثة للمحمول للمحمول	تتنازل	2	Sing
وقال سعد الدين العثماني ، نائب الأمين العام لحزب العدالة والتنمية " لا يمكن إلا أن نرحّب بهذه الترجمة باعتبارها عملاً يستحق التنويه وضرورة دينية مادام القرآن قد ترجم إلى مئات من اللغات واللهجات " .	ترجم	28	Sing
" في خضم همومنا الداخلية خرج صوت يدعو الى الحوار وتكريس مبادئ السلام والعدالة . انه صوت آبائنا أصحاب الغبطة بطاركة الشرق الكاثوليك ، وهم كانوا ولا يزالون رسل سلام ومحبة وحوار .	يزالون	27	Plur
واكد ان " الاطفال والكبار يمكن ان يصابوا بادمان على المشروبات التي تحتوي الكافيين وان يشعروا باعراض النقص جسديا ونفسيا اذا توقفوا عن شربها " .	تحتوي	12	Sing
كما قال باول فى المؤتمر الصحفى انه سيناقش مع الرئيس السورى مواضيع المنظمات الفلسطينية التى تتخذ من دمشق مقرا لها والحدود السورية العراقية واسلحة الدمار الشامل .	تتخذ	15	Sing
وقال الدكتور رولاند غريفيث الذي يقود فريق البحث ان منتجي المياه الغازية " يضيفون اليها مخدرا يسبب ادمانا طفيفا ويؤثر على الحالة المزاجية مما يفسر بالتاكيد زيادة الاقبال على المشروبات الغازية التي تحتوي على الكافيين " .	تحتوي	32	Sing
استقبلت باريس بارتياح تصريحات جديدة لشيخ الأزهر محمد سيد طنطاوي أكد فيها " حق " الدولة الفرنسية في إصدار قانون يحظر ارتداء المرأة الحجاب .	يحظر	20	Sing
أفاد الراديو النيجيرى المحلى اليوم أن سبعة أشخاص ، من بينهم ثلاثة من أفراد الشرطة ، قتلوا على يد عصابة من اللصوص المسلحين على طريق انكا - جومى السريع بولاية زامفارا شمال غرب نيجيريا .	أفاد	0	Sing
واكد مصدر مطلع على ملف تشكيل الحكومة ان لحود يريد تشكيلة موسعة تضم معظم القوى التي دعمت تمديد ولايته فيما يسعى الحريري الذي لم يتوصل الى اقناع المعارضة بالمشاركة الى ان تكون الحكومة حكومة مصغرة .	يتوصل	24	Sing
ومن عجب أن يتسبب في جل هذه المعاناة جماعات ممن يزعمون الانتساب إلى المسيح ودينه ، في أوروبا وأمريكا الذين شادوا حضارة العنف والعنصرية والانحلال الأخلاقي " . .	شادوا	20	Plur
غير ان باركو نفت ان يشمل البرنامج الامريكى لاعتراض تهريب المخدرات بالطائرات فى كولومبيا اقامة ممر جوى من ولاية تشوكا الى منطقة الغابات على الحدود الشمالية الشرقية للبلاد .	يشمل	5	Sing
أخطأ الذين اعتقدوا أن هجمات 11 سبتمبر طلقة مدوية في حرب بعيدة .	اعتقدوا	2	Plur
وتابع التقرير أن منتجي حديد التسليح لاسيما الكبار اضطروا إلى تهدئة الأوضاع والاستجابة لتدخل الحكومة لامتصاص غضب الرأي العام لحين العودة مجدداً لرفع الأسعار .	اضطروا	8	Plur
واعلن باراك للمسؤولة الاميركية انه رغم عدم التمكن من التوصل الى اتفاق في كامب ديفيد فان هذه القمة اتاحت تحقيق تقدم " ولا بد الان من انتظار قرارات الفلسطينيين " حسبما جاء في البيان .	اتاحت	18	Sing
ويجري مجلس الامن الدولي حاليا جلسة مشاورات على مستوى الخبراء لهذا القرار الذي طلب ضمنا بخروج القوات السورية من لبنان وبان تضع دمشق حدا لتدخلها في الشؤون الداخلية لهذا البلد .	تضع	21	Sing
وطالبوا بضرورة العمل على زيادة حجم الطاقة الإنتاجية للشركات بنسبة معقولة حتى تتوافر كافة احتياجات الأسواق وبالتالي يتجه مؤشر الأسعار إلى الانخفاض خاصة أن سعر تسليم المصنع لا يتجاوز 205 جنيها فقط .	تتوافر	12	Sing
وأفادت مصادر مطلعة أن المواطنين أبلغوا الشرطة التي انتقلت بأعداد كبيرة إلى القرية لتفادي استفحال الوضع كما حدث قبل سنوات في قرية الكشح التابعة لمحافظة سوهاج التي شهدت مصادمات بين المسلمين والأقباط أسفرت عن مقتل 20 قبطياً ومسلم واحد .	أبلغوا	5	Plur
تبذل محاولات رسمية ومدنية في مصر لتحدي حاجز الحرج المنيع المقام ضد قضايا الجنس التي تشغل بال المراهقين ، بغية تجنب الجهل وحجب المعلومات وهما يؤديان إلى مهازل أخلاقية .	تشغل	15	Sing
ويكمن بصيص الامل الوحيد بالنسبة الى اوتي في احدى مواد النظام الداخلي للاتحاد الجامايكي التي تنص على استبعاد اي رياضي لا يستطيع المحافظة على المستوى الذي ظهر به خلال التجارب .	تنص	15	Sing
أكّد تقرير حكومي مصري أن تحسّنًا طرأ على ميزان المدفوعات حيث حقق فائضاً جارياً بلغ 1.9 مليار دولار خلال العام الحالي .	طرأ	6	Sing
فقد جاءت دعوة الكلدان والآشوريين هذه بعد سلسلة مطالب كان من أبرزها المطالب الكردية التي أكدت ضرورة أن يتضمن الدستور العراقي المقبل نصاً صريحاً يقر بالفيدرالية التي تلبي الحقوق القومية الكاملة لأكراد العراق .	جاءت	1	Sing
صحيفة فرنسية : القذافي يتفاوض مع باريس بشان " المقابل السياسي " لوساطته في الفيليبين	يتفاوض	4	Sing
وأوضـح ان عدداً من المســــؤولين الاتراك أعلــنوا رسمياً ان تركيا » لا تأمل ولا تؤيد توجيه ضربة اميركية الى العراق ، لكن ظروفاً وشروطاً جديدة قد تجبرنا على اعادة النظر في موقفنا « .	أعلــنوا	6	Plur
وأعرب حسن خريشة نائب رئيس المجلس التشريعي عن امله بالاستجابة لمطالب التغيير واقالة وزراء وردت اسماؤهم في تقارير تتعلق بالفساد ، وآخرين فشلوا في اداء مهامهم .	فشلوا	22	Plur
وقد ادى هذا الفشل الى تذمر العراقيين بمن فيهم اولئك الذين رحبوا باسقاط النظام السابق ولا يكاد يمر يوم وخاصة فى الليل دون ان تسمع اصوات اطلاق الرصاص سواء تلك التى تتم اثناء عمليات السرقة او ضد الجنود الامريكيين .	رحبوا	11	Plur
تعليقاً على الوعكة الصحية التي ألمت بالرئيس أثناء إلقائه خطابه بمجلس الشعب كتب سمير رجب رئيس تحرير الجمهورية يقول : العلاقة التي تربط " حسني مبارك " بكل أبناء شعب مصر . .	ألمت	5	Sing
تم تقسيم جزيرة قبرص إلى جنوب يسيطر عليه القبارصة اليونانيون وشمال يسيطر عليه القبارصة الأتراك منذ الغزو التركى للجزيرة عام 1974 بعد فشل انقلاب موال لاثينا ، ويعترف المجتمع الدولى بالحكومة التى يسيطر عليها القبارصة اليونانيون فقط .	يسيطر	11	Sing
وعندما توجه التلاميذ الى المدارس في الصباح طبقا للموعد الذي حددته قوات الاحتلال الامريكية لاستئناف الدراسة كان الامل يحدوهم وكذلك اباؤهم في اكمال السنة الدراسية بعد توقف دام اكثر من شهر بسبب الحرب .	دام	27	Sing
وستقوم لجنة يرأسها الشيخ فوزي الزفزاف بإعداد رؤية شرعية شاملة عن الأفكار البهائية التي جعلت بعض شيوخ الأزهر والمسؤولين عن الإفتاء في مصر يحكمون على البهائيين بالكفر والخروج من الملة .	جعلت	14	Sing
وقال نائب رئيس مجلس الدولة انه خلال انتشار السارس يجب ان يفكر هؤلاء العمال فى انفسهم واقاربهم فى ديارهم ومجتمعاتهم فى المقام الاول ، وان يبقوا فى العمل بالمناطق الحضرية .	يبقوا	25	Plur
وقال إنه يجري حالياً التشاور بحيث لا تكون عروض الشركات المصرية مقصورة على بغداد فحسب وإنما تنتقل إلى الأقاليم الشمالية في العراق للتعريف بها هناك .	تنتقل	16	Sing
لكن مراقبين توقعوا أن تسرع السلطات بتصفية أوضاع جميع المعتقلين من المنتمين إلى الجماعات الإسلامية في غضون الشهور المقبلة .	تسرع	4	Sing
نظرتها المستمرة إلى العالم بعيني 11 سبتمبر لا تسهل مهمة التفاهم معها أو الرهان عليها .	تسهل	8	Sing
لاغوس 15 - 8 ( اف ب ) - لقي 18 شخصا مصرعهم عند انفجار انبوب نفط في جنوب شرق نيجيريا السبت بينما كانوا يشفطون النفط منه بطريقة غير قانونية ، حسبما اوردت الصحف الصادرة اليوم الثلاثاء .	اوردت	32	Sing
وأعربت عن توقعاتها أن تشهد المرحلة المقبلة زيادة حجم الاستثمارات الأمريكية في البلاد وكذلك حجم التجارة المتبادلة والتي من شأنها أن تلعب دوراً أساسياً في تنمية العلاقات الاستراتيجية بين البلدين .	تلعب	21	Sing
بعض العلاقات السرية تسبب لك مشكلات عديدة .	تسبب	3	Sing
تمتنع عن بيع الشركات التابعة لوزارة الاقتصاد سابقاً . الحكومة المصرية تخصص 936 مليون دولار لإصلاح شركات الحديد والصلب والغزل والنسيج والنسيج	تمتنع	0	Sing
وتشير الاتهامات الى الامريكيين الذين تركوا البلاد دون اتخاذ اى اجراء لضبط الامن والاستقرار وارتفاع الاسعار وانقطاع التيار الكهربائى والماء ووقود السيارات والخدمات العامة الخرى وعدم دفع رواتب الموظفين .	تركوا	5	Plur
- يطالب مشروع القرار الولايات المتحدة وبريطانيا " بممارسة المسؤولية " لفترة مبدئية مدتها 12 شهرا . وتستمر هذه الولاية تلقائيا مالم يقرر مجلس الامن غير ذلك .	يقرر	22	Sing
وللمرة الأولى لوحظ أن الصحف القومية أبرزت يوم 2 / 1 الحالي الحديث عن مسألة التوريث .	لوحظ	2	Sing
يذكر أن الكميات التي تم توريدها العام الماضي من القمح المحلي لم تتعد 1.7 مليون طن .	تتعد	12	Sing
ووجه الدكتور طنطاوي غضبه الشديد ضد صدام حسين ونظامه الذي وصفه بالإجرام دون أن يوجه كلمة انتقاد واحدة للمحتل الأمريكي وجرائمه التي ترتكب على أرض العراق .	ترتكب	22	Sing
وجاء في الاستجواب المقدم لوزيري التنمية المحلية والكهرباء أن بعض المحافظات تعاقدت مع شركات أجنبية لجمع القمامة وتحصيل ذلك مع فاتورة الكهرباء دون موافقة المواطنين رغم خلو عقود شركات الكهرباء من مثل هذه الجباية .	تعاقدت	11	Sing
مؤتمر جديد للقوى السياسية العراقية يعقد بعد ظهر اليوم فى بغداد	يعقد	5	Sing
نبدأ الان بارسال نشرتنا اليكم ونتمنى لكم التوفيق والعافية وشكرا .	نبدأ	0	Plur
توجه فريق خاص من صحفيى وكالة انباء شينخوا بعد ظهر اليوم الى احدى المستشفيات بغرب بكين خصصت لعلاج عرض الالتهاب الرئوى الحاد / سارس / .	خصصت	16	Sing
وبحسب الأرقام الرسمية الاميركية الصادرة اخيرا فان الولايات المتحدة تستهلك ما يعادل ربع إجمالي استهلاك العالم من النفط الخام ، وهذا الامر لن تطرأ عليه اية تغييرات جوهرية على مدى العقدين القادمين .	تستهلك	9	Sing
ويغيب عن المنتخب الالماني قائده اوليفر بيرهوف الذي لم يشف تماما من اصابة تعرض لها خلال بطولة اوروبا ، وكذلك لاعب وسط بايرن ميونيخ ينز يريميز الذي سيبتعد شهرين عن الملاعب لاصابة في اربطة الركبة .	يشف	9	Sing
فهل يستطيع شيراك اقناع بوش بضرورة التحرك وممارسة الضغوط المطلوبة ، لكي توافق اسرائيل على تطبيق توصيات لجنة ميتشل الأميركية ؟	توافق	12	Sing
وطالب تساو العاملين الطبيين هناك بان يلزموا مواقعهم وان يتشبثوا بالنضال ضد الوباء من اجل اتمام مهمتهم .	يتشبثوا	9	Plur
وعن العلاقات التي تربط بين كوريا الجنوبية والصين قال الوزير الكورى انها علاقات قوية وانها لا تقتصر على الجانب الدبلوماسي فحسب وإنما تشمل كافة المجالات الاقتصادية والثقافية وغيرها واصفا تلك العلاقات بأنها وطيدة .	تربط	3	Sing
وتقع هذه الحوادث امام انظار الناس الذين لا يستطيعون ان يفعلوا شيئا على الفور فى مواجهة قوات الاحتلال المدججة بالسلاح لكنهم بالتأكيد يضمرون الحقد لهؤلاء المحتلين الاجانب .	يضمرون	22	Plur
كما ابرزت الصحف وعلى صفحاتها الاولى ايضا نبأ غرق الغواصة التقليدية لاسطول جيش التحرير الشعبى بسبب خلل فنى وعلى متنها 70 ضابطا وجنديا لاقوا حتفهم .	لاقوا	23	Plur
واما المتهمة في هذه القضية فهي وكما اشرنا امرأة متزوجة ولها رضيع يبلغ من العمر حوالي شهرين وسبق لها ان ترددت كثيرا على السجون منذ كان عمرها 13 سنة .	ترددت	20	Sing
خبراء : ليبيا تدخر أفضل فرص الاستثمار في قطاع النفط للشركات الأميركية	تدخر	3	Sing
واخيرا اشارت الدراسة الى ان 41،5 % من النساء اللواتي يتعرضن للعنف الجسدي من قبل شريك حميم ، اصبن بجروح خلال تعرضهن للاعتداء الاخير مقابل 19،9 % للرجال .	اصبن	18	Plur
ويطلب قانون مراقبة المخابرات للاجانب لعام 1978 من مسؤولى تنفيذ القانون الحصول على تصريح من محكمة سرية باستخدام اجهزة التنصت لجمع المعلومات الاستخباراتية ، اذا استطاعوا اثبات ان المستهدف " عميل لسلطة اجنبية " او جماعة اجنبية .	استطاعوا	25	Plur
وأوضحوا أن هذه الإجراءات قد تؤدي لضغوط جديدة تدفع سوق الصرف المصرية لمواجهة أزمات دولارية جديدة .	تدفع	8	Sing
/ اضافة اولى واخيرة / أمستردام - - تقيم صالة كريستى للمزدات فى أمستردام مزادا تباع فيه عدد من اللوحات الفنية من بينها لوحة تمثل منظرا طبيعيا للرسام البريطانى ارثر ويلنجتون فولز نفذها بالالوان الزيتية .	تقيم	8	Sing
قال الرجل ، في تصريحاته المنشورة ، في مانشيتات عريضة بالصحف ، إننا نستورد نصف احتياجاتنا من الدقيق والفول والعدس واللحوم ، وكل احتياجاتنا من الشاي والبن .	نستورد	13	Plur
احرص ألا تسرف في إنفاقك للمال هذا الأسبوع .	احرص	0	Sing
مؤكداً أن منح البنوك لقروض جديدة لتمويل القطاع الصناعي لم يتوقف ، ولكن كل ما في الأمر أن معدلات الإقراض انخفضت ، نظراً لتراجع عدد المستثمرين في مجال التصنيع .	يتوقف	10	Sing
والاستمرار في الوضع الراهن الذي يراوح عملياً في مكانه منذ تشكيل مجلس الحكم يعني استنزافاً للأمريكيين بدأت معه أصوات كثيرة داخل الولايات المتحدة تعارض استمرار حرب غير واضحة الأفق .	تعارض	23	Sing
هذا إذا عاد إليها منفرداً ولا يضطر إلى تقاسمها مع حلفائه الحاليين الذين أظهرت تجربتهم في أفغانستان مهارتهم في تحويل بلد إلى مسلخة بشرية .	يضطر	6	Sing
وتابع التقرير : " إذا لم تتسلم السلطة ( بعهد الرئيس ) قيادة متمكنة فإن حماس ستكون الجهة السياسية الوحيدة التي ستكون لها سيطرة على المجتمع الفلسطيني " .	تتسلم	6	Sing
والله تعالى يقول " ومن يرد فيه بإلحاد بظلم نذقه من عذاب أليم " .	تعالى	1	Sing
واتهم الاتحاد الاوروبى بعدم الاهتمام الكافى بمخاوف تايلاند ، معربا عن امله بان فرنسا سوف تساعد الاتحاد الاوروبى فى معالجة الامور التى تقلق تايلاند كثيرا .	تقلق	22	Sing
وأشارت إحصائيات برلمانية حول موازنة البرلمان إلى أن البند الصحي والعلاجي لنواب البرلمان يحمّل موازنة البرلمان الخاصة نصف مليون جنيه مصري كل دورة برلمانية بخلاف بند الأدوية ومصاريف العيادة الطبية في البرلمان والتي تضم جميع التخصصات .	يحمّل	13	Sing
وناشد محمود شعيب شباب القاعة أن يفيئوا إلى رشدهم ـ وأن يعودوا إلى عقولهم ويراجعوا ضمائرهم ويكفوا عن ذلك ويضعوا السلاح ، فالسعودية بلد كل المسلمين وهي الملاذ الآمن لكل خائف والملجأ لكل لاجئ .	يعودوا	11	Plur
أما موقع صحيفة » واشنطن بوست « فبات عبارة عن خبر واحد بعنوان » طائرتان تصطدمان مركز التجارة العالمي وانفجار يلحق أضراراً بالبنتاغون « ، أرفقته بصور عمال انقاذ ينقلون جريحاً من المركز وغطى سواد الحريق وجوههم .	ينقلون	29	Plur
يشار إلى أن اقتصاد جنوب أفريقيا يتمتع بوجود قاعدة صناعية متقدمة وبنية تكنولوجية حديثة قادرة على المنافسة العالمية ، وهو ما انعكس على هيكل صادرات وواردات جنوب أفريقيا المتنوع بشكل كبير .	انعكس	21	Sing
كما استضافت هانوي مؤتمرا اسيويا للامم المتحدة حول فلسطين فى اذار / مارس الماضي .	استضافت	1	Sing
واعلنت هيئة المطارات الاسرائيلية في بيان ان اسرائيل اغلقت مساء امس مجالها الجوي لمدة 24 ساعة امام كل رحلات الشركات الاجنبية .	اغلقت	8	Sing
وطالب كانوك شركات الخطوط الجوية بتبنى اجراءات ملموسة لمواجهة المرض , داعيا اياها الى استخدام الموظفين الصحيين المحليين لمراقبة المسافرين الذين يشتبه فى ان لديهم اعراض مرض السارس قبل الصعود الى الطائرات وتوظيف اطباء للعمل على متن الرحلات .	يشتبه	21	Sing
وتحدثت صحيفة / الشعب اليومية / عن احتفالات المواطنين بعيد العمال العالمى فى بلديات بكين وشانغهاى وتيانجين وكذلك فى مدينة تشانغشا عاصمة مقاطعة هونان بوسط الصين وذلك بان زاروا الحدائق ومناطق مجاورة .	زاروا	28	Plur
وقالت المنظمات ، في تقارير رصدت الاسواق منذ 11 ايلول ( سبتمبر ) الماضي وحتى الآن ، ان الاوضاع في البلاد سيئة وقد تصل الى أزمة إذا لم تتخذ الحكومة اجراءات عملية للحد من تداعيات الأزمة على قطاعات معينة .	رصدت	5	Sing
وقال احد المتحدثين باسم البيت الابيض بي جي كراولي " اعتقد باننا سنسعى الى تكثيف هذه المحادثات فيما نصل الى اليوم السادس من القمة " .	نصل	18	Plur
كما ناشد أردوغان رفع العقوبات الدولية على " جمهورية شمال قبرص التركية " التى لم تعترف بها سوى أنقرة وحدها .	ناشد	1	Sing
وقد بعثت الشركة برسائل الى اللجنة الاتحادية للاتصالات التي تتولى شؤون المنافسة في القطاع التلفزيوني وطرحت احتمال " ضرورة التنازل عن موجودات " في بيانها .	بعثت	1	Sing
ولا تقيم اندونيسيا علاقات دبلوماسية مع اسرائيل . ويبدو ان التكتم الذي احاط بزيارة بيريز الى اندونيسيا كان يهدف الى تفادي اثارة ردود فعل معادية في البلاد .	تقيم	1	Sing
تنتهى نشرتنا اليوم 2 مايو 2003 وكالة انباء الصين الجديدة / شينخوا /	تنتهى	0	Sing
ولم يصدر عن القوات الامريكية اي تعليق عن هذه المصادمات التي قالت المصادر الطبية انها حدثت في احياء مدينة الصدر ، التي كانت بالسابق مسرحا للمصادمات بين القوات الامريكية ومسلحين عراقيين .	يصدر	1	Sing
ومن جانبها حرصت كاواجوتشي على أن تشير إلى أن العلاقات الثنائية بين مصر واليابان " دخلت في منعطف جديد عقب اللقاء الذي جمع الرئيس مبارك برئيس وزراء اليابان جونيشيور كويزومي بالقاهرة في يونيو الماضي " .	دخلت	15	Sing
وقد غرقت الغواصة " كورسك " السبت نتيجة انفجار على ما يبدو . ويقول الاميرال كوروييدوف ان " انفجارا في مقصورة الطوربيدات الاولى " اصاب الغواصة باضرار وادى الى غرقها الى القاع .	غرقت	1	Sing
واتجهت الأفئدة لله سبحانه وتعالى ترجو لرب العائلة . .	ترجو	5	Sing
واضاف البيان ان " بعضا من مرافقيه فروا فيما بعد الى الجرود المجاورة ولا تزال قوى الجيش تقوم بتطويق المنطقة وملاحقة الفارين " .	فروا	7	Plur
وواجهت رايس تحفظات وأسئلة كثيرة من نظرائها الأوروبيين الذين نبهوا إلى الاختلافات بين البلدان المعنية ، كما تساءل بعضهم عن " نتائج عكسية " قد تؤدي هذه المبادرة إليها .	نبهوا	9	Plur
لجنة الصناعة توافق على قرض ياباني لتوليد الكهرباء	توافق	2	Sing
غير أن هويدي لاحظ أن مؤتمر الوطني " قدم جمال مبارك بطريقة شرعية باعتباره الرجل الذي يتبنى فكر الإصلاح " .	يتبنى	16	Sing
وقال أعضاء لجنة التصدير بجمعية رجال الأعمال إن الاتحاد الأوروبي سيفرض شروط " اليورو جاب " على الحاصلات الزراعية القادمة من مصر والتي تشترط جودة مرتفعة في المنتجات .	تشترط	23	Sing
1998 - الاسد في باريس للمرة الاولى منذ 22 عاما والزيارة استغرقت ثلاثة ايام . وفي اليوم ذاته ، زارت بارجتان بريطانيتان لاول مرة منذ 48 عاما ، مرفأ اللاذقية السوري .	زارت	19	Sing
وقد هدد شباب ايجو بتعطيل انتخابات 3 مايو التشريعية وانتخابات الحكومة المحلية فى 21 يونيو .	هدد	1	Sing
وأعرب أعضاء هيئة التدريس عن استيائهم من ذلك وقاموا بتوجيه خطاب لرئيس الجامعة أكدوا فيه أن مباني الجامعة تضيق بالأنشطة العملية والتعليمية وطالبوا بتفسير لذلك إلا أن رئيس الجامعة تجاهل هذا الخطاب ولم يقدم تبريراً في هذا الشأن .	أكدوا	13	Plur
ويعد هذا احد القضايا التى نوقشت فى اجتماع بين وفد برازيلى برئاسة وزير الخارجية سيلسو اموريم ووفد موزمبيقى برئاسة نظيره ليوناردو سيماو .	نوقشت	5	Sing
أعلن مستشفى اتحاد كليات الطب في بكين أمس السبت أن المرضى الستة من الاجانب المصابين بوباء الالتهاب الرئوى الحاد / سارس / قد غادروا المستشفى بعدما تماثلوا للشفاء .	غادروا	23	Plur
واضاف : » ان عمليات الاصلاح المنفذة حتى الآن أثمرت حدوث زيادة بنسبة 14 في المئة في مبيعات الشركات التي يتم إصلاحها « .	أثمرت	9	Sing
طهران ، لندن - » الحياة « ، رويتــــرز - اكـــدت صحيفة ايرانية ان انفجاراً في خط انابيب للـنـــفط في جـــنوب غـــربي ايران أوقع قتيلاً و 41 جريحاً .	أوقع	23	Sing
الناشرون الاميركيون يجرون تجارب على كتاب المستقبل على الانترنت	يجرون	2	Plur
طالبت بتعويض قدره 75 مليون دولار . رد دعوى شركتين المانيتين ضد مجلس الانماء والإعمار اللبناني	طالبت	0	Sing
وأعلن شيخ الأزهر عن ترحيبه بالاستعانة بالقوات الأجنبية طالما أنها خلصت الشعب العراقي من صدام حسين أو حررت الكويت .	خلصت	10	Sing
وفي مقابلة نشرت في 26 تموز / يوليو الماضي ، اعلن نائب الرئيس العراقي طه ياسين رمضان ان بلاده تعتزم اعادة النظر في تطبيق الاتفاق الذي شكك في فائدته .	شكك	26	Sing
ولعل ذلك يفسر الهدوء الذي صاحب الإعلان عن إطلاق زعيم " الجماعة الإسلامية " في مقابل الضجة التي صاحبت مؤتمر الحزب الحاكم وتوجيهات الرئيس .	صاحبت	18	Sing
وأضافت أن التعاون الثنائي بين البلدين يتضمن اتجاهات متعددة ، مثل مشروع توليد الطاقة النظيفة عن طريق الرياح ومحطات توليد الكهرباء بالإسكندرية ، وزيادة كفاءة محطة مياه الشرب بالجيزة .	يتضمن	6	Sing
وبعدما لفت التقرير إلى مقدمة الكتاب وقعها سرحان نفسه لاحظ أن في الكتاب " تمجيداً للذة الجسدية . .	لاحظ	9	Sing
وقال وزير النقل الايطالى بيترو ليوناردى ان الحكومة تتوقع ان يعزز بونومى دور مطار مالبينسا بميلانو فى مجال استراتيجيات شركة " اليتاليا " للتطوير .	يعزز	10	Sing
قد يتسبب هذا في مشاكل واضطرابات منزلية .	يتسبب	1	Sing
كما يتضمن برنامج التعاون بين كورسيكا ومدنين دعم التبادل فى مجالات البحث العلمى والصحى والبيئى وانشاء مشاريع مشتركة وتعريف المستثمرين من كورسيكا بما هو متاح من الانشطة الاقتصادية من امتيازات وفرص للاستثمار وتبادل الوفود الشبابية وغيرها .	يتضمن	1	Sing
خطط لقضاء وقت أطول مع من تحب .	تحب	6	Sing
وذكرت السفارة النرويجية انها تلقت اخطارا من النمور " بأن السيد انطون بالاسينجام يعانى من مشكلة صحية عقب العملية ، وانه بحاجة الى علاج ومتابعة من جانب الاطباء المقيمين فى لندن .	يعانى	13	Sing
واستنكرت » الجماعة « في بيان الحملة واستغربت اعتقال المتهمين » في ظل ما يعيشه العالم من أحداث جسام « ، واعتبرت أن ما حدث » لا يخدم احداً بل يصب في خانة الممارسات غير العادلة « .	يصب	30	Sing
أفاد الراديو النيجيرى المحلى اليوم أن سبعة أشخاص ، من بينهم ثلاثة من أفراد الشرطة ، قتلوا على يد عصابة من اللصوص المسلحين على طريق انكا - جومى السريع بولاية زامفارا شمال غرب نيجيريا .	قتلوا	16	Plur
وشدد شارون على ان " القدس مقدسة بالنسبة لليهود اكثر منها للمسيحيين والمسلمين لاننا لم نعرف عاصمة اخرى او مدينة مقدسة اخرى " .	نعرف	15	Plur
يذكر أن تونس تهتم بانتاج الخيول العربية الى جانب الخيول البربرية وتركزت الجهود خلال الفترة الماضية لتحسين السلالات الى جانب عمل سجل لانساب الخيول فى تونس .	تهتم	3	Sing
انشئت » وكالة الاستخبارات المركزية « ( سي آي أيه ) العام 1947 في عهد الرئيس هاري ترومان . وعهد الى رئيس الوكالة مهمة التنسيق بين مختلف الوكالات الأمنية وتحليل المعلومات وتقويم الأوضاع المؤثرة على الأمن القومي .	انشئت	0	Sing
" الإخوان " يسعون إلى مواجهة خطة محاصرتهم وقطع علاقاتهم بالأحزاب بالأحزاب	يسعون	3	Plur
وهم يبيعون الدولار لتوفير احتياجاتهم الأساسية ، أما بالنسبة لعمليات المضاربة فهي منخفضة جدا الآن بسبب حالة الترقب كما ذكرت لأنهم لا يتوقعون رد فعل البنك المركزي على أي عملية للمضاربة لصالح الدولار على حساب الجنيه المصري .	يبيعون	1	Plur
كما يقيم هذا البحث الشامل الاستقرار السياسي والمشاكل الداخلية خصوصا تلك المتعلقة بالتزايد الديمغرافي والتنمية الاقتصادية .	يقيم	1	Sing
علماء في الأزهر يقولون إن طنطاوي يتحدث باسمه الشخصي	يقولون	3	Plur
قام العاهل الأردنى فور عودته من لندن مساء اليوم بزيارة الى المدينة الطبية حيث اطمأن على حالة الجرحى الثلاثة الذين أصيبوا فى الانفجار .	اطمأن	14	Sing
يذكر ان لوثار ماتيوس حامل الرقم القياسي العالمي في عدد المباريات الدولية ( 150 مباراة ) اعتزل اثر نهائيات اوروبا وكذلك الامر بالنسبة الى اولف كيرستن .	اعتزل	16	Sing
وكانت الطائرتان قد زارتا مجموعة من المدن التركية من بينها قونية واضنة وغيرها ومن ثم المدن السورية حلب وحمص وثم بيروت ودمشق واستكلمت الطائرة الناجية رحلتها الى القدس ويافا حيث انفجرت الطائرة الثانية .	انفجرت	30	Sing
لا تغضب ولكن حاول أن تتوخى حذرك جيداً .	تتوخى	5	Sing
مشكلتنا في لبنان ( الى سوء البنية الفوقية الزمني ) ان الحسد ينهش غير الواصلين ، فيرمون الواصلين برياح الحقد والاشاعات والتهم ، كي يسقطوا عنهم الهالة ، ولو انهم هم ، لن يستطيعوا بلوغ نعمة الهالة .	يسقطوا	24	Plur
فكم جفّت عفون فيك يا لبنان ؟ وخلدت روح الايمان ! " الروح يحيي والحرف يميت " ( السيد المسيح ) .	جفّت	1	Sing
واشنطن 16 - 7 ( اف ب ) - افادت دراسة نشرها امس السبت المعهد الوطني للعدالة ان العنف المنزلي في الولايات المتحدة يطال ربع النساء تقريبا خلال حياتهم .	افادت	9	Sing
القاهرة - - سقط يوم الاربعاء القمر الصناعى الايطالى ـ الهولندى / بيبوساكس / الذى كان يقوم باعمال الرصد والمراقبة الفضائية فى مياه المحيط الهادى دون احداث اية خسائر .	سقط	3	Sing
وأوضح المسكري ان المدرب الجديد يملك كامل الصلاحيات في اختيار التشكيلة التي تناسبه ، وان الاتحاد يتحمل أيضاً جزءاً من مسؤولية الخسارة الكبيرة « .	يتحمل	16	Sing
اسرائيل تربط الهجمات بـ » الارهاب الاسلامي « و وتغلق مجالها الجوي 24 ساعة	تربط	1	Sing
لا تكثر من الإنفاق على الأصدقاء والأسرة .	تكثر	1	Sing
رام الله ( وكالات الانباء ) قال نواب فلسطينيون ان النواب الغاضبين من فشل القيادة الفلسطينية في تنفيذ اصلاحات يعتزمون الترتيب لاجراء اقتراع لحجب الثقة قد يتمخض عن اسقاط الحكومة التي عينها الرئيس الفلسطيني ياسر عرفات .	يعتزمون	19	Plur
قالت المحامية " نهاد أبو القمصان " مديرة المركز إن مجلس الكنائس طلب تنظيم الدورة للسيدات القبطيات لتوعيتهن بقانون الأحوال الشخصية الذي يتيح لهؤلاء السيدات حق الخلع ، لكن الكنيسة ترفض الاعتراف .	ترفض	30	Sing
والمعلوم ان باراك فقد الغالبية داخل الكنيست بعد استقالة سبعة من وزرائه وانسحاب اربعة احزاب من الائتلاف الحكومي الذي يتراسه .	فقد	3	Sing
وقد وصل العدد التراكمى للمرضى الذين أدخلوا المستشفيات العامة بسبب الإصابة بالمرض منذ 12 مارس إلى 1621 مريضا .	أدخلوا	6	Plur
علم من الخبراء ان هذا النفق هو اول نفق بنى عبر / / اسلوب الانبوب الغارق / / الذى استخدمته شانغهاى لاول مرة فى تاريخ بناء الانفاق كما يعد الثانى فى آسيا والثالث فى العالم بهذا الاسلوب .	بنى	9	Sing
وجاء في البيان ان " القمة اعادت التأكيد على دعمها لاتفاق وقف اطلاق النار على انه الاساس الوحيد الذي يمكن ان يسمح بحل النزاع في الكونغو لكنها اسفت في الوقت نفسه لاستمرار انتهاكات وقف اطلاق النار " .	اعادت	6	Sing
استقبل ولي عهد دولة الامارات العربية المتحدة الشيخ خليفة بن زايد آل نهيان في قصر البطين امس وزير الثقافة اللبناني غسان سلامة في حضور وزير الثقافة والاعلام الاماراتي الشيخ عبدالله بن زايد وسفير لبنان في الامارات حسن برو .	استقبل	0	Sing
وبناء على هذه المعلومات تحول اعوان مركز الحرس الوطني بنابل على عين المكان وسيطروا على الوضع قبل ان ينجحوا في ايقاف بعض المشبوه بعلاقتهم فيما حدث بناء على معطيات قدمها اقارب المظنون فيه الاول .	ينجحوا	18	Plur
وأكدت على ان الاجراءات الفعالة للسيطرة على المرض من شأنها ان تقلل الى حد كبير من خطر العدوى , مع انها اعترفت بانه " ليس هناك ما يعرف بعدم وجود خطر على الاطلاق " فى مجال الصحة .	يعرف	27	Sing
وأضاف أن عدداً كبيراً من أصحاب الشركات تحول إلى العمل في مجالات أخرى مثل تجارة السيارات والتصدير والاستيراد تمهيدا للتقدم بطلبات إلغاء التراخيص مشيرا إلى أنه يبحث حاليا عن نشاط اقتصادي بديل .	تحول	7	Sing
وقال احد اولئك اللبنانيين للصحافيين الذين احتشدوا على الجانب اللبناني من الحدود " لقد اتينا لنطلب من العذراء التي يصادف عيدها اليوم ان تخفف من الامنا " .	احتشدوا	6	Plur
قال إنه يستكمل حرب الاستقلال .	يستكمل	2	Sing
وقال المتحدث الهندى ان سينها اتصل بنظيره الفرنسى دومنيك دى فيليبان .	اتصل	5	Sing
كما لا يجوز اعتبار الضريح والمقابر حوله ضمن رفات السلالات البشرية . .	يجوز	2	Sing
ولاحظ المساعد السابق لوزير الخارجية الدكتور عبد الله الأشعل أن حملة تتبناها دوائر إسرائيلية مفادها أن مواقف مصر في قضيتي العراق وفلسطين تلبي رغبات الأمريكية ، في مقابل تأمين موافقة البيت الأبيض على تولي جمال مبارك الحكم في المستقبل .	تلبي	22	Sing
ولم يتوصل رئيس الوزراء الاسرائيلي ايهود باراك ورئيس السلطة الفلسطينية ياسر عرفات الى اتفاق في كامب ديفيد لأن المفاوضات تعثرت حول وضع القدس .	تعثرت	19	Sing
اتفاق أمني يطوي مرحلة بروتوكول أضنه . سورية وتركيا تتبادلان تعهداً بـ » تدابير فعالة لمكافحة الارهاب «	يطوي	2	Sing
لكن السلطات المصرية أبدت تريثاً تجاه الطلب الإيراني باستئناف العلاقات الدبلوماسية فقد قال وزير الخارجية المصري أحمد ماهر إنه " لم يتم بعد اتخاذ قرار بإعادة " العلاقات الدبلوماسية مع إيران .	أبدت	3	Sing
واضاف " العالم يعرف من هو المنزعج من وقف اطلاق النار في كشمير ومن هو الذي يضع العراقيل " .	يعرف	3	Sing
ومن أبرز من أفتوا بتكفير البهائيين شيخ الأزهر السابق الدكتور جاد الحق علي جاد الحق .	أفتوا	3	Plur
لحود للارسن : اسرائيل حولت السلام الى خطط أمنية	حولت	4	Sing
تجدر الاشارة الى ان العراق دولة ذات اغلبية شيعية ، حيث يمثل المسلمون الشيعة فيها 65 فى المائة من اجمالى عدد السكان البالغ 24 مليون نسمة .	تجدر	0	Sing
جاء ذلك في كلمتها في الجلسة الافتتاحية لمؤتمر " آفاق التنمية ومستقبل الاستثمار العربي المشترك " الذي يشارك فيه 13 وزيراً ووفوداً من 14 دولة عربية وتنظمه جمعية سيدات الأعمال للتنمية برئاسة هدى يسي بالاشتراك مع الهيئة العامة للاستثمار .	يشارك	17	Sing
رفضت شركات المقاولات تحديد أسعار الشقق نتيجة الارتفاع المستمر في سعر الحديد والأسمنت ووضعت بنوداً جديدة في العقود تنص على جواز زيادة أسعار الوحدات السكنية وفقاً لمتغيرات التكلفة .	رفضت	0	Sing
ضرب النائب أيمن نور رقماً قياسياً في عدد الاستجوابات التي تقدم بها حيث تقدم بتسعة استجوابات لرئيس الوزراء ووزراء التموين والتخطيط والتنمية الإدارية والبترول والتأمينات والكهرباء والمالية والتجارة الخارجية .	ضرب	0	Sing
واشار مفاوض تابع للامم المتحدة الى ان كابيلا لا زال يرفض انتشار قوات الامم المتحدة على المناطق التي تسيطر عليها قواته بل يريدها ان تنتشر فقط في معاقل المتمردين .	تنتشر	24	Sing
وانتقد الاسد بشدة السبت جنبلاط بدون ان يسميه مؤكدا ان سوريا تدخلت عام 1976 في بداية الحرب اللبنانية لانقاذ المسيحيين من " المجازر " التي كانوا يتعرضون لها " باسم الاشتراكية والعدالة واصلاح النظام السياسي " .	تدخلت	11	Sing
اعتقلت وكالات تنفيذ القانون الباكستانية ستة ارهابيين يشتبه فى علاقتهم بشبكة القاعدة فى كراتشى يوم الاربعاء .	يشتبه	7	Sing
وكان لافتاً أن شيخ الأزهر أصر أن يكون حديثه أمام وكالات الأنباء العالمية حتى ينقلوا رأيه من دون أي مزايدات أو مغالطات ، وذلك بعدما عقد جلسة مع ساركوزي اقتصرت عليهما .	اقتصرت	29	Sing
لا يمكنك أن تترك شريك حياتك في مكان وتغلق الباب عليه فإذا قيدت حريته فإنه سيهجرك إلى الأبد .	تترك	3	Sing
وقد قصف مساء اول امس مبنى اخر في ضواحي الفلوجة يزعم الجيش الامريكي انه يؤوي ما بين 15 و 20 مقاتلا سبق وان اكد انهم كانوا يجرون تدريبات ذات طابع عسكري فيه .	يجرون	26	Plur
بيروت 15 - 8 ( اف ب ) - طلب لبنان من قوة الطوارىء الدولية العاملة في الجنوب التاكد من معلومات تشير الى انتهاكات اسرائيلية على الحدود المشتركة بين البلدين ومنع حصولها .	تشير	21	Sing
بعث الرئيس الصينى والسكرتير العام للجنة المركزية للحزب الشيوعى الصينى هو جين تاو برسائل تعازى اليوم الى اسر بحارة البحرية الذين لقوا مصرعهم فى حادث غواصة وقع امس الجمعة .	وقع	26	Sing
انتقدت مصادر أصولية في مصر استبعاد الإسلاميين من الحوار الوطني الذي يجريه الحزب الوطني الحاكم في مصر مع أحزاب المعارضة باعتبار أن ذلك يمثل استبعاداً للقوى المعارضة الرئيسية في المجتمع داخل الشارع السياسي والجماهيري في مصر .	انتقدت	0	Sing
وبحسب الأرقام الرسمية الاميركية الصادرة اخيرا فان الولايات المتحدة تستهلك ما يعادل ربع إجمالي استهلاك العالم من النفط الخام ، وهذا الامر لن تطرأ عليه اية تغييرات جوهرية على مدى العقدين القادمين .	تطرأ	23	Sing
وبدا وبكثير من الرمزية التي يفهمها اللبنانيون ، كمن يقود سيارة اسعاف تحمل جريحا نازفا هو الوضع المالي ، وتحاول الوصول الى المستشفى لانقاذه ، ولكنها تركض وسط طرقات وساحات لا يتوقف فيها القصف والقنص والكمائن كما كان يحصل !	تركض	26	Sing
ومنذ تلك المحادثة ، يحاول المسؤولون في السفارة الإسرائيلية في أنقرة ، فحص مصدر قلق الحكومة التركية ، لكنهم لم ينجحوا بتلقي أجوبة واضحة .	ينجحوا	20	Plur
» طالبان « تدين و تنفي مسؤولية ابن لادن	تنفي	5	Sing
حاول أن تقنع صديق مقرب لك أن يطلب إجازة ويقضيها معك .	تقنع	2	Sing
هز زلزال عنيف المنطقة الجبلية الواقعة جنوب شرقى تركيا فى وقت مبكر من اليوم / الخميس / , دون ان ترد تقارير فورية عن الخسائر فى الارواح والممتلكات .	هز	0	Sing
أراد رئيس الوزراء ، أن يقول للمصريين ، استمتعوا بالسيئ . .	استمتعوا	8	Plur
وتوقع القرنشاوي أن يصل إجمالي التدفقات الأجنبية للبنوك المصرية بنهاية العام الحالي إلى 6.2 مليار دولار ، غير أن هذه القيمة لن توازي الطلب وستظل هناك فجوة .	توازي	22	Sing
وعلى رغم أن الطلب لم يبت ، إلا أن الخيار لم يستبعد علماً أن الحكومة لا ترغب في اللجوء إليه .	ترغب	16	Sing
وقال الدكتور رولاند غريفيث الذي يقود فريق البحث ان منتجي المياه الغازية " يضيفون اليها مخدرا يسبب ادمانا طفيفا ويؤثر على الحالة المزاجية مما يفسر بالتاكيد زيادة الاقبال على المشروبات الغازية التي تحتوي على الكافيين " .	يفسر	24	Sing
الجمارك البلغارية تضبط نحو 40 كيلوغراما من الهيرويين	تضبط	2	Sing
يوم مناسب لكي تهتم باستثماراتك .	تهتم	3	Sing
هز زلزال عنيف المنطقة الجبلية الواقعة جنوب شرقى تركيا فى وقت مبكر من اليوم / الخميس / , دون ان ترد تقارير فورية عن الخسائر فى الارواح والممتلكات .	ترد	20	Sing
وهو ما ساهم بدوره في زيادة " قصقصة " الجنيه وتراجع قوته الشرائية لترتفع الأسعار بشكل لا مثيل له .	ساهم	2	Sing
بيد انه لم يتضح بعد ما اذا كانت عودة الدبلوماسيين ستتطلب تفويضا مسبقا من الامم المتحدة يعترف بالادارة المؤقتة فى العراق .	يعترف	16	Sing
وقالت وكالة الانباء العراقية نقلا عن الوزير ان " الحصار الجائر المفروض على العراق منذ عشر سنوات ألحق بالعراق خسائر تزيد على 140 مليار دولار " .	تزيد	20	Sing
فالحوار الجاري ليس فيه ما يدعو للتفاؤل ، والمشاركون قد لا يجدون ما يقولونه سوى الدعوة إلى وحدة الصف والمطالبة بانسحاب قوات الاحتلال بلا أجندة عمل حقيقية .	يجدون	11	Plur
وقال قصير انه " يمكن للعلماء المسلمين ان يوقعوا البيان وان اغفال موضوع الوجود السوري ليس من موقع عدم التطرق الى قضية خلافية بل من اجل التوصل الى نتائج ايجابية " .	يوقعوا	8	Plur
وقال مسؤول في البنتاغون رفض الكشف عن هويته ان موسكو لم تقدم بعد طلبا رسميا بالمساعدة ، ولكنها تستطلع راي الدول الاعضاء في الحلف عن المساعدة التي يمكن ان تقدمها لها في حال طلب منها ذلك .	تستطلع	18	Sing
ابحث عن الأمور التي تجد من خلالها نوع من المتعة وقم أيضاً ببعض الأشياء المتوافقة التي يرغب كلاكما في القيام بها .	ابحث	0	Sing
وكانت صحيفة " معاريف " الاسرائيلية افادت امس ان ضباطا كبارا من الجيش الاسرائيلي يتساءلون حول جدوى مواصلة العملية الجارية في قطاع غزة ويعتبرون انه " آن الاوان لوقفها " من اجل تجنب مواجهة " تعقيدات " .	يتساءلون	14	Plur
بعث الرئيس الصينى والسكرتير العام للجنة المركزية للحزب الشيوعى الصينى هو جين تاو برسائل تعازى اليوم الى اسر بحارة البحرية الذين لقوا مصرعهم فى حادث غواصة وقع امس الجمعة .	بعث	0	Sing
المحافظون المعارضون يحلون محل العمال كأكبر حزب فى المجالس البلدية البريطانية	يحلون	2	Plur
وقبل ذلك أعلن متحدث أمريكي مقتل ثلاثة جنود أمريكيين ومترجم وإصابة جندي آخر بجروح في هجوم استهدف دورية بمدينة القائم على الحدود السورية .	استهدف	16	Sing
واشار الصندوق الى انه قرر اعتبارا من هذا العام ان ينشر في حساباته السنوية المبلغ الاجمالي لرواتب المسؤولين فيه في اطار اعتماد المزيد من الشفافية .	ينشر	10	Sing
وقال الدكتور رولاند غريفيث الذي يقود فريق البحث ان منتجي المياه الغازية " يضيفون اليها مخدرا يسبب ادمانا طفيفا ويؤثر على الحالة المزاجية مما يفسر بالتاكيد زيادة الاقبال على المشروبات الغازية التي تحتوي على الكافيين " .	يسبب	16	Sing
وقال ان السودان اعطى فترة سماح حتى 2005 لتطبيق الرسوم والضرائب ذات الاثر المباشر بنسبة 20 فى المائة حتى يصل الى التعريفة الصفرية بحلول 2010 .	اعطى	3	Sing
- اعتقل جنود اسرائيليون متسلّلَيْن حاولا دخول اسرائيل قرب معبر اريتز في غزة وأحيلا على التحقيق .	اعتقل	1	Sing
واكد افينتاخادو انه سيتوجه الى جزيرة خولو في الساعات المقبلة يرافقه الوسيط الليبي رجب الزروق للتأكد من الافراج عن " جميع " الرهائن الغربيين المحتجزين بمن فيهم الصحافيون الفرنسيون الثلاثة الذين اسروا الشهر الماضي بينما كانوا يقومون بتغطية الازمة .	يقومون	36	Plur
بالمقابل ارتفعت في المناطق المسيحية لافتات ترحيب بالقرار 1559 وقد كتبت عليها عبارة " حرية سيادة استقلال " وهو الشعار الذي يردده انصار العماد ميشال عون المعارض لسوريا والمقيم في منفاه في فرنسا .	كتبت	10	Sing
شعب مصر الذي يتزايد بطريقة غير مسبوقة ، لابد أن تتزايد مع مواليده الظواهر الغريبة والمتباينة ، وأهمها ظاهرة " التوائم " التي تكاد تصبح ظاهرة مصرية خالصة .	يتزايد	3	Sing
مع إطاحة نظام صدام حسين التقت على أرض الشرق الأوسط كل الحروب وكل المخاوف .	التقت	5	Sing
نيجيريا / انفجار / حريق - لقي 18 شخصا مصرعهم عند انفجار انبوب نفط في جنوب شرق نيجيريا السبت بينما كانوا يشفطون النفط منه بطريقة غير قانونية .	يشفطون	21	Plur
علم ان هذه الحجرة مصممة طبقا لنظرية الضغط السالب وبمقدورها ان تتجنب العدوى المتبادلة بين مرضى السارس والطبيين .	علم	0	Sing
ويرى بعض المحللين أن الولايات المتحدة أصبحت ترى أن الاعتماد على ما يسمى " الدول الكبرى إقليميا " كي تكون الحارس الذي يؤدي ويدافع عن مصالح الولايات المتحدة السياسية من المحيط إلى الخليج ، هي تجربة فاشلة .	ترى	7	Sing
وأوضح المصدر أن الصنف الذي تصدره مصر إلى أمريكا يتحمل جمارك تصل إلى 30 % بينما نفس الصنف الذي تصدره الأردن طبقا " للكويز " لا يخضع للجمارك " .	يتحمل	9	Sing
واضاف ان العمال الذين اصيبوا بالسارس يجب ان يعالجوا بالمجان فى مواقع عملهم .	يعالجوا	8	Plur
ونقلت وكالة انترفاكس للانباء عن المصدر نفسه انه وجدت آثار متفجرات على ايدي القوقازي الذي اعتقل في موسكو ، ويجري فحصها في المختبر .	وجدت	8	Sing
وأوضح الصندوق ان هذا القرض يندرج في اطار تسهيلات اعتمادية مدتها ثلاث سنوات وقيمتها الاجمالية خمسة بلايين دولار . وأشار الصندوق الى ان » هذا القرض مخصص لدعم برنامج الحكومة الاندونيسية الرامي الى استقرار الاقتصاد وتعزيز الاصلاحات « .	يندرج	5	Sing
وقال " انه اذا توافرت الارادة والوحدة الوطنية العراقية فسوف نتمكن من استثمار الموقف الامريكى لمصلحة العراق والمهم ان نعمل كعراقيين على وحدة البلاد وان نبادر للحصول على الدعم من امريكا وبريطانيا واوروبا والدول العربية والاسلامية " .	توافرت	4	Sing
غير ان بعض هذه الحوادث كانت بسبب سوء تصرف الامريكيين ومثال على ذلك ما حدث اليوم الجمعة عندما اطلق الجنود الامريكيون النار على مواطن عراقى فقتلوه فى سيارته لانه لم يبعد سيارته عن طريقهم .	اطلق	18	Sing
تم عقد الاجتماع بناء على طلب من الولايات المتحدة التى رعت مشروع القرار بالاشتراك مع بريطانيا واسبانيا ، اشد انصار الحرب التى قادتها الولايات المتحدة ضد العراق .	رعت	10	Sing
واشار صندوق النقد الدولي الى ان راتب كوهلر الذي كان يرئس المصرف الاوروبي للتنمية واعادة الاعمار يتألف من 308 الاف دولار كراتب اساسي و 55 الفا على هيئة مخصصات وعلاوات .	يرئس	10	Sing
أكد وزير قطاع الاعمال العام المصري مختار خطاب أن الوزارة تلقت عروضاً جادة لشراء عدد من الشركات المطروحة للبيع في إطار برنامج التخصيص .	تلقت	10	Sing
وقد عين رضا خاتمي مديرا لمكتب الدراسات والابحاث في المجلس وفق ما جاء فى الصحافة اليوم الثلاثاء .	عين	1	Plur
ووصف الضجة التي اثيرت حول امكان سحب الاتحاد الاسيوي البطولة من لبنان بانها " كانت ايجابية لانها احدثت صدمة وجعلت المسؤولين يدركون خطورة الوضع ويتحملون المسؤولية " .	يدركون	21	Plur
واوضحت تلك المصادر أن افراد الشرطة القتلى تعرضوا لكمين عندما كانوا يستقلون حافلة ركاب صغيرة في المنطقة ، التي تبعد نحو 35 كيلومترا إلى الجنوب من العاصمة العراقية .	تبعد	19	Sing
واصبح مطلوبا الحصول على النفط من هذه المنطقة ، خصوصا إذربيجان وكازاخستان اللتين تملكان فيما بينهما احتياطا نفطيا يفوق ثلاثة اضعاف احتياطي النفط الاميركي .	يفوق	18	Sing
ساعد قريباً أو صديقاً مقرباً لك في إعداد ميزانية له .	ساعد	0	Sing
عشرون لبنانيا فروا الى اسرائيل اتوا للصلاة على الحدود	فروا	2	Plur
وحتى الان وقعت الولايات المتحدة اتفاقات تجارة حرة مع اسرائيل والاردن ، ومن المتوقع ان تتوصل الى اتفاق تجارة مع المغرب بنهاية العام الحالى .	تتوصل	15	Sing
واشار الى ان الاكراد شددوا الحراسة على خط انبوب النفط الذي يعبر مناطقهم واتخذوا احتياطات عسكرية لأن المسألة » مسألة حياة او موت وسنقاوم اي تدخل عسكري لأي غرض كان « .	شددوا	4	Plur
نتنياهو : سورية أضحت قرية صغيرة في العالم ومكانة إسرائيل تعززت	تعززت	10	Sing
القاهرة - » الحياة « - توقع وزير الدولة المصري للتخطيط احمد الدرش ان تتراجع المعونات الخارجية والمساعدات الى البلاد .	توقع	6	Sing
من جهة اخرى ، رفضت السلطات الروسية كل عروض المساعدة الخارجية ، الاميركية والبريطانية ، التي تهدف الى انقاذ الغواصة التي تحمل 24 صاروخا تسياريا غير مجهزة برؤوس نووية على حد تعبير البحرية الروسية .	تهدف	16	Sing
الخطوط الجوية البريطانية تعلن تعليق رحلات كونكورد	تعلن	3	Sing
باعتبار الأب ـ كما أشرت ـ الركيزة الأساسية لهذا البناء الاجتماعي " المتكامل .	أشرت	4	Sing
وقال احد المسئولين العسكريين اشترط عدم ذكر اسمه انه يبدو ان الطائرة اصطدمت بخطوط الكهرباء قبل ان تسقط فى نهر دجلة بالقرب من مدينة سامراء العراقية .	اشترط	4	Sing
وهاجم بيومي من يشككون في نزاهة علماء الأزهر وحيادهم لدرجة اتهامهم بأنهم يشبهون محاكم التفتيش ، مؤكدا أن من حق المتضررين أن يلجأوا إلى القضاء " إذا شعروا أن هناك أي ظلم أو مصادرة للفكر " .	يلجأوا	22	Plur
استعد لدخول دائرة الضوء إذا كنت ترغب في تنمية طموحاتك .	ترغب	6	Sing
تنص المذكرة على تكوين لجنة تجتمع مرتين سنوياً لمتابعة أنشطة التعاون المشترك .	تنص	0	Sing
كما تقرر قيام كل من الاتحاد العام لغرف التجارة والصناعة واتحاد المستثمرين العرب ترتيب زيارات للقطاع الخاص العربي لزيارة المواقع المختلفة المراد الاستثمار فيها في جنوب السودان وذلك بالتعاون مع اتحاد أصحاب العمل السوداني والغرف السودانية .	تقرر	1	Sing
فى العام الماضى اعلنت تويوتا انها تنوى حيازة عشرة بالمائة من سوق السيارات بالصين بحلول العام 2010 .	تنوى	6	Sing
مبارك ينفي تعرض القاهرة لضغوط أمريكية : نحن من يتمتع بالديموقراطية في هذه المنطقة	يتمتع	9	Sing
اعلنت وزيرة الخارجية الكولومبية كارولينا باركو يوم الجمعة ان بلادها قد طالبت الولايات المتحدة بتقديم المزيد من المساعدات فى حملة مكافحة المخدرات .	طالبت	11	Sing
يذكر ان بيرسول البالغ من العمر 17 عاما هو اصغر سباح اميركي نزل تحت حاجز الدقيقتين في سباق 200 م ظهرا وذلك عندما كان في الخامسة عشرة .	نزل	12	Sing
وأضافوا أن ارتفاع أسعار الفوائد المفروضة على القروض الصناعية يمثل عقبة بالنسبة لقدرة المشروع على السداد ، في ظل ما يطرأ على أسعار الخامات المستوردة من الخارج ، من ارتفاعات مفاجئة في أسعارها .	يطرأ	20	Sing
وذكر انه يتعين على الشعب ان يحول نعيهم الى مصدر للقوة وذلك بالتعلم من الحادث لدفع قدرة الدفاع الوطنى فى البلاد قدما وتسريع مسيرة تحديث الجيش .	يحول	6	Sing
ولفت خبراء ومحللون إلى أن مبارك لم يتحدث يوماً بطريقة توحي بأنه يؤيد توريث الحكم لابنه ، مما يرجح أن مثل هذا الاتجاه قد يكون مدعوماً من بعض المحيطين به .	توحي	10	Sing
كما شدد على ضرورة احترام القوانين الدولية قائلا ان السلام يمكن تحقيقه على اساس ذلك . واكد عبيد امام باول ان لبنان يدين الارهاب .	يدين	22	Sing
- اعتقلت قوات الأمن الاسرائيلية اربعة فلسطينيين في مخيم الغوار قرب الخليل ، وذكر انهم ينتمون الى فتح والجبهة الشعبية ، ولم تعرف التهمة .	اعتقلت	1	Sing
القاهرة 15 - 8 ( اف ب ) - ذكر مسؤول فلسطيني ان مفاوضين فلسطينيين في عملية السلام مع اسرائيل اجتمعوا مع مسؤولين مصريين اليوم الثلاثاء في القاهرة .	اجتمعوا	20	Plur
الأخوان والناصريون يتحالفون ضد التمويل الأمريكي للإعلام المصري	يتحالفون	2	Plur
نتنياهو : سورية أضحت قرية صغيرة في العالم ومكانة إسرائيل تعززت	أضحت	3	Sing
صرح نائب رئيس مجلس الدولة الصينى هوى ليانغ يو انه يتعين بذل مزيد من الجهود لمنع امتداد عرض الالتهاب الرئوى الحاد / سارس / الى المناطق الريفية بالصين .	يتعين	10	Sing
وتقع هذه الحوادث امام انظار الناس الذين لا يستطيعون ان يفعلوا شيئا على الفور فى مواجهة قوات الاحتلال المدججة بالسلاح لكنهم بالتأكيد يضمرون الحقد لهؤلاء المحتلين الاجانب .	يفعلوا	10	Plur
ويقول افينتاخادو " اقوم بجهود مضاعفة في محاولة لانهاء مسألة الرهائن قبل انطلاق الالعاب " ، واضاف " لم تحرز الفيليبين اي ميدالية ذهبية حتى الان في تاريخ الالعاب الاولمبية ، واحلم بتحقيق ذلك في سيدني " .	تحرز	19	Sing
تونس / الصباح يبدو ان ما يشبه عدم التنسيق حصل بين دوائر القرار صلب الحزب الديموقراطي التقدمي ، فيما يخص البيان الانتخابي والتعديلات التي حصلت مفاوضات بشأنها بين الحزب والادارة .	يشبه	6	Sing
تبلي بلاء حسنًا أمام الناس وبينك وبين نفسك , والخيار لك .	تبلي	0	Sing
واكد ان " الاطفال والكبار يمكن ان يصابوا بادمان على المشروبات التي تحتوي الكافيين وان يشعروا باعراض النقص جسديا ونفسيا اذا توقفوا عن شربها " .	يصابوا	7	Plur
ومن عجب أن يتسبب في جل هذه المعاناة جماعات ممن يزعمون الانتساب إلى المسيح ودينه ، في أوروبا وأمريكا الذين شادوا حضارة العنف والعنصرية والانحلال الأخلاقي " . .	يزعمون	10	Plur
دل تقرير إسرائيلي أن ربع النساء في غزة في سن الخصوبة حوامل .	دل	0	Sing
لم يبرز لهذه الطائفة أي دور في الحياة الإسرائيلية ولم يسمع لها صوت إلا في ما ندر .	ندر	16	Sing
