My jesteśmy gotowi .	gotowi	2	Plur
Dzieje się to zazwyczaj w pionowo rozbudowanych , konwekcyjnych chmurach kłębiastych .	konwekcyjnych	8	Plur
Przy kredytach dla ludności oprocentowanie najczęściej jest podawane z góry i nie zależy od oceny klienta .	podawane	7	Sing
Daje on młodym ludziom szansę wykazania się umiejętnościami organizatorskimi .	młodym	2	Plur
Bawi mnie to w jakiś ponury sposób .	ponury	5	Sing
Nie przeprowadził etnicznych czystek , nawet w policji i prasie .	etnicznych	2	Plur
Adres niech dobrodziej spisze z dowodu osobistego .	osobistego	6	Sing
Na morskiej jednostce mogą być zatrudnione tylko te osoby , które posiadają aktualne świadectwo zdrowia .	zatrudnione	5	Plur
To typowy klasyk , w którym każdy z cylindrów dysponuje tylko 2 zaworami .	typowy	1	Sing
Ale umiarkowani zmądrzeli .	umiarkowani	1	Plur
Ulice pokryły się także gałęziami połamanymi przez wiatr .	połamanymi	5	Plur
Nie licz na udany romans .	udany	3	Sing
Statystyki są zastanawiające , ale co się w rzeczywistości za nimi kryje ?	zastanawiające	2	Plur
Oryginalne lampy zdobyto z zasobów niemieckich przeznaczonych dla Wehrmachtu .	przeznaczonych	6	Plur
Zasapany Mock zszedł ze stołu i włożył głowę do żeliwnego zlewu .	żeliwnego	9	Sing
Dlatego ceni się sumienność , odpowiedzialność , perspektywiczne myślenie .	perspektywiczne	7	Sing
Mam najnowsze zestawy osób nagrodzonych .	najnowsze	1	Plur
Podobno były nawet pokazywane na wystawie przemysłowej , która odbyła się tu w zeszłym roku .	pokazywane	3	Plur
Teraz trwają intensywne przygotowania organizacyjne , sporządzane są ekspertyzy i bilanse .	intensywne	2	Plur
Ciężarówka wpadła między rosnące na skarpie drzewa .	rosnące	3	Plur
Nowy gadżet wymaga od właściciela kwiatków , czekoladek , randek w barach karaoke i miłosnych liścików .	miłosnych	14	Plur
Specjaliści z Centralnej Agencji Wywiadowczej mają już świadka , który widział zamachowców na kilka minut przed eksplozją w Nairobi .	Wywiadowczej	4	Sing
Teraz myśli się już o rzeczach dużo bardziej zaawansowanych .	zaawansowanych	8	Plur
Powstawały robotnicze kolonie przyfabryczne wiążące pracobiorcę z pracodawcą .	przyfabryczne	3	Plur
Uwielbia tańczyć , kołysana na rękach .	kołysana	3	Sing
Pokoje stanowią wyłączną własność poszczególnych lokatorów .	poszczególnych	4	Plur
Kiedyś w Poznaniu spotkał em się z moimi polskimi krewnymi .	polskimi	8	Plur
Język telenowel jest ujednolicony , mało barwny , ogólnopolski .	barwny	6	Sing
Pierwsze i drugie miejsce zajęły słowackie dziewczęta , ubrane w getry i krótkie falbankowe spódniczki .	słowackie	5	Plur
Odnalazł Jaskra , kibicującego łupiącym w gwinta krasnoludom .	łupiącym	4	Plur
Obecni byli posłowie Pękała i Witaszczyk , ale nie przemawiali .	Obecni	0	Plur
Oddech jego stał się krótki , przerywany , nierówny .	nierówny	8	Sing
Ich przedstawiciele , służąc w Gwardii Szlacheckiej , dodawali splendoru Stolicy Piotrowej , a jednocześnie znajdowali tam niejednokrotnie środki dla wygodnego życia , ponieważ za swą służbę otrzymywali pensje .	Szlacheckiej	6	Sing
Musisz cofnąć się o 2 pola do tyłu , by pozbyć się lepkich nici z twarzy .	lepkich	12	Plur
Jestem w troszeczkę lepszym usposobieniu .	lepszym	3	Sing
Natomiast zdjęcia eksponowane w MDK ukazują nowe spojrzenie na fotografię , którego dominantą jest wykonywanie makrofotograficznych ujęć z bardzo bliskiej odległości przy małej głębi ostrości .	makrofotograficznych	15	Plur
Stali dłuższą chwilę niezdecydowani , nie ważąc się na ryzykowny krok .	niezdecydowani	3	Plur
Była nawet ładna .	ładna	2	Sing
A potem dowiedziałem się , że nie mogę nie pójść na obiad wydawany w restauracji przez znajomego Chenga , bo w czasie ostatniego spotkania znajomy dał mi twarz .	wydawany	12	Sing
Z domku wyszedł im na spotkanie niski mężczyzna o nienaturalnie szerokich ramionach i krótkich , krzywych nogach .	krzywych	15	Plur
Z oficjalnym żądaniem wobec MKOl , złożonym na piśmie , wystąpił Narodowy Komitet Olimpijski KRLD , domagając się od naczelnej władzy sportowej rewizji listy triumfatorów olimpijskich .	olimpijskich	25	Plur
No kto , na przykład , zbudował radziecką bombę atomową ?	atomową	9	Sing
Daje poczucie wspólnoty , gromadzi ludzi z podobnymi problemami , którzy zaczynają stanowić dla siebie grupę wsparcia .	podobnymi	7	Plur
Paul Broca , lekarz paryski , zachował mózgi swoich pierwszych pacjentów dla potomności .	paryski	4	Sing
Reformy ograniczono do totalnej prywatyzacji , która przyjęła raczej ramy wyprzedaży majątku narodowego .	ograniczono	1	Sing
Jeńcy wojenni listy piszą . . .	wojenni	1	Plur
Na pastwisku w Uniszkach Gumowskich rolnik załadował na dwukółkę krowę .	Gumowskich	4	Plur
Lubi dobrą muzykę i piesze górskie wycieczki .	piesze	4	Plur
Tak zabawili się trzej tarnobrzescy gimnazjaliści .	tarnobrzescy	4	Plur
Jadę do Katowic w sprawach różnych , poprzecznych i podłużnych , jak mówią moje dzieci .	poprzecznych	7	Plur
Wcześniejsze doniesienia mówiły , że był to zamach samobójczy .	Wcześniejsze	0	Plur
Co się roi w twoim szalonym ruskim łbie ?	ruskim	6	Sing
Największe zainteresowanie budzi jednak specjalne seminarium poświęcone ustaleniu budowy ludzkiego DNA .	poświęcone	6	Sing
Tylko niektórzy użalają się na forach internetowych nad swoim losem .	internetowych	6	Plur
Owoc dojrzały nie wyda nasion , kiść uschnie .	dojrzały	1	Sing
Tymczasem miednice wypełnione podrobami przenoszono do kuchni .	wypełnione	2	Plur
- Czy grozi nam czarny scenariusz rozwoju sytuacji gospodarczej ?	gospodarczej	8	Sing
- Jestem bardzo dumna z bycia ciechanowianką .	dumna	3	Sing
Dzień później trener Bogdan Pamuła zabrał swoich podopiecznych , tym razem pod sztandarem juniorskim , na mecz do Przemyśla .	juniorskim	13	Sing
Może ja piszę sonety prorocze ?	prorocze	4	Plur
Były najdłuższe dni roku .	najdłuższe	1	Plur
Około 15 km za Nag–czu , boczną , terenową drogą dojechali śmy do pasterskich namiotów .	boczną	6	Sing
Stara to jest historia sprzed japońskiej wojny .	Stara	0	Sing
Emma pomyślała w tej chwili , że nie jest to spostrzeżenie specjalnie odkrywcze .	odkrywcze	12	Sing
– Stare wyrazy żyją ?	Stare	1	Plur
Saperzy wydobyli we wtorek sześć artyleryjskich pocisków burzących z czasów II wojny światowej , odkrytych na terenie budowy na krakowskim Prądniku Czerwonym .	burzących	7	Plur
We wszystkich miastach i miasteczkach odbyły się wiece i uroczyste akademie .	uroczyste	9	Plur
Powodem były jego publiczne wypowiedzi na temat ludzi upośledzonych fizycznie .	upośledzonych	8	Plur
Ostatecznie ten przemysł został stworzony przez Europejczyków .	stworzony	4	Sing
Talent dramatopisarski Kisielewskiego wypowiedział się w zasadzie w tych dwóch sztukach młodzieńczych .	dramatopisarski	1	Sing
Nieprzytomnego Pawła znajduje właściciel pizzerii .	Nieprzytomnego	0	Sing
W najlepszym razie wyglądało to tak .	najlepszym	1	Sing
3 . Unikaj dudniących , hałaśliwych kolumn .	dudniących	3	Plur
Nauczyciel szybko uporał się z zakupami i , nie powracając już do poprzedniego tematu , z widoczną ulgą pożegnał chałupniczkę .	widoczną	16	Sing
Najważniejszą zaletą będzie koordynacja wszystkich podsystemów komunikacyjnych z koleją podmiejska , a także motoryzacją indywidualną oraz komunikacją rowerową .	Najważniejszą	0	Sing
Ericsson kończy produkcję telefonów komórkowych , która przynosiła szwedzkiej spółce ogromne straty .	szwedzkiej	8	Sing
Rodziny , które zdecydują się kupić na kredyt własne M , mogą liczyć na pomoc finansową .	finansową	15	Sing
Pozostali pacjenci przebywają na oddziale ginekologicznym , wewnętrznym i kardiologicznym .	kardiologicznym	9	Sing
Gładki jest bardziej śliski .	śliski	3	Sing
Kolejowi robotnicy prowadzili tam prace modernizacyjne .	Kolejowi	0	Plur
- Poza tym Jan Paweł II nie został jeszcze ogłoszony świętym .	ogłoszony	9	Sing
Ograniczenie szybkości obowiązuje tutaj od soboty z powodu rutynowych prac konserwatorskich .	rutynowych	8	Plur
Który naród w Europie najbardziej kocha telefony komórkowe ?	komórkowe	7	Plur
Wysunięte pretensje pod adresem autorów słownika nie zmienią językowej rzeczywistości .	Wysunięte	0	Plur
Uniwersytet ten , założony w 1949 r . i prowadzony przez werbistów , nie posiada zbyt długiej tradycji akademickiej .	założony	3	Sing
Nie będzie to śmierć , ale trwałe kalectwo .	trwałe	6	Sing
Przekupnie w bazarowych zaułkach opowiadali , że upadek rządu jest bliski i nieuchronny , a ministrowie i generałowie knują spiski albo pakują walizy i szykują się do ucieczki za granicę .	bazarowych	2	Plur
To po prostu najprawdziwsza prawda .	najprawdziwsza	3	Sing
Od kilkunastu miesięcy w kraju działa Agencja Cenowa .	Cenowa	7	Sing
- Lista posłów zapisanych do głosu została wyczerpana .	zapisanych	3	Plur
Z wypłowiałego zdjęcia uśmiechała się azjatycka , młoda twarz pana Korzeniowskiego , wystrojonego w mundur zapięty pod szyją .	zapięty	15	Sing
Opieka naprzemienna jest konsekwencją sprzeciwu ojców , którzy poczuli się skrzywdzeni orzeczeniami sądów .	skrzywdzeni	10	Plur
Na konferencji mówiono też o stanie gospodarki europejskiej .	mówiono	2	Sing
Warszawscy radiowcy okazali się trudnymi rywalami .	Warszawscy	0	Plur
Zarząd miasta ma też sprawdzić , czy Zakład Usług Komunalnych prowadzi prace zgodnie z projektem .	Komunalnych	9	Plur
Nie zatamujesz krwi fałszywym bandażem .	fałszywym	3	Sing
Nikt się nie lituje , nie pieści z przyjeżdżającymi na zarobek .	przyjeżdżającymi	8	Plur
Amerykanie patrząc zza Oceanu na Europę myślą niemal wyłącznie kategoriami strategicznymi i gospodarczymi .	gospodarczymi	12	Plur
( Michał krzywi się , wyraźnie zirytowany . )	zirytowany	6	Sing
Palcem rysuje na wykładzinie małe syrenki .	małe	4	Plur
U nas takie imprezy są zupełną nowością , ale na Zachodzie to bardzo popularna dyscyplina .	zupełną	5	Sing
- Jakie są Pańskim zdaniem cechy dobrego dyplomaty ?	dobrego	6	Sing
Moczarskiego znał em sprzed wojny , byli śmy razem w Wyższej Szkole Dziennikarskiej , dość zaprzyjaźnieni .	zaprzyjaźnieni	15	Plur
Leci z Milwaukee do Pekinu na chiński Nowy Rok .	Nowy	7	Sing
500 chuliganów zorganizowało protest przeciw złej sytuacji finansowej klubu .	złej	5	Sing
Jadący z nadmierną szybkością wartburgiem Marek Ch . , będąc pod wpływem alkoholu , został wyrzucony na łuku jezdni na pobocze , a następnie przekoziołkował i uderzył w drzewo .	nadmierną	2	Sing
Oznacza to , że odbierze każde przychodzące wywołanie .	przychodzące	6	Sing
Leżeli później zlani potem .	zlani	2	Plur
Było jeszcze wtedy w granicach typowych dla Tadzia .	typowych	5	Plur
Nie wstąpi jego stopa junacka w strzemiona ojcowe .	ojcowe	7	Plur
Coraz częściej ludzi trapi poczucie małej wartości , obawa , że nie uda się im zrobić odpowiedniego wrażenia na rzadko widywanych bliskich .	widywanych	20	Plur
Potem ustosunkował się do tego , co wcześniej przekazali śmy w sprawach gospodarczych .	gospodarczych	12	Plur
Podobne warunki terenowe charakteryzują cmentarzysko w Předmostí .	Podobne	0	Plur
Oczywiście , ważny jest program , ważne są jednak także zbiorowe emocje , poczucie sprawiedliwości , historyczna pamięć .	zbiorowe	10	Plur
Lata dziewięćdziesiąte to również okres rozwoju przestrzennego Uniwersytetu .	przestrzennego	6	Sing
Są to bardzo spóźnione rewelacje .	spóźnione	3	Plur
Postój w tym byłym górniczym mieście poprzedził dyskretny telefon z ABW do władz grodu .	dyskretny	7	Sing
Dzieje się to zazwyczaj w pionowo rozbudowanych , konwekcyjnych chmurach kłębiastych .	kłębiastych	10	Plur
Czy Dominik , broniąc się , mógł przewidzieć aż tak dramatyczne skutki ? !	dramatyczne	10	Plur
Sporządzono także portrety pamięciowe napastników .	pamięciowe	3	Plur
– edwansa ma zrobionego ?	zrobionego	3	Sing
Jak urządzony jest Wasz dom ?	urządzony	1	Sing
W tym roku prawdziwa zima wyprzedziła kalendarzową .	kalendarzową	6	Sing
Na ekranie TV , na zatrzymanej stop-klatce Jurka Kilera idą napisy końcowe programu .	zatrzymanej	5	Sing
Kto wie , czy najwięcej nie przyczyniła się do mojego wybawienia długotrwała burza .	długotrwała	11	Sing
zadzwoń o dwunastej .	dwunastej	2	Sing
Jeszcze przed obcięciem uposażeń , krakowscy rajcy planowali wydać taką właśnie sumę na remont trzech komisariatów oraz zakup 9 samochodów dla policji i 4 dla straży miejskiej .	krakowscy	5	Plur
Łzy padały na cremoński lakier .	cremoński	3	Sing
Polskich komunistów nie łączyły nigdy żadne specjalne więzy z przywódcami ludowych Chin .	Polskich	0	Plur
Mimo ciepłego dnia pani domu przyjęła ją otulona w brązowy blezer , spod ciemnej spódnicy wystawały chude łydki .	ciemnej	13	Sing
W grudniu 1996 roku Havlovi wraz z górnym płatem prawego płuca usunięto niewielki nowotwór złośliwy .	złośliwy	14	Sing
Wśród oceniających zasiadły trzy blondynki .	oceniających	1	Plur
Terror niczego nie tworzy , jest jałowy .	jałowy	6	Sing
Moja babka jest odważna .	odważna	3	Sing
A ty przecież zwykły nie jesteś .	zwykły	3	Sing
W latach sześćdziesiątych , już jako sztygar oddziałowy , pamiętam odbiory przygotowywanych do rozruchu ścian dokonywane przez dyrektora Śniegonia .	przygotowywanych	11	Plur
U młodej dziewczyny psychiatra z Modusa rozpoznał początki choroby psychicznej , dziewczyna myśli o samobójstwie .	młodej	1	Sing
W załzawionym świecie jeden diabeł posiadał kontury ostre i wyraźne .	wyraźne	9	Plur
Obecnie mają oni najwyższe pensje w całym województwie pomorskim .	najwyższe	3	Plur
Majowe weekendy zapowiadają się naprawdę ładnie !	Majowe	0	Plur
Ranni żołnierze zostali przewiezieni do szpitala w Białogardzie .	przewiezieni	3	Plur
Rozumiem , są to szczególne złotówki .	szczególne	4	Plur
Niemiecki sąd konstytucyjny zabronił stosowania go na terenie tego kraju .	konstytucyjny	2	Sing
Już sama wiadomość o jego śmierci była spóźniona .	spóźniona	7	Sing
Będzie to film szerokoekranowy , składający się z dwóch części .	składający	5	Sing
W akcji ratunkowej uczestniczyło ok. 20 ratowników .	ratunkowej	2	Sing
W poniedziałek rano do Betlejem i Kalkilli na Zachodnim Brzegu Jordanu wjechały izraelskie czołgi .	izraelskie	12	Plur
Kongresy Międzynarodówki poruszały zawsze ważne problemy , istotne dla życia politycznego i społecznego danego okresu .	społecznego	12	Sing
Jeden facet zaczął zbierać .	Jeden	0	Sing
W grudniu 97 Komitet Wierzycieli MAAD złożył doniesienie karne przeciwko biznesmenowi i parlamentarzyście w poznańskiej Prokuraturze Wojewódzkiej .	97	2	Sing
Wówczas warto pospieszyć się z odpowiedzią , bo od złożenia takiej deklaracji operator w ciągu miesiąca musi wprowadzić nowe , korzystniejsze opłaty .	korzystniejsze	20	Plur
Stało się oczywiste , że porozumienia są możliwe i owocne .	owocne	9	Plur
Podczas obchodu można było się przekonać , że nastąpiły gruntowne zmiany w pomieszczeniach CSiK .	gruntowne	9	Plur
Podał jej żółtą , skórzaną rękawiczkę .	żółtą	2	Sing
Zwolnienia zostaną rozłożone na cały 2001 r.	rozłożone	2	Plur
Na tym kończymy rozpatrywanie punktów porządku dziennego w dniu dzisiejszym .	dziennego	6	Sing
Wtedy była słaba i uległa .	uległa	4	Sing
W programie obchodów przewidziano spotkanie uczestników ówczesnych wydarzeń , wystawę fotograficzną i sesję naukową .	ówczesnych	6	Plur
Z 13 do 27 zwiększa się w Łodzi liczba opiekunów , przeprowadzających dzieci idące na lekcje przez najruchliwsze jezdnie i skrzyżowania .	najruchliwsze	17	Plur
W egzekucjach przeprowadzonych w Miednoje , Charkowie i Katyniu zabito 15 tys . polskich oficerów .	zabito	9	Sing
Wszedł em do jego sterylnego gabinetu .	sterylnego	4	Sing
Zajmowała się tym głównie Maryla Wacławkówna , wygnana ongiś z przedszkola za klerykalizm .	wygnana	7	Sing
Za każdy samochód zabierali się od razu mechanicy , zmieniali koła , usuwali uszkodzenia powstałe w czasie forsownego treningu , wymieniali zdarte nakładki hamulcowe , regulowali silniki .	zdarte	21	Plur
Mariola odstawiła torebkę na malutki stołeczek .	malutki	4	Sing
Wreszcie na ludzi głodnych przybywających ze wsi czekały rozwijające się gwałtownie w XIX w . miasta .	rozwijające	8	Plur
Stali na chodniku przed odrapanym budynkiem w Erewanie , w którym mieścił się Komitet Karabachu .	odrapanym	4	Sing
Brzegi chodników były zastawione ławkami .	zastawione	3	Plur
Agnieszka jest odurzona szczęściem .	odurzona	2	Sing
Najbliżsi rywale Orfe także nie rezygnują z przejęcia kolejnych mniejszych dystrybutorów .	Najbliżsi	0	Plur
Rdzenni mieszkańcy wyspy stanowią rozpaczliwą mniejszość .	rozpaczliwą	4	Sing
Wojewoda doda jej dla splendoru nieszczupły taborek .	nieszczupły	5	Sing
Kontrolerzy nie wzięli pogróżek poważnie , bo wiedzieli z doświadczenia , że w podobnej sytuacji prawie każdy podatnik powołuje się na możnego protektora . . .	podobnej	13	Sing
Książę Andrzej Poniatowski , porucznik armii francuskiej , odwiedził Polskę w roku 1919 jako członek francuskiej misji wojskowej .	wojskowej	17	Sing
Wkrótce też natknęli się na mężczyzn ściągających skórę z zabitego kozła .	zabitego	9	Sing
Francuscy komuniści są gotowi stworzyć z socjalistami rząd lewicy po wyborach 1998 roku .	1998	11	Sing
Kierowca odniósł lżejsze obrażenia .	lżejsze	2	Plur
Tomaszewski był rozgoryczony tak długim odroczeniem swojego procesu .	długim	4	Sing
Wśród wielu przysmaków polskiej kuchni ryba morska zajmuje coraz ważniejszą pozycję .	ważniejszą	9	Sing
Sprowadzeni na miejsce strażacy i policjanci nie ukrywali zdziwienia .	Sprowadzeni	0	Plur
Czekała mnie długa noc .	długa	2	Sing
Obie spółki ustaliły identyczne ceny .	identyczne	3	Plur
– A pamiętasz swoje pierwsze wrażenie , kiedy zobaczył eś gołą dziewczynę w naturze ?	gołą	10	Sing
Szmigielski działa też w komisji ogródków działkowych , komisji mieszkaniowej i radzie osiedla ; ma biuro w piwnicy .	działkowych	6	Plur
Zaliczmy banana do żywotnych i nie będzie wyjątku . . .	żywotnych	3	Plur
Dzięki jego zaangażowaniu w naszym mieście nadal funkcjonuje sekcja piłki nożnej na odpowiednim poziomie sportowym , promująca Jarosław na terenie Polski południowo - wschodniej .	nożnej	10	Sing
Na szczęście któryś z bliżej stojących chłopaków podskoczył i podtrzymał go .	stojących	5	Plur
Wymaga to zainstalowania odpowiednich zbiorników .	odpowiednich	3	Plur
Praca w okupowanych szpitalach przebiega normalnie .	okupowanych	2	Plur
- Dlaczego fundusz ma dwie rady nadzorcze i dwa zarządy ?	nadzorcze	6	Plur
- Może zwrócę się o pomoc finansową do Wojewódzkiego Funduszu Ochrony Środowiska .	finansową	6	Sing
Jest to też jedna z najbardziej trwałych zdobyczy solidarnościowego przełomu .	trwałych	6	Plur
Gdy we wspomnianych dwu pionach narożnikowych ktoś się kąpie , wówczas woda spływa w dół nawilgacając po drodze niżej położone mieszkania .	położone	19	Plur
PiS okazało się osamotnione w swojej argumentacji .	osamotnione	3	Sing
Na uwagę zasługuje grupa OrangeTheJuice ze Stalowej Woli .	Stalowej	6	Sing
Ale nie lubię jubileuszy i nie czuję się zramolałym jubilatem .	zramolałym	8	Sing
Taka sytuacja łatwo popycha do kroków desperackich .	desperackich	6	Plur
Tu mogłem obserwować rzetelną , telewizyjną realizację bez pośpiechu , w której uczestniczenie było naprawdę przyjemnością .	rzetelną	3	Sing
Nie wprowadzono prywatnej własności ziemi , nie zniszczono feudalnego imperium dyrektorów kołchozów .	prywatnej	2	Sing
Sytuacja jest bardzo kłopotliwa " .	kłopotliwa	3	Sing
Tylko ulewa huczała nieprzerwanym , mokrym hukiem .	nieprzerwanym	3	Sing
Wśród 65-tysięcznej publiczności oglądającej uroczyste otwarcie igrzysk będzie 40 najwyższych dostojników różnych państw .	najwyższych	9	Plur
Ażeby takim przykrym kolizyom zaradzić , puszczamy w świat ten oto podręcznik .	przykrym	2	Plur
Przy ulicy Kawęczyńskiej w Warszawie , w Wyższej Szkole Menedżerskiej , trwają prace remontowe w budynku zaadaptowanym na nowy dziekanat i rektorat .	remontowe	13	Plur
– Leżał na rękawicach ochronnych i też był popaprany ziemią .	ochronnych	4	Plur
Czekolada , spożywana w umiarkowanych ilościach , może chronić nas przed chorobami serca .	spożywana	2	Sing
Nie było wolnych miejsc .	wolnych	2	Plur
- Porywacze uwolnili na naszą prośbę część kobiet oraz akredytowanych w naszym kraju dyplomatów .	akredytowanych	9	Plur
Z punktu widzenia potrzeb średniego szkolnictwa muzycznego , znaczenie książki jest wyjątkowo duże .	średniego	4	Sing
Przewiduje on wynajęcie firm zewnętrznych , które zajmą się utrzymaniem sieci abonenckiej TP SA .	abonenckiej	11	Sing
Komentatorzy powszechnie uważają , że zaszkodziła ona jednemu z głównych kandydatów na prezydenta Arturasowi Paulauskasowi .	głównych	9	Plur
Oddając zużyte elektrolity , które tam będą regenerowane , napełnimy zbiorniki nowymi roztworami .	zużyte	1	Plur
Nas , kobiety , obyczaj ciągle jeszcze skazuje na bierne wyczekiwanie .	bierne	9	Sing
Cudem przeżyła 9-letnia dziewczynka .	9-letnia	2	Sing
Wieczorem po przyjeździe do Nowego Jorku zdążyłem jeszcze przeczytać różne materiały i przygotować swoje wystąpienie , a potem odwiedziłem sekretarza generalnego ONZ U Thanta .	różne	9	Plur
W wydanym wczoraj oświadczeniu Rada podkreśliła , że wstrzymanie wykonania koncesji , gdy jednocześnie toleruje się działalność piratów , niszczy podstawy ładu w eterze .	wydanym	1	Sing
Tylko w minioną sobotę w atakach terrorystycznych w Bagdadzie zginęło ponad 40 osób .	terrorystycznych	6	Plur
– Nie zostanie pan jednak całkiem odsunięty od śledztwa .	odsunięty	6	Sing
Chodzi o inwestycje w dziesięciu gminach z rejonu Gór Świętokrzyskich .	Świętokrzyskich	9	Plur
Koledzy z zasadniczej górniczej patrzyli w niebo i czekali .	górniczej	3	Sing
Całe rodziny słoni są także przenoszone do nowych rezerwatów .	przenoszone	5	Plur
Z 13 do 27 zwiększa się w Łodzi liczba opiekunów , przeprowadzających dzieci idące na lekcje przez najruchliwsze jezdnie i skrzyżowania .	przeprowadzających	11	Plur
Zaczęło się od tego , że kupili śmy koledze na urodziny tarczę i sami zaczęli śmy grać .	sami	13	Plur
W kwietniu tegoż 1981 r . w naszych zachodnich okręgach wojskowych przeprowadzona została nadzwyczaj długa sztabowa gra wojenna .	wojskowych	10	Plur
W środę ze Szpitala Ginekologiczno - Położniczego w Opolu wypisywano 11 noworodków .	wypisywano	9	Sing
200 z nich chronionych jest jako zabytki architektury ogrodniczej .	chronionych	3	Plur
Analiza spektrometryczna wykazała , że jego skład izotopowy jest typowy dla procesów reaktorowych , a nie wybuchu jądrowego .	reaktorowych	12	Plur
Prokuratorowi oraz sędziom mówił , iż pojechał na Wschód , aby holować do Polski uszkodzony za Bugiem samochód .	uszkodzony	14	Sing
Luksusowego forda explorera nieznani sprawcy skradli wczoraj w Warszawie generałowi rosyjskiej milicji .	nieznani	3	Plur
On też miał we Lwowie kancelarię prawniczą .	prawniczą	6	Sing
Przedstawione powyżej podejścia , koncepcje i metody dają duży wybór w określeniu docelowego modelu alokacji .	Przedstawione	0	Plur
Narażenie rozgrzanego psa na przeciągi grozi poważnymi komplikacjami ze zdrowiem .	rozgrzanego	1	Sing
Jego usuwaniem zajęli się strażacy ze specjalistycznym sprzętem .	specjalistycznym	6	Sing
Przewidziany jest udział lekarzy w dalszych pracach identyfikacyjnych .	Przewidziany	0	Sing
Trzydzieste piąte Targi zostały rozpoczęte .	Trzydzieste	0	Plur
Uwodzić zapładniającego skutecznie mężczyznę .	zapładniającego	1	Sing
Słucham , usłyszał em raźny głos matki .	raźny	4	Sing
Podejmowane są zobowiązania indywidualne i zespołowe .	Podejmowane	0	Plur
- Masz dobrych rodziców .	dobrych	2	Plur
Nieprzytomną odwieziono do szpitala przy ul. Unii Lubelskiej .	Nieprzytomną	0	Sing
Ekolodzy zaopatrzyli młodszych kolegów w worki na śmieci i rękawiczki .	młodszych	2	Plur
Zawsze czuł wobec tych urządzeń jakiś instynktowny lęk .	instynktowny	6	Sing
Wówczas koła łowieckie będą dbały , aby populacja nie rozrastała się ponad dopuszczalną .	łowieckie	2	Plur
Pierwsze rzeźby wykonał w latach dwudziestych .	dwudziestych	5	Plur
Coraz większym zainteresowaniem cieszą się fundusze inwestycyjne działające na terenie Szwecji .	działające	7	Plur
Sprawa została upubliczniona na ostatniej miejskiej sesji .	upubliczniona	2	Sing
Obecnie trwa sadzenie późniejszych odmian .	późniejszych	3	Plur
Wcześniejsze doniesienia mówiły , że był to zamach samobójczy .	samobójczy	8	Sing
Grupa powstała we wczesnych latach 80 .	80	5	Plur
to jest borówka amerykańska tylko większa .	amerykańska	3	Sing
Kiedy lekarz wystrzelił , rozdrażnione zwierzę rzuciło się na niego .	rozdrażnione	4	Sing
Leżącego na trawie obok drogi mężczyznę zauważyły przejeżdżające tamtędy przypadkowe osoby .	przejeżdżające	7	Plur
W świecie nauki początek jesieni to emocje towarzyszące Nagrodom Nobla .	towarzyszące	7	Plur
Rada Ludowa próbowała przeciwstawiać się takim krokom .	Ludowa	1	Sing
Olbrzymie tiry parkują na osiedlowych ulicach .	Olbrzymie	0	Plur
Cały czas sprawdzana jest ich skuteczność .	Cały	0	Sing
Sprawą zainteresował się referat I-szy i przez kontrolę korespondencji może uzyskamy dalsze miejsca zachowanych rzeczy .	zachowanych	13	Plur
Za chwilę kardynałowie i biskupi wyniosą obraz Matki Bożej Jasnogórskiej na ołtarz przed kościołem .	Bożej	8	Sing
Podstawowe terminy powstały podczas badań lodowców w górach umiarkowanej strefy klimatycznej .	Podstawowe	0	Plur
Była typową polską postępową inteligentką czyli agnostyczką , i wzmianek o chodzeniu do kościoła u niej nie upatrzysz .	typową	1	Sing
Ograniczenie szybkości obowiązuje tutaj od soboty z powodu rutynowych prac konserwatorskich .	konserwatorskich	10	Plur
Jest mało ścieżek rowerowych .	rowerowych	3	Plur
Najbliżsi rywale Orfe także nie rezygnują z przejęcia kolejnych mniejszych dystrybutorów .	mniejszych	9	Plur
" Skrupulatnie przestrzegane zasady od dziesiątków lat współtworzą jej autorytet i wyjątkową pozycję na rynkach całego świata " .	przestrzegane	2	Plur
Byli zmarznięci i wystraszeni .	zmarznięci	1	Plur
Po trzech dniach Śpiąca Królewna wróciła do Warszawy .	Śpiąca	3	Sing
Szkoła ma dwie kondygnacje , 9 izb lekcyjnych , kuchnię i kotłownię .	lekcyjnych	7	Plur
Rekordowy mróz minus osiemnaście stopni Celsjusza zanotowano w podgórskiej miejscowości Przibyslavi .	minus	2	Plur
Darowizny przekazane na jej rzecz podlegają odpisowi podatkowemu .	podatkowemu	7	Sing
Już dziś wiadomo , że odprawy są zbyt hojne .	hojne	8	Plur
- Jest niemożliwa na lekcjach .	niemożliwa	2	Sing
Naszym wspólnym celem jest kultura , a kultura nie ma granic .	wspólnym	1	Sing
Niedawno zapytał darłowskie dzieci , kim był król Eryk .	darłowskie	2	Plur
Znajdą się tam także pomieszczenia rehabilitacyjne z basenem , salami gimnastycznymi i salami masażu .	rehabilitacyjne	5	Plur
O tym , co naprawdę działo się w kraju , wiedzieli tylko nieliczni notable .	nieliczni	12	Plur
Witały ich entuzjastyczne oklaski .	entuzjastyczne	2	Plur
W jej twarzy , mokrej od łez rozmazanych i czerwonej , tężały w osłupieniu szkliste , bladoniebieskie oczy .	mokrej	4	Sing
Użytkownik ma do dyspozycji 6 baz zawierających informacje posortowane według wybranego kryterium .	posortowane	8	Plur
Są chętne , jak Lilka .	chętne	1	Plur
Złotą Statuetkę pierwszy niekomunistyczny premier w powojennej Polsce odebrał w sobotę podczas Wielkiej Gali Polskiego Biznesu .	Złotą	0	Sing
Inaczej mogą zostać pobite .	pobite	3	Plur
Było przestronnie , panowała spokojna , sympatyczna atmosfera .	sympatyczna	6	Sing
Ale wtedy doszło do rzeczy niesłychanej .	niesłychanej	5	Sing
Zgodnie podkreślają , że bracia Kaczyńscy nie lubią hucznych imprez .	hucznych	8	Plur
I tym razem Gagarin zniósł ją ze stoickim spokojem .	stoickim	7	Sing
Sklepy były pozamykane .	pozamykane	2	Plur
Niepostrzeżenie wracamy do domu i nad ranem obwieszczamy światu odkrycie niecodziennego zjawiska .	niecodziennego	10	Sing
Może to tylko takie zabawy językowe , lingwistyka dla naiwnych ?	naiwnych	9	Plur
MPK jest dziś spółką , od której samorząd kupuje przewozowe usługi .	przewozowe	9	Plur
asai to jest ta borówka amerykańska ?	amerykańska	5	Sing
Do poradni chirurgicznej i pogotowia ratunkowego napływali poszkodowani piesi .	ratunkowego	5	Sing
Arytmetyka jest nieubłagana .	nieubłagana	2	Sing
- Zatem po raz pierwszy w Pańskim życiu kompozytorskim spotkały się obie Pańskie osobowości ?	Pańskie	12	Plur
Użytkowanie przez spółdzielnię wkładów gruntowych jest odpłatne .	odpłatne	6	Sing
Będzie ona z pewnością dobrą podstawą dalszych specjalistycznych studiów nad historią muzyki .	dalszych	6	Plur
Drugi pod względem kapitalizacji giełdowej Wielkopolski Bank Kredytowy osiągnął bardzo dobrą miesięczną dynamikę zysków wynoszącą 81,4 proc .	Kredytowy	7	Sing
Załamała się tradycja zbiorowych wystąpień i manifestacji .	zbiorowych	3	Plur
Zapada mrok , bierze lekki przymrozek .	lekki	4	Sing
Obok wspomnianych przedmiotów ścisłych lubi biologię , przykłada się do angielskiego .	angielskiego	10	Sing
Poznań jest właściwie jedynym większym miastem na terenie naszego kraju , na które spoglądały oczy wielkiego poety .	większym	4	Sing
Przedtem włóczyli się po mieście , topniał śnieg , szumiało w rynnach , czuć było powiewy ciepła i zgnilizny , nad dachami tłukły się kłębiaste chmury .	kłębiaste	24	Plur
Śmierć na miejscu poniosła 36-letnia kobieta , która z mężem przechodziła przez Małą Fatrę w rejonie Niskich Tatr .	Niskich	16	Plur
Wielka kanalizacja gminy Tychowa to najnowsza inwestycja tutejszych władz .	tutejszych	7	Plur
Do wytworzenia pary i utrzymywania ognia we właściwej temperaturze służy oddzielny palnik gazowy .	oddzielny	10	Sing
Książę Andrzej Poniatowski , porucznik armii francuskiej , odwiedził Polskę w roku 1919 jako członek francuskiej misji wojskowej .	francuskiej	6	Sing
Podwyżka zmniejszy ponoszone przez spółkę straty .	ponoszone	2	Plur
Nie narzeka na brak pomysłów twórczych .	twórczych	5	Plur
Czyżby jakieś złe moce zawisły nie tylko nad publicznymi mediami , ale również nad Warszawiakami ?	złe	2	Plur
Dom jest własnością pewnej rodziny mieszkającej na stałe w Ameryce .	mieszkającej	5	Sing
Zamierzał wraz z dwoma towarzyszami , którzy czekają w pobliskiej szopie , możliwe najszybciej przedostać się za granicę .	pobliskiej	9	Sing
W próbie tej potrzebujemy pocieszającej pomocy .	pocieszającej	4	Sing
Wykonany z asferycznych soczewek ze szkła fluorytowego , pozwala na uzyskanie bardzo dobrej jakości obrazu .	Wykonany	0	Sing
W turnieju udział wzięli uczniowie szkół podstawowych , gimnazjalnych i ponadgimnazjalnych .	podstawowych	6	Plur
Węże są zwierzętami mało poznanymi , niezwykłymi i fascynującymi .	fascynującymi	8	Plur
Hindusi i ja wybrali śmy się na zielone gołębie .	zielone	7	Plur
Ten okres minnesangu zakończył się w ostatniej dekadzie XII wieku , gdy naśladownictwa ustąpiły nowym tematom i formom wypracowanym przez miejscowych poetów .	miejscowych	20	Plur
Do obserwatorium waszyngtońskiego ściągały tłumy ciekawych .	ciekawych	5	Plur
Do domu weszli przez pomieszczenia gospodarcze , po wyjęciu z futryn okna .	gospodarcze	5	Plur
Ale bycie symbolem nie jest wcale zajęciem lukratywnym .	lukratywnym	7	Sing
Wędrował po Tatrach od 1914 r. , wspinał się od 1924 .	1924	10	Sing
W Centrum Naukowym Wielkich Jezior w amerykańskim Cleveland otwarto wystawę niecodziennych pomocy naukowych dla dzieci .	amerykańskim	6	Sing
Dochodzą niepokojące sygnały dotyczące prywatyzacji stoczni .	niepokojące	1	Plur
Po ich koncercie ludzie przychodzili do mnie i dziękowali , że zaprosiłem tak widowiskową grupę .	widowiskową	13	Sing
Znaczna koncentracja tego gazu w przyziemnej warstwie atmosfery sprzyja więc podwyższaniu temperatury powierzchni Ziemi .	Znaczna	0	Sing
Najciekawiej zapowiada się w Moskwie , gdzie miejscowy Spartak podejmuje Ajax Amsterdam .	miejscowy	7	Sing
Wykonywali różne figury akrobatyczne i gimnastyczne .	akrobatyczne	3	Plur
Kupiono za granicą oranżerie , marmurowe posągi .	marmurowe	5	Plur
Maturzyści - internauci zdający na pisemnym egzaminie język polski i historię najczęściej typują tematy związane z przełomem wieków .	zdający	3	Plur
Jeżeli rząd chce wprowadzać swoje reformatorskie projekty , musi porozumiewać się z prezydentem .	reformatorskie	5	Plur
Słuchawka leżała odłożona na stoliku obok czyjejś niedopitej herbaty .	odłożona	2	Sing
Zaprószono ogień i wybuchł poważny pożar na górnych piętrach .	górnych	7	Plur
W piątek , sobotę i niedzielę będziemy wspólnie świętować 1000-lecie Biskupstwa Wrocławskiego i 1000-lecie Wrocławia .	Wrocławskiego	11	Sing
Ale ci politycy z kolei nie gwarantują przeprowadzenia koniecznych reform gospodarczych .	gospodarczych	10	Plur
Niepalący żyją dłużej .	Niepalący	0	Plur
Ubierał się z wyszukaną , nieco staromodną elegancją .	staromodną	6	Sing
Znał dobrze urzędników gminnych i ich nieskończoną flegmę oraz absolutny brak poszanowania dla czasu bliźnich .	gminnych	3	Plur
Iluż poważnych obecnie pisarzy czytało swe pierwsze próby literackie w sali przy Krupniczej , siedząc wokół dębowych stołów zsuniętych pośrodku .	zsuniętych	18	Plur
Otwierają się tylne drzwi .	tylne	2	Plur
Wśród osób , które nielegalnie przekroczyły wschodnią granicę , było sześciu obywateli Bangladeszu , dwóch Afgańczyków i czterech Kurdów irackich , w tym kobieta z dzieckiem .	irackich	19	Plur
Sterowali ruchem w pobliżu cmentarzy , kontrolowali trzeźwość kierowców poruszających się drogami województwa .	poruszających	9	Plur
" Planowo postępuje dalsze ograniczanie arsenałów atomowych " . . .	atomowych	6	Plur
Jak ta Mirta miała wszystko uporządkowane i przemyślane !	uporządkowane	5	Sing
Czy Saszka robi coś niegodziwego ?	niegodziwego	4	Sing
I zapewne AWS jeszcze może się poszerzać o jakieś ugrupowania prawicowe .	prawicowe	10	Plur
Prowadził też agencję reklamową .	reklamową	3	Sing
Jeszcze w poniedziałek prosił o pomoc wojskową sąsiednie republiki kaukaskie i Rosję .	kaukaskie	9	Plur
- To wypracowuje się na codziennych , mozolnych próbach .	mozolnych	7	Plur
Aresztowanego na 48 godzin mistrza zwolniono po poręczeniu majątkowym .	Aresztowanego	0	Sing
Milion konsumentów nieprzestrzegających zasad koszerności dokonało przełomu na rynku spożywczym .	nieprzestrzegających	2	Plur
Z wolna milkły także widmowe instrumenty .	widmowe	4	Plur
Oddając zużyte elektrolity , które tam będą regenerowane , napełnimy zbiorniki nowymi roztworami .	nowymi	11	Plur
Za najważniejszych nazistowskich zbrodniarzy powszechnie uznawano Hitlera , Himmlera i Goebbelsa .	nazistowskich	2	Plur
Miłość nie jest wzajemną zależnością , ani uzależnieniem .	wzajemną	3	Sing
Pokazuje nam odpowiedni dokument panamski i dwa zaświadczenia .	panamski	4	Sing
Tekst ten jest zniszczony i w wielu miejscach nieczytelny .	nieczytelny	8	Sing
Dwa duże statki zostały zatopione przez powstańców .	zatopione	4	Plur
Myślałem , że pan jest poważnie myślącym młodym człowiekiem .	myślącym	6	Sing
Zerkała na czarno - biały obraz i pogryzała słone paluszki .	słone	8	Plur
Analiza spektrometryczna wykazała , że jego skład izotopowy jest typowy dla procesów reaktorowych , a nie wybuchu jądrowego .	jądrowego	17	Sing
Czołgi i wozy pancerne strzegą więzienia , do którego ciężarówki wojskowe bez przerwy przywożą aresztowanych .	pancerne	3	Plur
Potrząsnął em głową ; połączenie zostało zerwane .	zerwane	6	Sing
Całowała go drobnymi , szybkimi pocałunkami .	szybkimi	4	Plur
Musieli się przebić przez ludzkie gromady idące w przeciwnym kierunku .	idące	6	Plur
- Japońska firma Seiko wprowadziła na rynek pierwszy kwarcowy zegarek na rękę .	kwarcowy	8	Sing
- To coś naturalnego .	naturalnego	3	Sing
Stęknęły sprężyny sąsiedniego łóżka i usłyszał zaspany głos Gerdy .	zaspany	6	Sing
W grudniu 1996 roku Havlovi wraz z górnym płatem prawego płuca usunięto niewielki nowotwór złośliwy .	usunięto	11	Sing
Po długo obowiązującym zakazie , znowu do Japonii przybyli katoliccy misjonarze .	katoliccy	9	Plur
- To nie może wpływać na osoby zainteresowane .	zainteresowane	7	Plur
Później innego uczestnika spotkania znaleziono martwego w jego domu letniskowym pod Belgradem .	letniskowym	9	Sing
Brak drapaczom na Ś-W zaplecza w postaci sklepów spożywczych .	spożywczych	8	Plur
Podobnie jak we współczesnej Japonii , również w Tybecie żywe są dawne herbaciane tradycje , chociaż przyczyny ich kultywowania są zgoła odmienne .	odmienne	21	Plur
Szumiał wiatr w gołych gałęziach drzew .	gołych	3	Plur
- Małą miss została Klaudia Zdunek !	Małą	1	Sing
W rozległej przestrzeni czyśćca spotyka po raz pierwszy Beatrycze .	rozległej	1	Sing
Inne są jakby mniej zaangażowane .	zaangażowane	4	Plur
A cena jest zabójcza .	zabójcza	3	Sing
Pierwsza z wymienionych sygnalizacji pojawi się u zbiegu ulic Gdyńskiej i Piaskowej w Koziegłowach .	wymienionych	2	Plur
- Będzie realizowana jedna polityka uzgodniona na posiedzeniach Rady Ministrów .	realizowana	2	Sing
Od lat siedemdziesiątych coraz większą popularność zdobywa nurt neuroteologiczny .	siedemdziesiątych	2	Plur
Dlatego problem ten musi zostać wnikliwie rozpatrzony , a większość obiektów powinna być bezwzględnie zwrócona społeczeństwu , bo za jego pieniądze zostały wzniesione .	wzniesione	22	Plur
Wiem , że jestem nudna , zalecając rzecz tak oczywistą jak gimnastyka .	oczywistą	9	Sing
Immonen , w czarnych dżinsach welwetowych i w zgniłozielonym golfie , nie zdążył jeszcze zrzucić kożucha .	zgniłozielonym	8	Sing
Z głębin morza dalekich a z bełku przepadłego powrócił , żeby u stopy braterskiej jasne czoło położyć .	dalekich	3	Plur
Był to szybki i emocjonujący mecz .	emocjonujący	4	Sing
- W iluż miastach w okresie letnim odbywa się tyle bezpłatnych występów artystycznych .	bezpłatnych	10	Plur
Jak podały miejscowe rozgłośnie radiowe , wykoleiły się dwa wagoniki podziemnej kolejki .	radiowe	4	Plur
Obaj byli przyjaciółmi Kisiela , więc ich znajomość pojawiła się w sposób naturalny .	naturalny	12	Sing
Alkoholu jeszcze nie podano , popielniczki błyszczały czyste i nie skażone .	skażone	10	Plur
Jego wiarygodność sprawdzono poprzez Krajową Izbę Gospodarczą .	Gospodarczą	6	Sing
- Dlatego nie mogę się doczekać pięknej słonecznej pogody .	pięknej	6	Sing
I tym razem Gagarin zniósł ją ze stoickim spokojem .	stoickim	7	Sing
Wykop i południowe baraki są w jednej linii .	południowe	2	Plur
Przedostatni figuruje Artur Balazs , poseł i minister rolnictwa , a zamyka ją Stefan Oleszczuk z UPR-u , starosta kamieński .	Przedostatni	0	Sing
Biedny ptak , z szeroko otwartym dziobem , zwisał głową w dół , niby ułamana z krzewu kiść .	Biedny	0	Sing
Ranni żołnierze zostali przewiezieni do szpitala w Białogardzie .	Ranni	0	Plur
Rumuński parlament odrzucił rządowy projekt ustawy przewidujący likwidację kar za homoseksualizm .	przewidujący	6	Sing
Zaczął się już najwcześniejszy letni ranek .	najwcześniejszy	3	Sing
Pieniądze muszą być przeznaczone na konkretne zadania .	przeznaczone	3	Plur
Ksiądz zajął fotel dyrektora , oparł o brzeg biurka splecione dłonie , czekał .	splecione	9	Plur
W wyposażeniu podstawowym znajduje się również ABS .	podstawowym	2	Sing
Ewentualna ratyfikacja Konkordatu przed przyjęciem nowej konstytucji zaważyłaby zapewne na jej ostatecznym brzmieniu , odbierając Konstytucji RP charakter nowoczesnej ustawy zasadniczej demokratycznego państwa .	zasadniczej	20	Sing
Tam dyżurna kosmetyczka obejrzy pani cerę , udzieli porady i wskaże , jakie mleczko będzie najwłaściwsze , a może jeszcze doradzi jakiś krem .	najwłaściwsze	15	Sing
Nagle wzdrygnął się spojrzawszy w straszną twarz topielca i szybko poszedł dalej .	straszną	5	Sing
Członkowie nakielskiego stowarzyszenia podczas spotkania omówili główne cele swojej działalności .	nakielskiego	1	Sing
Na kolację , oprócz gulaszu , był chleb i masło , a do masła dodano nóż .	dodano	14	Sing
Na tegorocznym inauguracyjnym balu tradycyjnego karnawału w Rio pracowały równolegle dwie komisje sędziowskie .	tegorocznym	1	Sing
Są oni gorąco pozdrawiani przez zgromadzone na trasie tłumy .	pozdrawiani	3	Plur
W piątek i sobotę tylko w Chicago zmarło na skutek gorąca dalszych 26 osób .	dalszych	11	Plur
Tematyka prac twórcy z Jarantowic jest różnorodna i w poważnym stopniu zależy od zapotrzebowania , od zamówień odbiorców .	różnorodna	6	Sing
Jeśli to jest absolutnie niemożliwe , znaczy to , że twój charakter jest czymś pośrednim pomiędzy dwoma opisanymi w rozwiązaniu przy odpowiednich numerach .	odpowiednich	21	Plur
Przegląd najistotniejszych badań alokacji podatku dochodowego zamieszczono w następnym punkcie niniejszego rozdziału .	zamieszczono	6	Sing
Wspieramy bezpieczną aborcję .	bezpieczną	1	Sing
Obecnie tworzą się struktury regionalne związku .	regionalne	4	Plur
Jego spojrzenie , przed chwilą spłoszone , było teraz śmiałe i podstępne .	podstępne	11	Sing
Albo sami z ochotą wplątywali się w lokalne wojenki i rebelie .	lokalne	7	Plur
W kierunku zachodnim przewożono ich mercedesem .	zachodnim	2	Sing
W Polsce wyniki leczenia nowotworów dlatego są dwukrotnie gorsze od uzyskiwanych na Zachodzie , ponieważ na terapię trafiają chorzy przeważnie już z zaawansowanym guzem .	uzyskiwanych	10	Plur
Praca pedagogiczna na uniwersytecie japońskim różni się znacznie od pracy na uniwersytecie europejskim .	pedagogiczna	1	Sing
Widział em też węże na drodze , przejechane przez samochody .	przejechane	7	Plur
Partie polityczne oraz reprezentujący ich politycy stanęli w wyborcze szranki .	reprezentujący	3	Plur
Do akcji plebiscytowej włączają się działy sportowe poszczególnych gazet .	poszczególnych	7	Plur
Włoski rząd na nadzwyczajnym posiedzeniu przeznaczył wczoraj 50 milionów euro dla dotkniętego trzęsieniem ziemi regionu .	dotkniętego	11	Sing
Slezinger korzysta w swej pracy z wielu formuł matematycznych i cybernetycznych .	matematycznych	8	Plur
Nie orientował się też , że popełnia przestępstwo dewizowe .	dewizowe	8	Sing
Policjanci z Pieniężna od dawna szykowali się do akcji przeciwko miejscowym kłusownikom .	miejscowym	10	Plur
Ale po pierwsze czuł się głęboko skompromitowany , a po drugie wydawało się wątpliwe , żeby mógł jeszcze coś w tamtym środowisku osiągnąć .	skompromitowany	6	Sing
Dama klozetowa łagodnieje .	klozetowa	1	Sing
Mimo tak dużych możliwości EMG , czasem nie udaje się na jej podstawie postawić trafnej diagnozy .	dużych	2	Plur
Delfina w herbie ma Szkoła Policealna Pracowników Służb Socjalnych w Poznaniu .	Policealna	5	Sing
Czy wybór między czołowymi producentami nart jest istotny dla wyniku , czy to tylko kwestia pieniędzy ?	czołowymi	3	Plur
IZABELLE ADJANl , gwiazda filmu francuskiego , wygrała precedensowy proces .	precedensowy	8	Sing
Pokazuje nam odpowiedni dokument panamski i dwa zaświadczenia .	odpowiedni	2	Sing
Książęta kijowscy tracili podstawy gospodarcze swej pozycji politycznej .	kijowscy	1	Plur
Był by m siódmy lub ósmy w kolejce .	ósmy	5	Sing
Tutaj także zostały podmyte piwnice domów .	podmyte	3	Plur
Zdaniem lekarzy , szpitale cierpiące na brak pieniędzy podejmują drastyczne programy oszczędnościowe .	oszczędnościowe	11	Plur
Groźni faszyści są bezkarni , bo stronę założyli na amerykańskim serwerze .	Groźni	0	Plur
Czy nasze indywidualne cele pokrywają się z celem grupy jako całości ?	indywidualne	2	Plur
Po wizycie papieża płyty mają zostać zwrócone powiatowi kartuskiemu .	zwrócone	6	Plur
Słone przekleństwa dolatywały aż do ostatniego wozu .	Słone	0	Plur
Panowie nie mieli najmniejszych problemów z dziwnie skleconą reprezentacją Reszty Świata , panie też gładko wygrały z osłabioną ekipą USA .	skleconą	7	Sing
Drwale ściągali już z roboty do swoich rzeczy leżących przy drodze .	leżących	8	Plur
Ekspozycja zawiera kilkaset zdjęć przedstawiających życie codzienne ludzi w NRD .	codzienne	6	Sing
Młody Goethe i twórca drugiej części Fausta to bardzo odmienne postacie ?	drugiej	4	Sing
Oddaję się niecnym praktykom .	niecnym	2	Plur
Statut może przewidywać , że członkowi przysługuje prawo do działki przyzagrodowej .	przyzagrodowej	10	Sing
Ciągnął je ukryty wewnątrz drewnianego pudła muł .	ukryty	2	Sing
Małe oczki króla zamigotały złowrogo .	Małe	0	Plur
Przerwali terapię we Mstowie i w krótkim czasie zmarli z powodu narkotycznego przedawkowania .	narkotycznego	11	Sing
Podkreśla się , ze był on najlepszym rozgrywającym ligi i ojcem dominacji Chicago Fire w rozgrywkach grupowych .	grupowych	16	Plur
Do mieszkania Desselbergerów trafiają ptaki z połamanymi skrzydłami , przemarznięte , wyczerpane .	połamanymi	6	Plur
Małżonka dyplomaty przez 13 lat była nauczycielką w szkole podstawowej .	podstawowej	9	Sing
Nie mogła się mylić , bo odbite od łez światło dawało wyraźny błysk .	wyraźny	11	Sing
To jeden z najdroższych sylwestrów na Mazowszu .	najdroższych	3	Plur
Przed wejściem do parku wszyscy zostali wyposażeni w lornetki .	wyposażeni	6	Plur
U siebie pozwolił zainstalować to modne urządzenie jedynie w kuchni i w wozowni .	modne	5	Sing
A znamy i dawniejsze .	dawniejsze	3	Plur
Tom Spencer posiadał przy sobie pisma pornograficzne i kasety video dla homoseksualistów oraz marihuanę .	pornograficzne	6	Plur
O reklamowej działalności prezydenta mówią członkowie Sejmowej Komisji Etyki Poselskiej .	Poselskiej	9	Sing
Kaczyńscy i ich główni zausznicy są postrzegani jako politycy niebezpieczni , nieobliczalni .	nieobliczalni	11	Plur
Pragnę nadmienić , że nie wszystkie marzenia i oczekiwania wywołują sny odwrotne .	odwrotne	11	Plur
Chce wynająć salę na sobotę , żeby polska młodzież maturalna spotkała się z przedstawicielami szkół wyższych oraz Ministerstwa Nauki .	maturalna	9	Sing
Powołanie Semaka wzburzyło pracowników opolskiej rozgłośni .	opolskiej	4	Sing
Polska jest etnicznie jednorodna , heteroseksualna , katolicka i wolnorynkowa .	jednorodna	3	Sing
I znowu zapadła minuta denerwującej ciszy .	denerwującej	4	Sing
Szczególne podziękowania kierujemy do rodziców naszych wychowanków .	Szczególne	0	Plur
Zresztą francuzica niepotrzebnie wylicza kunsztowne potrawy , bo generał lubi tylko prostą kuchnię .	kunsztowne	4	Plur
Jedenaście dni po pojawieniu się opisanej wizji sennej czar zaczął działać .	opisanej	5	Sing
Czy ta wasza przyjaźń została nazwana , wyznana ?	wyznana	7	Sing
Na szczęście czarne prognozy naszego fantastyka pozostają odosobnione .	odosobnione	7	Plur
W Fundacji można też uzyskać wyczerpujące informacje na temat fachowej opieki nad kotami domowymi .	fachowej	9	Sing
Znaleźli jeszcze jedną taśmę z nagraniami z rajdu .	jedną	2	Sing
Wodzi oczyma po stojących postaciach .	stojących	3	Plur
WDT jest państwową jednostką organizacyjną nieposiadającą osobowości prawnej .	prawnej	7	Sing
Żeby skutecznie leczyć żywych , trzeba się uczyć na martwych .	martwych	9	Plur
Dystychy , analizowane dotąd oddzielnie , złóżmy obecnie w całość , bo przecież w Dusiołku tworzą one taką całość .	analizowane	2	Plur
- Powiewy bliskich gór przyniosły mu buntownicze słowa chłopskiej pieśni , zasłyszanej w dzieciństwie .	bliskich	2	Plur
Zmarł w Livorno w roku 1846 .	1846	5	Sing
Powołał do życia Centralne Biuro Śledcze .	Śledcze	5	Sing
– no ukradł mi ten zbój ruski . .	ruski	6	Sing
I to wszystko było dobre i znajome , potrzebne i pożyteczne .	znajome	6	Sing
Policja identyfikowała ofiary na podstawie znalezionych przy nich przedmiotów osobistych .	znalezionych	5	Plur
To jest złe myślenie .	złe	2	Sing
W innych spotkaniach towarzyskich uzyskano następujące wyniki .	następujące	5	Plur
Proszowiccy strażacy wyjeżdżali w ostatnim czasie do dwóch pożarów , spowodowanych prawdopodobnie przez podpalaczy .	Proszowiccy	0	Plur
– bo to jest sympatyczna impreza . .	sympatyczna	4	Sing
Tak często są postrzegane szkoły niepubliczne .	niepubliczne	5	Plur
Transmisja z jego strony szła przez dwa serwery anonimizujące , mógł przebywać w dowolnym miejscu na Ziemi .	dowolnym	13	Sing
Skarżył się jej przecież , że w kieracie prozaicznych zajęć , wśród ludzi zajętych tylko sprawami chleba powszedniego , brak mu rozmów na poważne tematy .	prozaicznych	8	Plur
Moi kontrkandydaci reprezentują określone partie polityczne i tylko te partie .	określone	3	Plur
W marcu dostał ostatnią wypłatę .	ostatnią	3	Sing
Młodzi modele krakowskiej ASP pozują , zdaniem Marty , przede wszystkim z powodów finansowych .	finansowych	13	Plur
Mankamentem rundy wiosennej były mecze wyjazdowe Obry .	wyjazdowe	5	Plur
Wczesnym popołudniem polska delegacja udała się do Warny .	Wczesnym	0	Sing
Saperzy wydobyli we wtorek sześć artyleryjskich pocisków burzących z czasów II wojny światowej , odkrytych na terenie budowy na krakowskim Prądniku Czerwonym .	krakowskim	19	Sing
Konsjerżka , jak większość konsjerżek Portugalka , szorowała chodnik i mury ryżową szczotką .	ryżową	11	Sing
A już na pewno z racji tej uczoności w 1456 roku dostał katedrę teologii , na której pozostał do końca dni swoich .	1456	9	Sing
Kościański zespół przegrał je wszystkie za wyjątkiem derbowego występu w Rawiczu .	derbowego	7	Sing
Na klatce schodowej domu u zbiegu Alei Jerozolimskich i Nowego Światu skoczył z wysokości trzeciego piętra .	Jerozolimskich	7	Plur
Bez niego cisza staje się martwa , sieroca .	sieroca	7	Sing
- Odezwał się po chwili zmartwionym głosem Tomaszewski .	zmartwionym	5	Sing
Musimy pracować , wziąć się do uczciwej pracy . . .	uczciwej	6	Sing
my byli śmy pod to podpinani . .	podpinani	5	Plur
Dolną część garderoby osłaniamy papierowymi ręcznikami , aby nie pobrudzić jej później jajkami .	papierowymi	4	Plur
Czy to ta niemoc grzybowa zwiastowała ?	grzybowa	4	Sing
Korespondenci budapesztańskich gazet donoszą , że wielu miejscowych Węgrów wyjechało do krewnych na wieś albo uciekło na Węgry .	budapesztańskich	1	Plur
Z głębin morza dalekich a z bełku przepadłego powrócił , żeby u stopy braterskiej jasne czoło położyć .	jasne	14	Sing
Właśnie zakończył się trzeci , diecezjalny etap konkursu .	trzeci	3	Sing
W uliczce nie ma żywego ducha .	żywego	4	Sing
Parkowanie na wyznaczonych miejscach wymaga posiadania karty parkingowej .	wyznaczonych	2	Plur
Na wczasy jeżdżą osoby nietrendowe .	nietrendowe	4	Plur
Rozbity samochód trafił na policyjny parking .	policyjny	4	Sing
W wózku wiozła 13-miesięcznego synka .	13-miesięcznego	3	Sing
Uczymy ich na kursach ogólnych i specjalistycznych .	ogólnych	4	Plur
Najwięcej pochłoną inwestycje w oświacie , drogowe , wodociągowe i proekologiczne .	proekologiczne	10	Plur
We włosach rudych widział boży ogień .	boży	4	Sing
Nazirejczycy nie pili wina , nie strzygli włosów , nie spożywali rytualnie nieczystych potraw i nie mogli dotykać zmarłych .	nieczystych	12	Plur
Jeden z mężczyzn przystąpił do majstrowania przy kablach telefonicznych .	telefonicznych	8	Plur
Już widze Opłatek w kulinarnej oprawie Hejrublańskiego !	kulinarnej	4	Sing
Parówki gotowane we wrzątku i podawane wprost z rondla bierze się na talerz i usuwa błonę , w której były gotowane .	podawane	5	Plur
- Jednostki budżetowe nie są osobami prawnymi , Panie Senatorze .	budżetowe	2	Plur
Z konarów i pni wyczarowywał dziwne figury przywołujące na myśl słowiańskich bogów .	przywołujące	7	Plur
Górnicze związki zawodowe domagają się , wbrew stanowisku resortu gospodarki , wypłaty nagród z ubiegłorocznych zysków spółek węglowych .	węglowych	17	Plur
– Płynie ogromny transport z demograficznym wyżem .	ogromny	2	Sing
Rzecznik praw obywatelskich poprosił o wyjaśnienia Ministerstwo Zdrowia .	obywatelskich	2	Plur
Bóg nigdy nie karał sam występujących przeciwko niemu .	występujących	5	Plur
nie mamy takiej sytuacji militarnej .	militarnej	4	Sing
Perski czador czy afgańska burka stawały się politycznym manifestem .	politycznym	7	Sing
Podczas niemieckiej okupacji spotykaliśmy się , należąc do podziemnej literackiej Warszawy .	niemieckiej	1	Sing
Nad placem przeleciały myśliwce naddźwiękowe .	naddźwiękowe	4	Plur
Amerykanie rzeczywiście zrobili śliczny manewr pancerny .	śliczny	3	Sing
Mimo obietnic złożonych pacjentom , stwardnienia rozsianego nadal nie ma na liście chorób przewlekłych .	przewlekłych	13	Plur
W uroczystości uczestniczyli wierni w kolorowych łowickich wełniakach .	łowickich	6	Plur
Są już nawet zaczernione sufity ?	zaczernione	3	Plur
Pani Jadwiga trzynaście lat temu kupiła w Arciechowie działkę ze starym domostwem .	starym	10	Sing
Angelina Jolie jest bezgranicznie zakochana w swoim adoptowanym synku , który niedawno urodził się w Kambodży .	adoptowanym	7	Sing
W XVII wieku hikyaku , czyli kurierzy , doręczali przesyłki feudalnym władcom .	XVII	1	Sing
Przybysze z najnowszej fali na ogół stronią od polonijnych organizacji społecznych .	polonijnych	8	Plur
Postęp techniczny dosięgnął także brytyjskich amatorów herbaty .	brytyjskich	4	Plur
W poniedziałek we wczesnych godzinach popołudniowych podano , że zdołano uratować siedemset dwadzieścia dwie osoby .	popołudniowych	5	Plur
To jest zabawne ?	zabawne	2	Sing
To będzie najpewniejszy dowód .	najpewniejszy	2	Sing
Mimo realizacji wielu programów adresowanych do osób niepełnosprawnych oraz możliwości zakupu sprzętu rehabilitacyjnego , nadal dla wielu osób problemem jest zdobycie wózka inwalidzkiego .	adresowanych	4	Plur
Obstawił się własnymi ochroniarzami i policjantami .	własnymi	2	Plur
Do tej pory wyroby spółdzielni nigdy nie były eksportowane poza kraje europejskie .	europejskie	11	Plur
Odcinali go z najmłodszym synem .	najmłodszym	3	Sing
W Kcyni odbyło się spotkanie z kandydatami na kierowników na samodzielny publiczny zakład opieki zdrowotnej w Kcyni i Kowalewku .	samodzielny	10	Sing
Kierowca widział w rękach J . długi zakrwawiony nóż .	długi	6	Sing
Także on został uznany za winnego .	uznany	3	Sing
- Czy praca jest pańską pasją ?	pańską	4	Sing
Podzieli ona Twoje nadzieje i zaproponuje wspólne plany .	wspólne	6	Plur
Jadwiga Melnyk przeszła w człuchowskim szpitalu dwa zabiegi .	człuchowskim	4	Sing
Otworzył usta i siedział w najwyższym osłupieniu .	najwyższym	5	Sing
A teraz , przez tę ciążę , jesteśmy uziemieni .	uziemieni	8	Plur
Zasadzka była starannie przygotowana .	przygotowana	3	Sing
- Mały czupurny kapral Patejuk gorącym szeptem dmuchał Marczakowi w ucho .	gorącym	5	Sing
By wdrożyć projektowany przez rząd nowy system taniego budownictwa mieszkaniowego , konieczne jest szybkie wyszkolenie kadr .	mieszkaniowego	9	Sing
Pierwszy dzień kalendarzowej wiosny przebiegł w Kielcach spokojnie .	kalendarzowej	2	Sing
Kiedy miałam pięć lat , posłano mnie do szkoły .	posłano	5	Sing
Papierową śmierć zafundowali śmy już kilku osobom .	Papierową	0	Sing
Doświadczenia laboratoryjne wykazały , że gąsienice motyli monarchów , karmione transgeniczną żywnością , miały kłopoty ze zdrowiem .	laboratoryjne	1	Plur
Byłem przyzwyczajony do dość dużej samodzielności .	dużej	4	Sing
Całość w formie tekstowej zostanie opublikowana po autoryzacji .	tekstowej	3	Sing
Uparci i bezkompromisowi , jednych przerażali , innych zachwycali .	bezkompromisowi	2	Plur
O godzinie dziewiątej rewiry były już zapchane .	dziewiątej	2	Sing
Na dachu paliła się 81-letnia kobieta .	81-letnia	4	Sing
- Pokręciła m głową i spojrzała m na nią z prawdziwym zachwytem .	prawdziwym	10	Sing
Niedługo po tym apelu Kamiński , Wołek i Jurek spotkali się na podwieczorku u krzywdzonego Pinocheta .	krzywdzonego	14	Sing
Trzeba przede wszystkim dużo inwestować w nowoczesny park maszyn .	nowoczesny	6	Sing
Szybsze topnienie brzegów lodowca kompensowane jest przez zwiększone opady w środku kontynentu .	kompensowane	4	Sing
Z jego przepalonego i odsłaniającego rusztowanie kręgów gardła wydobył się syk .	odsłaniającego	4	Sing
Tymczasem w liceach prowadzonych przez Społeczne Towarzystwo Oświatowe zdanie egzaminu dojrzałości nie należy do najłatwiejszych .	Oświatowe	7	Sing
Wszelkie informacje podane poniżej dotyczą jedynie wypadków sprawdzonych .	sprawdzonych	7	Plur
Kolejne inwentaryzacje dowodzą , że na półkach biblioteki brakuje kolejnych tytułów .	Kolejne	0	Plur
Przy kościele spoczywają powstańcy z 1831 i 1848 .	1831	5	Sing
Dodawał też , że korzystał z jawnych źródeł .	jawnych	6	Plur
To jest druga z niepodważalnych prawd węglowych .	niepodważalnych	4	Plur
Wiele zbrodni nigdy nie zostało ujawnionych .	ujawnionych	5	Plur
Różnymi technikami były również nanoszone poszczególne rysunki .	Różnymi	0	Plur
- Odważna staję się na scenie , pod wpływem muzyki .	Odważna	1	Sing
Romantycznym bohaterom odpowiada szatańska wersja pieśni .	szatańska	3	Sing
Tylko w minioną sobotę w atakach terrorystycznych w Bagdadzie zginęło ponad 40 osób .	minioną	2	Sing
Rozpuszcza się w roztworach cyjanków metali alkalicznych .	alkalicznych	6	Plur
wreszcie są upragnione .	upragnione	2	Plur
Nie są przeprowadzane bezpośrednio na ludziach .	przeprowadzane	2	Plur
Wystarczy wpłacić pieniądze na specjalne konto .	specjalne	4	Sing
Pamiętam w Iveronie w sześciu gablotach stłoczone największe relikwie .	stłoczone	6	Plur
Samoloty USA startowały z baz w Wietnamie południowym i lotniskowców Siódmej Floty .	Siódmej	10	Sing
Nawet kiedy sami tego żądają .	sami	2	Plur
- Jestem biedny i nie stać mnie na telefon .	biedny	2	Sing
Na jego otwarcie zjechali się przedstawiciele PSP w Warszawie , władze gminne , powiatowe oraz państwowe .	państwowe	15	Plur
Powiadają , że to obmierzłe plugastwo . . .	obmierzłe	4	Sing
Mniej zadowoleni będą narciarze .	zadowoleni	1	Plur
Nie przewidywały , że na własnej piersi wyhodują sobie takiego gada .	własnej	5	Sing
W skład Grupy wchodzą firmy i ludzie powiązani z interesami postkomunistów .	powiązani	7	Plur
Aminokwasy zawierające siarkę są niezbędne dla prawidłowej syntezy keratyny , która jest podstawowym składnikiem włosów i paznokci .	niezbędne	4	Plur
Marian patrzył prosto na mnie swymi dziecinnie niebieskimi oczami .	niebieskimi	7	Plur
Szczegółowo analizowane są zapisy z kamer monitorujących , które znajdują się na terenie Kwidzyna .	monitorujących	6	Plur
Wydawało się , że fiskus nie będzie dłużej gnębił Waldemara Gronowskiego , legnickiego piekarza , który przez ponad 10 lat rozdawał pieczywo najuboższym .	legnickiego	12	Sing
– Dziennikarze wmówili sądowi i ludziom , że Róża musi wrócić do biologicznych rodziców .	biologicznych	12	Plur
Miał przekrwione oczy i nabrzmiałą twarz .	przekrwione	1	Plur
A w takim wypadku , zwykle polega się na instynktownym własnym przekonaniu .	instynktownym	9	Sing
- W iluż miastach w okresie letnim odbywa się tyle bezpłatnych występów artystycznych .	artystycznych	12	Plur
Iluż poważnych obecnie pisarzy czytało swe pierwsze próby literackie w sali przy Krupniczej , siedząc wokół dębowych stołów zsuniętych pośrodku .	dębowych	16	Plur
Najtragiczniejszy był czwartek .	Najtragiczniejszy	0	Sing
Rozmawiają o tamilskich i hinduskich filmach .	tamilskich	2	Plur
Aby właściwie odebrać myśli autora , wskazane jest odpowiednie przygotowanie matematyczne .	wskazane	6	Sing
W oddzielnych grupach ćwiczą panie i panowie , później znów spotykają się i odbywają wspólnie zajęcia choreograficzno - taneczne .	oddzielnych	1	Plur
Do atrakcyjnej pani bosman podchodzi zniecierpliwiony wczasowicz .	atrakcyjnej	1	Sing
Podlaska Agencja Restrukturyzacji i Modernizacji Rolnictwa opracowała specjalną instrukcję dla parafii .	Podlaska	0	Sing
Był em w mieście , w górach ceglastych .	ceglastych	7	Plur
Długo oczekiwana wiosna przyjdzie do nas już jutro !	oczekiwana	1	Sing
Uszanowanie i respekt przed Bogiem są bardzo mocno zaakcentowane w doświadczeniu proroków .	zaakcentowane	8	Plur
Cały Boguszów trzęsie się z oburzenia .	Cały	0	Sing
Policjanci z pobliskiego komisariatu przyznają , że docierają do nich sygnały o rozbojach .	pobliskiego	2	Sing
Z 13 do 27 zwiększa się w Łodzi liczba opiekunów , przeprowadzających dzieci idące na lekcje przez najruchliwsze jezdnie i skrzyżowania .	idące	13	Plur
Delegacja polska stanowczo odrzuciła nową propozycję .	nową	4	Sing
Swoboda w tej dziedzinie umożliwia zakładanie spółek , prowadzenie przedsiębiorstw , uprawianie wolnych zawodów .	wolnych	12	Plur
Jesteś zalotna .	zalotna	1	Sing
Ważnym elementem samowychowującym jest nauka szkolna .	szkolna	5	Sing
O tym wyniku napisały nawet światowe agencje prasowe .	światowe	5	Plur
Kobiety mogą poruszać się poza domem wyłącznie w towarzystwie krewnego płci męskiej .	męskiej	11	Sing
Do oficjalnych transportów robotnicy dorzucali swoje ładunki .	oficjalnych	1	Plur
W szybkim tempie spijało rosę .	szybkim	1	Sing
Zapraszam do comiesięcznej lektury i do następnego konkursu .	następnego	6	Sing
Niewielka szansa , prawdopodobnie obaj żołnierze strzelą i któryś z nich musi trafić .	Niewielka	0	Sing
W Polsce przedwrześniowej mieli śmy jedynie 600 zelektryfikowanych wsi .	przedwrześniowej	2	Sing
Wanilii brak , ale cukry waniliowe znakomicie ją zastąpią .	waniliowe	5	Plur
Dopiero następnego dnia wieczorem ruszył w powrotną drogę .	następnego	1	Sing
Na szczęście , polichlorek winylu jest już stosowany na znacznie mniejszą skalę , a wyroby z niego są wyraźnie oznakowane .	oznakowane	19	Plur
Ewakuowano 200 gości hotelowych .	hotelowych	3	Plur
- Najdalej za rok będzie się stawał coraz młodszy .	młodszy	8	Sing
Nie można w ekspresowym tempie kształtować podstawowych zasad prawnych .	prawnych	8	Plur
Wrześniowe wybory zmieniły polityczny układ parlamentu .	Wrześniowe	0	Plur
Wykorzystując przerwę w popołudniowych grach , Agassi i Graf zrobili sobie małą sesję treningową .	popołudniowych	3	Plur
A ojciec był zazdrosny .	zazdrosny	3	Sing
Na obszarach łąk zielonych wstają białe smugi , a poprzez ich długie przędziwa wesoło trzepie się rzeka .	zielonych	3	Plur
Czy Szanowni grupowicze mogli by mi pomóc .	Szanowni	1	Plur
Jak dotąd , ani Państwowe Koleje Linowe , ani straż miejska , ani policja nie potrafiły poradzić sobie z konikami .	Linowe	6	Plur
Tam skrzyżowanie przypominało wzburzone jezioro .	wzburzone	3	Sing
Z przykrością stwierdzam , że zawiera on nieprawdziwe informacje .	nieprawdziwe	7	Plur
Przy ośrodkach będzie się prowadzić także punkty apteczne .	apteczne	7	Plur
Z każdym rokiem ruch osobowy i towarowy na przejściu granicznym w Chyżnem rośnie .	towarowy	6	Sing
Górnicze związki zawodowe domagają się , wbrew stanowisku resortu gospodarki , wypłaty nagród z ubiegłorocznych zysków spółek węglowych .	Górnicze	0	Plur
15 naukowców uczestniczących w sesji otrzymało pamiątkowe medale wybite z okazji jubileuszu .	wybite	8	Plur
Też dotyczył duchownego , choć był dużo mocniejszy i tam ofiara była całkowicie niewinna .	niewinna	13	Sing
Równie interesujące były programy przygotowane przez uczniów z pozostałych miejscowości .	interesujące	1	Plur
Wysokich drabin warszawska straż rzeczywiście nie ma .	Wysokich	0	Plur
Jakie są choroby zawodowe ?	zawodowe	3	Plur
Z drugiej strony oskarżyciel potwierdza , że on sam w czasach próby był inny i pozostał inny .	drugiej	1	Sing
Na placach poczęły gromadzić się grupy przechodniów z zadartymi do góry głowami .	zadartymi	8	Plur
Podwyżki zostaną wypłacone dzięki ustawie , którą uchwalił Sejm poprzedniej kadencji .	wypłacone	2	Plur
W krem wcisnąć osączone i pokrojone ananasy .	osączone	3	Plur
Następnie chcieli przejechać interweniujących policjantów .	interweniujących	3	Plur
Syna Włodzimierza Olewnika porwano jesienią 2001 r .	porwano	3	Sing
Była to sprawa górna i patetyczna .	patetyczna	5	Sing
Uważano więc w partii , że Gierek , po antrakcie Ochaba , powrócił do praktyki niszczenia poprzedników przez następców .	Uważano	0	Sing
Wszyscy jednak potwierdzają , że Buzek i Krzaklewski od lat darzą się absolutnym zaufaniem i przyjaźnią .	absolutnym	12	Sing
Istnieje jednak dość istotna różnica w podejściu do tego problemu .	istotna	3	Sing
Pomimo smutnej wymowy , sztuka obfituje w sceny humorystyczne , można również posłuchać piosenek Wasowskiego i Przybory .	humorystyczne	8	Plur
Do 1995 roku francuscy przedsiębiorcy mogli legalnie dotować partie polityczne .	francuscy	3	Plur
W całym województwie odbywają się liczne imprezy artystyczne i sportowe .	sportowe	9	Plur
Przez tereny parku wiodą 44 szlaki turystyczne piesze i 10 narciarskich .	turystyczne	6	Plur
Jest także wspólnota terytorialna , kulturowa i polityczna .	kulturowa	5	Sing
- Nie pozwolił jej skończyć , pocałował w usta , ale w tej chwili za oknem rozległ się dźwięk klaksonu , niespodziewany i głośny .	głośny	23	Sing
Prace polowe szybko postępują naprzód .	polowe	1	Plur
Ranni to czterej polscy żołnierze , dwóch żołnierzy salwadorskich i tłumacz .	salwadorskich	8	Plur
Nie sądzę , by był w waszym czarnym strumyku .	czarnym	7	Sing
Finansowo wspiera Trutnia Gminny Ośrodek Kultury w Rabie Wyżnej , a także skawiańscy biznesmeni z Polski i Chicago .	Wyżnej	8	Sing
Izydor znieruchomiał z kopiowym ołówkiem nad blankietem reklamacyjnym .	reklamacyjnym	7	Sing
Zdarza się , że ich sprawcy z powodu przedawnienia w ogóle nie zostają osądzeni .	osądzeni	13	Plur
Partnerem Trzebini będzie zachodnioukraińskie miasto Sokal .	zachodnioukraińskie	3	Sing
Zwolennicy Mossadegha , ministrowie , podejrzani oficerowie , działacze Tudeh są przesłuchiwani i torturowani .	podejrzani	5	Plur
Płatki owsiane zalać wodą do napęcznienia .	owsiane	1	Plur
Układy ACC technologiczne stosuje się przede wszystkim do obróbki zgrubnej w celu maksymalizacji wydajności obróbki .	technologiczne	2	Plur
Chmury rozsunęły się na moment , odsłaniając wytarty miedziak słońca .	wytarty	7	Sing
Dziś , po odkryciach Zygmunta Freuda , to zapomniane w średniowieczu dziedzictwo wchodzi do naszej codzienności i znajduje w niej swoje miejsce .	zapomniane	8	Sing
- Ważne są opinie ludzi mówiące o pozostawieniu miejskiej komunikacji .	mówiące	5	Plur
jest na niej 250 szopek nigdy dotąd poza Betlejem niepokazywanych .	niepokazywanych	9	Plur
Uczniowie są tym przedsięwzięciem bardzo zainteresowani .	zainteresowani	5	Plur
- Towarzyszył temu jakiś program ideowy ?	ideowy	5	Sing
Już po raz drugi oglądam tę chorobę w działaniu .	drugi	3	Sing
Wejdźcie więc do podziemnych lochów pełnych zasadzek i niespodzianek .	podziemnych	3	Plur
Pomyślałem o tych wielkich smutnych oczach , w których musimy się tak ładnie odbijać .	smutnych	4	Plur
Podłączyliśmy go do sztucznych komór , czekał na dawcę .	sztucznych	3	Plur
Słońce wyrwało się z pęt horyzontu i zaczęło uwalniać dusze z martwych ciał żołnierzy .	martwych	11	Plur
Współczesne trendy cywilizacyjne sprzyjają siłom zła , lecz dobro nie odpuszcza .	cywilizacyjne	2	Plur
Wszelkie informacje podane poniżej dotyczą jedynie wypadków sprawdzonych .	podane	2	Plur
Dlaczego wymyśliła to nieślubne dziecko ?	nieślubne	3	Sing
To jest ciągły proces .	ciągły	2	Sing
Ale widzisz , mnie chodzi o coś innego .	innego	7	Sing
Powyższą koncepcję w latach późniejszych rozwinął zespół meteorologów norweskich .	norweskich	8	Plur
Jeszcze przez kilka minut starali się uporać z doznaną porażką i dramatyczną decyzją Beatki .	doznaną	8	Sing
Do Tczewa przyjechały głównie najbardziej popularne koty rasowe .	rasowe	7	Plur
Ponoszę porażki , niepowodzenia wychowawcze .	wychowawcze	4	Plur
Rok funkcjonowania wyższych szczebli samorządów nie upoważnia jeszcze do ocen .	wyższych	2	Plur
Surowy , suchy klimat , huraganowe wiatry oraz nieurodzajność gleb spowodowały , że odkryta w 1520 roku przez Magellana Patagonia długo nie była kolonizowana przez Europejczyków .	huraganowe	5	Plur
Od 1993 r . jest kierownikiem Zakładu Współczesnych Teorii Ekonomicznych , a od 1999 r . pełni funkcję dziekana Wydziału Ekonomiczno - Socjologicznego Uniwersytetu Łódzkiego .	Współczesnych	7	Plur
- Zgromadziliśmy tu najstarsze i najładniejsze kostiumy .	najstarsze	3	Plur
Upragnioną miłość zanurzyłeś w najpodlejszym , cuchnącym bagnie .	Upragnioną	0	Sing
Napięta żyłka świsnęła i pękła w przeponie .	Napięta	0	Sing
Właściwie nie była głodna .	głodna	3	Sing
" W dzieciństwie byłem często rozpieszczany przez mamę , ale tato mnie lał " .	rozpieszczany	5	Sing
Po dobranocce najmłodsze idą spać .	najmłodsze	2	Plur
- Człowiek jest omylny , ale dusza jest nieomylna .	omylny	3	Sing
Do mieszkania Desselbergerów trafiają ptaki z połamanymi skrzydłami , przemarznięte , wyczerpane .	wyczerpane	11	Plur
" Zła organizacja pracy powoduje przede wszystkim brak prawidłowej i dobrej kontroli przełożonych nad podwładnymi " .	Zła	1	Sing
Ranny został operator Jerzy Ernst .	Ranny	0	Sing
Podchodzi do głównych drzwi wejściowych , by wpuścić dwie kobiety .	głównych	2	Plur
Od trzeciego rozbioru Polski do odzyskania niepodległości minęły 123 lata .	trzeciego	1	Sing
Dziś zdecydowana większość spółek notowanych na giełdzie chce podwyższać swój kapitał .	notowanych	4	Plur
Drzwi były zamknięte .	zamknięte	2	Plur
Według stołecznych policjantów , udało mu się zgromadzić wokół siebie młodych przestępców z Pragi .	stołecznych	1	Plur
Uhonorowani zostali także inni muzycy .	Uhonorowani	0	Plur
Potrawy były oceniane przez 110 niezależnych sędziów .	oceniane	2	Plur
Chcą nam obciąć 200 ton i dać gorszy .	gorszy	7	Sing
Twoje dalekosiężne projekty spotkają się ze zrozumieniem najbliższej osoby .	dalekosiężne	1	Plur
Błędek może domyślał się tego niedoszłego dalszego ciągu .	dalszego	6	Sing
Pobity kijem bejsbolowym mężczyzna trafił z licznymi obrażeniami do szpitala .	licznymi	6	Plur
W zbiorach muzeum jest także sztandar straży ogniowej oraz wiele pamiątkowych zdjęć .	pamiątkowych	10	Plur
Nawet piędź ziemi nie zostanie , rozdrapią jak głodne kruki .	głodne	8	Plur
Podstawowe problemy przemysłowej produkcji i masowych zastosowań półprzewodnikowych źródeł światła niebieskiego wydają się już rozwiązane .	półprzewodnikowych	7	Plur
Nowa kontrola miała inny zakres .	Nowa	0	Sing
Tym bardziej jest to smutne , gdy czynią to urzędnicy rządowi , którzy mają być apolityczni .	smutne	4	Sing
Siedział ponury na przedzie tramwaju , pod plastykowym dachem .	ponury	1	Sing
Robią to dziewiarze na dziewiarskich maszynach .	dziewiarskich	4	Plur
- Wojna wzbudziła we mnie ogromny lęk .	ogromny	5	Sing
Zrobiono to poza moimi plecami .	Zrobiono	0	Sing
Kilka dni temu na oddział trafiła prątkująca absolwentka gimnazjum .	prątkująca	6	Sing
Bruderszaft wypili gdzieś pod koniec lat czterdziestych .	czterdziestych	6	Plur
Panowie w cylindrach i w melonikach tkwili bokiem na przednich ławeczkach .	przednich	9	Plur
W dobrych warunkach mnożą się bardzo szybko .	dobrych	1	Plur
Dobroczynne działanie wina potwierdzają plantatorzy .	Dobroczynne	0	Sing
Wśród podhalańskich Cyganów z bezwzględności słynie jego współpracownik , współoskarżony w Oświęcimiu , Stanisław Kamiński z Czarnej Góry .	podhalańskich	1	Plur
Ważnym elementem samowychowującym jest nauka szkolna .	Ważnym	0	Sing
Księdza zatrzymano w ubiegłym tygodniu na polsko - ukraińskim przejściu granicznym w Dorohusku przy wjeździe do Polski .	granicznym	10	Sing
Pierwsze i jedyne auto zatrzymało się przy nich dopiero po kilku kwadransach !	jedyne	2	Sing
Dziewczyna obracająca się kusząco na parkiecie wydała mu się wyjątkowo wyjątkowa .	wyjątkowa	10	Sing
Mimo kilkakrotnych wizyt nie zastali śmy go w domu .	kilkakrotnych	1	Plur
W siedzibie kłodzkiego starostwa powiatowego dowiaduję się , że Średzińskiego nie lubią tu , bo to postkomuch , a powiatem rządzi egzotyczna koalicja złożona z platformersów i byłych pisowców .	egzotyczna	21	Sing
Czyżby teraz przepuściła okazję , mając tuż obok przystojnego młodego mężczyznę ?	przystojnego	8	Sing
Korespondenci budapesztańskich gazet donoszą , że wielu miejscowych Węgrów wyjechało do krewnych na wieś albo uciekło na Węgry .	miejscowych	7	Plur
Przygryzając wargi z bezsilnej złości , Chmura wołał Adasia .	bezsilnej	3	Sing
Wszelkie informacje podane poniżej dotyczą jedynie wypadków sprawdzonych .	sprawdzonych	7	Plur
- To nie jest program drugorzędny .	drugorzędny	5	Sing
Jest to duża armia , łącznie z oddziałami policji licząca 100 tysięcy ludzi .	licząca	9	Sing
Widzę na tej rycinie stojącą po lewej stronie grupkę ludzi ubranych w proste , długie szaty , którzy wskazują palcem na człowieka pogrążonego w przyjacielskiej pogawędce z diabłem .	ubranych	10	Plur
Na Ziemi Lubuskiej prace przedsiewne , zwłaszcza na glebach lekkich przybierają na sile .	przedsiewne	4	Plur
Przeciętne świadczenie emeryta , rencisty wzrośnie o 33 zł .	Przeciętne	0	Sing
– A ten nie był odpowiedni ?	odpowiedni	5	Sing
W Konstancinie-Jeziornie i Spale przygotowują się piłkarskie reprezentacje do nadzwyczaj ważnych spotkań .	piłkarskie	6	Plur
Ośrodki badania opinii publicznej publikują właśnie swe najświeższe sondaże , które potwierdzają utrzymujące się od wielu miesięcy trendy .	utrzymujące	12	Plur
Ale cięższą przeprawę mieli ci dziennikarze , którzy szli do centrum prasowego , by stamtąd jechać dalej autokarami .	cięższą	1	Sing
Znajdą się tam także pomieszczenia rehabilitacyjne z basenem , salami gimnastycznymi i salami masażu .	gimnastycznymi	10	Plur
Chłopiec wynurza się spod stołu , trzymając na dłoni rozbite jajko , strzaskaną skorupkę , rozlane żółtko i oślizłe białko .	rozbite	9	Sing
Umożliwi też uruchomienie w innych miejscowościach dodatkowych elektronicznych centrali cyfrowych .	cyfrowych	9	Plur
Dokładne dane już są przygotowane .	przygotowane	4	Plur
Więc kim się staniesz , gdy nie pojmiesz ich prostego języka , ich naturalnych gestów ?	naturalnych	13	Plur
Kobieta w fartuchu sprzedaje jej papierowy bilet .	papierowy	5	Sing
Świat jest chaotyczny , procesy rozwojowe nie układają się w logiczne ciągi i trzeba się z tym pogodzić .	chaotyczny	2	Sing
W dniu Debaty zamykam się razem ze stosem dokumentacji w pokoju redakcyjnym , wyłączam telefon komórkowy i nie ma mnie praktycznie dla nikogo .	redakcyjnym	11	Sing
Późna wiosna była dla księdza proboszcza najbardziej znienawidzoną porą roku .	Późna	0	Sing
Miał oczy przymknięte , blada twarz była bez wyrazu , jakby zabierał się do wysłuchania banalnej spowiedzi .	banalnej	15	Sing
Jestem proboszczem liczącej 1180 osób parafii , która posiada zabytkowy kościół wpisany do rejestru zabytków .	wpisany	11	Sing
Budapeszteńska giełda ma i inne poważne problemy .	poważne	5	Plur
Właścicielom wystarcza kino domowe , a bogate panie nie potrafią docenić kunsztu Anny Jaxy - Chamiec .	bogate	6	Plur
Juniorską reprezentację w najbliższym czasie czekają półfinały ME w Essen .	najbliższym	3	Sing
Żonę ma w Stanach Zjednoczonych , dorosłym dzieciom powodzi się dobrze .	dorosłym	6	Plur
Dalej autor artykułu sugestywnie opisuje , jak na ów obszar spada potężna rakieta z głowicą wodorową , powodując kolosalną eksplozję .	kolosalną	18	Sing
Tenisiści stołowi Energetyka Opoki Trzebinia znają już terminy spotkań barażowych o I ligę , w których ich rywalem będzie zwycięzca II ligi łódzko - świętokrzyskiej Start Brzezina .	stołowi	1	Plur
Uważano , że są one w dużym stopniu dziedziczne .	dziedziczne	8	Plur
Przed drzwiami sali rozpraw siedzieli uzbrojeni antyterroryści .	uzbrojeni	5	Plur
Dotychczas lokatorzy budynków , w których zainstalowane są gazomierze , płacili za gaz co dwa miesiące .	zainstalowane	6	Plur
Węże są zwierzętami mało poznanymi , niezwykłymi i fascynującymi .	poznanymi	4	Plur
W jednej z wsi w powiecie działdowskim 23-letni mężczyzna zgwałcił 44-letnią matkę .	44-letnią	10	Sing
Przede wszystkim , bądź dla niej dobry , wyrozumiały , łagodny .	łagodny	10	Sing
Czytanie jest u kalwinów powinnością religijną , obowiązkiem wierzącego .	religijną	5	Sing
- A wy skąd pieśni nasze , katolickie , znać możecie ?	katolickie	7	Plur
W mieście zainstalowana jest starego typu centrala elektromechaniczna .	zainstalowana	2	Sing
Mam najnowsze zestawy osób nagrodzonych .	nagrodzonych	4	Plur
Po dziesięciu latach wraca do Petersburga i do przerwanej pracy pisarskiej .	przerwanej	8	Sing
Rośnie pokolenie ludzi straconych , wyrzuconych . . .	wyrzuconych	5	Plur
Miejsca rozgrywania spotkań zostały ustalone w drodze losowania w siedzibie Polskiego Związku Tenisa Stołowego w Warszawie .	ustalone	4	Plur
Jak się mówi potocznie o facecie z małymi jajami ?	małymi	7	Plur
Za chwilę zjawią się kapłanki , a ja , jako bezbożnica , zostanę zelżona i wyrzucona stąd na zbity pysk .	zbity	18	Sing
Czy przyszłość świata należeć będzie do narodów ubogich , ale licznych i młodych ?	licznych	10	Plur
Oni nie są autentycznie indywidualni .	indywidualni	4	Plur
Nam się raczej zarzuca , że jesteśmy zbyt spolegliwi wobec Kościoła .	spolegliwi	8	Plur
Ma liczne rany tłuczone , poważny uraz głowy .	tłuczone	3	Plur
- Nie wyobrażam sobie piękniejszej śmierci .	piękniejszej	4	Sing
Ostatnio nie bywał delikatny .	delikatny	3	Sing
Wśród ludzi wybranych na najwyższe urzędy zjawiają się bandyci , gangsterzy , szpiedzy .	wybranych	2	Plur
Wśród tradycjonalistów muzułmańskich z państw Półwyspu Arabskiego wywołało ono szok .	muzułmańskich	2	Plur
We włosach rudych widział boży ogień .	rudych	2	Plur
W czasach elektronicznych rozmyła się wartość mozolnie zapisywanych karteczek i pedantycznie prowadzonych kartotek .	elektronicznych	2	Plur
- Lubimy zaglądać do takich dużych centrów .	dużych	5	Plur
Wysoka liczba urodzeń hamuje także rozwój gospodarczy kraju , w którym znaczny procent mieszkańców żyje poniżej uznanego progu ubóstwa .	uznanego	16	Sing
Niektórzy okażą się rzeczywiście sprawni i fachowi .	sprawni	4	Plur
Od tego też dnia czynna jest już wypożyczalnia sprzętu wodnego .	czynna	4	Sing
Do nowotarskiej tradycji weszły organizowane przez burmistrza spotkania noworoczne .	noworoczne	8	Plur
Uznano , że poszlaki były wątłe i niepewne , zwłaszcza podobieństwo papieru i sznurka .	niepewne	7	Plur
Swojego domku obitego papą Wanda Kędzierska trochę się wstydzi .	obitego	2	Sing
Już nie nosi starych butów z pourywanymi sznurówkami .	starych	3	Plur
Odpowiednie dane wynoszą 1410 i 820 mm .	Odpowiednie	0	Plur
Płonącą Warszawę widać było z dużej odległości .	Płonącą	0	Sing
Związany z kapistami , wielokrotnie jednak przekraczał wyznaczone przez nich malarskie granice .	malarskie	10	Plur
Poszedł żuraw obrażony .	obrażony	2	Sing
Komisja przetargowa miasta i Zarządu Dróg Miejskich wybrała najtańszą ofertę .	Miejskich	6	Plur
Do poszukiwań człowieka oskarżonego o ludobójstwo i zbrodnie przeciwko ludzkości włączyli się amerykańscy i brytyjscy agenci .	amerykańscy	12	Plur
Patrzy , a tu we włosach łonowych roi się od weszek .	łonowych	6	Plur
Na skrzyżowaniach wyrastają rośli policjanci , gazeciarze wciskają przechodniom papierowe płachty i przekrzykują się nowościami z wczorajszego dnia i nocy , która właśnie minęła .	papierowe	9	Plur
Do dziś w sądownictwie pracują osoby , które rozpoczynały swoją karierę w latach stalinowskich .	stalinowskich	13	Plur
Czy komornik będzie chciał zająć jeszcze coś innego ?	innego	7	Sing
Odwołany rząd , który zostaje przez Sejm zmuszony do rządzenia , zwykle przestaje pracować .	Odwołany	0	Sing
Ludmiła Putin , żona prezydenta Federacji Rosyjskiej Władimira Putina , rozpoczęła wczoraj wizytę w Polsce od zwiedzenia zamku na Wawelu .	Rosyjskiej	6	Sing
Do akcji plebiscytowej włączają się działy sportowe poszczególnych gazet .	plebiscytowej	2	Sing
Akcje funduszy jak najszybciej mają być wprowadzane na giełdę .	wprowadzane	6	Plur
Rozbiegli się Kaszubi , pod przymusem do tej walki pędzeni .	pędzeni	9	Plur
Zazwyczaj są to ich 6­9-letni synowie , których trzeba wyżywić .	6­9-letni	4	Plur
Gdy rozpędzał je kamień , uciekały w krzaki z pyskami wbitymi w puszki po konserwach .	wbitymi	10	Plur
To ostatecznie przesądziło o południowym kierunku japońskiej ekspansji .	japońskiej	6	Sing
Rząd prowadzi złą politykę i boi się , że coraz więcej będzie protestów i manifestacji .	złą	2	Sing
– Niech się pani nie martwi , ta pani Marysia to niezwykle urocze dziecko .	urocze	12	Sing
Z zestawienia sporządzanego przez starostwo wynika , że podmioty gospodarcze działające w powiecie działdowskim dokonują rocznie ponad 6000 odpraw celnych .	działające	10	Plur
W Polsce przedwrześniowej mieliśmy jedynie 600 zelektryfikowanych wsi .	zelektryfikowanych	6	Plur
- W spadku po odchodzącej ekipie nowy rząd otrzymuje olbrzymi deficyt w bilansie handlowym .	olbrzymi	9	Sing
Odkryto wiele nadużyć .	Odkryto	0	Sing
Bo nie przemija miłość do słów wypowiadających prawdę stałą , wieczną .	stałą	8	Sing
W czasach elektronicznych rozmyła się wartość mozolnie zapisywanych karteczek i pedantycznie prowadzonych kartotek .	prowadzonych	11	Plur
Zapisy antykoncentracyjne nie są aż tak rozległe tutaj .	antykoncentracyjne	1	Plur
- Czy polscy kierowcy zawodowi rzeczywiście są profesjonalistami ?	zawodowi	4	Plur
W okresie okupacji pracuje w Krakowie przy rozbudowie Zakładów Sodowych oraz Gmachu banku Rolnego , jako kierownik robót i statyk .	Rolnego	13	Sing
Drużynowymi finałami zakończona została w poniedziałek rywalizacja pływaków o medale i dolarowe premie w Igrzyskach Dobrej Woli .	Drużynowymi	0	Plur
W Olsztynie pod drzwiami szpitalnymi zmarły ostatnio dwie osoby .	szpitalnymi	4	Plur
Tutaj mamy jakąś pomieszaną wersję .	pomieszaną	3	Sing
Podobnie jest ze sposobami chemicznymi .	chemicznymi	4	Plur
Starszego aspiranta w prowincjonalnym ośrodku skierowano na badania psychiatryczne .	psychiatryczne	8	Plur
Obaj chorążowie zostali natychmiast zatrzymani i osadzeni w areszcie .	zatrzymani	4	Plur
Obowiązują tu także egzaminy teoretyczne .	teoretyczne	4	Plur
Wreszcie na ludzi głodnych przybywających ze wsi czekały rozwijające się gwałtownie w XIX w . miasta .	przybywających	4	Plur
- Po co wdzierał się do cudzego domu ? !	cudzego	6	Sing
Zakończyły się ligowe rozgrywki drużynowych mistrzostw Polski w zapasach .	drużynowych	4	Plur
To nie są normalne dzieci .	normalne	3	Plur
Szkody nie są wielkie .	wielkie	3	Plur
Zanieczyszczenia cytoplazmatyczne i błonowe są również groźne , stanowiąc prawdopodobne źródło zarówno aktywności proteolitycznej , jak i białek cytoplazmatycznych w puli niehistonowej .	prawdopodobne	9	Sing
Osiągniesz korzyść prestiżową i finansową .	finansową	4	Sing
Na Trakcie Królewskim ma stanąć Ronald Reagan .	Królewskim	2	Sing
Biedny Wojtek wysługuje się .	Biedny	0	Sing
Na pozostałym oleju podsmażyć mięso z roztartym na miazgę czosnkiem .	pozostałym	1	Sing
– Są świetne .	świetne	2	Plur
Nie czekał długo , po kilku minutach wybiegła , wyraźnie spłoszona .	spłoszona	10	Sing
W tym dniu życzenia owocnych obrad przekazali zjazdowi przewodniczący delegacji partii komunistycznych i robotniczych z krajów socjalistycznych .	komunistycznych	11	Plur
Dotyczy to na przykład usług telekomunikacyjnych , transportowych , ubezpieczeniowych , finansowych .	finansowych	11	Plur
To jedyne logiczne wyjaśnienie , o ile tu można mówić tu o logice .	logiczne	2	Sing
Komory zadziałały , ale organizm był już zbyt wycieńczony .	wycieńczony	8	Sing
Biznesmeni pakistańscy to ciągle pendżabscy latyfundyści .	pakistańscy	1	Plur
Zmniejszył szanse elekcyjne Marka Borowskiego .	elekcyjne	2	Plur
Jednak ewentualne załamanie koniunktury przy obecnych cenach będzie oznaczać dla inwestorów upadek z wysokiego konia .	obecnych	5	Plur
Co to wszystko obchodzi polskich klientów firm ubezpieczeniowych ?	ubezpieczeniowych	7	Plur
Zarząd Telekomunikacji Polskiej ustami rzecznika prasowego , Piotra Gawrona , podkreśla , że nie jest stroną w sporze między związkami i rządem .	prasowego	5	Sing
Nie czekając na decyzję Akcji , Unia Wolności zaczęła lansować na prezesa Karola Modzelewskiego , historyka i polityka związanego z Unią Pracy .	związanego	18	Sing
Oba pojazdy miały słupską rejestrację .	słupską	3	Sing
Istnieje u nas w ocenach twórczości artystycznej tradycja nawiązywania do słonia .	artystycznej	6	Sing
– Zidentyfikował z uśmiechem suknię , kupioną w salonie Coco Chanel .	kupioną	6	Sing
Wal z dużych flaszek !	dużych	2	Plur
Mam przynieść wypełnioną deklarację członkowską oraz partyjną ankietę .	partyjną	6	Sing
Akcję sprawozdawczo - wyborczą w pracowniczych ogrodach działkowych zakończy ogólnopolska konferencja delegatów wybranych na zjazdach wojewódzkich POD , która będzie obradowała w maju w Warszawie .	wojewódzkich	15	Plur
To obiecujące spotkanie .	obiecujące	1	Sing
Fałszywego księdza przewieziono do więzienia w Rawiczu .	Fałszywego	0	Sing
Przygotowuje się również wystawę archeologiczną .	archeologiczną	4	Sing
– widziała ś gdzieś ogródki działkowe .	działkowe	5	Plur
Spośród trzystu ochotników Polluks wybrał stu najlepiej znających się na morzu .	znających	7	Plur
W samolocie myślała m o tych dniach spędzonych z Kowerskim .	spędzonych	7	Plur
Pani minister mogłaby również poinformować posłów , jak przebiegają prace nad standaryzacją wydatków budżetowych .	budżetowych	13	Plur
Nie chcę nic sugerować , ale jest tam jedna fajna , prawie bezbłędna poetka .	fajna	9	Sing
Badania wielkości sił naciągu strun na torze przeprowadzono przez bezpośredni pomiar sił w poszczególnych strunach za pomocą przyrządu VOGT .	bezpośredni	9	Sing
Angelina oczywiście wyraziła chęć ponownego zagrania Lary Croft .	ponownego	4	Sing
Zanim został złapany przez pracowników ogrodu zoologicznego , odwiedził co najmniej dwa domy .	zoologicznego	6	Sing
Ale szybki zysk bywa celem nawet najpotężniejszych magnatów finansowych , bo rynki są wolatylne .	szybki	1	Sing
Horti 2000 to także okazja do zapoznania się z najnowocześniejszymi sprzętami ogrodowymi , niezbędnymi nawozami , które sprawiają , ze nasza działka będzie obiektem zachwytu .	najnowocześniejszymi	9	Plur
Przed następnym sezonem zorientuję się , czy w mojej obecnej szkole będę mógł sobie wziąć urlop dziekański .	dziekański	16	Sing
W tym roku w kościele św . Brygidy na Wielkanoc można było obejrzeć kościotrupa trzymającego flagę UE .	trzymającego	14	Sing
Inni milczeli .	Inni	0	Plur
Tatry są bezlitosne .	bezlitosne	2	Plur
Chłopiec przebywa w greckim przytułku prowadzonym przez organizację o złej reputacji .	prowadzonym	5	Sing
Płonącą Warszawę widać było z dużej odległości .	dużej	5	Sing
Dla pozostałych autobusów jadących w kierunku Śródki , dopuszczony zostanie przejazd ul . Estkowskiego .	dopuszczony	8	Sing
W kontekście emocjonalnych , osobistych wypowiedzi ta budzi podejrzenie o nieautentyczność .	osobistych	4	Plur
Trafił do Pogotowia Opiekuńczego w Polanowie .	Opiekuńczego	3	Sing
W Warszawie jest ulica Nowy Świat .	Nowy	4	Sing
Poparzeniu uległy także drogi oddechowe .	oddechowe	4	Plur
- To nam pozwoliło przetrwać ostatnią epokę lodową .	ostatnią	5	Sing
Oczywiście , postaramy się , aby też były całkowicie bezużyteczne . . .	bezużyteczne	9	Plur
Kwiaty otrzymali nauczyciele , którzy przed laty kształcili kolejarskich specjalistów .	kolejarskich	8	Plur
Po spełnieniu toastu świeżo upieczeni małżonkowie rzucają za siebie kieliszki .	upieczeni	4	Plur
- Polacy cenią polityków sytuujących się ponad podziałami .	sytuujących	4	Plur
Zaprószono ogień i wybuchł poważny pożar na górnych piętrach .	Zaprószono	0	Sing
Maria Kadłubek odebrała wydany zaocznie wyrok sądu grodzkiego .	wydany	3	Sing
Niektóre inwestycje były dzielone na części , by uniknąć stosowania reguł przetargowych .	przetargowych	11	Plur
Gospodarstwo Stanisławy Sowy , Irki Paulako i Moniki Niebrzydowskiej rozszerza się powoli poza obręb zabudowań gospodarskich .	gospodarskich	15	Plur
Zasypiam , ssąc chrupką skórkę przy migoczącym w telewizji Człowieku z żelaza .	chrupką	3	Sing
Głównym jego prześladowcą był malarz , majster Gileta .	Głównym	0	Sing
Z przodu oboma dłońmi chwytamy za przedramię zgięte w stawie łokciowym .	zgięte	7	Sing
Stary wiadukt przy ulicy Oświęcimskiej stanowił ogromną uciążliwość dla kierowców .	Oświęcimskiej	4	Sing
Spojrzał des Noyers na zegar gdański , stojący w rogu komnaty .	stojący	7	Sing
Według legend , w studni głębokiej na ponad 30 metrów znajdują się wejścia do lochów i tajnych chodników łączących posiadłości właścicieli zamku .	głębokiej	5	Sing
Po drodze , lekko podchmieleni , prowadzili ożywioną rozmowę .	podchmieleni	4	Plur
otworzę kanały elektryczne i niech wlezie tam . .	elektryczne	2	Plur
Tam znajdują się dane o poszukiwanych przestępcach .	poszukiwanych	5	Plur
Moi ulubieni artyści są jednak z tamtej zimnej części świata .	ulubieni	1	Plur
Uszkodzone zostały wówczas 932 zabytkowe drzewa .	zabytkowe	4	Plur
- Czy znasz dziesięciu sprawiedliwych w tym grodzie ?	sprawiedliwych	4	Plur
Tutaj wyraźnie widać wrażliwe , skłonne do ufności i entuzjazmu oblicze eseisty .	skłonne	5	Sing
Zapowiedział , że SLD zagłosuje w Sejmie przeciw rządowej propozycji .	rządowej	8	Sing
Infrastruktura teleinformacyjna nie może działać bez prądu .	teleinformacyjna	1	Sing
Wczoraj koło cmentarza w Sianowie znaleziono kilkuletniego chłopca .	kilkuletniego	6	Sing
- Zrobiła ręką gest zapraszający do środka .	zapraszający	4	Sing
Każde dziecko staje się kiedyś dorosłe .	dorosłe	5	Sing
Posiadał wszechstronny , uniwersalny umysł obejmujący szereg nauk specjalnych .	obejmujący	5	Sing
To pewnie porwana Angielka , cieszyły się polskie media .	porwana	2	Sing
Jeszcze większe wrażenie na współczesnych sprawiał Tomasz z Akwinu , dyktując dwa albo trzy traktaty filozoficzne .	filozoficzne	15	Plur
- Chłopcy stoją obok niej , są ubrani .	ubrani	7	Plur
Po dwóch tygodniach na jej rozkładające się zwłoki natrafił w lesie rowerzysta .	rozkładające	5	Plur
Emil Drejtser urodził się w Odessie , wyemigrował do USA w 1974 roku .	1974	11	Sing
Ptaki te chętnie korzystają z pokarmu wykładanego dla parkowych łabędzi .	parkowych	8	Plur
Teraz straszą budynki ogołocone z szyb i armatury .	ogołocone	3	Plur
Adiunkt notuje uwagi z kontroli , następuje krótka konsultacja naukowa .	naukowa	9	Sing
Banki akcyjne brały prowizje od swych usług i szukały zysku .	akcyjne	1	Plur
W 1990 r . Smolański brał czynny udział w napaści na afrykańskich studentów manifestujących na wrocławskim rynku .	manifestujących	13	Plur
Nie wie nawet , kiedy jest sobota i kiedy wypadają żydowskie święta .	żydowskie	10	Plur
Będą potrzebne ?	potrzebne	1	Plur
Podobały jej się ogrody otaczające stare wille .	otaczające	4	Plur
Najcudowniejsze cnoty staną się wadami , jeśli w nich zabraknie ufności .	Najcudowniejsze	0	Plur
Kwity wykłada sympatyczny i kulturalny pan po pięćdziesiątce .	kulturalny	4	Sing
Uroczystego otwarcia imprezy dokonał wojewoda nowosądecki Marek Oleksiński .	Uroczystego	0	Sing
W tym celu należało by wprowadzić do komina specjalną sondę .	specjalną	8	Sing
Wiedzą o tym dziesiątki właścicieli małych elektrowni wodnych .	małych	5	Plur
Drzwi uchyliły się z lekkim skrzypieniem nie naoliwionych zawiasów .	naoliwionych	7	Plur
W sposób bardzo oczywisty demonstrował to przy spełnianiu swych zadań w mesie .	oczywisty	3	Sing
Książka zniknęła natychmiast z półek księgarskich .	księgarskich	5	Plur
Wściekłość pokrył pobłażliwym uśmiechem .	pobłażliwym	2	Sing
Roszczenia , jak się zakłada , były by załatwiane w trybie administracyjnym .	załatwiane	8	Plur
Została ona zachwiana po październikowych wyborach .	październikowych	4	Plur
Tymczasem miednice wypełnione podrobami przenoszono do kuchni .	przenoszono	4	Sing
Na zakończenie uroczystości głos zabrał sam ks . kardynał Sodano , który na początku niemal czystą polszczyzną przywitał przybyłych gości oraz wyraził swoje zadowolenie z pobytu we Wrocławiu .	przybyłych	18	Plur
Trzecim , równie istotnym , podzbiorem są zasoby środowiska lokalnego .	Trzecim	0	Sing
W godzinach wieczornych premier Cyrankiewicz przybył do Tuluzy .	wieczornych	2	Plur
- Nóż niezbyt sprawnie odkrawał ziemniaczane spirale .	ziemniaczane	5	Plur
Pogańskie zwyczaje zapalania światełek przerodziły się we wspaniałe festyny światła w szaleńcze przedświąteczne dni .	przedświąteczne	12	Plur
Przez pierwszy tydzień leżą ukryte w wysokiej trawie , a następnie zaczynają wędrować za matką .	ukryte	4	Plur
Pozostaje do zidentyfikowania jeszcze 38 zwłok oraz 14 worków z ludzkimi szczątkami .	ludzkimi	10	Plur
Pomimo dokuczliwego zimna cieszyły się one dużym zainteresowaniem sportowców wiejskich .	wiejskich	9	Plur
Miał kochającą rodzinę , swoje pasje i marzenia .	kochającą	1	Sing
Dla firm internetowych sieć to przede wszystkim nowy , wielki rynek handlowy , dzięki któremu towar może bez problemu trafić pod drzwi klienta .	handlowy	11	Sing
Do zdarzenia doszło na dość oblodzonej ulicy .	oblodzonej	5	Sing
Istotne jest , aby cele edukacji ekologicznej zostały przełożone na język konkretów mających zastosowanie w codziennych działaniach ucznia .	mających	12	Plur
" Przysyła ci świeżą partię " .	świeżą	3	Sing
- Jak pani wspomina swoje szkolne lektury ?	szkolne	5	Plur
- Złożę też za chwilę na ręce pana marszałka ową poprawkę formalną , uzgodnioną z Biurem Legislacyjnym .	uzgodnioną	13	Sing
Na tym spotkaniu zakończyły się właściwie działania morskie wojny rosyjsko - japońskiej .	morskie	7	Plur
Temu sukcesowi w znacznej mierze przysłużył się również Szymon , który wywalczył 10 z 18 zdobytych przez Polaków punktów .	znacznej	3	Sing
Osadza się na odzieży oraz trwałych nieprzepuszczalnych powierzchniach takich jak beton czy asfalt .	trwałych	5	Plur
Stare by może uciekły , ale małe dorosły i zostały .	małe	6	Plur
Nie składają donosów do prokuratury , nie przejmują się całodobowym uśmiercaniem poczętych ?	poczętych	11	Plur
Dwaj wędkarze wpadli do wody , gdy wieloryb zaatakował ich łódź u południowo - wschodnich wybrzeży Australii .	wschodnich	14	Plur
Będą to wybory samorządowe .	samorządowe	3	Plur
Podejmowane są zobowiązania indywidualne i zespołowe .	indywidualne	3	Plur
Prawdopodobnie niesprawna instalacja elektryczna była przyczyną tragicznego pożaru w mieszkaniu przy ulicy Słupeckiej w Gdyni .	tragicznego	6	Sing
Wśród tradycjonalistów muzułmańskich z państw Półwyspu Arabskiego wywołało ono szok .	muzułmańskich	2	Plur
Podczas ostatniego spotkania przywódców Piętnastki w Brukseli rozstrzygnięto też kilka spornych kwestii związanych z miejscem przyszłych członków w unijnych instytucjach .	przyszłych	15	Plur
Był to słuszny protest ?	słuszny	2	Sing
Widzę na tej rycinie stojącą po lewej stronie grupkę ludzi ubranych w proste , długie szaty , którzy wskazują palcem na człowieka pogrążonego w przyjacielskiej pogawędce z diabłem .	pogrążonego	22	Sing
Do naszej salki wszedł teraz łysy facet w ciemnooprawnych okularach .	ciemnooprawnych	8	Plur
Przymknął oczy i trwał w zadumie nie słysząc nawet roztrzepanej gadaniny niezliczonych wróbli .	roztrzepanej	9	Sing
Dalej autor artykułu sugestywnie opisuje , jak na ów obszar spada potężna rakieta z głowicą wodorową , powodując kolosalną eksplozję .	wodorową	15	Sing
Największe zainteresowanie budzi jednak specjalne seminarium poświęcone ustaleniu budowy ludzkiego DNA .	ludzkiego	9	Sing
- Mój ojciec pracuje w BRH , biurze radcy handlowego .	handlowego	9	Sing
Ktoś biegnie z głuchym tupotem bosych nóg .	bosych	5	Plur
Większość rady stanowi elita armii algierskiej .	algierskiej	5	Sing
Jest to szczególnie atrakcyjne dla dzieci , które same proszą rodziców , aby mogły wziąć do rączki te piękne stworzenia .	atrakcyjne	3	Sing
Mocne łuki brwi jakby nastroszyły się .	Mocne	0	Plur
Tym razem głód został pokonany .	pokonany	4	Sing
Komisarz urzędował w godzinach przedpołudniowych .	przedpołudniowych	4	Plur
Na jego otwarcie zjechali się przedstawiciele PSP w Warszawie , władze gminne , powiatowe oraz państwowe .	gminne	11	Plur
Zauważył em , że po raz pierwszy powieki nie zakrywały jego źrenić , żółtych i okrągłych .	żółtych	13	Plur
W poniedziałek ustalony został ostateczny podział funkcji w radzie nadzorczej tucholskiej Spółdzielni Mieszkaniowej .	nadzorczej	9	Sing
W drugiej ręce trzymał pistolet maszynowy .	drugiej	1	Sing
- Nie sprawiał żadnych problemów wychowawczych .	wychowawczych	5	Plur
Ashram w Magliano Sabina to ośrodek dla małych dzieci Sahaja Yoginów .	małych	7	Plur
Następuje przewartościowanie z wymiaru duchowego na materialny .	duchowego	4	Sing
Zasklepiamy się w pozycji skrzywdzonego , dotkniętego nieszczęściem .	skrzywdzonego	4	Sing
W średniowieczu istniały tu winnice książęce .	książęce	5	Plur
Na groblach wybudowano jedenaście betonowych śluz wałowych .	betonowych	4	Plur
Z tego płynie nauka również dla innych szefów wojewódzkich .	wojewódzkich	8	Plur
Ponieważ ciągle nie została ujawniona publicznie statystyka represji poczerwcowych , trudno powiedzieć cokolwiek na temat ich zasięgu .	ujawniona	4	Sing
Jednak po dokładnych oględzinach straż pożarna odkryła ofiarę pożaru .	pożarna	5	Sing
Ojciec był zapalonym myśliwym i często wybierał się na polowania , zasilając w ten sposób naszą spiżarnię .	zapalonym	2	Sing
Cały kurs nadany będzie w Łodzi .	nadany	2	Sing
Adwent ma dla Pasierba szczególne znaczenie .	szczególne	4	Sing
Zwycięski zespół uzyska awans .	Zwycięski	0	Sing
Tym głównie Stronnictwo będzie się różniło od większości europejskich partii chadeckich , w których liberalizm gospodarczy miesza się z ideami socjaldemokratycznymi i nauką społeczną Kościoła .	socjaldemokratycznymi	20	Plur
Nadchodził schyłek lat trzydziestych .	trzydziestych	3	Plur
Związany z kapistami , wielokrotnie jednak przekraczał wyznaczone przez nich malarskie granice .	malarskie	10	Plur
Ze zdziwieniem spostrzegł , że jego lewa noga stopą dotyka mu twarzy .	lewa	6	Sing
W sobotę podporucznik Ziemba przeniósł swoje łóżko do kuchni , rowery wstawiono do pokoju podporucznika Kowalika .	wstawiono	11	Sing
Potem zaraz z świętym Piotrem zniknął .	świętym	3	Sing
- Czy ktoś z pań posłanek i panów posłów pragnie zabrać głos w sprawie przedstawionych propozycji ?	przedstawionych	14	Plur
Także w tym przypadku fototerapia może złagodzić lub znieść całkowicie niekorzystne objawy .	niekorzystne	10	Plur
Przekształcenie osad rolniczych w osady przemysłowe wprowadziło do nich kapitalistyczne stosunki .	kapitalistyczne	9	Plur
Powołano sejmową komisję śledczą do wyjaśnienia tej sprawy .	sejmową	1	Sing
Faktyczny strajk , który jest im zabroniony , oprócz wymiernych kosztów dla tysięcy firm naraził państwo polskie na kompromitację .	Faktyczny	0	Sing
Wysokich drabin warszawska straż rzeczywiście nie ma .	Wysokich	0	Plur
Po naszym telefonie na miejscu pojawiła się policja , by ocenić , czy jest to krzew znajdujący się na liście zakazanych używek halucynogennych .	zakazanych	20	Plur
Po śląskich miastach grasuje zboczeniec , który atakuje młode dziewczyny !	śląskich	1	Plur
Kolejna sygnalizacja pojawi się u zbiegu ulic Okrężnej i Gdyńskiej i ułatwi wyjazd z osiedla 40-lecia w Czerwonaku .	Kolejna	0	Sing
Pierwsza udana synteza nowego pierwiastka przeprowadzona została w 1940 roku .	udana	1	Sing
I Pan Jezus krzyż nad nimi uczynił , a oni się zamienili w trzy drzewa jabłonne .	jabłonne	15	Plur
Jest najwyższym mężczyzną w oddziałach Agencji Restrukturyzacji i Modernizacji Rolnictwa w Polsce .	najwyższym	1	Sing
Kwiaty otrzymali nauczyciele , którzy przed laty kształcili kolejarskich specjalistów .	kolejarskich	8	Plur
Monarchia Habsburgów została rozczłonkowana .	rozczłonkowana	3	Sing
Ale Moja Wdowa uważała , że zupy te czynią żołądek gładkim i młodym .	młodym	12	Sing
Pierwsze i drugie miejsce zajęły słowackie dziewczęta , ubrane w getry i krótkie falbankowe spódniczki .	ubrane	8	Plur
Nie były nigdy wydawane , przechowywali śmy je w archiwum rodzinnym .	rodzinnym	10	Sing
Nie są dokarmiane ani pojone .	pojone	4	Plur
W Centrum Naukowym Wielkich Jezior w amerykańskim Cleveland otwarto wystawę niecodziennych pomocy naukowych dla dzieci .	naukowych	12	Plur
Według islamu świnia jest uznawana za zwierzę nieczyste .	nieczyste	7	Sing
Wysoka liczba urodzeń hamuje także rozwój gospodarczy kraju , w którym znaczny procent mieszkańców żyje poniżej uznanego progu ubóstwa .	gospodarczy	6	Sing
- Nie jestem typowym jazzmanem , choć tak bywam oceniany .	oceniany	9	Sing
Dzięki ich ofiarnej postawie las został uratowany .	uratowany	6	Sing
Niespodziewana , nagła choroba zaściankowego Casanowy zmieniła sytuację .	zaściankowego	4	Sing
Znachor trzyma za grzywę myszatego konia .	myszatego	4	Sing
Ogień trzaskał w ciszy , dzieci wybiegły na dwór przestraszone .	przestraszone	9	Plur
Partia opozycyjna nie powinna bać się przedterminowych wyborców .	opozycyjna	1	Sing
Tak orzekł wczoraj niemiecki Trybunał Federalny w Karlsruhe .	Federalny	5	Sing
Mogę także powiedzieć , że transmitowany będzie w programie 2 Polskiego Radia .	transmitowany	5	Sing
Czy to może być port lotniczy ?	lotniczy	5	Sing
Oceniając strajk , Gawin oświadczył , że ruch towarowy praktycznie się nie odbywał , a na Śląsku stanęło wiele pociągów pasażerskich .	towarowy	8	Sing
40-osobowa grupa chuliganów wywołała rozróbę przed sobotnim III-ligowym meczem piłki nożnej Lublinianki z Cracovią .	nożnej	10	Sing
Niemiecki sąd konstytucyjny zabronił stosowania go na terenie tego kraju .	Niemiecki	0	Sing
W zamyśle ludzi zaplecza pana premiera to dwie oddzielne inicjatywy .	oddzielne	8	Plur
Na czele stoi król - Ashantehene , otoczony radą starszych .	otoczony	7	Sing
- Większa będzie odpowiedzialność spadkobierców .	Większa	1	Sing
Umożliwi też uruchomienie w innych miejscowościach dodatkowych elektronicznych centrali cyfrowych .	elektronicznych	7	Plur
Całowała go drobnymi , szybkimi pocałunkami .	drobnymi	2	Plur
Ze wschodnim uporem i takąż wytrwałością badali każdą ewentualność sami , przez swych znajomych , przez znajomych , aż znaleźli .	wschodnim	1	Sing
Posłowie udzielili też rządowi absolutorium z wykonania ubiegłorocznego budżetu .	ubiegłorocznego	7	Sing
Myślałem zrazu , że szkło jest zabrudzone .	zabrudzone	6	Sing
- Cały czas było spokojnie .	Cały	1	Sing
Ponadto zastosował środek zapobiegawczy w postaci zakazu opuszczania kraju , zawieszenia w czynnościach służbowych oraz poręczenie majątkowe w wysokości 10 tys . zł .	służbowych	13	Plur
Rafał Blechacz zapowiedział , że w niedzielę palmową ma zamiar zagrać kolejny ważny koncert .	palmową	7	Sing
- Bał by m się popadania w nastroje mesjanistyczne .	mesjanistyczne	8	Plur
Poznali śmy się w okolicznościach osobliwych .	osobliwych	5	Plur
Jeśli przez dwa miesiące nie uda się dogadać , można rozpocząć procedurę wywłaszczeniową .	wywłaszczeniową	12	Sing
Wuj matki , Bronisław Werner , spędził pięć lat w aresztanckich rotach w Orenburgu .	aresztanckich	10	Plur
Wycina się je tam dla celów rolniczych i hodowlanych A NIE PAPIERNICZYCH !	hodowlanych	8	Plur
- Dali śmy Kwaśniewskiemu szansę , bo mówił dużo o prostych ludziach .	prostych	10	Plur
Stare gmachy , dostojne i omszałe , coraz bardziej upodobniają się do mamutów , wchłanianych w błoto epoki polodowcowej .	omszałe	5	Plur
Pod uniesionymi zasłonami rozległego łoża z trudem udało mu się dostrzec ginącą w powodzi koronek , pomarszczoną twarz pani Lamaire .	uniesionymi	1	Plur
Oprócz PartitionMagic instalowane są aplikacje pomocnicze .	instalowane	2	Plur
Przecież miasto nie jest atrakcyjne turystycznie ?	atrakcyjne	4	Sing
Lokal ten otrzymał nowe pomieszczenia dla kuchni i podręcznych magazynów , oraz szatnię .	podręcznych	8	Plur
Wyrzekliśmy się naszych zasad i małpujemy kraje , które pogrążyły się w nihilizmie moralnym !	moralnym	13	Sing
Będzie musiał kupić na bazarze jakieś najprawdziwsze świadectwo maturalne .	najprawdziwsze	6	Sing
Ziemia jest naga .	naga	2	Sing
Wezwana na miejsce żandarmeria wojskowa stwierdziła , że skrzynki , w których przechowywane były materiały wybuchowe , są puste .	wybuchowe	15	Plur
W samym tylko Katyniu rozstrzelano prawie 4,5 tys . osób .	rozstrzelano	4	Sing
Warszawscy radni twierdzą , że nie miał prawa tego zrobić .	Warszawscy	0	Plur
Między miniaturowym arcydziełem a banalną grafomanią wyrasta obszar kompletnej pustki .	banalną	4	Sing
Układy ACC technologiczne stosuje się przede wszystkim do obróbki zgrubnej w celu maksymalizacji wydajności obróbki .	zgrubnej	9	Sing
W roku 2001 został powołany na stanowisko kierownika Zakładu Filozofii Współczesnej Instytutu Filozofii UŁ .	Współczesnej	10	Sing
W naszym przedziale walały się nawet dwa piękne wolne miejsca siedzące .	wolne	8	Plur
Załadowano się na pięć barek i o zmierzchu wyruszono .	Załadowano	0	Sing
Kaczyńscy i ich główni zausznicy są postrzegani jako politycy niebezpieczni , nieobliczalni .	postrzegani	6	Plur
Ważnym zadaniem jest zapewnienie warunków dla niezakłóconego funkcjonowania gospodarki i pracy urzędów .	Ważnym	0	Sing
Padały jeszcze pytania o drogi krajowe biegnące przez wsie .	krajowe	5	Plur
- Często słyszy się o konfliktach narciarzy ze związkami sportowymi w sprawach sprzętu .	sportowymi	9	Plur
Przy bardzo silnych wiatrach zawodnicy zakładają na płozy specjalne obciążenia .	specjalne	8	Plur
Klaskał mu prezydent Kwaśniewski oraz zgodnie prawa i lewa strona .	lewa	8	Sing
- Nabywca był podstawiony przez nas .	podstawiony	3	Sing
Polityka prorodzinna rządu francuskiego jest na bakier z programem przedsiębiorczości .	francuskiego	3	Sing
Nowe rady gminne będą mniej liczne od obecnych .	gminne	2	Plur
- Z tego punktu widzenia kryzys może być pożytecznym ograniczeniem .	pożytecznym	8	Sing
Kosiński wcisnął drugi hak linki holowniczej między swój błotnik i oponę , wsiadł do samochodu .	drugi	2	Sing
Iluż poważnych obecnie pisarzy czytało swe pierwsze próby literackie w sali przy Krupniczej , siedząc wokół dębowych stołów zsuniętych pośrodku .	poważnych	1	Plur
Wzdłuż alejek ustawionych zostanie osiemdziesiąt ławek .	ustawionych	2	Plur
Teraz ma sztuczne .	sztuczne	2	Sing
Dla zdrowia psychicznego i fizycznego trzeba wówczas chwilowo panią uśpić .	fizycznego	4	Sing
Policjanci jedynie pouczyli kierowcę i sporządzili notatkę służbową .	służbową	7	Sing
Rano obudził się z obolałą głową .	obolałą	4	Sing
Doroczny Bal Mody w salonach Hotelu Europejskiego zgromadził najpiękniejsze panie stolicy .	najpiękniejsze	8	Plur
Brak bandaży elastycznych .	elastycznych	2	Plur
Staruszka wyjęła z kredensu album oprawiony w zniszczoną ciemnowiśniową skórę .	ciemnowiśniową	8	Sing
Ruszyły sprawy spadkowe .	spadkowe	2	Plur
Niezależnie od przedstawionych wyników , kontrolę przeprowadzą jeszcze policjanci z Komendy Wojewódzkiej Policji w Katowicach .	przedstawionych	2	Plur
Prawdopodobnie powiaty będą wykonywać zarówno zadania zlecone przez rząd , jak i zadania gmin .	zlecone	6	Plur
Były dyrektor żąda przywrócenia do pracy .	Były	0	Sing
Ruszyli bez żadnych kłopotów , reflektory oświetliły drogę i pnie przydrożnych drzew .	przydrożnych	10	Plur
Po jej najwybitniejszych przedstawicielach na cenowe szczyty dostali się liczni malarze , których zasługi artystyczne , poza tworzeniem dekoracyjnych i sprawnych technicznie obrazów , są raczej mizerne .	cenowe	5	Plur
Ktoś inny w złości kopie ławkę i rzuca głośno soczyste przekleństwa .	soczyste	9	Plur
- Czy czarny scenariusz jest brany pod uwagę w zachodnich kołach finansowych ?	finansowych	11	Plur
A może chodzi o coś innego ?	innego	5	Sing
TP SA chce złagodzić planowane redukcje .	planowane	4	Plur
Rocznie na świecie ponad milion osób ginie w wypadkach drogowych , a ok . 40 mln odnosi rany .	drogowych	9	Plur
Dzisiejsza konfrontacja z łódzkimi zespołami , które mają pierwszoligowe aspiracje , zapowiada się niezwykle ciekawie .	pierwszoligowe	8	Plur
Wcisnął em je po przednie opony .	przednie	4	Plur
VIII Zjazd Inżynierów Mechaników Polskich obradował w Katowicach pod hasłem zbiorowego wysiłku myśli i pracy nad aktualnymi zagadnieniami technicznymi , mającego na celu rozwój techniki polskiej .	technicznymi	18	Plur
W drugiej połowie XIX wieku sztandar walki podjęli robotnicy .	XIX	3	Sing
Skazani rozwożeni są natychmiast do więzień na terenie całego kraju .	rozwożeni	1	Plur
Czy nie obawia się pani odpływu dewiz z banków krajowych ?	krajowych	9	Plur
Laboratorium badań serologicznych pozostało w gestii leszczyńskiego szpitala .	serologicznych	2	Plur
Pomyślano również o indywidualnych turnusach .	indywidualnych	3	Plur
Nakładamy rękawice ochronne , zapinamy swetry i wychodzimy na pokład .	ochronne	2	Plur
W Polsce przedwrześniowej mieli śmy jedynie 600 zelektryfikowanych wsi .	zelektryfikowanych	7	Plur
I brał w tym udział funkcjonariusz państwowy .	państwowy	6	Sing
48 zakładów mięsnych z całego kraju zgłosiło do konkursu 213 swoich produktów .	mięsnych	2	Plur
Stojący w drzwiach hotelu Wyroba natychmiast ruszył w jego kierunku .	Stojący	0	Sing
Tutaj jedynie pokrótce opiszemy ten standard i nieco uzupełnimy zaprezentowane w wymienionych artykułach informacje .	wymienionych	11	Plur
Osiągniesz korzyść prestiżową i finansową .	prestiżową	2	Sing
Bo nie przemija miłość do słów wypowiadających prawdę stałą , wieczną .	wypowiadających	6	Plur
Osadza się na odzieży oraz trwałych nieprzepuszczalnych powierzchniach takich jak beton czy asfalt .	nieprzepuszczalnych	6	Plur
Posiadacze fatalnych brodzików kąpią się z zachowaniem wszelkiej ostrożności , używając wody bardziej skąpo niż szczęśliwi posiadacze wanien .	szczęśliwi	15	Plur
Nie zląkł się pątnik cichy .	cichy	4	Sing
Gdy dorośnie , zbuduje swoją katedrę , tworząc powieściowy świat W poszukiwaniu straconego czasu .	straconego	12	Sing
Kardynał przewodniczy tam uroczystościom liturgicznym .	liturgicznym	4	Plur
Posiadał wszechstronny , uniwersalny umysł obejmujący szereg nauk specjalnych .	specjalnych	8	Plur
Latem ubiegłego roku Kubańczyk przybył do kliniki wrocławskiej .	wrocławskiej	7	Sing
Chcieli ich reanimować , ale okazało się to zbędne .	zbędne	8	Sing
Proboszcz parafii wyjaśniał podczas świątecznych kazań , że w tym roku parafię czekają dwie duże uroczystości .	świątecznych	4	Plur
W ciemnym miejscu chodnika do samotnie idącej dziewczyny podbiegł mężczyzna i zgwałcił ją .	idącej	6	Sing
Przyjęcie było bardzo serdeczne .	serdeczne	3	Sing
Siedział już w oknie , z nogami wystawionymi na zewnątrz , ale w porę obezwładnili go i ściągnęli z okna strażnicy miejscy .	miejscy	21	Plur
Zapada mrok , bierze lekki przymrozek .	lekki	4	Sing
Przechodził on długą ewolucję , stając się najpopularniejszym tanim zegarkiem .	długą	2	Sing
Może w dużych ośrodkach miejskich ludzie zagłosują na Juszczenkę , ale we wsiach poparcie dla Janukowicza będzie ogromne .	dużych	2	Plur
Rannymi cywilami zaopiekowali się najpierw amerykańscy sanitariusze z personelu naziemnego .	amerykańscy	5	Plur
Fani industrialnych dźwięków już od rana zjeżdżali do miasta .	industrialnych	1	Plur
Zimą , przylatując na popas do Polski , zadowala się pozostałymi na krzakach jagodami .	pozostałymi	10	Plur
Urodę stołu znakomicie podniosą antyczne lichtarze ze świecami , kryształy i srebra .	antyczne	4	Plur
Podtopiony dom , to była łódź z ludźmi zakotwiczona na środku Sanu .	Podtopiony	0	Sing
Ale czy naprawdę jest już pani przekonana o tym , że tak było .	przekonana	6	Sing
Po odsiadce nie zaprzestał złodziejskiego procederu .	złodziejskiego	4	Sing
Piękno w przyrodzie wydaje się ewolucyjnym luksusem .	ewolucyjnym	5	Sing
Biedny Drossos , sami analfabeci głosowali na niego …	Biedny	0	Sing
Streścił em jej dalszy ciąg i bardzo chichotała .	dalszy	3	Sing
Następnym razem przyprowadzą kolegów i pomalutku piękny sport narciarski zainteresuje bardziej młodzież naszego miasta .	piękny	6	Sing
Byłoby dziwne , gdyby ta większość przekazywała opozycji przewodnictwo najważniejszych komisji .	najważniejszych	9	Plur
Ale nawet najwięksi krytycy Rutkowskiego chwalą jego zdolności autoreklamiarskie .	autoreklamiarskie	8	Plur
Finansowo wspiera Trutnia Gminny Ośrodek Kultury w Rabie Wyżnej , a także skawiańscy biznesmeni z Polski i Chicago .	Gminny	3	Sing
Nastrój jesiennej majówki zepsuła ta dziewczyna .	jesiennej	1	Sing
Była zniszczona również przez żołnierzy napoleońskich .	napoleońskich	5	Plur
Najpierw operatorzy będą mieli miesiąc na poinformowanie klientów o nadchodzących zmianach i zadanie im rutynowego pytania , czy chcą obniżki opłat roamingowych .	roamingowych	21	Plur
Zawsze wygrywał , bo był najszybszy .	najszybszy	5	Sing
Szwedzi , biedny naród , nie znają zapachu piekarni , świeżego , prawdziwego chlebka .	biedny	2	Sing
Cóż znaczyło ośmiu ludzi wobec zbrojnych i groźnych tysięcy ?	groźnych	7	Plur
Jednocześnie następują dynamiczne , ale dostosowane do realiów społecznych i kapitałowych przekształcenia własnościowe .	dostosowane	5	Plur
W województwie świętokrzyskim znajdują się 323 obiekty sakralne .	świętokrzyskim	2	Sing
Zasypiam , ssąc chrupką skórkę przy migoczącym w telewizji Człowieku z żelaza .	migoczącym	6	Sing
Czyżby mniejszy mózg nie był wcale gorszy ? !	mniejszy	1	Sing
Dratewkę pani Joasia wyrwała z bestialskich łap pewnego szewca , którego niech piekło pochłonie .	bestialskich	5	Plur
W samym tylko województwie lubelskim co najmniej kilka tysięcy z nich będzie podczas wakacji dorabiać .	lubelskim	4	Sing
Gdyby udało się skompletować księgę obdarowanych , zawierałaby ona listę nazwisk tworzących znaczną część żelaznego elektoratu SLD .	żelaznego	14	Sing
Wzdłuż kamiennej podmurówki obszedł dom wokoło .	kamiennej	1	Sing
Prezes PiS-u piątkowym wystąpieniem tę opinię potwierdził .	piątkowym	2	Sing
Steve zaklina się , że po każdym dyżurze szykuje ekstra posiłek czworonożnemu ratownikowi .	czworonożnemu	11	Sing
Poprzedziła go jednak półtoragodzinna przerwa .	półtoragodzinna	3	Sing
Niemieccy policjanci twierdzą , że w rachubę nie wchodzi kolizja z innym pojazdem .	Niemieccy	0	Plur
Dziwnym trafem niezależne spółki węglowe zaproponowały bardzo podobne podwyżki .	niezależne	2	Plur
Przekupnie w bazarowych zaułkach opowiadali , że upadek rządu jest bliski i nieuchronny , a ministrowie i generałowie knują spiski albo pakują walizy i szykują się do ucieczki za granicę .	bliski	10	Sing
Woda dokoła niej poróżowiała od zmytego kurzu .	zmytego	5	Sing
Megane oddał synowi , pracownikowi dydaktycznemu warszawskiej uczelni .	dydaktycznemu	5	Sing
Zawsze przechowywała go w budkach u zaprzyjaźnionych handlarzy .	zaprzyjaźnionych	6	Plur
Tak to przynamniej wynika z danych statystycznych zebranych przez Komendę Wojewódzką Policji w Szczecinie .	statystycznych	6	Plur
Serwisy , które go oferują , często zawierają wiele odnośników prowadzących do przykładowych , działających już stron .	prowadzących	10	Plur
Przecież , jak podają gazety , sieć kin objazdowych stale się powiększa .	objazdowych	8	Plur
Najczęstsze przyczyny tragedii to według policji przecenianie własnych możliwości i nietrzeźwość .	Najczęstsze	0	Plur
Jednym z głównych celów rządu jest też szybka integracja z Unią Europejską .	Europejską	11	Sing
Kończy się kolejny odcinek zmagań współczesnego Piotra .	współczesnego	5	Sing
Spirytus jest rozlewany do kartoników litrowych , półlitrowych i ćwiartek .	rozlewany	2	Sing
O siódmej rano , kiedy wszyscy byli już od dawna w polu , przystępowali śmy do młocki .	siódmej	1	Sing
Poprzedziła go jednak półtoragodzinna przerwa .	półtoragodzinna	3	Sing
Jako metal szlachetny nie wypiera wodoru z kwasów , reaguje jedynie z gorącym kwasem azotowym i siarkowym , redukując je do odpowiednich tlenków .	siarkowym	16	Sing
Zostawiono drzewa wskazane przez specjalistów .	wskazane	2	Plur
Nie znosiłem tych białych zup .	białych	3	Plur
Nadleśnictwa z terenu powiatu tucholskiego odwołały zakaz wstępu do lasu .	tucholskiego	4	Sing
W poważnym stopniu przyczynił się do wysokich wyników wydziału .	wysokich	6	Plur
Było to największe w dziejach III RP oddłużenie .	III	5	Sing
Do 1939 miasto leżało po niemieckiej stronie granicy .	1939	1	Sing
Porozumienie to podpisano bez wstępnego konsultowania się z rządem .	wstępnego	4	Sing
Rzecznik Prokuratury Okręgowej w Łodzi Krzysztof Kopania , zasłaniając się dobrem postępowania , odmówił na tym etapie śledztwa odpowiedzi na pytanie , czy ksiądz przyznał się do stawianych mu zarzutów .	stawianych	27	Plur
Liczyli zdobyte łupy , oglądali własne i nieprzyjacielskie straty .	własne	5	Plur
Dlatego językiem oficjalnym stał się arabski , a dąży się , by stał się językiem ogólnonarodowym .	arabski	5	Sing
Poznanie składowych bilansu energetycznego i struktury termicznej lodowców jest dlatego niezwykle ważne .	energetycznego	3	Sing
Tym razem straciła życie moja starsza siostra .	starsza	5	Sing
Do akcji ratunkowej wezwano prawie wszystkich strażaków z zakopiańskiej Jednostki Ratowniczo - Gaśniczej .	zakopiańskiej	8	Sing
Obrazy cyfrowe składają się z połączonych ze sobą pikseli o różnych barwach lub tonach .	cyfrowe	1	Plur
W zaborze rosyjskim po śmierci Aleksandra II , który zginął w zamachu terrorystycznym , nastąpiło gwałtowne zaostrzenie polityki represyjnej we wszystkich dziedzinach życia publicznego .	publicznego	23	Sing
Środki pochodzą z Państwowego Funduszu Rehabilitacji Osób Niepełnosprawnych .	Państwowego	3	Sing
- Strachy lubią głębokie wody .	głębokie	3	Plur
W 1935 roku brytyjski informatyk Alan Mathison Turing wymyślił abstrakcyjną maszynę .	abstrakcyjną	9	Sing
Tam czekały już na nich armatki wodne , podstawione przez władze .	wodne	6	Plur
Usłyszała m kilka taktów renesansowych .	renesansowych	4	Plur
Za każdym razem schodziłem z prądem rzeki i ostrożna ryba doskonale mnie z daleka widziała .	ostrożna	8	Sing
Dwie ranne osoby trafiły do szpitala .	ranne	1	Plur
- W spadku po odchodzącej ekipie nowy rząd otrzymuje olbrzymi deficyt w bilansie handlowym .	handlowym	13	Sing
To maszyna piekielna .	piekielna	2	Sing
- Musimy zebrać ludzi , którzy chcą dokończyć rozpoczęte w 1981 roku dzieło .	1981	10	Sing
- Nie ma ludzi zdrowych , są tylko źle zdiagnozowani .	zdrowych	4	Plur
Powiększona kuchnia stała się obszernym pomieszczeniem mieszczącym duży stół .	obszernym	4	Sing
Istotne jest , aby cele edukacji ekologicznej zostały przełożone na język konkretów mających zastosowanie w codziennych działaniach ucznia .	przełożone	8	Plur
Bracia Kaczyńscy chcą w tej chwili albo koalicji na swoich warunkach , albo przyspieszonych wyborów .	przyspieszonych	13	Plur
Tym bardziej jest to smutne , gdy czynią to urzędnicy rządowi , którzy mają być apolityczni .	apolityczni	15	Plur
Wódz zacisnął sine wargi .	sine	2	Plur
Masowy powrót przyniósł by doraźne korzyści budżetowi .	doraźne	4	Plur
Ograniczenie szybkości obowiązuje tutaj od soboty z powodu rutynowych prac konserwatorskich .	konserwatorskich	10	Plur
Ponoć dawano Edkowi możliwość ucieczki z więzienia w Bielsku , gdzie trzymano ich przed odesłaniem do obozu .	dawano	1	Sing
- Na tym wyczerpali śmy listę posłów zapisanych do zabrania głosu .	zapisanych	7	Plur
Twoje inicjatywy , konkretne , praktyczne i pożyteczne , zyskają uznanie i poparcie .	pożyteczne	7	Plur
Po jego obu bokach zwisają nawleczone na sznur perły nazywane Paternoster .	nazywane	9	Plur
Dotychczasowa siedziba Archiwum jest przede wszystkim za mała w stosunku do wzrastających w szybkim tempie zbiorów .	szybkim	13	Sing
Po badaniach w szpitalu został wypuszczony do domu .	wypuszczony	5	Sing
Na szczególną uwagę zasługują wyraźnie zaakcentowane potrzeby pracy nad własnym charakterem .	własnym	9	Sing
Słuszne pytania i odpowiedzi mieszają się z podłymi .	Słuszne	0	Plur
To były fajne czasy .	fajne	2	Plur
- Panie McEnroe , nieodwołalnie udaje się Pan , w wieku 33 lat , na tenisową rentę ?	tenisową	15	Sing
Wyznaczeni posłowie zajęli miejsca .	Wyznaczeni	0	Plur
Podłączyli śmy go do sztucznych komór , czekał na dawcę .	sztucznych	4	Plur
Ale nie rozumiem , jak można w imię ekumenizmu wysuwać roszczenia do tworzenia w Europie stref monopolistycznych wpływów religijnych .	monopolistycznych	16	Plur
Daleko na czarnym niebie leżała jaśniejsza smuga .	jaśniejsza	5	Sing
Trudne warunki pozwolą co najwyżej wymyśleć cieplejszy korzuch .	cieplejszy	6	Sing
Równocześnie wznoszono nowoczesne dzielnice mieszkaniowe .	mieszkaniowe	4	Plur
Agnieszka Strumiłowska opowiedziała mi historię z jej czasów studenckich .	studenckich	8	Plur
Rozmawiali odwróceni plecami .	odwróceni	1	Plur
Sejm zaaprobował przekroczenie budżetowe , co przekreśliło sens dalszych działań Trybunału Stanu .	budżetowe	3	Sing
W Gnieźnie w sylwestrowy wieczór zginęli podczas pożaru trzej chłopcy , a jadący do akcji samochód strażacki wpadł na dwie kobiety .	strażacki	16	Sing
Jest jednym z nielicznych polskich twórców , którzy zrobili prawdziwie wielką międzynarodową karierę .	międzynarodową	11	Sing
Znacznie lepiej zagrał przed przerwą Kwapisiewicz na lewym skrzydle .	lewym	7	Sing
Pod jej nosem błyszczał pot , musiała biec , widocznie firma pilnująca mieszkania nie zawiadomiła jej o wyłączeniu alarmu .	pilnująca	11	Sing
Biblioteki kościelne zostały także obdarowane kolekcjami .	kościelne	1	Plur
Należy podkreślić , że gaźnik jest ważnym elementem samochodu , gdyż oprócz ekonomicznego zużycia paliwa w znacznym stopniu wpływa również na niezawodność jazdy i stałą gotowość techniczną pojazdu .	ważnym	6	Sing
Na Ziemi Lubuskiej prace przedsiewne , zwłaszcza na glebach lekkich przybierają na sile .	lekkich	9	Plur
Zacisnął em palce na szorstkim płótnie i wyczuł em obłe kształty pocisków .	obłe	9	Plur
Rękaw pięknie wyszywanego fraka prędko nasiąkł krwią .	wyszywanego	2	Sing
Wyprawa Magellana opłynęła wokół kulę ziemską .	ziemską	5	Sing
I zrozumieli ludzie , że tu Bóg był , i zburzyli ten sądowy dom , aby w nim nikt już więcej po Panu Jezusie nie sądził , a przed jabłonnymi drzewami postawili krzyż i on do dziś tam stoi .	jabłonnymi	29	Plur
Największy dług to kilkanaście tysięcy z odsetkami .	Największy	0	Sing
Jako członek komisji śledczej , który cały czas dążył do zniesławienia lewicy , zaszkodził nam najbardziej .	śledczej	3	Sing
Policja przypuszcza , że najnowszy ładunek został porzucony przez spłoszonego niedoświadczonego terrorystę .	spłoszonego	9	Sing
Pomysł powstał podczas uzupełniania ksiąg parafialnych , które były skrupulatnie sprawdzane podczas duszpasterskich wizytacji .	duszpasterskich	12	Plur
Z innych danych wynika , że z 37 masowców , które zatonęły w okresie od stycznia 1992 do marca 1996 , większość stanowiły statki tanich bander .	tanich	24	Plur
Sprawą włamania do domu wokalistki Blue Cafe zajęli się policjanci z komisariatu przy ul . Ciesielskiej .	Ciesielskiej	15	Sing
Trzy osoby podejrzane o korupcję , w tym profesora , który przewodniczył komisji egzaminującej weterynarzy , zatrzymali warmińsko - mazurscy policjanci .	podejrzane	2	Plur
W wyniku nieadiabatycznego ochładzania najniższych warstw troposfery powstają , ogólnie biorąc , najniższe chmury warstwowe .	najniższych	4	Plur
W ten sposób mieli oni zakończyć dwuletnie studia podnoszące kwalifikacje zawodowe .	dwuletnie	6	Plur
- Mamy tu więcej stanowisk strzeleckich .	strzeleckich	5	Plur
Na razie jest kicha , bo spółki samorządowe i prywatne mają tylko 5 proc . łóżek .	samorządowe	7	Plur
Rozebrał się , wszedł do rzeki , zanurkował przy urwistym brzegu .	urwistym	9	Sing
Pełna stawka wynosi obecnie 840 zł miesięcznie .	Pełna	0	Sing
Daje on młodym ludziom szansę wykazania się umiejętnościami organizatorskimi .	organizatorskimi	8	Plur
O tym , że pogoda ostatnio nas nie rozpieszcza , przekonał się właściciel lubelskiego sklepu futrzarskiego .	lubelskiego	13	Sing
Najbardziej narażone na skargi niezadowolonych klientów są placówki handlowe .	niezadowolonych	4	Plur
W strukturze współczesnego systemu szkonictwa wyższego w Polsce państwowe i niepaństwowe uczelnie dzielimy na dwie kategorie .	niepaństwowe	10	Plur
To wyjątkowa kobieta .	wyjątkowa	1	Sing
W opinii tej było tyleż przesady , ile podziwu dla niepokornych górali , którzy pozostawali wierni i lojalni , dopóki stara przyjaźń nie zaczynała dla nich samych stanowić zagrożenia .	niepokornych	10	Plur
Wzmocni ją możliwość bezpośredniego przekazywania prezydentowi poufnych informacji .	poufnych	6	Plur
Karykaturzysta Gulbransson miał małżonkę tak małomówną , że milczała całymi miesiącami .	małomówną	5	Sing
Zobowiązanie to zostało już wykonane .	wykonane	4	Sing
Wiślacy zgnietli niemiecką drużynę siłą ofensywy .	niemiecką	2	Sing
- Nie tęskni Pan za niespełnionym marzeniem ?	niespełnionym	5	Sing
Nie czuje się pani trochę odsunięta przez Leppera ?	odsunięta	5	Sing
Bo jest byłym gliną ?	byłym	2	Sing
Chodzi o to , aby uczniowie w odpowiednich warunkach mogli realizować cele w ramach poszczególnych przedmiotów , zajęć pozalekcyjnych czy pozaszkolnych .	poszczególnych	14	Plur
Jak widzę procesy zachodzące w sztuce ostatniego stulecia ?	zachodzące	3	Plur
Przewiduje on wynajęcie firm zewnętrznych , które zajmą się utrzymaniem sieci abonenckiej TP SA .	zewnętrznych	4	Plur
Policja przypuszcza , że najnowszy ładunek został porzucony przez spłoszonego niedoświadczonego terrorystę .	najnowszy	4	Sing
Przejazd we wrocławskich Świniarach nie jest strzeżony .	wrocławskich	2	Plur
Do tego dochodzą rachunki za telefon , wydatki na materiały piśmienne , na znaczki .	piśmienne	10	Plur
Po godzinie 15 przyjechał samochód ze specjalnym basenem z wodą , w którym umieszczono niebezpieczne butle .	niebezpieczne	14	Plur
Postulaty protestujących zarząd miasta uznał za bezzasadne .	bezzasadne	6	Plur
Zdaniem konkurentów , wyznaczył kanon radiowej prowokacji w warunkach polskich .	radiowej	5	Sing
Zbliżył się do nas , wydawał się zakłopotany .	zakłopotany	7	Sing
Uważają nas za moskalofilów , takich zaprzańców antyukraińskich , podczas gdy sami deklarują ukraiński patriotyzm .	antyukraińskich	7	Plur
Niemiecka liga hokeja należy do jednej z najlepszych lig w Europie .	najlepszych	7	Plur
– Będę gdzieś około jedenastej tym razem .	jedenastej	4	Sing
Popierają regionalne środowiska twórcze .	regionalne	1	Plur
Wypowiedział wojnę wielu bardzo różnym środowiskom .	różnym	4	Plur
Przeważnie zdarzają się zwichy tylne , obrotowo - tylne i przednie 5 . kręgu lędźwiowego .	tylne	4	Plur
Czy nowa białoruska elita intelektualna jest już ukształtowana ?	intelektualna	4	Sing
Funkcjonariusze apelują do mieszkanek Kwidzyna , aby w najbliższym czasie unikały ciemnych miejsc .	ciemnych	11	Plur
Dwa tygodnie temu oddano do użytku salę gimnastyczną przy II Liceum Ogólnokształcącym .	Ogólnokształcącym	11	Sing
Pod władzą nowego proboszcza rozpoczęła się reforma skostniałej kościelnej instytucji .	nowego	2	Sing
Wczoraj , po zamknięciu lokali wyborczych , niemieckie media zapowiedziały , że pani minister ustąpi ze stanowiska .	niemieckie	7	Plur
- Mówi bezbarwnie , ale oczy jego są teraz twarde .	twarde	9	Plur
Zajęcia teatralne i plastyczne , konkursy , zabawy , filmy i wycieczki przyciągnęły nowych uczestników .	teatralne	1	Plur
Zasadnicze znaczenie ma bilans cieplny powierzchni , dna i jego wnętrza .	Zasadnicze	0	Sing
Poza tym tych delikatnych wzorów nie zalewała minia i lakier .	delikatnych	3	Plur
Bo złodziej oskarża ich o pobicie , kradzież telefonu komórkowego i 50 złotych !	komórkowego	9	Sing
Od 1993 r . jest kierownikiem Zakładu Współczesnych Teorii Ekonomicznych , a od 1999 r . pełni funkcję dziekana Wydziału Ekonomiczno - Socjologicznego Uniwersytetu Łódzkiego .	1993	1	Sing
Dach przypomina fale morskie , które często zdobią japońskie drzeworyty .	japońskie	8	Plur
Zanim wiązanki kwiatów przykryły mogiłę , słowa modlitwy prowadzonej przez ks . Pawła Dorucha splatały się z wyrazami bólu i wspomnieniami przyjaciół .	prowadzonej	8	Sing
- Czy Pana zdaniem istnieje coś takiego jak przyjaźń polityczna ?	polityczna	9	Sing
Wydarzeniu patronował marszałek województwa mazowieckiego Adam Struzik .	mazowieckiego	4	Sing
Do najciekawszych należą parki w Wierzonce i Owińskach .	najciekawszych	1	Plur
Dobrze znosi warunki miejskie .	miejskie	3	Plur
Inwestycję wznowiono w połowie 2004 roku , a wartość zadania wynosi 5,6 miliona złotych .	2004	4	Sing
Z pism Slazskiej Energetiki wynika , że opalana węglem nowa elektrociepłownia w Trzyńcu będzie spełniała wszystkie europejskie normy ekologiczne .	ekologiczne	18	Plur
Są ponadto zależni od społeczności wyższych , które mają zwyczajowe prawo ingerowania w życie tych ludzi .	wyższych	5	Plur
Szczegółowo analizowane są zapisy z kamer monitorujących , które znajdują się na terenie Kwidzyna .	analizowane	1	Plur
Takie było zapotrzebowanie , ale bardziej lubię żarty sytuacyjne i abstrakcyjne .	abstrakcyjne	10	Plur
Nad głową ojca dyrektora od kilku tygodni gromadzą się czarne chmury .	czarne	9	Plur
Jego stałym zastępcą jest oficer G3 .	stałym	1	Sing
Poranione potłuczoną butelką zwierzę trafiło do weterynarza .	potłuczoną	1	Sing
Co jest ważne ?	ważne	2	Sing
Dwunastościan foremny miał symbolizować ład kosmiczny .	foremny	1	Sing
Kolejny pijany policjant straci pracę .	pijany	1	Sing
Poczuł em się wyróżniony ponad zasługę .	wyróżniony	3	Sing
Od dwóch lat Truteń przewodzi wśród kabaretów wiejskich .	wiejskich	7	Plur
Jesteś szczery , prostolinijny , ale prawdopodobnie swoje własne opinie będziesz zatrzymywać dla siebie .	własne	8	Plur
Należy podkreślić , że gaźnik jest ważnym elementem samochodu , gdyż oprócz ekonomicznego zużycia paliwa w znacznym stopniu wpływa również na niezawodność jazdy i stałą gotowość techniczną pojazdu .	znacznym	16	Sing
Myślał już o czekającym go etapie .	czekającym	3	Sing
Symbolizują zmienną fortunę i uzasadniają nawoływania do stoickiego znoszenia dopustów losu albo chrześcijańskiej ufności w Bogu .	stoickiego	7	Sing
W Technikum Mechanicznym wszystkie osoby zaliczyły pierwszy etap .	Mechanicznym	2	Sing
Odcinali go z najmłodszym synem .	najmłodszym	3	Sing
Społeczeństwo wychowywano w ślepym posłuszeństwie wobec Cesarstwa .	ślepym	3	Sing
Był brytyjski lotniskowiec , amerykańskie fregaty , hiszpańska piechota morska , portugalscy komandosi , polscy lotnicy .	portugalscy	11	Plur
Chociaż pamiętał ją , jak w ubiegłym roku jeszcze brała się za kosę .	ubiegłym	6	Sing
W innych miejscach znaleziono wyszlifowane i porysowane przedkarbońskie skały podłoża .	przedkarbońskie	7	Plur
Obaj skrupulatnie przepisywali rezultaty kolejnych odcinków specjalnych , by w pokojach hotelowych dokładnie je przeanalizować .	hotelowych	11	Plur
Gdy na miejscu zjawili się policjanci z komisariatu kolejowego policji , schronisko znajdowało się w opłakanym stanie .	kolejowego	8	Sing
Nagrody nie mogą być przyznawane pośmiertnie .	przyznawane	4	Plur
Na kapitał zagraniczny otwiera się też sektor bankowy i ubezpieczeniowy .	bankowy	7	Sing
Liczę na bliższe informacje .	bliższe	2	Plur
- Czytał em , choć czuł em się coraz mocniej poniżony .	poniżony	10	Sing
Oceniając strajk , Gawin oświadczył , że ruch towarowy praktycznie się nie odbywał , a na Śląsku stanęło wiele pociągów pasażerskich .	pasażerskich	20	Plur
Zawody będą rozgrywane na Dunajcu na odcinku od Krościenka do mostu w Gołkowicach .	rozgrywane	2	Plur
Szeroka blizna na czole jest jeszcze bardzo świeża .	świeża	7	Sing
Ale to nie tylko zadanie związku , bo kolosalne znaczenie ma też jakość hal .	kolosalne	8	Sing
Biedny Wojtek wysługuje się .	Biedny	0	Sing
Braliśmy udział w walkach o niepodległość Stanów Zjednoczonych Ameryki Południowej .	Południowej	9	Sing
Opolscy ciepłownicy obawiają się , że ich straty w pierwszych miesiącach nowego roku mogą się okazać horrendalne , bo na podwyżkę ceny węgla nałożyła się także wyjątkowo łagodna zima , która zmniejszyła zapotrzebowanie na ciepło .	Opolscy	0	Plur
Stare gmachy , dostojne i omszałe , coraz bardziej upodobniają się do mamutów , wchłanianych w błoto epoki polodowcowej .	wchłanianych	14	Plur
Od stycznia na ich drodze pojawiły się niespotykane dotąd rafy .	niespotykane	7	Plur
Powiększona kuchnia stała się obszernym pomieszczeniem mieszczącym duży stół .	mieszczącym	6	Sing
Wymóg obywatelstwa i miejsca stałego zamieszkania to posunięcia antydemokratyczne .	antydemokratyczne	8	Plur
Zanieczyszczenia cytoplazmatyczne i błonowe są również groźne , stanowiąc prawdopodobne źródło zarówno aktywności proteolitycznej , jak i białek cytoplazmatycznych w puli niehistonowej .	cytoplazmatycznych	18	Plur
Kosmetyka jest tylko bardzo pożądanym dodatkiem .	pożądanym	4	Sing
Leczenie ataków padaczkowych polega na podawaniu leków przerywających drgawki niezależnie od ich przyczyny .	padaczkowych	2	Plur
Byli następni w kolejce .	następni	1	Plur
Po prostu uważam , że ciało eteryczne nie załatwia sprawy .	eteryczne	6	Sing
W 1979 utworzono tu Szkołę Mistrzów Pszczelarskich .	Pszczelarskich	6	Plur
Wielu obawia się , że będzie skazany na typowe pieskie życie .	typowe	8	Sing
Kryzys zaufania zawsze ma negatywne i długofalowe konsekwencje wychowawcze .	długofalowe	6	Plur
Całej imprezie groziła katastrofa , mimo że istniała możliwość otrzymania odszkodowania z towarzystwa ubezpieczeniowego .	Całej	0	Sing
W przypadku BIG-u ostatni miesiąc roku obrachunkowego przyniósł wynik poniżej tegorocznej średniej .	tegorocznej	10	Sing
Czy był oralny i analny ?	oralny	2	Sing
Wówczas koła łowieckie będą dbały , aby populacja nie rozrastała się ponad dopuszczalną .	łowieckie	2	Plur
Był sparaliżowany , stracił mowę i pamięć .	sparaliżowany	1	Sing
Z tych najgorsi byli ci od Kota .	najgorsi	2	Plur
- Skoro pani minister już podniosła kwestię wpływów podatkowych z rozmaitych województw i ich proporcji , myślę , że warto się nad nimi zastanowić , gdyż są one czasami dziwne i nie wiadomo , z czego wynikają .	rozmaitych	10	Plur
Owa niezapomniana chwila zawierała nieprawdopodobny ładunek patosu .	niezapomniana	1	Sing
W licznych miejscach Zakopanego znajdują się jego rzeźby .	licznych	1	Plur
Zdenerwowani są także kierowcy .	Zdenerwowani	0	Plur
Trenerzy cały czas obserwują zawodników i nie zdecydowali , kto znajdzie się w podstawowej szóstce .	podstawowej	13	Sing
Na szczęście voyagerom wyznaczono cele .	wyznaczono	3	Sing
Kupmy jej srebrne .	srebrne	2	Plur
Trzynastolatek był członkiem grupy przestępczej , w której działali oskarżeni o jego późniejsze zabójstwo .	przestępczej	4	Sing
Dziwnie było iść białymi korytarzami , nie wiedząc , dokąd prowadzą .	białymi	3	Plur
- Minister Kulesza uważa , że nieprzeprowadzenie tej reformy spowoduje wyborczą porażkę .	wyborczą	10	Sing
Przechodzimy do kolejnego pytania .	kolejnego	2	Sing
W półfinałach rozegrano mecze systemem pucharowym , a zwycięzcy awansowali do finałów .	rozegrano	2	Sing
Dowódca sił amerykańskich w Afganistanie generał Tommy Franks zapowiedział kolejne operacje lądowe .	lądowe	11	Plur
Sikora nie włączył się w działalność struktur podziemnych .	podziemnych	7	Plur
Do Sieradza jest tylko kilka bezpośrednich połączeń dziennie .	bezpośrednich	5	Plur
Sprawa została upubliczniona na ostatniej miejskiej sesji .	miejskiej	5	Sing
Cała nadzieja na przerwanie szaleństwa tworzenia urzędów centralnych tkwi w prezydencie .	centralnych	7	Plur
Początkowo zapanował iście świąteczny nastrój .	świąteczny	3	Sing
W sezonie letnim w 2005 r. utonęło 325 osób .	2005	4	Sing
W czasie pozorowanych działań bojowych jednostki z pozycji obronnych dokonają przegrupowania , aby po sforsowaniu szerokiej przeszkody wodnej wyjść na nowe rubieże aktywnych działań zaczepnych .	pozorowanych	2	Plur
Wiedziała ruda dziewczynka z warkoczykami i piegowatym noskiem .	piegowatym	6	Sing
Ja jestem biseksualny .	biseksualny	2	Sing
Zerwał em suchą trawkę i zaczął em ją powoli żuć .	suchą	2	Sing
O zawilgoceniu gruntu i budynków informowali jedynie archeolodzy prowadzący wykopaliska na starówce .	prowadzący	8	Plur
Niebieskie światełko zgasło .	Niebieskie	0	Sing
Z głośników leciała palestyńska muzyka .	palestyńska	3	Sing
Pamiętam szare światło .	szare	1	Sing
Ludzie uważają , że do kłopotów z uzyskaniem zgody przyczynili się inwestorzy starający się o pozwolenie na budowę małego osiedla na działce sąsiadującej z ogródkami mieszkańców .	starający	12	Plur
Sądził em , że szarość nie powinna być niema .	niema	8	Sing
Wyrok ten uchylił sąd apelacyjny .	apelacyjny	4	Sing
Od 1993 r . jest kierownikiem Zakładu Współczesnych Teorii Ekonomicznych , a od 1999 r . pełni funkcję dziekana Wydziału Ekonomiczno - Socjologicznego Uniwersytetu Łódzkiego .	1999	13	Sing
Władza w tym okresie nie chciała ośmieszać się tak prymitywną propagandą .	prymitywną	9	Sing
Nieznani sprawcy w nocy z wtorku na środę zbezcześcili cmentarz w Akwizgranie .	Nieznani	0	Plur
Ma wobec niej myśli uwolnione z więzów .	uwolnione	4	Plur
Trudniejsze jest wtedy automatyczne sprawdzanie kompletności .	Trudniejsze	0	Sing
Najliczniejszy rój perseidów dotarł na ziemię kilka lat temu .	Najliczniejszy	0	Sing
Nietęgie miny mają strzelcy szwedzcy .	Nietęgie	0	Plur
Komputery podłączone do Sieci mogą skorzystać z okna zadań badawczych .	podłączone	1	Plur
On też to zauważył i wyciągnął natychmiast wnioski bojowe .	bojowe	8	Plur
Wzburzony ojciec zawiadomił policję , ale z chciwą pedagog i tak się umówił .	chciwą	7	Sing
Załogi z niepokojem śledzą ciche chmury nadchodzące z południa .	nadchodzące	6	Plur
Serduszka czekoladowe będą rozdawane w autobusach dla par .	rozdawane	3	Plur
Karolina jest drobną szatynką o dużych brązowych oczach .	dużych	5	Plur
Próba obalenia rządu ujawniła dziwne mechanizmy istniejące w naszym państwie .	istniejące	6	Plur
Była pierwszorzędną babcią .	pierwszorzędną	1	Sing
A dobra rzadsze są tym cenniejsze .	cenniejsze	5	Plur
W tym dniu życzenia owocnych obrad przekazali zjazdowi przewodniczący delegacji partii komunistycznych i robotniczych z krajów socjalistycznych .	socjalistycznych	16	Plur
Użytkowanie przez spółdzielnię wkładów gruntowych jest odpłatne .	gruntowych	4	Plur
Przed tygodniem wicestarosta Hrycyna podczas wyjazdu do Gdańska uzyskał przychylność tamtejszych środowisk żydowskich .	żydowskich	12	Plur
Spośród trzystu ochotników Polluks wybrał stu najlepiej znających się na morzu .	znających	7	Plur
Chętnie zatrudniłby w ministerstwie doświadczonych ludzi z organizacji ekologicznych .	ekologicznych	8	Plur
Rdzenni mieszkańcy wyspy stanowią rozpaczliwą mniejszość .	Rdzenni	0	Plur
W Zborowie powstał obiekt o powierzchni użytkowej 3364 metrów kwadratowych , w którym zamieszka 50 osób .	kwadratowych	9	Plur
Kabiny obu samochodów zostały doszczętnie zmiażdżone .	zmiażdżone	5	Plur
Nowe tablice rejestracyjne będą białe z czarnymi napisami i znakiem legalizacyjnym .	białe	4	Plur
Po 100 latach były w dobrym stanie , bez widocznych zniszczeń zewnętrznych .	widocznych	9	Plur
– ciemne włosy ma ?	ciemne	1	Plur
– domki ro jednorodzinne i ogródki działkowe tam są .	działkowe	6	Plur
Niektórzy z idiotów tylko onanizując się zaspokajają swoje potrzeby seksualne .	seksualne	9	Plur
Nowi ustne rozpoczęli od geografii .	ustne	1	Plur
Nawet u mnie nie byli , bo formalności wizowe trwały zbyt długo .	wizowe	8	Plur
Jeżeli człowiek silnie reaguje na różne zjawiska , może być tak odbierany .	różne	5	Plur
Zajmował się innymi sprawami , raczej oddalonymi od zainteresowań pisarskich .	pisarskich	9	Plur
Różnymi technikami były również nanoszone poszczególne rysunki .	poszczególne	5	Plur
Z zasady oglądam trzecią próbę generalną .	generalną	5	Sing
Nad pozostałymi obszarami dominują układy wyżowe .	pozostałymi	1	Plur
Są legalnie działające firmy zajmujące się przeróbkami .	zajmujące	4	Plur
Mimo realizacji wielu programów adresowanych do osób niepełnosprawnych oraz możliwości zakupu sprzętu rehabilitacyjnego , nadal dla wielu osób problemem jest zdobycie wózka inwalidzkiego .	inwalidzkiego	22	Sing
- Czy w zaświatach dalej puszczasz się z żydowskimi demonami ?	żydowskimi	8	Plur
Z połączonych dłoni zrobili koło .	połączonych	1	Plur
Internet pozwala komunikować się poprzez rozliczne kanały rozmów w czasie rzeczywistym .	rzeczywistym	10	Sing
Wzorem większości producentów przeczytał wyłącznie krótkie streszczenie zawarte na pierwszej stronie , ale po jego minie można było wyczytać , że sama koncepcja go urzekła .	zawarte	7	Sing
A320 jest prekursorem wśród odrzutowców liniowych .	liniowych	5	Plur
Niestety był to wpływ negatywny , pogłębiający istotniejące już uprzedzenia .	pogłębiający	6	Sing
- Czy wniosek był zgłoszony na 12 godzin wcześniej ?	zgłoszony	4	Sing
- Dokumenty dotyczące wyroku białostockiego sądu jeszcze nie trafiły do ministerstwa .	białostockiego	4	Sing
Tutaj jedynie pokrótce opiszemy ten standard i nieco uzupełnimy zaprezentowane w wymienionych artykułach informacje .	zaprezentowane	9	Plur
Świat jest chaotyczny , procesy rozwojowe nie układają się w logiczne ciągi i trzeba się z tym pogodzić .	logiczne	10	Plur
Karykaturzysta Gulbransson miał małżonkę tak małomówną , że milczała całymi miesiącami .	całymi	9	Plur
Spłonęły papiery , stare szmaty , niepotrzebne sprzęty .	niepotrzebne	6	Plur
Lżejsze podpórki chwytał po dwie i prawie biegnąc rzucał je na platformę .	Lżejsze	0	Plur
Na ich temat nic również nie powiedzieli płatni informatorzy , do których w tej sprawie zwrócili się policjanci prowadzący dochodzenie .	płatni	7	Plur
To ich zabawy domowe , tego się przy obcych nie robi , ale swój jest swój .	domowe	3	Plur
Zimna woda tryskała na głowę , szyję i płonące uszy .	płonące	8	Plur
W wysokiej trawie leżały setki stygnących ludzkich ciał .	wysokiej	1	Sing
Mieszkał em w domu polskich księży , niedaleko osobliwej piramidy , grobowca Cestiusza .	osobliwej	8	Sing
Ostatnio sprzedano cztery pod elektrownie wiatrowe .	wiatrowe	5	Plur
" W dzieciństwie byłam często wyzywana i bita " .	bita	7	Sing
Padały jeszcze pytania o drogi krajowe biegnące przez wsie .	biegnące	6	Plur
Teraz siedziała wyprostowana na łóżku , z napięciem wpatrując się w twarze Blothów .	wyprostowana	2	Sing
W prańskich koncertach wystąpi jeszcze parokrotnie .	prańskich	1	Plur
Detektyw precyzyjnym sztychem przeszył jego prawe ramię .	precyzyjnym	1	Sing
Nieżyczliwi twierdzą , że wojewoda chorował inaczej .	Nieżyczliwi	0	Plur
Techniki układali w zamknięty występ .	zamknięty	3	Sing
Pierwsza stanęła Parnecka .	Pierwsza	0	Sing
NBP OBNIŻYŁ o 4 punkty procentowe stopę swoich kredytów .	procentowe	5	Plur
Według nieoficjalnych informacji próbował otruć suczkę .	nieoficjalnych	1	Plur
– Musiałbym być szalony , żeby ci powiedzieć .	szalony	3	Sing
Wirują mu musztardowe księżyce i słońca , a na samym dole żagla zjawia się łeb wieloryba o mikroskopijnych , czerwonych oczach .	musztardowe	2	Plur
Mimo realizacji wielu programów adresowanych do osób niepełnosprawnych oraz możliwości zakupu sprzętu rehabilitacyjnego , nadal dla wielu osób problemem jest zdobycie wózka inwalidzkiego .	rehabilitacyjnego	12	Sing
Poruszyły się wskaźniki na podświetlanych zegarach .	podświetlanych	4	Plur
Rudowłosa pani Hania błyskawicznie wydawała karty drogowe , tablice rajdowe , plakietki , oficjalne itinerery .	oficjalne	13	Plur
Budynek podpalono .	podpalono	1	Sing
Izrael poniósł w Libanie dotkliwą porażkę polityczną .	dotkliwą	4	Sing
Jej dochód był nieco wyższy niż średnia krajowa .	krajowa	7	Sing
Śmieszy mnie ta zabawa w barbarzyńcę , bezmyślne opróżnianie butelek pod krzyżówkę Mickiewicza z amerykańskim hamburgerem .	bezmyślne	7	Sing
Tym razem postawiono na casting także w mniejszych miastach .	mniejszych	7	Plur
Od zbłąkanych misjonarzy uchroń nas , Panie .	zbłąkanych	1	Plur
Prokuratura orzekła , że jest niepoczytalny .	niepoczytalny	5	Sing
Już mnie tu nie zastaną i będą bardzo zdziwieni .	zdziwieni	8	Plur
Prezes ma całkowitą kontrolę nad swoją firmą , a bezpośrednia władza premiera kończy się na progu jego sekretariatu .	całkowitą	2	Sing
Antybiotyki to związki chemiczne wytwarzane w naturze przez same drobnoustroje .	chemiczne	3	Plur
Tylko powszechne uwłaszczenie obywateli stwarza dla Polaków ostatnią szansę na uzyskanie realnych praw własności .	realnych	11	Plur
Ugryzienia osy , pszczoły , trzmiela i szerszenia mogą być niebezpieczne .	niebezpieczne	10	Plur
Wszystkie pieniądze z aukcji zostaną przeznaczone na budowę nowego oddziału przeszczepowego dla dzieci z białaczką przy szpitalu w Poznaniu .	przeznaczone	5	Plur
Układy ACC technologiczne stosuje się przede wszystkim do obróbki zgrubnej w celu maksymalizacji wydajności obróbki .	ACC	1	Plur
Uszkodzone zostały wówczas 932 zabytkowe drzewa .	Uszkodzone	0	Plur
Tam czekał już pluton egzekucyjny , dowodzony przez podoficera .	egzekucyjny	4	Sing
W województwie świętokrzyskim znajdują się 323 obiekty sakralne .	świętokrzyskim	2	Sing
Jest to aminokwas poprawiający pamięć starzejącej się komórki .	starzejącej	5	Sing
Taboret upadł z dramatycznym łoskotem , a on , wierzgając nogami , zawisł niczym gotowy do wypatroszenia wieprz .	dramatycznym	3	Sing
Dlaczego chrześcijanie mają być popierani przez państwo ?	popierani	4	Plur
Bo rodzice będą wymyślać kary za złe stopnie .	złe	6	Plur
Na kapitał zagraniczny otwiera się też sektor bankowy i ubezpieczeniowy .	ubezpieczeniowy	9	Sing
Prace regulacyjne doprowadziły by do zniszczenia siedliska bobrów i do przepędzenia ich w nieznane .	regulacyjne	1	Plur
I tą karminową kredką nakreśliła trzeci werset , pod tamtymi .	karminową	2	Sing
Ostatnio równie wysoką inflację mieliśmy we wrześniu 1998 r .	1998	7	Sing
Łukasz zatrzymał przejeżdżającą taksówkę .	przejeżdżającą	2	Sing
- To była szopka jak za dawnych lat .	dawnych	6	Plur
Czemu są nieruchliwi niczym drewniane posągi ?	drewniane	4	Plur
Ich przyczyną były nagłe zmiany w materiale genetycznym wirusa .	genetycznym	7	Sing
Duch Boży mówi , abym szedł . . .	Boży	1	Sing
Analiza spektrometryczna wykazała , że jego skład izotopowy jest typowy dla procesów reaktorowych , a nie wybuchu jądrowego .	izotopowy	7	Sing
Podczas pobytu w elbląskim garnizonie najczęściej towarzyszyli mu dowódca stacjonującej tam dywizji , komendant szpitala wojskowego i kapelan .	stacjonującej	9	Sing
Przybysze z najnowszej fali na ogół stronią od polonijnych organizacji społecznych .	społecznych	10	Plur
Będą także mogli bezpłatnie zamawiać zdjęcia nagich modelek .	nagich	6	Plur
Ciemne włosy , spięte w koczek , podtrzymywała złocista spinka .	spięte	3	Plur
Zdaniem Marka Markiewicza , polityczną dojrzałość polityk osiąga dopiero po czterdziestce .	polityczną	4	Sing
To najwyższa nagroda dla gospodarzy .	najwyższa	1	Sing
Rezolucja wypowiada się przeciwko istnieniu narodowych sił nuklearnych , ale nie przeciwko samej broni nuklearnej .	samej	12	Sing
Ale okres ten jest już pogodniejszy od Popielca .	pogodniejszy	5	Sing
Podczas zajęć rękodzielniczych , mimo początkowego wątpienia we własne możliwości , młodzież tworzyła ozdoby wielkanocne .	rękodzielniczych	2	Plur
Trzydniową konferencję zorganizował Interpol .	Trzydniową	0	Sing
Artyści z trzech akademii sztuk pięknych oglądali wczoraj budynki przy ulicy Zamkowej .	pięknych	5	Plur
Droga do Falsztyna prowadzi przez łagodne wzgórza Pienin Spiskich .	łagodne	5	Plur
Ciągle jeszcze wybieramy naszych bohaterów i ich losy z miarką społeczną .	społeczną	10	Sing
Dostrzegł pędzącego byka .	pędzącego	1	Sing
Prezes OSP Stanisław Kocot wyjaśniał , że będą to nowoczesne , otwierane za pomocą pilota bramy , które znacznie ułatwią strażakom wyjazdy do akcji .	nowoczesne	9	Plur
No kto , na przykład , zbudował radziecką bombę atomową ?	radziecką	7	Sing
- Ustępstwa wobec anestezjologów zostały wymuszone .	wymuszone	5	Plur
To informacja poprzedzona chrząknięciem , ściszeniem głosu , podana jakby mimochodem .	poprzedzona	2	Sing
Stanowi to 0,7 proc . budżetu państwa i jest najniższą od trzech lat sumą przeznaczaną na kulturę .	najniższą	9	Sing
Ewentualna ratyfikacja Konkordatu przed przyjęciem nowej konstytucji zaważyłaby zapewne na jej ostatecznym brzmieniu , odbierając Konstytucji RP charakter nowoczesnej ustawy zasadniczej demokratycznego państwa .	nowoczesnej	18	Sing
Dla cięższej gramatury gastronomicznej trzykrotnie polskości się wyparłem .	cięższej	1	Sing
W ubiegłym roku udało się tę pozycję zmieścić w budżecie .	ubiegłym	1	Sing
Tępe łby zamieszczają zdjęcia .	Tępe	0	Plur
Podobnie jak we współczesnej Japonii , również w Tybecie żywe są dawne herbaciane tradycje , chociaż przyczyny ich kultywowania są zgoła odmienne .	współczesnej	3	Sing
Spodziewa się Pan , że wyższy wzrost gospodarczy przyniesie wyższe dochody z podatków ?	gospodarczy	7	Sing
Było przestronnie , panowała spokojna , sympatyczna atmosfera .	spokojna	4	Sing
A ogrzewania wyłączyć nie możemy , bo to zaszkodzi świeżo zakonserwowanym freskom w obu synagogach .	zakonserwowanym	10	Plur
Słyszymy dzwony z oddali , szczekanie psa , odgłosy zasypiającego Przymorza .	zasypiającego	9	Sing
- Dobry był ksiądz .	Dobry	1	Sing
Polacy jadący w autokarze spoglądają z nietajoną dumą na wielkiego rodaka .	jadący	1	Plur
Nikt w klubie nie ukrywał jednak , że to sytuacja tymczasowa .	tymczasowa	10	Sing
Po końcowym gwizdku arbitra w ekipie gości zapanowała zrozumiała euforia .	zrozumiała	8	Sing
Przybysze z najnowszej fali na ogół stronią od polonijnych organizacji społecznych .	społecznych	10	Plur
Był brytyjski lotniskowiec , amerykańskie fregaty , hiszpańska piechota morska , portugalscy komandosi , polscy lotnicy .	amerykańskie	4	Plur
Agencja chce pozbyć się ogierów , bo są schorowane .	schorowane	8	Plur
Dlatego byłem przeciwny jego polityce antyinflacyjnej .	przeciwny	2	Sing
Kij bejsbolowy pod poduszką trzymać .	bejsbolowy	1	Sing
W drugiej części czytelnik będzie mógł lepiej poznać cały pluton rotacyjny szeregowca Leńczyka .	rotacyjny	10	Sing
Czy uważa Pan , że dzisiejsi studenci już się nie buntują ?	dzisiejsi	5	Plur
Czy jej brak ma istotny wpływ na jakość amerykańskiego systemu szkolnictwa wyższego ?	wyższego	11	Sing
Na piątym był ostatni etap .	piątym	1	Sing
Krzyczy na mnie tylko trochę , kiedy się biję ze starszym bratem .	starszym	10	Sing
Wiadomo jednak , że podłożem tego przestępstwa były tak zwane taryfy pracownicze .	pracownicze	11	Plur
Etiopczycy kontynuują atak , choć pod koniec ubiegłego tygodnia władze Erytrei poinformowały o wycofaniu swych oddziałów ze wszystkich spornych terenów nadgranicznych .	spornych	18	Plur
Jeszcze przed obcięciem uposażeń , krakowscy rajcy planowali wydać taką właśnie sumę na remont trzech komisariatów oraz zakup 9 samochodów dla policji i 4 dla straży miejskiej .	miejskiej	26	Sing
Premier Cyrankiewicz i Pierre Lauret wygłosili krótkie przemówienia .	krótkie	6	Plur
Hotel posiadać będzie trzydzieści stylowo umeblowanych pokojów .	umeblowanych	5	Plur
Internet pozwala komunikować się poprzez rozliczne kanały rozmów w czasie rzeczywistym .	rozliczne	5	Plur
Tragiczny wypadek zdarzył się na trasie kolejowej z Piły do Chojnic .	Tragiczny	0	Sing
Zmieniały się tylko nazwiska i wielkość zdeprawowanych pieniędzy .	zdeprawowanych	6	Plur
Dymek w tym czasie ekspanderem przymocował otwartą klapę .	otwartą	6	Sing
Rozszerzone źrenice skierował na moją twarz , ale pod nimi była pustka .	Rozszerzone	0	Plur
Do nowotarskiej tradycji weszły organizowane przez burmistrza spotkania noworoczne .	organizowane	4	Plur
Zorganizowano również dla nich warsztaty rękodzielnicze z zakresu robienia na drutach , haftowania , tkania , wykonywania makram .	rękodzielnicze	5	Plur
Za najważniejszych nazistowskich zbrodniarzy powszechnie uznawano Hitlera , Himmlera i Goebbelsa .	najważniejszych	1	Plur
- Czy zatrzymają pana strefy ochronne wokół siedzib władzy ?	ochronne	5	Plur
Postępowanie przeciwko przestępcy , który został świadkiem koronnym , ulegałoby zawieszeniu .	koronnym	7	Sing
Syna Włodzimierza Olewnika porwano jesienią 2001 r .	2001	5	Sing
Zgodnie ocenili , że będzie to świetne miejsce do utworzenia centrum wzornictwa przemysłowego .	świetne	6	Sing
Po drugie , wkraczaliśmy na wyjątkowo niewdzięczny teren .	niewdzięczny	6	Sing
Konkurs składał się z etapu ustnego i pisemnego .	pisemnego	7	Sing
Zeznania urzędniczki były elementem republikańskiej kampanii , która miała zmusić prezydenta Billa Clintona do odwołania wizyty w Chinach .	republikańskiej	4	Sing
Część młodych osób chce pracować w państwowej firmie , bo to daje zabezpieczenie socjalne .	państwowej	6	Sing
Opaski przeglądamy w lipcu i niszczymy znajdujące się tam gąsienice .	znajdujące	6	Plur
- Są nierozerwalni jak dwie półkule mózgowe , stanowią najdoskonalsze małżeństwo świata .	nierozerwalni	2	Plur
Taksówka czekała z zapalonym silnikiem , a ci od pomocy drogowej wkładali jeepa na podnośnik .	zapalonym	3	Sing
Rzecznik Praw Obywatelskich wystąpił w obronie inwalidów wojennych i wojskowych , którym wprowadzono obowiązek płacenia za pobyt w sanatoriach uzdrowiskowych .	wojskowych	9	Plur
Technologię montażu zatrudnieni przy tym pracownicy poznają pod okiem koreańskich specjalistów .	koreańskich	9	Plur
Przy jego pomocy można obrazować wpływ poszczególnych czynników absencji .	poszczególnych	6	Plur
Tym głównie Stronnictwo będzie się różniło od większości europejskich partii chadeckich , w których liberalizm gospodarczy miesza się z ideami socjaldemokratycznymi i nauką społeczną Kościoła .	chadeckich	10	Plur
Ale trzeba na niego zapracować , zwłaszcza przed stresującym dniem .	stresującym	8	Sing
Wszak w tej chwili interpretuję myśl ludzką sprzed 22 wieków . . .	ludzką	6	Sing
Ta masa wodna , nieraz podnosząca poziom Wiku o jeden metr ponad równię Puckiej Zatoki , spotyka się przy dziobie gołębia z silnym prądem zachodnim .	zachodnim	24	Sing
Kościół prostuje mój kręgosłup moralny .	moralny	4	Sing
Lawa z największego otworu płynie strumieniem o szerokości 200 metrów .	największego	2	Sing
Jan Paweł II może być niebawem beatyfikowany .	beatyfikowany	6	Sing
Złotą Statuetkę pierwszy niekomunistyczny premier w powojennej Polsce odebrał w sobotę podczas Wielkiej Gali Polskiego Biznesu .	niekomunistyczny	3	Sing
Jadę do Katowic w sprawach różnych , poprzecznych i podłużnych , jak mówią moje dzieci .	podłużnych	9	Plur
Ma , bo poszczególne akty mogą być lepsze lub gorsze .	poszczególne	3	Plur
Punkt konstrukcyjny wynosił wtedy 20 metrów .	konstrukcyjny	1	Sing
Czy mogę złożyć wspólne zeznanie z byłą żoną ?	wspólne	3	Sing
Ale Europa Zachodnia jest bardzo łagodna i tolerancyjna wobec zbrodniarzy komunistycznych .	tolerancyjna	7	Sing
Ogromnym wzięciem cieszą się przed sezonem urlopowym jednorazowe nakładki toaletowe .	urlopowym	6	Sing
Elektrownie gazowe mają dać tyle prądu , ile daje elektrownia wodna w Asuanie .	wodna	10	Sing
Słońce , rozgrzewające żołądek Gregora Smidda , rozgrzało i granat .	rozgrzewające	2	Sing
Brytyjczycy są więc dominującym udziałowcem w największym polskim towarzystwie emerytalnym .	dominującym	3	Sing
Dla zdobywców pięciu pierwszych miejsc przewidziano regulaminowe nagrody .	przewidziano	5	Sing
Wszystkie klasztory i najznakomitsze rody pozostają naszymi klientami .	najznakomitsze	3	Plur
Policja przypuszcza , że najnowszy ładunek został porzucony przez spłoszonego niedoświadczonego terrorystę .	niedoświadczonego	10	Sing
Długie lata praktyki w kontaktach z nadkastowymi pozwoliły Hariemu zachować kamienną twarz .	Długie	0	Plur
To jest przykre stwierdzenie .	przykre	2	Sing
Innej alternatywy nie ma , a wszelkie marzenia o samodzielnej roli quasi-mocarstwowej Polski są tylko rojeniami fantastów .	quasi-mocarstwowej	11	Sing
Stamtąd te dane przekazuje do wojewódzkich stacji epidemiologicznych .	epidemiologicznych	7	Plur
Z ich opinią liczono się nie tylko w redakcji , ale również w środowiskach literackich i teatralnych .	teatralnych	16	Plur
Nie pamiętała ona już domu swego zamożnym .	zamożnym	6	Sing
- Wygląda na to , że piłka nożna seniorów w Występie przestanie istnieć .	nożna	7	Sing
Halina i ja byli śmy zdecydowani .	zdecydowani	5	Plur
Drżące dłonie opadły .	Drżące	0	Plur
Miał przekrwione oczy i nabrzmiałą twarz .	nabrzmiałą	4	Sing
Uległ wzruszeniu stary pedagog i zajął się wdowim synem z całą życzliwością .	wdowim	7	Sing
Nie znam przecież obyczajów panujących w jej kraju , nie interesowały mnie .	panujących	4	Plur
Oto ja , sponiewierana i przeklęta Żydówka , błagam was o litość .	przeklęta	5	Sing
Tutaj wyraźnie widać wrażliwe , skłonne do ufności i entuzjazmu oblicze eseisty .	wrażliwe	3	Sing
Trzeba też dodać , że wkraczali śmy do Francji w czasie dość trudnym dla wzajemnych stosunków .	trudnym	12	Sing
Zwycięskiego syberiana sprowadziła miesiąc temu ze Stanów Zjednoczonych .	Zjednoczonych	7	Plur
Chyba to nieprecyzyjnie powiedziane .	powiedziane	3	Sing
Prawdopodobnie część sprzętu rozkradziono .	rozkradziono	3	Sing
Zdaniem obrońców polecenie osadzenia Chodorkowskiego w pojedynczej celi przyszło z samego Kremla , który chce złamać byłego szefa koncernu naftowego .	pojedynczej	6	Sing
Warunki na głównych drogach powinny być dobre .	głównych	2	Plur
Podczas ostatniego spotkania przywódców Piętnastki w Brukseli rozstrzygnięto też kilka spornych kwestii związanych z miejscem przyszłych członków w unijnych instytucjach .	spornych	10	Plur
Stali wśród namiotów , w których krzątali się nadwołżańscy Niemcy , zruszczeni po wiekach .	zruszczeni	11	Plur
Po wstępnych kieliszkach było przyjemnie .	wstępnych	1	Plur
Przybysze z najnowszej fali na ogół stronią od polonijnych organizacji społecznych .	polonijnych	8	Plur
Trwa akcja protestacyjna .	protestacyjna	2	Sing
Warszawski Indeks Giełdowy zyskał 5 procent , a WIG20 , indeks największych spółek na parkiecie , wzrósł o 6,1 procent .	Warszawski	0	Sing
Chciał em zrobić ośrodek zimowy z prawdziwego zdarzenia .	zimowy	4	Sing
W uroczystości uczestniczyli wierni w kolorowych łowickich wełniakach .	kolorowych	5	Plur
Taki rachunek wystawił jej gdyński Szpital Miejski .	gdyński	4	Sing
Po ślubie wynajęli mieszkanie w starej kamienicy .	starej	5	Sing
Także usługi ogólnobudowlane prowadzi drugi z odznaczonych , pan Marek Nosal .	odznaczonych	6	Plur
Wkrótce będziesz w dużo lepszej kondycji .	lepszej	4	Sing
Do czwartku droga ma być przejezdna .	przejezdna	5	Sing
Były one niezwykle rzadkie , nadające świątyni szczególne miejsce wśród wszystkich miejsc kultu na Pomorzu Gdańskim .	nadające	5	Plur
200 z nich chronionych jest jako zabytki architektury ogrodniczej .	ogrodniczej	8	Sing
Obserwuję dużo młodszych kolegów , którzy ze zdziwieniem patrzą , co ja tu jeszcze robię .	młodszych	2	Plur
Władysław P . miał też długi , był schorowany i zażywał duże ilości leków .	schorowany	8	Sing
Jednak główną rolę w pracy nad brzmieniem płyty odegrały gitarzystka Wendy Melvoin i grająca na instrumentach klawiszowych Lisa Coleman .	grająca	13	Sing
To naturalna rzecz a nie promocja osobista .	osobista	6	Sing
Niefortunne strzały padły podczas zmiany warty .	Niefortunne	0	Plur
Później innego uczestnika spotkania znaleziono martwego w jego domu letniskowym pod Belgradem .	innego	1	Sing
Opolscy ciepłownicy obawiają się , że ich straty w pierwszych miesiącach nowego roku mogą się okazać horrendalne , bo na podwyżkę ceny węgla nałożyła się także wyjątkowo łagodna zima , która zmniejszyła zapotrzebowanie na ciepło .	łagodna	27	Sing
Przekonywał , że Wielkopolska jest przygotowana do skorzystania z unijnej oferty .	unijnej	9	Sing
Nie wstąpi jego stopa junacka w strzemiona ojcowe .	junacka	4	Sing
Są one bezsporne .	bezsporne	2	Plur
Jutro czy pojutrze mamy przekroczyć koło polarne .	polarne	6	Sing
Dłużej żyjący Polacy będą oczywiście mieli wpływ na wiele procesów gospodarczych .	żyjący	1	Plur
By wdrożyć projektowany przez rząd nowy system taniego budownictwa mieszkaniowego , konieczne jest szybkie wyszkolenie kadr .	projektowany	2	Sing
Wojna i okupacja były tylko finałem , nieuchronnie wynikającym z samej istoty faszyzmu .	wynikającym	8	Sing
W 20 polach diagramu ukryto skarby .	ukryto	4	Sing
Zanieczyszczenia cytoplazmatyczne i błonowe są również groźne , stanowiąc prawdopodobne źródło zarówno aktywności proteolitycznej , jak i białek cytoplazmatycznych w puli niehistonowej .	groźne	6	Plur
W dusznej od papierosowego dymu izbie tłoczono się okropnie .	dusznej	1	Sing
Zmumifikowaniu uległy tkanki miękkie .	miękkie	3	Plur
Warunki wolnego rynku okazały się silniejsze od rabinackich zakazów .	silniejsze	5	Plur
Komisja rewizyjna rady powiatowej zawnioskowała o udzielenie absolutorium i przesłała stosowny wniosek do Regionalnej Izby Obrachunkowej w Bydgoszczy .	Regionalnej	13	Sing
To właśnie nasza Polska , nowa Rzeczpospolita , Coraz bardziej podzielona , coraz bardziej rozbita .	podzielona	10	Sing
Rządowi eksperci z zachodniej Europy ostrzegają przed epidemią grypy .	Rządowi	0	Plur
Spódnica może być za krótka albo za długa . . .	długa	7	Sing
Kapitan Bayernu trafił do siatki Koeln jeszcze raz w 68 . minucie .	68	9	Sing
Był to bowiem pisarz mądry , ciekawy , który oparł się reżymowym nakazom , by nie stracić swej wiarygodności .	reżymowym	11	Plur
- Na wiosenną wodę puszczał okręciki , żeby się popisać czymś niezwykłym .	wiosenną	2	Sing
- Nie mam niebieskich oczu .	niebieskich	3	Plur
Podróżnik podzielił się ze słuchaczami wrażeniami ze swego samotnego rejsu .	samotnego	8	Sing
Czy ma pani jakiś szczególny stosunek do Izraela ?	szczególny	4	Sing
W grudniu 1992 roku , po trzech miesiącach , Honecker został zwolniony przez sąd w Berlinie za względów humanitarnych .	humanitarnych	18	Plur
Doświadczenia laboratoryjne wykazały , że gąsienice motyli monarchów , karmione transgeniczną żywnością , miały kłopoty ze zdrowiem .	transgeniczną	10	Sing
- W poniedziałek poszłam do lekarza ogólnego , który skierował mnie do chirurga .	ogólnego	6	Sing
Tam przygarnęła nas bardzo zacna rodzina .	zacna	4	Sing
Poparcie dla przystąpienia Polski do Unii Europejskiej systematycznie spada .	Europejskiej	6	Sing
Spirytus jest rozlewany do kartoników litrowych , półlitrowych i ćwiartek .	półlitrowych	7	Plur
Jesteście gotowi ?	gotowi	1	Plur
Jest to oczywistość , ale ta oczywistość konkretnie umiejscowiona , dla mnie przynajmniej , była jednak czymś wartym zastanowienia .	wartym	17	Sing
W naszej kantynie fabrycznej zmniejszono nam obiad o jedno danie .	fabrycznej	3	Sing
Unosiła się wokół nich anielska aura .	anielska	4	Sing
Polskie kopalnie zostaną sprywatyzowane .	Polskie	0	Plur
Tezy są skonfiskowane , ale to są rzeczy wiadome .	skonfiskowane	2	Plur
Część młodych osób chce pracować w państwowej firmie , bo to daje zabezpieczenie socjalne .	socjalne	13	Sing
Za każdy samochód zabierali się od razu mechanicy , zmieniali koła , usuwali uszkodzenia powstałe w czasie forsownego treningu , wymieniali zdarte nakładki hamulcowe , regulowali silniki .	powstałe	14	Plur
Meseńczycy , odwieczni wrogowie Sparty , zgodzili się przepuścić ich przez swoje terytorium .	odwieczni	2	Plur
się nie mieści jedno i drugie . .	jedno	3	Sing
Mimo to przystąpiliśmy do powołania Prezydenckiego Funduszu Stypendialnego .	Stypendialnego	7	Sing
Czy La Famille Richet istotnie została zaprezentowana w Edynburgu ?	zaprezentowana	6	Sing
- Powiewy bliskich gór przyniosły mu buntownicze słowa chłopskiej pieśni , zasłyszanej w dzieciństwie .	buntownicze	6	Plur
Zezwolił na podjechanie do samej bramy .	samej	4	Sing
W czwartek Prokuratura Okręgowa w Warszawie skierowała do sądu wniosek o aresztowanie .	Okręgowa	3	Sing
Wciąż drożeją zboża , głównie żyto , a ceny pszenicy ustabilizowały się na wysokim poziomie .	wysokim	13	Sing
Równocześnie wznoszono nowoczesne dzielnice mieszkaniowe .	nowoczesne	2	Plur
Mieszka pod Warszawą , a w swoim pięciohektarowym gospodarstwie , oprócz dwudziestu psów , hoduje także konie i kozy .	pięciohektarowym	7	Sing
Zarzuca mu pranie brudnych pieniędzy , płatną protekcję i udział w zorganizowanej grupie przestępczej .	brudnych	3	Plur
W dorożce siedział rozparty chirurg Tamten .	rozparty	3	Sing
Dla zdławienia partyzantów działających w górach rząd mobilizuje poważne siły zbrojne .	działających	3	Plur
Zakończył się VIII Raciborski Rajd Rowerowy Środowisk Trzeźwościowych Dookoła Polski .	Trzeźwościowych	7	Plur
Często karani kielczanie raz za razem grali w osłabieniu .	karani	1	Plur
W dobrych warunkach mnożą się bardzo szybko .	dobrych	1	Plur
W głowach łóżka na słupku od kwiatów paliła się zdjęta ze ściany gromnica .	zdjęta	9	Sing
Ministerstwo Rolnictwa , które przed rokiem obłożyło miód importowany opłatami wyrównawczymi , opracowało długofalowy program rozwoju pszczelarstwa .	wyrównawczymi	10	Plur
Klaskał mu prezydent Kwaśniewski oraz zgodnie prawa i lewa strona .	lewa	8	Sing
Część z nich była wypełniona cieczą .	wypełniona	4	Sing
Tam przez prawie dwa miesiące będą trwały badania dna morskiego .	morskiego	9	Sing
Wódz Samoobrony ma być umoczony w molestowanie seksualne .	umoczony	4	Sing
Rzecznik Praw Obywatelskich wystąpił w obronie inwalidów wojennych i wojskowych , którym wprowadzono obowiązek płacenia za pobyt w sanatoriach uzdrowiskowych .	wprowadzono	12	Sing
Przyniósł mu kiedyś steward nieświeży kotlet .	nieświeży	4	Sing
Rezolucja wypowiada się przeciwko istnieniu narodowych sił nuklearnych , ale nie przeciwko samej broni nuklearnej .	narodowych	5	Plur
Miał równie pokraczną głowę , krótki tułów .	pokraczną	2	Sing
To największe inwestycje budżetowe .	budżetowe	3	Plur
Jak dotąd , ani Państwowe Koleje Linowe , ani straż miejska , ani policja nie potrafiły poradzić sobie z konikami .	Państwowe	4	Plur
Czy wszystkie galaktyki Seyferta typu 2 mają pierścień pyłowy i ukryty obszar szybkich obłoków gazowych ?	ukryty	10	Sing
Wypada być chudą , bladą , melancholijną .	melancholijną	6	Sing
Zwolnienia zostaną rozłożone na cały 2001 r .	rozłożone	2	Plur
Słabszym doradza się wczołgiwanie .	Słabszym	0	Plur
Najwyższe sięgały nawet 180 cm .	Najwyższe	0	Plur
Wszystkie inne warunki miały być ustalone później , na konferencji pokojowej .	ustalone	5	Plur
Do obserwatorium waszyngtońskiego ściągały tłumy ciekawych .	waszyngtońskiego	2	Sing
Polityka prorodzinna rządu francuskiego jest na bakier z programem przedsiębiorczości .	prorodzinna	1	Sing
- Zakłady i instytucje państwowe działają na podstawie decyzji urzędniczych .	państwowe	4	Plur
Francuskie Zgromadzenie Narodowe uchwaliło wczoraj kontrowersyjną ustawę o skróceniu obowiązkowego tygodnia pracy z 39 do 35 godzin .	obowiązkowego	9	Sing
Andrzej długą chwilę milczał .	długą	1	Sing
Na placu Wolności wisiało jeszcze wtedy kilka plakatów , zachęcających do głosowania na Tadeusza Zwiefkę .	zachęcających	9	Plur
Musi uwierzyć , że pisane jej jest życie tylko z tobą .	pisane	4	Sing
To kwestia istnienia całej wielkiej organizacji .	wielkiej	4	Sing
Firmy reklamowe czasem robią taki numer .	reklamowe	1	Plur
Uzdrowienie sfery seksualnej nie dokonuje się jednak przez jednorazowy zryw duchowy .	duchowy	10	Sing
Marksizm był religią naszego bezreligijnego wieku .	bezreligijnego	4	Sing
Zimne piwo , wie pan . . .	Zimne	0	Sing
Przy bezpośrednim wprowadzaniu danych dowody księgowe są indywidualnie przekazywane do przetwarzania .	księgowe	5	Plur
Ludzie uważają , że do kłopotów z uzyskaniem zgody przyczynili się inwestorzy starający się o pozwolenie na budowę małego osiedla na działce sąsiadującej z ogródkami mieszkańców .	małego	18	Sing
Po spotkaniu w magistracie faktycznie ją wynajął za własne pieniądze .	własne	8	Plur
Uroczystości weselne zaczynały się od wtorku .	weselne	1	Plur
Odczuł em zaraz lekki niepokój .	lekki	3	Sing
Najpierw operatorzy będą mieli miesiąc na poinformowanie klientów o nadchodzących zmianach i zadanie im rutynowego pytania , czy chcą obniżki opłat roamingowych .	rutynowego	14	Sing
Wkrótce też natknęli się na mężczyzn ściągających skórę z zabitego kozła .	ściągających	6	Plur
Los głównej postaci dotyka bowiem istoty amerykańskiej mitologii , nie jest jednak jej prostą akceptacją .	prostą	13	Sing
U nas nie ma jeszcze takich mechanizmów motywacyjnych .	motywacyjnych	7	Plur
Przygoda u czoła Lodowca Hansa uświadomiła mi , że lepiej bezpośrednio nie dotykać lodowego klifu .	lodowego	13	Sing
Obaj skrupulatnie przepisywali rezultaty kolejnych odcinków specjalnych , by w pokojach hotelowych dokładnie je przeanalizować .	specjalnych	6	Plur
- Napił by m się grzanego piwa .	grzanego	5	Sing
Za 30.000 złotych wyremontowana została ulica prowadząca do ośrodka zdrowia w Lubiewie .	wyremontowana	3	Sing
Nie mogę powiedzieć , że byli uprzejmi , ale nie byli niegrzeczni .	uprzejmi	6	Plur
Deser zostanie podany po sprzątnięciu talerza głównego .	głównego	6	Sing
Po pewnym czasie pojawiła się też mniejsza grupa , zmierzająca w odwrotną stronę .	zmierzająca	9	Sing
Prokuratura Apelacyjna współpracuje w tej sprawie z oddziałami CBŚ we wspomnianych miastach i Urzędami Kontroli Skarbowej .	wspomnianych	10	Plur
( Wojska chemiczne nie działają na pierwszej linii frontu . )	chemiczne	2	Plur
Nasza sprawa jest czysta .	czysta	3	Sing
- Czy czarny scenariusz jest brany pod uwagę w zachodnich kołach finansowych ?	zachodnich	9	Plur
- Czy Wojtek był biseksualny ?	biseksualny	4	Sing
I montujemy z tego dziewięćdziesięciominutowy program .	dziewięćdziesięciominutowy	4	Sing
Prototyp zminiaturyzowanej komory jest już gotowy .	zminiaturyzowanej	1	Sing
Wiadomo jednak , że podłożem tego przestępstwa były tak zwane taryfy pracownicze .	zwane	9	Plur
Saperzy wydobyli we wtorek sześć artyleryjskich pocisków burzących z czasów II wojny światowej , odkrytych na terenie budowy na krakowskim Prądniku Czerwonym .	Czerwonym	21	Sing
Potem ból stał się tak silny , że przesłonił wszystko ciemnością pozbawioną woni i dźwięków .	pozbawioną	11	Sing
Niezwyciężony lęk przed dziwem w każdym momencie serca przychodniów przeszywał .	Niezwyciężony	0	Sing
Z szacunkowych danych wynika , że stopa bezrobocia w kwietniu wyniosła 13,6 proc .	szacunkowych	1	Plur
W weekend na zachodnich przejściach granicznych trwały wzmożone kontrole .	wzmożone	7	Plur
Czy był oralny i analny ?	analny	4	Sing
Za każdy samochód zabierali się od razu mechanicy , zmieniali koła , usuwali uszkodzenia powstałe w czasie forsownego treningu , wymieniali zdarte nakładki hamulcowe , regulowali silniki .	hamulcowe	23	Plur
Później były aresztowania brzeskie i w listopadzie wybory parlamentarne w atmosferze terroru , które dały BBWR większość w nowym Sejmie .	brzeskie	3	Plur
Nie ma natomiast pracy dla górników i mechaników urządzeń przemysłowych .	przemysłowych	9	Plur
Wtedy głos zabrali solidni krytycy .	solidni	3	Plur
- Stara ogrodnicza prawda mówi , że każdemu drzewu i krzewowi przycięcie zrobi dobrze .	ogrodnicza	2	Sing
Pociski są przerdzewiałe i posiadają zapalniki .	przerdzewiałe	2	Plur
Chodzi o to , aby uczniowie w odpowiednich warunkach mogli realizować cele w ramach poszczególnych przedmiotów , zajęć pozalekcyjnych czy pozaszkolnych .	pozalekcyjnych	18	Plur
Na północy pokrywa śnieżna sięga pół metra .	śnieżna	3	Sing
Narażenie rozgrzanego psa na przeciągi grozi poważnymi komplikacjami ze zdrowiem .	poważnymi	6	Plur
Zdaniem lekarzy , szpitale cierpiące na brak pieniędzy podejmują drastyczne programy oszczędnościowe .	drastyczne	9	Plur
Nie znałem go przedtem , bo za moich czasów wileńskich był jeszcze sztubakiem , a potem przebywał za granicą .	wileńskich	9	Plur
Nowi ustne rozpoczęli od geografii .	Nowi	0	Plur
W różnych krajach Europy Joint zachęcał do tworzenia miejscowych organizacji , zdolnych do samodzielnej pracy z sierotami .	zdolnych	11	Plur
Dotychczasowa siedziba Archiwum jest przede wszystkim za mała w stosunku do wzrastających w szybkim tempie zbiorów .	Dotychczasowa	0	Sing
Stanowią one razem z rzodkiewką potrawę pełnowartościową , dając jednocześnie ciekawy efekt dekoracyjny .	pełnowartościową	6	Sing
Kochamy Polskę , lecz fakty składające się na polską rzeczywistość działają nam na nerwy .	składające	5	Plur
Nie musi znać tekstu , bo na kredensie , na stole , na krześle ma przypięte kartki z dialogami , których kamera nie widzi .	przypięte	15	Plur
Sześć pięknych dziewcząt rywalizowało w Miejsko - Gminnym Ośrodku Kultury w Małogoszczu o tytuł Miss Regionu Jędrzejowskiego i Włoszczowskiego .	pięknych	1	Plur
102 lata obchodziła wczoraj Stanisława Przybyła , rodowita mieszkanka Łaz .	rodowita	7	Sing
Uroczysta msza święta w intencji reprezentacji Polski w piłce nożnej została odprawiona w piątek w Kazimierzu Dolnym .	Uroczysta	0	Sing
Wszystkie pieniądze z aukcji zostaną przeznaczone na budowę nowego oddziału przeszczepowego dla dzieci z białaczką przy szpitalu w Poznaniu .	przeszczepowego	10	Sing
Kot obejrzał się na mnie i usiadł , starannie zawijając ogon na przednie łapki .	przednie	12	Plur
Światło reflektorów bije na klatkę schodową .	schodową	5	Sing
Na ekranie TV , na zatrzymanej stop–klatce Jurka Kilera idą napisy końcowe programu .	końcowe	11	Plur
Kwintet poprowadził nauczyciel ze Szkoły Muzycznej , Krzysztof Garbacz .	Muzycznej	5	Sing
Stołeczna tkalnia w czynie tysiąclecia podjęła się regularnej produkcji płótna pasiakowego .	pasiakowego	10	Sing
Po części oficjalnej przyszedł czas na popisy artystyczne .	artystyczne	7	Plur
" Życie jest zbyt krótkie , żeby pić liche wina " .	liche	8	Plur
Odpowiedzi takie zaliczała m do poprawnych mimo zaistniałej pomyłki .	poprawnych	5	Plur
Bronił eksmitowanych na bruk , naprawiając błędy przyjętej przez koalicję SLD­PSL ustawy , grzmiał na globalistów i świeżych krajowych , drapieżnych kapitalistów .	świeżych	17	Plur
Widzicie , lyrijski orzeł czarny i rivskie rauty czerwone .	lyrijski	2	Sing
Pomorska Regionalna Kasa Chorych jest od wczoraj kontrolowana przez pracowników Urzędu Nadzoru Ubezpieczeń Zdrowotnych .	Regionalna	1	Sing
Potem profesor Lalos pokazał im szkołę dziecięcą .	dziecięcą	6	Sing
- Na stole rozłożył odbitki kserograficzne stron Rocznika Statystycznego .	kserograficzne	5	Plur
Nakręcił 60 filmów dokumentalnych i stworzył ponad 300 programów telewizyjnych .	dokumentalnych	3	Plur
Durny przodem idzie .	Durny	0	Sing
Aby pomóc przewodnikom w sporządzeniu spisu potrzebnych rzeczy , podajemy przykładowe zestawy sprzętu dla poszczególnych działów prac na kolonii .	przykładowe	10	Plur
Takie są skutki korzystania z prywatnej opieki zdrowotnej .	zdrowotnej	7	Sing
Mam chcieć być lepsza od innych .	lepsza	3	Sing
- Jeżeli ćwiczący źle dobiorą rakiety , piloci nie zniszczą przeciwnika .	ćwiczący	2	Plur
( Przypomnę tutaj , że w Komisji Trójstronnej trwają intensywne prace nad przygotowaniem nowelizacji tejże ustawy ) .	tejże	14	Sing
Z ulicy dobiegały czyjeś kroki .	czyjeś	3	Plur
- Już ze wstępnych oględzin wiadomo było , że kobieta została zamordowana .	wstępnych	3	Plur
Podczas niemieckiej okupacji spotykali śmy się , należąc do podziemnej literackiej Warszawy .	literackiej	10	Sing
Zaangażowano mnie w celu udowodnienia , że Mojka miał wspólników w Banku Prowincjonalnym .	Prowincjonalnym	12	Sing
Zdaniem włoskich ekspertów , jest to słabe tłumaczenie , ponieważ wszyscy wiedzą , że region Molise leży w strefie silnej aktywności sejsmicznej .	włoskich	1	Plur
Zdesperowany doktor wlał płyn do dezynfekowania narzędzi chirurgicznych do dużego naczynia , włożył w płyn zaganiacza , zamieszał .	Zdesperowany	0	Sing
Ultimatum postawione przez Izrael minęło wczoraj .	postawione	1	Sing
lekko młotkiem gumowym chlapnąć .	gumowym	2	Sing
Mamy do wyremontowania wiele instalacji wodno - kanalizacyjnych w gimnazjach .	kanalizacyjnych	7	Plur
Dziś już wiadomo , że powszechnie akceptowany na świecie jest model bazujący na podejściu bilansowym , koncepcji pełnej alokacji i metodzie zobowiązań .	bilansowym	14	Sing
Poszkodowany do dnia dzisiejszego nie otrzymał zakupionego telefonu .	zakupionego	6	Sing
Dotknięta wojennymi ciężarami buntowała się i odmawiała odrabiania pańszczyzny .	Dotknięta	0	Sing
Wszelkie informacje podane poniżej dotyczą jedynie wypadków sprawdzonych .	podane	2	Plur
Wśród trzech pozostałych młodych rysi śledzonych telemetrycznie , które osiedliły się w Puszczy Białowieskiej , były dwie samice .	Białowieskiej	13	Sing
- Czas był wtedy pogodny .	pogodny	4	Sing
Załamała się tradycja zbiorowych wystąpień i manifestacji .	zbiorowych	3	Plur
Stary wiadukt przy ulicy Oświęcimskiej stanowił ogromną uciążliwość dla kierowców .	ogromną	6	Sing
Myślę , że są to po prostu dobre kompozycje i świetne teksty .	świetne	10	Plur
Ślizgawki są organizowane cyklicznie .	organizowane	2	Plur
Są to jedynie najważniejsze , opisane dość pobieżnie , zranienia w dziedzinie seksualnej , które wymagają uzdrowienia .	opisane	5	Plur
Współczesne trendy cywilizacyjne sprzyjają siłom zła , lecz dobro nie odpuszcza .	Współczesne	0	Plur
W Chadaju odezwała się podlaska dusza .	podlaska	4	Sing
To nie był rozsądny pomysł .	rozsądny	3	Sing
Tymczasem korki paraliżują okolice ul . Saskiej , bo kierowcy , aby dostać się na Wał , muszą dojechać na niego wąskimi ulicami Saskiej Kępy .	wąskimi	21	Plur
Nawet dla słabo zorganizowanych grup , przewalanie towaru będzie kaszką z mlekiem .	zorganizowanych	3	Plur
Po trzech dniach Śpiąca Królewna wróciła do Warszawy .	Śpiąca	3	Sing
U podstaw takiego postępowania leżą poglądy mityczne , które muszą zniknąć z praktyki lekarskiej .	mityczne	6	Plur
Ranni żołnierze zostali przewiezieni do szpitala w Białogardzie .	Ranni	0	Plur
Towarzyszyli mu polscy policjanci ze specjalnego wydziału zajmującego się deportacją z Komendy Głównej Policji .	specjalnego	5	Sing
Chodzi o to , żeby demonstracje odbywały się w spokoju , żeby w minimalnym stopniu zakłócały życie innych ludzi i żeby nie było polską normą bicie policjantów , okupowanie budynków , wyrywanie znaków drogowych czy niszczenie samochodów .	drogowych	33	Plur
Okaz ten jest chroniony przez Konwencję Waszyngtońską .	chroniony	3	Sing
Miejscowi Polacy zapowiadają zaskarżenie decyzji do sądu .	Miejscowi	0	Plur
Za pomocą kamer przemysłowych inżynierowie obserwowali próby przekazu prowadzone na parkiecie w dyskotece .	prowadzone	8	Plur
Serwisy , które go oferują , często zawierają wiele odnośników prowadzących do przykładowych , działających już stron .	przykładowych	12	Plur
Magazyn pozwoli firmie na zaspokojenie potrzeb rynku poprzez zapewnienie odpowiednich zapasów ogumienia .	odpowiednich	9	Plur
Nawiązano współpracę z kołami gospodyń wiejskich w Domatkowie , Kolbuszowej Górnej , Nowej Wsi , Weryni i Widełce .	Nawiązano	0	Sing
Całą energię i myśli oddaję pracy .	Całą	0	Sing
W Zborowie powstał obiekt o powierzchni użytkowej 3364 metrów kwadratowych , w którym zamieszka 50 osób .	użytkowej	6	Sing
- Zbliżają się wybory prezydenckie .	prezydenckie	4	Plur
Ucierpi niezawisłość sędziowska ?	sędziowska	2	Sing
Kamienny młot człowieka uderzał w furii we włochatą pierś zwierzęcą .	włochatą	7	Sing
Zarzuca mu pranie brudnych pieniędzy , płatną protekcję i udział w zorganizowanej grupie przestępczej .	przestępczej	13	Sing
W dwie godziny później Ania i Norbert siedzieli w fotelach w pokoju gościnnym przy łóżku Karoliny .	gościnnym	12	Sing
Na dziobie , bodącym niebo , przerzucony przez poręcz wisiał mister Dawid Lingslay .	przerzucony	6	Sing
Właściwie tylko Białostockie Przedsiębiorstwo Budownictwa Przemysłowego posiada laboratorium z prawdziwego zdarzenia .	Białostockie	2	Sing
Serwal to rzadko spotykany w polskich ogrodach drapieżnik z rodziny kotów .	spotykany	3	Sing
- Jesteście za dobrzy dla Kościoła ?	dobrzy	3	Plur
Ale później , w latach sześćdziesiątych , wywiązała się intensywna publiczna debata na temat stosunków polsko - niemieckich . . .	sześćdziesiątych	5	Plur
Rok bieżący przyniesie około 40.000 nowych izb .	bieżący	1	Sing
Załogi z niepokojem śledzą ciche chmury nadchodzące z południa .	ciche	4	Plur
Pozostałoby do rozstrzygnięcia pytanie , dlaczego paradoks , występujący w odniesieniu do przenoszenia masy i energii w przeszłość , nie obowiązuje w stosunku do przyszłości .	występujący	8	Sing
Dowódca sił amerykańskich w Afganistanie generał Tommy Franks zapowiedział kolejne operacje lądowe .	lądowe	11	Plur
Do akcji ratunkowej wezwano prawie wszystkich strażaków z zakopiańskiej Jednostki Ratowniczo - Gaśniczej .	ratunkowej	2	Sing
Z głośników popłyną rytmy soul i disco .	soul	4	Plur
Sztandar bojowy podniosły także narody podbite i uciemiężone przez carat .	uciemiężone	7	Plur
- Zbiórkę poprzedziła akcja informacyjna , uczniowie wiedzą , na jaki dobry cel popłyną pieniądze .	informacyjna	4	Sing
Spotyka mnie teraz zasłużona kara .	zasłużona	3	Sing
W wielu miastach widzieliśmy gigantyczne kolejki .	gigantyczne	4	Plur
Znał dobrze urzędników gminnych i ich nieskończoną flegmę oraz absolutny brak poszanowania dla czasu bliźnich .	nieskończoną	6	Sing
Modernizacja Opla Frontery miała uczynić go bardziej przyjaznym dla użytkowników , nie zmniejszając jednocześnie jego możliwości .	przyjaznym	7	Sing
Użytkownik ma do dyspozycji 6 baz zawierających informacje posortowane według wybranego kryterium .	zawierających	6	Plur
Pierwsze trwałe osady założono dopiero w drugiej połowie XIX wieku .	założono	3	Sing
Dużym zainteresowaniem cieszą się barwne szklane witraże jako prace ozdobne .	barwne	4	Plur
Miała ciągłe kłopoty .	ciągłe	1	Plur
Policja z uwagi na prowadzone wciąż czynności operacyjne nie ujawnia szczegółów dotyczących tej sprawy .	operacyjne	7	Plur
Przygotowanie takiej paczki nie stanowi problemu finansowego dla wielu ludzi .	finansowego	6	Sing
Przedostatni figuruje Artur Balazs , poseł i minister rolnictwa , a zamyka ją Stefan Oleszczuk z UPR-u , starosta kamieński .	kamieński	19	Sing
Celnicy podejmują decyzje o bardzo dużych kwotach .	dużych	5	Plur
Pierwsze gwiazdy toną w duszy młodego człowieka jak w górskim jeziorze .	górskim	9	Sing
Z urzędów i różnych instytucji ginie nawet papier toaletowy .	toaletowy	8	Sing
I wyrzucano .	wyrzucano	1	Sing
Dużym zainteresowaniem cieszą się barwne szklane witraże jako prace ozdobne .	ozdobne	9	Plur
Orzechowe oczy garncarza wpatrzyły się badawczo w twarz Kaliasa .	Orzechowe	0	Plur
Stołeczna tkalnia w czynie tysiąclecia podjęła się regularnej produkcji płótna pasiakowego .	regularnej	7	Sing
Jego wiarygodność sprawdzono poprzez Krajową Izbę Gospodarczą .	sprawdzono	2	Sing
Walczak poczuł dręczące pragnienie .	dręczące	2	Sing
Prace metaloplastyczne w kościele wykonywał Władysław Gąsienica Makowski .	metaloplastyczne	1	Plur
Ty sama jesteś naturą bardziej refleksyjną , obowiązkową .	refleksyjną	5	Sing
Sprawdź dokumenty osoby zbierającej datki .	zbierającej	3	Sing
Warto pamiętać , że krupa lodowa jest młodszą siostrą gradu .	lodowa	5	Sing
- Jego twarz jest zazwyczaj dość blada , czasami ma nieco zielonkawy odcień .	zielonkawy	11	Sing
Mimo ciepłego dnia pani domu przyjęła ją otulona w brązowy blezer , spod ciemnej spódnicy wystawały chude łydki .	otulona	7	Sing
Głosować będziemy zgodnie z zasadami sformułowanymi w poprzednim punkcie porządku dziennego .	sformułowanymi	5	Plur
- W 1299-tym nadał Nakłu prawa miejskie mały drobny Król Łokietek , a Dzielny Krzywousty w 12-tym wieku narobił w Nakle kapusty !	1299-tym	2	Sing
Kolor pełni w obu rodzajach reklamy bardzo interesującą funkcję .	interesującą	7	Sing
Takie parlamentarne metody nie odpowiadają mi , rozumiecie ?	parlamentarne	1	Plur
Potem proszono ich o wykonanie odwrotnego zadania .	odwrotnego	5	Sing
On jest zakochany , na trąbie siedzi mrówka i wysyła serduszka .	zakochany	2	Sing
Owa niezapomniana chwila zawierała nieprawdopodobny ładunek patosu .	niezapomniana	1	Sing
I te bilety uśmierzyły wzburzone umysły golibrody i wynalazcy .	wzburzone	4	Plur
Informacje na temat historii zen i różnych szkół znajdzie Czytelnik w chronologicznym zestawieniu najważniejszych wydarzeń z historii zen w Chinach i Japonii .	najważniejszych	13	Plur
Nieuchronne podziały pogłębił niski poziom politycznych dyskusji .	Nieuchronne	0	Plur
Architekci opracowujący rysunki robocze są zazwyczaj wieloletnimi praktykami .	wieloletnimi	6	Plur
Systematycznie prowadzili kontrole , zmierzające do ujawnienia różnego rodzaju piractwa .	zmierzające	4	Plur
Udało się niestety uratować tylko Marię Fryc , zaś dwudziestotrzyletni jej mąż utonął .	dwudziestotrzyletni	9	Sing
Darowizny przekazane na jej rzecz podlegają odpisowi podatkowemu .	podatkowemu	7	Sing
Na jego otwarcie zjechali się przedstawiciele PSP w Warszawie , władze gminne , powiatowe oraz państwowe .	powiatowe	13	Plur
Mao urodził się w 1893 roku w zamożnej rodzinie chłopskiej .	1893	4	Sing
Czuł em jego mięśnie napięte pod skórą , twarde jak drewno .	twarde	8	Plur
Tam dokonał czynów lubieżnych na dziewczynce .	lubieżnych	3	Plur
Widziałem ich po raz pierwszy i jestem pod ogromnym wrażeniem .	ogromnym	8	Sing
Ciemne włosy , spięte w koczek , podtrzymywała złocista spinka .	Ciemne	0	Plur
W październiku podczas pierwszych tegorocznych mrozów zamarzły cztery osoby .	tegorocznych	4	Plur
Dozorca i drugi mężczyzna , stojący obok , wzięli kobietę pod ręce i wyprowadzili na korytarz .	stojący	5	Sing
Polska jest etnicznie jednorodna , heteroseksualna , katolicka i wolnorynkowa .	katolicka	7	Sing
Drużynowymi finałami zakończona została w poniedziałek rywalizacja pływaków o medale i dolarowe premie w Igrzyskach Dobrej Woli .	dolarowe	11	Plur
W czołówce znajduje się też słynna Zielona Budka , ale firma nie jest już polska .	słynna	5	Sing
- Dajemy sygnał organizacjom terrorystycznym .	terrorystycznym	4	Plur
- Czy nie zabrakło woli politycznej do osądzenia komunistycznych zbrodniarzy ?	komunistycznych	8	Plur
Na Ukrainie i Białorusi została już częściowo odtworzona struktura administracji kościelnej .	kościelnej	10	Sing
Ponadmiesięczna wyprawa zakończyła się sukcesem .	Ponadmiesięczna	0	Sing
Ale nawet najwięksi krytycy Rutkowskiego chwalą jego zdolności autoreklamiarskie .	autoreklamiarskie	8	Plur
– chyba jestem głodna .	głodna	3	Sing
Od kolebki , od małych lat jestem tu wychowany , na tym placu .	małych	4	Plur
Dotknięta wojennymi ciężarami buntowała się i odmawiała odrabiania pańszczyzny .	wojennymi	1	Plur
Orkiestry murzyńskie grają ragtime'y , tłum cheerleaderek tworzy radosny , falujący szpaler .	murzyńskie	1	Plur
Tymczasem polska motoryzacja nie ma żadnej przyszłości poza prostym składaniem zestawów samochodowych , a planowana operacja ma zabezpieczyć interesy banków .	prostym	8	Sing
- Proszę posłów sekretarzy o zajęcie miejsc przy stole prezydialnym .	prezydialnym	9	Sing
Wykonywali różne figury akrobatyczne i gimnastyczne .	różne	1	Plur
- Obiecał em mojemu młodszemu , że przyniosę mu dzisiaj dwie kulki . . .	młodszemu	4	Sing
Czy nauki empiryczne są istotnie na takim doświadczeniu zbudowane , jeśli ono istnieje ?	zbudowane	8	Plur
- W naszej drużynie nie ma gwiazd , potrzebni są ludzie nieprawdopodobnie zaangażowani w grę .	zaangażowani	12	Plur
Dobrze znosi warunki miejskie .	miejskie	3	Plur
Tego nie wiemy na pewno , mimo że zacytowane wyżej zdanie stało się znakiem rozpoznawczym .	zacytowane	8	Sing
Ośrodki badania opinii publicznej publikują właśnie swe najświeższe sondaże , które potwierdzają utrzymujące się od wielu miesięcy trendy .	najświeższe	7	Plur
Obcowanie z księgą może odbywać się w całkowitej pustce .	całkowitej	7	Sing
Na parterze pozostanie Księgarnia Literacka .	Literacka	4	Sing
Gdyby udało się skompletować księgę obdarowanych , zawierałaby ona listę nazwisk tworzących znaczną część żelaznego elektoratu SLD .	tworzących	11	Plur
Obu szwedzkim dyplomatom zarzucono też działalność wykraczającą poza ich oficjalny status .	szwedzkim	1	Plur
Drobne , zaradne i opiekuńcze szatynki zawsze miały u niego powodzenie .	opiekuńcze	4	Plur
Powstała nawet nauka o snach , nazywana onejrologią .	nazywana	6	Sing
Energia ta może być sublimowana , przekształcana .	przekształcana	6	Sing
Jeśli to jest absolutnie niemożliwe , znaczy to , że twój charakter jest czymś pośrednim pomiędzy dwoma opisanymi w rozwiązaniu przy odpowiednich numerach .	opisanymi	17	Plur
– Robisz się religijny , kiedy mówisz o piłce nożnej .	nożnej	9	Sing
Most w Kuligach na rzece Jegrzni znajduje się w fatalnym stanie i grozi zawaleniem .	fatalnym	9	Sing
Po chwili odsłonił głowę i uważnie lustrował zaniepokojone twarze .	zaniepokojone	7	Plur
Trzydzieste piąte Targi zostały rozpoczęte .	rozpoczęte	4	Plur
Jakby tego było mało , podczas kontroli technicznej stwierdzono , że oba pojazdy są niesprawne .	niesprawne	14	Plur
Dzięki temu przekonano się , że galaktyki aktywne nie tworzą jednolitej grupy , ale mają dość zróżnicowane własności .	zróżnicowane	16	Plur
– ale to nie jest takie proste . .	proste	6	Sing
Był em tym zachwycony i chodził em po Akademii dumny jak paw .	zachwycony	3	Sing
Przyjrzyj się fotografiom i rysunkom w podręczniku przedstawiającym przykład krajobrazu śródziemnomorskiego .	przedstawiającym	7	Plur
Związek taki łączą nie tylko wspólni praprzodkowie .	wspólni	5	Plur
Mała lampka rozpraszała mrok , rzucając nikłe światło na błękitną tapetę .	błękitną	9	Sing
Orzecznictwo jest niejawne i zaoczne .	zaoczne	4	Sing
Niech żyje wyzwoleńcza Ochotnicza Rosyjska Armia !	wyzwoleńcza	2	Sing
Rozpoczyna się teraz emocjonujący wyścig ze zbliżającą się burzą .	zbliżającą	6	Sing
Ja na miejscu Pana Giertycha wprowadziłbym zakaz rodzenia głupim matkom .	głupim	8	Plur
Jak widzę procesy zachodzące w sztuce ostatniego stulecia ?	zachodzące	3	Plur
Ustawa ma własne przepisy karne .	karne	4	Plur
Tom Spencer posiadał przy sobie pisma pornograficzne i kasety video dla homoseksualistów oraz marihuanę .	video	9	Plur
W niedzielę 7 czerwca o godz . 17 Odra podejmuje Inę , a Mieszko o tej samej godzinie u siebie gra z Dąbrovią .	17	7	Sing
Na koniec wyniki podliczono by w blasku jupiterów na wielkiej konwencji ogólnopolskiej .	ogólnopolskiej	11	Sing
Miał em je pobierać w miesięcznych ratach .	miesięcznych	5	Plur
Wszelki mrok rozpływa się niczym mgła w promieniach porannego słońca .	porannego	8	Sing
Nie jest on spotykany zbyt często .	spotykany	3	Sing
Jest jak wielka rozrastająca się tkanka rakowata .	rakowata	6	Sing
Ogłoszone wczoraj dane Narodowego Banku Polskiego , dotyczące wielkości deficytu na rachunku obrotów bieżących , zaskoczyły ekonomistów .	Ogłoszone	0	Plur
Tymczasem w liceach prowadzonych przez Społeczne Towarzystwo Oświatowe zdanie egzaminu dojrzałości nie należy do najłatwiejszych .	najłatwiejszych	14	Plur
Mam przynieść wypełnioną deklarację członkowską oraz partyjną ankietę .	członkowską	4	Sing
Przez ostatnie 10 lat przyzwyczaili się do obecności prezydenckiej pary .	prezydenckiej	8	Sing
W poniedziałek ustalony został ostateczny podział funkcji w radzie nadzorczej tucholskiej Spółdzielni Mieszkaniowej .	Mieszkaniowej	12	Sing
W rozbite pojazdy uderzyła jeszcze jedna ciężarówka .	rozbite	1	Plur
Od czasu do czasu słychać było głosy pierwszych ptaków , brzmiące świeżo i przenikliwie .	brzmiące	10	Plur
- Ważne są opinie ludzi mówiące o pozostawieniu miejskiej komunikacji .	Ważne	1	Plur
Siedzieli śmy w nowej , modnej knajpie .	modnej	5	Sing
Przekształcenie osad rolniczych w osady przemysłowe wprowadziło do nich kapitalistyczne stosunki .	przemysłowe	5	Plur
Stan czterech z 15 uratowanych pasażerów jest krytyczny .	uratowanych	4	Plur
Prawdopodobnie niesprawna instalacja elektryczna była przyczyną tragicznego pożaru w mieszkaniu przy ulicy Słupeckiej w Gdyni .	Słupeckiej	12	Sing
Ja wszelako nie piszę w imieniu przegranych polityków .	przegranych	6	Plur
I to wszystko było dobre i znajome , potrzebne i pożyteczne .	pożyteczne	10	Sing
Zwykły mieszkaniec kraju ma się leczyć ziołami , które zaleca tradycyjna medycyna koreańska .	tradycyjna	10	Sing
Jeszcze w poniedziałek prosił o pomoc wojskową sąsiednie republiki kaukaskie i Rosję .	sąsiednie	7	Plur
Ale hodowcy stworzyli nowe , bardziej atrakcyjne odmiany o cechach uniwersalnych .	atrakcyjne	6	Plur
W czasie pozorowanych działań bojowych jednostki z pozycji obronnych dokonają przegrupowania , aby po sforsowaniu szerokiej przeszkody wodnej wyjść na nowe rubieże aktywnych działań zaczepnych .	obronnych	8	Plur
Nie można w ekspresowym tempie kształtować podstawowych zasad prawnych .	ekspresowym	3	Sing
Ledwie sformowany rząd ustąpił protestującej grupie zawodowej .	sformowany	1	Sing
Zbyt szybkie tempo życia doprowadza zwykle do zmęczenia i bałaganu .	szybkie	1	Sing
Nieboszczyk ojciec zawsze nam to śpiewał i na pedałowej harmonii sobie podgrywał .	pedałowej	8	Sing
TP SA chce złagodzić planowane redukcje .	planowane	4	Plur
Bądź czujna .	czujna	1	Sing
Dzięki znajdującym się u podstawy każdego wibrysa komórkom mięśniowym zwierzę potrafi dowolnie poruszać wąsami niemal na wszystkie strony .	mięśniowym	8	Plur
Mam pracę do czerwca , rozbieramy teraz czwarty piec .	czwarty	7	Sing
Warszawscy radiowcy okazali się trudnymi rywalami .	trudnymi	4	Plur
Nie miała m wtedy żadnych doświadczeń seksualnych .	seksualnych	6	Plur
W ubiegłym roku w czerwcu okna w komunalnym mieszkaniu Salwockich wybijano trzy razy .	ubiegłym	1	Sing
Mówił pan interesujące rzeczy .	interesujące	2	Plur
Wprowadzenie rozwiązań proponowanych przez SLD prowadziło by do wynaradawiania .	proponowanych	2	Plur
Faktyczny strajk , który jest im zabroniony , oprócz wymiernych kosztów dla tysięcy firm naraził państwo polskie na kompromitację .	wymiernych	9	Plur
Według legend , w studni głębokiej na ponad 30 metrów znajdują się wejścia do lochów i tajnych chodników łączących posiadłości właścicieli zamku .	łączących	18	Plur
Faceci wyglądają na prawdziwych twardzieli .	prawdziwych	3	Plur
Podobnie jak we współczesnej Japonii , również w Tybecie żywe są dawne herbaciane tradycje , chociaż przyczyny ich kultywowania są zgoła odmienne .	dawne	11	Plur
Medykamenty współczesne dostępne są na czarnym rynku .	współczesne	1	Plur
Wykaz obejmował 33 rasy psów wymagających rejestracji i szkolenia .	wymagających	5	Plur
Podkreśla się , ze był on najlepszym rozgrywającym ligi i ojcem dominacji Chicago Fire w rozgrywkach grupowych .	najlepszym	6	Sing
Jedynie opisywane przez panią żółwie na Seszelach się p . . .	opisywane	1	Plur
Odebrano im łup i zrabowaną broń .	zrabowaną	4	Sing
Spłata pozostałych 80 proc . zostałaby odroczona do 30 czerwca 2005 roku .	odroczona	6	Sing
Czy transgeniczna żywność jest bezpieczna ?	bezpieczna	4	Sing
Znaczna koncentracja tego gazu w przyziemnej warstwie atmosfery sprzyja więc podwyższaniu temperatury powierzchni Ziemi .	przyziemnej	5	Sing
Po 6,5-godzinnej burzliwej dyskusji sejmowa komisja kultury przyjęła wczoraj projekt budżetu kultury i budżetu radia i telewizji .	6,5-godzinnej	1	Sing
Jego odejście od lewaków do religijnych ortodoksów spowodowało , rzecz jasna , szyderstwa i krytykę , ale wbrew powszechnym oczekiwaniom nie został odrzucony przez media .	powszechnym	18	Plur
Bohaterki filmu reprezentują różne odmiany kultury śródziemnomorskiej .	śródziemnomorskiej	6	Sing
W wyniku nieadiabatycznego ochładzania najniższych warstw troposfery powstają , ogólnie biorąc , najniższe chmury warstwowe .	najniższe	12	Plur
Specyficzna sytuacja jest w Śródmieściu .	Specyficzna	0	Sing
Intuicja okazała się przydatna .	przydatna	3	Sing
I innych dzieciatych też nie uwielbiam .	dzieciatych	2	Plur
Podobny spis już istnieje .	Podobny	0	Sing
W Nowym Tomyślu wiatr zerwał dach urzędu skarbowego i pasażu handlowego .	handlowego	10	Sing
Zdawał się zbierać myśli i szukać odpowiednich słów .	odpowiednich	6	Plur
Prezydent Aleksander Kwaśniewski podpisał nową ordynację wyborczą do Sejmu i Senatu .	nową	4	Sing
Po części oficjalnej przyszedł czas na popisy artystyczne .	artystyczne	7	Plur
Czy w różnych stadiach ewolucji Wszechświata aktywne jądra galaktyk były identyczne ?	aktywne	6	Plur
Wielu obawia się , że będzie skazany na typowe pieskie życie .	pieskie	9	Sing
Od XVIII w. Serbowie już nie byli tam absolutną większością .	XVIII	1	Sing
Ułatwi ona włączenie się do ruchu jadącym z Koziegłów do Poznania .	jadącym	6	Plur
Auto z czterema młodymi mężczyznami wpadło do Wisły .	młodymi	3	Plur
Po przykrych porażkach przychodziły miłe niespodzianki .	miłe	4	Plur
Od 1993 r . jest kierownikiem Zakładu Współczesnych Teorii Ekonomicznych , a od 1999 r . pełni funkcję dziekana Wydziału Ekonomiczno - Socjologicznego Uniwersytetu Łódzkiego .	Ekonomicznych	9	Plur
Wykorzystał on salę sądową do demonstracyjnego wystąpienia w obronie ideologii komunistycznej .	demonstracyjnego	5	Sing
Przedstawione powyżej podejścia , koncepcje i metody dają duży wybór w określeniu docelowego modelu alokacji .	docelowego	12	Sing
- Czy byli śmy inwigilowani ?	inwigilowani	4	Plur
Donald Tusk umiejętnie punktował ogólnikowe wypowiedzi swych konkurentów .	ogólnikowe	4	Plur
Istotne jest , aby cele edukacji ekologicznej zostały przełożone na język konkretów mających zastosowanie w codziennych działaniach ucznia .	Istotne	0	Sing
W Raciborzu odbywa się wiele imprez kulturalnych .	kulturalnych	6	Plur
Opolscy ciepłownicy obawiają się , że ich straty w pierwszych miesiącach nowego roku mogą się okazać horrendalne , bo na podwyżkę ceny węgla nałożyła się także wyjątkowo łagodna zima , która zmniejszyła zapotrzebowanie na ciepło .	horrendalne	16	Plur
