W pierwszych dniach maja rozpocznie się piętnasta wyprawa badawcza dna Oceanu Spokojnego .	Spokojnego	11	Gen
Był to straszliwy bląd polityczny .	straszliwy	2	Nom
Główne dowództwo niemieckie musi objąć kierownictwo operacji wojennych we Włoszech .	wojennych	7	Gen
Na ich stoliku leżały pokruszone papierosy , cygara , przewrócone filiżanki .	przewrócone	9	Nom
Istotnie , w damskim pokoju aż syczało .	damskim	3	Loc
Jednostkę zlikwidowano w ramach reorganizacji polskiej armii .	zlikwidowano	1	Nom
Żeby jednak mieć dobrą samoocenę , lubić siebie , dziecko musi mieć jakieś zasoby wynikające z relacji z najbliższymi .	najbliższymi	18	Ins
Francuscy komuniści są gotowi stworzyć z socjalistami rząd lewicy po wyborach 1998 roku .	Francuscy	0	Nom
Została ona zachwiana po październikowych wyborach .	zachwiana	2	Nom
Przejazd we wrocławskich Świniarach nie jest strzeżony .	strzeżony	6	Nom
W Wojewódzkim Szpitalu Zespolonym odbyła się pierwsza w Poznaniu udana operacja przeszczepienia rogówki .	Wojewódzkim	1	Loc
Rozpoczyna się teraz emocjonujący wyścig ze zbliżającą się burzą .	zbliżającą	6	Ins
Na dziobie , bodącym niebo , przerzucony przez poręcz wisiał mister Dawid Lingslay .	bodącym	3	Loc
Rezolucja wypowiada się przeciwko istnieniu narodowych sił nuklearnych , ale nie przeciwko samej broni nuklearnej .	nuklearnych	7	Gen
Nie czekając na decyzję Akcji , Unia Wolności zaczęła lansować na prezesa Karola Modzelewskiego , historyka i polityka związanego z Unią Pracy .	związanego	18	Acc
Parlament Europejski w Strasburgu przegłosował niedawno całkowity zakaz reklamowania wyrobów tytoniowych .	tytoniowych	10	Gen
Przybysze z najnowszej fali na ogół stronią od polonijnych organizacji społecznych .	polonijnych	8	Gen
Celników z rzepińskiej Izby Celnej wspierali funkcjonariusze z Poznania i Krakowa .	Celnej	4	Gen
- Może nową posadą będzie fotel prezesa PZN ?	nową	2	Ins
Alarmującym problemem jest narkomania wśród młodzieży .	Alarmującym	0	Ins
Po jej najwybitniejszych przedstawicielach na cenowe szczyty dostali się liczni malarze , których zasługi artystyczne , poza tworzeniem dekoracyjnych i sprawnych technicznie obrazów , są raczej mizerne .	najwybitniejszych	2	Loc
Podłączyliśmy go do sztucznych komór , czekał na dawcę .	sztucznych	3	Gen
Przygoda u czoła Lodowca Hansa uświadomiła mi , że lepiej bezpośrednio nie dotykać lodowego klifu .	lodowego	13	Gen
Zacisnął em palce na szorstkim płótnie i wyczuł em obłe kształty pocisków .	szorstkim	4	Loc
Kuczma oświadczył , że gospodarka będzie reformowana na zasadach rynkowych .	reformowana	6	Nom
A stopy mocno stoją na twardym , świętym gruncie .	twardym	5	Loc
- Dlaczego jesteś taka niegrzeczna ?	niegrzeczna	4	Nom
Omawiana książka jeszcze raz to potwierdza .	Omawiana	0	Nom
W wspomnianych zestawach nie figurują te nazwiska .	wspomnianych	1	Loc
W większej gliniance z godnością pływa starszy mężczyzna .	większej	1	Loc
Po dobranocce najmłodsze idą spać .	najmłodsze	2	Nom
Miłość nie jest wzajemną zależnością , ani uzależnieniem .	wzajemną	3	Ins
W pobliżu granicy Kosowa z Albanią zginęło w walkach z serbskimi żołnierzami co najmniej ośmiu albańskich separatystów .	albańskich	15	Gen
W piwnicy za zakrętem korytarza wartownik błysnął światłem ręcznej latarki .	ręcznej	8	Gen
Kontrolerzy nie wzięli pogróżek poważnie , bo wiedzieli z doświadczenia , że w podobnej sytuacji prawie każdy podatnik powołuje się na możnego protektora . . .	podobnej	13	Loc
Co zrobić z ukrytym bezrobociem na wsi ?	ukrytym	3	Ins
Tata ukrywał się na Żoliborzu u Zosi , mojej przyszłej wspaniałej macochy , jako Pan Nikt .	wspaniałej	10	Gen
Prawdziwe chwile euforii przeżywała również warszawska giełda .	warszawska	5	Nom
Taksówka czekała z zapalonym silnikiem , a ci od pomocy drogowej wkładali jeepa na podnośnik .	zapalonym	3	Ins
Ale pani poseł nie dopuściła do niewygodnej debaty na temat tych zarzutów .	niewygodnej	6	Gen
Na czele stoi król - Ashantehene , otoczony radą starszych .	starszych	9	Gen
Francuscy komuniści są gotowi stworzyć z socjalistami rząd lewicy po wyborach 1998 roku .	1998	11	Gen
By wdrożyć projektowany przez rząd nowy system taniego budownictwa mieszkaniowego , konieczne jest szybkie wyszkolenie kadr .	taniego	7	Gen
Dante miał wzrok utkwiony w jego usta .	utkwiony	3	Acc
Bez dłuższych wstępów przedłożyłem mu całą sprawę i zaproponowałem pracę .	dłuższych	1	Gen
Samo się zaczęło .	Samo	0	Nom
Na pewno też wywołał by protesty spowodowane dalszym naruszaniem stabilności sytuacji podatników .	dalszym	7	Ins
Zarzuca mu pranie brudnych pieniędzy , płatną protekcję i udział w zorganizowanej grupie przestępczej .	przestępczej	13	Loc
Zosia Szymanowska była starszą siostrą Antka , mego dawnego kolegi od Batorego .	dawnego	8	Gen
PiS idzie do wyborów pod własnym szyldem .	własnym	5	Ins
Stanowią one razem z rzodkiewką potrawę pełnowartościową , dając jednocześnie ciekawy efekt dekoracyjny .	pełnowartościową	6	Acc
Będę się starał o inne rozwiązanie , a jestem uparty .	uparty	9	Nom
Oryginalne lampy zdobyto z zasobów niemieckich przeznaczonych dla Wehrmachtu .	Oryginalne	0	Acc
W poniedziałek spotkał się z wiernymi na południowej modlitwie .	południowej	7	Loc
Rośnie pokolenie ludzi straconych , wyrzuconych . . .	wyrzuconych	5	Gen
Mając to na uwadze Ogólnopolska Rada Ruchów Katolickich po raz czwarty podjęła inicjatywę Białego Tygodnia .	Katolickich	7	Gen
Z oficjalnym żądaniem wobec MKOl , złożonym na piśmie , wystąpił Narodowy Komitet Olimpijski KRLD , domagając się od naczelnej władzy sportowej rewizji listy triumfatorów olimpijskich .	oficjalnym	1	Ins
Przewiduję obopólne korzyści .	obopólne	1	Acc
Leżała na wersalce z nosem wtulonym we włochatą poduszeczkę .	wtulonym	5	Ins
Luksusowego forda explorera nieznani sprawcy skradli wczoraj w Warszawie generałowi rosyjskiej milicji .	Luksusowego	0	Acc
Niektórzy z idiotów tylko onanizując się zaspokajają swoje potrzeby seksualne .	seksualne	9	Acc
Uniwersytet ten , założony w 1949 r . i prowadzony przez werbistów , nie posiada zbyt długiej tradycji akademickiej .	długiej	16	Gen
Trzech jest nieprzytomnych .	nieprzytomnych	2	Gen
Pomorska Regionalna Kasa Chorych jest od wczoraj kontrolowana przez pracowników Urzędu Nadzoru Ubezpieczeń Zdrowotnych .	Zdrowotnych	13	Gen
Jak dotąd , ani Państwowe Koleje Linowe , ani straż miejska , ani policja nie potrafiły poradzić sobie z konikami .	miejska	10	Nom
Nowe tablice rejestracyjne będą białe z czarnymi napisami i znakiem legalizacyjnym .	czarnymi	6	Ins
Czy musiały śmy tu przyjechać z tą wstrętną Grochulską ?	wstrętną	7	Ins
Demonstranci mieli flagi Liberalno - Demokratycznej Partii Rosji , organizacji politycznej znanego nacjonalisty Żyrinowskiego .	Demokratycznej	5	Gen
Towarzyszyli mu polscy policjanci ze specjalnego wydziału zajmującego się deportacją z Komendy Głównej Policji .	Głównej	12	Gen
O reklamowej działalności prezydenta mówią członkowie Sejmowej Komisji Etyki Poselskiej .	Poselskiej	9	Gen
Kontrast ten może nawet świadczyć o jakiejś obojętności czy martwocie religijnej panującej w czasach proroka .	panującej	11	Loc
Dzięki temu pracownicy bardzo szybko ustalili , kto może być odpowiedzialny za zdarzające się coraz częściej w firmie tajemnicze manka .	zdarzające	12	Acc
- W budownictwie jest straszna bryndza .	straszna	4	Nom
Po zajęciu miejscowości Krzyżacy zmasakrowali miejscową ludność .	miejscową	5	Acc
Młodzi modele krakowskiej ASP pozują , zdaniem Marty , przede wszystkim z powodów finansowych .	krakowskiej	2	Gen
Z dziwnym uczuciem brała m go do ręki .	dziwnym	1	Ins
Bo jest byłym gliną ?	byłym	2	Ins
Zgodnie z podjętymi na wtorkowym spotkaniu ustaleniami , targi eksporterów oraz wystawy turystyczne odbędą się w przyszłym roku .	turystyczne	12	Nom
Jest tu 16 jezior , łącznie z 4 jeziorami na obrzeżu , znajdującymi się już poza administracyjną granicą WPN .	administracyjną	16	Ins
- To wypracowuje się na codziennych , mozolnych próbach .	mozolnych	7	Loc
Użytkownik ma do dyspozycji 6 baz zawierających informacje posortowane według wybranego kryterium .	wybranego	10	Gen
Pierwsze gwiazdy toną w duszy młodego człowieka jak w górskim jeziorze .	Pierwsze	0	Nom
Przy władającym Uranie twoja twórczość może ujawniać się jako zdolności wynalazcze .	władającym	1	Loc
Nie sądzę , żeby Aleksandra Jakubowska była jakimś głównym problemem .	głównym	8	Ins
Złotą Statuetkę pierwszy niekomunistyczny premier w powojennej Polsce odebrał w sobotę podczas Wielkiej Gali Polskiego Biznesu .	niekomunistyczny	3	Nom
Zmienił obiektyw na długą rurę .	długą	3	Acc
Spotkał się ze stanowczą odmową .	stanowczą	3	Ins
Wysoka liczba urodzeń hamuje także rozwój gospodarczy kraju , w którym znaczny procent mieszkańców żyje poniżej uznanego progu ubóstwa .	gospodarczy	6	Acc
Zwierzę unieruchomione w pułapce nie mogło wydostać się stamtąd o własnych siłach .	własnych	10	Loc
Czy pieniędzy zabraknie dla wszystkich potrzebujących ?	potrzebujących	5	Gen
Mimo tak dużych możliwości EMG , czasem nie udaje się na jej podstawie postawić trafnej diagnozy .	trafnej	14	Gen
Zupełnie nie udał się start naszej pięciobojowej młodzieży w mistrzostwach świata w czwórboju nowoczesnym kobiet i mężczyzn w szwedzkiej Uppsali .	szwedzkiej	18	Loc
W kościele mariackim w Radomiu o północy mszę święto odprawił biskup senior Edward Materski .	mariackim	2	Loc
Został em zmobilizowany do przemysłu .	zmobilizowany	2	Nom
W oddzielnych grupach ćwiczą panie i panowie , później znów spotykają się i odbywają wspólnie zajęcia choreograficzno - taneczne .	taneczne	18	Acc
Rozdzielali zwaśnione strony w ramach misji pokojowych ONZ .	zwaśnione	1	Acc
Poznał kosmetyczkę i przybory toaletowe .	toaletowe	4	Acc
Pewną ręką zamyka książkę .	Pewną	0	Ins
Nagrody i poczęstunek był dla wszystkich , a najlepsi zawodnicy otrzymali ponadto puchary .	najlepsi	8	Nom
Bez tego nawet w naszych sklepach mogą się wkrótce pojawić chińskie owoce .	chińskie	10	Nom
Rzecznik Praw Obywatelskich wystąpił w obronie inwalidów wojennych i wojskowych , którym wprowadzono obowiązek płacenia za pobyt w sanatoriach uzdrowiskowych .	wojskowych	9	Gen
Smarkaci mężczyźni gonią tylko za ładną buzią i modną sukienką .	modną	8	Ins
Dobrze jest odparować nadmiar wody z ogórków , aby potrawa nie była zbyt wodnista .	wodnista	13	Nom
Wypadek nie przyniósł groźniejszych konsekwencji .	groźniejszych	3	Gen
W 2004 Jabil wszedł w posiadanie fabryki telewizorów w Kwidzynie .	2004	1	Loc
Największy na świecie producent sieci komórkowych zamierza skupić się na podstawowej działalności , a aparaty będzie kupował od producenta zewnętrznego z siedzibą w Singapurze i tylko sygnował je własnym znakiem towarowym .	towarowym	30	Ins
Podchodzi do głównych drzwi wejściowych , by wpuścić dwie kobiety .	wejściowych	4	Gen
Siedzibą tej parafii jest usytuowany przy skrzyżowaniu ulicy Zamoyskiego i Sabały nowoczesny kościół Świętego Krzyża .	usytuowany	4	Nom
Po kompromitującym czynie , logiczna jest likwidacja świadków , to typowy sposób postępowania wszystkich szanujących się gangsterów .	typowy	10	Nom
Dlatego demokracja musi być podbudowana aksjologią , bo bez tego jest groźniejsza niż dobra dyktatura .	podbudowana	4	Nom
Sprawą zajmują się policjanci z 6 komisariatu na Górnej .	Górnej	8	Loc
Był by m bardziej autentyczny .	autentyczny	4	Nom
Ten z pozoru kosmetyczny zabieg spowodował sporo zamieszania .	kosmetyczny	3	Nom
Olbrzymy zazwyczaj są barwy czerwonej .	czerwonej	4	Gen
Należy podkreślić , że gaźnik jest ważnym elementem samochodu , gdyż oprócz ekonomicznego zużycia paliwa w znacznym stopniu wpływa również na niezawodność jazdy i stałą gotowość techniczną pojazdu .	ekonomicznego	12	Gen
Zaangażowała się w Teatrze Dramatycznym kierowanym wówczas przez Gustawa Holoubka .	Dramatycznym	4	Loc
Z trudem dostrzegam siedzących pod oknem Stefana i Wiktora .	siedzących	3	Acc
Tymczasem polska motoryzacja nie ma żadnej przyszłości poza prostym składaniem zestawów samochodowych , a planowana operacja ma zabezpieczyć interesy banków .	prostym	8	Ins
Przy okazji zauważył , że wcale nie była skończoną pięknością , lecz tylko doprowadziła do artyzmu trudną sztukę makijażu .	skończoną	8	Ins
W numerze wydanym przez Movex rzuca się w oczy kilkustronicowy wstępniak .	wydanym	2	Loc
Uczestnicy zjazdu wypili wodę święconą z kościoła Najświętszego Zbawiciela .	Najświętszego	7	Gen
– Ach , mówisz o pomarańczowej !	pomarańczowej	5	Loc
Bo koledzy starsi o rok , dwa mogli stracić dziewictwo jeszcze w komunizmie .	starsi	2	Nom
– chyba jestem głodna .	głodna	3	Nom
Niepostrzeżenie wracamy do domu i nad ranem obwieszczamy światu odkrycie niecodziennego zjawiska .	niecodziennego	10	Gen
Tam dyżurna kosmetyczka obejrzy pani cerę , udzieli porady i wskaże , jakie mleczko będzie najwłaściwsze , a może jeszcze doradzi jakiś krem .	najwłaściwsze	15	Nom
Odpowiedziałeś posługując się sztandarowym obok Białorusi argumentem .	sztandarowym	3	Ins
Włoski rząd na nadzwyczajnym posiedzeniu przeznaczył wczoraj 50 milionów euro dla dotkniętego trzęsieniem ziemi regionu .	nadzwyczajnym	3	Loc
O sytuacji dzieci poinformowała szpital przypadkowa osoba .	przypadkowa	5	Nom
Postój w tym byłym górniczym mieście poprzedził dyskretny telefon z ABW do władz grodu .	górniczym	4	Loc
Będzie dostępna około czternastej .	dostępna	1	Nom
Matka - niematka wzięła urlop macierzyński .	macierzyński	5	Acc
Usiedli obydwaj przy herbacie zaparzonej w grubych szklankach .	zaparzonej	4	Loc
To wyjątkowa kobieta .	wyjątkowa	1	Nom
Po sukcesie wyborczym NSDAP w lipcu 1932 naród niemiecki zaczyna przejawiać ślady otrzeźwienia .	wyborczym	2	Loc
Rękopisy zostały przyniesione przez lwowianina , który po wojnie osiedlił się w tych stronach .	przyniesione	2	Nom
Nigdy wcześniej w tak wielkiej imprezie sportowej , i tak prestiżowej , nie startowali śmy .	prestiżowej	10	Loc
Drużynowymi finałami zakończona została w poniedziałek rywalizacja pływaków o medale i dolarowe premie w Igrzyskach Dobrej Woli .	zakończona	2	Nom
Wyróżniał się licznymi szybami górniczymi , kryjącymi w swych wnętrzach wieże wyciągowe i windy do przewozu ludzi i węgla .	górniczymi	4	Ins
Na diagramie Hertzsprunga - Russella olbrzymy znajdują się ponad ciągiem głównym .	głównym	10	Ins
Lewy policjant pożyczył od niego na paliwo .	Lewy	0	Nom
Woda zalała zasiewy i drogi lądowe .	lądowe	5	Acc
- W iluż miastach w okresie letnim odbywa się tyle bezpłatnych występów artystycznych .	letnim	6	Loc
Od kilku lat w górnej szufladzie mojego biurka leży biały zeszyt .	biały	9	Nom
Dobre imię dano ci na chrzcie , nasz drogi radco .	Dobre	0	Acc
Są ponadto zależni od społeczności wyższych , które mają zwyczajowe prawo ingerowania w życie tych ludzi .	zwyczajowe	9	Acc
Przyszła Kryśka i zdziwiła się , że jestem taka blada .	blada	9	Nom
W kontekście emocjonalnych , osobistych wypowiedzi ta budzi podejrzenie o nieautentyczność .	emocjonalnych	2	Gen
Przypomnijmy , że 16 lipca 1994 r . dziadkowie półtorarocznej wówczas Moniki zostawili ją przed legnicką apteką pod opieką ojca , Roberta Bielawskiego .	legnicką	15	Ins
- To nam pozwoliło przetrwać ostatnią epokę lodową .	lodową	7	Acc
Nie znał em go przedtem , bo za moich czasów wileńskich był jeszcze sztubakiem , a potem przebywał za granicą .	wileńskich	10	Gen
Mówiły one o uniezależnieniu się Prus Książęcych od Polski .	Książęcych	6	Gen
Przy podniesieniu w czasie mszy używa się według Antegnatiego solowego rejestru pryncypalnego o bardzo delikatnym brzmieniu .	pryncypalnego	11	Gen
Niemal wszystkie nici myśli kwestionującej prowadzą do Kartezjusza .	kwestionującej	4	Gen
Siedział już w oknie , z nogami wystawionymi na zewnątrz , ale w porę obezwładnili go i ściągnęli z okna strażnicy miejscy .	wystawionymi	7	Ins
Możesz jeść małymi łyżeczkami .	małymi	2	Ins
Pędzę do pokojówki z tą hiobową wieścią .	hiobową	5	Ins
- Mamy tu więcej stanowisk strzeleckich .	strzeleckich	5	Gen
Społeczność ludzka funkcjonuje w strukturach zapewniających formę organizacyjną .	organizacyjną	7	Acc
Reformy ograniczono do totalnej prywatyzacji , która przyjęła raczej ramy wyprzedaży majątku narodowego .	narodowego	12	Gen
Wykorzystując przerwę w popołudniowych grach , Agassi i Graf zrobili sobie małą sesję treningową .	treningową	13	Acc
– jedną kapustę czerwoną zrobiła m .	czerwoną	3	Acc
Duduś wymusza rzucanie , dopominając się o nie przeraźliwym miauczeniem .	przeraźliwym	8	Ins
- I zupełnym przypadkiem trafił eś na Jacka Kuronia .	zupełnym	2	Ins
Co takiego stało się w ostatnią sobotę ?	ostatnią	5	Acc
Zwłaszcza gimnazjum wydaje się nieudanym pomysłem .	nieudanym	4	Ins
A sprawa nie jest błaha .	błaha	4	Nom
Za chwilę kardynałowie i biskupi wyniosą obraz Matki Bożej Jasnogórskiej na ołtarz przed kościołem .	Bożej	8	Gen
Nie składają donosów do prokuratury , nie przejmują się całodobowym uśmiercaniem poczętych ?	całodobowym	9	Ins
Zatracił gdzieś wcześniejszą brawurę i zawadiacką pozę .	zawadiacką	5	Acc
Wielu partyjnych kolegów chętnie widziałoby go na stanowisku prezydenta Łodzi , ponieważ Marcisz ma opinię dobrego menadżera .	partyjnych	1	Gen
Ja wszelako nie piszę w imieniu przegranych polityków .	przegranych	6	Gen
Polskich komunistów nie łączyły nigdy żadne specjalne więzy z przywódcami ludowych Chin .	Polskich	0	Gen
Z ich opinią liczono się nie tylko w redakcji , ale również w środowiskach literackich i teatralnych .	teatralnych	16	Loc
Są to sprawy oczywiste .	oczywiste	3	Nom
Rano obudził się z obolałą głową .	obolałą	4	Ins
Duże urozmaicenie wprowadzają do tegorocznej wystawy fotomontaże .	tegorocznej	4	Gen
Z głębin morza dalekich a z bełku przepadłego powrócił , żeby u stopy braterskiej jasne czoło położyć .	braterskiej	13	Gen
Zatopieni w pełnym kontakcie , przestali śmy zauważać resztę świata .	Zatopieni	0	Nom
Wybili szybę w drzwiach wejściowych sklepu betonowym krawężnikiem .	betonowym	6	Ins
Stanowią one razem z rzodkiewką potrawę pełnowartościową , dając jednocześnie ciekawy efekt dekoracyjny .	pełnowartościową	6	Acc
W sztuce miecza faza oddechu jest bardzo ważna , bo szermierz biorący oddech jest wtedy najsłabszy .	biorący	11	Nom
Irga rozkrzewiona to jeden z najpiękniejszych gatunków o wspaniałym jesiennym przebarwieniu liści , również obficie owocujący .	jesiennym	9	Loc
- Dobre sondaże są dla premiera niemałym kłopotem .	Dobre	1	Nom
Stary wiadukt przy ulicy Oświęcimskiej stanowił ogromną uciążliwość dla kierowców .	Oświęcimskiej	4	Loc
Właściwie tylko Białostockie Przedsiębiorstwo Budownictwa Przemysłowego posiada laboratorium z prawdziwego zdarzenia .	Białostockie	2	Nom
Całowała go drobnymi , szybkimi pocałunkami .	drobnymi	2	Ins
- To znakomite miejsce na spędzenie weekendu .	znakomite	2	Nom
40-osobowa grupa chuliganów wywołała rozróbę przed sobotnim III-ligowym meczem piłki nożnej Lublinianki z Cracovią .	III-ligowym	7	Ins
W sprawie formalnej zgłasza się pan poseł Marek Jurek .	formalnej	2	Loc
Prawem opozycji nazwał szef Agencji Bezpieczeństwa Wewnętrznego Andrzej Barcikowski zapowiedź ewentualnego wniosku o odwołanie go z pełnionej funkcji .	Wewnętrznego	6	Gen
Na muzeum przeznaczono część parteru drewnianego budynku .	drewnianego	5	Gen
Zacisnąłem palce na szorstkim płótnie i wyczułem obłe kształty pocisków .	szorstkim	3	Loc
Nie sądzi pan , że te kłamstwa kompromitują naukę scientologiczną ?	scientologiczną	9	Acc
Horti 2000 to także okazja do zapoznania się z najnowocześniejszymi sprzętami ogrodowymi , niezbędnymi nawozami , które sprawiają , ze nasza działka będzie obiektem zachwytu .	niezbędnymi	13	Ins
Dziecko niespodziewanie wsiadło do czekającej na piętrze windy .	czekającej	4	Gen
Wypowiadamy się w sondach telewizyjnych a czasami przesyłamy także nasze opinie elektronicznie .	telewizyjnych	4	Loc
- Nie zorganizowano zawodów na odpowiednim poziomie , na przykład w skokach do wody czy siatkówce , bo Zimbabwe nie spodziewa się w tych dyscyplinach osiągnięć .	odpowiednim	5	Loc
Modernizacja Opla Frontery miała uczynić go bardziej przyjaznym dla użytkowników , nie zmniejszając jednocześnie jego możliwości .	przyjaznym	7	Ins
W Centrum Naukowym Wielkich Jezior w amerykańskim Cleveland otwarto wystawę niecodziennych pomocy naukowych dla dzieci .	naukowych	12	Gen
Rano Odra nasyca niebieskawą mgłą ulice obu miast .	niebieskawą	3	Ins
To wspaniały , rock'n'rollowy zespół wbrew pozorom .	rock'n'rollowy	3	Nom
Cały prawy błotnik wraz ze światłami został na haku .	prawy	1	Nom
Saperzy wydobyli we wtorek sześć artyleryjskich pocisków burzących z czasów II wojny światowej , odkrytych na terenie budowy na krakowskim Prądniku Czerwonym .	artyleryjskich	5	Gen
Oświadczył też , że idą z polecenia organizacji z bardzo ważnym zadaniem .	ważnym	10	Ins
Wiatr przynosił ostry alkoholowy zapach traw .	alkoholowy	3	Acc
- W 1299-tym nadał Nakłu prawa miejskie mały drobny Król Łokietek , a Dzielny Krzywousty w 12-tym wieku narobił w Nakle kapusty !	12-tym	16	Loc
Numer drugi mrugał zachęcająco .	drugi	1	Nom
Krępa i kanciasta sylwetka zdaje się ją rozsadzać .	kanciasta	2	Nom
Zgodnie z podjętymi na wtorkowym spotkaniu ustaleniami , targi eksporterów oraz wystawy turystyczne odbędą się w przyszłym roku .	podjętymi	2	Ins
- Staszek był trudnym człowiekiem , bardzo rozdwojonym .	rozdwojonym	7	Ins
– eee czy czujesz się dojrzały ?	dojrzały	5	Nom
Lecz w porze kolacyjnej do drzwi zapukano .	kolacyjnej	3	Loc
W intymną narrację wdzierają się echa bośniackiej tragedii .	intymną	1	Acc
Inni też obiecywali .	Inni	0	Nom
Jeszcze niedawno informowano , że skradziono 60 starych ksiąg , teraz okazało się , że brakuje ponad 90 pozycji .	starych	7	Gen
Dlatego językiem oficjalnym stał się arabski , a dąży się , by stał się językiem ogólnonarodowym .	ogólnonarodowym	15	Ins
– tam są domki jednorodzinne .	jednorodzinne	4	Nom
Postulaty protestujących zarząd miasta uznał za bezzasadne .	bezzasadne	6	Acc
Później innego uczestnika spotkania znaleziono martwego w jego domu letniskowym pod Belgradem .	martwego	5	Acc
Poznali śmy się w okolicznościach osobliwych .	osobliwych	5	Loc
Pokaże także adresy różnych instytucji , wyświetli kolorowy rozkład jazdy i poda repertuar kin czy teatrów .	kolorowy	7	Acc
Ale Moja Wdowa uważała , że zupy te czynią żołądek gładkim i młodym .	gładkim	10	Ins
Tematem prelekcji i dyskusji był problem uzależnienia alkoholowego .	alkoholowego	7	Gen
Drużynowymi finałami zakończona została w poniedziałek rywalizacja pływaków o medale i dolarowe premie w Igrzyskach Dobrej Woli .	dolarowe	11	Acc
Sekcja zwłok wykazała , że przyczynami zgonu były zakrzepica żyły udowej , zator tętnicy płucnej i niewydolność krążeniowo - oddechowa .	oddechowa	19	Nom
Obecnie jest to osada jednozagrodowa , rolnicza .	jednozagrodowa	4	Nom
Konstruuje jakieś sprzęty do badań meteorologicznych .	meteorologicznych	5	Gen
Na tym wyczerpaliśmy porządek dzienny 113 . posiedzenia Sejmu .	113	5	Gen
Teraz myśli się już o rzeczach dużo bardziej zaawansowanych .	zaawansowanych	8	Loc
Ostatnim wysiłkiem naprowadza płonący samolot wprost na wieżyczkę u-boota .	Ostatnim	0	Ins
Przeważnie zdarzają się zwichy tylne , obrotowo - tylne i przednie 5 . kręgu lędźwiowego .	lędźwiowego	14	Gen
Stałą obserwacją objęta jest ulica Bohaterów Warszawy od poczty głównej do placu Wolności .	Stałą	0	Ins
Kolejną aferę w zakładach pracy chronionej ujawnili policjanci z wydziału do walki z przestępczością gospodarczą Komendy Wojewódzkiej w Olsztynie .	gospodarczą	14	Ins
Jego wiarygodność sprawdzono poprzez Krajową Izbę Gospodarczą .	Krajową	4	Acc
Suger Land jest najdynamiczniej rozwijającym się teksańskim miastem .	teksańskim	6	Ins
Dwoisz się i troisz , aby rozwiązać kilkadziesiąt praktycznych problemów równocześnie .	praktycznych	8	Gen
Dla firm internetowych sieć to przede wszystkim nowy , wielki rynek handlowy , dzięki któremu towar może bez problemu trafić pod drzwi klienta .	internetowych	2	Gen
Usłużnym kierowcą okazał się 34-letni Rob Gatena .	Usłużnym	0	Ins
Życie rodzinne , domowe , schodzi na dalszy plan .	dalszy	7	Acc
Księdza zatrzymano w ubiegłym tygodniu na polsko - ukraińskim przejściu granicznym w Dorohusku przy wjeździe do Polski .	zatrzymano	1	Nom
Grupa powstała we wczesnych latach 80 .	80	5	Loc
Według legend , w studni głębokiej na ponad 30 metrów znajdują się wejścia do lochów i tajnych chodników łączących posiadłości właścicieli zamku .	łączących	18	Gen
Wymiana metra bariery energochłonnej , montowanej na mostach i wiaduktach , to wydatek kilkuset złotych .	energochłonnej	3	Gen
VIII Zjazd Inżynierów Mechaników Polskich obradował w Katowicach pod hasłem zbiorowego wysiłku myśli i pracy nad aktualnymi zagadnieniami technicznymi , mającego na celu rozwój techniki polskiej .	aktualnymi	16	Ins
Warszawscy radni twierdzą , że nie miał prawa tego zrobić .	Warszawscy	0	Nom
Drugim ważnym wydarzeniem był run na giełdę firm poszukujących kapitału .	Drugim	0	Ins
Popierają regionalne środowiska twórcze .	regionalne	1	Acc
Miał 28 lat , żonaty , córka .	żonaty	4	Nom
Jej zdaniem coś złego wydarzyło się w mieszkaniu przy ul . Składowej , w którym wraz z siostrą mieszkała jej koleżanka .	Składowej	11	Loc
Sześć pięknych dziewcząt rywalizowało w Miejsko - Gminnym Ośrodku Kultury w Małogoszczu o tytuł Miss Regionu Jędrzejowskiego i Włoszczowskiego .	Włoszczowskiego	18	Gen
- Widzę siebie w przyszłej Radzie .	przyszłej	4	Loc
Może to oznaczać kolejny wzrost stóp procentowych , droższego dolara i spadek zaufania inwestorów zagranicznych .	droższego	8	Acc
Głosić takie wywrotowe poglądy przed takim audytorium !	wywrotowe	2	Acc
- Jako człowiek próżny chętnie wracam do rzeczy przyjemnych .	przyjemnych	8	Gen
Śpiącego , zielem odurzonego zabiła m sztyletem .	odurzonego	3	Acc
– Mam syna starszego od ciebie . . .	starszego	3	Acc
Przyzwoitość każe szanować gości i ja właśnie w ten elegancki sposób uszanuję Jagodowe wakacje .	elegancki	9	Acc
W tym pieprzonym rejonie zawsze wieje .	pieprzonym	2	Loc
Młoda demokracja została siłą wtłoczona w ramy półautorytarnej republiki prezydenckiej .	prezydenckiej	9	Gen
Komisja przetargowa miasta i Zarządu Dróg Miejskich wybrała najtańszą ofertę .	najtańszą	8	Acc
Dokonują wstrząsającej ekspertyzy zniszczeń .	wstrząsającej	1	Gen
Jechali w ponurym milczeniu .	ponurym	2	Loc
Dzieci są okaleczone na całe życie .	okaleczone	2	Nom
Mariola odstawiła torebkę na malutki stołeczek .	malutki	4	Acc
Chodzi o to , żeby demonstracje odbywały się w spokoju , żeby w minimalnym stopniu zakłócały życie innych ludzi i żeby nie było polską normą bicie policjantów , okupowanie budynków , wyrywanie znaków drogowych czy niszczenie samochodów .	drogowych	33	Gen
W szybkim tempie spijało rosę .	szybkim	1	Loc
Zyta milknie , Blanka opowiada o kłopotach małżeńskich .	małżeńskich	7	Loc
Poranione potłuczoną butelką zwierzę trafiło do weterynarza .	potłuczoną	1	Ins
Posiadanie pełnych praw akademickich oznacza , że uczelnia nadaje stopień naukowy doktora , przeprowadza przewody habilitacyjne oraz występuje z wnioskiem o nadanie tytułu naukowego profesora .	habilitacyjne	15	Acc
Piękna 32-letnia piosenkarka występuje w nim w nietypowej dla siebie roli aktorki porno .	32-letnia	1	Nom
Znaleziono go w grobowcu Ramzesa III .	III	5	Gen
Nadmieniamy , że w pierwszą niedzielę lutego br . przeprowadzono zbiórkę pieniędzy na zakup niezbędnego urządzenia medycznego do pracowni analitycznej w Wiejskim Ośrodku Zdrowia w Brzeziu .	analitycznej	19	Gen
Wojewoda doda jej dla splendoru nieszczupły taborek .	nieszczupły	5	Acc
Po co to zostawiać na ostatnią chwilę ?	ostatnią	5	Acc
Zresztą francuzica niepotrzebnie wylicza kunsztowne potrawy , bo generał lubi tylko prostą kuchnię .	kunsztowne	4	Acc
Nigdy nie zauważyłem , by padał na mnie jakiś cień , bym pozostawał w czyimś cieniu .	czyimś	14	Loc
Szwagier pana Korzeniowskiego toporem rozrąbał świński łeb i wydobył mózg .	świński	5	Acc
Październik był krótkim świętem .	krótkim	2	Ins
Poruszyły się wskaźniki na podświetlanych zegarach .	podświetlanych	4	Loc
Największy na świecie producent sieci komórkowych zamierza skupić się na podstawowej działalności , a aparaty będzie kupował od producenta zewnętrznego z siedzibą w Singapurze i tylko sygnował je własnym znakiem towarowym .	podstawowej	10	Loc
Hehe wspinał się mozolnie po schodach starej kamienicy przy Poznańskiej .	Poznańskiej	9	Loc
Młodzież z Mełgwi otrzymała pełnowymiarową halę sportową .	pełnowymiarową	4	Acc
Głupiego samochodu na parę minut zostawić nie można , to się nazywa MO ?	Głupiego	0	Gen
Właściwie nie czułem się jeszcze senny , chociaż miałem za sobą dość długi i męczący dzień .	senny	5	Nom
Klasztor fundacji Gaszynów posiada sklepione cele i korytarze komunikacyjne .	komunikacyjne	8	Acc
Naczelnik ulicznych rzeźników wykrzywił twarz .	ulicznych	1	Gen
Panowie w cylindrach i w melonikach tkwili bokiem na przednich ławeczkach .	przednich	9	Loc
Doświadczenia laboratoryjne wykazały , że gąsienice motyli monarchów , karmione transgeniczną żywnością , miały kłopoty ze zdrowiem .	transgeniczną	10	Ins
Emma pomyślała w tej chwili , że nie jest to spostrzeżenie specjalnie odkrywcze .	odkrywcze	12	Nom
Funkcjonariusze inspekcji celnej przy pomocy biegłych ustalili , że przy próbie wywozu najprawdopodobniej naruszone zostały przepisy Kodeksu celnego .	celnej	2	Gen
Mógł się zmieścić w złożonych dłoniach .	złożonych	4	Loc
W niedzielny wieczór premier Izraela Ariel Saron ogłosił wojnę z palestyńskim terroryzmem .	palestyńskim	10	Ins
Znaczna koncentracja tego gazu w przyziemnej warstwie atmosfery sprzyja więc podwyższaniu temperatury powierzchni Ziemi .	Znaczna	0	Nom
W nadchodzącym tygodniu wyznaczone zostały posiedzenia czterech komisji sejmowych .	wyznaczone	3	Nom
Zamiast trzystu dwudziestu ośmiu obiektów elektryfikacyjnych , załoga wybudowała trzysta sześćdziesiąt cztery .	elektryfikacyjnych	5	Gen
Panowie nie mieli najmniejszych problemów z dziwnie skleconą reprezentacją Reszty Świata , panie też gładko wygrały z osłabioną ekipą USA .	najmniejszych	3	Gen
- To była szopka jak za dawnych lat .	dawnych	6	Gen
Tego nie wiemy na pewno , mimo że zacytowane wyżej zdanie stało się znakiem rozpoznawczym .	rozpoznawczym	14	Ins
W pańskim wieku , na pańskim stanowisku torturować kobietę !	pańskim	1	Loc
Klepał Jazończyka po ramieniu , ciągle ze śmiechem , mimo że twarz tamtego wyrażała surową powagę .	surową	14	Acc
W związku z wyrażonym wotum nieufności , Ponikowski w imieniu całego gabinetu poprosił o dymisję , która została przyjęta .	wyrażonym	3	Ins
Tam nawiązuje kontakt z grupą partyzancką o zabarwieniu skrajnym , likwidującą komunistów i uciekinierów z gett .	partyzancką	5	Ins
Szwedzi , biedny naród , nie znają zapachu piekarni , świeżego , prawdziwego chlebka .	świeżego	10	Gen
Świeżo upieczony hejnalista ma już swoją trąbkę .	upieczony	1	Nom
Daktyle sparzyć , drobno pokroić i dodać z pozostałym masłem do kuskusu .	pozostałym	8	Ins
Juniorską reprezentację w najbliższym czasie czekają półfinały ME w Essen .	Juniorską	0	Acc
W Polsce przedwrześniowej mieliśmy jedynie 600 zelektryfikowanych wsi .	przedwrześniowej	2	Loc
Większość skradziono w Berlinie , Hamburgu , Kilonii i Bremie .	skradziono	1	Nom
– Nie zostanie pan jednak całkiem odsunięty od śledztwa .	odsunięty	6	Nom
Pierwszy cios , który później okazał się śmiertelny , został zadany metalowym krzesłem w tył głowy .	metalowym	11	Ins
Kelnerka miała narzucony płaszcz .	narzucony	2	Acc
Akcję sprawozdawczo - wyborczą w pracowniczych ogrodach działkowych zakończy ogólnopolska konferencja delegatów wybranych na zjazdach wojewódzkich POD , która będzie obradowała w maju w Warszawie .	wojewódzkich	15	Loc
Później były aresztowania brzeskie i w listopadzie wybory parlamentarne w atmosferze terroru , które dały BBWR większość w nowym Sejmie .	parlamentarne	8	Nom
ale żal ci tamtych chwil tych intymnych ?	intymnych	6	Gen
Obok miasta umieszczono cmentarz żydowski z wyeksponowanym nagrobkiem do złudzenia przypominającym ohel Sonnenberga .	wyeksponowanym	6	Ins
Wybieram brązową .	brązową	1	Acc
Gdy na miejscu zjawili się policjanci z komisariatu kolejowego policji , schronisko znajdowało się w opłakanym stanie .	opłakanym	15	Loc
Daje on młodym ludziom szansę wykazania się umiejętnościami organizatorskimi .	organizatorskimi	8	Ins
Na dachu paliła się 81-letnia kobieta .	81-letnia	4	Nom
Panuję nad negatywnymi nastrojami .	negatywnymi	2	Ins
Z ogromną prędkością przejechały przez nie dwa samochody osobowe .	ogromną	1	Ins
Podczas zabawy dzieci znalazły pociski karabinowe .	karabinowe	5	Acc
Wróciła dwucyfrowa inflacja .	dwucyfrowa	1	Nom
Jej wnuczka , dziesięcioletnia Marta , chodziła do klasy z zamordowanym Łukaszem .	zamordowanym	10	Ins
Biblioteki kościelne zostały także obdarowane kolekcjami .	kościelne	1	Nom
Są to rurki szklane cylindryczne o zwężonym końcu .	cylindryczne	4	Nom
Sto gazet ukazuje się obecnie w przedsiębiorstwach przemysłowych i usługowych .	przemysłowych	7	Loc
Przygotowuje się również wystawę archeologiczną .	archeologiczną	4	Acc
Nie pamiętam tych dwóch córek niemieckiego majstra .	niemieckiego	5	Gen
Bandytów nie złapano .	złapano	2	Nom
Zerkała na czarno - biały obraz i pogryzała słone paluszki .	słone	8	Acc
Oprócz słuchania Steczkowskiej delegaci zajmowali się dyskusją o strajku generalnym .	generalnym	9	Loc
Pootwierało wiele zamkniętych dotąd drzwi .	zamkniętych	2	Gen
Banał wywoła krwawe powstanie ?	krwawe	2	Acc
Przedstawiamy dziś rasę niezwykle rzadką , niehodowaną w Polsce .	rzadką	4	Acc
Nad ranem cała trójka zostaje wyciągnięta ze swych domów i trafia do aresztu .	wyciągnięta	5	Nom
Przy wypełnianiu zeznania podatnik powinien się trzymać ustawy i rozporządzeń wykonawczych .	wykonawczych	10	Gen
Wezwana na miejsce żandarmeria wojskowa stwierdziła , że skrzynki , w których przechowywane były materiały wybuchowe , są puste .	Wezwana	0	Nom
Klasztor na Jasnej Górze przeżywa prawdziwe oblężenie .	Jasnej	2	Loc
- Propozycja prowadzi do niebezpiecznych napięć .	niebezpiecznych	4	Gen
Pierwsze trwałe osady założono dopiero w drugiej połowie XIX wieku .	XIX	8	Gen
Powodem był ulatniający się z nieszczelnej instalacji gaz .	nieszczelnej	5	Gen
- Minister Kulesza uważa , że nieprzeprowadzenie tej reformy spowoduje wyborczą porażkę .	wyborczą	10	Acc
- Mój ojciec pracuje w BRH , biurze radcy handlowego .	handlowego	9	Gen
Jest legendarnym przywódcą związkowym .	związkowym	3	Ins
Zgodnie z ustaleniami nie udzielił żadnych wywiadów ani nie wydał żadnego oświadczenia politycznego .	politycznego	12	Gen
W Pruszkowie gang zorganizowali wychowankowie słynnego w czasach PRL bandyty Barabasza .	słynnego	5	Gen
Przyleciał rejsowym samolotem .	rejsowym	1	Ins
- Przez niemiecką żeglugę śródlądową jakaś dzikuska nie będzie miała frajdy .	śródlądową	4	Acc
W Polsce przedwrześniowej mieli śmy jedynie 600 zelektryfikowanych wsi .	zelektryfikowanych	7	Gen
Rola UNPROFOR jest jednak niejasna .	niejasna	4	Nom
Weszli do lodowatej rzeki , by ratować zwierzaka .	lodowatej	2	Gen
Wszedł do wagonu , w przejściu natknął się na konduktora - służbistę , który zrobił mu wykład o niebezpieczeństwie związanym ze wskakiwaniem do pociągu w biegu .	związanym	19	Loc
Ale nie rozumiem , jak można w imię ekumenizmu wysuwać roszczenia do tworzenia w Europie stref monopolistycznych wpływów religijnych .	religijnych	18	Gen
Po letniej przerwie w najbliższą niedzielę wznowią rozgrywki pięściarze pierwszej i drugiej ligi bokserskiej .	najbliższą	4	Acc
Po kompromitującym czynie , logiczna jest likwidacja świadków , to typowy sposób postępowania wszystkich szanujących się gangsterów .	kompromitującym	1	Loc
Policja podejrzewa , że fałszerze byli niezadowoleni z ich jakości .	niezadowoleni	6	Nom
Funkcję tę pełnił przez 35 lat i wywarł ogromne piętno na prawodawstwie amerykańskim .	amerykańskim	12	Loc
A to pewnie był akurat chwyt zamierzony przez autora i głęboko uzasadniony .	zamierzony	6	Nom
Trzymający ją mężczyzna roześmiał się .	Trzymający	0	Nom
Środek był ocenzurowany .	ocenzurowany	2	Nom
Teraz policjanci z komisariatu na Dworcu Głównym PKP szukają poszkodowanych .	Głównym	6	Loc
Pobity kijem bejsbolowym mężczyzna trafił z licznymi obrażeniami do szpitala .	licznymi	6	Ins
Marchewki obrać i zetrzeć na tarce o dużych oczkach .	dużych	7	Loc
Z oficjalnym żądaniem wobec MKOl , złożonym na piśmie , wystąpił Narodowy Komitet Olimpijski KRLD , domagając się od naczelnej władzy sportowej rewizji listy triumfatorów olimpijskich .	sportowej	21	Gen
W sezonie letnim w 2005 r. utonęło 325 osób .	2005	4	Loc
– Płynie ogromny transport z demograficznym wyżem .	ogromny	2	Nom
Trzy lata temu rozstał się z górniczą spółką mieszkaniową w Nikiszowcu .	górniczą	6	Ins
Zasięg prac był dokładnie określony .	określony	4	Nom
Czternastoletni chłopiec cierpiał z powodu ciężkiej alergii wielonarządowej , której objawami były atopowe zapalenie skóry , astma oskrzelowa oraz całoroczny katar .	Czternastoletni	0	Nom
I jakie są skutki bezwzględnego wymogu potwierdzenia w korpusie ?	bezwzględnego	4	Gen
Potem ustosunkował się do tego , co wcześniej przekazali śmy w sprawach gospodarczych .	gospodarczych	12	Loc
Tym razem postawiono na casting także w mniejszych miastach .	mniejszych	7	Loc
Przyznam się , że nie pamiętam już tak chłodnego początku października .	chłodnego	8	Gen
Przez pierwszy tydzień leżą ukryte w wysokiej trawie , a następnie zaczynają wędrować za matką .	wysokiej	6	Loc
Ludzki układ immunologiczny stawał się wobec nich bezradny .	immunologiczny	2	Nom
W odpowiednim sklepie za 350 zł sprzedadzą każdemu .	odpowiednim	1	Loc
Powiększona kuchnia stała się obszernym pomieszczeniem mieszczącym duży stół .	mieszczącym	6	Ins
Odbędzie się on w Sali Kongresowej w Warszawie .	Kongresowej	5	Loc
Na poszczególnych lodowcach warunki lokalne modyfikują tę zależność .	poszczególnych	1	Loc
Wzbudza to niepokój inwestorów zagranicznych i krajowych , a także wyborców .	krajowych	6	Acc
Do akcji ratunkowej wezwano prawie wszystkich strażaków z zakopiańskiej Jednostki Ratowniczo - Gaśniczej .	ratunkowej	2	Gen
U podstaw takiego postępowania leżą poglądy mityczne , które muszą zniknąć z praktyki lekarskiej .	lekarskiej	13	Gen
Przygotowano też rozmaite zestawy upominkowe w estetycznych opakowaniach .	estetycznych	6	Loc
Wieczorem wymykają się z hoteliku , by spojrzeć na ulubioną maszynę i pocałować ją na dobranoc .	ulubioną	9	Acc
On jest bardzo ważnym partnerem .	ważnym	3	Ins
Radny Eugeniusz Morta chciał przed głosowaniem usłyszeć silne argumenty za wydaniem tak dużej kwoty .	silne	7	Acc
Rodzina i przyjaciele powitali w sobotę uwolnione przez rosyjskie służby specjalne Polki .	uwolnione	6	Acc
W ubiegłym roku udało się tę pozycję zmieścić w budżecie .	ubiegłym	1	Loc
Jeżeli nasz samochód to combi lub van , a zwierzak jest duży , możemy przewozić go w odpowiednio przygotowanym bagażniku .	przygotowanym	18	Loc
Wikipedia , nasz siostrzany projekt , zawiera artykuł na temat nawozów zielonych .	siostrzany	3	Nom
Że się szydzi z personelu naziemnego .	naziemnego	5	Gen
nawet karty gwarancyjnej nie mam . .	gwarancyjnej	2	Gen
Istnieje jeszcze jedna dieta , której skuteczność jest niedoceniana ze względu na jej kontrowersyjność .	niedoceniana	8	Nom
- Obrzuciła go karcącym spojrzeniem .	karcącym	3	Ins
W rozległej przestrzeni czyśćca spotyka po raz pierwszy Beatrycze .	rozległej	1	Loc
Zapowiada się kolejna bezsenna noc .	bezsenna	3	Nom
Nietschke myślał chwilę o samotnym , smutnym ptaku .	samotnym	4	Loc
Służy do tego oddzielne naczynko o chropowatym dnie , pozwalającym ptakowi w kąpieli pewnie stać na nóżkach .	pozwalającym	9	Loc
Słuszna jest uwaga o wyrwanej kartce z Gazety .	wyrwanej	4	Loc
Cały prawy błotnik wraz ze światłami został na haku .	Cały	0	Nom
W 1990 r . Smolański brał czynny udział w napaści na afrykańskich studentów manifestujących na wrocławskim rynku .	manifestujących	13	Acc
Konwój został zaatakowany w okolicach An Numaniyah w prowincji Wasit .	zaatakowany	2	Nom
Położono na niej nową nawierzchnię asfaltową .	asfaltową	5	Acc
Dzisiaj lubi organizować spotkania poetyckie swoim przyjaciołom i znajomym .	poetyckie	4	Acc
Wtorkowa nominacja wywołała gwałtowne protesty całej opozycji .	gwałtowne	3	Acc
Poza tym powinna być bardziej dostępna dla zainteresowanych osób , które zechcą przechować w nim ważne osobiste dokumenty .	osobiste	16	Acc
Zbieranie dzieł twórców nieprofesjonalnych zapewnia światowy prestiż i międzynarodowe przyjaźnie .	międzynarodowe	8	Acc
Przymknął oczy i trwał w zadumie nie słysząc nawet roztrzepanej gadaniny niezliczonych wróbli .	niezliczonych	11	Gen
Nie wiadomo , ile głowic zostało już wywiezionych do Rosji .	wywiezionych	7	Gen
Gdy we wspomnianych dwu pionach narożnikowych ktoś się kąpie , wówczas woda spływa w dół nawilgacając po drodze niżej położone mieszkania .	położone	19	Acc
Nerwowy kupiec odruchowo wcisnął mu sakiewkę do ręki .	Nerwowy	0	Nom
Dzięki temu przekonano się , że galaktyki aktywne nie tworzą jednolitej grupy , ale mają dość zróżnicowane własności .	przekonano	2	Nom
Miejsca rozgrywania spotkań zostały ustalone w drodze losowania w siedzibie Polskiego Związku Tenisa Stołowego w Warszawie .	Stołowego	13	Gen
W ubiegłym roku udało się tę pozycję zmieścić w budżecie .	ubiegłym	1	Loc
Najchętniej jada golonkę z piwem i staropolskiego schabowego z kostką .	staropolskiego	6	Acc
W samym tylko województwie lubelskim co najmniej kilka tysięcy z nich będzie podczas wakacji dorabiać .	lubelskim	4	Loc
Nie często zdarza się uczestniczyć w wydarzeniu artystycznym , a takim na pewno był koncert u Chrystusa Króla .	artystycznym	7	Loc
Czarodziejka usiadła , wracając do przerwanej czynności .	przerwanej	5	Gen
Po dziesięciu rozegranych kolejkach MG MZKS ma zaledwie dwa punkty .	rozegranych	2	Loc
Ale tego rodzaju zabiegi mogą być wykonywane tylko przez specjalnie przeszkolone ekipy zwalczania szkodników .	przeszkolone	10	Acc
Beata nigdy nie zobaczyła swojego wydrukowanego Aniołka .	wydrukowanego	5	Gen
Spojrzał des Noyers na zegar gdański , stojący w rogu komnaty .	gdański	5	Acc
Wraz z kolejnymi minutami potrawa zmieniała się z płynnej w coraz bardziej stałą .	płynnej	8	Gen
U nas takie imprezy są zupełną nowością , ale na Zachodzie to bardzo popularna dyscyplina .	zupełną	5	Ins
Język telenowel jest ujednolicony , mało barwny , ogólnopolski .	ujednolicony	3	Nom
Z głębin morza dalekich a z bełku przepadłego powrócił , żeby u stopy braterskiej jasne czoło położyć .	przepadłego	7	Gen
Nieznani sprawcy ostrzelali jego samochód zaparkowany przed sklepem .	Nieznani	0	Nom
I doczekać z antykaczyńskim rządem do jesiennych wyborów .	antykaczyńskim	3	Ins
Rozmawiając , zboczyli na polną drogę .	polną	4	Acc
Później łupy pojawiały się na krakowskiej giełdzie elektronicznej .	elektronicznej	7	Loc
Michnik jest czwartym laureatem ustanowionej w 1996 r . nagrody .	czwartym	2	Ins
Płonącą Warszawę widać było z dużej odległości .	Płonącą	0	Acc
Niebo zasnuło się ołowianymi chmurami .	ołowianymi	3	Ins
Jadwiga Melnyk przeszła w człuchowskim szpitalu dwa zabiegi .	człuchowskim	4	Loc
Niedobrze dzieje się na rynku rolnym .	rolnym	5	Loc
- Ma tylko jedną .	jedną	3	Acc
Na wczasy jeżdżą osoby nietrendowe .	nietrendowe	4	Nom
Nastroszony w telewizorze Biernacki jest równie zabawny jak nastroszony Buzek .	Nastroszony	0	Nom
W innych miejscach znaleziono wyszlifowane i porysowane przedkarbońskie skały podłoża .	porysowane	6	Acc
Uważano , że są one w dużym stopniu dziedziczne .	dużym	6	Loc
Co w takim razie robić z takimi nadliczbowymi zarodkami ?	nadliczbowymi	7	Ins
Szybkie obniżanie się tego ciężaru następuje zwykle w późniejszych stadiach rozwojowych i działalności metabolicznej grzybów .	późniejszych	8	Loc
Były one niezwykle rzadkie , nadające świątyni szczególne miejsce wśród wszystkich miejsc kultu na Pomorzu Gdańskim .	szczególne	7	Acc
Z połamanymi kończynami i uszkodzonym kręgosłupem przestępca trafił do szpitala .	połamanymi	1	Ins
43-letni młodszy brygadier dmuchnął w alkomat .	43-letni	0	Nom
Leczenie ataków padaczkowych polega na podawaniu leków przerywających drgawki niezależnie od ich przyczyny .	padaczkowych	2	Gen
Jadźka z miną dumną przechodzi .	dumną	3	Ins
Prowadźcie mnie do głównego .	głównego	3	Gen
Pierwszy cios , który później okazał się śmiertelny , został zadany metalowym krzesłem w tył głowy .	śmiertelny	7	Nom
Akcja zostanie wznowiona we wtorek rano .	wznowiona	2	Nom
Budynek będzie miał elewację w tonacji pistacjowo - kremowej .	kremowej	8	Loc
Stracił cały swój początkowy tupet .	początkowy	3	Acc
Projekt przewiduje postawienie 7-kondygnacyjnego biurowca z dwupoziomowym garażem podziemnym na 450 samochodów oraz częścią handlową i usługową .	handlową	14	Ins
W ten sposób zaaprobowane zostało wstępne porozumienie , osiągnięte w ubiegłym roku przez ministrów zdrowia Piętnastki .	osiągnięte	8	Nom
Pociski są przerdzewiałe i posiadają zapalniki .	przerdzewiałe	2	Nom
Manifestanci próbowali uniemożliwić policji zamykanie biur zdelegalizowanego ugrupowania .	zdelegalizowanego	6	Gen
Położyli na drabiniastym wozie .	drabiniastym	2	Loc
Upragnioną miłość zanurzył eś w najpodlejszym , cuchnącym bagnie .	najpodlejszym	5	Loc
W I lidze piłkarskiej rozpoczyna się runda wiosenna .	piłkarskiej	3	Loc
W piątek od rana w naszym mieście spotka się na plenarnym posiedzeniu Episkopat Polski .	plenarnym	10	Loc
Posługując się nim z szermierczą precyzją i taneczną lekkością , można grać na barwnych strunach duszy .	taneczną	7	Ins
Jadący motorem 22-letni mężczyzna na łuku drogi stracił panowanie nad pojazdem i uderzył w betonowe ogrodzenie .	betonowe	14	Acc
Ukryty za maćkowymi plecami Łagiewka przytaknął .	maćkowymi	2	Ins
Jeńcy wojenni listy piszą . . .	wojenni	1	Nom
Załogi z niepokojem śledzą ciche chmury nadchodzące z południa .	ciche	4	Acc
Jednocześnie zmienia się jego skład chemiczny i ubytek ciężaru właściwego .	chemiczny	5	Nom
Kto odpowiada za szkody wyrządzone w lesie przez zwierzynę ?	wyrządzone	4	Acc
Osiedla się w Kafarnaum nad jeziorem i zaczyna swoją publiczną działalność .	publiczną	9	Acc
Konsjerżka , jak większość konsjerżek Portugalka , szorowała chodnik i mury ryżową szczotką .	ryżową	11	Ins
W czasach elektronicznych rozmyła się wartość mozolnie zapisywanych karteczek i pedantycznie prowadzonych kartotek .	elektronicznych	2	Loc
Felek jakiś niepewny siedzi na linach i przeciera oczy .	niepewny	2	Nom
Pani Czapkowa zaścieliła stół świeżą ceratą , podała kotlety z dzika , a po obiedzie odbyło się sympozjum .	świeżą	4	Ins
Na dłuższą metę okazało się to wszakże rzeczą niemożliwą .	niemożliwą	8	Ins
Z zaskoczeniem przeglądali śmy witrynę internetową Stołecznego Zakładu Energetycznego .	internetową	5	Acc
Sławny pianista utracił dłonie w wypadku , ale przeszczepiono mu ręce straconego mordercy .	Sławny	0	Nom
W Technikum Mechanicznym wszystkie osoby zaliczyły pierwszy etap .	Mechanicznym	2	Loc
Śpiewającą męską siódemką dyryguje na estradzie po mistrzowsku Charles Bailly .	Śpiewającą	0	Ins
Co to wszystko obchodzi polskich klientów firm ubezpieczeniowych ?	ubezpieczeniowych	7	Gen
Żeby opłacić dziennikarza , przeciętne warszawskie osiedle musiało by się złożyć po 10 groszy .	przeciętne	4	Nom
W programie obchodów przewidziano spotkanie uczestników ówczesnych wydarzeń , wystawę fotograficzną i sesję naukową .	fotograficzną	10	Acc
Aminokwasy zawierające siarkę są niezbędne dla prawidłowej syntezy keratyny , która jest podstawowym składnikiem włosów i paznokci .	niezbędne	4	Nom
Dorożki i kabriolety turkotały po wyboistym bruku .	wyboistym	5	Loc
Seniorska reprezentacja Polski zbliża się do zgrupowania we Wronkach .	Seniorska	0	Nom
Cały nakład rozszedł się błyskawicznie .	Cały	0	Nom
Amerykanie patrząc zza Oceanu na Europę myślą niemal wyłącznie kategoriami strategicznymi i gospodarczymi .	strategicznymi	10	Ins
Wiedziała ruda dziewczynka z warkoczykami i piegowatym noskiem .	piegowatym	6	Ins
A przynajmniej choćby na jakiś czas powstrzymać zalewający kraj rewolucyjny potop .	rewolucyjny	9	Acc
Znaleziono ich w opuszczonym domu z dowodami winy .	opuszczonym	3	Loc
lekko młotkiem gumowym chlapnąć .	gumowym	2	Ins
Sterowali ruchem w pobliżu cmentarzy , kontrolowali trzeźwość kierowców poruszających się drogami województwa .	poruszających	9	Gen
Nikt się nie lituje , nie pieści z przyjeżdżającymi na zarobek .	przyjeżdżającymi	8	Ins
Jedziemy do Havru , ten stary kozioł płaci .	stary	5	Nom
Doświadczenia z dzieciństwa spędzonego w rodzinie alkoholowej u wielu mężczyzn i kobiet owocują w dorosłym życiu utrwalonymi schematami odczuwania , zachowania i myślenia .	utrwalonymi	16	Ins
- Czy świadomie wybrała pani rzeźbę , przecież to taki niekobiecy zawód ?	niekobiecy	10	Nom
Jest legendarnym przywódcą związkowym .	legendarnym	1	Ins
Jak ta Mirta miała wszystko uporządkowane i przemyślane !	przemyślane	7	Acc
Le Pen straszy zjednoczoną Europą .	zjednoczoną	3	Ins
Kryteria do odstrzału selekcyjnego są zróżnicowane w zależności od rejonu siedliska .	selekcyjnego	3	Gen
Obu szwedzkim dyplomatom zarzucono też działalność wykraczającą poza ich oficjalny status .	wykraczającą	6	Acc
Młodszy , w okularach , był wysoki i miał jaśniejszą skórę .	jaśniejszą	9	Acc
Odczuła m dokuczliwą zazdrość .	dokuczliwą	2	Acc
Listę tę prezydent Stanów Zjednoczonych przekazał w poniedziałek innym państwom .	Zjednoczonych	4	Gen
W oddzielnych grupach ćwiczą panie i panowie , później znów spotykają się i odbywają wspólnie zajęcia choreograficzno - taneczne .	oddzielnych	1	Loc
Na koniec kokieteryjnie usprawiedliwiła się , że mówi bez ładu i składu , bo jest już w zaawansowanym wieku .	zaawansowanym	17	Loc
Kartka zaadresowana do mnie czekała w Teatrze Powszechnym .	Powszechnym	7	Loc
Nad pozostałymi obszarami dominują układy wyżowe .	pozostałymi	1	Ins
Piotr Aniołkiewicz i Paweł Sulikowski zginęli w 1997 r. koło Komorowa .	1997	7	Loc
Dla światowych producentów odzieży Polska staje się coraz ważniejszym rynkiem zbytu .	ważniejszym	8	Ins
Brytyjczycy są więc dominującym udziałowcem w największym polskim towarzystwie emerytalnym .	emerytalnym	9	Loc
Czyżby teraz przepuściła okazję , mając tuż obok przystojnego młodego mężczyznę ?	młodego	9	Acc
- Mówiła ś mi wtedy o starej legendzie waszego kraju .	starej	6	Loc
Shimada wyznaczył więc ludzi i za chwilę wnętrze góry poczęło błyskać upiornym światłem palników i ożywiło się znów koszmarną krzątaniną .	upiornym	11	Ins
W ręce izraelskich żołnierzy dostali się palestyńscy politycy związani z Hamasem .	palestyńscy	6	Nom
Niedziela Palmowa na Kociewiu różniła się zresztą od obchodów w innych częściach Polski .	Palmowa	1	Nom
Z nowym rokiem weszło w życie nowe prawo dewizowe .	dewizowe	8	Nom
W zaborze rosyjskim po śmierci Aleksandra II , który zginął w zamachu terrorystycznym , nastąpiło gwałtowne zaostrzenie polityki represyjnej we wszystkich dziedzinach życia publicznego .	terrorystycznym	12	Loc
Mądrzej byłoby ominąć go szerokim łukiem .	szerokim	4	Ins
Dla zdobywców pięciu pierwszych miejsc przewidziano regulaminowe nagrody .	przewidziano	5	Nom
Minęli jakąś suterenę z maleńkimi okienkami .	maleńkimi	4	Ins
Zrealizował go Polak , wykorzystując literaturę rosyjską i japońskich wykonawców .	rosyjską	6	Acc
Dziewczyny mówią , że piszczała , płakała , śmiała się , przykucnęła , usiłując uspokoić drżące od wysiłku mięśnie i wtedy rzuciły się na nią . . .	drżące	15	Acc
W 1935 roku brytyjski informatyk Alan Mathison Turing wymyślił abstrakcyjną maszynę .	1935	1	Loc
Z tak zlokalizowanym wrogiem łatwiej walczyć . . .	zlokalizowanym	2	Ins
Powiększona kuchnia stała się obszernym pomieszczeniem mieszczącym duży stół .	Powiększona	0	Nom
Symbolizują zmienną fortunę i uzasadniają nawoływania do stoickiego znoszenia dopustów losu albo chrześcijańskiej ufności w Bogu .	chrześcijańskiej	12	Gen
Mimo tak dużych możliwości EMG , czasem nie udaje się na jej podstawie postawić trafnej diagnozy .	dużych	2	Gen
Z przykrością stwierdzam , że zawiera on nieprawdziwe informacje .	nieprawdziwe	7	Acc
Laboratorium badań serologicznych pozostało w gestii leszczyńskiego szpitala .	serologicznych	2	Gen
- Z tego punktu widzenia kryzys może być pożytecznym ograniczeniem .	pożytecznym	8	Ins
Jeszcze przed obcięciem uposażeń , krakowscy rajcy planowali wydać taką właśnie sumę na remont trzech komisariatów oraz zakup 9 samochodów dla policji i 4 dla straży miejskiej .	miejskiej	26	Gen
VIII Zjazd Inżynierów Mechaników Polskich obradował w Katowicach pod hasłem zbiorowego wysiłku myśli i pracy nad aktualnymi zagadnieniami technicznymi , mającego na celu rozwój techniki polskiej .	technicznymi	18	Ins
Brakuje również sportowego sukcesu , zgodnego z oczekiwaniami kibiców i sympatyków Klubu .	zgodnego	5	Gen
Kiedyś poziom był dużo większy .	większy	4	Nom
Wtem na leśnej drodze pojawia się granatowa lancia .	leśnej	2	Loc
Tragiczny wypadek zdarzył się na trasie kolejowej z Piły do Chojnic .	Tragiczny	0	Nom
- Szósty rok prowadzę kadrę .	Szósty	1	Acc
Kto wie , czy najwięcej nie przyczyniła się do mojego wybawienia długotrwała burza .	długotrwała	11	Nom
Sporządzono także portrety pamięciowe napastników .	pamięciowe	3	Acc
Potem odwiedził kiełpiński cmentarz .	kiełpiński	2	Acc
Ona poprzez lasy przerąbała pierwszą drogę dla cichego apostolstwa synów bożych .	cichego	7	Gen
Zmęczeni wysiadali śmy z ciasnej szoferki .	ciasnej	4	Gen
Patrzy , a tu we włosach łonowych roi się od weszek .	łonowych	6	Loc
Dzięki cyfrowej telewizji satelitarnej istnieje też możliwość połączenia z Internetem czy udziału w kursach przygotowujących do matury albo egzaminu na studia .	przygotowujących	14	Loc
Wyjaśnia on w przystępny sposób tajniki stosowanych w programie konwencji .	przystępny	3	Acc
Upragnioną miłość zanurzyłeś w najpodlejszym , cuchnącym bagnie .	Upragnioną	0	Acc
Sprawy budżetowe zajmą więc zapewne sporo czasu na czwartkowej sesji .	czwartkowej	8	Loc
Po 1956 r . dekret o wysiedleniach został anulowany .	1956	1	Loc
Ostatnio przebiła się lewa górna 2 !	górna	4	Nom
Uchwała rady powinna być podjęta w ciągu miesiąca od dnia doręczenia wniosku Naczelnej Rady Aptekarskiej .	Naczelnej	12	Gen
Podobnie jak we współczesnej Japonii , również w Tybecie żywe są dawne herbaciane tradycje , chociaż przyczyny ich kultywowania są zgoła odmienne .	współczesnej	3	Loc
Jeżeli rząd chce wprowadzać swoje reformatorskie projekty , musi porozumiewać się z prezydentem .	reformatorskie	5	Acc
Samo pojęcie wywodzi się ze średniowiecznej filozofii .	średniowiecznej	5	Gen
Takie stanowisko może się jednak słusznie wydawać nazbyt łatwą dymisją rozumu .	łatwą	8	Ins
Msza żałobna odbyła się pod gołym niebem .	gołym	5	Ins
Ważnym elementem samowychowującym jest nauka szkolna .	samowychowującym	2	Ins
- Fokusy są ważnym elementem planowania kampanii reklamowych .	reklamowych	7	Gen
Równocześnie , zdecydowana większość uważa , że w Polsce tylko nieliczni mogą się wzbogacić .	zdecydowana	2	Nom
- Ludzie starsi gubią się w technicznych problemach z tym związanych , a takie ciągłe zabawy ze zmianą pasma nadawania to brak szacunku dla abonentów .	związanych	10	Loc
– Joanna z lekkim wyrzutem spojrzała na młodą koleżankę .	lekkim	3	Ins
Może jakoś dogada się jeszcze z tym głupim bydlakiem .	głupim	7	Ins
Udzielenie bowiem pracownikowi urlopu bezpłatnego nie oznacza rozwiązania umowy o pracę z danym zakładem .	bezpłatnego	4	Gen
Po południu kościelna procesja wyrusza w drogę po bajecznie kolorowym kwietnym dywanie .	kwietnym	10	Loc
By wdrożyć projektowany przez rząd nowy system taniego budownictwa mieszkaniowego , konieczne jest szybkie wyszkolenie kadr .	mieszkaniowego	9	Gen
Ojciec ofiary uważa , że w sprawę zamieszani są policjanci i dlatego śledztwo prowadzone było tak niemrawo .	zamieszani	7	Nom
Sprawy zasadnicze to niemiecka marka i Europa .	zasadnicze	1	Nom
Inne są jakby mniej zaangażowane .	zaangażowane	4	Nom
Jednocześnie prezydent Egiptu Hosni Mubarak ogłosił , że jest możliwy kompromis .	możliwy	9	Nom
Poza wymienionymi , charakterystycznymi rodzajami przebiegu akumulacji w ciągu roku stwierdza się ich modyfikacje lub rodzaje pośrednie .	charakterystycznymi	3	Ins
Zapewne dla wielu kobiet słowa Jana Pawła II są ważne i zbawienne , ale słowa nie wystarczą .	zbawienne	11	Nom
Wyszedłem na spacer z nietresowalnym bassetem .	nietresowalnym	4	Ins
Pierwsze trwałe osady założono dopiero w drugiej połowie XIX wieku .	trwałe	1	Acc
Łódź odnaleziono porzuconą i ogołoconą z silnika i kosztownego wyposażenia .	ogołoconą	4	Acc
W różnych krajach Europy Joint zachęcał do tworzenia miejscowych organizacji , zdolnych do samodzielnej pracy z sierotami .	zdolnych	11	Gen
- Nie zdarza się , aby przedmiotu wykładanego w gimnazjum nie było w jego oddziale zamiejscowym .	wykładanego	7	Gen
Nie wystarczy już sam preparat o działaniu nawilżającym .	nawilżającym	7	Loc
Na tym wyczerpaliśmy porządek dzienny 113 . posiedzenia Sejmu .	dzienny	4	Acc
Oceniając strajk , Gawin oświadczył , że ruch towarowy praktycznie się nie odbywał , a na Śląsku stanęło wiele pociągów pasażerskich .	pasażerskich	20	Gen
W półfinałach rozegrano mecze systemem pucharowym , a zwycięzcy awansowali do finałów .	pucharowym	5	Ins
Tym głównie Stronnictwo będzie się różniło od większości europejskich partii chadeckich , w których liberalizm gospodarczy miesza się z ideami socjaldemokratycznymi i nauką społeczną Kościoła .	społeczną	23	Ins
Masz strasznie zimną rękę .	zimną	2	Acc
Omawiana książka jeszcze raz to potwierdza .	Omawiana	0	Nom
Ta masa wodna , nieraz podnosząca poziom Wiku o jeden metr ponad równię Puckiej Zatoki , spotyka się przy dziobie gołębia z silnym prądem zachodnim .	silnym	22	Ins
W czasie pozorowanych działań bojowych jednostki z pozycji obronnych dokonają przegrupowania , aby po sforsowaniu szerokiej przeszkody wodnej wyjść na nowe rubieże aktywnych działań zaczepnych .	wodnej	17	Gen
Dlaczego ugrupowanie , które będzie rozliczane przez wyborców z efektów rządzenia , ma sobie utrudniać pracę ?	rozliczane	5	Nom
PQBoot to narzędzie do zmiany partycji bootującej dla tych użytkowników , którzy tylko od czasu do czasu potrzebują skorzystać z innego systemu .	bootującej	6	Gen
Z tak zlokalizowanym wrogiem łatwiej walczyć . . .	zlokalizowanym	2	Ins
Grupa powstała we wczesnych latach 80 .	wczesnych	3	Loc
Prowadzimy wszelkie prace remontowe .	remontowe	3	Acc
Wiele zarzutów ma powierzchowny charakter .	powierzchowny	3	Acc
Oprócz absolwentów przybyli także dawni dyrektorzy i nauczyciele Nowodworka .	dawni	4	Nom
W tym roku o tytuł najlepszej walczyło 160 pism .	najlepszej	5	Gen
Komputerowy montaż grafiki nie jest domeną zastrzeżoną wyłącznie dla profesjonalistów .	zastrzeżoną	6	Ins
Reagował jak ideowy socjalista .	ideowy	2	Nom
Będzie musiał kupić na bazarze jakieś najprawdziwsze świadectwo maturalne .	najprawdziwsze	6	Acc
Obaj uznali je za wspaniałą lekcję historii .	wspaniałą	4	Acc
Cóż znaczyło ośmiu ludzi wobec zbrojnych i groźnych tysięcy ?	groźnych	7	Gen
Cmentarz przecina już kilka alejek z kostki betonowej .	betonowej	7	Gen
Posłużono się amerykańską zastawką doktora Starra .	amerykańską	2	Ins
Stan czterech z 15 uratowanych pasażerów jest krytyczny .	uratowanych	4	Gen
Ale jak zinterpretować pojawienie się kolędników w finałowej scenie , kiedy rozjadą się już Konrad i ksiądz Piotr ?	finałowej	7	Loc
Przegląd najistotniejszych badań alokacji podatku dochodowego zamieszczono w następnym punkcie niniejszego rozdziału .	najistotniejszych	1	Gen
W sobotnią noc na parkingu dyskoteki w Nowych Bielicach uszkodzono dwa samochody .	Nowych	7	Loc
Kierowca , 29-letni Daniel Marciniak , odbiera telefon .	29-letni	2	Nom
Znał dobrze urzędników gminnych i ich nieskończoną flegmę oraz absolutny brak poszanowania dla czasu bliźnich .	absolutny	9	Acc
Jest wesolutki , chętny do spędzania czasu przy kolacji .	wesolutki	1	Nom
Wśród 65-tysięcznej publiczności oglądającej uroczyste otwarcie igrzysk będzie 40 najwyższych dostojników różnych państw .	65-tysięcznej	1	Gen
Chłopiec przebywa w greckim przytułku prowadzonym przez organizację o złej reputacji .	prowadzonym	5	Loc
– Masz takie męskie dłonie , January .	męskie	3	Acc
Interesanci spojrzeli we wskazanym kierunku i oniemieli z radości .	wskazanym	3	Loc
Przed obecnymi na spotkaniu wystąpili dzisiejsi uczniowie szkoły .	obecnymi	1	Ins
Badania wielkości sił naciągu strun na torze przeprowadzono przez bezpośredni pomiar sił w poszczególnych strunach za pomocą przyrządu VOGT .	bezpośredni	9	Acc
Jestem przekonany , że grzechem jest oglądać ten film i trzeba się z tego spowiadać .	przekonany	1	Nom
Licznie przybyła publiczność zajęła miejsca przy stołach biesiadnych , na obszernym trawniku lub obok sceny .	biesiadnych	7	Loc
W pierwszej kolejności będzie służyła ponad 400 uczniom szkoły podstawowej i gimnazjum .	podstawowej	9	Gen
W Typinie , małej wiosce pod Tomaszowem Lubelskim , wrze .	Lubelskim	7	Ins
Stary wiadukt przy ulicy Oświęcimskiej stanowił ogromną uciążliwość dla kierowców .	Oświęcimskiej	4	Loc
Kochają go za tę doskonałą bezinteresowność .	doskonałą	4	Acc
Udzielając poparcia świętej wojnie , mogli poprawić swoją nadszarpniętą reputację .	nadszarpniętą	8	Acc
Ale najgorszy moment tego czystego szaleństwa i paskudnego zachowania Angusa miał dopiero nastąpić .	paskudnego	7	Gen
Na koniec wyniki podliczono by w blasku jupiterów na wielkiej konwencji ogólnopolskiej .	wielkiej	9	Loc
Podpułkownik Krabel zarządził strzelanie na garnizonowej strzelnicy .	garnizonowej	5	Loc
Piękno w przyrodzie wydaje się ewolucyjnym luksusem .	ewolucyjnym	5	Ins
Świat jest wtedy znacznie ciekawszy . . .	ciekawszy	4	Nom
Inną bili kamieniem po twarzy .	Inną	0	Acc
Stanowczo odradza się naśladowanie ich przez turystów , ponieważ dla człowieka wejście na leżący na zboczu płat śniegu kończy się tragicznie .	leżący	13	Acc
Przekonywał , że Wielkopolska jest przygotowana do skorzystania z unijnej oferty .	przygotowana	5	Nom
W związku małżeńskim trwają do dziś .	małżeńskim	2	Loc
Niezależnie od przedstawionych wyników , kontrolę przeprowadzą jeszcze policjanci z Komendy Wojewódzkiej Policji w Katowicach .	przedstawionych	2	Gen
Zamki przemycała kobieta handlująca na bazarze Różyckiego w Warszawie .	handlująca	3	Nom
I tą karminową kredką nakreśliła trzeci werset , pod tamtymi .	karminową	2	Ins
Fenometys wciąż kręcił głową , światło lamp odbijało się na bezwłosej skórze idealnymi refleksami .	bezwłosej	10	Loc
Parafianie wysłali skargę do biskupa koszalińskiego Kazimierza Nycza .	koszalińskiego	5	Gen
Podróżujący pierwszą klasą będą odtąd mogli wypoczywać podczas lotu na rozkładanych podwójnych siedzeniach .	podwójnych	11	Loc
Pontyfikat Piusa XII trwał 7152 dni .	XII	2	Gen
Stary wiadukt przy ulicy Oświęcimskiej stanowił ogromną uciążliwość dla kierowców .	ogromną	6	Acc
- Zakłady i instytucje państwowe działają na podstawie decyzji urzędniczych .	urzędniczych	9	Gen
Zwracajmy szczególną uwagę na bezpieczeństwo dzieci .	szczególną	1	Acc
Postawił em samochód na podziemnym parkingu pod hotelem i wszedł em do windy .	podziemnym	4	Loc
W czwartkowe popołudnie gasili płonący śmietnik przy ul. Brodzińskiego w Proszowicach .	czwartkowe	1	Acc
Tym głównie Stronnictwo będzie się różniło od większości europejskich partii chadeckich , w których liberalizm gospodarczy miesza się z ideami socjaldemokratycznymi i nauką społeczną Kościoła .	socjaldemokratycznymi	20	Ins
Nie mają oni atrakcyjnej oferty dla ludzi XXI wieku , więc boją się konkurencji katolicyzmu .	atrakcyjnej	3	Gen
Tak jak w ubiegłym roku może nie starczyć pieniędzy na grudniowe pensje dla nauczycieli .	grudniowe	10	Acc
Obok miasta umieszczono cmentarz żydowski z wyeksponowanym nagrobkiem do złudzenia przypominającym ohel Sonnenberga .	przypominającym	10	Ins
W 1905 roku Karl Braun zbudował detektor kryształkowy .	1905	1	Loc
W niżej położonych Puławach przekroczyła stan ostrzegawczy o 30 cm .	położonych	2	Loc
Władze hiszpańskie działały niezwykle szybko .	hiszpańskie	1	Nom
Skończyłem już na dzisiaj działalność ostatnich dwóch tygodni , teraz będę miał trochę luzu , ale będę gdzieś tak między jedenastą , a czwartą .	jedenastą	20	Ins
Wanna nie nasunęła mi żadnych skojarzeń , była normalną wanną .	normalną	8	Ins
Ewakuowano 200 gości hotelowych .	hotelowych	3	Gen
Przypuśćmy , że stoi ono w związku z postępującą chorobą .	postępującą	8	Ins
Most w Kuligach na rzece Jegrzni znajduje się w fatalnym stanie i grozi zawaleniem .	fatalnym	9	Loc
Poza Centralną Komisją Wyborczą głosy liczy także LADO .	Wyborczą	3	Ins
Czy czujesz się samodzielnym człowiekiem ?	samodzielnym	3	Ins
Kwaśniewski znów okaże się sympatycznym facetem .	sympatycznym	4	Ins
Projekt przewiduje postawienie 7-kondygnacyjnego biurowca z dwupoziomowym garażem podziemnym na 450 samochodów oraz częścią handlową i usługową .	dwupoziomowym	6	Ins
Tymczasem w liceach prowadzonych przez Społeczne Towarzystwo Oświatowe zdanie egzaminu dojrzałości nie należy do najłatwiejszych .	prowadzonych	3	Loc
Tak przynajmniej wynika z zachowanych dokumentów i relacji .	zachowanych	4	Gen
Wziął em lodowaty prysznic , po śniadaniu wyłączył em telefony i w ciszy gabinetu nastawił em w pamięci taśmę mojego życia .	lodowaty	2	Acc
Takie było zapotrzebowanie , ale bardziej lubię żarty sytuacyjne i abstrakcyjne .	sytuacyjne	8	Acc
Jest to duży wysiłek , jednak nauka szkolna jest zasadniczym czynnikiem samowychowawczym .	szkolna	7	Nom
Niezwyciężony lęk przed dziwem w każdym momencie serca przychodniów przeszywał .	Niezwyciężony	0	Nom
PiS idzie do wyborów pod własnym szyldem .	własnym	5	Ins
Brazylijczyk , dwukrotny zwycięzca wielkoszlemowego Roland Garros , podkreślał przed spotkaniem , że najważniejszym elementem piątkowej potyczki będzie skuteczna gra przy własnym serwisie .	najważniejszym	13	Ins
Jednak tym razem do zwycięstwa wiodła nie umiejętność fechtunku , lecz znajomość spraw strażackich .	strażackich	13	Gen
- Normalnych klientów mi odstraszyli .	Normalnych	1	Acc
Wpadł na warszawskim Bemowie .	warszawskim	2	Loc
Nagrody przyznała specjalna Kapituła , pragnąc uhonorować osoby i instytucje , których działalność wniosła znaczący wkład w krzewienie tolerancji .	znaczący	14	Acc
Władze miasta zapewniają , że remont kapitalny torowiska na ulicy Pomorskiej rozpocznie się w pierwszej połowie bieżącego roku .	Pomorskiej	10	Loc
W tym roku inkasenci Zakładu Gazowniczego w Białymstoku będą wystawiać rachunki za gaz w blokach co trzy miesiące .	Gazowniczego	5	Gen
Tu też przyrządzał wspaniałe słodkości .	wspaniałe	3	Acc
Od XVIII w. Serbowie już nie byli tam absolutną większością .	absolutną	8	Ins
Na przykład z Australią łączył em się na dwudziestoletnim radiu mojego ojca .	dwudziestoletnim	8	Loc
Koło urządziło również podczas wakacji obóz wędrowny po Pomorzu .	wędrowny	6	Acc
Tematem tegorocznego Forum była fotografia otworkowa .	otworkowa	5	Nom
W Kcyni odbyło się spotkanie z kandydatami na kierowników na samodzielny publiczny zakład opieki zdrowotnej w Kcyni i Kowalewku .	samodzielny	10	Acc
Tragiczny wypadek zdarzył się na trasie kolejowej z Piły do Chojnic .	kolejowej	6	Loc
Sanki pomknęły po ubitym śniegu na Pohulankę .	ubitym	3	Loc
Nigdy nie starał się być odważnym .	odważnym	5	Ins
Różnymi technikami były również nanoszone poszczególne rysunki .	Różnymi	0	Ins
Nie pamiętam szczegółów , ale coś podobnego już zaszło .	podobnego	6	Gen
Udało się dopiero wtedy , gdy zorientowałem się , co jest grane .	grane	11	Nom
- Tomek był pogodnym , uśmiechniętym dzieckiem .	uśmiechniętym	5	Ins
Oddając zużyte elektrolity , które tam będą regenerowane , napełnimy zbiorniki nowymi roztworami .	nowymi	11	Ins
Istotnie , w damskim pokoju aż syczało .	damskim	3	Loc
Zwierzętarnia , wciśnięta między gmach zakładu doświadczalnego a kotłownię , stanowiła całe odrębne królestwo .	wciśnięta	2	Nom
Sklepy były pozamykane .	pozamykane	2	Nom
Następnym razem przyprowadzą kolegów i pomalutku piękny sport narciarski zainteresuje bardziej młodzież naszego miasta .	Następnym	0	Ins
Do dziś dziękuję Bogu , że trafiłem na takich porządnych ludzi , którzy dali nam dach nad głową i przysłowiowy talerz zupy .	przysłowiowy	19	Acc
Zażarta walka trwała kilkadziesiąt minut .	Zażarta	0	Nom
- Prowadzi edukację humanitarną , pomaga uchodźcom , powodzianom .	humanitarną	3	Acc
Katecheta zwięźle opowiedział o swych niedomaganiach i wtrącił słówko o kosztownej kuracji w Karlsbadzie .	kosztownej	10	Loc
Republika to sposób harmonijnego ułożenia życia społecznego i organizowania go według pewnych zasad .	harmonijnego	3	Gen
Takie parlamentarne metody nie odpowiadają mi , rozumiecie ?	parlamentarne	1	Nom
Wszyscy mieli przypięte kolorowe identyfikatory Orkiestry oraz specjalne puszki .	kolorowe	3	Acc
Niedobory pozostałych składników , które biorą aktywny udział w przemianie białkowej , mogą powodować schorzenia włosów i paznokci .	białkowej	10	Loc
Albo ubić faceta z wiecznie zadartym ornamencikiem w rozporku .	zadartym	5	Ins
W wysokiej trawie leżały setki stygnących ludzkich ciał .	wysokiej	1	Loc
Pan Korzeniowski zerwał się z krzesła , podbiegł do szafy , wysunął dolną szufladę , chwilę grzebał w papierzyskach .	dolną	12	Acc
Dymek w tym czasie ekspanderem przymocował otwartą klapę .	otwartą	6	Acc
Niebo było pokryte białymi barankami .	pokryte	2	Nom
- Czy to jest objaw narodowego masochizmu ?	narodowego	5	Gen
Inne doświadczenie to etyka utylitarna .	Inne	0	Nom
W stanie obrzydzenia przyprawiającego o nowe mdłości nie zauważył nawet , że wielki ból zaczyna z wolna zanikać .	przyprawiającego	3	Gen
Spojrzała m na jej męża , ale oczy miał zasłonięte kapeluszem .	zasłonięte	9	Acc
Niektórzy szukali ich na dalekiej mroźnej północy .	mroźnej	5	Loc
Amerykanie patrząc zza Oceanu na Europę myślą niemal wyłącznie kategoriami strategicznymi i gospodarczymi .	gospodarczymi	12	Ins
Donald Tusk umiejętnie punktował ogólnikowe wypowiedzi swych konkurentów .	ogólnikowe	4	Acc
Włoski rząd na nadzwyczajnym posiedzeniu przeznaczył wczoraj 50 milionów euro dla dotkniętego trzęsieniem ziemi regionu .	Włoski	0	Nom
Na wrocławski Rynek rzeczywiście przybyły tłumy .	wrocławski	1	Acc
Padały jeszcze pytania o drogi krajowe biegnące przez wsie .	biegnące	6	Acc
Po odsiadce nie zaprzestał złodziejskiego procederu .	złodziejskiego	4	Gen
Huntington nie przyjmuje zatem argumentu o globalnej sekularyzacji .	globalnej	6	Loc
Artyści z trzech akademii sztuk pięknych oglądali wczoraj budynki przy ulicy Zamkowej .	pięknych	5	Gen
Uniewinnienie przełożonych ich synów wstrząsnęło zbolałymi kobietami .	zbolałymi	5	Ins
W latach sześćdziesiątych , już jako sztygar oddziałowy , pamiętam odbiory przygotowywanych do rozruchu ścian dokonywane przez dyrektora Śniegonia .	przygotowywanych	11	Gen
- Gdybym niszczył pieczywo , fiskus byłby zadowolony .	zadowolony	7	Nom
Zastawał em Janka w ciemnym pokoju .	ciemnym	4	Loc
Tu spędzał wolne chwilę .	wolne	2	Acc
– Nie zostanie pan jednak całkiem odsunięty od śledztwa .	odsunięty	6	Nom
Warto zadbać o zapis wywiadu na taśmie wideo lub magnetofonowej .	magnetofonowej	9	Loc
Główne dowództwo niemieckie musi objąć kierownictwo operacji wojennych we Włoszech .	Główne	0	Nom
Na Śląsku w tajemniczych okolicznościach giną młode dziewczyny !	tajemniczych	3	Loc
Tam nawiązuje kontakt z grupą partyzancką o zabarwieniu skrajnym , likwidującą komunistów i uciekinierów z gett .	likwidującą	10	Ins
W czasach uczelnianego wyścigu szczurów i masowego bezrobocia pełni często rolę bezpłatnej terapii .	bezpłatnej	11	Gen
Jeszcze gorzej przedstawia się sytuacja z pracą laboratoriów w przedsiębiorstwach budowlano - montażowych .	montażowych	12	Loc
Molekularnie jest piękny .	piękny	2	Nom
Na klatce schodowej domu u zbiegu Alei Jerozolimskich i Nowego Światu skoczył z wysokości trzeciego piętra .	schodowej	2	Loc
Opinia publiczna sprzyja Małkowskiemu .	publiczna	1	Nom
Ogłuszający stukot kół nie obudził smacznie śpiącego mężczyzny .	Ogłuszający	0	Nom
Ani mu się śniło opowiadać o słonecznej wiośnie .	słonecznej	6	Loc
Projekt zakończył się uroczystym śniadaniem wielkanocnym .	wielkanocnym	5	Ins
Fiokła spała w sąsiednim pokoju .	sąsiednim	3	Loc
Kim jest strażnik łowiecki ?	łowiecki	3	Nom
Dzisiejsza konfrontacja z łódzkimi zespołami , które mają pierwszoligowe aspiracje , zapowiada się niezwykle ciekawie .	pierwszoligowe	8	Acc
Badania wielkości sił naciągu strun na torze przeprowadzono przez bezpośredni pomiar sił w poszczególnych strunach za pomocą przyrządu VOGT .	poszczególnych	13	Loc
Pierwsza z nich idzie do Was !	Pierwsza	0	Nom
A może chodzi o coś innego ?	innego	5	Gen
Przebiegała między najwyższą topolą na brzegu a kominem mleczarni .	najwyższą	2	Ins
Staruszka wyjęła z kredensu album oprawiony w zniszczoną ciemnowiśniową skórę .	zniszczoną	7	Acc
Satelita miał badać promienie kosmiczne i mikrometeoryty .	kosmiczne	4	Acc
Książka ukazała się w odpowiednim momencie , w okresie dyskusji nad nowymi programami .	nowymi	11	Ins
Dziwnym trafem niezależne spółki węglowe zaproponowały bardzo podobne podwyżki .	Dziwnym	0	Ins
Jeśli zostanie on zrealizowany , to za pięć lat będziemy mieli w kraju ok . półtora miliona rodzin pszczelich .	pszczelich	18	Gen
Szumiał wiatr w gołych gałęziach drzew .	gołych	3	Loc
Ja chodziła m do bezpłatnej szkoły na Krakowskiej i była m zadowolona .	bezpłatnej	4	Gen
W innych miejscach znaleziono wyszlifowane i porysowane przedkarbońskie skały podłoża .	przedkarbońskie	7	Acc
Mają ciałka masywnie zbudowane , raczej krępe .	krępe	6	Acc
Nie złożyłem podpisu pod wnioskiem o wotum nieufności skierowanym do marszałka Sejmu .	skierowanym	8	Ins
Hakerzy zaatakowali stronę internetową Watykanu .	internetową	3	Acc
Miał oczy przymknięte , blada twarz była bez wyrazu , jakby zabierał się do wysłuchania banalnej spowiedzi .	przymknięte	2	Acc
Upragnioną miłość zanurzył eś w najpodlejszym , cuchnącym bagnie .	cuchnącym	7	Loc
Stołeczna tkalnia w czynie tysiąclecia podjęła się regularnej produkcji płótna pasiakowego .	regularnej	7	Gen
Zgodnie z podjętymi na wtorkowym spotkaniu ustaleniami , targi eksporterów oraz wystawy turystyczne odbędą się w przyszłym roku .	wtorkowym	4	Loc
Podczas obchodu można było się przekonać , że nastąpiły gruntowne zmiany w pomieszczeniach CSiK .	gruntowne	9	Nom
Ostatni król Polinezji , Pomare V , zmarł z powodu alkoholizmu .	V	5	Nom
Królik jest w stosunku do innych zwierząt swego gatunku bardzo towarzyski , zajmuje nory wspólne i żyje całymi koloniami .	całymi	17	Ins
Ma do tego dojść na specjalnym posiedzeniu Rady Miejskiej , prawdopodobnie zamkniętym dla gości i mediów .	zamkniętym	11	Loc
Gwyneth przyznaje , że przez tych ostatnich kilka lat dojrzewała na zdwojonych obrotach .	zdwojonych	11	Loc
Mówimy o sytuacji , w której budżet musi jednocześnie wytrzymać skutki rosyjskiego kryzysu i koszty tegorocznych reform .	tegorocznych	15	Gen
Sztandar bojowy podniosły także narody podbite i uciemiężone przez carat .	podbite	5	Nom
Chłopiec przebywa w greckim przytułku prowadzonym przez organizację o złej reputacji .	greckim	3	Loc
Była typową polską postępową inteligentką czyli agnostyczką , i wzmianek o chodzeniu do kościoła u niej nie upatrzysz .	postępową	3	Ins
Jest to choroba wzrostowa zwana także bolesną kifozą młodzieńczą .	młodzieńczą	8	Ins
– a nie macie starej kasety jakiejś ?	starej	4	Gen
Mimo realizacji wielu programów adresowanych do osób niepełnosprawnych oraz możliwości zakupu sprzętu rehabilitacyjnego , nadal dla wielu osób problemem jest zdobycie wózka inwalidzkiego .	adresowanych	4	Gen
Nakładkę rozkłada się na desce sedesowej .	sedesowej	5	Loc
Pod pachą trzymała jakąś paczkę zawiniętą w gazetę .	zawiniętą	5	Acc
Po chwili odsłonił głowę i uważnie lustrował zaniepokojone twarze .	zaniepokojone	7	Acc
Pan konsul obiecał , że poruszy natychmiast tę sprawę z attaché wojskowym , generałem brygady .	wojskowym	11	Ins
Prócz akcji upowszechniania czytelnictwa wśród dzieci Warszawy , podjęła prace o charakterze ogólnym , często prekursorskim .	prekursorskim	15	Loc
W krajach zazwyczaj triumfujących filmy o ciężkich chwilach są przypomnieniem czegoś , co zagrażało .	triumfujących	3	Loc
Sejm przyjął wczoraj nową ustawę lustracyjną .	nową	3	Acc
Społeczeństwo wychowywano w ślepym posłuszeństwie wobec Cesarstwa .	ślepym	3	Loc
Czytanie jest u kalwinów powinnością religijną , obowiązkiem wierzącego .	religijną	5	Ins
Pracownik zwalnia się często podczas pracy dla załatwienia spraw osobistych .	osobistych	9	Gen
Następnie Aleksander Zawadzki dokonał otwarcia muzeum w dziesiątym Pawilonie .	dziesiątym	7	Loc
Ślizgawki w Dąbrowie Górniczej odbywają się już od 4 lat .	Górniczej	3	Loc
Źródło ognia znajdowało się przy drzwiach wejściowych .	wejściowych	6	Loc
- To nie może wpływać na osoby zainteresowane .	zainteresowane	7	Acc
Za sobą mieli martwą rzekę , która leżała wśród piasków jak rozbity dzban .	rozbity	11	Nom
W październiku podczas pierwszych tegorocznych mrozów zamarzły cztery osoby .	tegorocznych	4	Gen
- Są nierozerwalni jak dwie półkule mózgowe , stanowią najdoskonalsze małżeństwo świata .	najdoskonalsze	9	Acc
Polskie zasady zestrzeliwania opisano w niewielkiej czerwonej książeczce .	Polskie	0	Acc
Powinna ona również być akredytowana , gwarantowana .	akredytowana	4	Nom
W miniony czwartek w referendum ratyfikacyjnym Irlandia odrzuciła ten Traktat , otwierający drogę do rozszerzenia Unii .	otwierający	11	Acc
Marysia mówi , że trzeba iść drugą bramą , tą pod murem kremlowskim .	kremlowskim	12	Ins
Zbierał te suche rozstajne krótkie drogi , wiązał w pokaźne drapadła o ściśniętym kierunku .	suche	2	Acc
Ten rok pustelni byłby swoistym duchowym prysznicem .	swoistym	4	Ins
Zanim wiązanki kwiatów przykryły mogiłę , słowa modlitwy prowadzonej przez ks . Pawła Dorucha splatały się z wyrazami bólu i wspomnieniami przyjaciół .	prowadzonej	8	Gen
Kochamy Polskę , lecz fakty składające się na polską rzeczywistość działają nam na nerwy .	składające	5	Nom
Chciał by m poznać osobiście człowieka o tak niesamowitej wyobraźni .	niesamowitej	8	Loc
Powrócono do szkoleń politycznych , na których trzeba było walczyć z wszechogarniającą sennością .	politycznych	3	Gen
Wobec powyższego Angus uznał obecny wykład za głupi , wprost śmieszny absurd .	powyższego	1	Gen
Bo zawsze nowy papież to sięgnięcie po nową talię .	nową	7	Acc
Siedział za pięciometrowym murem zakończonym drutem kolczastym .	zakończonym	4	Ins
Zmarł w Livorno w roku 1846 .	1846	5	Loc
Wczesnym popołudniem polska delegacja udała się do Warny .	Wczesnym	0	Ins
Na piątym był ostatni etap .	piątym	1	Loc
W czwartkowe popołudnie gasili płonący śmietnik przy ul. Brodzińskiego w Proszowicach .	płonący	4	Acc
Życie jest szare i smutne , ale można się pocieszać zakupami .	szare	2	Nom
- Czy nie zabrakło woli politycznej do osądzenia komunistycznych zbrodniarzy ?	komunistycznych	8	Gen
Jak długo jeszcze trupy z esbeckich szaf będą nas straszyć ?	esbeckich	5	Gen
Do zdarzenia doszło przed jednym z bloków przy ul. Łąkowej .	Łąkowej	9	Loc
Nigdy wcześniej w tak wielkiej imprezie sportowej , i tak prestiżowej , nie startowali śmy .	wielkiej	4	Loc
Jesienią zeszłego roku odwołać dyrektora Ziarkowskiego usiłowała Rada Kasy .	zeszłego	1	Gen
Moment bezwładności to miara bezwładności ciała w ruchu obrotowym względem określonej , ustalonej osi obrotu .	obrotowym	8	Loc
Jestem siłą roboczą , nie mogę cię oceniać .	roboczą	2	Ins
Komentarz do wyniku jest chyba zbyteczny .	zbyteczny	5	Nom
Związki zawodowe reprezentują przecież grupy obywateli i są zobligowane do dbania o ich interesy .	zawodowe	1	Nom
Bawi mnie to w jakiś ponury sposób .	ponury	5	Acc
Był em tym zachwycony i chodził em po Akademii dumny jak paw .	zachwycony	3	Nom
Ale my nie jesteśmy partią ortodoksyjną .	ortodoksyjną	5	Ins
Widział em rano , jak rozmawiała ś z tym sympatycznym młodzieńcem , Abibem Denisem .	sympatycznym	9	Ins
Reformy ograniczono do totalnej prywatyzacji , która przyjęła raczej ramy wyprzedaży majątku narodowego .	totalnej	3	Gen
Zasapany Mock zszedł ze stołu i włożył głowę do żeliwnego zlewu .	żeliwnego	9	Gen
Konkurs składał się z etapu ustnego i pisemnego .	ustnego	5	Gen
Człowiek staje się wyleniałym tygrysem .	wyleniałym	3	Ins
jestem w stanie zgodzić się na utrzymywanie emeryta , gdyż przepracował swoje życie i coś dobrego dla społeczeństwa zrobił .	dobrego	15	Gen
Doświadczenie zawodowe zdobyła pracując w teatrze i telewizji w Polsce i na Ukrainie .	zawodowe	1	Acc
Tegoroczną nowością raportu jest skala krajowego seksu wirtualnego .	wirtualnego	7	Gen
Czuł em jego mięśnie napięte pod skórą , twarde jak drewno .	napięte	4	Acc
Patrzy , a tu we włosach łonowych roi się od weszek .	łonowych	6	Loc
Od 1993 r . jest kierownikiem Zakładu Współczesnych Teorii Ekonomicznych , a od 1999 r . pełni funkcję dziekana Wydziału Ekonomiczno - Socjologicznego Uniwersytetu Łódzkiego .	Ekonomicznych	9	Gen
Skupieni operatorzy delikatnie manipulowali skomplikowanymi urządzeniami odbioru przekazywanej informacji .	skomplikowanymi	4	Ins
- W pierwszym roku naszej działalności poszukiwaliśmy młodzieży chętnej do pracy z osobami niepełnosprawnymi .	niepełnosprawnymi	13	Ins
Jest to duży wysiłek , jednak nauka szkolna jest zasadniczym czynnikiem samowychowawczym .	zasadniczym	9	Ins
I zrozumieli ludzie , że tu Bóg był , i zburzyli ten sądowy dom , aby w nim nikt już więcej po Panu Jezusie nie sądził , a przed jabłonnymi drzewami postawili krzyż i on do dziś tam stoi .	sądowy	12	Acc
- Czy w zaświatach dalej puszczasz się z żydowskimi demonami ?	żydowskimi	8	Ins
Potrawy były oceniane przez 110 niezależnych sędziów .	oceniane	2	Nom
O przygotowaniu do studiów wyższych wspominano w dalszym punkcie .	wyższych	4	Gen
Potem roztworem chemicznym starannie spryskano bezcenne posągi i stare mozaiki .	chemicznym	2	Ins
Dla oddziału chirurgicznego znajdującego się na pierwszym piętrze jest to siedziba tymczasowa .	znajdującego	3	Gen
Ministerstwo Rolnictwa , które przed rokiem obłożyło miód importowany opłatami wyrównawczymi , opracowało długofalowy program rozwoju pszczelarstwa .	wyrównawczymi	10	Ins
Zauważam jednak , że kabel jest końcem rogu olbrzymiego nosorożca , który stoi na dole .	olbrzymiego	8	Gen
Miał równie pokraczną głowę , krótki tułów .	krótki	5	Acc
A stopy mocno stoją na twardym , świętym gruncie .	świętym	7	Loc
Warto pamiętać , że krupa lodowa jest młodszą siostrą gradu .	młodszą	7	Ins
Przez następne 200 lat Krzyżacy kolonizowali Prusy i budowali swoje państwo .	następne	1	Acc
Za kratami sprawował się tak dobrze , że więzienne władze chcą , by wyszedł przed końcem kary .	więzienne	8	Nom
Pierwsze krople deszczu zadudniły o trumnę i zmieszały się ze święconą wodą , którą ksiądz rozpryskiwał z kropidła podobnego do królewskiego berła .	święconą	10	Ins
Pozostali pacjenci przebywają na oddziale ginekologicznym , wewnętrznym i kardiologicznym .	wewnętrznym	7	Loc
Powołano sejmową komisję śledczą do wyjaśnienia tej sprawy .	śledczą	3	Acc
Ten pstrąg zajeżdżał mułem głębinowym , to wszystko .	głębinowym	4	Ins
Każdy duży sklep samoobsługowy lub mięsny wyposażono w krajalnice do wędlin .	samoobsługowy	3	Acc
Akcja ratunkowa trwa .	ratunkowa	1	Nom
Jeszcze w 1576 , jak wspominają akta wizytacyjne , mieszkali tu wolni Prusowie .	1576	2	Loc
Dziś zgromadzili śmy się tu , zwabieni staropolską gościnnością twoją , ażeby uczcić dzień twego imienia .	staropolską	7	Ins
82 proc . respondentów CBOS uważa , że różnica zarobków w Polsce jest zbyt duża .	duża	14	Nom
Ich mieszkańcy do dzisiaj pamiętają wojnę z rozwydrzoną młodzieżą , wojnę o prawo do spokojnego snu , którą w końcu wygrały dla nich oddziały gestapowskiej policji .	rozwydrzoną	7	Ins
Z oficjalnym żądaniem wobec MKOl , złożonym na piśmie , wystąpił Narodowy Komitet Olimpijski KRLD , domagając się od naczelnej władzy sportowej rewizji listy triumfatorów olimpijskich .	naczelnej	19	Gen
Wolała puszczać w kinach filmy kung-fu licząc , że dzięki temu ludzie przestaną myśleć o polityce .	kung-fu	5	Acc
O drugiej rozpoczął się dramat jak z kadrów sensacyjnego filmu .	sensacyjnego	8	Gen
Gdy we wspomnianych dwu pionach narożnikowych ktoś się kąpie , wówczas woda spływa w dół nawilgacając po drodze niżej położone mieszkania .	wspomnianych	2	Loc
Postępowanie przeciwko przestępcy , który został świadkiem koronnym , ulegałoby zawieszeniu .	koronnym	7	Ins
Nieboszczyk ojciec zawsze nam to śpiewał i na pedałowej harmonii sobie podgrywał .	pedałowej	8	Loc
W samej Warszawie w Internecie swoje auta eksponuje już kilkadziesiąt komisów .	samej	1	Loc
– Dziennikarze wmówili sądowi i ludziom , że Róża musi wrócić do biologicznych rodziców .	biologicznych	12	Gen
Policji udało się już w dużym stopniu zrekonstruować przebieg wypadków .	dużym	5	Loc
- Złożę też za chwilę na ręce pana marszałka ową poprawkę formalną , uzgodnioną z Biurem Legislacyjnym .	Legislacyjnym	16	Ins
Małżonka dyplomaty przez 13 lat była nauczycielką w szkole podstawowej .	podstawowej	9	Loc
- Małą miss została Klaudia Zdunek !	Małą	1	Ins
Nie muszę używać trybu przypuszczającego .	przypuszczającego	4	Gen
Chodzi o to , aby uczniowie w odpowiednich warunkach mogli realizować cele w ramach poszczególnych przedmiotów , zajęć pozalekcyjnych czy pozaszkolnych .	pozaszkolnych	20	Gen
Książę Andrzej Poniatowski , porucznik armii francuskiej , odwiedził Polskę w roku 1919 jako członek francuskiej misji wojskowej .	wojskowej	17	Gen
Lubuscy policjanci rozbili grupę zajmującą się włamaniami do kościołów i kradzieżami figur oraz przedmiotów kultu religijnego .	religijnego	15	Gen
Wiele ptaków owadożernych zimą zmienia jadłospis na roślinny .	owadożernych	2	Gen
Kongresy Międzynarodówki poruszały zawsze ważne problemy , istotne dla życia politycznego i społecznego danego okresu .	danego	13	Gen
Jako metal szlachetny nie wypiera wodoru z kwasów , reaguje jedynie z gorącym kwasem azotowym i siarkowym , redukując je do odpowiednich tlenków .	azotowym	14	Ins
Potem jeszcze kaszkę ryżową dał em .	ryżową	3	Acc
Trafi do szpitala psychiatrycznego .	psychiatrycznego	3	Gen
Uderzył w biurokratyzm partyjny .	partyjny	3	Acc
Na początku lat 80 . fryzjerka z najdłuższym stażem była na zjeździe branży w Warszawie .	najdłuższym	7	Ins
Tom Spencer posiadał przy sobie pisma pornograficzne i kasety video dla homoseksualistów oraz marihuanę .	video	9	Acc
Sprzeciwili się projektowi ustawy , która pozwoli na przynoszący zysk import odpadów nuklearnych .	przynoszący	8	Acc
Są nawet puderniczki z prasowanym pudrem i same wkłady .	prasowanym	4	Ins
Tym bardziej jest to smutne , gdy czynią to urzędnicy rządowi , którzy mają być apolityczni .	smutne	4	Nom
Odcinali go z najmłodszym synem .	najmłodszym	3	Ins
- Ważne są opinie ludzi mówiące o pozostawieniu miejskiej komunikacji .	Ważne	1	Nom
W tym roku prawdziwa zima wyprzedziła kalendarzową .	kalendarzową	6	Acc
Wyobraź sobie człowieka znajdującego się na ogromnej górze .	ogromnej	6	Loc
Księdza zatrzymano w ubiegłym tygodniu na polsko - ukraińskim przejściu granicznym w Dorohusku przy wjeździe do Polski .	granicznym	10	Loc
Zapalono wszystkie lampy , ustawiono ruchome wieszadła , kelnerzy w oczekiwaniu gości spacerowali po korytarzach hotelowych .	hotelowych	15	Loc
Unosiła się wokół nich anielska aura .	anielska	4	Nom
Pod stołem bawił się granatem mały chłopiec , nazywany Osęką .	nazywany	8	Nom
Zapewne nazwisko niejednego znajomka znalazłbym na Bronkowej liście .	Bronkowej	6	Loc
Dotknął wilgotnego ręcznika w łazience , pogładził mięsistą połę szlafroka , powąchał mydło w cedrowej kasetce .	cedrowej	14	Loc
Siedemdziesięciu chorych leżało na słomianych barłogach we własnym kale .	słomianych	4	Loc
Ponadto badania te świadczą , że koncentraty alkoholowe różnych roślin są dobrym środkiem zapobiegawczym przeciw grypie .	alkoholowe	7	Nom
W grupie finałowej rozegrano mecze każdy z każdym i wyłoniono zwycięzcę , którym został zespół Warka Tuchola .	wyłoniono	9	Nom
Ognista łapa przejechała po głowie Liścia , ledwie zdołał jej umknąć .	Ognista	0	Nom
Przez dwie godziny w miniony piątek nie pracowali technicy elektroradiologii .	miniony	4	Acc
Dwa lata temu kilkudziesięciu okolicznych rolników demonstrowało swoje niezadowolenie przed mławską Temidą .	mławską	10	Ins
Dziś zgromadzili śmy się tu , zwabieni staropolską gościnnością twoją , ażeby uczcić dzień twego imienia .	zwabieni	6	Nom
Jest to choroba wzrostowa zwana także bolesną kifozą młodzieńczą .	wzrostowa	3	Nom
Kolejną aferę w zakładach pracy chronionej ujawnili policjanci z wydziału do walki z przestępczością gospodarczą Komendy Wojewódzkiej w Olsztynie .	chronionej	5	Gen
Licznie przybyła publiczność zajęła miejsca przy stołach biesiadnych , na obszernym trawniku lub obok sceny .	obszernym	10	Loc
Wyrzekliśmy się naszych zasad i małpujemy kraje , które pogrążyły się w nihilizmie moralnym !	moralnym	13	Loc
Trzydzieste piąte Targi zostały rozpoczęte .	rozpoczęte	4	Nom
Nagie , surowe ściany tchnęły mroźną wilgocią .	mroźną	5	Ins
Zachichotała do własnych erotycznych skojarzeń .	własnych	2	Gen
Odrzucił płaszcz , czoło miał zroszone potem .	zroszone	5	Acc
Dowódca sił amerykańskich w Afganistanie generał Tommy Franks zapowiedział kolejne operacje lądowe .	lądowe	11	Acc
Załadował na wóz wynajętych gazeciarzy i rozwiózł po mieście , każąc rozdawać list przechodniom .	wynajętych	3	Acc
Pomysłodawcą zmian w ordynacji samorządowej była Samoobrona .	samorządowej	4	Loc
Bronił eksmitowanych na bruk , naprawiając błędy przyjętej przez koalicję SLD­PSL ustawy , grzmiał na globalistów i świeżych krajowych , drapieżnych kapitalistów .	świeżych	17	Acc
Ze wschodnim uporem i takąż wytrwałością badali każdą ewentualność sami , przez swych znajomych , przez znajomych , aż znaleźli .	wschodnim	1	Ins
Jednocześnie następują dynamiczne , ale dostosowane do realiów społecznych i kapitałowych przekształcenia własnościowe .	własnościowe	12	Nom
Spała , Wałcz czy Cetniewo są od dawna ośrodkami na najwyższym europejskim poziomie .	europejskim	11	Loc
W zaborze rosyjskim po śmierci Aleksandra II , który zginął w zamachu terrorystycznym , nastąpiło gwałtowne zaostrzenie polityki represyjnej we wszystkich dziedzinach życia publicznego .	rosyjskim	2	Loc
Odpowiedział eś posługując się sztandarowym obok Białorusi argumentem .	sztandarowym	4	Ins
Pozytywne zdanie miała garstka z nich .	Pozytywne	0	Acc
Odnalazł em w nim wiele smutnych prawd współczesności .	smutnych	5	Gen
Brakowało jakiegoś rysu dawnego Jeffa .	dawnego	3	Gen
Wiślana smuga wtopiła się w szarość horyzontu .	Wiślana	0	Nom
Z zaskoczeniem przeglądali śmy witrynę internetową Stołecznego Zakładu Energetycznego .	Stołecznego	6	Gen
Nie pamiętała ona już domu swego zamożnym .	zamożnym	6	Ins
Ale zaprzyjaźnił em się z nim dopiero w 1956 .	1956	8	Loc
I tym razem Gagarin zniósł ją ze stoickim spokojem .	stoickim	7	Ins
Jakiś chłopak postanowił wspiąć się na słup , by osobiście zdementować bzdury o magicznym prądzie elektrycznym .	elektrycznym	15	Loc
Chętnie zatrudniłby w ministerstwie doświadczonych ludzi z organizacji ekologicznych .	doświadczonych	4	Acc
A dobra rzadsze są tym cenniejsze .	cenniejsze	5	Nom
W Zwieczycy koło Rzeszowa autobus PKS wpadł do głębokiego rowu .	głębokiego	8	Gen
Do atrakcyjnej pani bosman podchodzi zniecierpliwiony wczasowicz .	atrakcyjnej	1	Gen
Potem zaraz z świętym Piotrem zniknął .	świętym	3	Ins
Próżne było nasze czekanie .	Próżne	0	Nom
Policja przypuszcza , że najnowszy ładunek został porzucony przez spłoszonego niedoświadczonego terrorystę .	spłoszonego	9	Acc
Z nowym rokiem weszło w życie nowe prawo dewizowe .	nowym	1	Ins
- Czy wniosek był zgłoszony na 12 godzin wcześniej ?	zgłoszony	4	Nom
To poemat dla romantycznych głów .	romantycznych	3	Gen
Ochmistrz ma otwartą kabinę , dla przyzwoitości pukam w uchylone drzwi .	otwartą	2	Acc
A potem wywieszono listę przyjętych , i mnie tam nie było .	wywieszono	2	Nom
Gdy dorośnie , zbuduje swoją katedrę , tworząc powieściowy świat W poszukiwaniu straconego czasu .	powieściowy	8	Acc
Olbrzymie tiry parkują na osiedlowych ulicach .	Olbrzymie	0	Nom
Podstawą każdego programu tłumaczącego jest słownik .	tłumaczącego	3	Gen
Na obszarach łąk zielonych wstają białe smugi , a poprzez ich długie przędziwa wesoło trzepie się rzeka .	białe	5	Nom
Do poradni chirurgicznej i pogotowia ratunkowego napływali poszkodowani piesi .	poszkodowani	7	Nom
Wuj matki , Bronisław Werner , spędził pięć lat w aresztanckich rotach w Orenburgu .	aresztanckich	10	Loc
W turnieju udział wzięli uczniowie szkół podstawowych , gimnazjalnych i ponadgimnazjalnych .	ponadgimnazjalnych	10	Gen
Istnieje tam aż sześć grup inicjatywnych , które chcą zorganizować wybory .	inicjatywnych	5	Gen
Zazwyczaj są to ich 6­9-letni synowie , których trzeba wyżywić .	6­9-letni	4	Nom
W ciągu pierwszego roku życia niemowlę potraja swoją wagę urodzeniową .	urodzeniową	9	Acc
Wizja Nawara Derela na stole sekcyjnym musiała być bardzo zabawna .	sekcyjnym	5	Loc
Zaczynam odczuwać tęsknotę za utworami o głębszej treści i większym sensie .	większym	9	Loc
Górnicze związki zawodowe domagają się , wbrew stanowisku resortu gospodarki , wypłaty nagród z ubiegłorocznych zysków spółek węglowych .	ubiegłorocznych	14	Gen
Amerykanie rzeczywiście zrobili śliczny manewr pancerny .	pancerny	5	Acc
Nie wiadomo też , kto nam odda pieniądze , jeśli obiecanej nagrody nigdy nie zobaczymy .	obiecanej	10	Gen
W styczniu kredytowy ruch jeszcze się zwiększył .	kredytowy	2	Nom
W licznych miejscach Zakopanego znajdują się jego rzeźby .	licznych	1	Loc
Bo rodzice będą wymyślać kary za złe stopnie .	złe	6	Acc
jest na niej 250 szopek nigdy dotąd poza Betlejem niepokazywanych .	niepokazywanych	9	Gen
- Jako człowiek próżny chętnie wracam do rzeczy przyjemnych .	przyjemnych	8	Gen
To maszyna piekielna .	piekielna	2	Nom
Doświadczenia z dzieciństwa spędzonego w rodzinie alkoholowej u wielu mężczyzn i kobiet owocują w dorosłym życiu utrwalonymi schematami odczuwania , zachowania i myślenia .	alkoholowej	6	Loc
Doniesienie o możliwych nieprawidłowościach wpłynęło do tucholskiej prokuratury w gorącym przedwyborczym okresie na początku października .	przedwyborczym	10	Loc
Przedostatni figuruje Artur Balazs , poseł i minister rolnictwa , a zamyka ją Stefan Oleszczuk z UPR-u , starosta kamieński .	Przedostatni	0	Nom
Polak zajął drugie miejsce .	drugie	2	Acc
Świadczy o tym choćby ceremoniał religijny podczas zaprzysiężenia .	religijny	5	Nom
Tymczasem ten istniejący był gruntownie remontowany kilka lat temu .	remontowany	5	Nom
Młoda demokracja została siłą wtłoczona w ramy półautorytarnej republiki prezydenckiej .	wtłoczona	4	Nom
W tegorocznym VIII turnieju wystartowało 18 drużyn podzielonych na 6 grup .	tegorocznym	1	Loc
Pamiętam w Iveronie w sześciu gablotach stłoczone największe relikwie .	stłoczone	6	Acc
Kiedyś w Poznaniu spotkałem się z moimi polskimi krewnymi .	polskimi	7	Ins
W opinii tej było tyleż przesady , ile podziwu dla niepokornych górali , którzy pozostawali wierni i lojalni , dopóki stara przyjaźń nie zaczynała dla nich samych stanowić zagrożenia .	niepokornych	10	Gen
Przesadził em tu z ofensywnym tonem .	ofensywnym	4	Ins
Jadę do Katowic w sprawach różnych , poprzecznych i podłużnych , jak mówią moje dzieci .	poprzecznych	7	Loc
Z drugiej strony dla mnie cała branża jest bardzo interesująca .	drugiej	1	Gen
WYKORZYSTAJMY EUROPEJSKĄ SZANSĘ !	EUROPEJSKĄ	1	Acc
Podstawowym problemem jest to , że na tym terenie mieszkają 2 rodziny .	Podstawowym	0	Ins
- Nóż niezbyt sprawnie odkrawał ziemniaczane spirale .	ziemniaczane	5	Acc
W środowisku olkuskim była osobą znaną , często w miejscowej resursie organizowano jej wystawy .	organizowano	11	Nom
Z zestawienia sporządzanego przez starostwo wynika , że podmioty gospodarcze działające w powiecie działdowskim dokonują rocznie ponad 6000 odpraw celnych .	działające	10	Nom
Ale już nie zdążyli , na pozostałym kawałku lądowały niemieckie dywizje pancerne .	pozostałym	6	Loc
" W dzieciństwie byłam często smutną dziewczynką " .	smutną	5	Ins
Celników z rzepińskiej Izby Celnej wspierali funkcjonariusze z Poznania i Krakowa .	rzepińskiej	2	Gen
Po incydentach w meczu derbowym ukarali ście Cracovię zamknięciem stadionu na dwa mecze .	derbowym	4	Loc
Krótko mówiąc , mam odpowiedniego człowieka .	odpowiedniego	4	Acc
Siedział em w ciemnym barakowozie , wpatrując się w niewyraźny zarys półlitrówki .	ciemnym	3	Loc
Potem ból stał się tak silny , że przesłonił wszystko ciemnością pozbawioną woni i dźwięków .	pozbawioną	11	Ins
Ziemia jest naga .	naga	2	Nom
W Urzędzie Wojewódzkim w Skierniewicach pracuje około 230 osób .	Wojewódzkim	2	Loc
W 1935 roku brytyjski informatyk Alan Mathison Turing wymyślił abstrakcyjną maszynę .	brytyjski	3	Nom
Zdjąć te cholerne obrazki po właścicielu .	cholerne	2	Acc
Tymczasem widzę , że pan również przyłączył się do tej niesmacznej orgii .	niesmacznej	10	Gen
Do sześciu głodujących w Poznaniu dołączyło w piątek trzech związkowców ze Śremu .	głodujących	2	Gen
I to wszystko było dobre i znajome , potrzebne i pożyteczne .	pożyteczne	10	Nom
Światło reflektorów bije na klatkę schodową .	schodową	5	Acc
- Skoro pani minister już podniosła kwestię wpływów podatkowych z rozmaitych województw i ich proporcji , myślę , że warto się nad nimi zastanowić , gdyż są one czasami dziwne i nie wiadomo , z czego wynikają .	podatkowych	8	Gen
Miejscowy hydraulik ma więc duże wzięcie .	Miejscowy	0	Nom
I są dobrymi gospodarzami .	dobrymi	2	Ins
O drugiej rozpoczął się dramat jak z kadrów sensacyjnego filmu .	drugiej	1	Loc
Palcem rysuje na wykładzinie małe syrenki .	małe	4	Acc
Moment bezwładności to miara bezwładności ciała w ruchu obrotowym względem określonej , ustalonej osi obrotu .	ustalonej	12	Gen
Zebrali śmy się u Nocnego Śpiewaka .	Nocnego	4	Gen
Mieszkający samotnie w starej drewnianej chałupie inwalida nie ukrywa , że jest rozczarowany .	starej	3	Loc
Odkrycie jest ważnym głosem w dyskusji dotyczącej bezpieczeństwa przeszczepów pochodzących od zwierząt .	dotyczącej	6	Loc
Warto zadbać o zapis wywiadu na taśmie wideo lub magnetofonowej .	wideo	7	Loc
Artystka zażądała czarnej kotary i profesjonalnego oświetlenia .	profesjonalnego	5	Gen
Jego spojrzenie , przed chwilą spłoszone , było teraz śmiałe i podstępne .	podstępne	11	Nom
- Żeby być przyjętym na Uniwersytet w Cambridge , trzeba mieć 45 punktów .	przyjętym	3	Ins
Groźni faszyści są bezkarni , bo stronę założyli na amerykańskim serwerze .	amerykańskim	9	Loc
Wkrótce ma ruszyć przeciw Sparcie cała armia etolska .	etolska	7	Nom
Godzinami , chmurni , łazili po mieście , ciągała go po galeriach , muzeach , teatrach .	chmurni	2	Nom
Samozwańczy gliniarz posługuje się oryginalną legitymacją .	oryginalną	4	Ins
— Aktualnie ta ściana jest w bardzo złym stanie .	złym	7	Loc
W Wielką Sobotę święci się też wodę i ogień .	Wielką	1	Acc
W latach 90 . wielu duszpasterzy , kierując się potrzebą posiadania wyrazistego wroga , wskazuje z ambony na wyraźnie nazwany obóz polityczny , lożę , fundację czy partię .	nazwany	19	Acc
- Wasza gazeta od dawna robi świetne przewodniki dla poszukujących pracy w Irlandii .	świetne	6	Acc
Nie było bezpośredniego kontaktu .	bezpośredniego	2	Gen
Oczywiście SLD mogło by być ugrupowaniem ateistycznym albo umiarkowanie areligijnym .	areligijnym	9	Ins
Codziennie na polickich drogach dochodzi do około 180 wypadków .	polickich	2	Loc
Okna były pozamykane .	pozamykane	2	Nom
Zdarzały się też i gorsze rzeczy .	gorsze	4	Nom
Giną więc wozy , których właściciele nie ubezpieczają ze względu na wysokie stawki .	wysokie	11	Acc
A przynajmniej choćby na jakiś czas powstrzymać zalewający kraj rewolucyjny potop .	zalewający	7	Acc
Wtedy stosowano materiały niskiej jakości .	stosowano	1	Nom
Jeśli to jest absolutnie niemożliwe , znaczy to , że twój charakter jest czymś pośrednim pomiędzy dwoma opisanymi w rozwiązaniu przy odpowiednich numerach .	odpowiednich	21	Loc
Zapalono wszystkie lampy , ustawiono ruchome wieszadła , kelnerzy w oczekiwaniu gości spacerowali po korytarzach hotelowych .	ruchome	5	Acc
Wzmocni ją możliwość bezpośredniego przekazywania prezydentowi poufnych informacji .	poufnych	6	Gen
Ostra sauna , potem pływa się w basenie okolonym drzewami .	okolonym	8	Loc
Dom jest nieocieplony .	nieocieplony	2	Nom
U małych pacjentów lekarze stwierdzali najczęściej anginę i nieżyt górnych dróg oddechowych .	górnych	9	Gen
Właściwie nie czułem się jeszcze senny , chociaż miałem za sobą dość długi i męczący dzień .	długi	12	Acc
Samozwańczy gliniarz posługuje się oryginalną legitymacją .	oryginalną	4	Ins
Trenerzy cały czas obserwują zawodników i nie zdecydowali , kto znajdzie się w podstawowej szóstce .	podstawowej	13	Loc
- Staszek był trudnym człowiekiem , bardzo rozdwojonym .	trudnym	3	Ins
- Dlatego nie mogł em rozmawiać z interesującymi mnie bokserami .	interesującymi	7	Ins
Między miniaturowym arcydziełem a banalną grafomanią wyrasta obszar kompletnej pustki .	miniaturowym	1	Ins
W grudniu 97 Komitet Wierzycieli MAAD złożył doniesienie karne przeciwko biznesmenowi i parlamentarzyście w poznańskiej Prokuraturze Wojewódzkiej .	poznańskiej	14	Loc
Stare gmachy , dostojne i omszałe , coraz bardziej upodobniają się do mamutów , wchłanianych w błoto epoki polodowcowej .	wchłanianych	14	Gen
– fotografia nie jest twoją mocną stroną .	mocną	5	Ins
Na razie jest kicha , bo spółki samorządowe i prywatne mają tylko 5 proc . łóżek .	samorządowe	7	Nom
Następnym mówcą będzie pan poseł Alojzy Gąsiorczyk .	Następnym	0	Ins
Odebrać bogactwa wszystkim bogaczom i uczynić je własnością powszechną .	powszechną	8	Ins
Zawsze i wszędzie jestem bezpieczny , w dzień i w nocy , w domu i poza domem , na ulicy i w samochodzie .	bezpieczny	4	Nom
Innej alternatywy nie ma , a wszelkie marzenia o samodzielnej roli quasi-mocarstwowej Polski są tylko rojeniami fantastów .	samodzielnej	9	Loc
Noc zamazała fantastyczne kolory i wszystkie klomby wyglądały teraz jednakowo .	fantastyczne	2	Acc
Następnym mówcą będzie senator Marian Żenkiewicz .	Następnym	0	Ins
- Co robicie , by w tak świetnej kondycji dotańczyć do finału ?	świetnej	7	Loc
W grudniu 1992 roku , po trzech miesiącach , Honecker został zwolniony przez sąd w Berlinie za względów humanitarnych .	zwolniony	11	Nom
Wyznaczeni posłowie zajęli miejsca .	Wyznaczeni	0	Nom
Interpressowska organizacja okazała się dobrze pomyślana . . .	pomyślana	5	Nom
Ale trzeba na niego zapracować , zwłaszcza przed stresującym dniem .	stresującym	8	Ins
Ponadto wykładano o spółdzielczości rolniczej i handlu rolniczym .	rolniczym	7	Loc
Prezydent Bush zapewniał w środowym przemówieniu telewizyjnym , że siły koalicji będą maksymalnie oszczędzały ludność cywilną .	środowym	4	Loc
Ostatnią decyzją Adamsa , podjętą przed opuszczeniem Białego Domu , było podpisanie nominacji dla Johna Marshalla na prezesa Sądu Najwyższego .	Najwyższego	19	Gen
We wszystkich miastach i miasteczkach odbyły się wiece i uroczyste akademie .	uroczyste	9	Nom
Odbudujmy porozumienie ponad różnicami , tak mało istotnymi wobec rzeczywistych problemów !	istotnymi	7	Ins
- Obrzuciła go karcącym spojrzeniem .	karcącym	3	Ins
I nagle zrywa się , zachłystując radosnym gwarem .	radosnym	6	Ins
Długie lata praktyki w kontaktach z nadkastowymi pozwoliły Hariemu zachować kamienną twarz .	nadkastowymi	6	Ins
Kobiety przystrajają drzewko kolorowymi wstążkami , śpiewając przy tym tradycyjne pieśni .	kolorowymi	3	Ins
Po naszym telefonie na miejscu pojawiła się policja , by ocenić , czy jest to krzew znajdujący się na liście zakazanych używek halucynogennych .	zakazanych	20	Gen
Ograniczenie szybkości obowiązuje tutaj od soboty z powodu rutynowych prac konserwatorskich .	rutynowych	8	Gen
Ma Pan trzy córki , czy podtrzymują one rodzinną tradycję ?	rodzinną	8	Acc
- Na płycie gra wielu znakomitych muzyków . . .	znakomitych	5	Gen
Brałam udział w strajkach na Politechnice Wrocławskiej , gdzie byłam doktorantką .	Wrocławskiej	6	Loc
Parlament Europejski w Strasburgu przegłosował niedawno całkowity zakaz reklamowania wyrobów tytoniowych .	całkowity	6	Acc
Na atramentowej powierzchni wody chybotał się samotny biały żagiel .	samotny	6	Nom
Wymaga to wielkiego samozaparcia i silnej woli , żeby nie ulec presji otoczenia .	silnej	5	Gen
Dante raczył zajmować się przede wszystkim potępionymi .	potępionymi	6	Ins
Lubi dobrą muzykę i piesze górskie wycieczki .	piesze	4	Acc
O tym , że pogoda ostatnio nas nie rozpieszcza , przekonał się właściciel lubelskiego sklepu futrzarskiego .	lubelskiego	13	Gen
Zespół od 15 lat cieszy się niezmienną popularnością .	niezmienną	6	Ins
Wstępna analiza Inspektoratu wskazuje , że sąd w Jeleniej Górze nie jest przystosowany do procesów , w których oskarżonymi są członkowie zorganizowanych grup przestępczych .	zorganizowanych	21	Gen
Odziedziczyła ona po bracie majątek w Galicji , uprzemysłowiony i dający duże profity .	uprzemysłowiony	8	Acc
Napastników zdradziły nagrania kamer na dworcu i w brukselskim metrze .	brukselskim	8	Loc
Jedenaście dni po pojawieniu się opisanej wizji sennej czar zaczął działać .	opisanej	5	Gen
Zawsze wygrywał , bo był najszybszy .	najszybszy	5	Nom
Praca pedagogiczna na uniwersytecie japońskim różni się znacznie od pracy na uniwersytecie europejskim .	europejskim	12	Loc
Tomaszewski był rozgoryczony tak długim odroczeniem swojego procesu .	długim	4	Ins
W Czarnem umieszczono go w celi o zaostrzonym rygorze .	zaostrzonym	7	Loc
Wszystko było przysypane żółtoszarym pyłem .	żółtoszarym	3	Ins
Ponad 1600 osób wzięło wczoraj udział w 24 . maratonie ulicznym we Wrocławiu .	ulicznym	10	Loc
Leżał żółty , patrzył na nich , nic nie mówił .	żółty	1	Nom
Kontrolę prywatyzacji jednoosobowych spółek Agencji WRSP Izba przeprowadziła na zlecenie sejmowej Komisji Rolnictwa i Rozwoju Wsi .	sejmowej	10	Gen
W innych miejscach znaleziono wyszlifowane i porysowane przedkarbońskie skały podłoża .	wyszlifowane	4	Acc
Teresa S . była kierownikiem w krakowskiej firmie .	krakowskiej	6	Loc
Posiadanie pełnych praw akademickich oznacza , że uczelnia nadaje stopień naukowy doktora , przeprowadza przewody habilitacyjne oraz występuje z wnioskiem o nadanie tytułu naukowego profesora .	akademickich	3	Gen
Tam przez prawie dwa miesiące będą trwały badania dna morskiego .	morskiego	9	Gen
Spostrzegł , że opuściła głowę i zaciskała poruszające się nerwowo usta .	poruszające	7	Acc
W ubiegłym roku w czerwcu okna w komunalnym mieszkaniu Salwockich wybijano trzy razy .	ubiegłym	1	Loc
Zgodnie ocenili , że będzie to świetne miejsce do utworzenia centrum wzornictwa przemysłowego .	przemysłowego	12	Gen
W pewnej chwili podeszła do niej dziewczynka z cienkimi warkoczykami .	cienkimi	8	Ins
Znajdą się tam także pomieszczenia rehabilitacyjne z basenem , salami gimnastycznymi i salami masażu .	gimnastycznymi	10	Ins
Alibi było , ale przy okazji sfotografowano tego wysokiego , przystojnego mężczyznę .	przystojnego	10	Acc
Nauczyciel szybko uporał się z zakupami i , nie powracając już do poprzedniego tematu , z widoczną ulgą pożegnał chałupniczkę .	poprzedniego	12	Gen
Według badań Unii Europejskiej jesteśmy najmniej aktywnym społeczeństwem w Europie .	aktywnym	6	Ins
Aubigne nienawidzi Paryża , choć stolica Francji jest dla niego zarazem miastem świętym .	świętym	12	Ins
Gdyby z takiego nierozsądnego myślenia wyrastało się jak z dziecięcych ubrań , nie było by większego problemu .	nierozsądnego	3	Gen
Samorządem , który ma 100 proc . udziałów w szpitalnej spółce akcyjnej , kierują od kilkunastu miesięcy ludzie Tuska .	akcyjnej	11	Loc
Nie chcąc zaskoczyć krywów , starał się wywołać jak największy hałas .	największy	9	Acc
Z każdym rokiem ruch osobowy i towarowy na przejściu granicznym w Chyżnem rośnie .	towarowy	6	Nom
- Nie wyobrażam sobie piękniejszej śmierci .	piękniejszej	4	Gen
Orkiestry murzyńskie grają ragtime'y , tłum cheerleaderek tworzy radosny , falujący szpaler .	falujący	10	Acc
Za krótka kołdra pokazywała jak nigdzie swoją małpią złośliwość .	małpią	7	Acc
Lokal ten otrzymał nowe pomieszczenia dla kuchni i podręcznych magazynów , oraz szatnię .	podręcznych	8	Gen
Niestety , z tym jest najgorzej i najlepsze koncepcje mogą nie zostać zrealizowane .	zrealizowane	12	Nom
Unijna forsa gryzie tylko rolników .	Unijna	0	Nom
Wciąż drożeją zboża , głównie żyto , a ceny pszenicy ustabilizowały się na wysokim poziomie .	wysokim	13	Loc
Wisła w Toruniu przekroczyła stan alarmowy o 80 cm , a wody wciąż przybywa .	alarmowy	5	Acc
Jest to maszyna transportowa .	transportowa	3	Nom
W poniedziałek we wczesnych godzinach popołudniowych podano , że zdołano uratować siedemset dwadzieścia dwie osoby .	wczesnych	3	Loc
W kraju nad Wisłą dominującym gatunkiem jest Polakatolik .	dominującym	4	Ins
Maluje na wypełzłym jedwabiu twarze jakby oglądane przez zasłonę z gazy .	wypełzłym	2	Loc
Do wytworzenia pary i utrzymywania ognia we właściwej temperaturze służy oddzielny palnik gazowy .	właściwej	7	Loc
Skontaktuję się z mamą trojaczków w najbliższych dniach .	najbliższych	6	Loc
Na groblach wybudowano jedenaście betonowych śluz wałowych .	wałowych	6	Gen
Jest wysoko zapięta pod szyję , wysmukła jak kwiat .	zapięta	2	Nom
Architekci opracowujący rysunki robocze są zazwyczaj wieloletnimi praktykami .	robocze	3	Acc
W połączeniu z manipulowaniem ostrością tworzy to klimat z pogranicza jawy i nierzeczywistości o niejasnej proweniencji .	niejasnej	14	Loc
Na Ziemi Lubuskiej prace przedsiewne , zwłaszcza na glebach lekkich przybierają na sile .	lekkich	9	Loc
Nawet w tych nerwowych czasach spokojnie się z nim pracowało .	nerwowych	3	Loc
Maria Kadłubek odebrała wydany zaocznie wyrok sądu grodzkiego .	grodzkiego	7	Gen
Dramatyczny przebieg mistrzostw zakończył się dla Szymona XIV miejscem w światowej klasyfikacji .	XIV	7	Ins
Ten wszechstronny , nowoczesny obiekt jest wyposażony w profesjonalny sprzęt pożarniczy .	profesjonalny	8	Acc
Przyjechali popołudniowym pociągiem .	popołudniowym	1	Ins
- Nie mogę w ten sposób nadużywać pańskiej uczynności .	pańskiej	7	Gen
Serduszka czekoladowe będą rozdawane w autobusach dla par .	czekoladowe	1	Nom
Zeznania urzędniczki były elementem republikańskiej kampanii , która miała zmusić prezydenta Billa Clintona do odwołania wizyty w Chinach .	republikańskiej	4	Gen
Jest to aminokwas poprawiający pamięć starzejącej się komórki .	starzejącej	5	Gen
Zatrzepotała gęstymi rzęsami .	gęstymi	1	Ins
Obecnie mają oni najwyższe pensje w całym województwie pomorskim .	najwyższe	3	Acc
Auto z czterema młodymi mężczyznami wpadło do Wisły .	młodymi	3	Ins
Dankowski objął Bełchatów na początku sezonu , a pierwszej porażki doznał dopiero w siódmej kolejce .	siódmej	13	Loc
Nowy gadżet wymaga od właściciela kwiatków , czekoladek , randek w barach karaoke i miłosnych liścików .	Nowy	0	Nom
Browar żywiecki , książęcy , ma ponad sto lat .	książęcy	3	Nom
Czy ma pani jakiś szczególny stosunek do Izraela ?	szczególny	4	Acc
Chowa się w małej wioskowej świątyni .	małej	3	Loc
Po drugie , wkraczaliśmy na wyjątkowo niewdzięczny teren .	niewdzięczny	6	Acc
Po czwartkowej wizycie w ratuszu zmienił jednak zdanie .	czwartkowej	1	Loc
Dużym zainteresowaniem cieszą się barwne szklane witraże jako prace ozdobne .	ozdobne	9	Nom
Sześć pięknych dziewcząt rywalizowało w Miejsko - Gminnym Ośrodku Kultury w Małogoszczu o tytuł Miss Regionu Jędrzejowskiego i Włoszczowskiego .	Jędrzejowskiego	16	Gen
Po paru dniach znał już wszystko i wszystkich i spędzał na górnych piętrach każdą wolną chwilę , wychodząc tylko w porze posiłków i oczywiście snu .	górnych	11	Loc
Westchnienia Ruskina i Prousta trafiają na podatny grunt .	podatny	6	Acc
Był by m siódmy lub ósmy w kolejce .	ósmy	5	Nom
Po feriach zimowych do nowej szkoły wprowadzili się uczniowie Liceum Ogólnokształcącego w Drohiczynie .	zimowych	2	Loc
- Komar to żywa istota .	żywa	3	Nom
Inspirował się także muzyką klasyczną i rockiem .	klasyczną	4	Ins
Panuję nad negatywnymi nastrojami .	negatywnymi	2	Ins
Radny Eugeniusz Morta chciał przed głosowaniem usłyszeć silne argumenty za wydaniem tak dużej kwoty .	dużej	12	Gen
Przy bardzo silnych wiatrach zawodnicy zakładają na płozy specjalne obciążenia .	silnych	2	Loc
Została ona zachwiana po październikowych wyborach .	październikowych	4	Loc
Jadący z nadmierną szybkością wartburgiem Marek Ch . , będąc pod wpływem alkoholu , został wyrzucony na łuku jezdni na pobocze , a następnie przekoziołkował i uderzył w drzewo .	nadmierną	2	Ins
Zostaje przewieziona do Centrum Zdrowia Matki Polki .	przewieziona	1	Nom
Podkreśla się , ze był on najlepszym rozgrywającym ligi i ojcem dominacji Chicago Fire w rozgrywkach grupowych .	grupowych	16	Loc
Jesteście gotowi ?	gotowi	1	Nom
Bardziej znamienne są liczby w poszczególnych gałęziach przemysłu .	znamienne	1	Nom
Roszczenia , jak się zakłada , były by załatwiane w trybie administracyjnym .	administracyjnym	11	Loc
Składamy hołd pokoleniom , które tworzą naszą historię , ale są też aktywnie obecne we współczesności .	obecne	13	Nom
Z domu wyniosłam zamiłowanie do pracy , moja rodzina była rodziną pracowitych ludzi .	pracowitych	11	Gen
Podczas zajęć rękodzielniczych , mimo początkowego wątpienia we własne możliwości , młodzież tworzyła ozdoby wielkanocne .	rękodzielniczych	2	Gen
Rozpoczęli zwożenie kamiennych płyt .	kamiennych	2	Gen
A jak sfinansować resztę dodatkowego deficytu ?	dodatkowego	4	Gen
Obecnie powstała niecka wysypiskowa wraz z infrastrukturą techniczną .	techniczną	7	Ins
W województwie świętokrzyskim znajdują się 323 obiekty sakralne .	świętokrzyskim	2	Loc
Nie wyobrażam sobie wprowadzania w życie indywidualnych planów .	indywidualnych	6	Gen
W marzeniach sennych główną rolę grają symbole .	sennych	2	Loc
Mimo takiego nowoczesnego rozwiązania i tak mam sporo kłopotów .	nowoczesnego	2	Gen
- Działania operacyjne ustały , a C . ciągle piął się w górę .	operacyjne	2	Nom
Austria i carska Rosja niszczyły je dalej systematycznie .	carska	2	Nom
Syn marnotrawny powrócił i spoczął pod opieką mamusi .	marnotrawny	1	Nom
Posiadał wszechstronny , uniwersalny umysł obejmujący szereg nauk specjalnych .	specjalnych	8	Gen
W październiku zeszłego roku w Warszawie odzyskano skradzionego opla .	zeszłego	2	Gen
ZSRR zgodził się zwolnić zatrzymanych marynarzy .	zatrzymanych	4	Acc
Ponad 20 ulic będzie wyłączonych z ruchu w związku ze Świętem Zmarłych .	wyłączonych	4	Gen
Trzecioligowcy strzelili kontaktowego gola , ale w ostatnim kwadransie dwie bramki dla Lecha wypracował Remień .	kontaktowego	2	Acc
Panowie nie mieli najmniejszych problemów z dziwnie skleconą reprezentacją Reszty Świata , panie też gładko wygrały z osłabioną ekipą USA .	osłabioną	17	Ins
Tylko w tym celu został w kosmos zaproszony .	zaproszony	7	Nom
– Płynie ogromny transport z demograficznym wyżem .	demograficznym	5	Ins
Stanisław N . nie jest jedynym szczecińskim nauczycielem , któremu zarzuca się łapówkarstwo .	szczecińskim	6	Ins
A na czym polega wasza działalność gospodarcza ?	gospodarcza	6	Nom
– My mieszkamy na samej górze .	samej	4	Loc
Pierwsze rzeźby wykonał w latach dwudziestych .	Pierwsze	0	Acc
Owocuje to eksplozją pomysłów i niespożytą energią niezbędną do ich realizacji .	niespożytą	5	Ins
Pod uniesionymi zasłonami rozległego łoża z trudem udało mu się dostrzec ginącą w powodzi koronek , pomarszczoną twarz pani Lamaire .	uniesionymi	1	Ins
VIII Zjazd Inżynierów Mechaników Polskich obradował w Katowicach pod hasłem zbiorowego wysiłku myśli i pracy nad aktualnymi zagadnieniami technicznymi , mającego na celu rozwój techniki polskiej .	zbiorowego	10	Gen
W województwie świętokrzyskim znajdują się 323 obiekty sakralne .	świętokrzyskim	2	Loc
By wdrożyć projektowany przez rząd nowy system taniego budownictwa mieszkaniowego , konieczne jest szybkie wyszkolenie kadr .	projektowany	2	Acc
Czy kobiety biorą u was udział w ruchu związkowym ?	związkowym	8	Loc
Teraz jest asfaltowa o każdej porze roku .	asfaltowa	2	Nom
Pociągnął em drugi raz za cyngiel .	drugi	2	Acc
W 1997 roku zachorowało około 11 tys . kobiet , z tego około 6 tys . zmarło .	1997	1	Loc
Wargi nie pulsowały triumfującą czerwienią .	triumfującą	3	Ins
Powrócił do wiary , postanowił wrócić do Kościoła katolickiego .	katolickiego	8	Gen
Tylko ulewa huczała nieprzerwanym , mokrym hukiem .	nieprzerwanym	3	Ins
Prezes ma całkowitą kontrolę nad swoją firmą , a bezpośrednia władza premiera kończy się na progu jego sekretariatu .	całkowitą	2	Acc
Już we wtorek prezydent Kwaśniewski wybiera się z roboczą wizytą do Paryża , by przekonywać do naszych racji prezydenta Jacquesa Chiraka .	roboczą	8	Ins
Polska gospodarka od 1994 r . wykazuje wysokie tempo wzrostu .	wysokie	7	Acc
I szedł em przez te stygnące odchody coraz bardziej markotny , a przygnębienia przybywało mi z każdym krokiem .	stygnące	5	Acc
Chętnie zatrudniłby w ministerstwie doświadczonych ludzi z organizacji ekologicznych .	ekologicznych	8	Gen
Wiosną i latem 1919 r . nastąpiło znaczne wzmocnienie Flotylli Wiślanej .	Wiślanej	10	Gen
Uległ wzruszeniu stary pedagog i zajął się wdowim synem z całą życzliwością .	wdowim	7	Ins
Osiągniesz korzyść prestiżową i finansową .	prestiżową	2	Acc
- Pokochać i być prawdziwym przyjacielem .	prawdziwym	4	Ins
W jego moskiewskim salonie bywała śmietanka przedrewolucyjnej Rosji .	moskiewskim	2	Loc
Jakby tego było mało , podczas kontroli technicznej stwierdzono , że oba pojazdy są niesprawne .	niesprawne	14	Nom
Miłość nie jest wzajemnym wywieraniem na siebie presji .	wzajemnym	3	Ins
Z ich opinią liczono się nie tylko w redakcji , ale również w środowiskach literackich i teatralnych .	literackich	14	Loc
W całym województwie odbywają się liczne imprezy artystyczne i sportowe .	sportowe	9	Nom
Suger Land jest najdynamiczniej rozwijającym się teksańskim miastem .	rozwijającym	4	Ins
Bracia Kaczyńscy chcą w tej chwili albo koalicji na swoich warunkach , albo przyspieszonych wyborów .	przyspieszonych	13	Gen
Krzyczy na mnie tylko trochę , kiedy się biję ze starszym bratem .	starszym	10	Ins
- Przeprowadzono w nich kontrole .	Przeprowadzono	1	Nom
- Zatem po raz pierwszy w Pańskim życiu kompozytorskim spotkały się obie Pańskie osobowości ?	Pańskim	6	Loc
Ich przedstawiciele , służąc w Gwardii Szlacheckiej , dodawali splendoru Stolicy Piotrowej , a jednocześnie znajdowali tam niejednokrotnie środki dla wygodnego życia , ponieważ za swą służbę otrzymywali pensje .	Szlacheckiej	6	Loc
Niemiecki sąd konstytucyjny zabronił stosowania go na terenie tego kraju .	Niemiecki	0	Nom
Stali na chodniku przed odrapanym budynkiem w Erewanie , w którym mieścił się Komitet Karabachu .	odrapanym	4	Ins
W pierwszych wiekach jego wyznawcy doznali okrutnych prześladowań .	okrutnych	6	Gen
Obok miasta umieszczono cmentarz żydowski z wyeksponowanym nagrobkiem do złudzenia przypominającym ohel Sonnenberga .	żydowski	4	Acc
Powołano sejmową komisję śledczą do wyjaśnienia tej sprawy .	sejmową	1	Acc
Na seminarium historycznym występowały wszystkie wielkie walory uczonego i nauczyciela .	historycznym	2	Loc
Przyzwoitość każe szanować gości i ja właśnie w ten elegancki sposób uszanuję Jagodowe wakacje .	Jagodowe	12	Acc
" Tak chciał Bóg , żeby nasz umysł w sprawach matematycznych osiągał pewność logiczną , ale w religii osiągał ją dzięki prawdopodobieństwu nagromadzonemu . "	matematycznych	10	Loc
W Tczewie w Radzie Miejskiej zasiada 23 radnych .	Miejskiej	4	Loc
- Oto walczę na froncie Kościoła i tam dbam o prawdziwą wiarę .	prawdziwą	10	Acc
- Zgromadziliśmy tu najstarsze i najładniejsze kostiumy .	najstarsze	3	Acc
Pożegnalny obiad był prawdziwą ucztą .	prawdziwą	3	Ins
Po drodze , lekko podchmieleni , prowadzili ożywioną rozmowę .	podchmieleni	4	Nom
Rozmaite padliny wieszano na Sienkiewiczu , ale ja w jego obronie zawsze staję .	Rozmaite	0	Acc
Przy wspólnym stole jadają tu studenci izraelscy i palestyńscy .	wspólnym	1	Loc
Porozumienie to podpisano bez wstępnego konsultowania się z rządem .	wstępnego	4	Gen
Tutaj jedynie pokrótce opiszemy ten standard i nieco uzupełnimy zaprezentowane w wymienionych artykułach informacje .	zaprezentowane	9	Acc
Zgodnie podkreślają , że bracia Kaczyńscy nie lubią hucznych imprez .	hucznych	8	Gen
Rudowłosa pani Hania błyskawicznie wydawała karty drogowe , tablice rajdowe , plakietki , oficjalne itinerery .	oficjalne	13	Acc
Wyrok znów był niekorzystny , ale emeryt się nie poddaje .	niekorzystny	3	Nom
Zasnął z głową opartą o skraj łóżka .	opartą	3	Ins
I doczekać z antykaczyńskim rządem do jesiennych wyborów .	antykaczyńskim	3	Ins
Janek Prosty uważał rude włosy za szczytowe osiągnięcie Pana Boga .	szczytowe	6	Acc
- Czy czarny scenariusz jest brany pod uwagę w zachodnich kołach finansowych ?	zachodnich	9	Loc
Ta masa wodna , nieraz podnosząca poziom Wiku o jeden metr ponad równię Puckiej Zatoki , spotyka się przy dziobie gołębia z silnym prądem zachodnim .	zachodnim	24	Ins
Sikora nie włączył się w działalność struktur podziemnych .	podziemnych	7	Gen
- Był zabezpieczony .	zabezpieczony	2	Nom
Stary zegar stojący na komodzie tyka natrętnie .	stojący	2	Nom
— W sprawie wywiadu moja sekretarka skontaktuje się z pańską sekretarką .	pańską	9	Ins
Na ul . Kolumny zginął wczoraj pod ciężarówką mężczyzna w średnim wieku .	średnim	10	Loc
- W spadku po odchodzącej ekipie nowy rząd otrzymuje olbrzymi deficyt w bilansie handlowym .	odchodzącej	4	Loc
W kilka godzin później wyjechałem z ciężkim sercem i obietnicą szybkiego spotkania .	szybkiego	10	Gen
Przed światłami kierujący ruchem zatrzymał tira , a za nim stanęła skoda .	kierujący	2	Nom
Ekipa ekspertów przy jednej z ulic znajduje dom niewiele uszkodzony .	uszkodzony	9	Acc
Od sześciu lat jest wiceprzewodniczącym czeskiego PEN Clubu .	czeskiego	5	Gen
Ważnym elementem samowychowującym jest nauka szkolna .	Ważnym	0	Ins
Amerykanie patrząc zza Oceanu na Europę myślą niemal wyłącznie kategoriami strategicznymi i gospodarczymi .	gospodarczymi	12	Ins
Spotkał się ze stanowczą odmową .	stanowczą	3	Ins
Związkowcy nie mają łatwego życia w policji .	łatwego	3	Gen
Punkt konstrukcyjny wynosił wtedy 20 metrów .	konstrukcyjny	1	Nom
W lasach pasły się krowy i owce , czasem ozwał się poryk niedźwiedzia lub gniewne parsknięcie rysia .	gniewne	14	Nom
Jeżeli ciasto troszeczkę rozlatuje się w oleju , oznacza to , że zostało prawidłowo przyrządzone .	przyrządzone	14	Nom
Obstępują solenizanta , śpiewają sto lat , a maluchy wręczają kolorowe paczki .	kolorowe	10	Acc
Ta specjednostka nosi bowiem imię legendarnych skoczków spadochronowych Armii Krajowej .	legendarnych	5	Gen
W wydanym wczoraj oświadczeniu Rada podkreśliła , że wstrzymanie wykonania koncesji , gdy jednocześnie toleruje się działalność piratów , niszczy podstawy ładu w eterze .	wydanym	1	Loc
Bardzo często , kiedy był em wściekły i napięty , wypijał em na rozluźnienie piwko czy setkę .	napięty	8	Nom
Ostatnią decyzją Adamsa , podjętą przed opuszczeniem Białego Domu , było podpisanie nominacji dla Johna Marshalla na prezesa Sądu Najwyższego .	podjętą	4	Ins
Teraz leżą tam w ciemności oba kosmyki i płyną w przyszłość spiralnym torem .	spiralnym	11	Ins
Trzy lata temu rozstał się z górniczą spółką mieszkaniową w Nikiszowcu .	mieszkaniową	8	Ins
Maszynista nie miał szans na zatrzymanie rozpędzonego elektrowozu .	rozpędzonego	6	Gen
Posiada ok. 150 ciekawych i zróżnicowanych egzemplarzy .	zróżnicowanych	5	Gen
Trzeba iść małymi krokami .	małymi	2	Ins
Dach przypomina fale morskie , które często zdobią japońskie drzeworyty .	morskie	3	Acc
Zimna woda tryskała na głowę , szyję i płonące uszy .	płonące	8	Acc
Było to szczególne uczucie .	szczególne	2	Nom
Ostatnio dał 18-latce na urodziny swoją dżinsową koszulę z niezmywalnym autografem .	dżinsową	6	Acc
Zdawał się zbierać myśli i szukać odpowiednich słów .	odpowiednich	6	Gen
Nawet kiedy sami tego żądają .	sami	2	Nom
Barok ambony , kiedyś dla niej naturalny , płynący dzielnie przez wieki , sprawiał teraz wrażenie kłopotliwego dodatku , fanaberii artysty , był nieznośnie kiczowaty , jarmarczny .	płynący	8	Nom
Modna kobieta pozostawi w swojej szafie spodenki do kolan oraz rybaczki .	Modna	0	Nom
Naścinali suchej trawy , aby urządzić sobie miękkie posłania .	miękkie	7	Acc
Przedstawione powyżej podejścia , koncepcje i metody dają duży wybór w określeniu docelowego modelu alokacji .	Przedstawione	0	Nom
29 kwietnia 2002 r . sąd wydał wyrok .	29	0	Gen
Dolną część garderoby osłaniamy papierowymi ręcznikami , aby nie pobrudzić jej później jajkami .	papierowymi	4	Ins
Zwolennicy Mossadegha , ministrowie , podejrzani oficerowie , działacze Tudeh są przesłuchiwani i torturowani .	torturowani	13	Nom
Pseudokibicom ze Stalowej Woli upiekło się , choć nieźle w sobotę nabroili .	Stalowej	2	Gen
Dzieci muszą doskonalić ważne społeczne i szkolne sprawności .	społeczne	4	Acc
Czasami zapominała o wielu istotnych rzeczach .	istotnych	4	Loc
Podstawowe terminy powstały podczas badań lodowców w górach umiarkowanej strefy klimatycznej .	klimatycznej	10	Gen
Był człowiekiem o wielkiej kulturze osobistej .	wielkiej	3	Loc
Jerzy Gruza wydaje się nieubłagany w swoim perfekcjonizmie .	nieubłagany	4	Nom
Z 13 do 27 zwiększa się w Łodzi liczba opiekunów , przeprowadzających dzieci idące na lekcje przez najruchliwsze jezdnie i skrzyżowania .	najruchliwsze	17	Acc
Młody Goethe i twórca drugiej części Fausta to bardzo odmienne postacie ?	drugiej	4	Gen
Rdzenni mieszkańcy wyspy stanowią rozpaczliwą mniejszość .	Rdzenni	0	Nom
I nie myśl , że mam Ci to za złe .	złe	9	Acc
Załadowano się na pięć barek i o zmierzchu wyruszono .	wyruszono	8	Nom
Kazio M . jest ciekawym przypadkiem .	ciekawym	4	Ins
Z zasady oglądam trzecią próbę generalną .	generalną	5	Acc
Taboret upadł z dramatycznym łoskotem , a on , wierzgając nogami , zawisł niczym gotowy do wypatroszenia wieprz .	dramatycznym	3	Ins
Ciągle jeszcze wybieramy naszych bohaterów i ich losy z miarką społeczną .	społeczną	10	Ins
Partie polityczne oraz reprezentujący ich politycy stanęli w wyborcze szranki .	reprezentujący	3	Nom
Serwisy , które go oferują , często zawierają wiele odnośników prowadzących do przykładowych , działających już stron .	działających	14	Gen
Grają muzykę będącą unikalnym mariażem form i stylów , zachwycają jurorów na wszelkich konkursach .	unikalnym	3	Ins
A ty jesteś ładna , zgrabna , wysoka , miła i mądra . . .	zgrabna	5	Nom
Więc kim się staniesz , gdy nie pojmiesz ich prostego języka , ich naturalnych gestów ?	naturalnych	13	Gen
Aresztowanego na 48 godzin mistrza zwolniono po poręczeniu majątkowym .	majątkowym	8	Loc
Poza tym powinna być bardziej dostępna dla zainteresowanych osób , które zechcą przechować w nim ważne osobiste dokumenty .	dostępna	5	Nom
Do tego momentu Polak miał wyraźną przewagę .	wyraźną	5	Acc
Poprawkę skrytykował już dyrektor wykonawczy Światowego Kongresu Żydów Elan Steinberg .	Światowego	5	Gen
Wezwana na miejsce żandarmeria wojskowa stwierdziła , że skrzynki , w których przechowywane były materiały wybuchowe , są puste .	przechowywane	12	Nom
Ułożył je ks. Wawrzyniec Beniok w 1707 roku .	1707	6	Loc
- Jesteśmy krajem katolickim !	katolickim	3	Ins
Pierwszym zapisanym mówcą jest senator Zbigniew Kulak .	zapisanym	1	Ins
Kaźmierz oddał stryjowi latarnię ; na ziemi położył podłużny wąski przedmiot .	podłużny	8	Acc
Najbardziej alergogennym składnikiem kosmetyków są środki zapachowe .	alergogennym	1	Ins
Mieszka pod Warszawą , a w swoim pięciohektarowym gospodarstwie , oprócz dwudziestu psów , hoduje także konie i kozy .	pięciohektarowym	7	Loc
A przecież prezydent Kaczyński odsłaniał kiedyś pomnik Ognia i wtedy prawie nikt nie był oburzony .	oburzony	14	Nom
- Nie zdarza się , aby przedmiotu wykładanego w gimnazjum nie było w jego oddziale zamiejscowym .	zamiejscowym	15	Loc
- Nasi żarłoczni przyjaciele ciągle są w amoku . . .	żarłoczni	2	Nom
Pozostali pacjenci przebywają na oddziale ginekologicznym , wewnętrznym i kardiologicznym .	ginekologicznym	5	Loc
Dziś w biznesowej działalności wspiera młodzieńca mamusia .	biznesowej	2	Loc
Mam pracę do czerwca , rozbieramy teraz czwarty piec .	czwarty	7	Acc
WDT jest państwową jednostką organizacyjną nieposiadającą osobowości prawnej .	państwową	2	Ins
Biała plama zniknęła , cały glob był opasany siecią wspólnot .	opasany	7	Nom
Miał em do niego pewną prywatną sprawę .	prywatną	5	Acc
Dodaje , że prace rozbiórkowe rozpoczną się prawdopodobnie już dziś .	rozbiórkowe	4	Nom
Ostatnią decyzją Adamsa , podjętą przed opuszczeniem Białego Domu , było podpisanie nominacji dla Johna Marshalla na prezesa Sądu Najwyższego .	Ostatnią	0	Ins
W Wojewódzkim Szpitalu Zespolonym odbyła się pierwsza w Poznaniu udana operacja przeszczepienia rogówki .	Zespolonym	3	Loc
Pomimo smutnej wymowy , sztuka obfituje w sceny humorystyczne , można również posłuchać piosenek Wasowskiego i Przybory .	humorystyczne	8	Acc
Już prawie jesteś wybudzona .	wybudzona	3	Nom
- To wypracowuje się na codziennych , mozolnych próbach .	mozolnych	7	Loc
Ukrywający się od wielu lat serbski zbrodniarz wojenny gen . Ratko Mladić nie może już czuć się bezpieczny .	wojenny	7	Nom
W Tczewie w Radzie Miejskiej zasiada 23 radnych .	Miejskiej	4	Loc
Opracował program dydaktyczny wychowania seksualnego , którego realizacja została ostatnio wstrzymana .	seksualnego	4	Gen
- Nie zajmujemy się leczeniem , ale poprawiamy społeczne funkcjonowanie .	społeczne	8	Acc
Po co w ogóle kastrować wolno żyjące koty ?	żyjące	6	Acc
Po jej najwybitniejszych przedstawicielach na cenowe szczyty dostali się liczni malarze , których zasługi artystyczne , poza tworzeniem dekoracyjnych i sprawnych technicznie obrazów , są raczej mizerne .	artystyczne	14	Nom
Gdyby śmy wobec tych przeciwności zareagowali negatywnym myśleniem lub działaniem , pomnożymy tylko złe siły , a te zrealizują się w naszym życiu .	negatywnym	6	Ins
Rdzenni mieszkańcy wyspy stanowią rozpaczliwą mniejszość .	rozpaczliwą	4	Acc
Ogromnym wzięciem cieszą się przed sezonem urlopowym jednorazowe nakładki toaletowe .	urlopowym	6	Ins
Najpierw były występy rockowego zespołu muzycznego oraz pokazy tańca nowoczesnego grupy z tczewskiego Centrum Kultury i Sztuki i karaoke .	muzycznego	5	Gen
Nowi ustne rozpoczęli od geografii .	Nowi	0	Nom
Cena wywoławcza czarnego watermana ze złotą stalówką wynosiła 300 zł .	czarnego	2	Gen
Małgorzata chodziła w letniej sukience na ciepłym wietrze .	letniej	3	Loc
Lepper spotkał się wczoraj z rolnikami w Malechowie w województwie zachodniopomorskim .	zachodniopomorskim	10	Loc
W Małej Komorzy z tego powodu zapaliły się sadze .	Małej	1	Loc
Nadleśnictwa z terenu powiatu tucholskiego odwołały zakaz wstępu do lasu .	tucholskiego	4	Gen
- Dali śmy Kwaśniewskiemu szansę , bo mówił dużo o prostych ludziach .	prostych	10	Loc
Sklejka , która była tegorocznym pewniakiem do prywatyzacji , nie ma żadnego szefa .	tegorocznym	4	Ins
Sama wymyśliła m przepis na moje najukochańsze ciasto .	najukochańsze	6	Acc
Decyzja zapadła , mimo że szefowie tajnych służb ostrzegli , iż Palestyńczycy wyjdą na ulice .	tajnych	6	Gen
Nie narzeka na brak pomysłów twórczych .	twórczych	5	Gen
Stan rannych jest stabilny .	stabilny	3	Nom
Leki na obniżenie temperatury nie działały , a sytuacja , według słów Havlovej , w nocy z poniedziałku na wtorek stała się krytyczna .	krytyczna	22	Nom
Generalnie znacznie lepiej wypadły kąpieliska w województwie zachodniopomorskim .	zachodniopomorskim	7	Loc
Pan stoi przed życiową szansą .	życiową	3	Ins
Tempo zajęć programowych wzrasta .	programowych	2	Gen
Jednocześnie polecił zająć się milicjantem prowadzącym śledztwo .	prowadzącym	5	Ins
Niech płaszczą się przed groźnym wieprzem !	groźnym	4	Ins
Na terenie przyległym do Kolonii Wierzbicy znajdują się dwie garbarnie .	przyległym	2	Loc
Kobieta otworzyła drzwi , wpuściła do środka czarnowłosego mężczyznę .	czarnowłosego	7	Acc
Jak planował , pojechał do Jurka wczesnym popołudniem .	wczesnym	6	Ins
– to było takie niewinne zupełnie . .	niewinne	4	Nom
W piątek , sobotę i niedzielę będziemy wspólnie świętować 1000-lecie Biskupstwa Wrocławskiego i 1000-lecie Wrocławia .	Wrocławskiego	11	Gen
Zaczynam odczuwać tęsknotę za utworami o głębszej treści i większym sensie .	głębszej	6	Loc
– Ktoś polał drzwi do mieszkania łatwopalną substancją i podpalił .	łatwopalną	6	Ins
Dopiero po 5 minutach zamieszanie zostało opanowane przez policję .	opanowane	6	Nom
Sześć cebul kupiła na kiermaszu zorganizowanym w pobliskiej szkole .	zorganizowanym	5	Loc
Sztuka miała premierę w maju 2001 .	2001	5	Gen
Wobec niektórych z notowanych firm toczy się obecnie postępowanie upadłościowe .	upadłościowe	9	Nom
Kontrakty te są nowym instrumentem polityki rozwoju regionalnego .	regionalnego	7	Gen
W ten sposób mieli oni zakończyć dwuletnie studia podnoszące kwalifikacje zawodowe .	zawodowe	10	Acc
Zaprószono ogień i wybuchł poważny pożar na górnych piętrach .	Zaprószono	0	Nom
Polskie zasady zestrzeliwania opisano w niewielkiej czerwonej książeczce .	niewielkiej	5	Loc
Dziś , patrząc na Koło Polskie w Dumie , jesteśmy raczej bezradni .	Polskie	5	Acc
Nie zatamujesz krwi fałszywym bandażem .	fałszywym	3	Ins
Dla pozostałych autobusów jadących w kierunku Śródki , dopuszczony zostanie przejazd ul . Estkowskiego .	jadących	3	Gen
Julek okazał się mniej drażliwy .	drażliwy	4	Nom
Mora nie był urodziwy .	urodziwy	3	Nom
Oto wybiera się sierota z całą gromadą kopać na hrabiowskich redlinach .	hrabiowskich	9	Loc
Stanął na górnej płycie .	górnej	2	Loc
Radar emituje impulsy fal radiowych , rozchodzących się z prędkością światła .	radiowych	4	Gen
Rozdzielali zwaśnione strony w ramach misji pokojowych ONZ .	zwaśnione	1	Acc
Możesz włożyć granatową .	granatową	2	Acc
Jest ona znacznie trudniejsza i bardziej skomplikowana .	trudniejsza	3	Nom
Wielka kanalizacja gminy Tychowa to najnowsza inwestycja tutejszych władz .	tutejszych	7	Gen
Czyżby jakieś złe moce zawisły nie tylko nad publicznymi mediami , ale również nad Warszawiakami ?	publicznymi	8	Ins
Będzie matka Agnieszka kontenta . . .	kontenta	3	Nom
Słyszysz żałosne skargi głodnych i złaknionych zwierząt ?	żałosne	1	Acc
Nie były nigdy wydawane , przechowywali śmy je w archiwum rodzinnym .	rodzinnym	10	Loc
Dla zdrowia psychicznego i fizycznego trzeba wówczas chwilowo panią uśpić .	fizycznego	4	Gen
Lekcja kończy się rozczarowaniem , ale mistrz wydaje się daleki od rezygnacji .	daleki	9	Nom
Równocześnie wznoszono nowoczesne dzielnice mieszkaniowe .	wznoszono	1	Nom
Ze stara wyciekał olej i płyn chłodzący , a przyczepa miała zdemontowany hamulec awaryjny .	awaryjny	13	Acc
Wraz z kolejnymi minutami potrawa zmieniała się z płynnej w coraz bardziej stałą .	stałą	12	Acc
Na krześle siedzi smutny , zrezygnowany człowiek .	smutny	3	Nom
Swoja drogą można by przełożyć ją na lato , można by tłoczyć jakieś bułgarskie winogrona , przynajmniej wino nie byłoby takie cierpkie .	bułgarskie	13	Acc
Innej alternatywy nie ma , a wszelkie marzenia o samodzielnej roli quasi-mocarstwowej Polski są tylko rojeniami fantastów .	Innej	0	Gen
Wszystko tu było zrobione z myślą o wygodzie i miłosnych uciechach .	miłosnych	9	Loc
Bił tak mocno , że złamał kij bejsbolowy .	bejsbolowy	7	Acc
W Gnieźnie w sylwestrowy wieczór zginęli podczas pożaru trzej chłopcy , a jadący do akcji samochód strażacki wpadł na dwie kobiety .	jadący	12	Nom
Jeżeli człowiek silnie reaguje na różne zjawiska , może być tak odbierany .	odbierany	11	Nom
Dla światowych producentów odzieży Polska staje się coraz ważniejszym rynkiem zbytu .	światowych	1	Gen
Wśród tradycjonalistów muzułmańskich z państw Półwyspu Arabskiego wywołało ono szok .	Arabskiego	6	Gen
Osobiście poznała m swojego zaciekłego wroga .	zaciekłego	4	Acc
Transmisja z jego strony szła przez dwa serwery anonimizujące , mógł przebywać w dowolnym miejscu na Ziemi .	anonimizujące	8	Acc
Wydawała mi się bezbronna i tak strasznie niezaradna !	bezbronna	3	Nom
Tymczasem w liceach prowadzonych przez Społeczne Towarzystwo Oświatowe zdanie egzaminu dojrzałości nie należy do najłatwiejszych .	Społeczne	5	Acc
Dlaczego posłowie nie powinni płacić mandatów w postępowaniu mandatowym ?	mandatowym	8	Loc
Właśnie zakończył się trzeci , diecezjalny etap konkursu .	trzeci	3	Nom
Odziedziczyła ona po bracie majątek w Galicji , uprzemysłowiony i dający duże profity .	dający	10	Acc
Są bardzo niebezpieczne , ich wybuch spowodowałby falę uderzeniową o promieniu do jednego kilometra .	uderzeniową	8	Acc
Z pozostałymi członkami dawnego kierownictwa związanymi z Gomułką plenum obeszło się bezceremonialnie , usuwając ich w większości ze składu KC .	pozostałymi	1	Ins
Nieprzytomną odwieziono do szpitala przy ul. Unii Lubelskiej .	Nieprzytomną	0	Acc
Pozostaje wreszcie problem walorów dydaktycznych książki .	dydaktycznych	4	Gen
Dziecko się zrobiło nerwowe po tych przejściach .	nerwowe	3	Nom
Prokuratura Apelacyjna współpracuje w tej sprawie z oddziałami CBŚ we wspomnianych miastach i Urzędami Kontroli Skarbowej .	Apelacyjna	1	Nom
Od trzeciego rozbioru Polski do odzyskania niepodległości minęły 123 lata .	trzeciego	1	Gen
Nie puszczamy w powietrze materiałów obciążających .	obciążających	5	Gen
Zrobiła to , bo skazany jest wzorowym więźniem .	wzorowym	6	Ins
To pleban kawęczyński jechał dwukonnym wózkiem do miasta .	dwukonnym	4	Ins
W tej sprawie proszę rozmawiać z oficerem prasowym !	prasowym	7	Ins
Marian patrzył prosto na mnie swymi dziecinnie niebieskimi oczami .	niebieskimi	7	Ins
Nie kieruję się przy tym ideologią wegetariańską , choć z nią sympatyzuję .	wegetariańską	6	Ins
Kłaniając się przepraszająco , opuścili śmy z panem Adamkiem zakład pogrzebowy .	pogrzebowy	10	Acc
- Od dłuższego czasu w środowisku prawniczym szeroko komentowano zniszczenie umorzenia .	prawniczym	6	Loc
Deser zostanie podany po sprzątnięciu talerza głównego .	podany	2	Nom
W tych pierwszych związkach nastolatki doświadczają smaku ludzkiej miłości , odkrywają siłę fascynacji i wzajemnego przyciągania siebie .	wzajemnego	14	Gen
Przebieg incydentu został sfilmowany przez reportera rosyjskiej prywatnej telewizji NTV .	prywatnej	7	Gen
Czy jej brak ma istotny wpływ na jakość amerykańskiego systemu szkolnictwa wyższego ?	amerykańskiego	8	Gen
Z całego nakładu książki Witkacego wycięto stronę przedtytułową .	przedtytułową	7	Acc
Czy przyszłość świata należeć będzie do narodów ubogich , ale licznych i młodych ?	licznych	10	Gen
Próba przekroczenia granicy Rzeczypospolitej przez grupę kolarzy spod znaku UPA wywołała ogólnopolskie oburzenie .	ogólnopolskie	11	Acc
- Nie jestem typowym jazzmanem , choć tak bywam oceniany .	typowym	3	Ins
Niestety był to wpływ negatywny , pogłębiający istotniejące już uprzedzenia .	istotniejące	7	Acc
Woda dokoła niej poróżowiała od zmytego kurzu .	zmytego	5	Gen
Twierdzą , ze sprawa jest rozwojowa .	rozwojowa	5	Nom
- Brak nam jeszcze wielu umów z gospodarzami indywidualnymi . . .	indywidualnymi	8	Ins
– Dziadek zagrzmiał swoim głosem basowym .	basowym	5	Ins
Niewątpliwie jest to jedyna użytkowa wartość porozumienia sprzed lat .	użytkowa	4	Nom
Samoobrona i PSL znalazły się poniżej progu wyborczego .	wyborczego	7	Gen
Starem z przyczepą załadowaną piaskiem kierował kursant .	załadowaną	3	Ins
– Musiałbym być szalony , żeby ci powiedzieć .	szalony	3	Nom
Firma Connex świadczy usługi transportowe w Polsce od roku 1998 .	1998	9	Gen
Niemiecka liga hokeja należy do jednej z najlepszych lig w Europie .	Niemiecka	0	Nom
Na ekranie TV , na zatrzymanej stop–klatce Jurka Kilera idą napisy końcowe programu .	zatrzymanej	5	Loc
Sylwetka Golfa w porównaniu z agresywnymi liniami Focusa wygląda spokojnie , ale jego bryła może być uznana za ponadczasową .	agresywnymi	5	Ins
Ale nawet najwięksi krytycy Rutkowskiego chwalą jego zdolności autoreklamiarskie .	autoreklamiarskie	8	Acc
Nadal jednak będzie PSL przeciwnikiem gospodarki wolnorynkowej , partią w podejściu do gospodarki lewicową .	lewicową	13	Ins
Podobny spis już istnieje .	Podobny	0	Nom
Spłata pozostałych 80 proc . zostałaby odroczona do 30 czerwca 2005 roku .	odroczona	6	Nom
Oto ja , sponiewierana i przeklęta Żydówka , błagam was o litość .	sponiewierana	3	Nom
Spędź godzinę z piękną dziewczyną , a wyda ci się minutą .	piękną	3	Ins
Wyróżniał się licznymi szybami górniczymi , kryjącymi w swych wnętrzach wieże wyciągowe i windy do przewozu ludzi i węgla .	licznymi	2	Ins
Prokuratura ma też kilka filmów nagranych amatorskimi kamerami .	amatorskimi	6	Ins
Samozwańczy gliniarz posługuje się oryginalną legitymacją .	Samozwańczy	0	Nom
Nie znam ani dwóch sprawiedliwych !	sprawiedliwych	4	Gen
Szczekały przez długi czas wśród jasnej od księżyca nocy .	długi	2	Acc
Dolną część garderoby osłaniamy papierowymi ręcznikami , aby nie pobrudzić jej później jajkami .	Dolną	0	Acc
Mogła sobie w nim utłuc rokokowym samojebem dziecko z krwi , spermy i chromosomów śliny .	rokokowym	5	Ins
Niewiele brakowało , by zaproponowała odstrzał niegrzecznych myśliwych polujących na kuropatwy .	polujących	8	Gen
Trzy lata temu rozstał się z górniczą spółką mieszkaniową w Nikiszowcu .	górniczą	6	Ins
I tym razem Gagarin zniósł ją ze stoickim spokojem .	stoickim	7	Ins
Znaczenie ma także wielkość akumulacji zimowej .	zimowej	5	Gen
Popierają regionalne środowiska twórcze .	twórcze	3	Acc
Dla oddziału chirurgicznego znajdującego się na pierwszym piętrze jest to siedziba tymczasowa .	chirurgicznego	2	Gen
Przechodnie patrzyli obojętnie na nieszczęśliwe zwierzę .	nieszczęśliwe	4	Acc
Drzwi do łazienki , wyjęte z zawiasów , stały oparte o ścianę .	wyjęte	4	Nom
Społeczność ludzka funkcjonuje w strukturach zapewniających formę organizacyjną .	zapewniających	5	Loc
Innym razem pojechała z Kaharem do portu Xiamen na południu Chin , gdzie kupili trzy japońskie magnetowidy .	japońskie	15	Acc
Do obserwatorium waszyngtońskiego ściągały tłumy ciekawych .	ciekawych	5	Gen
Niosło wonią smoły i wodorostów , woda pluskała cicho o łódki przywiązane do omszałych pali .	omszałych	13	Gen
Napisałaby więc z pewnością o Bali , co się stało w Kucie , tuż przy głównym deptaku .	głównym	15	Loc
Zbierał te suche rozstajne krótkie drogi , wiązał w pokaźne drapadła o ściśniętym kierunku .	ściśniętym	12	Loc
Prowadzi to do nietolerancji laktozy i poważnych zaburzeń w trawieniu .	poważnych	6	Gen
Hodowla owiec jest do dzisiaj jedną z głównych gałęzi gospodarki tych nadal słabo zaludnionych rejonów .	jedną	5	Ins
Wysyłam je najczęściej za pośrednictwem konduktorów autobusowych .	autobusowych	6	Gen
Zarząd Telekomunikacji Polskiej ustami rzecznika prasowego , Piotra Gawrona , podkreśla , że nie jest stroną w sporze między związkami i rządem .	prasowego	5	Gen
Na progu stał wysoki , zarośnięty mężczyzna .	zarośnięty	5	Nom
Tymczasem korki paraliżują okolice ul . Saskiej , bo kierowcy , aby dostać się na Wał , muszą dojechać na niego wąskimi ulicami Saskiej Kępy .	wąskimi	21	Ins
– Najpierw chciałbym sprawdzić jakość tego francuskiego łóżka .	francuskiego	6	Gen
Kupili jakieś zmiotki w ruskiej hurtowni i zbijają na mnie kasę .	ruskiej	4	Loc
W inscenizację umiejętnie wkomponowano wspomnienia nauczycieli i byłych uczniów .	byłych	7	Gen
- Tomek był pogodnym , uśmiechniętym dzieckiem .	pogodnym	3	Ins
Nie trzeba wielkiej przenikliwości , aby się domyślić , że Anglicy przeprowadzają rewizję .	wielkiej	2	Gen
Policja prowadzi w tej sprawie intensywne śledztwo .	intensywne	5	Acc
Komputery podłączone do Sieci mogą skorzystać z okna zadań badawczych .	podłączone	1	Nom
Jego wiarygodność sprawdzono poprzez Krajową Izbę Gospodarczą .	sprawdzono	2	Nom
Na tych przejazdach woda była płytka , ale dno piaszczyste nie groziło uszkodzeniem łodzi .	płytka	5	Nom
Chociaż pamiętał ją , jak w ubiegłym roku jeszcze brała się za kosę .	ubiegłym	6	Loc
Na tegorocznym inauguracyjnym balu tradycyjnego karnawału w Rio pracowały równolegle dwie komisje sędziowskie .	sędziowskie	12	Nom
Zerwałem suchą trawkę i zacząłem ją powoli żuć .	suchą	1	Acc
Wszystkie cztery podstawowe tezy scholastyczno - tomistycznej koncepcji Boga uległy w nowożytnej filozofii gruntownemu zakwestionowaniu .	tomistycznej	6	Gen
- Z naszych danych wynika , że przybywa kontraktów denominowanych w złotych .	denominowanych	9	Gen
Teraz składamy paskowy patchwork , ocieplenie i podszewkę , zszywamy wzdłuż prostego brzegu i obszywamy lamówką .	prostego	11	Gen
Idziemy z mieszkańcem Sławogóry Starej po gruntowej drodze .	Starej	4	Gen
Po tym orzeczeniu na scenę wkroczył Ogólnopolski Związek Zawodowy Lekarzy .	Zawodowy	8	Nom
Skałki Kroczyckie są miejscem treningów członków śląskich klubów wysokogórskich .	Kroczyckie	1	Nom
Pogładził łaskawą pieszczotą wyślizgane drewienka .	łaskawą	1	Ins
Na poszczególnych lodowcach warunki lokalne modyfikują tę zależność .	poszczególnych	1	Loc
Sprytny oszust jest przekonujący , swym ofiarom proponuje pozostawienie obrączki lub innej bezwartościowej rzeczy w zastaw i zwrot gotówki za kilkadziesiąt minut .	bezwartościowej	12	Gen
W milczeniu spożywali zimną konsolację , szczękały sztućce , dworscy w ciemnych surdutach sprawnie zmieniali misy .	ciemnych	11	Loc
Nad każdym , nawet najkrótszym tekstem medytuję .	najkrótszym	4	Ins
Przedostatni figuruje Artur Balazs , poseł i minister rolnictwa , a zamyka ją Stefan Oleszczuk z UPR-u , starosta kamieński .	kamieński	19	Nom
Skończyłem już na dzisiaj działalność ostatnich dwóch tygodni , teraz będę miał trochę luzu , ale będę gdzieś tak między jedenastą , a czwartą .	czwartą	23	Ins
Niebo powleka się rudożółtą oponą .	rudożółtą	3	Ins
Sprawą zainteresował się referat I-szy i przez kontrolę korespondencji może uzyskamy dalsze miejsca zachowanych rzeczy .	zachowanych	13	Gen
Styl ten też uwzględniłby edukacyjny rozwój jednostki .	edukacyjny	4	Acc
Około 15 km za Nag–czu , boczną , terenową drogą dojechali śmy do pasterskich namiotów .	terenową	8	Ins
Miał rasowego ogiera .	rasowego	1	Acc
Chyba przyznasz , że przyjemniej obcuje się z osobami myślącymi i sympatycznymi .	myślącymi	9	Ins
My jesteśmy za biedni !	biedni	3	Nom
Użytkownik ma do dyspozycji 6 baz zawierających informacje posortowane według wybranego kryterium .	posortowane	8	Acc
Po decyzji parlamentu zawiesiły działalność polityczną Batasuny .	polityczną	5	Acc
Śmieszy mnie ta zabawa w barbarzyńcę , bezmyślne opróżnianie butelek pod krzyżówkę Mickiewicza z amerykańskim hamburgerem .	amerykańskim	14	Ins
Związany z kapistami , wielokrotnie jednak przekraczał wyznaczone przez nich malarskie granice .	Związany	0	Nom
W ubiegłym roku trzynastki pochłonęły 54.537 złotych .	ubiegłym	1	Loc
Przechodził on długą ewolucję , stając się najpopularniejszym tanim zegarkiem .	najpopularniejszym	7	Ins
Inwestycję wznowiono w połowie 2004 roku , a wartość zadania wynosi 5,6 miliona złotych .	2004	4	Gen
Pędzę do pokojówki z tą hiobową wieścią .	hiobową	5	Ins
Są to placówki przeważnie prowadzące działalność pensjonatowo - hotelową .	hotelową	8	Acc
Początkowo zapanował iście świąteczny nastrój .	świąteczny	3	Nom
" Życie jest zbyt krótkie , żeby pić liche wina " .	liche	8	Acc
Suchy polder jest łatwiejszy i bezpieczniejszy w eksploatacji .	Suchy	0	Nom
Dach przypomina fale morskie , które często zdobią japońskie drzeworyty .	japońskie	8	Acc
Rannymi cywilami zaopiekowali się najpierw amerykańscy sanitariusze z personelu naziemnego .	Rannymi	0	Ins
Wikipedia , nasz siostrzany projekt , zawiera artykuł na temat nawozów zielonych .	siostrzany	3	Nom
Powinna wierzyć , że jej mąż żyje , a te biedne zwłoki należą do kogoś innego . . .	innego	15	Gen
Czyżby teraz przepuściła okazję , mając tuż obok przystojnego młodego mężczyznę ?	przystojnego	8	Acc
A teraz , przez tę ciążę , jesteśmy uziemieni .	uziemieni	8	Nom
W 1993 roku , jeżeli zostanie utrzymana dyscyplina finansowa , prognoza CUP może okazać się realna .	1993	1	Loc
Rozpada się dawny czas , nic po nim nie pozostaje .	dawny	2	Nom
Zarodniki grzybów pleśniowych wywołują przede wszystkim zapalenie śluzówek nosa z niedrożnością , polipy nosa i zatok , ale też astmę o ciężkim przebiegu .	pleśniowych	2	Gen
Patrzyła biernie , nie widząc niczego , na mijające za oknem podmiejskie pejzaże .	podmiejskie	11	Acc
Miałby on wspierać uczniów uzdolnionych , którzy mają trudności z kontynuowaniem nauki z przyczyn rodzinnych czy ekonomicznych .	uzdolnionych	4	Acc
Małe zeugle nie są niebezpieczne .	Małe	0	Nom
Jeżeli jeszcze przed dwudziestu laty w zasadzie obowiązywała surowa formalna wykładnia przepisów kanonicznego prawa małżeńskiego , to obecnie stosuje się wykładnię rozszerzającą , a więc łagodną .	rozszerzającą	21	Acc
Pannę Wiosnę rozpiera młodzieńcza energia .	młodzieńcza	3	Nom
Projekt zakończył się uroczystym śniadaniem wielkanocnym .	uroczystym	3	Ins
- Małą miss została Klaudia Zdunek !	Małą	1	Ins
Tak to przynamniej wynika z danych statystycznych zebranych przez Komendę Wojewódzką Policji w Szczecinie .	Wojewódzką	10	Acc
Oczywiście , określenie to jest bardzo umowne .	umowne	6	Nom
Wódz Samoobrony ma być umoczony w molestowanie seksualne .	seksualne	7	Acc
Uszkodzone zostały wówczas 932 zabytkowe drzewa .	zabytkowe	4	Nom
Bawi się Pan w kolejnego kundelka UPR-u ?	kolejnego	4	Acc
Jego stałym zastępcą jest oficer G3 .	stałym	1	Ins
Maluch jest zdrowym chłopcem .	zdrowym	2	Ins
Te wątki pojawiają się też w poselskim projekcie .	poselskim	6	Loc
Z głębin morza dalekich a z bełku przepadłego powrócił , żeby u stopy braterskiej jasne czoło położyć .	dalekich	3	Gen
W tym roku prawdziwa zima wyprzedziła kalendarzową .	kalendarzową	6	Acc
Choinka mieni się różnobarwnie , z bożonarodzeniowego bierwiona w kominku bije przytulne ciepło .	bożonarodzeniowego	6	Gen
Zawsze czuł wobec tych urządzeń jakiś instynktowny lęk .	instynktowny	6	Acc
Chcą nam obciąć 200 ton i dać gorszy .	gorszy	7	Acc
Być lojalnym .	lojalnym	1	Ins
Następuje przewartościowanie z wymiaru duchowego na materialny .	duchowego	4	Gen
Narconon to najskuteczniejszy program , jaki wymyślono .	najskuteczniejszy	2	Nom
Specjalne brygady w maskach i odzieży ochronnej nadzorowały rzeź ptactwa i dezynfekcję bazarów , targowisk , sklepów i środków transportu .	ochronnej	6	Loc
– Zakładamy klub muzyczny .	muzyczny	3	Acc
Skupieni operatorzy delikatnie manipulowali skomplikowanymi urządzeniami odbioru przekazywanej informacji .	przekazywanej	7	Gen
Rafał Blechacz zapowiedział , że w niedzielę palmową ma zamiar zagrać kolejny ważny koncert .	palmową	7	Acc
Stali się dwujęzyczni .	dwujęzyczni	2	Nom
Myślałem , że pan jest poważnie myślącym młodym człowiekiem .	młodym	7	Ins
Tegoroczną nowością raportu jest skala krajowego seksu wirtualnego .	Tegoroczną	0	Ins
Okazało się , że 22-latek jest żołnierzem służby czynnej .	czynnej	8	Gen
- W naszej drużynie nie ma gwiazd , potrzebni są ludzie nieprawdopodobnie zaangażowani w grę .	zaangażowani	12	Nom
W kilkusetosobowej kolumnie obok mężczyzn idą kobiety i dzieci .	kilkusetosobowej	1	Loc
Ofiary następnej deportacji to rodziny represjonowanych .	represjonowanych	5	Gen
Trzech sprytnych chłopców szukało nawet syrenki w przedszkolnym akwarium .	przedszkolnym	7	Loc
Kuczma oświadczył , że gospodarka będzie reformowana na zasadach rynkowych .	rynkowych	9	Loc
IZABELLE ADJANl , gwiazda filmu francuskiego , wygrała precedensowy proces .	precedensowy	8	Acc
Burmistrz , Zbigniew Grzesiak , wyjaśnił , że są trudności w porozumieniu się z Urzędem Rejonowym .	Rejonowym	15	Ins
Powrócono do szkoleń politycznych , na których trzeba było walczyć z wszechogarniającą sennością .	wszechogarniającą	11	Ins
Po miesiącu zdałam egzamin i przeniesiono mnie do drugiej klasy , do innej szkoły .	przeniesiono	5	Nom
Czy Dominik , broniąc się , mógł przewidzieć aż tak dramatyczne skutki ? !	dramatyczne	10	Acc
Podniosła m oczy znad talerzyka z malinami , posypanymi cukrem .	posypanymi	8	Ins
Świadek ten był wezwany na wniosek Rzecznika Interesu Publicznego .	Publicznego	8	Gen
Wczoraj w podobnych okolicznościach wpadł technik Wydziału Kryminalnego w Nowym Mieście Lubawskim .	Lubawskim	11	Loc
W tym roku pojawiły się one w całym powiecie kwidzyńskim .	kwidzyńskim	9	Loc
Przedsiębiorcę z Barda niepokoi , że w obrocie gospodarczym brakuje pieniędzy .	gospodarczym	8	Loc
Dzieci zaczepiali na katowickim dworcu PKP .	katowickim	3	Loc
Po odbyciu kary Zdankiewicz znów brylował w podrzędnych knajpach .	podrzędnych	7	Loc
Aby udowodnić winę osobie opalającej zabronionymi materiałami , należałoby przeprowadzić specjalistyczne badania wydobywającego się z komina dymu .	specjalistyczne	10	Acc
Obaj skrupulatnie przepisywali rezultaty kolejnych odcinków specjalnych , by w pokojach hotelowych dokładnie je przeanalizować .	specjalnych	6	Gen
Wzrośnie w tym roku dostępność studiów wyższych .	wyższych	6	Gen
Jest najwyższym mężczyzną w oddziałach Agencji Restrukturyzacji i Modernizacji Rolnictwa w Polsce .	najwyższym	1	Ins
Jeszcze przez kilka minut starali się uporać z doznaną porażką i dramatyczną decyzją Beatki .	doznaną	8	Ins
W akcji ratunkowej uczestniczyło ok. 20 ratowników .	ratunkowej	2	Loc
Wykręcił się na pięcie i wybiegł na dwór z rozpaloną głową .	rozpaloną	9	Ins
Wchodzimy w wiraż , coraz bardziej zbliżając się do sklepienia kanału , które naraz przybiera jaskrawoniebieski kolor z domieszką fosforyzującego fioletu .	jaskrawoniebieski	15	Acc
Nagle wzrok funkcjonariusza padł na pudło z płytami kompaktowymi bez hologramów .	kompaktowymi	8	Ins
Był to jego debiut w tak wysokich rozgrywkach ligowych .	wysokich	6	Loc
Była w deszczowym płaszczu i w obcisłej , skórzanej czapeczce .	obcisłej	6	Loc
Niedzielny wieczór to wielki koncert w Auli UAM .	Niedzielny	0	Nom
43-letni młodszy brygadier dmuchnął w alkomat .	młodszy	1	Nom
Kiepsko wyglądała , musiała być wykończona tą dobą .	wykończona	5	Nom
Rozpoczyna się teraz emocjonujący wyścig ze zbliżającą się burzą .	zbliżającą	6	Ins
Przypuszczam , że akurat to pytanie jest , Panie Senatorze , trochę przedwczesne .	przedwczesne	12	Nom
Jak się mówi potocznie o facecie z małymi jajami ?	małymi	7	Ins
W zbiorach muzeum jest także sztandar straży ogniowej oraz wiele pamiątkowych zdjęć .	pamiątkowych	10	Gen
Ojciec był zapalonym myśliwym i często wybierał się na polowania , zasilając w ten sposób naszą spiżarnię .	zapalonym	2	Ins
Wjeżdżamy między niechlujne zabudowania Płaszowa .	niechlujne	2	Acc
Skończył technikum budowlane , klasę konstrukcji stolarskich .	stolarskich	6	Gen
Dzień później trener Bogdan Pamuła zabrał swoich podopiecznych , tym razem pod sztandarem juniorskim , na mecz do Przemyśla .	juniorskim	13	Ins
Wiślacy zgnietli niemiecką drużynę siłą ofensywy .	niemiecką	2	Acc
Przypomnijmy , że przed laty Jelcyn nie wysiadł na spotkanie z irlandzkimi władzami .	irlandzkimi	11	Ins
Obaj skrupulatnie przepisywali rezultaty kolejnych odcinków specjalnych , by w pokojach hotelowych dokładnie je przeanalizować .	hotelowych	11	Loc
Polacy jadący w autokarze spoglądają z nietajoną dumą na wielkiego rodaka .	nietajoną	6	Ins
Niestety , niektórzy czytelnicy wierzą , że mogła m takie głupawe wierszydło napisać .	głupawe	10	Acc
Stanowi to 0,7 proc . budżetu państwa i jest najniższą od trzech lat sumą przeznaczaną na kulturę .	przeznaczaną	14	Ins
Kasprowicz opuścił Wrocław i wyjechał do rodzinnego Szymborza .	rodzinnego	6	Gen
Małachowski zarzuca Kościołowi milczenie wobec wystąpień nacjonalistycznych i antysemickich .	antysemickich	8	Gen
Myślałem , że pan jest poważnie myślącym młodym człowiekiem .	myślącym	6	Ins
Świat z coraz większym trudem akceptuje trwającą na drogach hekatombę i związane z tym straty ekonomiczne .	większym	3	Ins
Załogi z niepokojem śledzą ciche chmury nadchodzące z południa .	nadchodzące	6	Acc
Wojewódzki Inspektorat IH był pierwszym w Polsce , który jeszcze na podstawie starych przepisów zawarł porozumienie z Polskim Towarzystwem Towaroznawczym .	Towaroznawczym	19	Ins
Brzegi chodników były zastawione ławkami .	zastawione	3	Nom
W naszej kantynie fabrycznej zmniejszono nam obiad o jedno danie .	jedno	8	Acc
Na tegorocznym inauguracyjnym balu tradycyjnego karnawału w Rio pracowały równolegle dwie komisje sędziowskie .	tegorocznym	1	Loc
Wypada być chudą , bladą , melancholijną .	bladą	4	Ins
Błyskawicznie usunąłem plastikowe kliny i wyjąłem szybę z ramy .	plastikowe	2	Acc
Finansowo wspiera Trutnia Gminny Ośrodek Kultury w Rabie Wyżnej , a także skawiańscy biznesmeni z Polski i Chicago .	skawiańscy	12	Nom
W 1972 r. wraz z kolegami wpadł podczas rozlepiania ulotek na mieście .	1972	1	Loc
Wykonany z asferycznych soczewek ze szkła fluorytowego , pozwala na uzyskanie bardzo dobrej jakości obrazu .	dobrej	12	Gen
Obaj byli wysocy , zwaliści , misiowato potężni .	potężni	7	Nom
Nie mogła się mylić , bo odbite od łez światło dawało wyraźny błysk .	wyraźny	11	Acc
Niewątpliwie najbardziej okazałym egzemplarzem dysponował Henry Fischer z Berlina .	okazałym	2	Ins
Uzdrowienie sfery seksualnej nie dokonuje się jednak przez jednorazowy zryw duchowy .	jednorazowy	8	Acc
Ale centroprawica powinna być siłą całkowicie autonomiczną .	autonomiczną	6	Ins
- Słuchaj , ty pewnie wyższą akademię talmudyczną w Mirze ukończył eś ?	wyższą	5	Acc
Wirują mu musztardowe księżyce i słońca , a na samym dole żagla zjawia się łeb wieloryba o mikroskopijnych , czerwonych oczach .	mikroskopijnych	17	Loc
- Powiewy bliskich gór przyniosły mu buntownicze słowa chłopskiej pieśni , zasłyszanej w dzieciństwie .	bliskich	2	Gen
U młodej dziewczyny psychiatra z Modusa rozpoznał początki choroby psychicznej , dziewczyna myśli o samobójstwie .	młodej	1	Gen
Jedli śmy te doskonałe ogórki i zapijali śmy wódką .	doskonałe	3	Acc
Zaniepokojona , otworzyła oczy .	Zaniepokojona	0	Nom
Główne dowództwo niemieckie musi objąć kierownictwo operacji wojennych we Włoszech .	niemieckie	2	Nom
W tych okolicznościach , po gruntownym przeanalizowaniu sytuacji , widział em przed sobą dwie drogi .	gruntownym	5	Loc
Złoty medal w kategorii do 68 kilogramów zdobyła Kamila Zgolak .	Złoty	0	Acc
– Leżał na rękawicach ochronnych i też był popaprany ziemią .	ochronnych	4	Loc
Wszystkie mówią o srebrnym terenowym samochodzie .	terenowym	4	Loc
W wózku wiozła 13-miesięcznego synka .	13-miesięcznego	3	Acc
Wtedy wydawało mi się to nadmierną ostrożnością .	nadmierną	5	Ins
Osiełek chce połknąć tajemniczą kartkę .	tajemniczą	3	Acc
W dwie godziny później Ania i Norbert siedzieli w fotelach w pokoju gościnnym przy łóżku Karoliny .	gościnnym	12	Loc
W okresie międzywojennym pałac w Kadynach nie był zamieszkały .	międzywojennym	2	Loc
Stąd też Jego narodzenie powinno przypadać 25 grudnia .	25	6	Gen
Ze ścian mrugają kolorowe neony świąteczne w kształcie choinek , bombek i dzwonków .	kolorowe	3	Nom
Faceci wyglądają na prawdziwych twardzieli .	prawdziwych	3	Acc
WDT jest państwową jednostką organizacyjną nieposiadającą osobowości prawnej .	nieposiadającą	5	Ins
W XVII wieku hikyaku , czyli kurierzy , doręczali przesyłki feudalnym władcom .	XVII	1	Loc
Podstawowym zadaniem straży granicznej jest kontrola ruchu granicznego .	granicznego	7	Gen
Po zetknięciu z ziemią maszyna wybuchła , a siła eksplozji wyrzuciła dwóch słowackich mechaników i Marka Panasia .	słowackich	12	Gen
Wiadomo , że w tym roku uczniowie będą zdawać albo starą , albo nową maturę .	nową	13	Acc
Andrzej podjął nagłą decyzję .	nagłą	2	Acc
Po jego obu bokach zwisają nawleczone na sznur perły nazywane Paternoster .	nazywane	9	Nom
Podobno były nawet pokazywane na wystawie przemysłowej , która odbyła się tu w zeszłym roku .	przemysłowej	6	Loc
Niepokojącym zjawiskiem jest mieszanie różnych narkotyków oraz rozpuszczanie ich w alkoholu .	Niepokojącym	0	Ins
Sekretarz Łapa społecznie działa w poradni małżeńskiej , ale z podobnym postępowaniem kobiety nie spotkał się .	podobnym	10	Ins
Jego usuwaniem zajęli się strażacy ze specjalistycznym sprzętem .	specjalistycznym	6	Ins
Rannymi cywilami zaopiekowali się najpierw amerykańscy sanitariusze z personelu naziemnego .	Rannymi	0	Ins
Policja przypuszcza , że najnowszy ładunek został porzucony przez spłoszonego niedoświadczonego terrorystę .	niedoświadczonego	10	Acc
Wykorzystując przerwę w popołudniowych grach , Agassi i Graf zrobili sobie małą sesję treningową .	popołudniowych	3	Loc
Rozpuszcza się w roztworach cyjanków metali alkalicznych .	alkalicznych	6	Gen
Nagrobek zniszczono podczas pospiesznej rozbiórki opactwa w 1529 roku .	1529	7	Loc
A już na pewno z racji tej uczoności w 1456 roku dostał katedrę teologii , na której pozostał do końca dni swoich .	1456	9	Loc
Drugi pod względem kapitalizacji giełdowej Wielkopolski Bank Kredytowy osiągnął bardzo dobrą miesięczną dynamikę zysków wynoszącą 81,4 proc .	miesięczną	11	Acc
Daniel dobrze pamiętał najstarszego .	najstarszego	3	Acc
W ubiegłym roku bracia Lunelli osiągnęli kolejny pułap .	ubiegłym	1	Loc
Istotą rozmów o sprawach seksualnych jest klimat zaufania i szczerości .	seksualnych	4	Loc
Jadę do Katowic w sprawach różnych , poprzecznych i podłużnych , jak mówią moje dzieci .	podłużnych	9	Loc
Katarakta nocy zasnuwa każdą rubinową szybkę witrażowej rozety nad portalem .	witrażowej	6	Gen
Szkolenie odbędzie się jutro o godz . 10 w sali konferencyjnej Starostwa Powiatowego .	konferencyjnej	10	Loc
Ponadto zastosował środek zapobiegawczy w postaci zakazu opuszczania kraju , zawieszenia w czynnościach służbowych oraz poręczenie majątkowe w wysokości 10 tys . zł .	majątkowe	16	Acc
O tych wątpliwościach pisała regionalna prasa .	regionalna	4	Nom
Społeczność ludzka funkcjonuje w strukturach zapewniających formę organizacyjną .	organizacyjną	7	Acc
Samoloty rozrzucają ulotki wzywające powstańców do kapitulacji .	wzywające	3	Acc
Odwiedzają moją sąsiadkę , bladą dziewczynę spod ściany .	bladą	4	Acc
Kapitan Bayernu trafił do siatki Koeln jeszcze raz w 68 . minucie .	68	9	Loc
W naszej kantynie fabrycznej zmniejszono nam obiad o jedno danie .	fabrycznej	3	Loc
Jestem niepobożnym ministrantem z pazurami .	niepobożnym	1	Ins
Duże urozmaicenie wprowadzają do tegorocznej wystawy fotomontaże .	Duże	0	Acc
Akceptacja wyraża obiektywną prawdę o człowieku , a nie tylko subiektywne przeżycia jednostki .	subiektywne	10	Acc
Dlatego prośba o przebaczenie jest tak trudna .	trudna	6	Nom
W programie obchodów przewidziano spotkanie uczestników ówczesnych wydarzeń , wystawę fotograficzną i sesję naukową .	naukową	13	Acc
- W 1299-tym nadał Nakłu prawa miejskie mały drobny Król Łokietek , a Dzielny Krzywousty w 12-tym wieku narobił w Nakle kapusty !	miejskie	6	Acc
Immonen , w czarnych dżinsach welwetowych i w zgniłozielonym golfie , nie zdążył jeszcze zrzucić kożucha .	welwetowych	5	Loc
Tam nawiązuje kontakt z grupą partyzancką o zabarwieniu skrajnym , likwidującą komunistów i uciekinierów z gett .	skrajnym	8	Loc
W skrajnych , parodystyczno - humorystycznych wersjach mówi się o walce kryptokomunistów i masonów , antysemitów i pseudoeuropejczyków .	humorystycznych	5	Loc
Policja z uwagi na prowadzone wciąż czynności operacyjne nie ujawnia szczegółów dotyczących tej sprawy .	operacyjne	7	Acc
Od strony wjazdu zbliżał się ubłocony fiat Kosińskiego .	ubłocony	5	Nom
Ewentualna ratyfikacja Konkordatu przed przyjęciem nowej konstytucji zaważyłaby zapewne na jej ostatecznym brzmieniu , odbierając Konstytucji RP charakter nowoczesnej ustawy zasadniczej demokratycznego państwa .	ostatecznym	11	Loc
Położyli na drabiniastym wozie .	drabiniastym	2	Loc
Miał je obezwładnić strzałem z pociskiem usypiającym .	usypiającym	6	Ins
Najpierw związał się z Kongresem Liberalno - Demokratycznym .	Demokratycznym	7	Ins
Prezydenci Polski , Ukrainy i Rumunii spotkali się na roboczych rozmowach w Bukareszcie .	roboczych	9	Loc
W niedzielę 7 czerwca o godz . 17 Odra podejmuje Inę , a Mieszko o tej samej godzinie u siebie gra z Dąbrovią .	7	2	Gen
Kiermasze te zapowiadały Wielki Tydzień , który charakteryzował się postem i wyrzeczeniami .	Wielki	3	Acc
Miała ciągłe kłopoty .	ciągłe	1	Acc
Dogonili go dopiero na pobliskim parkingu .	pobliskim	4	Loc
Jest unerwiona przez nerw trójdzielny .	trójdzielny	4	Acc
Janusz O . przyznał się do stawianych mu zarzutów i bez poręczenia majątkowego dziś wyszedł na wolność .	majątkowego	12	Gen
Marks był by przerażony efektami .	przerażony	3	Nom
Na ganek wyszła starsza pani , ubrana w niemodną sukienkę z koronkowym kołnierzykiem i mankietami .	koronkowym	11	Ins
Wielka katastrofa przestawiła ludzki umysł na wyższe obroty .	ludzki	3	Acc
Miał przekrwione oczy i nabrzmiałą twarz .	nabrzmiałą	4	Acc
Iluż poważnych obecnie pisarzy czytało swe pierwsze próby literackie w sali przy Krupniczej , siedząc wokół dębowych stołów zsuniętych pośrodku .	poważnych	1	Gen
Miał przekrwione oczy i nabrzmiałą twarz .	przekrwione	1	Acc
Pokoje stanowią wyłączną własność poszczególnych lokatorów .	wyłączną	2	Acc
Każdy duży sklep samoobsługowy lub mięsny wyposażono w krajalnice do wędlin .	wyposażono	6	Nom
Robią to dziewiarze na dziewiarskich maszynach .	dziewiarskich	4	Loc
Przekazuj zasady prostym językiem .	prostym	2	Ins
Jak się mówi potocznie o facecie z małymi jajami ?	małymi	7	Ins
Natomiast o urządzenie wspólnych części mieszkania postarał się OPS .	wspólnych	3	Gen
Śledztwo przeciwko świadkowi koronnemu zostanie umorzone dopiero , gdy bez zarzutu wypełni swoją rolę .	umorzone	5	Nom
Do przechodzącego ulicą 28-letniego mieszkańca Ostrowca Świętokrzyskiego oddał dwa strzały .	28-letniego	3	Gen
Na placach poczęły gromadzić się grupy przechodniów z zadartymi do góry głowami .	zadartymi	8	Ins
Czy sędziowie w programie są stronniczy ?	stronniczy	5	Nom
Był by znakomitym pedagogiem uwielbianym przez studentów .	znakomitym	2	Ins
- Jakiś pan w samej koszulce wskoczył do wody .	samej	4	Loc
Mówmy , że ktoś nieśmiały jest też bardziej wrażliwy , milszy .	milszy	10	Nom
Wyszedł em na spacer z nietresowalnym bassetem .	nietresowalnym	5	Ins
Nawet załatwił em już sobie jedną , ale się nie odważył em .	jedną	5	Acc
Denver został założony w 1858 roku i był wielkim centrum górnictwa złota i srebra ; w II połowie XIX wieku powstało Muzeum Sztuki z kolekcją sztuki Indian .	założony	2	Nom
W forcie więziono również Rosjan , Francuzów i Jugosłowian i niemieckich antyfaszystów .	niemieckich	10	Acc
Stan czterech z 15 uratowanych pasażerów jest krytyczny .	krytyczny	7	Nom
- Ale czy ma on rzeczywisty wymiar ?	rzeczywisty	5	Acc
Na wczorajszej rozprawie zeznania składali kolejni świadkowie w procesie , który niedawno został rozpoczęty ponownie .	wczorajszej	1	Loc
Posługując się nim z szermierczą precyzją i taneczną lekkością , można grać na barwnych strunach duszy .	szermierczą	4	Ins
Szerzyła się filozofia w najszerszym znaczeniu .	najszerszym	4	Loc
- Czuje się Pan dostatecznie silny , żeby takie decyzje podejmować ?	silny	5	Nom
Ich zdaniem , proponowane rekompensaty są za niskie .	proponowane	3	Nom
- W 1299-tym nadał Nakłu prawa miejskie mały drobny Król Łokietek , a Dzielny Krzywousty w 12-tym wieku narobił w Nakle kapusty !	1299-tym	2	Loc
Po wizycie papieża płyty mają zostać zwrócone powiatowi kartuskiemu .	zwrócone	6	Nom
W Stanach istnieje taka zasada , że pracownik naukowy uniwersytetu może raz na trzy lata startować w konkursie na innej uczelni .	innej	19	Loc
- Czy nie zabrakło woli politycznej do osądzenia komunistycznych zbrodniarzy ?	komunistycznych	8	Gen
Leci z Milwaukee do Pekinu na chiński Nowy Rok .	Nowy	7	Acc
I nie myśl , że mam Ci to za złe .	złe	9	Acc
Ale oni są mi za drodzy , żeby m im to sprawiła .	drodzy	5	Nom
Dzisiejsza konfrontacja z łódzkimi zespołami , które mają pierwszoligowe aspiracje , zapowiada się niezwykle ciekawie .	łódzkimi	3	Ins
Nie mogą one zająć się w sposób szczególny dziećmi autystycznymi .	autystycznymi	9	Ins
W środowisku olkuskim była osobą znaną , często w miejscowej resursie organizowano jej wystawy .	miejscowej	9	Loc
Wydaje mi się , że na tym odcinku Krupówek wykonano kanalizację zbyt wąskimi rurami .	wąskimi	12	Ins
Od 1993 r . jest kierownikiem Zakładu Współczesnych Teorii Ekonomicznych , a od 1999 r . pełni funkcję dziekana Wydziału Ekonomiczno - Socjologicznego Uniwersytetu Łódzkiego .	1993	1	Gen
Głównym jego prześladowcą był malarz , majster Gileta .	Głównym	0	Ins
Wyniki badań nad wszystkimi 13 właściwościami doskonale ilustruje przejrzysty wykres na 165 stronie książki .	165	11	Loc
Oddzielnie myjemy rzodkiewki i jej liście , od których oddzielamy części zepsute .	zepsute	11	Acc
Była typową polską postępową inteligentką czyli agnostyczką , i wzmianek o chodzeniu do kościoła u niej nie upatrzysz .	typową	1	Ins
Przewidziany jest udział lekarzy w dalszych pracach identyfikacyjnych .	dalszych	5	Loc
Szedłem niskim i wąskim korytarzykiem , oświetlając sobie drogę uniesioną ku górze latarką .	uniesioną	9	Ins
Jednym z głównych celów rządu jest też szybka integracja z Unią Europejską .	Europejską	11	Ins
Podchodzi do głównych drzwi wejściowych , by wpuścić dwie kobiety .	głównych	2	Gen
Tegoroczną nowością raportu jest skala krajowego seksu wirtualnego .	krajowego	5	Gen
W niedzielny wieczór premier Izraela Ariel Saron ogłosił wojnę z palestyńskim terroryzmem .	niedzielny	1	Acc
Od kilku lat w górnej szufladzie mojego biurka leży biały zeszyt .	górnej	4	Loc
Z oficjalnym żądaniem wobec MKOl , złożonym na piśmie , wystąpił Narodowy Komitet Olimpijski KRLD , domagając się od naczelnej władzy sportowej rewizji listy triumfatorów olimpijskich .	złożonym	6	Ins
To stworzyłoby szansę na ukaranie bezpośrednich sprawców .	bezpośrednich	5	Gen
Alkoholu jeszcze nie podano , popielniczki błyszczały czyste i nie skażone .	skażone	10	Nom
Na atramentowej powierzchni wody chybotał się samotny biały żagiel .	atramentowej	1	Loc
W weekend na zachodnich przejściach granicznych trwały wzmożone kontrole .	zachodnich	3	Loc
Ale to nie tylko zadanie związku , bo kolosalne znaczenie ma też jakość hal .	kolosalne	8	Acc
Obie też towarzyszyły swoim synom na uroczystości wręczenia stypendiów w Pałacu Prezydenckim .	Prezydenckim	11	Loc
Ugryzienia osy , pszczoły , trzmiela i szerszenia mogą być niebezpieczne .	niebezpieczne	10	Nom
I tym razem partia okazała się nieodpowiednia .	nieodpowiednia	6	Nom
Na szczególną uwagę zasługują wyraźnie zaakcentowane potrzeby pracy nad własnym charakterem .	szczególną	1	Acc
Każdy chce być jak najlepszym rodzicem .	najlepszym	4	Ins
Sprawdź dokumenty osoby zbierającej datki .	zbierającej	3	Gen
Za rakietami przeciwpancernymi suną majestatycznie olbrzymie srebrzyste cygara .	przeciwpancernymi	2	Ins
Osuch przeszył go nieprzyjemnym , badawczym spojrzeniem .	nieprzyjemnym	3	Ins
Dymek w tym czasie ekspanderem przymocował otwartą klapę .	otwartą	6	Acc
W Kcyni odbyło się spotkanie z kandydatami na kierowników na samodzielny publiczny zakład opieki zdrowotnej w Kcyni i Kowalewku .	publiczny	11	Acc
Pierwsza uczestniczka zaśpiewa o miłości przyprawianej różnymi smakami .	przyprawianej	5	Loc
Tutaj wyraźnie widać wrażliwe , skłonne do ufności i entuzjazmu oblicze eseisty .	skłonne	5	Acc
- Wydziela kwas salicylowy .	salicylowy	3	Acc
Nowe tablice rejestracyjne będą białe z czarnymi napisami i znakiem legalizacyjnym .	legalizacyjnym	10	Ins
Trzeba wreszcie usprawnić system zabezpieczeń społecznych , aby skutecznie dotrzeć do osób i rodzin naprawdę potrzebujących pomocy .	potrzebujących	15	Gen
Wówczas koła łowieckie będą dbały , aby populacja nie rozrastała się ponad dopuszczalną .	dopuszczalną	12	Acc
W historii szuka tylko starych bredni , które już zna .	starych	4	Gen
W piątek otrzymała w nagrodę kuchenkę mikrofalową , ufundowaną przez Makro .	mikrofalową	6	Acc
Wzdłuż kamiennej podmurówki obszedł dom wokoło .	kamiennej	1	Gen
Zażerała się orzechami w czekoladzie i kasztanami mrożonymi , oblizując swoim obyczajem czubki palców .	mrożonymi	7	Ins
Pod jej nosem błyszczał pot , musiała biec , widocznie firma pilnująca mieszkania nie zawiadomiła jej o wyłączeniu alarmu .	pilnująca	11	Nom
Tydzień upłynął w całkowitym milczeniu .	całkowitym	3	Loc
Republika to sposób harmonijnego ułożenia życia społecznego i organizowania go według pewnych zasad .	społecznego	6	Gen
Zachowała się jego piękna fotografia w powstańczym stroju , wykonana w jednym z krakowskich atelier , a także oryginalne dokumenty , powstańcza prasa i ulotki .	powstańczym	6	Loc
Prawa ręka spoczęła na klamce , lewa , dygocąc , przywarła do zamka .	lewa	6	Nom
Staruszka wyjęła z kredensu album oprawiony w zniszczoną ciemnowiśniową skórę .	ciemnowiśniową	8	Acc
Rozszerzone źrenice skierował na moją twarz , ale pod nimi była pustka .	Rozszerzone	0	Acc
Zakończył się VIII Raciborski Rajd Rowerowy Środowisk Trzeźwościowych Dookoła Polski .	VIII	2	Nom
Do pierwsze kolizji doszło przy ulicy Kolejowej w Szydłowcu .	Kolejowej	6	Loc
Kolejne inwentaryzacje dowodzą , że na półkach biblioteki brakuje kolejnych tytułów .	Kolejne	0	Nom
Ta specjednostka nosi bowiem imię legendarnych skoczków spadochronowych Armii Krajowej .	Krajowej	9	Gen
Jeśli to jest absolutnie niemożliwe , znaczy to , że twój charakter jest czymś pośrednim pomiędzy dwoma opisanymi w rozwiązaniu przy odpowiednich numerach .	pośrednim	14	Ins
Podróżujący pierwszą klasą będą odtąd mogli wypoczywać podczas lotu na rozkładanych podwójnych siedzeniach .	podwójnych	11	Loc
Kobieta w fartuchu sprzedaje jej papierowy bilet .	papierowy	5	Acc
Moczarskiego znał em sprzed wojny , byli śmy razem w Wyższej Szkole Dziennikarskiej , dość zaprzyjaźnieni .	Wyższej	10	Loc
Andrzej Micewski zrobił to dopiero w roku 1956 .	1956	7	Loc
Warszawscy radiowcy okazali się trudnymi rywalami .	trudnymi	4	Ins
Niemiecka liga hokeja należy do jednej z najlepszych lig w Europie .	najlepszych	7	Gen
W tym czasie moim serdecznym przyjacielem stał się koń .	serdecznym	4	Ins
Dziennik kończy artykuł niezamaskowaną pogróżką .	niezamaskowaną	3	Ins
- Ustępstwa wobec anestezjologów zostały wymuszone .	wymuszone	5	Nom
Powołał do życia Centralne Biuro Śledcze .	Śledcze	5	Acc
DigiPath przykładowo pozwala na zarządzanie drukowaniem dokumentów w sieci korporacyjnej .	korporacyjnej	9	Loc
Potem opłukała naczynia i ustawiła na drucianej kratce , by obeschły .	drucianej	6	Loc
— Wielu Europejczyków wyznaje ideologię komunistyczną .	komunistyczną	5	Acc
Prototypy powinny odznaczać się światowym standardem .	światowym	4	Ins
Pierwsze krople deszczu zadudniły o trumnę i zmieszały się ze święconą wodą , którą ksiądz rozpryskiwał z kropidła podobnego do królewskiego berła .	królewskiego	20	Gen
Straszny ziąb w nawie , nawet anioł ze środkowego pilastru wydaje się drżeć z chłodu .	środkowego	8	Gen
Budżet państwa sfinansuje połowę odsetek od kredytów hipotecznych .	hipotecznych	7	Gen
Po spełnieniu toastu świeżo upieczeni małżonkowie rzucają za siebie kieliszki .	upieczeni	4	Nom
- Jeżeli mu się nie znudzi , może być świetnym patologiem . . .	świetnym	9	Ins
Będzie musiał kupić na bazarze jakieś najprawdziwsze świadectwo maturalne .	maturalne	8	Acc
Dostrzegł pędzącego byka .	pędzącego	1	Acc
Czy my wszyscy zasługujemy na życie w państwie rządzonym przez państwa Kaczyńskich ?	rządzonym	8	Loc
Zawsze czuł wobec tych urządzeń jakiś instynktowny lęk .	instynktowny	6	Acc
Pokazano jej lichą zagrodę , naprzeciw wiejskiego cmentarza .	wiejskiego	6	Gen
Jeszcze dozwolono ci wybrać . . .	dozwolono	1	Nom
Przeważnie zdarzają się zwichy tylne , obrotowo - tylne i przednie 5 . kręgu lędźwiowego .	tylne	4	Nom
Liczyli zdobyte łupy , oglądali własne i nieprzyjacielskie straty .	zdobyte	1	Acc
Ze swadą wyśmiał i wypunktował tę pookrągłostołową zgraję rządzącą Polską z nadania Kiszczaka .	rządzącą	8	Acc
Zwykły mieszkaniec kraju ma się leczyć ziołami , które zaleca tradycyjna medycyna koreańska .	Zwykły	0	Nom
Tymczasem w liceach prowadzonych przez Społeczne Towarzystwo Oświatowe zdanie egzaminu dojrzałości nie należy do najłatwiejszych .	najłatwiejszych	14	Gen
- Kriszan , odwieziesz pana na Stare Delhi .	Stare	6	Acc
Możesz z nim pójść do dowolnego obwodu .	dowolnego	5	Gen
Nie eksponujemy go szczególnie , by nie robić niepotrzebnej szopki .	niepotrzebnej	8	Gen
Rzecz dotyczy berlińskiej olimpiady w 1936 roku i przynależności państwowej triumfatora .	1936	5	Loc
U ludów słowiańskich rodzina miała charakter patriarchalny , a przewodził jej ojciec .	patriarchalny	6	Acc
Niosła się w obłoku , zakurzona .	zakurzona	5	Nom
Starcie między Generałem a MRP przybrało nawet formy drastyczne .	drastyczne	8	Acc
Wyjaśnił w niej , że został wychowany w bardzo purytańskim domu , w którym wpojono mu szacunek dla takich cnót jak skromność i oszczędność .	purytańskim	9	Loc
Mariusz Walter zadebiutował jako reżyser już w latach 60 . , szybko związał się z telewizją publiczną , w której pracował aż do lat 80 .	publiczną	16	Ins
Nauczyciel szybko uporał się z zakupami i , nie powracając już do poprzedniego tematu , z widoczną ulgą pożegnał chałupniczkę .	widoczną	16	Ins
Ale nie rozumiem , jak można w imię ekumenizmu wysuwać roszczenia do tworzenia w Europie stref monopolistycznych wpływów religijnych .	monopolistycznych	16	Gen
Czeka nas jeszcze kilka zimnych dni .	zimnych	4	Gen
Tarnobrzescy policjanci zatrzymali w pobliżu Stalowej Woli 12 nielegalnych emigrantów .	nielegalnych	8	Gen
Czyżby jakieś złe moce zawisły nie tylko nad publicznymi mediami , ale również nad Warszawiakami ?	złe	2	Nom
Podobny sprzęt otrzymywały od niego dzieci i w ten sposób kontaktował się z nimi .	Podobny	0	Acc
Do zbrodni przyznał się 22-letni mieszkaniec tego miasta .	22-letni	4	Nom
200 z nich chronionych jest jako zabytki architektury ogrodniczej .	chronionych	3	Gen
Złote lata się skończyły .	Złote	0	Nom
Mam przynieść wypełnioną deklarację członkowską oraz partyjną ankietę .	partyjną	6	Acc
Zastrzeżenia wojewody dotyczyły tylko Polaków na stanowiskach kierowniczych .	kierowniczych	7	Loc
Rozśpiewały się ptaki , powracające gromadami w mury Zamku .	powracające	4	Nom
Tam czekały już na nich armatki wodne , podstawione przez władze .	wodne	6	Nom
Celnicy podejmują decyzje o bardzo dużych kwotach .	dużych	5	Loc
Temu sukcesowi w znacznej mierze przysłużył się również Szymon , który wywalczył 10 z 18 zdobytych przez Polaków punktów .	znacznej	3	Loc
WYKORZYSTAJMY EUROPEJSKĄ SZANSĘ !	EUROPEJSKĄ	1	Acc
Kazimierz Laudański i jego bracia to znani w okolicy pszczelarze , klienci przyjeżdżają aż z Niemiec po miód .	znani	6	Nom
Brytyjczycy są więc dominującym udziałowcem w największym polskim towarzystwie emerytalnym .	dominującym	3	Ins
Nie kieruję się przy tym ideologią wegetariańską , choć z nią sympatyzuję .	wegetariańską	6	Ins
Parlament Europejski w Strasburgu przegłosował niedawno całkowity zakaz reklamowania wyrobów tytoniowych .	Europejski	1	Nom
- Bo są też , panie Gustawie , dziki inteligentne .	inteligentne	9	Nom
Projekt przewiduje postawienie 7-kondygnacyjnego biurowca z dwupoziomowym garażem podziemnym na 450 samochodów oraz częścią handlową i usługową .	podziemnym	8	Ins
Obława policyjna przyniosła skutek .	policyjna	1	Nom
Prezes PiS-u piątkowym wystąpieniem tę opinię potwierdził .	piątkowym	2	Ins
Widzicie , lyrijski orzeł czarny i rivskie rauty czerwone .	rivskie	6	Nom
Po ponad dwóch tygodniach brak mi będzie telewizyjnej , turyńskiej zimy .	turyńskiej	9	Gen
Nawiązano współpracę z kołami gospodyń wiejskich w Domatkowie , Kolbuszowej Górnej , Nowej Wsi , Weryni i Widełce .	wiejskich	5	Gen
Postęp techniczny dosięgnął także brytyjskich amatorów herbaty .	brytyjskich	4	Gen
Na cóż pogłębiać straszliwy kryzys ?	straszliwy	3	Acc
Prawdopodobnie mają słabsze technologie .	słabsze	2	Acc
Czy wszystkie galaktyki Seyferta typu 2 mają pierścień pyłowy i ukryty obszar szybkich obłoków gazowych ?	ukryty	10	Acc
Jemiołuszka na przykład w ciepłych porach roku jest amatorką much łapiącą w locie owady .	ciepłych	4	Loc
Rzuca się na podłogę w hipermarkecie , bo nie dostało kolejnej zabawki .	kolejnej	10	Gen
Raport podkreśla , że w wielu krajach najpoważniejszym problemem jest wysokie bezrobocie .	najpoważniejszym	7	Ins
W grudniu 1996 roku Havlovi wraz z górnym płatem prawego płuca usunięto niewielki nowotwór złośliwy .	usunięto	11	Nom
Zauważył em , że po raz pierwszy powieki nie zakrywały jego źrenić , żółtych i okrągłych .	okrągłych	15	Gen
Powiększona kuchnia stała się obszernym pomieszczeniem mieszczącym duży stół .	obszernym	4	Ins
W miniony czwartek w referendum ratyfikacyjnym Irlandia odrzuciła ten Traktat , otwierający drogę do rozszerzenia Unii .	miniony	1	Acc
Prowadziła także programy telewizyjne dla mniejszości ukraińskiej i rosyjskiej w Polsce .	ukraińskiej	6	Gen
Dlatego problem ten musi zostać wnikliwie rozpatrzony , a większość obiektów powinna być bezwzględnie zwrócona społeczeństwu , bo za jego pieniądze zostały wzniesione .	rozpatrzony	6	Nom
Namówił ich do tego zły wąż .	zły	4	Nom
Ten tytoń , augustowska wirdżinia , stoi sobie w paletach pod folią .	augustowska	3	Nom
Miejscowi Polacy zapowiadają zaskarżenie decyzji do sądu .	Miejscowi	0	Nom
Koszty wyjazdu nie są małe .	małe	4	Nom
Należy podkreślić , że gaźnik jest ważnym elementem samochodu , gdyż oprócz ekonomicznego zużycia paliwa w znacznym stopniu wpływa również na niezawodność jazdy i stałą gotowość techniczną pojazdu .	stałą	24	Acc
Natomiast zdjęcia eksponowane w MDK ukazują nowe spojrzenie na fotografię , którego dominantą jest wykonywanie makrofotograficznych ujęć z bardzo bliskiej odległości przy małej głębi ostrości .	makrofotograficznych	15	Gen
Wrócił na czołg po własnych śladach .	własnych	4	Loc
Przekazuj zasady prostym językiem .	prostym	2	Ins
Czy mogę być normalny , skoro przez lata byłem aktorem w policyjnym pornosie ?	policyjnym	11	Loc
Ze zrozumieniem przyjmują lekkomyślny gest .	lekkomyślny	3	Acc
Elektromagnetyczne promieniowanie każdego rodzaju sprzętu elektronicznego ma z reguły odmienny , tylko jemu przypisywany charakter .	elektronicznego	5	Gen
To najgorszy wstrząs sejsmiczny zarejestrowany w Kolumbii .	sejsmiczny	3	Nom
Brazylijczyk , dwukrotny zwycięzca wielkoszlemowego Roland Garros , podkreślał przed spotkaniem , że najważniejszym elementem piątkowej potyczki będzie skuteczna gra przy własnym serwisie .	piątkowej	15	Gen
Zastygła m z lekko przechylonym dzbankiem .	przechylonym	4	Ins
Siedział za pięciometrowym murem zakończonym drutem kolczastym .	kolczastym	6	Ins
Cały czas sprawdzana jest ich skuteczność .	sprawdzana	2	Nom
Horti 2000 to także okazja do zapoznania się z najnowocześniejszymi sprzętami ogrodowymi , niezbędnymi nawozami , które sprawiają , ze nasza działka będzie obiektem zachwytu .	najnowocześniejszymi	9	Ins
Padały jeszcze pytania o drogi krajowe biegnące przez wsie .	krajowe	5	Acc
W pustym hallu , zebrani przy swoich skrzynkach żołnierskich , stali nasi chłopcy .	żołnierskich	8	Loc
Inne interesujące złoże odkryto w Macedonii .	Inne	0	Acc
Mamy dziesięcioletnie doświadczenie z samorządami gminnymi .	gminnymi	5	Ins
Jest to duży wysiłek , jednak nauka szkolna jest zasadniczym czynnikiem samowychowawczym .	samowychowawczym	11	Ins
- Fokusy są ważnym elementem planowania kampanii reklamowych .	ważnym	3	Ins
Sekcja zwłok wykazała , że przyczynami zgonu były zakrzepica żyły udowej , zator tętnicy płucnej i niewydolność krążeniowo - oddechowa .	udowej	10	Gen
Nawet duże lustro na staroświeckiej komodzie służyło z pewnością do różnych celów .	staroświeckiej	4	Loc
Szczególnie serdecznie zapraszamy do współpracy nowo powstałe firmy .	powstałe	6	Acc
Dopiero po wojnie można było się przekonać , ile było wtyczek na wysokich urzędach w różnych sferach .	wysokich	12	Loc
Premier nazwał pieniądze przeznaczone na utrzymanie Kancelarii Prezydenta i swojej wartościami .	przeznaczone	3	Acc
Miała ciągłe kłopoty .	ciągłe	1	Acc
- To wypracowuje się na codziennych , mozolnych próbach .	codziennych	5	Loc
Skulona , ze spuszczoną głową , zniknęła na schodach .	spuszczoną	3	Ins
W pół godziny po wylądowaniu samolot wystartował do Londynu , z pełną 185-osobową obsadą na pokładzie .	185-osobową	12	Ins
Przechodzimy do kolejnego pytania .	kolejnego	2	Gen
Jeden z mężczyzn przystąpił do majstrowania przy kablach telefonicznych .	telefonicznych	8	Loc
Może zabrakło lampy błyskowej ?	błyskowej	3	Gen
Czternastoletni chłopiec cierpiał z powodu ciężkiej alergii wielonarządowej , której objawami były atopowe zapalenie skóry , astma oskrzelowa oraz całoroczny katar .	wielonarządowej	7	Gen
Drużynowymi finałami zakończona została w poniedziałek rywalizacja pływaków o medale i dolarowe premie w Igrzyskach Dobrej Woli .	Drużynowymi	0	Ins
Denver został założony w 1858 roku i był wielkim centrum górnictwa złota i srebra ; w II połowie XIX wieku powstało Muzeum Sztuki z kolekcją sztuki Indian .	1858	4	Loc
O siódmej rano , kiedy wszyscy byli już od dawna w polu , przystępowali śmy do młocki .	siódmej	1	Loc
Zaciągnął w kąt grubego , jowialnego Skwarskiego .	grubego	3	Acc
W obliczu trudnej sytuacji na rynku pracy , 9-miesięczna przygoda w wojsku wydaje się dla nich niemiłą perspektywą .	niemiłą	16	Ins
Melodia płynąca ze skrzypiec jest smętna , żałosna .	żałosna	7	Nom
Śpiewającą męską siódemką dyryguje na estradzie po mistrzowsku Charles Bailly .	męską	1	Ins
Żegnamy się nowo poznaną piosenką i okolicznościowym hasłem .	poznaną	3	Ins
Jeśli w młodości nie przyzwyczaimy organizmu do tego życiodajnego płynu , organizm przestanie wytwarzać laktozę , enzym niezbędny do trawienia cukru mlecznego .	życiodajnego	8	Gen
Dzieci zgodnym chórem twierdzą , że nawet mama nigdy nie gotowała lepiej .	zgodnym	1	Ins
Doświadczenia z dzieciństwa spędzonego w rodzinie alkoholowej u wielu mężczyzn i kobiet owocują w dorosłym życiu utrwalonymi schematami odczuwania , zachowania i myślenia .	dorosłym	14	Loc
Sześć cebul kupiła na kiermaszu zorganizowanym w pobliskiej szkole .	pobliskiej	7	Loc
Ostatni , w 1822 , strawił większość drewnianej i murowanej zabudowy .	1822	3	Loc
Wśród przyjezdnych jest młoda Jadzia Maślak .	przyjezdnych	1	Gen
W 2007 roku neurolodzy amerykańscy wyciągnęli je z muzeum i poddali badaniu rezonansem magnetycznym .	magnetycznym	13	Ins
Znaczna koncentracja tego gazu w przyziemnej warstwie atmosfery sprzyja więc podwyższaniu temperatury powierzchni Ziemi .	przyziemnej	5	Loc
Potem zostaną ulokowani w hotelach i ośrodkach wypoczynkowych .	wypoczynkowych	7	Loc
Talent dramatopisarski Kisielewskiego wypowiedział się w zasadzie w tych dwóch sztukach młodzieńczych .	młodzieńczych	11	Loc
- Manewr z odroczeniem posiedzenia Sejmu oznacza , że bracia Kaczyńscy dążą do władzy absolutnej , do dyktatury .	absolutnej	14	Gen
Mądrzej było by ominąć go szerokim łukiem .	szerokim	5	Ins
O reklamowej działalności prezydenta mówią członkowie Sejmowej Komisji Etyki Poselskiej .	Sejmowej	6	Gen
Jak zwykle pośliznął się na posadzce w przedpokoju , chłodnym i białym niczym Antarktyda we mgle .	białym	11	Loc
- Reforma na pewno nie zostanie zaniechana .	zaniechana	6	Nom
Byli ożywieni .	ożywieni	1	Nom
Wstępną odpowiedź firma ma dać w ciągu dwóch tygodni .	Wstępną	0	Acc
Astma jako wynik uczulenia na pyłki roślin ma burzliwy przebieg i stwarza duże niebezpieczeństwo dla chorego .	burzliwy	8	Acc
W ogólnym rozgardiaszu jedynie Kosiński i Gorczyca zachowywali się spokojnie .	ogólnym	1	Loc
Przed Sądem Okręgowym w Koszalinie zeznała tak wczoraj pielęgniarka z karetki .	Okręgowym	2	Ins
Oczywiście SLD mogło by być ugrupowaniem ateistycznym albo umiarkowanie areligijnym .	ateistycznym	6	Ins
Przez całą niedzielę sprawdzano każdy wątek i potencjalnych sprawców .	potencjalnych	7	Acc
Witraże projektował Jerzy Skąpski , a wykonali w 1991 r . Anna i Ireneusz Zarzyccy .	1991	8	Loc
– Zajrzała jej w oczy spłowiałym błękitem tęczówek .	spłowiałym	5	Ins
Obstawił się własnymi ochroniarzami i policjantami .	własnymi	2	Ins
Niechlubny ranking województwa wielkopolskiego otwiera Wojewódzki Szpital Zespolony w Lesznie .	wielkopolskiego	3	Gen
Te następne często bywały nieporadne .	następne	1	Nom
W Olsztynie pod drzwiami szpitalnymi zmarły ostatnio dwie osoby .	szpitalnymi	4	Ins
Późnym wieczorem już był na nogach i mógł wsiąść na japoński statek płynący do USA .	płynący	12	Acc
– nie mogli reagować osłabieniem waluty na trudności gospodarcze .	gospodarcze	8	Acc
Dramatem zakończyła się nocna kąpiel dwóch mieszkańców Białegostoku .	nocna	3	Nom
Ta masa wodna , nieraz podnosząca poziom Wiku o jeden metr ponad równię Puckiej Zatoki , spotyka się przy dziobie gołębia z silnym prądem zachodnim .	wodna	2	Nom
Konkurs składał się z etapu ustnego i pisemnego .	pisemnego	7	Gen
Nie ma natomiast pracy dla górników i mechaników urządzeń przemysłowych .	przemysłowych	9	Gen
Urząd , nawet na podstawie wadliwej decyzji , mógł ściągnąć niesłusznie naliczony podatek .	wadliwej	5	Gen
Niedawno zapytał darłowskie dzieci , kim był król Eryk .	darłowskie	2	Acc
Prokuratura ma też kilka filmów nagranych amatorskimi kamerami .	nagranych	5	Gen
Piękne i mądre są nasze dzieciaki .	Piękne	0	Nom
Chodzę w czarnych okularach nawet w pochmurne dni .	czarnych	2	Loc
W katowickim oddziale WBK pierwszy klient wykupił wszystkie akcje .	katowickim	1	Loc
Z domku wyszedł im na spotkanie niski mężczyzna o nienaturalnie szerokich ramionach i krótkich , krzywych nogach .	krzywych	15	Loc
Lżejsze podpórki chwytał po dwie i prawie biegnąc rzucał je na platformę .	Lżejsze	0	Acc
W czasach Demokryta panował jeszcze inny pogląd na nicość materialną , który nazwę potocznym .	potocznym	13	Ins
Obecnie mają oni najwyższe pensje w całym województwie pomorskim .	pomorskim	8	Loc
Opary porannej mgły nad jeziorem znikały w złotych promieniach słońca .	porannej	1	Gen
Jeden z architektów przybija na ocalałej bramie kartkę wyrwaną z notesu .	ocalałej	5	Loc
- Najprostszym sposobem ukrycia miejsca do pracy jest korzystanie z wsuwanych blatów .	Najprostszym	1	Ins
Odgłosy tego polskie media zagłuszały białoruską wrzawą .	białoruską	5	Ins
Partyjni stratedzy planują więc przedsięwzięcia z myślą o wyborach dalszych , tych pojutrze .	dalszych	9	Loc
Po jego obu bokach zwisają nawleczone na sznur perły nazywane Paternoster .	nawleczone	5	Nom
wreszcie są upragnione .	upragnione	2	Nom
- W iluż miastach w okresie letnim odbywa się tyle bezpłatnych występów artystycznych .	bezpłatnych	10	Gen
- Zrobimy pana landrata na szosie w podgórskim pejzażu .	podgórskim	7	Loc
Okazuje się , że zaproszona grupa baletowa prawdopodobnie będzie musiała zrezygnować z udziału w festiwalu .	zaproszona	4	Nom
Spytała m o niego mężczyznę siedzącego obok .	siedzącego	5	Acc
Była nawet ładna .	ładna	2	Nom
Nie przewidywały , że na własnej piersi wyhodują sobie takiego gada .	własnej	5	Loc
Wizyta ma charakter prywatny .	prywatny	3	Acc
Dozorca strzyknął brunatną śliną .	brunatną	2	Ins
Poznańska Starówka otrzymała stałą iluminację .	stałą	3	Acc
Następnym mówcą będzie pan poseł Jan Kulas .	Następnym	0	Ins
Następnie podgrzewamy i przesączamy przez gęste sito .	gęste	5	Acc
W szerokim pęknięciu fosforycznie świeciło próchno .	szerokim	1	Loc
Zbyt szybkie tempo życia doprowadza zwykle do zmęczenia i bałaganu .	szybkie	1	Nom
Zdaniem włoskich ekspertów , jest to słabe tłumaczenie , ponieważ wszyscy wiedzą , że region Molise leży w strefie silnej aktywności sejsmicznej .	sejsmicznej	21	Gen
Pozostali pacjenci przebywają na oddziale ginekologicznym , wewnętrznym i kardiologicznym .	kardiologicznym	9	Loc
Ale Europa Zachodnia jest bardzo łagodna i tolerancyjna wobec zbrodniarzy komunistycznych .	komunistycznych	10	Gen
- Stara ogrodnicza prawda mówi , że każdemu drzewu i krzewowi przycięcie zrobi dobrze .	Stara	1	Nom
- Słyszę silny szum i tętnienie .	silny	2	Acc
W zgodnej opinii sztabu szkoleniowego radomian , wszyscy mają równe szanse .	równe	9	Acc
Nie wprowadzono prywatnej własności ziemi , nie zniszczono feudalnego imperium dyrektorów kołchozów .	feudalnego	8	Gen
Środki pochodzą z Państwowego Funduszu Rehabilitacji Osób Niepełnosprawnych .	Państwowego	3	Gen
W Polsce wyniki leczenia nowotworów dlatego są dwukrotnie gorsze od uzyskiwanych na Zachodzie , ponieważ na terapię trafiają chorzy przeważnie już z zaawansowanym guzem .	uzyskiwanych	10	Gen
Przed urzędem wojewódzkim domagali się , by władze wydały zgodę na budowę supermarketu na terenie klubu .	wojewódzkim	2	Ins
Od tego też dnia czynna jest już wypożyczalnia sprzętu wodnego .	wodnego	9	Gen
Za 30.000 złotych wyremontowana została ulica prowadząca do ośrodka zdrowia w Lubiewie .	wyremontowana	3	Nom
Wtórna samotność zdaje się jeszcze cięższa .	cięższa	5	Nom
Później łupy pojawiały się na krakowskiej giełdzie elektronicznej .	krakowskiej	5	Loc
Szkolenie odbędzie się jutro o godz . 10 w sali konferencyjnej Starostwa Powiatowego .	10	7	Loc
- Czy czarny scenariusz jest brany pod uwagę w zachodnich kołach finansowych ?	finansowych	11	Loc
Najgłośniejsza draka wybuchła o Tywonka .	Najgłośniejsza	0	Nom
Głubczycka PSS rozpoczynała swoją działalność od jednego sklepu .	Głubczycka	0	Nom
Jechało im się dobrze , na szosie po przedpołudniowym deszczu nie było kurzu , ale jezdnia nie była już mokra .	przedpołudniowym	8	Loc
W kraju działa kilka grup partyzanckich utworzonych przez patriotów Dominikany .	utworzonych	6	Gen
Towarzystwo Naukowe KUL pełni w Polsce rolę zbliżoną do Katolickiej Akademii Nauk .	Naukowe	1	Nom
Sierpcem nie interesuje się zupełnie przemysł terenowy .	terenowy	6	Nom
W zgodnej opinii sztabu szkoleniowego radomian , wszyscy mają równe szanse .	równe	9	Acc
Sornicy będą nosić tradycyjne kozackie mundury .	kozackie	4	Acc
Pierwsze i drugie miejsce zajęły słowackie dziewczęta , ubrane w getry i krótkie falbankowe spódniczki .	krótkie	12	Acc
Ale nie lubię jubileuszy i nie czuję się zramolałym jubilatem .	zramolałym	8	Ins
Groźni faszyści są bezkarni , bo stronę założyli na amerykańskim serwerze .	bezkarni	3	Nom
Pełniący obecnie obowiązki szefa rosyjskiego państwa Putin był jeszcze niedawno szefem służb specjalnych .	rosyjskiego	4	Gen
W dusznej od papierosowego dymu izbie tłoczono się okropnie .	dusznej	1	Loc
Na szczęście , polichlorek winylu jest już stosowany na znacznie mniejszą skalę , a wyroby z niego są wyraźnie oznakowane .	mniejszą	10	Acc
W kwietniu tegoż 1981 r . w naszych zachodnich okręgach wojskowych przeprowadzona została nadzwyczaj długa sztabowa gra wojenna .	zachodnich	8	Loc
Uczył się w Liceum Technik Plastycznych w Zakopanem prowadzonym przez Antoniego Kenara .	Plastycznych	5	Gen
W klatkach znajdowały się dzikie koty .	dzikie	4	Nom
Poczta zmniejsza swój deficyt i już w 1997 r. powinna zacząć przynosić zyski .	1997	7	Loc
Aresztowanego na 48 godzin mistrza zwolniono po poręczeniu majątkowym .	Aresztowanego	0	Acc
