Rodzice ze wzruszeniem prezentowali dziennikarzom swoje maleństwa i dziękowali za pomoc .	dziennikarzom	4	Hum
Neapolitańska policja zatrzymała czterech młodych Polaków pod zarzutem wymuszania pieniędzy i rabunku .	rabunku	11	Inan
Ich przyczyną były nagłe zmiany w materiale genetycznym wirusa .	wirusa	8	Nhum
W gabinecie sadza na fotelu , siada obok i w obecności rodziców streszcza mu , co jej opowiedzieli .	rodziców	11	Hum
Spod wody wyłaniały się nowe kontynenty .	kontynenty	5	Inan
Wiedzą o tym dziesiątki właścicieli małych elektrowni wodnych .	właścicieli	4	Hum
Ciągle nie możemy doczekać się takich czasów , kiedy rządy po prostu nie będą przeszkadzały .	czasów	6	Inan
Ale wydaje mi się , że Lech , Czech i Rus musieli bardzo długo pędzić za jeleniem , dzikiem i niedźwiedziem .	niedźwiedziem	20	Nhum
Dla pozostałych autobusów jadących w kierunku Śródki , dopuszczony zostanie przejazd ul . Estkowskiego .	autobusów	2	Inan
Mogę się tylko domyślać , że mechanicy zabiją barana , który od rana obgryza skraj plastikowego worka , i przyniosą mi moją część .	barana	8	Nhum
Jej właścicielem została włosko - niemiecka spółka Roncadin .	właścicielem	1	Hum
Rzecznik Prokuratury Okręgowej w Łodzi Krzysztof Kopania , zasłaniając się dobrem postępowania , odmówił na tym etapie śledztwa odpowiedzi na pytanie , czy ksiądz przyznał się do stawianych mu zarzutów .	Rzecznik	0	Hum
Nauczyciele wymienili spojrzenia .	Nauczyciele	0	Hum
Ani on , ani zastępca Grzegorz Paluch nie chcieli jednak wypowiadać się o całej sprawie na łamach prasy .	łamach	16	Inan
Wówczas warto pospieszyć się z odpowiedzią , bo od złożenia takiej deklaracji operator w ciągu miesiąca musi wprowadzić nowe , korzystniejsze opłaty .	operator	12	Hum
Ćwiczyli wojacy z 25 krajów .	wojacy	1	Hum
Najbardziej popularne są mercedesy , audi , golfy i BMW .	golfy	7	Nhum
U ludów słowiańskich rodzina miała charakter patriarchalny , a przewodził jej ojciec .	charakter	5	Inan
I jakie są skutki bezwzględnego wymogu potwierdzenia w korpusie ?	korpusie	8	Inan
Kot wyjeżdżający do Finlandii musi być dodatkowo odrobaczony na 30 dni przed wyjazdem .	Kot	0	Nhum
Ułoży się most , star przejedzie , kratownice wrócą na miejsce , zatrzemy ślady i poczekamy .	star	4	Nhum
Nadążacie , Towarzysze ?	Towarzysze	2	Hum
" Zła organizacja pracy powoduje przede wszystkim brak prawidłowej i dobrej kontroli przełożonych nad podwładnymi " .	podwładnymi	14	Hum
Drugi pod względem kapitalizacji giełdowej Wielkopolski Bank Kredytowy osiągnął bardzo dobrą miesięczną dynamikę zysków wynoszącą 81,4 proc .	Bank	6	Inan
Arkadiusza J . pogrążyły też zeznania taksówkarza , który zabrał oskarżonych sprzed Stodoły .	taksówkarza	6	Hum
Kością niezgody jest nadal powstanie niezależnej korporacji prokuratorów .	prokuratorów	7	Hum
W środku był też ciężko poparzony inny mężczyzna .	mężczyzna	7	Hum
Tymczasem byk już był przy nim .	byk	1	Nhum
Dzięki nim zmniejsza się u chorego zaleganie afektu , rozładowują się utrwalone stereotypy uczuciowe , obiektywniej widzi swoją sytuację .	stereotypy	12	Inan
Sylwetka Golfa w porównaniu z agresywnymi liniami Focusa wygląda spokojnie , ale jego bryła może być uznana za ponadczasową .	Golfa	1	Nhum
Na wszelki wypadek weźmiemy cię za wielbłąda .	wielbłąda	6	Nhum
Ogłoszone wczoraj dane Narodowego Banku Polskiego , dotyczące wielkości deficytu na rachunku obrotów bieżących , zaskoczyły ekonomistów .	ekonomistów	16	Hum
Lech przynajmniej przeskoczył przez płot .	płot	4	Inan
O napadzie i kradzieży zawiadomił policję sam poszkodowany , pracownik jednej z katowickich firm dealerskich .	napadzie	1	Inan
Szczegółowo analizowane są zapisy z kamer monitorujących , które znajdują się na terenie Kwidzyna .	zapisy	3	Inan
W tym roku w kościele św . Brygidy na Wielkanoc można było obejrzeć kościotrupa trzymającego flagę UE .	kościotrupa	13	Nhum
W przypadku BIG-u ostatni miesiąc roku obrachunkowego przyniósł wynik poniżej tegorocznej średniej .	wynik	8	Inan
Wyjątkiem były centrale banków .	banków	3	Inan
Ale już nie zdążyli , na pozostałym kawałku lądowały niemieckie dywizje pancerne .	kawałku	7	Inan
Dziękuję , panie marszałku .	marszałku	3	Hum
Demonstranci mieli flagi Liberalno - Demokratycznej Partii Rosji , organizacji politycznej znanego nacjonalisty Żyrinowskiego .	Demonstranci	0	Hum
Miał napady agresji , wpadał w histerię .	napady	1	Inan
Dojedli śniadanie , wyjęli papierosy , zapalili .	papierosy	4	Nhum
Twierdzili , że nie oddali córki do szpitala , bo nie mogliby jej odwiedzać .	szpitala	7	Inan
Adres niech dobrodziej spisze z dowodu osobistego .	dobrodziej	2	Hum
Zawód przeżyły grupy protestujących warszawiaków , które licznie przybyły na wczorajszą sesję rady miasta .	warszawiaków	4	Hum
Funkcjonariusze policji przypuszczają , że ofiara zasnęła .	Funkcjonariusze	0	Hum
Według legend , w studni głębokiej na ponad 30 metrów znajdują się wejścia do lochów i tajnych chodników łączących posiadłości właścicieli zamku .	chodników	17	Inan
Zgodził się , dał kilka dobrych rad i wyznaczył Polluksa na dowódcę .	dowódcę	11	Hum
Wśród nich są przede wszystkim napady , kradzieże i rozboje .	napady	5	Inan
Pamiętam z ogrodu zoologicznego w Wiedniu duże pomieszczenie koszatniczek .	ogrodu	2	Inan
W zgodnej opinii sztabu szkoleniowego radomian , wszyscy mają równe szanse .	radomian	5	Hum
Ta masa wodna , nieraz podnosząca poziom Wiku o jeden metr ponad równię Puckiej Zatoki , spotyka się przy dziobie gołębia z silnym prądem zachodnim .	gołębia	20	Nhum
43-letni młodszy brygadier dmuchnął w alkomat .	alkomat	5	Inan
Wchodzimy w wiraż , coraz bardziej zbliżając się do sklepienia kanału , które naraz przybiera jaskrawoniebieski kolor z domieszką fosforyzującego fioletu .	kanału	10	Inan
Uczniowie klas młodszych sprzątali las w oddziale 184 pod kierunkiem stażysty , Przemysława Mazgaj .	Uczniowie	0	Hum
Zagraniczne agencje informacyjne i prasa obszernie zrelacjonowały sobotnią konferencję prasową wicepremiera Janusza Obodowskiego .	wicepremiera	10	Hum
Rzecznik Praw Obywatelskich wystąpił w obronie inwalidów wojennych i wojskowych , którym wprowadzono obowiązek płacenia za pobyt w sanatoriach uzdrowiskowych .	Rzecznik	0	Hum
Modernizacja Opla Frontery miała uczynić go bardziej przyjaznym dla użytkowników , nie zmniejszając jednocześnie jego możliwości .	Opla	1	Nhum
Nie trzeba jednak od razu spiętrzać Wisły , żeby wytwarzać energię elektryczną .	razu	4	Inan
Zatrzymał traktor .	traktor	1	Inan
Zjadano dziennie stado baranów , setki kur , górę ryżu , sadzawkę jogurtu , piramidę melonów i wypijano wagon coca-coli .	melonów	15	Nhum
- Czy Pana zdaniem istnieje coś takiego jak przyjaźń polityczna ?	Pana	2	Hum
Kierowcy pozostałych samochodów mieli liczne otarcia naskórka , które lekarz pogotowia opatrzył na miejscu .	samochodów	2	Inan
Gdy zrozumiał , że Zachód mylnie pojmuje religię hinduską jako politeizm , zaczął szukać głębszych warstw i analogii .	Zachód	4	Inan
Odczuwa jednak dotkliwie pustkę , brak sensu życia .	brak	5	Inan
Była też okazja do rozmów z wszystkimi piłkarzami i szkoleniowcami reprezentacji .	piłkarzami	7	Hum
Chłopak zawahał się .	Chłopak	0	Hum
Już na schodach usłyszała dźwięki dobiegające z komnaty dziadka .	dziadka	8	Hum
Podwórko pachniało cytrusami .	cytrusami	2	Nhum
Sklejka , która była tegorocznym pewniakiem do prywatyzacji , nie ma żadnego szefa .	pewniakiem	5	Nhum
Delfina w herbie ma Szkoła Policealna Pracowników Służb Socjalnych w Poznaniu .	herbie	2	Inan
Pomorska Regionalna Kasa Chorych jest od wczoraj kontrolowana przez pracowników Urzędu Nadzoru Ubezpieczeń Zdrowotnych .	Chorych	3	Hum
Każdy z synów założył rodzinę .	synów	2	Hum
Od strony wjazdu zbliżał się ubłocony fiat Kosińskiego .	fiat	6	Nhum
Kiedy mówi się o cudach w Lourdes , kiedy ktoś dostąpił cudownego uzdrowienia , Kościół prosi lekarzy , aby wypowiedzieli się na ten temat .	cudach	4	Inan
Podczas pokazu zwiedzający mają możliwość zobaczenia wielu ras myszy .	pokazu	1	Inan
Wstępna analiza Inspektoratu wskazuje , że sąd w Jeleniej Górze nie jest przystosowany do procesów , w których oskarżonymi są członkowie zorganizowanych grup przestępczych .	oskarżonymi	18	Hum
Do obserwatorium waszyngtońskiego ściągały tłumy ciekawych .	tłumy	4	Inan
- Atak był wściekły .	Atak	1	Inan
Byli niemal rówieśnikami .	rówieśnikami	2	Hum
Kazimierz Laudański i jego bracia to znani w okolicy pszczelarze , klienci przyjeżdżają aż z Niemiec po miód .	bracia	4	Hum
W 1989 roku Humphrey zaczął pracować w rezydencji premierów Wielkiej Brytanii w charakterze niezłomnego pogromcy myszy i szczurów .	pogromcy	14	Hum
Opieka naprzemienna jest konsekwencją sprzeciwu ojców , którzy poczuli się skrzywdzeni orzeczeniami sądów .	ojców	5	Hum
Opodal trenowali skoki chłopcy na deskorolkach .	chłopcy	3	Hum
Robią to dziewiarze na dziewiarskich maszynach .	dziewiarze	2	Hum
Akcje tego typu podejmowane samorzutnie w roku 1956 przyniosły cenne zdobycze .	typu	2	Inan
W jego koszyku znalazło się aż 125 dorodnych prawdziwków .	prawdziwków	8	Nhum
W latach sześćdziesiątych , już jako sztygar oddziałowy , pamiętam odbiory przygotowywanych do rozruchu ścian dokonywane przez dyrektora Śniegonia .	sztygar	6	Hum
W ten sposób zaaprobowane zostało wstępne porozumienie , osiągnięte w ubiegłym roku przez ministrów zdrowia Piętnastki .	ministrów	13	Hum
U dorosłych przeciwdziała on również zawałowi serca .	dorosłych	1	Hum
Za każdy kolejny kilogram zapłacimy 24 zł .	kilogram	3	Inan
Daktyle sparzyć , drobno pokroić i dodać z pozostałym masłem do kuskusu .	Daktyle	0	Nhum
" Zła organizacja pracy powoduje przede wszystkim brak prawidłowej i dobrej kontroli przełożonych nad podwładnymi " .	przełożonych	12	Hum
To jednak dopiero początek jego kłopotów .	kłopotów	5	Inan
Tymczasem komandor zatrzaśnięty w samochodzie wydzwaniał z telefonu komórkowego do znajomych .	komandor	1	Hum
- Nie ma trybu .	trybu	3	Inan
Dlaczego złoty wczoraj tak nagle osłabł ?	złoty	1	Nhum
Wśród ludzi wybranych na najwyższe urzędy zjawiają się bandyci , gangsterzy , szpiedzy .	szpiedzy	12	Hum
Wchodzimy w wiraż , coraz bardziej zbliżając się do sklepienia kanału , które naraz przybiera jaskrawoniebieski kolor z domieszką fosforyzującego fioletu .	wiraż	2	Inan
Trzymiesięczne owczarki niemieckie pochodzą z wyspecjalizowanej hodowli ze Słowacji .	owczarki	1	Nhum
Negocjacje rozpoczęły się dopiero po przyjeździe do szkoły zastępcy wójta gminy .	wójta	9	Hum
Amator kąpieli po skoku nie wypłynął .	Amator	0	Hum
Jeden hotel musiał być oddany po wygaśnięciu dzierżawy , drugi sprzedano , aby pokryć dług w Funduszu Społecznym Żołnierza .	Żołnierza	18	Hum
Steve zaklina się , że po każdym dyżurze szykuje ekstra posiłek czworonożnemu ratownikowi .	dyżurze	7	Inan
Miałam inne policzki , inne oczy , inny nos . . .	nos	8	Inan
Pani z jamnikiem spytała Kuronia , czy to jego samochód .	jamnikiem	2	Nhum
Złamanie tego zakazu powinno spowodować odwołanie faceta z funkcji .	faceta	6	Hum
Barok ambony , kiedyś dla niej naturalny , płynący dzielnie przez wieki , sprawiał teraz wrażenie kłopotliwego dodatku , fanaberii artysty , był nieznośnie kiczowaty , jarmarczny .	Barok	0	Inan
Powołanie Semaka wzburzyło pracowników opolskiej rozgłośni .	pracowników	3	Hum
Trubadur głosił , iż jej dochowanie należało do obowiązków damy , lecz niczego nie gwarantowało niewieście .	Trubadur	0	Hum
Radny Eugeniusz Morta chciał przed głosowaniem usłyszeć silne argumenty za wydaniem tak dużej kwoty .	argumenty	8	Inan
Może pan weryfikator nie wie , co podpisuje ?	weryfikator	2	Hum
Z tych powodów w innych krajach ministrowie starają się mówić tym samym głosem .	ministrowie	6	Hum
Życie ojca , surowe i ciężkie , całkowicie poświęcone rodzinie i opiece nad innymi ludźmi , budzi dziś zdumienie nieprawdopodobną obowiązkowością , odpowiedzialnością i pogodą ducha .	ducha	25	Nhum
W poniedziałek naczelnik Jerzy Żemełko był na urlopie .	naczelnik	2	Hum
Małgorzata Supronowicz , właścicielka syberiana , jest lekarzem weterynarii .	syberiana	4	Nhum
Andrzej Chronowski , dotychczasowy minister skarbu , złożył wczoraj dymisję na ręce premiera .	premiera	12	Hum
Od zbłąkanych misjonarzy uchroń nas , Panie .	misjonarzy	2	Hum
Jeśli właścicielka nie odbierze Odiego , aby go pochować , pies trafi do specjalistycznej firmy , która go zutylizuje .	pies	10	Nhum
W trakcie remontu zauważył go nowy właściciel mieszkania , bo z piasku wystawała ręka .	właściciel	6	Hum
- Nie kradnę , nie sprzedaję narkotyków i nie morduję za pieniądze .	narkotyków	6	Inan
Rodzice wciąż pracują .	Rodzice	0	Hum
Którędy się idzie , by zejść na manowce ?	manowce	7	Inan
Spod czerni i płomieni zaczynały już wyglądać żółtawe żebra trupa .	trupa	9	Nhum
Dwaj nieznani mężczyźni okradają restauratorów we Włochach , Opaczy , Pruszkowie .	restauratorów	4	Hum
W ten sposób samorząd chce odzyskać od skarbu państwa pieniądze na niedoszacowaną subwencję na ubiegły rok .	samorząd	3	Inan
Jeszcze większe wrażenie na współczesnych sprawiał Tomasz z Akwinu , dyktując dwa albo trzy traktaty filozoficzne .	współczesnych	4	Hum
Poruszyły się wskaźniki na podświetlanych zegarach .	zegarach	5	Inan
Zdjąć te cholerne obrazki po właścicielu .	właścicielu	5	Hum
W ciągu godziny można było zaobserwować około stu meteorów .	meteorów	8	Inan
Pamiętam , że stawaliśmy o 3 . 15 nad ranem , udając się do zakładu samochodów małolitrażowych .	samochodów	15	Inan
Połączono go z obchodami 70-lecia szkoły .	obchodami	3	Inan
Stwierdzam , że Sejm wobec nieuzyskania bezwzględnej większości głosów poprawkę Senatu przyjął .	Senatu	10	Inan
Leczenie ataków padaczkowych polega na podawaniu leków przerywających drgawki niezależnie od ich przyczyny .	ataków	1	Inan
Zmiany dokonane w Oplu Fronterze wyszły mu na dobre .	Oplu	3	Nhum
Dopiero po wojnie można było się przekonać , ile było wtyczek na wysokich urzędach w różnych sferach .	urzędach	13	Inan
Na Siemiradzkiego wybrzydzali krytycy , ale publiczność uwielbiała jego obrazy .	krytycy	3	Hum
Czołgi i wozy pancerne strzegą więzienia , do którego ciężarówki wojskowe bez przerwy przywożą aresztowanych .	aresztowanych	14	Hum
Aż trudno uwierzyć , że jeszcze kilkanaście dni temu ptaszki ćwierkały , że zostawi stację Waltera i przeniesie się do TVP .	ptaszki	9	Nhum
Jednak ewentualne załamanie koniunktury przy obecnych cenach będzie oznaczać dla inwestorów upadek z wysokiego konia .	konia	14	Nhum
Gdy karetka zabierała chorego , jego ciało było już sine .	chorego	3	Hum
Demony są bardzo uparte .	Demony	0	Nhum
Świadkowie twierdzą , że przy nazwisku figuruje jego stopień .	stopień	8	Inan
Przedtem włóczyli się po mieście , topniał śnieg , szumiało w rynnach , czuć było powiewy ciepła i zgnilizny , nad dachami tłukły się kłębiaste chmury .	dachami	21	Inan
500 chuliganów zorganizowało protest przeciw złej sytuacji finansowej klubu .	chuliganów	1	Hum
Oprócz absolwentów przybyli także dawni dyrektorzy i nauczyciele Nowodworka .	dyrektorzy	5	Hum
Łoś podniósł łeb .	Łoś	0	Nhum
Nie ma natomiast pracy dla górników i mechaników urządzeń przemysłowych .	mechaników	7	Hum
Delfina w herbie ma Szkoła Policealna Pracowników Służb Socjalnych w Poznaniu .	Pracowników	6	Hum
Imprezę obsługiwać będzie 11 tys . dziennikarzy i pracowników technicznych .	dziennikarzy	6	Hum
Oprócz laureatów wzięli udział w tym spotkaniu liczni działacze naszej organizacji , redaktorzy naczelni , przedstawiciele szeregu wydawnictw .	laureatów	1	Hum
Stylistyka Opla Astry wkrótce po jego prezentacji była dość nowoczesna , ale teraz w porównaniu z najnowszymi autami wygląda dość konserwatywnie .	Opla	1	Nhum
Witam wszystkich grupowiczów ! ! !	grupowiczów	2	Hum
Jednego z zatrzymanych sąd aresztował pod zarzutem rozboju i uszkodzenia ciała .	zatrzymanych	2	Hum
na powodzian zbierają pieniądze .	powodzian	1	Hum
Przy kredytach dla ludności oprocentowanie najczęściej jest podawane z góry i nie zależy od oceny klienta .	klienta	15	Hum
Uniwersytet ten , założony w 1949 r . i prowadzony przez werbistów , nie posiada zbyt długiej tradycji akademickiej .	werbistów	11	Hum
Przez 13 lat był maszynistą kolejowym .	maszynistą	4	Hum
Wiezie grupę architektów .	architektów	2	Hum
Ale wydaje mi się , że Lech , Czech i Rus musieli bardzo długo pędzić za jeleniem , dzikiem i niedźwiedziem .	dzikiem	18	Nhum
Jest sobie system języka i teksty tego języka .	teksty	5	Inan
Sześć pięknych dziewcząt rywalizowało w Miejsko - Gminnym Ośrodku Kultury w Małogoszczu o tytuł Miss Regionu Jędrzejowskiego i Włoszczowskiego .	Regionu	15	Inan
Sznur tirów przecina niemal cały Wrocław , ma dziesięć kilometrów długości , stoi w nim kilkaset ciężarowek .	tirów	1	Nhum
Pamiętam swego pierwszego dużego bolenia .	bolenia	4	Nhum
Wysyłam je najczęściej za pośrednictwem konduktorów autobusowych .	konduktorów	5	Hum
Sprawdzamy wyrostki kolczyste i łuki kręgów .	kręgów	5	Inan
Stary wiadukt przy ulicy Oświęcimskiej stanowił ogromną uciążliwość dla kierowców .	kierowców	9	Hum
Jemiołuszka na przykład w ciepłych porach roku jest amatorką much łapiącą w locie owady .	owady	13	Nhum
Tarot Marsylski powstał prawdopodobnie w końcu średniowiecza , gdy świeże były jeszcze skojarzenia Czyśćca z refrigerum .	Tarot	0	Nhum
Jak widać ze scenariusza Homera - Dixona , taki zamach nie jest trudny do realizacji .	scenariusza	3	Inan
Musimy wypracować nowy polityczny model społeczeństwa .	model	4	Inan
W ciągu ostatniego minionego tygodnia zarówno dolar , jak i marka straciły wobec polskiej waluty .	dolar	6	Nhum
Po powrocie zauważył , że drzwi do komórki , zawsze zamknięte na skobel , są otwarte .	skobel	12	Inan
- Czy pan chce zakneblować usta ludziom , którzy na ulicach protestują przeciwko rządzącym ?	rządzącym	13	Hum
Sytuacja nie zmieniła się za pontyfikatu Jana Pawła II .	pontyfikatu	5	Inan
W latach sześćdziesiątych , już jako sztygar oddziałowy , pamiętam odbiory przygotowywanych do rozruchu ścian dokonywane przez dyrektora Śniegonia .	odbiory	10	Inan
Jednocześnie prezydent Egiptu Hosni Mubarak ogłosił , że jest możliwy kompromis .	kompromis	10	Inan
Kazimierz Pytko napisał na naszych łamach , że nerwowe odruchy prawosławnych biorą się z ich poczucia słabości .	odruchy	9	Inan
Jest potwierdzeniem dla wartości życia bliźniego .	bliźniego	5	Hum
- Wwozisz do Polski kapitał , bierzesz adwokata , który w krótkim czasie załatwia wszystkie prawne problemy .	kapitał	4	Inan
Siedzimy naprzeciw siebie , pijemy herbatę , jemy piernik domowego wypieku .	wypieku	10	Inan
Znakomicie lokalizuje miejsca , w których kryją się szkodniki .	szkodniki	8	Nhum
Był pan organizatorem takiego niestrawnego politycznie obiadu w Drawsku .	organizatorem	2	Hum
Dziewczyny mówią , że piszczała , płakała , śmiała się , przykucnęła , usiłując uspokoić drżące od wysiłku mięśnie i wtedy rzuciły się na nią . . .	wysiłku	17	Inan
- Lista posłów zapisanych do głosu została wyczerpana .	posłów	2	Hum
Związany z kapistami , wielokrotnie jednak przekraczał wyznaczone przez nich malarskie granice .	kapistami	2	Hum
Dlatego w dziedzinie literatury demokratyzm Internetu jest pozorny .	demokratyzm	4	Inan
VIII Zjazd Inżynierów Mechaników Polskich obradował w Katowicach pod hasłem zbiorowego wysiłku myśli i pracy nad aktualnymi zagadnieniami technicznymi , mającego na celu rozwój techniki polskiej .	Mechaników	3	Hum
Gdybym miał pieniądze , to kupiłbym bez namysłu .	namysłu	7	Inan
- Będzie dalej atakowany , bo dzieciaki mu nie popuszczą .	dzieciaki	6	Nhum
Zauważam jednak , że kabel jest końcem rogu olbrzymiego nosorożca , który stoi na dole .	kabel	4	Inan
Bóg zesłał Anioła , bo go zatrzymać w ostatniej minucie .	Anioła	2	Nhum
- Mój ojciec pracuje w BRH , biurze radcy handlowego .	radcy	8	Hum
Czyżby teraz przepuściła okazję , mając tuż obok przystojnego młodego mężczyznę ?	mężczyznę	10	Hum
Trzeciego dnia zniknął .	Trzeciego	0	Nhum
Czy komornik poprzestanie na aucie byłego ministra , skoro śledczy kazali zabezpieczyć majątek wart 150 tys . zł ?	śledczy	9	Hum
Później strzałami w powietrze sterroryzował kasjerkę i zmusił ją do wydania pieniędzy .	strzałami	1	Inan
- Nie mogę jednak zawieść swoich pacjentów .	pacjentów	6	Hum
Dominować będą piosenki do tekstów Edwarda Stachury .	tekstów	4	Inan
Zjadano dziennie stado baranów , setki kur , górę ryżu , sadzawkę jogurtu , piramidę melonów i wypijano wagon coca-coli .	baranów	3	Nhum
Gdańscy radni podjęli uchwałę o przekazaniu miliona złotych na odbudowę kościoła św . Katarzyny .	radni	1	Hum
Shimada wyznaczył więc ludzi i za chwilę wnętrze góry poczęło błyskać upiornym światłem palników i ożywiło się znów koszmarną krzątaniną .	palników	13	Inan
Ogień zauważyli mieszkańcy kamienicy w nocy z poniedziałku na wtorek .	Ogień	0	Inan
Swojego dworca nie miał .	dworca	1	Inan
Potem szli na romantyczny spacer , przytulali się i całowali .	spacer	4	Inan
Proceder trwał przynajmniej dwa lata .	Proceder	0	Inan
- Czy to jest objaw narodowego masochizmu ?	objaw	4	Inan
Za punktualność , komfort podróżowania , czy czystość przystanków będzie dbał MZKZG .	przystanków	8	Inan
Przed awanturą natomiast wszyscy Zarządowi patrzyli na ręce , zarzucając mu niekompetencję i prywatę .	Zarządowi	4	Inan
To po to zafundowali ci laptopa ?	laptopa	5	Nhum
- O to też pytałeś szpicli ?	szpicli	5	Hum
Angelina Jolie jest bezgranicznie zakochana w swoim adoptowanym synku , który niedawno urodził się w Kambodży .	synku	8	Hum
Przygoda u czoła Lodowca Hansa uświadomiła mi , że lepiej bezpośrednio nie dotykać lodowego klifu .	klifu	14	Inan
Tak właśnie zrobiliśmy , a tych handlarzy , którzy pracowali półlegalnie , przegonili pogranicznicy .	handlarzy	6	Hum
Mieliśmy wczoraj naprawdę rekordowy początek roku .	początek	4	Inan
Z prawej wyskoczył cwałem ciężkozbrojny bez hełmu , schylił się , usiłując chwycić za szory zaprzęgu .	zaprzęgu	15	Inan
Trzymający ją mężczyzna roześmiał się .	mężczyzna	2	Hum
Mieszkający samotnie w starej drewnianej chałupie inwalida nie ukrywa , że jest rozczarowany .	inwalida	6	Hum
- Poza tym Jan Paweł II nie został jeszcze ogłoszony świętym .	świętym	10	Hum
Przygnębiający był ten stan bierności , marazmu , kiśnięcia .	marazmu	6	Inan
Jego brat , rzecznik łódzkiego pogotowia , jest szefem Związku .	rzecznik	3	Hum
Świadek zeznawałby w procesach pozostałych członków gangu .	gangu	6	Inan
Resa pośpieszyła do Ab–Rama , czekającego niecierpliwie w swoim namiocie .	namiocie	9	Inan
Mówią , że chcą wynająć salę na bankiet dla gości z Zachodu .	gości	9	Hum
Od instynktu samozachowania wybaw nas , Panie .	instynktu	1	Inan
Miewał zawsze wielu antagonistów .	antagonistów	3	Hum
Teraz na zamówienie mafii gangi złożone z zamieszkałych w Niemczech Polaków kradną samochody wybranej marki .	gangi	4	Inan
Ten kierownik to ma chyba fioła .	fioła	5	Nhum
Użytkownik ma do dyspozycji 6 baz zawierających informacje posortowane według wybranego kryterium .	Użytkownik	0	Hum
Proszę uprzejmie , pan poseł Zbyszek Zaborowski z SLD .	poseł	4	Hum
Tak zabawili się trzej tarnobrzescy gimnazjaliści .	gimnazjaliści	5	Hum
W pewnym momencie Łukasz mocno nadepnął na hamulec , samochód się zatrzymał , a chłopak wyskoczył i zatrzasnął komandora w środku .	hamulec	7	Inan
To pleban kawęczyński jechał dwukonnym wózkiem do miasta .	pleban	1	Hum
Jest mowa i o plastikach w paski na kurtki dla pocztów sztandarowych .	paski	6	Inan
Orzechy i migdały zemleć , wymieszać z cukrem oraz 3 łyżkami masła na gładką masę i połączyć z kuskusem .	Orzechy	0	Nhum
W jego koszyku znalazło się aż 125 dorodnych prawdziwków .	koszyku	2	Inan
Zakłada ona , że obywatele polscy będą mogli przebywać w Izraelu bez wizy do trzech miesięcy i że takie samo prawo w odniesieniu do pobytu w Polsce będą mieli obywatele Izraela .	obywatele	4	Hum
- Pani poseł , czas minął .	poseł	2	Hum
Uczniów to nie przekonało .	Uczniów	0	Hum
Kilka dni temu na oddział trafiła prątkująca absolwentka gimnazjum .	oddział	4	Inan
Tenisiści stołowi Energetyka Opoki Trzebinia znają już terminy spotkań barażowych o I ligę , w których ich rywalem będzie zwycięzca II ligi łódzko - świętokrzyskiej Start Brzezina .	zwycięzca	19	Hum
Protokół i listę mówców prowadzić będą pani posłanka Zdzisława Kobylińska oraz pan poseł Andrzej Zapałowski .	poseł	12	Hum
Przeważnie zdarzają się zwichy tylne , obrotowo - tylne i przednie 5 . kręgu lędźwiowego .	zwichy	3	Inan
Wszystkie zamieszczone na stronie internetowej numery telefoniczne były nieaktualne .	numery	5	Inan
Tematem tegorocznego Forum była fotografia otworkowa .	Tematem	0	Inan
W 2000 r . na światowych giełdach nastąpił krach , a zawyżone kursy akcji spółek internetowych spadły na łeb .	kursy	12	Inan
Sołtys Ligoty Stanisław Kuźnik składa serdeczne podziękowanie wszystkim sponsorom , którzy przyczynili się do zorganizowania festynu i dzięki którym dzieci z Ligoty będą mogły pojechać na wycieczkę .	festynu	15	Inan
Specjaliści Paribas mówią przede wszystkim o doskonałej kondycji gospodarki amerykańskiej , która winduje kurs dolara .	Specjaliści	0	Hum
Trzech sprytnych chłopców szukało nawet syrenki w przedszkolnym akwarium .	chłopców	2	Hum
Przez dwa ostatnie tygodnie policjanci zaczęli podejrzliwie obserwować Staszka i Dawida .	tygodnie	3	Inan
- Ty jesteś łobuz !	łobuz	3	Hum
Napisy okrążały schematyczny wizerunek wypieczonego chleba .	chleba	5	Inan
Dotąd absolutną większość w parlamencie mieli zwolennicy Radovana Karadżicia .	zwolennicy	6	Hum
- Panowie przyszli .	Panowie	1	Hum
Kiedy jest rozmnoża królików ?	królików	3	Nhum
Czy pan zna inżyniera Jarzęckiego ?	inżyniera	3	Hum
Witam , Poszukuję jakiegoś opracowania na temat początków rozwoju przemysłu w Białymstoku .	początków	7	Inan
Zbigniew Brzeziński , doradca prezydenta Jimmy'ego Cartera do spraw bezpieczeństwa , zaapelował o umiar do robotników , władzy i Kościoła w Polsce .	umiar	13	Inan
Na posłanie z ziół i kwiatów ułożono kości i pokryto je szczątkami sztandaru .	sztandaru	12	Inan
Prototyp zminiaturyzowanej komory jest już gotowy .	Prototyp	0	Inan
Dlaczego babiarze udają nababów ?	babiarze	1	Hum
Zwycięskiego syberiana sprowadziła miesiąc temu ze Stanów Zjednoczonych .	syberiana	1	Nhum
Nieźle tam zarabia , ale niejednokrotnie chwali się drogimi rzeczami kupionymi za pieniądze , które syn tego pana zostawia na utrzymanie ojca .	syn	15	Hum
Zgłosili się panie i panowie posłowie do zadania pytań .	panowie	4	Hum
W Senacie zgłosił swoje przystąpienie do komunistów senator Boguszewski , wybrany z listy BBWR , już przedtem miał kontakty .	Senacie	1	Inan
Nos odgryzł syn .	syn	2	Hum
- To unik , tato .	tato	4	Hum
i w ogóle jest syf .	ogóle	2	Inan
Kanclerz Kiesinger wyraźnie oświadczył , że jego rząd uzależnia przystąpienie NRF do układu od szeregu warunków i w ogóle odkłada ten problem na nieokreślony termin .	układu	12	Inan
Ażeby takim przykrym kolizyom zaradzić , puszczamy w świat ten oto podręcznik .	podręcznik	11	Inan
Duch Boży mówi , abym szedł . . .	Duch	0	Nhum
W niedzielę rano odprawiono z okazji rocznicy śmierci kompozytora msze święte w kościołach sióstr Wizytek i św . Krzyża , gdzie spoczywa serce Chopina .	Krzyża	18	Inan
Ciekawostkę stanowi fakt , że dwa górne rzędy wibrysów mogą poruszać się niezależnie od dwóch dolnych rzędów .	wibrysów	8	Nhum
Załadował na wóz wynajętych gazeciarzy i rozwiózł po mieście , każąc rozdawać list przechodniom .	gazeciarzy	4	Hum
Aktor mamrocze coś niewyraźnie pod nosem , ale ma mikrofon i widz go zrozumie .	widz	11	Hum
Nowa ustawa zobowiąże szefów do zakupu okularów korekcyjnych dla pracowników , którzy potrzebują ich podczas wykonywania swoich zajęć .	szefów	3	Hum
Po czwartkowej wizycie w ratuszu zmienił jednak zdanie .	ratuszu	4	Inan
Co jest za tym murem ?	murem	4	Inan
W latach sześćdziesiątych , już jako sztygar oddziałowy , pamiętam odbiory przygotowywanych do rozruchu ścian dokonywane przez dyrektora Śniegonia .	oddziałowy	7	Hum
Stanisław N . nie jest jedynym szczecińskim nauczycielem , któremu zarzuca się łapówkarstwo .	nauczycielem	7	Hum
W święta głodowało już sześciu pracowników MZK , przedwczoraj dwóch z nich odmówiło przyjmowania płynów .	pracowników	5	Hum
Należy starać się odnaleźć każdego postrzałka .	postrzałka	5	Nhum
Krew spryskała bok mierzynka .	mierzynka	3	Nhum
Kontrast ten może nawet świadczyć o jakiejś obojętności czy martwocie religijnej panującej w czasach proroka .	czasach	13	Inan
W pierwszych dniach tygodnia czekają Cię ożywione spotkania z przyjaciółmi lub kolegami .	kolegami	11	Hum
Chłopak zerwał się z miejsca , złapał posążek i ścisnął mocno w dłoni .	posążek	7	Inan
Tomasz Zombie wszedł w towarzystwie strażnika .	strażnika	5	Hum
I jakie są skutki bezwzględnego wymogu potwierdzenia w korpusie ?	wymogu	5	Inan
Zacisnąłem palce na szorstkim płótnie i wyczułem obłe kształty pocisków .	palce	1	Inan
Planiści wypracowali już koncepcję drogi , na której przeobrażenie to winno się odbyć kosztem możliwie minimalnych ofiar .	Planiści	0	Hum
Katecheta zwięźle opowiedział o swych niedomaganiach i wtrącił słówko o kosztownej kuracji w Karlsbadzie .	Katecheta	0	Hum
Tenisiści stołowi Energetyka Opoki Trzebinia znają już terminy spotkań barażowych o I ligę , w których ich rywalem będzie zwycięzca II ligi łódzko - świętokrzyskiej Start Brzezina .	rywalem	17	Hum
Pan chciałby szefa podporządkować bezpośrednio prezydentowi .	prezydentowi	5	Hum
Na szczęście któryś z bliżej stojących chłopaków podskoczył i podtrzymał go .	chłopaków	6	Hum
Dzięki nim zmniejsza się u chorego zaleganie afektu , rozładowują się utrwalone stereotypy uczuciowe , obiektywniej widzi swoją sytuację .	chorego	5	Hum
Nie wiedziała , jak długo Francuzka stała w progu .	progu	8	Inan
Pokaże także adresy różnych instytucji , wyświetli kolorowy rozkład jazdy i poda repertuar kin czy teatrów .	rozkład	8	Inan
Wielu partyjnych kolegów chętnie widziałoby go na stanowisku prezydenta Łodzi , ponieważ Marcisz ma opinię dobrego menadżera .	menadżera	16	Hum
Czy w Kielcach uczył się w szkole rabinackiej i czy naprawdę był rabinem , jak zapewniał Fangora i inne osoby w Ameryce ?	rabinem	12	Hum
Spore zdziwienie mieszkańców Gdyni wywołał widok jachtów w basenie Prezydenta .	Prezydenta	9	Hum
Neapolitańska policja zatrzymała czterech młodych Polaków pod zarzutem wymuszania pieniędzy i rabunku .	pieniędzy	9	Inan
Byłem jedynym płońskim taksówkarzem .	taksówkarzem	3	Hum
Policjanci z pobliskiego komisariatu przyznają , że docierają do nich sygnały o rozbojach .	sygnały	10	Inan
Tylko współlokatorka nie rokowała przyjemnego pobytu . . .	pobytu	5	Inan
Wydawało się , że fiskus nie będzie dłużej gnębił Waldemara Gronowskiego , legnickiego piekarza , który przez ponad 10 lat rozdawał pieczywo najuboższym .	piekarza	13	Hum
Parowozy zawsze fascynowały i przerażały .	Parowozy	0	Inan
O klasztornym piekle , zgotowanym przez trzy potwory w habitach , pisaliśmy w kwietniu br .	potwory	7	Nhum
Jaki trunek do czego pasuje ?	trunek	1	Inan
Tegoroczną nowością raportu jest skala krajowego seksu wirtualnego .	raportu	2	Inan
Tu należy się ukłon w stronę nauki . . .	ukłon	3	Inan
Dla światowych producentów odzieży Polska staje się coraz ważniejszym rynkiem zbytu .	producentów	2	Hum
Policja przypuszcza , że najnowszy ładunek został porzucony przez spłoszonego niedoświadczonego terrorystę .	terrorystę	11	Hum
Jej program układał radca handlowy ambasady RP w Rzymie .	radca	3	Hum
Przed tygodniem rzesze ostrzeszowian odprowadziły go na miejsce wiecznego spoczynku .	tygodniem	1	Inan
- Taki był u nas zwyczaj od pokoleń .	zwyczaj	5	Inan
W samej końcówce rozpaczliwe broniliśmy się i naprawdę radomianie napędzili nam wielkiego stracha .	radomianie	8	Hum
Według KPN budżet państwa traci na [import]cie paliw , a zasady koncesjonowania są niejasne .	[import]cie	6	Inan
- Państwo nie może tolerować terrorysty Leppera .	terrorysty	5	Hum
- Od nowego roku będzie nowy katecheta .	katecheta	6	Hum
Bronił eksmitowanych na bruk , naprawiając błędy przyjętej przez koalicję SLD­PSL ustawy , grzmiał na globalistów i świeżych krajowych , drapieżnych kapitalistów .	kapitalistów	21	Hum
Nie potrzeba do niego wąglika , sarinu ani nawet walizkowej bomby atomowej .	sarinu	6	Inan
Ludzie uważają , że do kłopotów z uzyskaniem zgody przyczynili się inwestorzy starający się o pozwolenie na budowę małego osiedla na działce sąsiadującej z ogródkami mieszkańców .	inwestorzy	11	Hum
Osobiście nigdy nie żałowałem , iż zostałem historykiem .	historykiem	7	Hum
I fiat palio weekend został zatrzymany .	fiat	1	Nhum
Dzieci spędzają noce w oddziale noworodków .	noworodków	5	Nhum
- Moich zawodników zdopingowała wczorajsza porażka Górnika z Jeziorakiem .	zawodników	2	Hum
- Czy grozi nam czarny scenariusz rozwoju sytuacji gospodarczej ?	scenariusz	5	Inan
Przed światłami kierujący ruchem zatrzymał tira , a za nim stanęła skoda .	tira	5	Nhum
Megane oddał synowi , pracownikowi dydaktycznemu warszawskiej uczelni .	pracownikowi	4	Hum
Wydawało się , że fiskus nie będzie dłużej gnębił Waldemara Gronowskiego , legnickiego piekarza , który przez ponad 10 lat rozdawał pieczywo najuboższym .	fiskus	4	Nhum
Wzorem większości producentów przeczytał wyłącznie krótkie streszczenie zawarte na pierwszej stronie , ale po jego minie można było wyczytać , że sama koncepcja go urzekła .	producentów	2	Hum
Skałki Kroczyckie są miejscem treningów członków śląskich klubów wysokogórskich .	członków	5	Hum
Napastnicy grozili nastolatkom , że ich pobiją .	nastolatkom	2	Hum
Z początkiem bieżącego roku Ministerstwo Oświaty i Wychowania podwyższyło uczniowskie stypendia .	początkiem	1	Inan
Egzekucja należy do komornika sądu , w którego okręgu statek znajduje się w chwili wszczęcia egzekucji .	okręgu	8	Inan
Skazani rozwożeni są natychmiast do więzień na terenie całego kraju .	Skazani	0	Hum
Wykształciuchy bronią się przed premierem .	Wykształciuchy	0	Nhum
Usmaż jeszcze kiedyś faworki , błagam .	faworki	3	Nhum
Kochamy Polskę , lecz fakty składające się na polską rzeczywistość działają nam na nerwy .	fakty	4	Inan
Rzecznik australijskiego koncernu Chris Codrington wyraził przekonanie , że przyczyną zatrucia wód Cisy nie był cyjanek .	koncernu	2	Inan
Uczestnicy zjazdu wypili wodę święconą z kościoła Najświętszego Zbawiciela .	Uczestnicy	0	Hum
- Chce Pan przez to powiedzieć , że Tajner zrobił podział mandatów pod siebie ?	mandatów	11	Inan
Towarzystwo oddelegowało kilku rzeczoznawców do pełnienia dyżurów i udzielania porad konsumentom .	rzeczoznawców	3	Hum
U ludów słowiańskich rodzina miała charakter patriarchalny , a przewodził jej ojciec .	ojciec	11	Hum
Jego matka znała słabo francuski , ale jako tako mogły się porozumieć .	francuski	4	Inan
Obowiązują wizy , odprawa paszportowa , a przy wyjeździe celnik gruntownie przeszukuje rzeczy w poszukiwaniu skarbów , których tak wiele stąd ukradziono .	skarbów	15	Inan
Jeden z architektów przybija na ocalałej bramie kartkę wyrwaną z notesu .	architektów	2	Hum
Wiślacy zgnietli niemiecką drużynę siłą ofensywy .	Wiślacy	0	Hum
Załadował na wóz wynajętych gazeciarzy i rozwiózł po mieście , każąc rozdawać list przechodniom .	wóz	2	Inan
- Czy nie zabrakło woli politycznej do osądzenia komunistycznych zbrodniarzy ?	zbrodniarzy	9	Hum
- W spadku po odchodzącej ekipie nowy rząd otrzymuje olbrzymi deficyt w bilansie handlowym .	spadku	2	Inan
Niezgoda w ostatniej chwili uskakuje do przydrożnego rowu , inaczej byłyby dwa pogrzeby .	pogrzeby	12	Inan
Kościański zespół przegrał je wszystkie za wyjątkiem derbowego występu w Rawiczu .	wyjątkiem	6	Inan
Często jednak dociekliwość pracowników straży powoduje , że za kratki trafiają groźni przestępcy .	przestępcy	12	Hum
Minister wciąż ma wielbicieli .	wielbicieli	3	Hum
Do głosowania nad uchwałą Senatu przystąpimy jutro rano .	Senatu	4	Inan
Obstawił się własnymi ochroniarzami i policjantami .	policjantami	5	Hum
- Idę w ślady ojca , on też kucharzy .	ojca	4	Hum
Z drugiej strony pisowcy chyba mnie polubili .	pisowcy	3	Hum
Jestem proboszczem liczącej 1180 osób parafii , która posiada zabytkowy kościół wpisany do rejestru zabytków .	rejestru	13	Inan
Niektórzy twierdzą , że patrząc na nich można to zauważyć . . .	Niektórzy	0	Hum
Ponadto można eksportować dane do pliku tekstowego z uwzględnieniem wybranych kolumn i sposobu sortowania .	sposobu	12	Inan
Użytkowanie przez spółdzielnię wkładów gruntowych jest odpłatne .	wkładów	3	Inan
Był mężem mojej bratanicy .	mężem	1	Hum
Celników z rzepińskiej Izby Celnej wspierali funkcjonariusze z Poznania i Krakowa .	Celników	0	Hum
Mariola odstawiła torebkę na malutki stołeczek .	stołeczek	5	Inan
" Dąbrowska odnotowuje , że zarys którejś z nowel Kowalska w pośpiechu rzuciła na papier po francusku " .	pośpiechu	11	Inan
Niech zstąpi Duch Twój !	Duch	2	Nhum
W Polsce wyniki leczenia nowotworów dlatego są dwukrotnie gorsze od uzyskiwanych na Zachodzie , ponieważ na terapię trafiają chorzy przeważnie już z zaawansowanym guzem .	guzem	23	Nhum
Podpłynął księżyc , przywarł i zaczął ssać .	księżyc	1	Inan
- Słyszy pan te krzyki ?	krzyki	4	Inan
Pana podpis jest nieważny ?	Pana	0	Hum
Podczas pobytu w elbląskim garnizonie najczęściej towarzyszyli mu dowódca stacjonującej tam dywizji , komendant szpitala wojskowego i kapelan .	komendant	13	Hum
Niedawno urodziły mu się bliźniaki .	bliźniaki	4	Nhum
Na trotyl natrafiono w miejscu , które wskazał radiesteta , zatrudniony przez rodzinę zaginionego .	zaginionego	13	Hum
Zjadano dziennie stado baranów , setki kur , górę ryżu , sadzawkę jogurtu , piramidę melonów i wypijano wagon coca-coli .	jogurtu	12	Inan
Według legend , w studni głębokiej na ponad 30 metrów znajdują się wejścia do lochów i tajnych chodników łączących posiadłości właścicieli zamku .	zamku	21	Inan
Zauważam jednak , że kabel jest końcem rogu olbrzymiego nosorożca , który stoi na dole .	nosorożca	9	Nhum
Odkrycie jest ważnym głosem w dyskusji dotyczącej bezpieczeństwa przeszczepów pochodzących od zwierząt .	przeszczepów	8	Inan
Polskich komunistów nie łączyły nigdy żadne specjalne więzy z przywódcami ludowych Chin .	komunistów	1	Hum
Romantycznym bohaterom odpowiada szatańska wersja pieśni .	bohaterom	1	Hum
Mag osunął się bezwładnie .	Mag	0	Hum
Są bardzo niebezpieczne , ich wybuch spowodowałby falę uderzeniową o promieniu do jednego kilometra .	promieniu	10	Inan
Postępowanie przeciwko przestępcy , który został świadkiem koronnym , ulegałoby zawieszeniu .	świadkiem	6	Hum
To był ten kopiec .	kopiec	3	Inan
Nie ma ani chwili na odpoczynek .	odpoczynek	5	Inan
Każdy zbombardowany , okaleczony , nieszczęśliwy dom stawał się teraz ich celem .	celem	11	Inan
W 1935 roku brytyjski informatyk Alan Mathison Turing wymyślił abstrakcyjną maszynę .	informatyk	4	Hum
Wtedy bandyci atakują chłopaka .	chłopaka	3	Hum
Astma jako wynik uczulenia na pyłki roślin ma burzliwy przebieg i stwarza duże niebezpieczeństwo dla chorego .	wynik	2	Inan
Funkcjonariusze inspekcji celnej przy pomocy biegłych ustalili , że przy próbie wywozu najprawdopodobniej naruszone zostały przepisy Kodeksu celnego .	Funkcjonariusze	0	Hum
Kierowca mazdy uderzył tam w peugeota i uciekł z miejsca zdarzenia .	peugeota	5	Nhum
- Dobre sondaże są dla premiera niemałym kłopotem .	premiera	5	Hum
Nazajutrz Tomek osiodłał pony i razem z Dingiem wyruszył do parowu .	pony	3	Nhum
Po przyjeździe do Izraela trzeba się rozstać ze złudzeniem , że ktoś tu na nas czeka .	przyjeździe	1	Inan
Przytyka Studentowi kieliszek do ust i poi go szampanem .	szampanem	8	Nhum
W Kcyni odbyło się spotkanie z kandydatami na kierowników na samodzielny publiczny zakład opieki zdrowotnej w Kcyni i Kowalewku .	kandydatami	6	Hum
Po rzucie rożnym obrońcy Vardaru zbyt wolno wychodzili spod swojej bramki , podanie z linii pola karnego dotarło do Kucharskiego , a ten strzelił , stojąc tyłem do bramki .	tyłem	26	Inan
Przepraszam , nawet po pouczeniu pana marszałka zacznę od kilku zdań wstępu .	marszałka	6	Hum
Psy grzebały w śmietniku .	śmietniku	3	Inan
W poniedziałek naczelnik Jerzy Żemełko był na urlopie .	urlopie	7	Inan
W samej końcówce rozpaczliwe broniliśmy się i naprawdę radomianie napędzili nam wielkiego stracha .	stracha	12	Nhum
Przecież high life i skrajna nędza są normalką .	high	1	Inan
Klub Przyjaciół Życia Ludzkiego działa w Nakle od 1996 roku .	Przyjaciół	1	Hum
Tacy obserwatorzy na pewno nie wnoszą nic do naszej pracy pełnej poświęcenia .	obserwatorzy	1	Hum
Cało z wypadku wyszedł kierowca poloneza .	poloneza	5	Nhum
Dotychczas obowiązek donoszenia WKU o studentach , którzy przerwali naukę , spoczywał na uczelniach .	studentach	5	Hum
Ta masa wodna , nieraz podnosząca poziom Wiku o jeden metr ponad równię Puckiej Zatoki , spotyka się przy dziobie gołębia z silnym prądem zachodnim .	poziom	6	Inan
Najpierw zajmie się nadawcami programów regionalnych , więc prawdopodobnie pierwsi z nich będą mogli dostać koncesje w sierpniu - wrześniu .	nadawcami	3	Hum
Specjaliści Paribas mówią przede wszystkim o doskonałej kondycji gospodarki amerykańskiej , która winduje kurs dolara .	dolara	14	Nhum
Trudno przewidzieć wynik głosowania nad skróceniem tygodnia pracy .	tygodnia	6	Inan
Beata nigdy nie zobaczyła swojego wydrukowanego Aniołka .	Aniołka	6	Nhum
Ale tego rodzaju zabiegi mogą być wykonywane tylko przez specjalnie przeszkolone ekipy zwalczania szkodników .	szkodników	13	Nhum
Starczy tego rzępolenia , łajzy !	łajzy	4	Nhum
W skład Grupy wchodzą firmy i ludzie powiązani z interesami postkomunistów .	postkomunistów	10	Hum
Mężczyzna był nietrzeźwy .	Mężczyzna	0	Hum
Wyniki podaliśmy wczoraj .	Wyniki	0	Inan
Pracowicie wyodrębnił pojęcia takie jak ból , smutek , rozpacz , cierpienie , żal .	ból	5	Inan
To pytanie nie daje spokoju .	spokoju	4	Inan
Wyszliśmy na dwór , a potem kroczyliśmy smutno ulicą Wolności , obok naszej piekarni , naszego fryzjera , naszej apteki .	dwór	2	Inan
Morderca żony i córki trafi do szpitala psychiatrycznego , lekarze co pół roku będą sporządzać raporty dla sądu o stanie jego zdrowia .	Morderca	0	Hum
Mimo że Amerykanie uznali operację za udaną , z rejonu walk zdołało wymknąć się wielu partyzantów .	partyzantów	15	Hum
Narzędzie zbrodni i rogi pochodzą z dworku , ty to czujesz ?	dworku	6	Inan
- Pani duch jest jednak z Północy …	duch	2	Nhum
Na szczęście voyagerom wyznaczono cele .	voyagerom	2	Inan
Sygnalizuje pan brak odpowiedzi na pytanie dotyczące rencistów i emerytów .	rencistów	7	Hum
Wyznaczeni posłowie zajęli miejsca .	posłowie	1	Hum
Czemu kogut głośno pieje ?	kogut	1	Nhum
W pierwszej części obrad sekretarzami będą pani posłanka Zdzisława Kobylińska i pan poseł Mieczysław Jedoń .	poseł	12	Hum
Równocześnie metody te wpływają na świadomość , przekonania i postawy ucznia .	ucznia	10	Hum
Do tej pory Jarosław Kret , prezenter z TVP , był nieugięty .	prezenter	6	Hum
Dlatego w Masterlink pojawiają się kolejne etaty na odległość .	etaty	6	Inan
Mariusz Walter zadebiutował jako reżyser już w latach 60 . , szybko związał się z telewizją publiczną , w której pracował aż do lat 80 .	reżyser	4	Hum
Przerażona dziewczyna pobiegła do ciotki , która mieszka za ścianą , i w sekrecie opowiedziała , co robił jej tata .	sekrecie	13	Inan
Stali wśród namiotów , w których krzątali się nadwołżańscy Niemcy , zruszczeni po wiekach .	wiekach	13	Inan
- Porywacze uwolnili na naszą prośbę część kobiet oraz akredytowanych w naszym kraju dyplomatów .	Porywacze	1	Hum
Jeżeli nasz samochód to combi lub van , a zwierzak jest duży , możemy przewozić go w odpowiednio przygotowanym bagażniku .	zwierzak	9	Nhum
Słońce prażyło niemiłosiernie , a na domiar złego wykończyły się zapasy żywności i wody .	zapasy	10	Inan
Donald Tusk będzie miał kontrkandydata w wyścigu o fotel przewodniczącego Platformy .	przewodniczącego	9	Hum
We znaki dały się też niewyczyszczone przed zimą przewody kominowe .	przewody	8	Inan
Na skrzyżowaniach wyrastają rośli policjanci , gazeciarze wciskają przechodniom papierowe płachty i przekrzykują się nowościami z wczorajszego dnia i nocy , która właśnie minęła .	gazeciarze	6	Hum
W pustym hallu , zebrani przy swoich skrzynkach żołnierskich , stali nasi chłopcy .	chłopcy	12	Hum
Konia by powaliło .	Konia	0	Nhum
Ponadto można eksportować dane do pliku tekstowego z uwzględnieniem wybranych kolumn i sposobu sortowania .	pliku	5	Inan
Steve zaklina się , że po każdym dyżurze szykuje ekstra posiłek czworonożnemu ratownikowi .	ratownikowi	12	Hum
Auto zostało całkowicie zniszczone , a kierowcę strażacy wydobyli za pomocą narzędzi hydraulicznych .	kierowcę	6	Hum
PQBoot to narzędzie do zmiany partycji bootującej dla tych użytkowników , którzy tylko od czasu do czasu potrzebują skorzystać z innego systemu .	użytkowników	9	Hum
Paul Broca , lekarz paryski , zachował mózgi swoich pierwszych pacjentów dla potomności .	pacjentów	10	Hum
Ten biało - czarny kocur zdobył szturmem serca pracowników Downing Street , a z czasem jego sława rozprzestrzeniła się na cały kraj .	kraj	21	Inan
Żelazny kolos Żugajowi nie nabił nawet guza .	guza	6	Nhum
Suchocka nie jest osamotniona w swej walce z prokuratorami .	prokuratorami	8	Hum
Czeka koń z furą .	koń	1	Nhum
Antyterroryści spuścili się po linach ze śmigłowca wprost pod drzwi gangstera .	gangstera	10	Hum
Jeśli zostanie on zrealizowany , to za pięć lat będziemy mieli w kraju ok . półtora miliona rodzin pszczelich .	miliona	16	Inan
– Jeden z nich zaczął napierać na mnie ciałem .	Jeden	1	Hum
- Spotkaliśmy się , towarzyszu rektorze . . .	rektorze	5	Hum
Zazwyczaj dzieci i kobiety nie były samurajami .	samurajami	6	Hum
Nikt nie zatrzyma rozwoju medycyny .	rozwoju	3	Inan
Zamierzał ją zawieść do inseminatora .	inseminatora	4	Hum
Jeszcze przez dwa tygodnie będą mieszkać w namiotach .	tygodnie	3	Inan
Odkręcił korek , oblał się i podpalił .	korek	1	Inan
Obie też towarzyszyły swoim synom na uroczystości wręczenia stypendiów w Pałacu Prezydenckim .	synom	4	Hum
Mieszka pod Warszawą , a w swoim pięciohektarowym gospodarstwie , oprócz dwudziestu psów , hoduje także konie i kozy .	psów	12	Nhum
Razem ze mną miał być przyjęty inny kandydat , który jednak w ostatniej chwili zrezygnował .	kandydat	7	Hum
Dotąd absolutną większość w parlamencie mieli zwolennicy Radovana Karadżicia .	parlamencie	4	Inan
Choć pod tym względem ci obecni ani trochę nie ustępują poprzednikom .	poprzednikom	10	Hum
Regulaminowe decyzje , po wnikliwej analizie protokołu z tego pojedynku , podejmie Wydział Dyscypliny BOZPN .	protokołu	6	Inan
Któż lepiej niż Ty mógłby mnie poprowadzić przez życie .	Któż	0	Hum
Zakłada ona , że obywatele polscy będą mogli przebywać w Izraelu bez wizy do trzech miesięcy i że takie samo prawo w odniesieniu do pobytu w Polsce będą mieli obywatele Izraela .	obywatele	29	Hum
Przewaga któregokolwiek układu skurczowego lub niedowład któregokolwiek układu rozkurczowego powoduje skurcz mięśni gładkich oskrzeli .	mięśni	11	Inan
Nasze spółdzielnie produkcyjne powstały dzięki przykładowi kołchozów radzieckich .	kołchozów	6	Inan
Przed sądem chce też udowodnić , że miał pieniądze na podwyżki dla lekarzy .	lekarzy	12	Hum
Rodzice kondorka trochę się pospieszyli .	kondorka	1	Nhum
Ale jak zaufać policji , która robi w konia kandydatów na policjantów ?	konia	8	Nhum
Czy jej brak ma istotny wpływ na jakość amerykańskiego systemu szkolnictwa wyższego ?	brak	2	Inan
Są pożyteczne , zbliżają ludzi i umacniają przyjaźnie , a artystom garmażerni , barmanom , kelnerom i sprzątaczkom płaci kasjer ambasady .	artystom	10	Hum
W sidła oszustów - pośredników oferujących pracę Polacy wpadają także w Hiszpanii .	oszustów	2	Hum
A gdzież to panowie tak podróżują ?	panowie	3	Hum
Zaciągam się papierosem i próbuję przypomnieć sobie dawnego Dziedziuszkę .	papierosem	2	Nhum
Tam weterynarz przeprowadził sekcję , z której jasno wynika , że pies padł z powodu wysokiej temperatury .	pies	11	Nhum
Rolnik , szukając schronienia , błyskawicznie wskoczył na dwukółkę .	Rolnik	0	Hum
Zgromadzili się gapie .	gapie	2	Hum
Duchy lubią takie miasteczka .	Duchy	0	Nhum
W zeszłym tygodniu , świadczeniobiorcy otrzymali z ZUS-u zawiadomienie o wysokości waloryzacji .	świadczeniobiorcy	4	Hum
Przenosi obojętne spojrzenie na stronę z nekrologami , którą Gabriela przygważdża do stołu kościstym palcem .	stołu	12	Inan
Rzecznik australijskiego koncernu Chris Codrington wyraził przekonanie , że przyczyną zatrucia wód Cisy nie był cyjanek .	cyjanek	15	Inan
Jadący z nadmierną szybkością wartburgiem Marek Ch . , będąc pod wpływem alkoholu , został wyrzucony na łuku jezdni na pobocze , a następnie przekoziołkował i uderzył w drzewo .	wartburgiem	4	Nhum
Uczniowie klas młodszych sprzątali las w oddziale 184 pod kierunkiem stażysty , Przemysława Mazgaj .	stażysty	10	Hum
W pół godziny po wylądowaniu samolot wystartował do Londynu , z pełną 185-osobową obsadą na pokładzie .	samolot	5	Inan
W czasie pobytu u sióstr w klasztorze Krystyna korespondowała z ojcem , niecierpliwie wyczekując jego listów .	listów	15	Inan
Wyjątkiem były centrale banków .	Wyjątkiem	0	Inan
Sołtys Ligoty Stanisław Kuźnik składa serdeczne podziękowanie wszystkim sponsorom , którzy przyczynili się do zorganizowania festynu i dzięki którym dzieci z Ligoty będą mogły pojechać na wycieczkę .	sponsorom	8	Hum
Zwolennicy Mossadegha , ministrowie , podejrzani oficerowie , działacze Tudeh są przesłuchiwani i torturowani .	Zwolennicy	0	Hum
Podrzuciłem kluczyki w dłoni .	kluczyki	1	Inan
Tym razem milicjanci interweniowali natychmiast .	milicjanci	2	Hum
W programie obchodów przewidziano spotkanie uczestników ówczesnych wydarzeń , wystawę fotograficzną i sesję naukową .	programie	1	Inan
Wyprowadzają one małe koźlęta na płaty śniegu i uczą je zjeżdżać na racicach .	płaty	5	Inan
Zabrała mnie ze sobą , była to dobra okazja , żeby zafundować sobie darmową terapię , pojechać szybko jej passatem do Gdańska .	passatem	19	Nhum
Według relacji świadków , gdy biały opel frontera zbliżył się do ambasady , wyskoczył z niego człowiek ubrany w panterkę , z granatnikiem w ręku , i próbował odpalić granat w kierunku ambasady .	frontera	7	Nhum
Grubas roześmiał się głośno , przytrzymując ręką pióra na głowie .	Grubas	0	Hum
Dzieci leżą w oddziale noworodków , ale mamy mogą je odwiedzać .	noworodków	4	Nhum
Od odpowiedzi na pierwsze dwa pytania zależy wybór odpowiedniego stylu i języka .	stylu	9	Inan
Obok colonel Eddie majstruje coś we wspaniałym Kodaku .	colonel	1	Hum
Podmuch obrócił go i Nicholas zahaczył barkiem o coś miękkiego .	barkiem	6	Inan
Rzecznik praw obywatelskich poprosił o wyjaśnienia Ministerstwo Zdrowia .	Rzecznik	0	Hum
Wiedziałem , że dalsza indagacja do niczego nie doprowadzi , ale na wszelki wypadek nie zbliżałem się do pola obstrzału dzielnego ormowca .	ormowca	21	Hum
Spora część delegatów , reprezentujących zwłaszcza środowiska młodzieżowe , zaprezentowała alternatywny wobec projektu kierownictwa program .	program	14	Inan
Z kolejnej po jabłkach , wiśniach i porzeczkach klęski urodzaju cieszą się konsumenci .	konsumenci	12	Hum
Z jego zeznań wynika , że wczoraj około godziny 15 podjechał samochodem na ulicę Grażyńskiego .	samochodem	11	Inan
Prezydent zapowiada , że w ciągu półtora roku plan zostanie zmieniony .	Prezydent	0	Hum
Z ważnych powodów sąd może na żądanie poszkodowanego przyznać mu zamiast renty lub jej części odszkodowanie jednorazowe .	powodów	2	Inan
Kierowca wrzuca wsteczny i na pełnym gazie taranuje pieszych .	wsteczny	2	Inan
Wtedy stosowano materiały niskiej jakości .	materiały	2	Inan
Dziękujemy panu , panie komisarzu .	komisarzu	4	Hum
Na ich temat nic również nie powiedzieli płatni informatorzy , do których w tej sprawie zwrócili się policjanci prowadzący dochodzenie .	informatorzy	8	Hum
Jeszcze kilka miesięcy temu 15 dyplomatów z tej listy pracowało w Polsce .	dyplomatów	5	Hum
I znów poczułeś się zwycięzcą !	zwycięzcą	4	Hum
Nie spodziewali się tego organizatorzy z Automobilklubu Świętokrzyskiego i działacze warszawscy .	Automobilklubu	6	Inan
33-letniemu mężczyźnie przedstawiono zarzut usiłowania zabójstwa ochroniarza .	ochroniarza	6	Hum
Wizytator pokręcił surowo głową .	Wizytator	0	Hum
Nazajutrz Tomek osiodłał pony i razem z Dingiem wyruszył do parowu .	parowu	10	Inan
Peugeot jedzie za Oplem , który zatrzymuje się przy pierwszym domu we wsi .	Peugeot	0	Nhum
Pies musi być podwórzowy , zły , w budzie na łańcuchu siedzący .	Pies	0	Nhum
Syn pana Bogdana raz sam się przekonał , jak wygląda opieka nad niepełnosprawnymi na porządnym zachodnioeuropejskim poziomie .	niepełnosprawnymi	12	Hum
Od 1 lutego wszystkie białoruskie partie i ugrupowania muszą ponownie złożyć wnioski o rejestrację .	lutego	2	Inan
Narażenie rozgrzanego psa na przeciągi grozi poważnymi komplikacjami ze zdrowiem .	przeciągi	4	Inan
Banki mogą żądać prowizji od kredytu .	Banki	0	Inan
Kiedy w Banja Luce skończył się ostatni , decydujący o medalu mecz , Halina leżała na parkiecie , a na niej kłębiła się góra ciał .	parkiecie	16	Inan
Stare gmachy , dostojne i omszałe , coraz bardziej upodobniają się do mamutów , wchłanianych w błoto epoki polodowcowej .	mamutów	12	Nhum
- Nie układa się jej pod rynkowego konkurenta , ale warto wiedzieć , w co on gra .	konkurenta	7	Hum
W sztuce miecza faza oddechu jest bardzo ważna , bo szermierz biorący oddech jest wtedy najsłabszy .	oddechu	4	Inan
Wszedł do wagonu , w przejściu natknął się na konduktora - służbistę , który zrobił mu wykład o niebezpieczeństwie związanym ze wskakiwaniem do pociągu w biegu .	wagonu	2	Inan
Pytam , czy przekonała już kiedyś jakiegoś nauczyciela , że powinien zmienić pracę .	nauczyciela	7	Hum
W czasie pobytu u sióstr w klasztorze Krystyna korespondowała z ojcem , niecierpliwie wyczekując jego listów .	klasztorze	6	Inan
Naciąg strun odbywał się jednocześnie dla całego masztu , czyli w zależności od typu masztu naciągano 12 , 16 lub 18 strun .	masztu	14	Inan
W półfinałach rozegrano mecze systemem pucharowym , a zwycięzcy awansowali do finałów .	systemem	4	Inan
Szwecja wymaga także odrobaczenia kota na 10 dni przed wyjazdem .	kota	4	Nhum
Pożegnalny obiad był prawdziwą ucztą .	obiad	1	Inan
Po paru dniach znał już wszystko i wszystkich i spędzał na górnych piętrach każdą wolną chwilę , wychodząc tylko w porze posiłków i oczywiście snu .	posiłków	21	Inan
Jedynie opisywane przez panią żółwie na Seszelach się p . . .	żółwie	4	Nhum
Wymóg obywatelstwa i miejsca stałego zamieszkania to posunięcia antydemokratyczne .	Wymóg	0	Inan
Fabrykę zaplombowano , konfiskując także podejrzane materiały .	materiały	6	Inan
Nawet piędź ziemi nie zostanie , rozdrapią jak głodne kruki .	kruki	9	Nhum
Kuskus przygotować według przepisu na opakowaniu , dodając 2 łyżki masła i szczyptę soli .	Kuskus	0	Inan
Informacje na temat historii zen i różnych szkół znajdzie Czytelnik w chronologicznym zestawieniu najważniejszych wydarzeń z historii zen w Chinach i Japonii .	zen	4	Inan
Oprócz wiśni i czereśni zawierają go truskawki i winogrona oraz orzechy włoskie .	orzechy	10	Nhum
Znalazł się generał !	generał	2	Hum
Ambasada amerykańska w Moskwie kategorycznie odmówiła komentarzy do tej sprawy .	komentarzy	6	Inan
Poinformował w nim , że około godz . 19 . 30 w poniedziałek wartownik wojskowy zauważył zerwane plomby i kłódki do garnizonowego składu amunicji .	składu	22	Inan
- Zabezpieczenie śladów na miejscu zdarzenia jest ważne , ale przede wszystkim rolą policjanta jest złapanie złodzieja .	złodzieja	16	Hum
Kot obejrzał się na mnie i usiadł , starannie zawijając ogon na przednie łapki .	ogon	10	Inan
Szef Polsatu zapowiedział , że złoży dziś do NSA wniosek o zmianę postanowienia .	Szef	0	Hum
Nagle usłyszałem strzał , wpadłem do warsztatu i zastałem trupa .	trupa	9	Nhum
Rząd stara się spowolnić proces demonopolizacji rynku telekomunikacyjnego pod hasłem ochrony wartości prywatyzowanego właśnie narodowego operatora .	operatora	15	Hum
Kilka lat temu ofiarą wandali padły mogiły na Cmentarzu na Powązkach w Warszawie .	wandali	4	Hum
Rzadko je to uszczęśliwia , często się buntują i wtedy cała rodzina ma problemy .	problemy	13	Inan
Może narażę się na krytykę ze strony pana premiera Pawlaka , ale wciąż zbyt wielkie znaczenie przywiązujemy do umów międzyrządowych .	premiera	8	Hum
Przyjechali saperzy , zabrali granat i zdetonowali go w bezpiecznym miejscu .	granat	4	Inan
Bandyci zmienili więc prawdopodobnie rejon działania .	Bandyci	0	Hum
W Tczewie w Radzie Miejskiej zasiada 23 radnych .	radnych	7	Hum
Żaden z jej członków nie zasługiwał na specjalne względy .	członków	3	Hum
Sekcja zwłok wykazała , że przyczynami zgonu były zakrzepica żyły udowej , zator tętnicy płucnej i niewydolność krążeniowo - oddechowa .	zator	12	Inan
Drużynowymi finałami zakończona została w poniedziałek rywalizacja pływaków o medale i dolarowe premie w Igrzyskach Dobrej Woli .	pływaków	7	Hum
Ze stara wyciekał olej i płyn chłodzący , a przyczepa miała zdemontowany hamulec awaryjny .	stara	1	Nhum
- W 1299-tym nadał Nakłu prawa miejskie mały drobny Król Łokietek , a Dzielny Krzywousty w 12-tym wieku narobił w Nakle kapusty !	Król	9	Hum
Przerażona dziewczyna pobiegła do ciotki , która mieszka za ścianą , i w sekrecie opowiedziała , co robił jej tata .	tata	19	Hum
Zdesperowany doktor wlał płyn do dezynfekowania narzędzi chirurgicznych do dużego naczynia , włożył w płyn zaganiacza , zamieszał .	zaganiacza	15	Nhum
- Co spowodowało , że podjęła Pani decyzję o wyjeździe i dlaczego wybór padł właśnie na ten kraj ?	wyjeździe	9	Inan
- Politycy muszą się w końcu zdeklarować i dokonać wyboru .	Politycy	1	Hum
Naukowcy z Uniwersytetu w Portland w USA sklonowali rezusa , czyli małpę należącą do rzędu naczelnych .	rezusa	8	Nhum
Daj przepis na faworki .	przepis	1	Inan
- Ucząc języka , jednocześnie budzimy w dzieciach intelekt , ciekawość świata .	intelekt	8	Inan
Gospodarze odpowiedzieli dwoma golami Ralfa Hauptmanna i Austriaka Tony Polstera .	Gospodarze	0	Hum
Pierwszą czynnością po uruchomieniu programu jest wybór zestawu .	zestawu	7	Inan
Auto z czterema młodymi mężczyznami wpadło do Wisły .	mężczyznami	4	Hum
Chłopiec przebywa w greckim przytułku prowadzonym przez organizację o złej reputacji .	przytułku	4	Inan
W teatrze nie da się oszukać widza .	widza	6	Hum
Według islamu świnia jest uznawana za zwierzę nieczyste .	islamu	1	Inan
Półkole słuchało jednak Badacza bez śmichów chichów .	Badacza	3	Hum
Pojawia się drapanie w gardle , wysypka , nagły spadek ciśnienia , duszność , trudności w oddychaniu , bóle brzucha .	bóle	18	Inan
Poza tym powinna być bardziej dostępna dla zainteresowanych osób , które zechcą przechować w nim ważne osobiste dokumenty .	dokumenty	17	Inan
Psy grzebały w śmietniku .	Psy	0	Nhum
Parafianie wysłali skargę do biskupa koszalińskiego Kazimierza Nycza .	Parafianie	0	Hum
W budynkach Kompanii Węglowej i holdingu znajdowało się wczoraj 40 związkowców .	związkowców	10	Hum
- Porywacze uwolnili na naszą prośbę część kobiet oraz akredytowanych w naszym kraju dyplomatów .	dyplomatów	13	Hum
Istotne jest , aby cele edukacji ekologicznej zostały przełożone na język konkretów mających zastosowanie w codziennych działaniach ucznia .	ucznia	17	Hum
System ma 27 stanowisk i zatwierdzony jest do roku 2100 .	System	0	Inan
Jakim prawem ojciec tak mówi ?	ojciec	2	Hum
Wielu uczniów w gimnazjach pali papierosy i pije alkohol .	papierosy	5	Nhum
Rodzice nie będą już mogli wmawiać swoim pociechom , że przynosi je bocian bądź znaleziono je w kapuście .	bocian	12	Nhum
Ale Europa Zachodnia jest bardzo łagodna i tolerancyjna wobec zbrodniarzy komunistycznych .	zbrodniarzy	9	Hum
Dlaczego babiarze udają nababów ?	nababów	3	Hum
W niedzielę po południu kilka osób zaczęło skarżyć się na bóle brzucha .	bóle	10	Inan
Oddając zużyte elektrolity , które tam będą regenerowane , napełnimy zbiorniki nowymi roztworami .	elektrolity	2	Inan
Nie udało się ustalić rasy , wiadomo jedynie , że zwierzak był wielki .	zwierzak	10	Nhum
Ojciec , który był szlachcicem , stracił cały majątek przez komunistów .	komunistów	10	Hum
Uważa się , że od bhang pochodzi nazwa tradycyjnego indyjskiego tańca bhangra .	bhangra	11	Inan
Ministerstwo Rolnictwa , które przed rokiem obłożyło miód importowany opłatami wyrównawczymi , opracowało długofalowy program rozwoju pszczelarstwa .	rokiem	5	Inan
Jaki amok ją czeka , jaki mrok ją ogarnie ?	amok	1	Inan
Z ciał potopionych stryjów wylęgły się tysiące myszy i wyruszyły wszystkie do Kruszwicy , prosto na dwór zbrodniarza .	stryjów	3	Hum
Harcerze zbierają niepotrzebne rowery , aby po naprawie przekazać je Domowi Dziecka w Kórniku-Bninie .	rowery	3	Inan
W zeszłym roku lekarz stwierdził , że ma świnkę .	lekarz	3	Hum
Wyciągnął ręce , żeby je ostrożnie odebrać i w tym momencie dziwny świst przeszył powietrze .	świst	12	Inan
Salony na parterze udostępniono publiczności i pełniły one rolę muzeum .	parterze	2	Inan
- Gdybym niszczył pieczywo , fiskus byłby zadowolony .	fiskus	5	Nhum
Ten okres minnesangu zakończył się w ostatniej dekadzie XII wieku , gdy naśladownictwa ustąpiły nowym tematom i formom wypracowanym przez miejscowych poetów .	poetów	21	Hum
Pontyfikat Piusa XII trwał 7152 dni .	Pontyfikat	0	Inan
" Skrupulatnie przestrzegane zasady od dziesiątków lat współtworzą jej autorytet i wyjątkową pozycję na rynkach całego świata " .	autorytet	9	Inan
Zwycięzcy gratulujemy !	Zwycięzcy	0	Hum
Od 1993 r . jest kierownikiem Zakładu Współczesnych Teorii Ekonomicznych , a od 1999 r . pełni funkcję dziekana Wydziału Ekonomiczno - Socjologicznego Uniwersytetu Łódzkiego .	kierownikiem	5	Hum
Wikipedia , nasz siostrzany projekt , zawiera artykuł na temat nawozów zielonych .	nawozów	10	Inan
Tassilo de Tresckow zajechał go i ciął mieczem .	de	1	Hum
Przez zwały gruzów ulicami miasta przebija się z trudem wojskowy Willys .	Willys	10	Nhum
Dzięki znajdującym się u podstawy każdego wibrysa komórkom mięśniowym zwierzę potrafi dowolnie poruszać wąsami niemal na wszystkie strony .	wibrysa	6	Nhum
Los głównej postaci dotyka bowiem istoty amerykańskiej mitologii , nie jest jednak jej prostą akceptacją .	Los	0	Inan
- Nie ucz dziada , jak charchać !	dziada	3	Hum
Śmieszy mnie ta zabawa w barbarzyńcę , bezmyślne opróżnianie butelek pod krzyżówkę Mickiewicza z amerykańskim hamburgerem .	hamburgerem	15	Nhum
Tam nawiązuje kontakt z grupą partyzancką o zabarwieniu skrajnym , likwidującą komunistów i uciekinierów z gett .	kontakt	2	Inan
Wiele ptaków owadożernych zimą zmienia jadłospis na roślinny .	ptaków	1	Nhum
Sołtys Ligoty Stanisław Kuźnik składa serdeczne podziękowanie wszystkim sponsorom , którzy przyczynili się do zorganizowania festynu i dzięki którym dzieci z Ligoty będą mogły pojechać na wycieczkę .	Sołtys	0	Hum
Jednak sam chipset nie stanowi jeszcze o atrakcyjności danej płyty dla użytkownika .	chipset	2	Inan
Zwycięzcy grup awansowali do półfinałów .	Zwycięzcy	0	Hum
Artyści z trzech akademii sztuk pięknych oglądali wczoraj budynki przy ulicy Zamkowej .	Artyści	0	Hum
Całe rodziny słoni są także przenoszone do nowych rezerwatów .	słoni	2	Nhum
Niektórzy didżeje wpisują sobie występ w Pieksie do CV .	didżeje	1	Hum
Negocjacje rozpoczęły się dopiero po przyjeździe do szkoły zastępcy wójta gminy .	zastępcy	8	Hum
Gen . Wróblewski jest kwatermistrzem Warszawskiego Okręgu Wojskowego .	Okręgu	6	Inan
Kaźmierz oddał stryjowi latarnię ; na ziemi położył podłużny wąski przedmiot .	stryjowi	2	Hum
Statut może przewidywać , że członkowi przysługuje prawo do działki przyzagrodowej .	Statut	0	Inan
Jeden syn , którego odnalazła , zginął na froncie , a drugiego nie odnalazła .	froncie	8	Inan
Parlamentarzyści Socjaldemokracji będą zabiegać o pełną swobodę podejmowania pracy przez Polaków we wszystkich krajach unijnych .	Parlamentarzyści	0	Hum
W stan posiadania ZPR wpisano też kasyna oraz automaty do gry .	automaty	8	Inan
Stanisław M . , ojciec Dariusza , kierowcy ciężarówki , nie może uwierzyć , że jego synowi nic się nie stało .	synowi	16	Hum
Normalny obywatel nie chodzi z takim radiotelefonem .	radiotelefonem	6	Inan
Antyterroryści spuścili się po linach ze śmigłowca wprost pod drzwi gangstera .	Antyterroryści	0	Hum
Późna wiosna była dla księdza proboszcza najbardziej znienawidzoną porą roku .	księdza	4	Hum
Dramat rozegrał się w ciągu kilku sekund .	Dramat	0	Inan
Nie przewidywały , że na własnej piersi wyhodują sobie takiego gada .	gada	10	Nhum
- Internet wzbudza wielkie nadzieje wśród inwestorów .	inwestorów	6	Hum
Innej alternatywy nie ma , a wszelkie marzenia o samodzielnej roli quasi-mocarstwowej Polski są tylko rojeniami fantastów .	fantastów	16	Hum
U nas nie ma jeszcze takich mechanizmów motywacyjnych .	mechanizmów	6	Inan
Oddając zużyte elektrolity , które tam będą regenerowane , napełnimy zbiorniki nowymi roztworami .	roztworami	12	Inan
Na ostateczną cenę kredytu wpływ mają opłaty dodatkowe , których banki żądają od klientów .	kredytu	3	Inan
Wtedy Bóg złapie to całe towarzystwo łącznie ze mną i wrzuci w ogień piekielny , a będzie tam płacz i zgrzytanie zębów .	Bóg	1	Hum
Organizatorzy postarali się też o prezenty dla wykonawców .	wykonawców	7	Hum
Wikary Pudło odprawia je żując gumę .	Wikary	0	Hum
Przyjaciel z prowincji powiada , że żona mogłaby zapobiec pojedynkowi już na placu .	Przyjaciel	0	Hum
Praca w okupowanych szpitalach przebiega normalnie .	szpitalach	3	Inan
Wysoka liczba urodzeń hamuje także rozwój gospodarczy kraju , w którym znaczny procent mieszkańców żyje poniżej uznanego progu ubóstwa .	procent	12	Inan
Politycy mają takie przekonanie , że można coś sprzedać ludziom w innym , lepszym opakowaniu .	Politycy	0	Hum
Parlament Europejski w Strasburgu przegłosował niedawno całkowity zakaz reklamowania wyrobów tytoniowych .	wyrobów	9	Inan
Pani Czapkowa zaścieliła stół świeżą ceratą , podała kotlety z dzika , a po obiedzie odbyło się sympozjum .	kotlety	8	Nhum
Z pozostałymi członkami dawnego kierownictwa związanymi z Gomułką plenum obeszło się bezceremonialnie , usuwając ich w większości ze składu KC .	członkami	2	Hum
Najbardziej popularne są mercedesy , audi , golfy i BMW .	mercedesy	3	Nhum
Funkcjonariusze inspekcji celnej przy pomocy biegłych ustalili , że przy próbie wywozu najprawdopodobniej naruszone zostały przepisy Kodeksu celnego .	biegłych	5	Hum
Niewiele brakowało , by zaproponowała odstrzał niegrzecznych myśliwych polujących na kuropatwy .	myśliwych	7	Hum
Królik jest w stosunku do innych zwierząt swego gatunku bardzo towarzyski , zajmuje nory wspólne i żyje całymi koloniami .	Królik	0	Nhum
- Czy znasz dziesięciu sprawiedliwych w tym grodzie ?	grodzie	7	Inan
Rękaw pięknie wyszywanego fraka prędko nasiąkł krwią .	Rękaw	0	Inan
Kiedy podróżnicy przygotowywali się już do powrotu na statek , Bentley ofiarował Tomkowi na pamiątkę prawdziwy bumerang , dzidę i tarczę .	podróżnicy	1	Hum
Największy na świecie producent sieci komórkowych zamierza skupić się na podstawowej działalności , a aparaty będzie kupował od producenta zewnętrznego z siedzibą w Singapurze i tylko sygnował je własnym znakiem towarowym .	producent	3	Hum
Popatrzyła z niedowierzaniem na mój kciuk .	kciuk	5	Inan
Podczas pobytu w elbląskim garnizonie najczęściej towarzyszyli mu dowódca stacjonującej tam dywizji , komendant szpitala wojskowego i kapelan .	kapelan	17	Hum
Jeśli to jest absolutnie niemożliwe , znaczy to , że twój charakter jest czymś pośrednim pomiędzy dwoma opisanymi w rozwiązaniu przy odpowiednich numerach .	charakter	11	Inan
Przekupnie w bazarowych zaułkach opowiadali , że upadek rządu jest bliski i nieuchronny , a ministrowie i generałowie knują spiski albo pakują walizy i szykują się do ucieczki za granicę .	spiski	19	Inan
Z oficjalnym żądaniem wobec MKOl , złożonym na piśmie , wystąpił Narodowy Komitet Olimpijski KRLD , domagając się od naczelnej władzy sportowej rewizji listy triumfatorów olimpijskich .	triumfatorów	24	Hum
Najpierw samodzielność uzyskał Zakład Naprawy Autobusów w Biskupicach , wcześniej stanowiący integralną część MPK .	Autobusów	5	Inan
W środę ze Szpitala Ginekologiczno - Położniczego w Opolu wypisywano 11 noworodków .	Szpitala	3	Inan
Komendant główny policji już kilka lat temu zabronił montowania jakichkolwiek terminali w jednostkach policji .	terminali	10	Inan
W tej sprawie proszę rozmawiać z oficerem prasowym !	oficerem	6	Hum
To typowy klasyk , w którym każdy z cylindrów dysponuje tylko 2 zaworami .	klasyk	2	Inan
Czy mańkut z natury już jest lewicowcem ?	mańkut	1	Hum
- Czy polscy kierowcy zawodowi rzeczywiście są profesjonalistami ?	profesjonalistami	7	Hum
Chmury rozsunęły się na moment , odsłaniając wytarty miedziak słońca .	miedziak	8	Nhum
Służy do tego oddzielne naczynko o chropowatym dnie , pozwalającym ptakowi w kąpieli pewnie stać na nóżkach .	ptakowi	10	Nhum
Chłopak umilkł .	Chłopak	0	Hum
Kandydat na prezydenta zapowiedział , że w swojej kampanii poruszać będzie głównie sprawy socjalne obywateli , czyli prawo do pracy i godnego bytu .	Kandydat	0	Hum
Trenerzy cały czas obserwują zawodników i nie zdecydowali , kto znajdzie się w podstawowej szóstce .	zawodników	4	Hum
Rzecznik Praw Obywatelskich wystąpił w obronie inwalidów wojennych i wojskowych , którym wprowadzono obowiązek płacenia za pobyt w sanatoriach uzdrowiskowych .	inwalidów	6	Hum
Policjanci śmieją się , odreagowując stres .	stres	5	Inan
Ptaki te chętnie korzystają z pokarmu wykładanego dla parkowych łabędzi .	Ptaki	0	Nhum
Źródła historyczne podają , że studnia należała do zamku biskupów wrocławskich .	zamku	8	Inan
Nakręcił 60 filmów dokumentalnych i stworzył ponad 300 programów telewizyjnych .	programów	8	Inan
W minioną sobotę odbyły się obchody Dnia Strażaka .	Strażaka	7	Hum
Na przełomie czerwca i lipca Stomil - Olsztyn SA zamierza oddać do użytku budowany właśnie magazyn opon .	użytku	12	Inan
Salony na parterze udostępniono publiczności i pełniły one rolę muzeum .	Salony	0	Inan
Radni powiatowi z Nowogródka zdecydowali wczoraj , że w rodzinnym mieście Adama Mickiewicza nie będzie polskiej szkoły .	Radni	0	Hum
Sprzedaż monti i stanowisk nie pokrywała chronicznego deficytu .	deficytu	7	Inan
Obaj chorążowie zostali natychmiast zatrzymani i osadzeni w areszcie .	chorążowie	1	Hum
Serduszka czekoladowe będą rozdawane w autobusach dla par .	autobusach	5	Inan
Czekaj , on mógł mieć coś wspólnego z napadem na mnie ?	napadem	8	Inan
Podejrzałem go ukradkiem i okazało się , że napisałem już ponad milion znaków .	ukradkiem	2	Inan
Masz za sobą astrologiczny półmetek .	półmetek	4	Inan
Po ofiarach tylko czasem zawyje wierny pies .	pies	6	Nhum
Maturzyści - internauci zdający na pisemnym egzaminie język polski i historię najczęściej typują tematy związane z przełomem wieków .	Maturzyści	0	Hum
Plony z tego siewu są już wyłącznie twoją własnością .	Plony	0	Inan
Iluż poważnych obecnie pisarzy czytało swe pierwsze próby literackie w sali przy Krupniczej , siedząc wokół dębowych stołów zsuniętych pośrodku .	stołów	17	Inan
Ich celem było po prostu zlikwidowanie wszystkich dziur .	celem	1	Inan
Wypowiedź jednego z robotników pracujących przy drodze zupełnie poraziła .	robotników	3	Hum
Potwierdził to prezydent Jiang podczas niedawnego spotkania z prezydentem Clintonem .	prezydentem	8	Hum
Członkowie nakielskiego stowarzyszenia podczas spotkania omówili główne cele swojej działalności .	Członkowie	0	Hum
- Zbita z tropu uśmiechnęła się niepewnie .	tropu	3	Inan
Zgodnie z nim , dyrektorzy wojewódzkich kolumn złożą do końca lutego w Ministerstwie Zdrowia programy restrukturyzacji zakładów .	dyrektorzy	4	Hum
Później połączono go z lądem groblą .	lądem	4	Inan
Pierwsza z wymienionych sygnalizacji pojawi się u zbiegu ulic Gdyńskiej i Piaskowej w Koziegłowach .	zbiegu	7	Inan
– Lekarze mówią , że powinien poleżeć parę dni .	Lekarze	1	Hum
Twoje słowa trafiły na podatny grunt .	grunt	5	Inan
Ze stara wyciekał olej i płyn chłodzący , a przyczepa miała zdemontowany hamulec awaryjny .	hamulec	12	Inan
Książę Andrzej Poniatowski , porucznik armii francuskiej , odwiedził Polskę w roku 1919 jako członek francuskiej misji wojskowej .	Książę	0	Hum
Chrześcijaństwo nakazuje miłość bliźniego .	bliźniego	3	Hum
Akurat wtedy , gdy kadrowicze rozpakowywali w Warszawie swój sprzęt po powrocie ze zgrupowania w Barsinghausen , w kościele w Kazimierzu zebrał się tłum wiernych , który modlił się o powodzenie naszej drużyny w zbliżających się mistrzostwach świata .	kadrowicze	4	Hum
- Józwa ma konika . . .	konika	3	Nhum
Wiedziałam , gdzie są fotografie z naszych pogrzebów ; wystarczyło , żeby poszperał trochę w szufladach .	pogrzebów	7	Inan
W 2007 roku neurolodzy amerykańscy wyciągnęli je z muzeum i poddali badaniu rezonansem magnetycznym .	neurolodzy	3	Hum
Konkurs składał się z etapu ustnego i pisemnego .	etapu	4	Inan
Polityka prorodzinna rządu francuskiego jest na bakier z programem przedsiębiorczości .	bakier	6	Inan
Chodzi o to , aby uczniowie w odpowiednich warunkach mogli realizować cele w ramach poszczególnych przedmiotów , zajęć pozalekcyjnych czy pozaszkolnych .	cele	11	Inan
Dzień po śmierci matka powiadomiła prokuraturę o popełnieniu przestępstwa przez lekarzy pogotowia .	lekarzy	10	Hum
Informacje i dokumenty , którymi dysponujemy , wskazują jednak , że poseł kłamie .	dokumenty	2	Inan
- Przyjeżdżają i od progu mówią , że cały obszar kupują .	obszar	9	Inan
Jesteś umarlak !	umarlak	1	Nhum
Bandytów nie złapano .	Bandytów	0	Hum
Według relacji świadków , gdy biały opel frontera zbliżył się do ambasady , wyskoczył z niego człowiek ubrany w panterkę , z granatnikiem w ręku , i próbował odpalić granat w kierunku ambasady .	opel	6	Nhum
- Idźcie na dół .	dół	3	Inan
Również szefowie konkurencyjnych rolniczych związków zawodowych uważają , że Lepper zrobi wszystko , by doszło do konfrontacji rolników z policją .	szefowie	1	Hum
Aby pomóc przewodnikom w sporządzeniu spisu potrzebnych rzeczy , podajemy przykładowe zestawy sprzętu dla poszczególnych działów prac na kolonii .	sprzętu	12	Inan
Udało się to osiągnąć połowicznie , bo wszystkie szczegóły umowy nie zostały ujawnione .	szczegóły	8	Inan
Jednym z głównych celów rządu jest też szybka integracja z Unią Europejską .	celów	3	Inan
Pracuję w dziale płac .	dziale	2	Inan
Lecz trzeba być w zgodzie z kompozytorem .	kompozytorem	6	Hum
W ostatnim momencie chwytam w dłonie jakiś kabel .	kabel	7	Inan
— Dlaczego nie osądzono komunistów ?	komunistów	4	Hum
Pogróżkowy ton pod adresem duce podtrzymał A . Hall .	duce	4	Hum
W programie jest oczywiście praktyczna nauka żeglowania .	programie	1	Inan
Dlaczego ugrupowanie , które będzie rozliczane przez wyborców z efektów rządzenia , ma sobie utrudniać pracę ?	wyborców	7	Hum
Istnieje u nas w ocenach twórczości artystycznej tradycja nawiązywania do słonia .	słonia	10	Nhum
W 2007 roku neurolodzy amerykańscy wyciągnęli je z muzeum i poddali badaniu rezonansem magnetycznym .	rezonansem	12	Inan
Przyjaciel z prowincji powiada , że żona mogłaby zapobiec pojedynkowi już na placu .	pojedynkowi	9	Inan
Michnik jest czwartym laureatem ustanowionej w 1996 r . nagrody .	laureatem	3	Hum
W czasach uczelnianego wyścigu szczurów i masowego bezrobocia pełni często rolę bezpłatnej terapii .	szczurów	4	Nhum
Odpowiedziałeś posługując się sztandarowym obok Białorusi argumentem .	argumentem	6	Inan
Człowieka po prostu ogarnia przerażenie .	Człowieka	0	Hum
Zatrzymanym przedstawiano zarzuty udziału w zorganizowanej grupie przestępczej i wprowadzenia na rynek narkotyków .	narkotyków	12	Inan
Porucznik nie zamierzał wykładać swoich kart , a przynajmniej nie zamierzał robić tego od razu .	Porucznik	0	Hum
Kto pierwszy wstaje od stołu ?	stołu	4	Inan
Mimo pomocy lekarzy umiera .	lekarzy	2	Hum
Pomysłowość bankowców w ustanawianiu dodatkowych opłat jest zadziwiająca .	bankowców	1	Hum
Szynkarz kłaniał mu się nisko .	Szynkarz	0	Hum
Jakie priorytety wiążą się z mincerzami ?	mincerzami	5	Hum
JANUSZOWI PANASEWICZOWI nawet retusz nie pomoże .	retusz	3	Inan
Dziewczyna wysupłała zza dekoltu banknoty dziesięciomarkowe .	dekoltu	3	Inan
- Piotrze , już skończyłam rozmowę z rodzicami , teraz chciałabym porozmawiać z tobą .	rodzicami	7	Hum
Bronił eksmitowanych na bruk , naprawiając błędy przyjętej przez koalicję SLD­PSL ustawy , grzmiał na globalistów i świeżych krajowych , drapieżnych kapitalistów .	globalistów	15	Hum
Likwidacja okazuje się dla wielu wyborców bolesna .	wyborców	5	Hum
To zwierzę to prawdziwy czort .	czort	4	Nhum
Nie odpowiada ono na przykład prototypowi stalinowskiemu .	prototypowi	5	Inan
Selekcjoner Jerzy Engel rozdał pamiątkowe monety , wybite z okazji zbliżających się mistrzostw świata .	Selekcjoner	0	Hum
Wtorkowa nominacja wywołała gwałtowne protesty całej opozycji .	protesty	4	Inan
W wspomnianych zestawach nie figurują te nazwiska .	zestawach	2	Inan
- A ja jestem żołnierzem .	żołnierzem	4	Hum
Cichociemni spotkali się w GROM-ie .	Cichociemni	0	Hum
Jeśli WebScan znajdzie wirusa , ostrzega użytkownika , by nie ściągał danego pliku z sieci .	pliku	12	Inan
Darek P . widząc , że jego zeznania nie przyniosły żadnego skutku , a Komor chodzi na wolności , sprzedaje majątek i dalej prowadzi swoje lewe interesy , zwrócił się z prośbą o pomoc do dziennikarzy .	skutku	11	Inan
Za sobą mieli martwą rzekę , która leżała wśród piasków jak rozbity dzban .	piasków	9	Inan
Studenci będą mogli korzystać z wprowadzonego pilotażowo od października br . systemu pożyczek studenckich .	Studenci	0	Hum
Po paru dniach znał już wszystko i wszystkich i spędzał na górnych piętrach każdą wolną chwilę , wychodząc tylko w porze posiłków i oczywiście snu .	snu	24	Inan
Na dużym talerzu uformować kopczyk z kuskusu i posypać go ozdobnie cynamonem .	talerzu	2	Inan
W turnieju udział wzięli uczniowie szkół podstawowych , gimnazjalnych i ponadgimnazjalnych .	turnieju	1	Inan
Zadanie dotyczy odcinka o długości 0,46438 km .	odcinka	2	Inan
Uroiła sobie , że lekarze chcą ją zabić .	lekarze	4	Hum
Pawłowi M . zarzuca się również , że działał z zamiarem spowodowania ciężkiego kalectwa rzucając nożem w głowę włoskiego piłkarza Dino Baggio .	zamiarem	10	Inan
We wtorek ci sami uczestnicy licytacji zaproponowali 1.500 zł .	wtorek	1	Inan
Nie narzeka na brak pomysłów twórczych .	brak	3	Inan
Okazało się , że był nią pies .	pies	6	Nhum
Unijni przetwórcy mogą kupować owoce gdzie indziej .	przetwórcy	1	Hum
Karina pracowała na oddziale dziecięcym .	oddziale	3	Inan
Obu panów łączy miłość do piłki nożnej .	panów	1	Hum
Próba przekroczenia granicy Rzeczypospolitej przez grupę kolarzy spod znaku UPA wywołała ogólnopolskie oburzenie .	znaku	8	Inan
Imprezę obsługiwać będzie 11 tys . dziennikarzy i pracowników technicznych .	pracowników	8	Hum
Chłopczyk z miejsca się budzi .	Chłopczyk	0	Hum
Zwolennicy Mossadegha , ministrowie , podejrzani oficerowie , działacze Tudeh są przesłuchiwani i torturowani .	oficerowie	6	Hum
Celników z rzepińskiej Izby Celnej wspierali funkcjonariusze z Poznania i Krakowa .	funkcjonariusze	6	Hum
Zamaskowany bandyta wszedł do banku , w obu rękach trzymał pistolety .	pistolety	10	Inan
Mimo wysiłków lekarzy zmarł .	wysiłków	1	Inan
Popędzali swoje konie , bo koniecznie chcieli dopaść upatrzonej zwierzyny .	konie	2	Nhum
I został , bo to jest geniusz .	geniusz	6	Hum
Oficer wyszedł , rencistka odkręciła gaz .	Oficer	0	Hum
Mówimy o sytuacji , w której budżet musi jednocześnie wytrzymać skutki rosyjskiego kryzysu i koszty tegorocznych reform .	kryzysu	12	Inan
Wysiadł więc i piknął pilotem , blokując centralny zamek .	pilotem	4	Inan
Na pastwisku w Uniszkach Gumowskich rolnik załadował na dwukółkę krowę .	rolnik	5	Hum
Stanął w nich ubrany w piżamę , zakrwawiony 12-letni Łukasz , wnuk gospodarzy , po chwili osunął się na ziemię .	wnuk	11	Hum
Tata musiał pojechać do domu .	Tata	0	Hum
Stał na środku przedpokoju , hipnotyzując wzrokiem Lidkę , która wpatrywała się w niego z niedowierzaniem i zachwytem .	zachwytem	17	Inan
Przed następnym sezonem zorientuję się , czy w mojej obecnej szkole będę mógł sobie wziąć urlop dziekański .	urlop	15	Inan
Nie znałem go przedtem , bo za moich czasów wileńskich był jeszcze sztubakiem , a potem przebywał za granicą .	czasów	8	Inan
Skąd masz granaty ?	granaty	2	Inan
- Ale jak się to stało , odebraliście go złodziejom tak prędko ?	złodziejom	9	Hum
W latach sześćdziesiątych , już jako sztygar oddziałowy , pamiętam odbiory przygotowywanych do rozruchu ścian dokonywane przez dyrektora Śniegonia .	rozruchu	13	Inan
Tadeusz podszedł do niej i wprowadził ją do środka .	środka	8	Inan
Po tej wypowiedzi papieża zapytaliśmy księdza Tadeusza Isakowicza - Zaleskiego , gorącego zwolennika lustracji , jak odebrał te słowa .	księdza	5	Hum
I w ogóle myślę , że wszystko jest okay .	ogóle	2	Inan
Zacisnąłem palce na szorstkim płótnie i wyczułem obłe kształty pocisków .	kształty	8	Inan
Dostrzegł pędzącego byka .	byka	2	Nhum
Czy to może być port lotniczy ?	port	4	Inan
Konferencja będzie miejscem wymiany poglądów , doświadczeń i wyników badań nad oddziaływaniem mediów .	wyników	8	Inan
Ekolodzy zaopatrzyli młodszych kolegów w worki na śmieci i rękawiczki .	worki	5	Inan
– Nie mam już tego kawałeczka skórki , jeśli o to chodzi , ale wszystko tylko na tym się skończyło .	kawałeczka	5	Inan
We wtorek posłowie przyszli po te informacje .	posłowie	2	Hum
- Blondynka popatrzyła na tancerzy , którzy przy bufecie głośno rozmawiali z właścicielem knajpy .	tancerzy	4	Hum
Tęsknota ogarniała chłopców .	chłopców	2	Hum
Przypomnijmy , że 16 lipca 1994 r . dziadkowie półtorarocznej wówczas Moniki zostawili ją przed legnicką apteką pod opieką ojca , Roberta Bielawskiego .	lipca	4	Inan
Rebelianci z tak zwanej Wyzwoleńczej Armii Kosowa zajęli Belacewacz tydzień temu .	Rebelianci	0	Hum
Polscy producenci nie dają za wygraną , dotrzymując kroku modzie i zachodnim nowinkom .	producenci	1	Hum
Wśród 65-tysięcznej publiczności oglądającej uroczyste otwarcie igrzysk będzie 40 najwyższych dostojników różnych państw .	dostojników	10	Hum
Do użydowienia namówił mnie narodowy szołmen Wojciech Cejrowski .	szołmen	5	Hum
Miejsc tych tragedii nie wizytują premierzy , ministrowie czy samorządowi notable .	ministrowie	7	Hum
Wykręcił się na pięcie i wybiegł na dwór z rozpaloną głową .	dwór	7	Inan
Kongresy Międzynarodówki poruszały zawsze ważne problemy , istotne dla życia politycznego i społecznego danego okresu .	problemy	5	Inan
Wieczorem po przyjeździe do Nowego Jorku zdążyłem jeszcze przeczytać różne materiały i przygotować swoje wystąpienie , a potem odwiedziłem sekretarza generalnego ONZ U Thanta .	sekretarza	19	Hum
Wystawa w Tel Awiwie przyciągnęła ponad 5 tysięcy zwiedzających , pokazano ją we wszystkich izraelskich telewizjach , pisały o niej wszystkie gazety .	zwiedzających	8	Hum
Wobec powyższego Angus uznał obecny wykład za głupi , wprost śmieszny absurd .	wykład	5	Inan
Syn pana Bogdana raz sam się przekonał , jak wygląda opieka nad niepełnosprawnymi na porządnym zachodnioeuropejskim poziomie .	poziomie	16	Inan
Jej dezynfekcja za pomocą chloru jest zbyteczna .	chloru	4	Inan
Po końcowym gwizdku arbitra w ekipie gości zapanowała zrozumiała euforia .	gwizdku	2	Inan
W międzyczasie skończyłam też dziennikarstwo .	międzyczasie	1	Inan
Jeden syn , którego odnalazła , zginął na froncie , a drugiego nie odnalazła .	drugiego	11	Nhum
Ufundowanie muzeum dla zbiorów Jasieńskiego było naturalnym odruchem obywatela , miłośnika sztuki .	miłośnika	10	Hum
Według legend , w studni głębokiej na ponad 30 metrów znajdują się wejścia do lochów i tajnych chodników łączących posiadłości właścicieli zamku .	lochów	14	Inan
Brakuje również sportowego sukcesu , zgodnego z oczekiwaniami kibiców i sympatyków Klubu .	Klubu	11	Inan
Kontrola w terenowych oddziałach tej instytucji dopiero się rozpoczyna .	oddziałach	3	Inan
Cieszy fakt , że Royal Canin tak bardzo dba o koty i chce dzielić się swą wiedzą i doświadczeniem z ich miłośnikami .	koty	10	Nhum
Piłkarze krakowskiej Wisły sprawili wspaniały prezent wszystkim sympatykom futbolu w Polsce .	sympatykom	7	Hum
I niestety , gdy w pewnej chwili znów się wspiął na palce , nagle zachwiał się .	palce	11	Inan
Geje robią wokół siebie szum , żeby tylko się wypromować .	Geje	0	Hum
Tam nawiązuje kontakt z grupą partyzancką o zabarwieniu skrajnym , likwidującą komunistów i uciekinierów z gett .	komunistów	11	Hum
Myślę , że tak właśnie powinni zachowywać się odpowiedzialni kandydaci .	kandydaci	9	Hum
W lutym skradziono ją prawdziwemu funkcjonariuszowi w Warszawie .	funkcjonariuszowi	5	Hum
Ptaki te chętnie korzystają z pokarmu wykładanego dla parkowych łabędzi .	łabędzi	9	Nhum
Nie było takich czasów i już nie będzie .	czasów	3	Inan
Opracował program dydaktyczny wychowania seksualnego , którego realizacja została ostatnio wstrzymana .	program	1	Inan
Wizytator przeprosił kierownika i udał się z powrotem do klasy szóstej .	Wizytator	0	Hum
A któż z Was nie czuje się pokrzywdzony ?	któż	1	Hum
Czy wszystkie galaktyki Seyferta typu 2 mają pierścień pyłowy i ukryty obszar szybkich obłoków gazowych ?	obszar	11	Inan
W Polsce wyniki leczenia nowotworów dlatego są dwukrotnie gorsze od uzyskiwanych na Zachodzie , ponieważ na terapię trafiają chorzy przeważnie już z zaawansowanym guzem .	Zachodzie	12	Inan
Kropidłami żegnają granaty i rynsztokami płynie woda święcona .	rynsztokami	4	Inan
Rannymi cywilami zaopiekowali się najpierw amerykańscy sanitariusze z personelu naziemnego .	cywilami	1	Hum
Prosi się też zakłady pracy , które dysponują autobusami , by wspomogły komunikację zastępczą .	autobusami	8	Inan
Obowiązują wizy , odprawa paszportowa , a przy wyjeździe celnik gruntownie przeszukuje rzeczy w poszukiwaniu skarbów , których tak wiele stąd ukradziono .	wyjeździe	8	Inan
Jednak sam chipset nie stanowi jeszcze o atrakcyjności danej płyty dla użytkownika .	użytkownika	11	Hum
Delfina w herbie ma Szkoła Policealna Pracowników Służb Socjalnych w Poznaniu .	Delfina	0	Nhum
Niech płaszczą się przed groźnym wieprzem !	wieprzem	5	Nhum
– Dziennikarze wmówili sądowi i ludziom , że Róża musi wrócić do biologicznych rodziców .	Dziennikarze	1	Hum
Ponadto badania te świadczą , że koncentraty alkoholowe różnych roślin są dobrym środkiem zapobiegawczym przeciw grypie .	środkiem	12	Inan
Włoski rząd na nadzwyczajnym posiedzeniu przeznaczył wczoraj 50 milionów euro dla dotkniętego trzęsieniem ziemi regionu .	regionu	14	Inan
Dzielenie się władzą to zawsze prima aprilis .	aprilis	6	Inan
Najpierw strzelił w kierunku ochroniarza , na szczęście chybił .	ochroniarza	4	Hum
Jeden hotel musiał być oddany po wygaśnięciu dzierżawy , drugi sprzedano , aby pokryć dług w Funduszu Społecznym Żołnierza .	dług	14	Inan
Gospodarze odpowiedzieli dwoma golami Ralfa Hauptmanna i Austriaka Tony Polstera .	golami	3	Nhum
Renowacja postumentu , na którym ponownie umieszczone zostanie popiersie , kosztować będzie 12 tys . złotych .	postumentu	1	Inan
Lekarze zdecydowali się na operację , ale brakowało dawcy .	dawcy	8	Hum
Mówi , że za komuny było lepiej , bo można było iść do sekretarza partii .	sekretarza	13	Hum
Projekt przewiduje postawienie 7-kondygnacyjnego biurowca z dwupoziomowym garażem podziemnym na 450 samochodów oraz częścią handlową i usługową .	samochodów	11	Inan
Oczywiście tę moją zapobiegliwość o każdy szczegół bryczki spostrzegł kowal .	kowal	9	Hum
Kontrakty te są nowym instrumentem polityki rozwoju regionalnego .	Kontrakty	0	Inan
Jednocześnie zapowiedział rozpoczęcie maratonu negocjacyjnego .	maratonu	3	Inan
Martha Kosicky ma blond włosy i dziadka z Polski .	dziadka	6	Hum
Zwycięzcą biegu maratońskiego został 87-letni dziś Koreańczyk Ki - jung Son .	Zwycięzcą	0	Hum
Przeciwko wnioskom Komisji ostro zaprotestował radny Krzysztof Gajewski , wiceprezydent w zarządzie odpowiedzialnym za zakup Elektrociepłowni .	wiceprezydent	9	Hum
Do dziś dziękuję Bogu , że trafiłem na takich porządnych ludzi , którzy dali nam dach nad głową i przysłowiowy talerz zupy .	dach	15	Inan
Studiują tutaj Łukasz Kruczek , Grzegorz Śliwka , Krystian Długopolski , teraz obok mnie studentem został Tomek Pochwała .	studentem	14	Hum
Spotkanie w urzędzie wywarło na wszystkich jego uczestnikach niesamowite wrażenie .	urzędzie	2	Inan
Gdy Cahirowi czupryna nieco mocniej przyschnie do czerepu , powędrujemy ku Toussaint .	czerepu	7	Inan
Posiadanie pełnych praw akademickich oznacza , że uczelnia nadaje stopień naukowy doktora , przeprowadza przewody habilitacyjne oraz występuje z wnioskiem o nadanie tytułu naukowego profesora .	przewody	14	Inan
Na każdej tabletce było logo dolara .	dolara	5	Nhum
Rabi Eleazar ben Cwi nie szemrze .	ben	2	Hum
Nadmieniamy , że w pierwszą niedzielę lutego br . przeprowadzono zbiórkę pieniędzy na zakup niezbędnego urządzenia medycznego do pracowni analitycznej w Wiejskim Ośrodku Zdrowia w Brzeziu .	Ośrodku	22	Inan
Opowieść uczestniczy także w pochodzie performatywów , stwarza wzory i poglądy .	performatywów	5	Inan
Ludzie odeszli i zwrócili się w stronę Wiktora .	Ludzie	0	Hum
- Pisaliśmy razem komunikaty z posiedzeń TKK .	komunikaty	3	Inan
Cała nadzieja na przerwanie szaleństwa tworzenia urzędów centralnych tkwi w prezydencie .	urzędów	6	Inan
Piłkarze krakowskiej Wisły sprawili wspaniały prezent wszystkim sympatykom futbolu w Polsce .	futbolu	8	Inan
Miejsca rozgrywania spotkań zostały ustalone w drodze losowania w siedzibie Polskiego Związku Tenisa Stołowego w Warszawie .	Tenisa	12	Nhum
Parkoty zaczynają się w lutym i trwają do sierpnia .	lutym	4	Inan
Kazał Paoli przynieść sobie drinka .	drinka	4	Nhum
Czternastoletni chłopiec cierpiał z powodu ciężkiej alergii wielonarządowej , której objawami były atopowe zapalenie skóry , astma oskrzelowa oraz całoroczny katar .	katar	20	Inan
Wydaje się , że o decyzji przesądziły trzy czynniki .	czynniki	8	Inan
Warszawski Indeks Giełdowy zyskał 5 procent , a WIG20 , indeks największych spółek na parkiecie , wzrósł o 6,1 procent .	parkiecie	14	Inan
Ale ona tylko skinęła na okrwawionego fenomulata .	fenomulata	6	Hum
Beacie towarzyszył mój starszy kuzyn , inżynier Wacław Straszyński .	kuzyn	4	Hum
Dzięki lekarzom , wsparciu rodziny i samozaparciu pokonał chorobę .	lekarzom	1	Hum
Atak nastąpił z bliska , w wąskiej uliczce .	Atak	0	Inan
Wirują mu musztardowe księżyce i słońca , a na samym dole żagla zjawia się łeb wieloryba o mikroskopijnych , czerwonych oczach .	wieloryba	15	Nhum
Znajdą się tam także pomieszczenia rehabilitacyjne z basenem , salami gimnastycznymi i salami masażu .	masażu	13	Inan
Znał dobrze urzędników gminnych i ich nieskończoną flegmę oraz absolutny brak poszanowania dla czasu bliźnich .	urzędników	2	Hum
Większość wpływów banku z kredytów wynika z ich oprocentowania .	wpływów	1	Inan
Minister obrony Tengiz Kitowani , były premier Tengiz Sigua i szef milicji Mchedrioni Dżaba Joseljani obalili przed rokiem prezydenta Zwiada Gamsahurdię .	rokiem	17	Inan
Cieszy fakt , że Royal Canin tak bardzo dba o koty i chce dzielić się swą wiedzą i doświadczeniem z ich miłośnikami .	miłośnikami	21	Hum
Koalicja jest zbyt liczna , by pozwolić sobie na komasację resortów , a jeszcze może dojść do jej rozszerzenia . . .	resortów	10	Inan
Pani minister mogłaby również poinformować posłów , jak przebiegają prace nad standaryzacją wydatków budżetowych .	posłów	5	Hum
Po kolejnych wstrząsach wszyscy zostali ewakuowani i nie mają dostępu do swoich domów , z których wiele grozi zawaleniem .	wstrząsach	2	Inan
Patesi stanął przy królu .	królu	3	Hum
Wojskowy kandydat nie rozdawał ulotek ze swoim programem wyborczym .	programem	7	Inan
Stamtąd przywieziono do Poznania obie rogówki zmarłego .	zmarłego	6	Hum
Prawdopodobnie w toalecie przestępcy zaopatrzyli się w granaty i pistolet .	granaty	7	Inan
Sztandar bojowy podniosły także narody podbite i uciemiężone przez carat .	Sztandar	0	Inan
Pierwszy cios , który później okazał się śmiertelny , został zadany metalowym krzesłem w tył głowy .	tył	14	Inan
Konsjerżka , jak większość konsjerżek Portugalka , szorowała chodnik i mury ryżową szczotką .	chodnik	8	Inan
Gdy Wielki Brat oznajmił , że Grzegorz ma opuścić program , Karolina płakała .	Brat	2	Hum
Ale demokrata Al Gore obiecał emerytom dopłaty państwa do leków . . .	leków	9	Inan
Trzynastolatek był członkiem grupy przestępczej , w której działali oskarżeni o jego późniejsze zabójstwo .	Trzynastolatek	0	Hum
Są pożyteczne , zbliżają ludzi i umacniają przyjaźnie , a artystom garmażerni , barmanom , kelnerom i sprzątaczkom płaci kasjer ambasady .	barmanom	13	Hum
Koszmar rozegrał się w nocy .	Koszmar	0	Inan
Peugeot jedzie za Oplem , który zatrzymuje się przy pierwszym domu we wsi .	Oplem	3	Nhum
Nie muszę używać trybu przypuszczającego .	trybu	3	Inan
Ugryzienia osy , pszczoły , trzmiela i szerszenia mogą być niebezpieczne .	trzmiela	5	Nhum
W gościnnym pokoju u Czapków zasiadają często naukowcy .	naukowcy	7	Hum
Gdy KOT usiadł na ławeczce Juliana Tuwima , poeta nie krył zdziwienia z tego niecodziennego spotkania .	KOT	1	Nhum
Janos wykonywał stoły , zydle , półeczki dla siebie , rodziny , sąsiadów , płacił nimi za pomoc przy gospodarstwie .	stoły	2	Inan
Jeśli weźmiemy pod uwagę sprawność i wydajność akumulatorów wanadowych , projekt wydaje się zupełnie realny .	akumulatorów	7	Inan
Z ważnych powodów sąd może na żądanie poszkodowanego przyznać mu zamiast renty lub jej części odszkodowanie jednorazowe .	poszkodowanego	7	Hum
Kot usiadł obok i znowu miauknął .	Kot	0	Nhum
Był brytyjski lotniskowiec , amerykańskie fregaty , hiszpańska piechota morska , portugalscy komandosi , polscy lotnicy .	lotniskowiec	2	Inan
W dyskusji zgłoszono wniosek o odrzucenie projektu uchwały w sprawie założeń polityki pieniężnej na 1995 r .	projektu	6	Inan
Mniej zadowoleni będą narciarze .	narciarze	3	Hum
Ludzie uważają , że do kłopotów z uzyskaniem zgody przyczynili się inwestorzy starający się o pozwolenie na budowę małego osiedla na działce sąsiadującej z ogródkami mieszkańców .	kłopotów	5	Inan
To okres na zamykanie , kończenie różnych spraw .	okres	1	Inan
Liście kołysały się na wietrze , gałęzie drzew szumiały jak morze w snach .	snach	12	Inan
Chodzi o to , żeby demonstracje odbywały się w spokoju , żeby w minimalnym stopniu zakłócały życie innych ludzi i żeby nie było polską normą bicie policjantów , okupowanie budynków , wyrywanie znaków drogowych czy niszczenie samochodów .	samochodów	36	Inan
Błyskawicznie usunąłem plastikowe kliny i wyjąłem szybę z ramy .	kliny	3	Inan
Trzy osoby podejrzane o korupcję , w tym profesora , który przewodniczył komisji egzaminującej weterynarzy , zatrzymali warmińsko - mazurscy policjanci .	weterynarzy	14	Hum
Gdy odbywa służbę wojskową w Maroku , wielkie wrażenie robi na nim głęboka religijność wyznawców Islamu .	Islamu	15	Inan
Mogę się tylko domyślać , że mechanicy zabiją barana , który od rana obgryza skraj plastikowego worka , i przyniosą mi moją część .	skraj	14	Inan
- W iluż miastach w okresie letnim odbywa się tyle bezpłatnych występów artystycznych .	występów	11	Inan
Dzięki cyfrowej telewizji satelitarnej istnieje też możliwość połączenia z Internetem czy udziału w kursach przygotowujących do matury albo egzaminu na studia .	egzaminu	18	Inan
Pan asesor zamilkł i więcej już do końca sądu nie otworzył ust swoich .	asesor	1	Hum
Ponad 1600 osób wzięło wczoraj udział w 24 . maratonie ulicznym we Wrocławiu .	maratonie	9	Inan
– Dziadek mi kazał .	Dziadek	1	Hum
Twoi Duchowni twierdzą , że siedzibą Szatana są nasze podbrzusza .	Szatana	6	Nhum
Michał naciągnął mi na oczy kaptur , omotał szalikiem i kazał wracać do domu .	szalikiem	8	Inan
Zapisał nuty , przemówił do mnie szyfrem .	szyfrem	6	Inan
Na dużym talerzu uformować kopczyk z kuskusu i posypać go ozdobnie cynamonem .	kuskusu	6	Inan
Ciekawostkę stanowi fakt , że dwa górne rzędy wibrysów mogą poruszać się niezależnie od dwóch dolnych rzędów .	rzędy	7	Inan
Mało brakowało , a miłość do zajączka Kamil przypłaciłby życiem .	zajączka	6	Nhum
W sztuce miecza faza oddechu jest bardzo ważna , bo szermierz biorący oddech jest wtedy najsłabszy .	oddech	12	Inan
Dodatkowym zyskiem będzie stworzenie nowych miejsc pracy .	zyskiem	1	Inan
Stawiał sobie wielkie problemy i plon jego pracy był wielki .	problemy	3	Inan
Wyszedłem na spacer z nietresowalnym bassetem .	bassetem	5	Nhum
Miejscowy hydraulik ma więc duże wzięcie .	hydraulik	1	Hum
Zakończył się drugi rozdział krótkiej historii fullerenów .	fullerenów	6	Inan
Na torze pod Kielcami odbyty się pierwsze wyścigi samochodowe .	wyścigi	7	Inan
Zarząd Telekomunikacji Polskiej ustami rzecznika prasowego , Piotra Gawrona , podkreśla , że nie jest stroną w sporze między związkami i rządem .	rzecznika	4	Hum
Przekupnie w bazarowych zaułkach opowiadali , że upadek rządu jest bliski i nieuchronny , a ministrowie i generałowie knują spiski albo pakują walizy i szykują się do ucieczki za granicę .	Przekupnie	0	Hum
Kazimierz Pytko napisał na naszych łamach , że nerwowe odruchy prawosławnych biorą się z ich poczucia słabości .	łamach	5	Inan
Rozpoczyna się teraz emocjonujący wyścig ze zbliżającą się burzą .	wyścig	4	Inan
Aminokwasy zawierające siarkę są niezbędne dla prawidłowej syntezy keratyny , która jest podstawowym składnikiem włosów i paznokci .	paznokci	16	Inan
Dotychczas lokatorzy budynków , w których zainstalowane są gazomierze , płacili za gaz co dwa miesiące .	gaz	12	Inan
Federaliści przegrali wybory .	Federaliści	0	Hum
W poniedziałek dwaj gorzowianie podbili ją do 1.000 zł .	gorzowianie	3	Hum
- Ale to przecież twoi koledzy .	koledzy	5	Hum
Modernizacja Opla Frontery miała uczynić go bardziej przyjaznym dla użytkowników , nie zmniejszając jednocześnie jego możliwości .	użytkowników	9	Hum
Z tych powodów w innych krajach ministrowie starają się mówić tym samym głosem .	głosem	12	Inan
Tego nie wiemy na pewno , mimo że zacytowane wyżej zdanie stało się znakiem rozpoznawczym .	znakiem	13	Inan
Na torze pod Kielcami odbyty się pierwsze wyścigi samochodowe .	torze	1	Inan
Od pięciu dni na ulicach Wrocławia stoi największy korek w kraju .	korek	8	Inan
Jaki jest pana stosunek do eksperymentów genetycznych , dzięki którym zdaniem wielu specjalistów będzie można leczyć najcięższe schorzenia ?	stosunek	3	Inan
W bramie spotkał podporucznika Samczyca .	podporucznika	3	Hum
Niepokojącym zjawiskiem jest mieszanie różnych narkotyków oraz rozpuszczanie ich w alkoholu .	alkoholu	10	Inan
Przed obecnymi na spotkaniu wystąpili dzisiejsi uczniowie szkoły .	uczniowie	6	Hum
Ostre cięcia grożą też prezesom państwowych spółek .	prezesom	4	Hum
To jest mój debiut w kierowaniu kropidłem .	debiut	3	Inan
Jeszcze wczoraj Francja miała zarządzić blokadę kont Osamy bin Ladena oraz 26 innych osób i organizacji znajdujących się na amerykańskiej liście terrorystów .	bin	8	Hum
Negocjacje rozpoczęły się dopiero po przyjeździe do szkoły zastępcy wójta gminy .	przyjeździe	5	Inan
Kler sam na siebie zastawił polityczne sidła .	Kler	0	Inan
Dwójka ratowników wyruszyła śmigłowcem na patrol .	śmigłowcem	3	Inan
Sen w tym wypadku jest najczulszym instrumentem .	instrumentem	6	Inan
Debren starał się nie patrzeć na coś , co było do niedawna twarzą smolarza .	smolarza	13	Hum
Na witrynie umieścili też nazwiska ponad 500 znanych ludzi , którzy podpisali się pod protestem przeciwko zakazowi Marszu Równości .	protestem	14	Inan
Nie czekając na decyzję Akcji , Unia Wolności zaczęła lansować na prezesa Karola Modzelewskiego , historyka i polityka związanego z Unią Pracy .	historyka	15	Hum
Na nim konie tańczą .	konie	2	Nhum
Sterowali ruchem w pobliżu cmentarzy , kontrolowali trzeźwość kierowców poruszających się drogami województwa .	ruchem	1	Inan
Przykręca knot i dmucha w płomień lampy .	knot	1	Inan
Po powrocie do domu stwierdziłem , że nie stać mnie na zakup .	powrocie	1	Inan
Partia Konserwatywna zawiesiła Spencera w obowiązkach posła .	obowiązkach	5	Inan
- Pacjenci muszą kontynuować leczenie przynajmniej przez rok w grupie pokuracyjnej .	Pacjenci	1	Hum
Większość pampersów nie przepracowała w telewizorni nawet 12 miesięcy , więc zgodnie z obowiązującym regulaminem nie mogła uczestniczyć w nagrodach z zysku za 1994 rok .	pampersów	1	Hum
Nieleczona choroba przerodziła się w złośliwego chłoniaka .	chłoniaka	6	Nhum
Dziś liczy piętnastu członków .	członków	3	Hum
Należy podkreślić , że gaźnik jest ważnym elementem samochodu , gdyż oprócz ekonomicznego zużycia paliwa w znacznym stopniu wpływa również na niezawodność jazdy i stałą gotowość techniczną pojazdu .	pojazdu	27	Inan
Ten kierownik to ma chyba fioła .	kierownik	1	Hum
Mimo wysiłków lekarzy zmarł .	lekarzy	2	Hum
Jest jednym z nielicznych polskich twórców , którzy zrobili prawdziwie wielką międzynarodową karierę .	twórców	5	Hum
Kilka lat temu ofiarą wandali padły mogiły na Cmentarzu na Powązkach w Warszawie .	Cmentarzu	8	Inan
Dzięki nim zmniejsza się u chorego zaleganie afektu , rozładowują się utrwalone stereotypy uczuciowe , obiektywniej widzi swoją sytuację .	afektu	7	Inan
Wielu uczestników tegorocznego Karnawału gościło już wcześniej na deskach Domu Ludowego w Bukowinie Tatrzańskiej .	Karnawału	3	Inan
Kot obejrzał się na mnie i usiadł , starannie zawijając ogon na przednie łapki .	Kot	0	Nhum
Ksiądz zajął fotel dyrektora , oparł o brzeg biurka splecione dłonie , czekał .	dyrektora	3	Hum
Wcześniej jako naczelnik Wydziału Urbanistyki i Architektury podpisywał pozwolenia na budowę .	Wydziału	3	Inan
Lufki wysunęły się z większości oczu , ustalając osobę chichotu .	chichotu	9	Inan
- Ludzie wciąż przychodzą .	Ludzie	1	Hum
Powstawały robotnicze kolonie przyfabryczne wiążące pracobiorcę z pracodawcą .	pracodawcą	7	Hum
Wszechpolaków przybywa .	Wszechpolaków	0	Hum
Na tej klepce bracia mocno się poślizgnęli .	bracia	3	Hum
Obaj byli przyjaciółmi Kisiela , więc ich znajomość pojawiła się w sposób naturalny .	przyjaciółmi	2	Hum
- Oto walczę na froncie Kościoła i tam dbam o prawdziwą wiarę .	froncie	4	Inan
Wśród trzech pozostałych młodych rysi śledzonych telemetrycznie , które osiedliły się w Puszczy Białowieskiej , były dwie samice .	rysi	4	Nhum
Frajer odjedzie .	Frajer	0	Hum
KPN chce zaproponować własne rozwiązania tego problemu i dlatego żąda od resortu danych o imporcie .	imporcie	14	Inan
Gonią mnie potwory .	potwory	2	Nhum
Wyjątek stanowi finał .	Wyjątek	0	Inan
Przewodniczącym , po raz kolejny , wybrano Zbigniewa Wiktora , wykładowcę akademickiego z Wrocławia .	wykładowcę	10	Hum
Pewien brytyjski rolnik leczył swą chorą krowę piwem .	rolnik	2	Hum
Gdyby tak było , w roli matematyka doskonale spisywałby się komputer .	matematyka	6	Hum
Zmieniłem Marka Walburga , bo rozbolał go żołądek i po prostu musiał szybko udać się do ubikacji .	żołądek	7	Inan
Wybierz dowolny chat , umów się z przyjacielem na określoną godzinę i rozmawiaj do woli .	przyjacielem	7	Hum
Na zorganizowany z tej okazji piknik przybyło kilka tysięcy opolan .	opolan	9	Hum
Radni poruszyli problem złych nawierzchni dróg , domagając się ich remontu .	Radni	0	Hum
Uczestniczki wysłuchały wykładów doradców zawodowych i prawników , uczestniczyły w zajęciach psychologicznych , poznawały podstawy obsługi komputera i korzystania z Internetu .	prawników	6	Hum
Zatrzymał doktorwagena przed samym wejściem , przywiązał lejce do barierki przy krawężniku , pogłaskał konia po chrapach i wszedł do królestwa Polizeiwachtmeistra Starkego .	konia	14	Nhum
Złożoność biografii Wilhelma bez wątpienia nie stanowiła tajemnicy dla jego współczesnych .	współczesnych	10	Hum
Przewróciła plaster sarniny na drugą stronę .	plaster	1	Inan
Czy chcę ich oboje z Cezarem obrazić , zapytała .	oboje	3	Inan
Arkadiusza J . pogrążyły też zeznania taksówkarza , który zabrał oskarżonych sprzed Stodoły .	oskarżonych	10	Hum
Rozpędzonej karuzeli stanowisk nie zatrzymała minister Piwnik , choć przez pierwsze pół roku urzędowania wstrzymywała się ona z ruchami kadrowymi .	ruchami	18	Inan
Szefowie Masterlink zauważyli , że chociaż nie mają pracownika obok siebie , jego efektywność wzrosła .	pracownika	8	Hum
Zamek chętnie zwiedzają cudzoziemcy .	cudzoziemcy	3	Hum
Uważano więc w partii , że Gierek , po antrakcie Ochaba , powrócił do praktyki niszczenia poprzedników przez następców .	antrakcie	9	Inan
Starem z przyczepą załadowaną piaskiem kierował kursant .	Starem	0	Nhum
- Czas był wtedy pogodny .	Czas	1	Inan
Dyrektorzy szpitali tłumaczą , że nie mają pieniędzy dla lekarzy .	lekarzy	9	Hum
W środę ze Szpitala Ginekologiczno - Położniczego w Opolu wypisywano 11 noworodków .	noworodków	11	Nhum
- Wysłaliśmy ponad 500 zapytań , systematycznie przeglądamy odpowiedzi i nie natrafiliśmy jeszcze na urzędnika , na którym ciąży prawomocny wyrok sądowy .	urzędnika	14	Hum
Zawsze przechowywała go w budkach u zaprzyjaźnionych handlarzy .	handlarzy	7	Hum
Piękne dziewczyny zelektryzowały kierowców tirów .	kierowców	3	Hum
Świadkowie twierdzą , że spod siedziby SdRP odjechało w ostatnich kilkunastu miesiącach kilka takich grup .	Świadkowie	0	Hum
Po odparciu ataku i ujęciu 10 terrorystów zawrócono konwój do bazy w Al Kut .	terrorystów	6	Hum
Polski samolot M-28 rozbił się i eksplodował kilka sekund po starcie z lotniska w Puerto Cabello , 200 km na zachód od Caracas .	samolot	1	Inan
Niech zstąpi Duch Twój !	Duch	2	Nhum
Nigdy nie było żadnych długów .	długów	4	Inan
Wyrok jest nieprawomocny .	Wyrok	0	Inan
Ale wydaje mi się , że Lech , Czech i Rus musieli bardzo długo pędzić za jeleniem , dzikiem i niedźwiedziem .	jeleniem	16	Nhum
Przed urzędem wojewódzkim domagali się , by władze wydały zgodę na budowę supermarketu na terenie klubu .	supermarketu	12	Inan
Nieprawidłowości wykrył prezes spółdzielni , zarządził właśnie kontrolę .	prezes	2	Hum
Wczoraj kamieniarze szykowali się do swojej części prac .	kamieniarze	1	Hum
Po odparciu ataku i ujęciu 10 terrorystów zawrócono konwój do bazy w Al Kut .	konwój	8	Inan
Człowiek staje się wyleniałym tygrysem .	tygrysem	4	Nhum
Pociski są przerdzewiałe i posiadają zapalniki .	Pociski	0	Inan
Dowódca sił amerykańskich w Afganistanie generał Tommy Franks zapowiedział kolejne operacje lądowe .	generał	5	Hum
Przechodzień , który pomógł bitemu policjantowi , już dostaje pogróżki .	policjantowi	5	Hum
MPK jest dziś spółką , od której samorząd kupuje przewozowe usługi .	samorząd	7	Inan
Chłopiec wynurza się spod stołu , trzymając na dłoni rozbite jajko , strzaskaną skorupkę , rozlane żółtko i oślizłe białko .	stołu	4	Inan
– Był Pan pijany i prosił Pan sąsiada , aby Pana zastrzelił ?	sąsiada	7	Hum
Taki stosunek nie może sprzyjać należytemu rozwojowi myśli twórczej wśród pracowników Stoczni , a tym samym przynosi straty państwu .	stosunek	1	Inan
Napisałaby więc z pewnością o Bali , co się stało w Kucie , tuż przy głównym deptaku .	deptaku	16	Inan
Do roku 2006 znikną z obszaru Unii Europejskiej ostatnie reklamy papierosów .	papierosów	10	Nhum
Pokrzepiła mnie tym na duchu .	duchu	4	Nhum
Otrzymuje wyrok śmierci , zamieniony na dziesięć lat łagru .	wyrok	1	Inan
Na zakończenie uroczystości głos zabrał sam ks . kardynał Sodano , który na początku niemal czystą polszczyzną przywitał przybyłych gości oraz wyraził swoje zadowolenie z pobytu we Wrocławiu .	kardynał	8	Hum
- Weź te ręce , gówniarzu !	gówniarzu	5	Hum
Ale jak zaufać policji , która robi w konia kandydatów na policjantów ?	kandydatów	9	Hum
Specjaliści przewidują , że cena za tonę pszenicy nie przekroczy 380 złotych .	Specjaliści	0	Hum
Francuscy komuniści są gotowi stworzyć z socjalistami rząd lewicy po wyborach 1998 roku .	socjalistami	6	Hum
Daj przepis na faworki .	faworki	3	Nhum
Wobec tego mąż delikatnie informuje o tym żonę .	mąż	2	Hum
Przyczyną tej zadziwiającej dla Europejczyków decyzji jest postać Prosiaczka , przyjaciela Kubusia .	przyjaciela	10	Hum
- Nie mam czasu chodzić do doktora , ani mi się śni !	doktora	6	Hum
Grupa ponad 30 działaczy samorządowych , spółdzielców i bankierów na czterech pięciodniowych sesjach ma poznać francuskie rozwiązania dotyczące budownictwa czynszowego .	bankierów	8	Hum
Z pism Slazskiej Energetiki wynika , że opalana węglem nowa elektrociepłownia w Trzyńcu będzie spełniała wszystkie europejskie normy ekologiczne .	węglem	8	Inan
– Bo chyba pana Macierewicza trzymają się żarty .	żarty	7	Inan
Stwierdzam , że Sejm wobec nieuzyskania bezwzględnej większości głosów poprawkę Senatu przyjął .	głosów	8	Inan
Uczestniczki wysłuchały wykładów doradców zawodowych i prawników , uczestniczyły w zajęciach psychologicznych , poznawały podstawy obsługi komputera i korzystania z Internetu .	komputera	16	Inan
Podejrzanym grozi do 10 lat pozbawienia wolności .	Podejrzanym	0	Hum
Szwagier pana Korzeniowskiego toporem rozrąbał świński łeb i wydobył mózg .	łeb	6	Inan
W opinii tej było tyleż przesady , ile podziwu dla niepokornych górali , którzy pozostawali wierni i lojalni , dopóki stara przyjaźń nie zaczynała dla nich samych stanowić zagrożenia .	górali	11	Hum
Przyjrzyj się fotografiom i rysunkom w podręczniku przedstawiającym przykład krajobrazu śródziemnomorskiego .	przykład	8	Inan
Nie wystarczy już sam preparat o działaniu nawilżającym .	preparat	4	Inan
Pani Czapkowa zaścieliła stół świeżą ceratą , podała kotlety z dzika , a po obiedzie odbyło się sympozjum .	dzika	10	Nhum
Stilo to model środka gamy Fiata .	model	2	Inan
Niestety odzewu nie było .	odzewu	1	Inan
Zdaniem lekarzy , szpitale cierpiące na brak pieniędzy podejmują drastyczne programy oszczędnościowe .	brak	6	Inan
Leczenie ataków padaczkowych polega na podawaniu leków przerywających drgawki niezależnie od ich przyczyny .	leków	6	Inan
Jest to duży wysiłek , jednak nauka szkolna jest zasadniczym czynnikiem samowychowawczym .	czynnikiem	10	Inan
Najstarszy prawnuk ma 21 lat ; gdyby założył rodzinę , jubilaci zostaliby prapradziadkami .	prawnuk	1	Hum
Czy mogę być normalny , skoro przez lata byłem aktorem w policyjnym pornosie ?	pornosie	12	Nhum
- Mamy własnego stara .	stara	3	Nhum
A przecież poeta świetnie wiedział , że cud wiosny zdarza się regularnie co roku .	poeta	2	Hum
Niechlubny ranking województwa wielkopolskiego otwiera Wojewódzki Szpital Zespolony w Lesznie .	ranking	1	Inan
Z drugiej strony oskarżyciel potwierdza , że on sam w czasach próby był inny i pozostał inny .	oskarżyciel	3	Hum
- Langer z grubasami popychał dziennikarską brać do wyjścia .	grubasami	3	Hum
Padają Zakłady Cegielskiego w Poznaniu , a dialog przenosi się na ulice .	Zakłady	1	Inan
Na progu stał wysoki , zarośnięty mężczyzna .	mężczyzna	6	Hum
Po naszym telefonie na miejscu pojawiła się policja , by ocenić , czy jest to krzew znajdujący się na liście zakazanych używek halucynogennych .	krzew	15	Inan
Idea Rajskiego Cerbera bardzo mi się podoba .	Cerbera	2	Nhum
W 1989 roku Humphrey zaczął pracować w rezydencji premierów Wielkiej Brytanii w charakterze niezłomnego pogromcy myszy i szczurów .	szczurów	17	Nhum
O planach grupy biznesmenów z Łeby mówi się coraz głośniej .	biznesmenów	3	Hum
Bronił eksmitowanych na bruk , naprawiając błędy przyjętej przez koalicję SLD­PSL ustawy , grzmiał na globalistów i świeżych krajowych , drapieżnych kapitalistów .	bruk	3	Inan
Ten biało - czarny kocur zdobył szturmem serca pracowników Downing Street , a z czasem jego sława rozprzestrzeniła się na cały kraj .	kocur	4	Nhum
Każde spotkanie z przyjacielem sprawia mi ogromną radość .	przyjacielem	3	Hum
Późna wiosna była dla księdza proboszcza najbardziej znienawidzoną porą roku .	proboszcza	5	Hum
Do samolotu wolno zabrać bagaż podręczny o wadze 5 kg .	bagaż	4	Inan
Pawłowi M . zarzuca się również , że działał z zamiarem spowodowania ciężkiego kalectwa rzucając nożem w głowę włoskiego piłkarza Dino Baggio .	piłkarza	19	Hum
Warszawski Indeks Giełdowy zyskał 5 procent , a WIG20 , indeks największych spółek na parkiecie , wzrósł o 6,1 procent .	procent	5	Inan
Z wnioskiem takim wystąpił naczelnik OSP Arkadiusz Pindral .	naczelnik	4	Hum
Ustalono to na podstawie mutacji zachodzących w wirusie .	wirusie	7	Nhum
Obdarował pan ojciec klasztor , obdarował !	ojciec	2	Hum
- To unik , tato .	unik	2	Inan
W opinii BCC dzięki kompromisowi politycznemu , którego zwolennikiem był ekspremier , Polska jest obecnie gospodarczym tygrysem Europy Środkowo - Wschodniej .	tygrysem	16	Nhum
Czy dużo synów robotników i chłopów studiuje na uniwersytetach ?	robotników	3	Hum
Oceniając strajk , Gawin oświadczył , że ruch towarowy praktycznie się nie odbywał , a na Śląsku stanęło wiele pociągów pasażerskich .	pociągów	19	Inan
Nagle usłyszałem strzał , wpadłem do warsztatu i zastałem trupa .	strzał	2	Inan
W pewnej chwili podeszła do niej dziewczynka z cienkimi warkoczykami .	warkoczykami	9	Inan
Kazimierz Pytko napisał na naszych łamach , że nerwowe odruchy prawosławnych biorą się z ich poczucia słabości .	prawosławnych	10	Hum
Linux powinien sam wykryć wszystkie pozostałe systemy , więc raczej nie będzie potrzeby zmiany jego ustawień .	systemy	6	Inan
Przypomnijmy , że 16 lipca 1994 r . dziadkowie półtorarocznej wówczas Moniki zostawili ją przed legnicką apteką pod opieką ojca , Roberta Bielawskiego .	dziadkowie	8	Hum
Dotknął wilgotnego ręcznika w łazience , pogładził mięsistą połę szlafroka , powąchał mydło w cedrowej kasetce .	szlafroka	9	Inan
Uprawnienia selekcjonerskie dają prawo do odstrzału samców zwierzyny płowej .	samców	6	Nhum
- W pani wierszach , które zawsze tak intensywnie portretują otoczenie i pejzaż , nie ma śladu Warszawy .	wierszach	3	Inan
Mój Piotrek uchodzi za speca w dziedzinie drewnianego budownictwa na Podhalu .	speca	4	Hum
Stratę tę rekompensuje możliwość taniego zakupu nowych akcji .	zakupu	5	Inan
Co odpowie na to dominikanin ?	dominikanin	4	Hum
Wykonany z asferycznych soczewek ze szkła fluorytowego , pozwala na uzyskanie bardzo dobrej jakości obrazu .	obrazu	14	Inan
Teraz leżą tam w ciemności oba kosmyki i płyną w przyszłość spiralnym torem .	torem	12	Inan
Cała delegacja była ubrana w czarne smokingi .	smokingi	6	Inan
Po zmianie stron między słupkami zabrzańskiej bramki stanął Tomasz Wronka .	słupkami	4	Inan
Jeśli radni wyrażą na nią zgodę , to nowe ceny zaczną obowiązywać po dwóch tygodniach od opublikowania uchwały Rady w dzienniku urzędowym wojewody śląskiego .	radni	1	Hum
Nakazał też zdemontowanie istniejących terminali .	terminali	4	Inan
Nie wiem , czy Putin to Piotr II , który chciałby przywiązać Rosję do Zachodu , by uczynić ją silną .	Zachodu	14	Inan
Odbyło się to przy stosunkowo niewielkim przyroście wpływów z tytułu odsetek i podobnych dochodów .	wpływów	7	Inan
Oprócz laureatów wzięli udział w tym spotkaniu liczni działacze naszej organizacji , redaktorzy naczelni , przedstawiciele szeregu wydawnictw .	redaktorzy	12	Hum
Widzę na tej rycinie stojącą po lewej stronie grupkę ludzi ubranych w proste , długie szaty , którzy wskazują palcem na człowieka pogrążonego w przyjacielskiej pogawędce z diabłem .	diabłem	27	Nhum
Zatrzymanym przedstawiano zarzuty udziału w zorganizowanej grupie przestępczej i wprowadzenia na rynek narkotyków .	Zatrzymanym	0	Hum
Tam dyżurna kosmetyczka obejrzy pani cerę , udzieli porady i wskaże , jakie mleczko będzie najwłaściwsze , a może jeszcze doradzi jakiś krem .	krem	22	Inan
Posiadacze fatalnych brodzików kąpią się z zachowaniem wszelkiej ostrożności , używając wody bardziej skąpo niż szczęśliwi posiadacze wanien .	Posiadacze	0	Hum
Jestem proboszczem liczącej 1180 osób parafii , która posiada zabytkowy kościół wpisany do rejestru zabytków .	kościół	10	Inan
Na nasz rozum z Polmosu najzwyczajniej wyprowadzono 2 mln euro .	rozum	2	Inan
Przeciwko wnioskom Komisji ostro zaprotestował radny Krzysztof Gajewski , wiceprezydent w zarządzie odpowiedzialnym za zakup Elektrociepłowni .	radny	5	Hum
Na inwestycję przyznano 28 milionów marek kredytu , który przyznano na 15 lat z pięcioletnią karencją spłaty odsetek .	kredytu	6	Inan
Lekarze opatrzyli stłuczenia , zwichnięcia i złamania u 14 pacjentów .	Lekarze	0	Hum
Informacje i dokumenty , którymi dysponujemy , wskazują jednak , że poseł kłamie .	poseł	11	Hum
Jeszcze przed obcięciem uposażeń , krakowscy rajcy planowali wydać taką właśnie sumę na remont trzech komisariatów oraz zakup 9 samochodów dla policji i 4 dla straży miejskiej .	rajcy	6	Hum
Pociski są przerdzewiałe i posiadają zapalniki .	zapalniki	5	Inan
Zdaniem obrońców polecenie osadzenia Chodorkowskiego w pojedynczej celi przyszło z samego Kremla , który chce złamać byłego szefa koncernu naftowego .	obrońców	1	Hum
W minioną sobotę odbyły się obchody Dnia Strażaka .	Dnia	6	Inan
Maturzyści - internauci zdający na pisemnym egzaminie język polski i historię najczęściej typują tematy związane z przełomem wieków .	internauci	2	Hum
Wszedł do wagonu , w przejściu natknął się na konduktora - służbistę , który zrobił mu wykład o niebezpieczeństwie związanym ze wskakiwaniem do pociągu w biegu .	służbistę	11	Hum
Zatrzymał doktorwagena przed samym wejściem , przywiązał lejce do barierki przy krawężniku , pogłaskał konia po chrapach i wszedł do królestwa Polizeiwachtmeistra Starkego .	doktorwagena	1	Nhum
Następnie rozłożyła wysoki statyw , zawiesiła na nim pudełko , przeprowadziła od niego przezroczysty przewód do igły , którą wcześniej automatyczny iniektor umieścił w żyle na przedramieniu Irka .	iniektor	21	Inan
Obok colonel Eddie majstruje coś we wspaniałym Kodaku .	Kodaku	7	Nhum
Redukcja zatrudnienia obejmie przede wszystkim pracowników administracji i obsługi produkcji .	pracowników	5	Hum
Wszedł do wagonu , w przejściu natknął się na konduktora - służbistę , który zrobił mu wykład o niebezpieczeństwie związanym ze wskakiwaniem do pociągu w biegu .	biegu	25	Inan
Jednak ewentualne załamanie koniunktury przy obecnych cenach będzie oznaczać dla inwestorów upadek z wysokiego konia .	inwestorów	10	Hum
- Dajemy sygnał organizacjom terrorystycznym .	sygnał	2	Inan
Ćwiczyła w hełmofonie .	hełmofonie	2	Inan
Natomiast Gorczyca pominął w ogóle sprawę milczeniem .	ogóle	4	Inan
- Dlatego ZOZ-y powinny składać z kolei pozwy o zwrot pieniędzy ze skarbu państwa .	pozwy	7	Inan
Monopoliści nakręcą inflację .	Monopoliści	0	Hum
W czasie obławy policjantom z Pieniężna udało się zatrzymać dwóch kłusowników .	policjantom	3	Hum
Może to oznaczać kolejny wzrost stóp procentowych , droższego dolara i spadek zaufania inwestorów zagranicznych .	dolara	9	Nhum
Kiedyś w Poznaniu spotkałem się z moimi polskimi krewnymi .	krewnymi	8	Hum
Poseł w liście do ministra pyta o możliwość postawienia Polańskiego przed polskim sądem .	ministra	4	Hum
Pięcioletnia dziewczynka , porwana wczoraj przez 65-letniego mężczyznę w Chorzowie na Śląsku , odzyskała wieczorem przytomność .	mężczyznę	7	Hum
- Możliwość odejścia Leszka Balcerowicza bardzo zaniepokoiła inwestorów .	inwestorów	7	Hum
Rozkaz jej rozpoczęcia wydał oddziałom armii prezydent Boris Trajkovski .	oddziałom	4	Inan
Niestety zabrakło światowej sławy muzyka , przyjaciela Karola Szymanowskiego , Romana Totenberga , któremu choroba nie pozwoliła na przyjazd do Zakopanego .	przyjazd	18	Inan
Wśród ludzi wybranych na najwyższe urzędy zjawiają się bandyci , gangsterzy , szpiedzy .	bandyci	8	Hum
Szybkie obniżanie się tego ciężaru następuje zwykle w późniejszych stadiach rozwojowych i działalności metabolicznej grzybów .	grzybów	14	Nhum
Piasek zasypywał aryki , pola i domy .	aryki	2	Inan
Po co w ogóle kastrować wolno żyjące koty ?	koty	7	Nhum
Po zawarciu nowego pokoju w połowie trzynastego stulecia Swiętopełk nową , piątą z rzędu wojnę rozpoczął .	rzędu	13	Inan
Partnerem Trzebini będzie zachodnioukraińskie miasto Sokal .	Partnerem	0	Hum
Trupy wrzucono do Gopła .	Trupy	0	Nhum
W 2004 Jabil wszedł w posiadanie fabryki telewizorów w Kwidzynie .	telewizorów	7	Inan
Niedziela Palmowa na Kociewiu różniła się zresztą od obchodów w innych częściach Polski .	obchodów	8	Inan
Przed tygodniem rzesze ostrzeszowian odprowadziły go na miejsce wiecznego spoczynku .	ostrzeszowian	3	Hum
Do Warszawy dotarli już o gęstym zmroku .	zmroku	6	Inan
Denat nie miał przy sobie dokumentów .	Denat	0	Hum
Ważnym zadaniem jest zapewnienie warunków dla niezakłóconego funkcjonowania gospodarki i pracy urzędów .	urzędów	11	Inan
Owa niezapomniana chwila zawierała nieprawdopodobny ładunek patosu .	patosu	6	Inan
Wzbudza to niepokój inwestorów zagranicznych i krajowych , a także wyborców .	wyborców	10	Hum
Korespondenci budapesztańskich gazet donoszą , że wielu miejscowych Węgrów wyjechało do krewnych na wieś albo uciekło na Węgry .	Korespondenci	0	Hum
Mądrzej byłoby ominąć go szerokim łukiem .	łukiem	5	Inan
Czy dużo synów robotników i chłopów studiuje na uniwersytetach ?	synów	2	Hum
Jego brat , rzecznik łódzkiego pogotowia , jest szefem Związku .	Związku	9	Inan
Przecież ja tatki prawie nie znam !	tatki	2	Hum
Taki stan rzeczy powinien być bodźcem dla rządzących do ochrony rodziny i zachęcania małżonków do posiadania dzieci .	małżonków	13	Hum
Duże kontrowersje wzbudził zapis wywalczony przez Związek Nauczycielstwa Polskiego .	zapis	3	Inan
TWARDZIEL 1 pokazuje legitymację służb specjalnych .	TWARDZIEL	0	Hum
Nagrobek zniszczono podczas pospiesznej rozbiórki opactwa w 1529 roku .	Nagrobek	0	Inan
Sędzia także to zauważył .	Sędzia	0	Hum
Słońce prażyło niemiłosiernie , a na domiar złego wykończyły się zapasy żywności i wody .	złego	7	Hum
Taboret upadł z dramatycznym łoskotem , a on , wierzgając nogami , zawisł niczym gotowy do wypatroszenia wieprz .	wieprz	17	Nhum
– Mieliśmy listę Wildsteina , teraz wypłynęła tak zwana lista 500 , o której istnieniu poinformował prezes IPN Janusz Kurtyka .	prezes	16	Hum
W Polsce wyniki leczenia nowotworów dlatego są dwukrotnie gorsze od uzyskiwanych na Zachodzie , ponieważ na terapię trafiają chorzy przeważnie już z zaawansowanym guzem .	chorzy	18	Hum
Spora część delegatów , reprezentujących zwłaszcza środowiska młodzieżowe , zaprezentowała alternatywny wobec projektu kierownictwa program .	delegatów	2	Hum
Jeśli WebScan znajdzie wirusa , ostrzega użytkownika , by nie ściągał danego pliku z sieci .	wirusa	3	Nhum
Z klatki wyszedł sąsiad i w pijackim amoku rzucił się na niego z siekierą .	sąsiad	3	Hum
Ufundowanie muzeum dla zbiorów Jasieńskiego było naturalnym odruchem obywatela , miłośnika sztuki .	odruchem	7	Inan
Przymknął oczy i trwał w zadumie nie słysząc nawet roztrzepanej gadaniny niezliczonych wróbli .	wróbli	12	Nhum
Próba przekroczenia granicy Rzeczypospolitej przez grupę kolarzy spod znaku UPA wywołała ogólnopolskie oburzenie .	kolarzy	6	Hum
Nasz artykuł o zakupie przez wojsko kurtek dla pilotów od firmy kierowanej przez Bogusława Bagsika spowodował kontrolę Najwyższej Izby Kontroli .	pilotów	8	Hum
Planiści wypracowali już koncepcję drogi , na której przeobrażenie to winno się odbyć kosztem możliwie minimalnych ofiar .	kosztem	13	Inan
Dyskrecja , takt i skromność to podstawowe pojęcia bon tonu .	tonu	9	Inan
Mimo realizacji wielu programów adresowanych do osób niepełnosprawnych oraz możliwości zakupu sprzętu rehabilitacyjnego , nadal dla wielu osób problemem jest zdobycie wózka inwalidzkiego .	programów	3	Inan
Wychowankowie Domu Dziecka na Oruni otrzymali od policjantów prezenty mikołajkowe .	Wychowankowie	0	Hum
Skarżył się jej przecież , że w kieracie prozaicznych zajęć , wśród ludzi zajętych tylko sprawami chleba powszedniego , brak mu rozmów na poważne tematy .	kieracie	7	Inan
Można ją wypatrzyć przez teleskop .	teleskop	4	Inan
- Weź pilota , wyłącz kmiota , niech się nie miota .	kmiota	5	Hum
– Kucharki chyba nie miały wysokich stołków . . .	stołków	6	Inan
Napastnicy grozili nastolatkom , że ich pobiją .	Napastnicy	0	Hum
Zastawił się przed cięciem w prawy bok .	bok	6	Inan
Co się z panem działo ?	panem	3	Hum
- Zdałem maturę , jestem studentem AWF w Katowicach . . .	studentem	5	Hum
- Kiedy zaczęliście grać w brydża ?	brydża	5	Nhum
Koledzy pozwolą na górę .	Koledzy	0	Hum
Stwierdzam , że Sejm wobec nieuzyskania bezwzględnej większości głosów poprawki Senatu przyjął .	głosów	8	Inan
Są pożyteczne , zbliżają ludzi i umacniają przyjaźnie , a artystom garmażerni , barmanom , kelnerom i sprzątaczkom płaci kasjer ambasady .	kelnerom	15	Hum
Nasz artykuł o zakupie przez wojsko kurtek dla pilotów od firmy kierowanej przez Bogusława Bagsika spowodował kontrolę Najwyższej Izby Kontroli .	artykuł	1	Inan
Kolejną aferę w zakładach pracy chronionej ujawnili policjanci z wydziału do walki z przestępczością gospodarczą Komendy Wojewódzkiej w Olsztynie .	zakładach	3	Inan
Ciechanowianie szczycą się zabytkiem i lubią przyprowadzać tu swoich krewnych z innych miast .	krewnych	9	Hum
W sobotę podporucznik Ziemba przeniósł swoje łóżko do kuchni , rowery wstawiono do pokoju podporucznika Kowalika .	podporucznik	2	Hum
Jest to srebrna głowa jelenia w błękitnym polu , a nad nią widnieją trzy złote gwiazdy .	jelenia	4	Nhum
Potem odważniej zaatakowali gospodarze .	gospodarze	3	Hum
Policjanci odwieźli delikwentów do izby wytrzeźwień .	delikwentów	2	Hum
Wszystko dzieje się za sprawą wichru . . .	wichru	5	Inan
ja nie mam gdzie rzucać łachów .	łachów	5	Inan
Kiwa tylko ze smutkiem głową .	smutkiem	3	Inan
Zostałem Żydem zaraz po oderwaniu się od polskiej ziemi , tej , której nigdy nie sprzedamy cudzoziemcom .	cudzoziemcom	16	Hum
Nad bezpieczeństwem i utrzymaniem porządku czuwać będzie 45 tys . funkcjonariuszy i 32 tys . pomocników .	pomocników	15	Hum
W turnieju udział wzięli uczniowie szkół podstawowych , gimnazjalnych i ponadgimnazjalnych .	uczniowie	4	Hum
Piękne dziewczyny zelektryzowały kierowców tirów .	tirów	4	Nhum
W latach sześćdziesiątych , już jako sztygar oddziałowy , pamiętam odbiory przygotowywanych do rozruchu ścian dokonywane przez dyrektora Śniegonia .	dyrektora	17	Hum
Organizatorzy wręczali mu kilka czekolad i dziękowali . . .	Organizatorzy	0	Hum
Hezychasta jest wolny od grzesznych namiętności i złych myśli .	Hezychasta	0	Hum
W czasie pobytu u sióstr w klasztorze Krystyna korespondowała z ojcem , niecierpliwie wyczekując jego listów .	pobytu	2	Inan
Ugryzienia osy , pszczoły , trzmiela i szerszenia mogą być niebezpieczne .	szerszenia	7	Nhum
- Oczywiście , przecież nie robię filmów dla siebie .	filmów	6	Inan
Przejazd we wrocławskich Świniarach nie jest strzeżony .	Przejazd	0	Inan
Tępe łby zamieszczają zdjęcia .	łby	1	Nhum
W zamachu zginęły 2 osoby , a 73 odniosły rany .	zamachu	1	Inan
Do poszukiwań człowieka oskarżonego o ludobójstwo i zbrodnie przeciwko ludzkości włączyli się amerykańscy i brytyjscy agenci .	agenci	15	Hum
Malarz uspokoił się .	Malarz	0	Hum
Sprytny oszust jest przekonujący , swym ofiarom proponuje pozostawienie obrączki lub innej bezwartościowej rzeczy w zastaw i zwrot gotówki za kilkadziesiąt minut .	oszust	1	Hum
- Czy uważa pan , że po to , by utrzymać trzeźwość , alkoholik potrzebuje AA do końca życia ?	alkoholik	13	Hum
O wrocławskim spotkaniu prezydentów Kwaśniewskiego i Chiraca oraz kanclerza Schrödera informowały wszystkie media .	prezydentów	3	Hum
W Betlejem zupełnie utracili ducha dociekliwości , z punktu widzenia intelektualisty zachowali się nadzwyczaj pokornie .	intelektualisty	10	Hum
Tymczasem ktoś wykradł rysunki kości i wysłał je do Paryża .	rysunki	3	Inan
Po opadach deszczu nadleśniczowie z Tucholi , Woziwody , Zamrzenicy i Trzebcin podjęli decyzję o wycofaniu zakazu .	nadleśniczowie	3	Hum
Zdaniem ekspertów pytanych przez PG , nowe prawo farmaceutyczne nie spowoduje odpływu reklamodawców .	odpływu	11	Inan
Pożeracz Chmur przełknął ostatni kęs i oblizał palce .	kęs	4	Inan
W województwie świętokrzyskim znajdują się 323 obiekty sakralne .	obiekty	6	Inan
Nie wprowadzono prywatnej własności ziemi , nie zniszczono feudalnego imperium dyrektorów kołchozów .	dyrektorów	10	Hum
Czy każdy podatnik to człowiek podatny ?	podatnik	2	Hum
Elektrownie gazowe mają dać tyle prądu , ile daje elektrownia wodna w Asuanie .	prądu	5	Inan
W ciągu ostatniego minionego tygodnia zarówno dolar , jak i marka straciły wobec polskiej waluty .	tygodnia	4	Inan
Nie można wtedy wykryć wirusa .	wirusa	4	Nhum
W Świebodzinie na śmietniku znaleziono torbę z fałszywymi banknotami wartości miliarda złotych .	banknotami	8	Inan
Nie musi znać tekstu , bo na kredensie , na stole , na krześle ma przypięte kartki z dialogami , których kamera nie widzi .	dialogami	18	Inan
Z ciał potopionych stryjów wylęgły się tysiące myszy i wyruszyły wszystkie do Kruszwicy , prosto na dwór zbrodniarza .	zbrodniarza	17	Hum
Po wizycie papieża płyty mają zostać zwrócone powiatowi kartuskiemu .	papieża	2	Hum
A to dlatego , że norwescy słuchacze nie cenią artystów wykreowanych przez wielkie wytwórnie .	artystów	9	Hum
Wczoraj w podobnych okolicznościach wpadł technik Wydziału Kryminalnego w Nowym Mieście Lubawskim .	technik	5	Hum
Interesanci spojrzeli we wskazanym kierunku i oniemieli z radości .	Interesanci	0	Hum
Rannymi cywilami zaopiekowali się najpierw amerykańscy sanitariusze z personelu naziemnego .	sanitariusze	6	Hum
- To rekin , a ty się boisz , że przy pierwszej okazji wytarmoszę go za płetwy .	rekin	2	Nhum
Właściwie , jestem instruktorem .	instruktorem	3	Hum
jestem w stanie zgodzić się na utrzymywanie emeryta , gdyż przepracował swoje życie i coś dobrego dla społeczeństwa zrobił .	emeryta	7	Hum
Jakie renty otrzymują u was inwalidzi ?	inwalidzi	5	Hum
Świat jest chaotyczny , procesy rozwojowe nie układają się w logiczne ciągi i trzeba się z tym pogodzić .	Świat	0	Inan
Pan konsul obiecał , że poruszy natychmiast tę sprawę z attaché wojskowym , generałem brygady .	generałem	13	Hum
Na leśnej drodze zaatakował ją rowerzysta .	rowerzysta	5	Hum
W państwach europejskich , takich jak Szwecja , które mają dużo imigrantów z tego regionu , zwyczaj zwalczany jest z całą surowością prawa .	zwyczaj	16	Inan
Przykręca knot i dmucha w płomień lampy .	płomień	5	Inan
Sprytny oszust jest przekonujący , swym ofiarom proponuje pozostawienie obrączki lub innej bezwartościowej rzeczy w zastaw i zwrot gotówki za kilkadziesiąt minut .	zastaw	15	Inan
Ale cięższą przeprawę mieli ci dziennikarze , którzy szli do centrum prasowego , by stamtąd jechać dalej autokarami .	autokarami	17	Inan
Gwiazda przemieniła się w inkwizytora .	inkwizytora	4	Hum
Piłkarze krakowskiej Wisły sprawili wspaniały prezent wszystkim sympatykom futbolu w Polsce .	Piłkarze	0	Hum
Komputerowy montaż grafiki nie jest domeną zastrzeżoną wyłącznie dla profesjonalistów .	profesjonalistów	9	Hum
Sprawa została jednak skierowana do niemieckiego Urzędu Prasy i Informacji przy urzędzie kanclerza Niemiec .	kanclerza	12	Hum
Stan termiczny lodowca jest rezultatem współdziałania kilku procesów .	rezultatem	4	Inan
Nakręcił 60 filmów dokumentalnych i stworzył ponad 300 programów telewizyjnych .	filmów	2	Inan
Elektromagnetyczne promieniowanie każdego rodzaju sprzętu elektronicznego ma z reguły odmienny , tylko jemu przypisywany charakter .	sprzętu	4	Inan
W Fundacji można też uzyskać wyczerpujące informacje na temat fachowej opieki nad kotami domowymi .	kotami	12	Nhum
Oprócz słuchania Steczkowskiej delegaci zajmowali się dyskusją o strajku generalnym .	delegaci	3	Hum
- To twój pies ?	pies	3	Nhum
Polska winna się wyrzec tradycji , mumii , księcia Józefa i teatru .	księcia	8	Hum
Na wyszkolenie jednego dzika potrzeba około trzech miesięcy .	dzika	3	Nhum
W oddzielnych grupach ćwiczą panie i panowie , później znów spotykają się i odbywają wspólnie zajęcia choreograficzno - taneczne .	panowie	6	Hum
A potem zgłoś się do księcia po nagrodę .	księcia	5	Hum
Taki zapis spowoduje obligatoryjność podjęcia przez rzecznika praw obywatelskich spraw skierowanych przez rzecznika praw dziecka .	rzecznika	6	Hum
Przytyka Studentowi kieliszek do ust i poi go szampanem .	kieliszek	2	Inan
Posiada Pan jedynie dyplom magistra filozofii . . .	dyplom	3	Inan
Ta ostatnia sieć szykuje kontratak .	kontratak	4	Inan
- Wierzę , że kandydaci do członkostwa w NATO powinni spełniać generalne kryteria demokratycznych rządów i gospodarki wolnorynkowej , włączając w to poszanowanie dla praw człowieka oraz cywilną kontrolę nad wojskiem .	rządów	14	Inan
Cena wywoławcza czarnego watermana ze złotą stalówką wynosiła 300 zł .	watermana	3	Nhum
Poseł Włodzimierz Wasiński sądzi , że zmiany w rządzie nie ograniczą się do dymisji wicepremiera Janusza Tomaszewskiego .	wicepremiera	14	Hum
Zbigniew Brzeziński , doradca prezydenta Jimmy'ego Cartera do spraw bezpieczeństwa , zaapelował o umiar do robotników , władzy i Kościoła w Polsce .	doradca	3	Hum
Czy w różnych stadiach ewolucji Wszechświata aktywne jądra galaktyk były identyczne ?	Wszechświata	5	Inan
Choć pod tym względem ci obecni ani trochę nie ustępują poprzednikom .	obecni	5	Hum
Leki na obniżenie temperatury nie działały , a sytuacja , według słów Havlovej , w nocy z poniedziałku na wtorek stała się krytyczna .	poniedziałku	17	Inan
Po obaleniu caratu został przewodniczącym Komisji Likwidacyjnej do spraw Królestwa Polskiego .	przewodniczącym	4	Hum
Z tak zlokalizowanym wrogiem łatwiej walczyć . . .	wrogiem	3	Hum
Była też okazja do rozmów z wszystkimi piłkarzami i szkoleniowcami reprezentacji .	szkoleniowcami	9	Hum
Kosmonauci przechodzili ją jednak nieraz w czasie treningów .	Kosmonauci	0	Hum
Właścicielami szpitali i przychodni są miasta , powiaty i województwa .	Właścicielami	0	Hum
Żelazny kolos Żugajowi nie nabił nawet guza .	kolos	1	Nhum
Drugim ważnym wydarzeniem był run na giełdę firm poszukujących kapitału .	kapitału	9	Inan
- Będę musiał kupić nowe buty .	buty	5	Inan
Przebiegające pod miastem chodniki kopalni zalano wodą , a wzgórze zgniło i zapadło się w ziemię jak przydeptane .	chodniki	3	Inan
Poza wymienionymi , charakterystycznymi rodzajami przebiegu akumulacji w ciągu roku stwierdza się ich modyfikacje lub rodzaje pośrednie .	ciągu	8	Inan
Faceci wyglądają na prawdziwych twardzieli .	Faceci	0	Hum
To koszt rzędu 10 tysięcy funtów .	funtów	5	Nhum
Gdy strażacy ugasili już płomienie , znaleźli zwęglone zwłoki mężczyzny .	strażacy	1	Hum
Najpierw operatorzy będą mieli miesiąc na poinformowanie klientów o nadchodzących zmianach i zadanie im rutynowego pytania , czy chcą obniżki opłat roamingowych .	klientów	7	Hum
Chodzi o to , żeby demonstracje odbywały się w spokoju , żeby w minimalnym stopniu zakłócały życie innych ludzi i żeby nie było polską normą bicie policjantów , okupowanie budynków , wyrywanie znaków drogowych czy niszczenie samochodów .	spokoju	9	Inan
Janos wykonywał stoły , zydle , półeczki dla siebie , rodziny , sąsiadów , płacił nimi za pomoc przy gospodarstwie .	zydle	4	Inan
Istotne jest , aby cele edukacji ekologicznej zostały przełożone na język konkretów mających zastosowanie w codziennych działaniach ucznia .	cele	4	Inan
Aminokwasy zawierające siarkę są niezbędne dla prawidłowej syntezy keratyny , która jest podstawowym składnikiem włosów i paznokci .	składnikiem	13	Inan
Wniesienie skargi o wznowienie nie tamuje wykonania zaskarżonego wyroku .	wyroku	8	Inan
O wrocławskim spotkaniu prezydentów Kwaśniewskiego i Chiraca oraz kanclerza Schrödera informowały wszystkie media .	kanclerza	8	Hum
Zachowują się jak jacyś ekstremiści , niszcząc piękną tradycję .	ekstremiści	4	Hum
Ale wstrząsające relacje wywołały debatę na temat stosowania przymusu przy kontroli urodzin .	przymusu	8	Inan
Początek przedstawienia to bardzo delikatny moment wchodzenia w fikcję .	Początek	0	Inan
Wojna i okupacja były tylko finałem , nieuchronnie wynikającym z samej istoty faszyzmu .	finałem	5	Inan
Kanclerz Kiesinger wyraźnie oświadczył , że jego rząd uzależnia przystąpienie NRF do układu od szeregu warunków i w ogóle odkłada ten problem na nieokreślony termin .	szeregu	14	Inan
Króliki rozmnażają się bardzo szybko i są nawet plagą na niektórych terenach .	Króliki	0	Nhum
Za jego uwolnienie bandyci zażądali 300 tys . euro .	bandyci	3	Hum
Otwarcie granic nie poprawiło sytuacji plantatorów .	plantatorów	5	Hum
15 lat temu w Kielcach był jeden Wszechpolak .	Wszechpolak	7	Hum
- Może nadejdą lepsze czasy i wróci do nas .	czasy	4	Inan
Ogłoszone wczoraj dane Narodowego Banku Polskiego , dotyczące wielkości deficytu na rachunku obrotów bieżących , zaskoczyły ekonomistów .	Banku	4	Inan
