Če potegnemo črto , ugotovimo , da se nam ne splača delati , kajti kot državni prvaki plačujemo ves mladinski in članski pogon .	mladinski	19	Def
Šele nekaj tednov je bil tam , pa je že odkril , da je tu po vsej verjetnosti več alkoholikov na kvadratni kilometer kot v kateremkoli drugem velemestu v deželi .	kvadratni	21	Def
V nekaj pičlih trenutkih je vsemogočni umetnik prebarval pokrajino preko neštetih sivih odtenkov v črnosivo .	vsemogočni	5	Def
V njej je Akademski pevski zbor 12. decembra 1941 zaključil provokativni koncert s pesmijo Lipa in se z njo zavil v kulturni molk .	Akademski	3	Def
Avtor Čarobnic dr. Mirko Zupančič je dan po premieri v novogoriškem gledališču prejel srebrni častni znak Svobode Republike Slovenije .	srebrni	13	Def
Podjetje Chips and Technologies pa je ponudilo 64 - bitni video in grafični krmilnik HiQVideo .	grafični	12	Def
LJUBLJANA , 26. - Poljski premier Jerzy Buzek je sinoči prispel na dvodnevni uradni obisk v Slovenijo .	uradni	13	Def
KO JE UMRLA TUDI ONA , JE VAŠKI POGREBNIK RAZKRIL NJEN PRAVI SPOL ŠOKIRANIM MOŠKIM V BARU .	VAŠKI	7	Def
Ti so z brskalniki prvega rodu zaradi večminutnega čakanja na prikaz nove strani brez prave možnosti , da bi imeli vsaj delni vpogled v besedilo , ki ga je odjemalec že prenesel , zato prej obupajo .	delni	21	Def
Pri nas prodaja Auralogov tečaj založba Mladinska knjiga tudi v slovenski različici .	Auralogov	3	Ind
eee potem pa sorte chardonnay sivi pinot laški rizling renski rizling rumeni muškat kerner eee v suhih polsuhih variantah v polsladkih odvisno od blagovne znamke	renski	9	Def
Justin pripelje Janet v zanemarjen stanovanjski blok , kjer živi Les , ki izdeluje maske .	zanemarjen	4	Ind
Dnevni promet je na račun večjih svežnjev z republiškimi obveznicami presegel milijardo tolarjev , vendar je realni promet pod povprečjem .	Dnevni	0	Def
Lep prosto preplezljiv raztežaj privede prav na raz .	Lep	0	Ind
Analizam posameznih delnic je dodan še krovni list z razlago trenutne sestave košarice in pričakovane donosnosti košarice .	dodan	4	Ind
Balzac je svoja dela strnil v obsežen literarni načrt , zasnovan kot realistična raziskava sodobne družbe , ki jo je imenoval Človeška komedija .	literarni	7	Def
Če bo postopek do vseh enak in pravičen , ne bi smelo biti težav .	pravičen	7	Ind
Ubogljivi in od vodilne stranke poslušni minister Jelko Kacin je s svojo operativno udarno enoto ( šest oboroženih pripadnikov Voma ) opravil še zadnje kadrovske zamenjave in prerazporeditve in tako brigadi zadal še zadnji smrtni udarec .	poslušni	5	Def
štiri minute in dvajset sekund do pol sedmih je ura [incident] tole jutro se evo tudi z žvrgolenjem ptičkov prebuja pomlad je tukaj danes pa je petindvajseti marec in materinski dan danes zdajle ne rabiš nič govoriti [name:personal]	materinski	29	Def
Na tretji tekmi sezone za poletni Grand prix v Courchevelu se je naš obetavni smučarski skakalec kot tretji drugič v svoji karieri povzpel na posamične zmagovalne stopničke .	obetavni	13	Def
Zato nisem slab človek , se je pošalila .	slab	2	Ind
Tako smo se po zaslugi njenega prepričevanja proti grozeči zanemarjenosti oborožili še z drugim sesalcem , če bi se zgodilo , da bi morali naš 1100 - vatni sesalec nekega dne dati v popravilo .	vatni	27	Def
In prav zato bi bil potreben resen razmislek o škodljivosti početja , ki se mu je vendarle mogoče odreči in si s tem bistveno izboljšati kakovost življenja ter seveda podaljšati čas bivanja na tem planetu .	potreben	5	Ind
Bil je veliko bolj divji , bolj nezmeren , iz njegovega notranjega vrenja in razkrajanja pa so rasle kalne sile , nasproti katerim se je zdelo nemško ustavno življenje pravcato zdravje .	nezmeren	7	Ind
Kulturni razcvet v prvi polovici 19. stoletja je povezan s Francetom Prešernom ( 1800 - 1848 ) in njegovim krogom .	povezan	8	Ind
Na skupno občinsko vajo bodo povabili tudi ekipo gozdarjev , saj imajo letos v " načrtu " gozdni požar .	gozdni	17	Def
To je bil čuden zvok , ki je zvenel kakor jaggghh .	čuden	3	Ind
Vaš vnuk je bil še pred kratkim nebogljen dojenček , potem pa je kar čez noč shodil in se čez nekaj časa začel z vami " pogovarjati " z razpoznavnimi besedami in znamenji .	nebogljen	7	Ind
Takrat bo verjetno tudi že znan točen datum začetka izdaje maloobmejnih prepustnic oziroma rok , do katerega naj bi bil uveljavljen nov režim prehajanja meje v skladu s sporazumom .	znan	5	Ind
Nasledil ga je sin Oton I. , prvi sveti rimski cesar .	sveti	8	Def
Vsako predstavlja določen element , ki je upodobljen na oltarni plošči ; najvišja je pater .	določen	2	Ind
Podpolkovnik je bil videti začuden nad oglašanjem svojega pribočnika .	začuden	4	Ind
Ko v bližini ni bilo prodajalk , je vrečko vrgel skozi okno na ulico , kjer je čakal R. J. Trik so vseeno opazili zaposleni in B. K. prijeli do prihoda policistov , ki so tatinski par kazensko ovadili .	tatinski	35	Def
Ti so slovenski jezik ohranili kot materni jezik in se priučili jezika okolja .	materni	6	Def
ti v bistvu si šel na izločevalni sistem ni ni slaba taktika	izločevalni	6	Def
Lahko pa kot prilogo naredite tudi zelenjavni pire .	zelenjavni	6	Def
Iz dneva v dan sem bolj miren in sproščen in tako pomagam imunskemu sistemu uvideti “ zmoto ” .	sproščen	8	Ind
Slednji velja za najstarejšo ohranjeno gotsko stavbo pri nas .	Slednji	0	Def
Muzej je teritorialno pokrival ozemlje današnje Koroške v Republiki Sloveniji ( območje Mežiške , Mislinjske in zgornji del Dravske doline ) in zamejsko Koroško , kjer živijo Koroški Slovenci .	zgornji	16	Def
Znanstvenike njihova božanska radovednost in neustavljivi entuziazem zaslepita do te mere , da praviloma niti ne uvidijo možnih negativnih posledic svojega dela , prav tako pa jim nikoli v zgodovini ni uspelo nadzirati družbenih posledic svojih odkritij .	neustavljivi	5	Def
Vidno vlogo je imel Nemec še pred tremi leti , ko je na začetku tako močno dominiral , da je njegov najbolj nevarni tekmec Mika Häkkinen čutil že veliko pritiska na svojih ramenih .	nevarni	22	Def
Zmletemu mesu dodamo namočen , dobro ožet kruh , slanino , jajce , na masti prepraženo čebulo s peteršiljem in česnom ter druge začimbe in vse zelo dobro ugnetemo .	namočen	3	Ind
Predstavljaj si tale dogodek : jajčece je bilo po ovulaciji oplojeno in mali gost je ravno na poti skozi jajcevod v smeri maternice , da bi si tam poiskal mehak kotiček za prebivanje .	mehak	29	Ind
Večji obseg bi bil možen le izjemoma , ob pridobitvi predhodnega soglasja posamezne lokalne skupnosti .	možen	4	Ind
ja še spočit	spočit	2	Ind
Poudaril je , da je bila to , ko je pred desetimi leti postal deželni glavar , dokazano najboljša doba za narodnostne manjšine .	deželni	14	Def
Ta temeljni preobrat v znanostih o življenju pa se ni zgodil v zgodovinskem vakuumu , temveč je spremljal spremembe v naravi in tehnologiji moči znotraj kontinuirane gonilne sile kapitalistične reprodukcije .	temeljni	1	Def
Vsak dan ob štirih zjutraj jih razpadajoči vlak , ki ga je vlada leta 1937 rabljenega kupila od Nemcev , odpelje na delo v osemdeset kilometrov oddaljeni Rio .	razpadajoči	6	Def
Nepričakovani zaplet pred začetkom 30. tedna slovenske drame v Kranju	Nepričakovani	0	Def
Zadnji korak je izvoz podatkov .	Zadnji	0	Def
Tudi zanj pa velja , da za enak denar dobimo zelo dober klasičen fotoaparat , zato se bo najbrž le redko kdo odločil za nakup elektronske inačice .	klasičen	12	Ind
Lani je napisal odmevno izjavo Izvensodni proces in v njej protestiral , da so ga mediji drug za drugim brez ovinkov obtožili in hkrati že obsodili , češ da je kriv nezakonite in koristoljubne zlorabe uradnega položaja .	Izvensodni	5	Def
Je pogost in poleti se v jatah zadržuje na plitvinah .	pogost	1	Ind
Program je primeren predvsem za večje organizacije , kjer je v navezi s programom Symantec Enterprise Security Manager odličen par , saj slednji skrbi , da se vsi člani omrežja držijo iste varnostne politike oz. predpisov .	slednji	22	Def
Težko razumljivo je , da na trgu ponujeni izdelki za čiščenje keramike vsebujejo natrijev hidroksid in natrijev hipoklorit .	natrijev	16	Ind
Razširjenost : Razširjen je v Severni Ameriki od Severne Dakote , Velikih jezer in reke Hudson proti jugu do Mehiškega zaliva .	Razširjen	2	Ind
Na nemških tleh se je tudi zgodil njegov zlom ; v odločilni bitki , pri Leipzigu , so mu pruske in avstrijske čete zadale smrtni udarec .	smrtni	24	Def
V domišljiji se pogovori o tem s Pavlo in njeno materjo ter ju skuša prepričati , da je njegov umik upravičen :	upravičen	20	Ind
" Zato smo že septembra lani prek Gospodarske zbornice Slovenije predlagali obdavčitev vseh javnih poštnih storitev , ker bi s tem po naših izračunih imeli pozitivni finančni učinek okrog 850 milijonov tolarjev na leto .	finančni	26	Def
Ukrajinci so neugoden nasprotnik , a glede na vse težave s poškodbami in igralskimi spremembami v reprezentanci je za nas neugoden prav vsak nasprotnik .	neugoden	20	Ind
Glas Haberlove stopi na opustošeno obalo , v opustošeni svet , razsrediščen , shizofren in absolutno razbolen .	opustošeni	8	Def
eee sklenina ponavadi sega do dlesni potem pa če se malo odmakne pa da je tam kakšen mali žepek eee pri dlesni je potem razgaljen dentin	mali	17	Def
Ja , se je nasmehnil Florijan in obmiroval s pogledom na skupinici kaplanov iz okoliških mestec in vasi , ki so se hranili ob obloženi mizi sredi prostora , ampak svet je ne glede na muke zadnjih dni odrešen .	odrešen	38	Ind
Na neki čuden in skrivnosten način sva se nazadnje oba zaposlila v washingtonski policiji .	skrivnosten	4	Ind
V njem je jasno zapisano , da če obstaja utemeljen sum , da je bil storjen prekršek , potem računsko sodišče predlaga uvedbo postopka zaradi prekrška .	storjen	15	Ind
Njegov zadržani in rahločutni slog je bil v popolnem nasprotju s tedanjimi smernicami .	rahločutni	3	Def
Skrivnostna roka narave je mrzli kamen izbrusila v prečudovito umetnino .	mrzli	4	Def
Nemški konservativni dnevnik Frankfurter Allgemeine Zeitung v torkovem komentarju poziva Čehe , naj ne vztrajajo pri zastarelih izganjalnih ukazih , ki niso v duhu temeljnih vrednot Evropske unije .	Nemški	0	Def
Hip zatem je nanjo spominjal le še ogromen vrtinec .	ogromen	7	Ind
Pravi divji zagon obeh nemških navez se je že do tretjega raztežaja ustavil , pred četrtim pa smo spet vsi lepo na tesnem na drobni polički .	divji	1	Def
Amandma je umaknjen .	umaknjen	2	Ind
A njihovi napadi niso bili brezglavi , zmedeni in nadigrani Rusi pa so klonili že v sedmi minuti , ko je bil za njih usoden Portov dvojec Deco - Maniche .	Portov	25	Ind
Na posvetu vrha stranke si niso bili edini , ali je v resnici vseskozi pošten ali pa je tako zelo pokvarjen , da tega ne more nihče odkriti , so se spraševali .	pošten	14	Ind
Harrisonov prijatelj Michael Palin iz ekipe Leteči cirkus Montyja Pytona mu je nekoč namreč potožil , da mu je zmanjkalo denarja za film The Life of Brian .	Harrisonov	0	Ind
Hiter pa ni le razvoj programov , temveč tudi tako imenovanih standardov , ki skušajo vzpostaviti red na novih področjih uporabe Interneta in Svetovnega spleta .	Hiter	0	Ind
To pomeni , da nekdanji novorokerski program Štirke sedaj lahko najdemo v Orto klubu .	novorokerski	5	Def
Ministrstvo je tudi preučilo devizni in tolarski del cene plina ( prvi znaša dobrih 89 odstotkov ) .	tolarski	6	Def
Neki tinjanski podložnik je pobil beneškega vojaka , ki je iz Poreča v Brest nesel pošto .	tinjanski	1	Def
Večina slovenskih srednješolcev opravlja tudi delovno prakso ali praktični pouk v vsakdanjem delovnem okolju preizkušajo in dokazujejo svoje znanje .	praktični	8	Def
Kot odgovorni urednik informativnega programa je bil Darko zaslužen za ustanovitev Studia Ljubljana pod vodstvom Tomaža Peroviča .	odgovorni	1	Def
Sedemletni fantič iz Daruvarja zdaj dobro okreva , čaka pa ga še socialno okrevanje	Sedemletni	0	Def
Potem je svet postal lepši .	lepši	4	Def
Povedal mi je , da je posel neverjetno dober in mi takoj gostobesedno kot prodajalci od vrat do vrat svetoval , naj za svojega prijatelja priskrbim slovenski potni list .	dober	8	Ind
S takim načinom spodbujanja otrok pa želimo spodbuditi otrokov občutek za odpovedovanje .	otrokov	8	Ind
V improvizaciji je gotovo zajet vsaj odsev skladanja oziroma izbiranja elementov , ki jih pozneje kombiniraš v novo stvar .	zajet	4	Ind
Potem ko se je Milan Zorman upokojil , je ostal v podjetju kot dragocen strokovni svetovalec oziroma siva eminenca .	strokovni	14	Def
V naročje ji je padel zajeten programski niz .	programski	6	Def
Med njimi so celo zasebne organizacije , kakršna je Svetovni ekonomski forum .	ekonomski	10	Def
ko sva se dogovarjala za intervju na današnji dan vas je eee četrti maj asociiral na dva dogodka	današnji	7	Def
Iz zapora jo pospremi ambiciozni odvetnik Loudon Trott , ki ne sluti , da se mu bo njegov urejeni svet v kratkem obrnil na glavo .	ambiciozni	4	Def
S testiranjem vnetja lahko določimo , komu preti srčni napad , čeprav ima bolnik normalen ali celo nizek holesterol .	nizek	17	Ind
Tako zamišljen program je bil uporaben v deželah z različno strukturo .	zamišljen	1	Ind
samo to ne vem če je že preden zapusti vrtec šolo dijaški dom a ne	dijaški	11	Def
V SPEČEM ŽIVLJENJU RUTH RENDELL INŠPEKTORJU WEXFORDU USPE RAZVOZLATI MISTERIOZNI PRIMER UMORA ŠELE S POMOČJO HČERINE PRIPOMBE , DA BI MORALE ŽENSKE PRAKTICIRATI EONIZEM , ČE BI HOTELE BITI ENAKOPRAVNE .	MISTERIOZNI	9	Def
Folkloristi so bili tako vneti pri zbiranju denarja , da je moral vstopnino plačati celo nastopajoči Tomaž Domicelj .	nastopajoči	15	Def
CECIL RHODES JE BIL TAKO OČARAN NAD MATOBOM , DA SI JE TU IZBRAL PROSTOR ZA SVOJ GROB .	OČARAN	5	Ind
Če je skrivnopisni sestav dober , mu to ne bo uspelo .	skrivnopisni	2	Def
Če je upor uspešen , lahko predvidimo dva verjetna rezultata .	uspešen	3	Ind
Iz dneva v dan sem bolj miren in sproščen in tako pomagam imunskemu sistemu uvideti “ zmoto ” .	miren	6	Ind
Njihov osnovni del , ki omogoča le navidezni zaslon , se namesti v dodaten zavihek v Display Properties , nekaj dodatnih programčkov pa dobi svoje ikone in se namesti v menu Start .	navidezni	7	Def
Previdno zakoračim v trdem snegu v prečnico proti levi , kjer skalna klada v pobočju zadržuje sneg in tvori snežni grebenček .	snežni	19	Def
[incident] samo gospod [name:surname] je bil neposredno izzvan prosim lepo	izzvan	7	Ind
Je zelo pomemben plen za številne ribojede ptiče in ribe .	pomemben	2	Ind
Njej je v zbirki enajstih izbirnikov posvečen še celoten izbirnik .	celoten	8	Ind
Velja za najmanjši hotel na svetu in je vpisan v Guinnessovo knjigo rekordov .	najmanjši	2	Def
kaj finega boš eee pojedel v kruharni izola lep dan ti želimo	lep	8	Ind
Srce je več kakor človekov razum , volja in čustvo .	človekov	4	Ind
glavni lik je bil policaj zdaj pa je župan kot v mariboru še m [gap] ime mu je frenk drži ali ne drži ?	glavni	0	Def
bartosz bosacki je izkušen nogometaš triintridesetletni branilec ki igra za lech iz poznanja	triintridesetletni	5	Def
To pomeni , da nekdanji novorokerski program Štirke sedaj lahko najdemo v Orto klubu .	nekdanji	4	Def
V 63. minuti pa je Vogrinčič opravil pravi slalom skozi desni del obrambe Celjanov , podal žogo na drugo vratnico , kjer je bil z glavo najvišji Romero in postavil končni izid .	desni	10	Def
Ujet in zvezan na stranišču starega kina .	zvezan	2	Ind
ZOPER SKLEP O PRAVICI OZIROMA OBVEZNOSTI IZ DELOVNEGA RAZMERJA JE DOVOLJENO SODNO VARSTVO PRED DELOVNIM SODIŠČEM POD POGOJEM , DA JE JAVNI USLUŽBENEC IZKORISTIL MOŽNOST PRITOŽBE .	JAVNI	21	Def
Človk dons preprost mora met uničen imunski sistem .	uničen	5	Ind
Za že ustanovljene avtošole sicer še velja dveletni prehodni rok , v katerem morajo uskladiti svoje delovanje z novim zakonom , za tiste , ki nastajajo v teh dneh , pa je novi zakon že obvezujoč .	dveletni	7	Def
Priključek je zanimiv za kmetije , ki preko sezone krmijo z zeleno krmo v hlevu ( t. i. zeleni krmni trak ) .	zanimiv	2	Ind
FRKA : Kam se lahko občani pritožijo , če mislijo , da je bil postopek izveden nekorektno .	izveden	15	Ind
Univerza v Rostocku mu je podelila doktorski naslov po samo štirih dneh proučevanja njegovega " znanstvenega " dela .	doktorski	6	Def
Ves blaten in lačen , moker in naveličan čakanja sem bil ob srečanju s kagujem nenadoma najsrečnejši človek .	moker	5	Ind
Če pa ostane odrasel otrok doma , se starši le težko sprijaznijo s tem , da je " velik " , otrok pa ima ves čas občutek , da se njegovi starši po nepotrebnem vtikajo v njegovo življenje .	odrasel	3	Ind
Če je vodilo neke nacionalne pripadnosti kakršen koli finančni , materialni ali drugi interes , potem lahko sklepamo , da je bilo leta 1991 več Italijanov zato , ker se je tedaj po takšni logiki izplačalo biti Italijan .	materialni	10	Def
tisto sem pozabila ma saj veš jaz sem živ obup	živ	8	Ind
eee hrvaški predsednik stipe mesič je rekel da so med drugo svetovno vojno istro vse do trsta osvojili hrvaški partizani in da bi morala biti slovenija hvaležna saj bi sicer gledala na morje z oddaljenosti dvajsetih kilometrov	hrvaški	1	Def
eee da b [gap] in dodatno nih [gap] nobenemu ni dala dopusta tako da so one to vse i [name:personal] je delala celi dan in [name:personal] so delale celi dan	celi	22	Def
Glasovnice je v kotu kongresne dvorane štel legendarni hrvaški vratar Mirko Bašić .	legendarni	7	Def
EGBGB Erführungsgesetz zum Bürgerlichen Geseztbuch ( Uvodni zakon k Državljanskemu zakoniku )	Uvodni	6	Def
Kralj , presenečen in ganjen zaradi tega nepričakovanega predloga in Veronikine velikodušne pripravljenosti , da poskusi tudi problematično poslanstvo in da se odpove lastnim apostolskim nalogam v Združenih državah in drugod , je ponudbo hvaležno sprejel .	presenečen	2	Ind
Čebelarski muzej v Gornjem Krapju je torej star sto let in je vreden ogleda .	Čebelarski	0	Def
Ker je vozil vinjen in brez veljavnega vozniškega dovoljenja , prav tako pa je večkratni kršitelj prometnih predpisov , so ga ob 19.20 metliški policisti pridržali do streznitve .	večkratni	14	Def
Razumem , da živalski vrt potrebuje denar , a da ga zbira s predragimi sladoledi in poskakovanju po napeti tkanini , preprosto nima smisla .	živalski	3	Def
Čeprav je McCartney v javnosti skoraj vedno nasmejan , pa je po 21 letih prvič odkrito spregovoril o avanturi , zaradi katere bi skorajda dobil večletno zaporno kazen .	nasmejan	7	Ind
Značilni vzorec trikotnih zob morskega psa je dobro viden pri posnetku , ko je sonce že nizko .	Značilni	0	Def
ne ful je ogromen pa eee ne vem no pa še kar zmeraj stoji še zmeraj isto velik kakor je bil takrat ko je bilo ful snega [audience:laughter]	ogromen	3	Ind
S preiskavo bodo skušali odkriti , kakšen je notranji in zunanji nadzor kakovosti v vrhunsko zavarovanem podjetju .	notranji	8	Def
Približno kilometer stran od hotela deluje v neugledni baraki , ki se seveda ne more primerjati z razmerami , v katerih delajo » uradni srbski novinarji « , Informativni center Kosova .	Informativni	28	Def
Mislm , da sem mu mal zameru , ko sem bil še mejhen .	mejhen	12	Ind
ampak eee skratka si pravi kleni pohorec kako se pa štekate z onimi savinjčani ?	kleni	5	Def
Glede na potreben vložek pa je naložba predraga , so ocenili v Darsu in prometnem ministrstvu .	potreben	2	Ind
Marsikateri seksualno sprevrženi Kozorog se poslužuje hujših oblik sadizma , kot so denimo igrice » ujetništva « .	sprevrženi	2	Def
In prav to darilo se ljubiteljem elektronske plesne glasbe obeta na šesti rojstni dan izolskega posebneža Ambasade Gavioli .	rojstni	12	Def
Slavnostni govornik na petkovi slovesnosti je bil predsednik GZS Jožko Čuk .	Slavnostni	0	Def
Ko sem po odprtju Orto kluba spet prišel nazaj v Orto bar , je bil bajkerski potencial skrit na vsakem vogalu .	bajkerski	15	Def
Minule objave nerevidiranih poslovnih poročil pa so okrepile povpraševanje in včeraj je na trgu vladal zmeren optimizem .	zmeren	15	Ind
Poskusite novi , večstransko učinkoviti izdelek za nego kože okoli oči Elizabeth Arden Ceramide Defining Eye Brightener .	učinkoviti	4	Def
Če potegnemo črto , ugotovimo , da se nam ne splača delati , kajti kot državni prvaki plačujemo ves mladinski in članski pogon .	članski	21	Def
- Ob vstopu iz zunanjega v zaprt prostor otroku slečemo vrhnja oblačila in snamemo kapico .	zaprt	6	Ind
Sam sem ostal in prižgal novo cigareto .	Sam	0	Ind
» Kakovosten razpis bo opravil prvo selekcijo in privabil primerne kandidate .	Kakovosten	1	Ind
To je turističen kraj .	turističen	2	Ind
Ta del je bil sila splošen , tako nabit z gradivom , da smo mu komaj sledili , ampak je sprehod povezovala nikoli moteča se Tajda Lekše , ki bi bila sposobna odrecitirati na pamet cel Krst pri Savici .	nabit	8	Ind
Poraženci se umaknejo na osamljeni del otoka , včasih pa se celo samomorilsko poženejo s skalnih pečin v globino .	osamljeni	4	Def
Iščemo potrebni standardni odklon procesa , da bo zagotovljena zahtevana sposobnost procesa .	standardni	2	Def
Zunanjepolitična sla po oblasti je v bistvu iracionalna in vselej trči ob nasprotnika , ki je prav tako iracionalen .	iracionalen	18	Ind
Pravi razmah digitalnih kamer pa šele prihaja .	Pravi	0	Def
Njegov nemirni duh le malokdo razume .	nemirni	1	Def
Civilni dialog je temelj sodelovanja med državo in NVO Na prvi nacionalni konferenci so predstavili strateške dokumente	Civilni	0	Def
Izbor je tako raznolik in pisan , da bi bilo škoda balkon prepustiti jesenski vlažni sivini .	raznolik	3	Ind
Šele vsi ti zakoni skupaj bodo predstavljali potrebno normativno podlago za trajno tržno zasnovan gospodarski sistem .	gospodarski	14	Def
Balzac je svoja dela strnil v obsežen literarni načrt , zasnovan kot realistična raziskava sodobne družbe , ki jo je imenoval Človeška komedija .	zasnovan	10	Ind
Zakonodajno oblast ima 90 - članski Državni zbor , ki voli Vlado Republike Slovenije .	Državni	6	Def
eee se vam zdi gospod [name:personal] [name:surname] da mora biti človek prav mahnjen na te reči da da to predeluje in prebira	mahnjen	12	Ind
tale malbuch je pa fajn ta	fajn	4	Ind
eee [gap] konec osemdesetih let je bil čas ko je ko je postajal tudi v slovenskem prostoru vse bolj zanimiv eee vse bolj zanimiva smer postmodernizem postmodernizem	zanimiv	19	Ind
zdaj nekateri pravijo da j [gap] dvojni agent trojni agent da j [gap] trojanski konj ne vem kaj	dvojni	6	Def
Za te je odgovoren Pungartnik , ki pravi , da ima kot član IO KKŠ pravico obveščati člane o projektih , čeprav sam za koroško gavdo 18. decembra ni pristojen .	pristojen	29	Ind
Pa tudi cene so ugodne , saj najcenejši Palm stane le približno 20 tisočakov .	najcenejši	7	Def
Človk dons preprost mora met uničen imunski sistem .	imunski	6	Def
To pa bi pomenilo , da je na robu njegove zahteve , da bi bil uslišan , že svetila želja , da ne bi bil uslišan oziroma da bi ga bog zavrnil .	uslišan	25	Ind
Klasični koncert .	Klasični	0	Def
Rudolph je bil oblečen v popolno črnino .	oblečen	3	Ind
V arbitražnem pravu je nesporno uveljavljeno , da je pojem javnega reda ožji od pojma prisilnih predpisov , kar torej pomeni , da je izpodbijanje arbitražne odločbe zaradi kršitve materialnega prava po uveljavitvi ZDSS - 1 bolj omejeno .	ožji	12	Def
Tako zamišljen program je bil uporaben v deželah z različno strukturo .	uporaben	5	Ind
Grad v Žužemberku , ki je bil med vojno močno poškodovan so začeli obnavljati v sedemdesetih letih , vendar je obnova kmalu zastala .	poškodovan	10	Ind
Lahko sem bil enako potrpežljiv kot on .	potrpežljiv	4	Ind
Močnejši in srečnejši .	Močnejši	0	Def
Odbor že pripravlja nov zbornik o Suhi krajini , ki ga bo uredil Jože Rozman , odgovorni urednik Kmečkega glasa .	odgovorni	16	Def
Prisiljen je bil tekati z enega na drugi konec poveljniškega mostu , da bi vsi slišali njegove ukaze .	Prisiljen	0	Ind
Preko timske organizacijske strukture je vsakdo v organizaciji od predsednika uprave do posameznika na najnižjem hierarhičnem nivoju vključen v upravljanje in izboljševanje svojega dela .	vključen	17	Ind
Teči skozi visok gost plevel je bilo , kakor da bi brodila po vodi .	visok	2	Ind
OBVEZNA SESTAVINA POGODBE O ZAPOSLITVI JE DOGOVOR O NAČINU URESNIČEVANJA PRAVIC IN OBVEZNOSTI IZ TEGA DELOVNEGA RAZMERJA GLEDE NA PRAVICE IN OBVEZNOSTI DELAVCA PRI DELODAJALCU , KJER JE ZAPOSLEN S POLNIM DELOVNIM ČASOM .	ZAPOSLEN	28	Ind
Ponavadi mirni tok prekinja okrog 50 jezov , ki so jih postavili za mline in žage .	mirni	1	Def
A pomanjkanje komunikacije ni niti edini niti najmanjši greh Kopačevega ministrstva .	najmanjši	7	Def
Ogled kraja dogodka je prevzel dežurni preiskovalni sodnik .	preiskovalni	6	Def
Objavljen razpis je prvi stik med organizacijo in kandidatom in vpliva na oblikovanje ugodnega ali neugodnega vtisa o podjetju .	Objavljen	0	Ind
» Pozna uveljavitev zahtevane tehnične zakonodaje za majhna in srednje velika podjetja bo pomenila izgubo koristi , ki jih bo prinesel skupni evropski trg , « je poudaril vodja delegacije Evropske komisije v Sloveniji Erwan Fouere .	evropski	22	Def
DELAVKINA ODSOTNOST Z DELA V TEM ČASU SE ZATO NE MORE ŠTETI KOT NEOPRAVIČENA IN PROTI NJEJ NE MORE BITI IZREČEN DISCIPLINSKI UKREP PRENEHANJA DELOVNEGA RAZMERJA	DISCIPLINSKI	21	Def
Ima vitko srednje veliko telo prelivajoče se rjave barve , spodaj je svetlejši .	svetlejši	12	Def
ta pes je tako aboten videti tako bi genmanipuliert bil … tega poba zračunaj to pa lahko izračunaš tukaj računi rajtam tudi niso tako ekstra težki	aboten	4	Ind
Zakonodajno oblast ima 90 - članski Državni zbor , ki voli Vlado Republike Slovenije .	članski	5	Def
Ta mu je tudi osebno grozil , od ljudi pa je slišal , da je obtoženi govoril , » da bo vse v luft spustil « .	obtoženi	15	Def
Ujela sem Jasnin presenečeni in hkrati jezni pogled .	Jasnin	2	Ind
Dovolj je , če povemo , da je rezultat srečnejši , kot bi človek pričakoval po vseh teh zmedah in naprezanjih .	srečnejši	9	Def
Ob rečnih mrtvicah se ohranja pester in slikovit življenjski prostor logov , močvirij in poplavljenih travnikov .	pester	5	Ind
ja zdajle imate u [gap] a je tu kolektiven ali kako je zdaj to	kolektiven	8	Ind
Če gre za zaključeno ali zaprto skupino oziroma bilateralni odnos , dogovor ne predstavlja posebnega problema .	bilateralni	8	Def
MDO PD Pomurje vabi v soboto na planinski ples .	planinski	7	Def
Stric je bil tako razjarjen , da je za njima zalučal grebljo .	razjarjen	4	Ind
Ruski pohlep po prevladi ni bil niti za las boljši od nemškega .	Ruski	0	Def
Nočni pohod bi lahko še nadaljevali .	Nočni	0	Def
Lani je bila v tem tekmovanju najuspešnejša Mozambičanka Maria Mutola , ki je s samimi zmagami v teku na 800 m dobila milijon ameriških dolarjev nagrade in kot prva atletinja v zgodovini sama osvojila celoten zmagoviti delež lige .	celoten	34	Ind
Pisanja sem imela čez glavo dovolj in privoščila sem si enomesečni odmor .	enomesečni	10	Def
Za izjemne dolgoletne zasluge in osebni prispevek v slovenski gledališki kulturi je predsednik Milan Kučan odlikoval še profesorje AGRFT Štefanijo Drolc , Jožeta Galeta , Mirana Herzoga , Vido Jan Juvan , Mileta Koruna in Pina Mlakarja .	osebni	5	Def
Čilsko sodišče mu je sklenilo odvzeti imuniteto , ki si jo je pridobil kot dosmrtni senator .	dosmrtni	14	Def
Naslednji dan se je Vatanen z zajčkom napotil v heinolsko banko .	Naslednji	0	Def
To je pičkin dim .	pičkin	2	Ind
Pravico voliti in biti voljen za člana občinskega sveta - predstavnika romske skupnosti imajo pripadniki te skupnosti , ki imajo volilno pravico .	voljen	4	Ind
eee to je eem eee rastlina oddaja kisik ki ga j [gap] eee ogljikov dioksid ki ga ne potrebuje	ogljikov	13	Ind
Odločilni prelom v razvoju mesta se je zgodil , ko je bila med letoma 1849 in 1857 speljana skozi Ljubljano železniška proga Dunaj - Trst .	Odločilni	0	Def
V torek zvečer bodo na dvorišču knežjega dvorca spektakularno odprli letošnji celjski poletni festival	celjski	11	Def
Vsak dan ob štirih zjutraj jih razpadajoči vlak , ki ga je vlada leta 1937 rabljenega kupila od Nemcev , odpelje na delo v osemdeset kilometrov oddaljeni Rio .	oddaljeni	26	Def
Morda bi bil kdo ubit , vendar bi bil izid verjetno še vedno bolj ugoden zanje .	ugoden	14	Ind
Večji obseg bi bil možen le izjemoma , ob pridobitvi predhodnega soglasja posamezne lokalne skupnosti .	Večji	0	Def
Opisan je bil način , kako pomagati alkoholiku do ozdravitve s pomočjo alternativne medicine .	Opisan	0	Ind
Ribji živelj si je zato opomogel .	Ribji	0	Def
Na Čatežu bi prišlo celo do primera , ko bi smelo točiti odprti cviček le osebje višje ležeče gostilne sredi naselja , medtem ko bi morali pri njihovih sosedih na obrežju reke Save kupovati stekleničeno vino .	odprti	12	Def
ja eee ker svet ni več tako zelo prijazen vsaj kar se tega tiče	prijazen	8	Ind
ob tem vivaldijevem stavku sem se spomnila kako so nekdaj plesali in se priklanjali drug drugemu	drug	14	Ind
Med naravnimi spomeniki velja omeniti najnižje ležeči nasad smreke v Evropi , najvišje bukve na svetu in evropske živalske posebnosti , kot je medved ali ris .	ležeči	6	Def
Po sklepu vlade naj bi delovna skupina , ki jo vodimo , v enem mesecu pripravila antidiskriminacijski zakon .	antidiskriminacijski	16	Def
To je bil najdaljši polet kateregakoli space shuttla v zgodovini , preučevali pa so predvsem , kako vesoljska potovanja učinkujejo na človeški organizem .	najdaljši	3	Def
MOSKVA , 11. - Ruski predsednik Boris Jelcin , je vendarle ugotovil , da ne bo uspel prepričati poslancev dume , in umaknil predlog o imenovanju Viktorja Černomirdina za predsednika zvezne vlade .	Ruski	4	Def
V širši regiji so pripravili še naravoslovno razstavo iz zapuščine Maksa Kunca in rudarsko stanovanje v muzeju Podzemlje Pece v Mežici , splavarski muzej v Javorniku ter Kamnoseški in glažutarski muzej v Josipdolu na Pohorju .	glažutarski	29	Def
jutranji pogled na cerkev je bil za vaščane veliko presenečenje	jutranji	0	Def
Ko bi nekdo potem na spletnem mestu zahteval abecedni seznam , bi dobil samodejno generiran seznam , ki bil tako ažuren , kot je zbirka podatkov .	ažuren	20	Ind
V Sloveniji namreč nimamo koncesionarjev , ki bi zbirali posebne odpadke , izjema je le mežiški TAB , ki zbira odslužene akumulatorje .	mežiški	15	Def
Bil sem presenečen , da ponuja slovenske papirje , saj sem vedel , da je hrvaški policist .	presenečen	2	Ind
LJUBLJANA Dvajsetletni B. K. iz okolice Iga in 23 - letni R. J. iz Ljubljane sta hotela iz trgovine v Čopovi ulici ukrasti jakno .	letni	10	Def
Močan odziv trga je bil posledica presenečenja trgov nad pozitivno novico v tehnološkem evropskem sektorju .	Močan	0	Ind
Mandarić pravi , da je zanj največja težava pomanjkanje časa , kajti menda je polno zaposlen s projektom gradnje novega štadiona Portsmoutha .	zaposlen	15	Ind
Aktiven je ponoči svoj plen zaznava s svojimi občutljivimi brki .	Aktiven	0	Ind
Žrtvi se odpravita proti studiu , sumljivi individuum pa odide v svojo hišo .	sumljivi	6	Def
Veliko več državljanov je nanj namreč odgovorilo , da je njihov materni jezik italijanščina , kot se jih je izreklo za italijansko narodnost .	materni	11	Def
Če tak otrok ne dobi ustrezne nujne prve pomoči , je lahko naslednji pik usoden .	usoden	14	Ind
Hitreje in bolj zanesljivo skozi ovinke : novi variabilni zaporni sistem odpravlja večino slabosti klasične diferencialne zapore , zato nudi več voznih užitkov na različnih cestnih podlagah .	variabilni	8	Def
Glavni delež obremenitev bo pri snemanju videa iz TV - kartice nosil sam procesor .	Glavni	0	Def
Dober interpret njegovih pesmi in igralec , ki ga upodablja v filmu o njem , mora izpolnjevati ta prvi pogoj .	Dober	0	Ind
Toda tudi najbolj zvezdniška zasedba v nogometni zgodovini v tej sezoni ni bila dovolj dobra , saj je v polfinalu lige prvakov izpadla z Juventusom , potem ko je v nepozabnem četrtfinalu izločila prav Beckhamov dosedanji klub Manchester United .	Beckhamov	34	Ind
Prospero ga je nagovoril , učil ga je govoriti in sploh je bil do njegove umske revščine zelo pozoren .	pozoren	18	Ind
Šeligov slog je zato težak , izrazito hermetičen , poln nakazanih podob in pomenov , ki jih bralec večkrat le zasluti , povsem jasno razvozlati pa jih ne more .	težak	4	Ind
Sosedov brat je vedel , da ta spolno zlorablja punčko in jo je začel tudi sam .	Sosedov	0	Ind
Poleg tega , da ji je prinesel zajtrk in kosilo , je še štirikrat preveril , kako je z njo , vendar je bila vsakič priključena na svojo virtualno čelado ali pa na računalniški terminal .	računalniški	33	Def
Velikanski zabaviščni prostor je ograjen in mrki redarji preverjajo vsak nahrbtnik posebej .	ograjen	4	Ind
Med njimi so celo zasebne organizacije , kakršna je Svetovni ekonomski forum .	Svetovni	9	Def
Toda Grudnov strah pred trajno zvezo z Marijo je močnejši od njegove vesti .	Grudnov	1	Ind
Ves blaten in lačen , moker in naveličan čakanja sem bil ob srečanju s kagujem nenadoma najsrečnejši človek .	lačen	3	Ind
Dan je bil prekrasen .	prekrasen	3	Ind
Če pa želite svoje čebelice toplo odeti že oktobra , naj bo opaž zračen in suh .	zračen	13	Ind
ZVZD JE NOV , VSEOBSEŽEN PRAVNI VIR SODOBNE ZAKONSKE UREDITVE VARNOSTI IN ZDRAVJA PRI DELU , KI JE NADOMESTIL DOTLEJ VELJAVNI ZAKON O VARSTVU PRI DELU IZ LETA 1974 .	VELJAVNI	20	Def
Ko bo zakon o družbah , prepričani smo , da bo sprejet , sprejet , se bo pravo delo šele začelo .	sprejet	13	Ind
Problem z Bourdieujevim modelom je , da je tako francoski .	francoski	9	Def
Niti mogočna mati niti kraljevski oče Zevs je nista mogla rešiti krute usode .	kraljevski	4	Def
Zelo miren je in takoj zna preceniti , kakšna sem in kakšne so moje potrebe , ter se vesti v skladu s tem .	miren	1	Ind
Poln zaupanja se zatekam v zavetje vajinih ljubečih Src .	Poln	0	Ind
Za danes je napovedano usklajevanje na ministrstvu za finance , predvidoma prihodnji teden naj bi uredbo sprejela vlada .	prihodnji	11	Def
Lahko opravimo tudi preizkus občutljivosti na C - reaktivni protein ( CRP ) , ki kaže na vnetje endotelija oziroma notranje stene krvnih žil .	reaktivni	8	Def
Begbiejeve bojevite oči , odprt gobec pa zamrznena faca se stran obrnejo pa probavajo nekak dojet to informacijo pa se odločt , a je to zdaj v redu , slabo al pa ga totalno boli kurac za vse skupi .	odprt	4	Ind
S poslano dopisnico sodelujoči potrjuje , da je seznanjen s pravili nagradne igre .	sodelujoči	3	Def
Meni se zdi to najzanimivejši , obetavni del pusta in pustovanja .	obetavni	6	Def
Kot pravi Nika Leben , naj bi letos restavrirali v tej cerkvi glavni renesančni oltar in freske na fasadi prezbiterija ter tako zaključili obnovo .	renesančni	13	Def
LJUBLJANA , 26. - Poljski premier Jerzy Buzek je sinoči prispel na dvodnevni uradni obisk v Slovenijo .	Poljski	4	Def
Ker nista hotela razkriti , kateri od njiju mu je zadal smrtni udarec , so ju obsodili na zgolj osem let zapora zaradi okrutnosti do otrok .	smrtni	11	Def
Sedež sežigalnice odpadkov naj bi bil v Kidričevem , vendar je občinski svet mnenja , da se tamkajšnji prebivalci s tem ne bodo strinjali .	občinski	11	Def
Glas Haberlove stopi na opustošeno obalo , v opustošeni svet , razsrediščen , shizofren in absolutno razbolen .	shizofren	13	Ind
Na pol pota po rokavu navzgor smo izstopili in pokosili ; in med tem kosilom sva z Georgeom doživela precejšen šok .	precejšen	19	Ind
Na poti si ogledamo še smrekov gozd v ekstremnih razmerah in ostaline savske linije .	smrekov	5	Ind
Ogled kraja dogodka je prevzel dežurni preiskovalni sodnik .	dežurni	5	Def
Nemški konservativni dnevnik Frankfurter Allgemeine Zeitung v torkovem komentarju poziva Čehe , naj ne vztrajajo pri zastarelih izganjalnih ukazih , ki niso v duhu temeljnih vrednot Evropske unije .	konservativni	1	Def
Vinko Potočnik , ki se v Cerkvi na Slovenskem največ ukvarja s statističnimi raziskavami , je nad izločitvijo vprašanja nadvse začuden .	začuden	20	Ind
Od tod se vrnemo proti jugovzhodu na Mrzli Studenec , kjer Pokljuška pot sklene svoj krog .	Mrzli	7	Def
Avtor Čarobnic dr. Mirko Zupančič je dan po premieri v novogoriškem gledališču prejel srebrni častni znak Svobode Republike Slovenije .	častni	14	Def
ZAGREB , 22. - Podobno kot pri nas v soboto je bil tudi na Hrvaškem včeraj odločilni obračun za prvo mesto v rokometnem prvenstvu .	odločilni	16	Def
Prodala sva ves moj nakit in ko denarja ni bilo več , se je Ibrahim domislil , da bi dala časopisni oglas .	časopisni	20	Def
Do upokojitve leta 1984 pa je bil dolga desetletja direktor Tiskarsko - kartonažnega in založniškega podjetja Pomurski tisk Murska Sobota .	Pomurski	16	Def
Tudi rok plačila je dvoumen .	dvoumen	4	Ind
onadva sta iz logarske doline ti si pa tu naš kleni pohorec [gap] … zelenega pohorja	kleni	10	Def
Oba sta razumela ta izbrani užitek ki je bil toliko močnejši , čim bolj prepovedan je bil .	prepovedan	14	Ind
» Frizerski salon za moške « je bil najbolj vroč kraj za jam session v severovzhodnem Washingtonu .	Frizerski	1	Def
Po vsebinskih poudarkih so sicer različni , a njihova skupna značilnost je , da poskušajo strokovni gordijski vozel razmejitve presekati tako , da pripišejo narodu druge države negativne kolektivne lastnosti .	strokovni	15	Def
» Zdaj je poplačan ves trud .	poplačan	3	Ind
Mladice imajo črno vzdolžno progo , ki se pri odraslih spremeni v nekakšen temen vzorec , podoben šahovnici .	temen	13	Ind
Prepletene pa so s prav tako zabavnimi zgodovinskimi ekskurzi o krajih in pokrajinah , skozi katere vodi prijatelje Temzin tok .	Temzin	18	Ind
Velika svečanost po mitraičnem koledarju se je odvijala 25. decembra , vsak 16. dan v mesecu je bil posvečen Mitru .	posvečen	18	Ind
Sam poseg sicer dlačico poškoduje tako , da ne more več rasti , koža pa pri tem ostane nepoškodovana .	Sam	0	Ind
Program je primeren predvsem za večje organizacije , kjer je v navezi s programom Symantec Enterprise Security Manager odličen par , saj slednji skrbi , da se vsi člani omrežja držijo iste varnostne politike oz. predpisov .	odličen	18	Ind
Opazen ni bil nikakršen razpoznaven red ali kronološka oziroma geografska postavitev , kategorije in klasifikacije so ostale le delno razpoznavne .	razpoznaven	4	Ind
Zemljo si razdelil med sinove , prgišče morja , ki ti je ostalo , si prodal za temen kot v nedokončani hiši s pogledom na vaško pristanišče .	temen	17	Ind
Na neki čuden in skrivnosten način sva se nazadnje oba zaposlila v washingtonski policiji .	čuden	2	Ind
Drugi je zavrniti takó disciplino kot skupnost , ki izvršuje nadzor .	Drugi	0	Def
Nenadoma pa se znajde v nezavidljivem položaju , ko mamica znova zanosi in mora kot najstarejši otrok paziti na bratca in sestrico .	najstarejši	15	Def
Vzemimo za primer piranski občinski svet , čeravno je verjetno zelo podobno povsod drugod .	občinski	4	Def
Tako je bil včeraj obiskan profesionalni teniški turnir ATP v Domžalah , ko je nastopil Mariborčan Iztok Božič .	teniški	6	Def
" Ljubim Nicoletto in to sem dolžan storiti , " je dejal tenorist .	dolžan	6	Ind
Šele ko se je poročil s poljsko grofico Evo Hansko ( 1849 ) , se je rešil dolgov , ker je bil nekaj tednov pozneje že mrtev .	mrtev	26	Ind
Nato pa sva bruhnila v glasen krohot .	glasen	5	Ind
jasno dodan ima še slalom	dodan	1	Ind
Predvideni datum letošnje osrednje dirke je sovpadal z dnevom pogreba papeža Janeza Pavla II.	Predvideni	0	Def
Črni ponarejeni Armanijev športni plašč .	Armanijev	2	Ind
V DRUGIH DRŽAVNIH ORGANIH PRAVICE IN DOLŽNOSTI DELODAJALCA IZVRŠUJE PREDSTOJNIK , ČE ZAKON , DRUG PREDPIS ALI SPLOŠNI AKT ORGANA NE DOLOČA DRUGAČE .	SPLOŠNI	17	Def
Slišal je nejevoljen , pridušen pogovor pijanih mož .	pridušen	4	Ind
Avstralski znanstvenik dr. David Lewis iz Sydneya je s svojo raziskavo pri različnih ljubezenskih parčkih ugotovil naslednje .	Avstralski	0	Def
Načrtujejo tudi skorajšnja srečanja z drugimi zainteresiranimi udeleženci zakonodajne razprave , kot sta obe zbornici , združenje ravnateljev , republiški svet za vzgojo in preventivo v cestnem prometu , občine …	republiški	19	Def
" Zato smo že septembra lani prek Gospodarske zbornice Slovenije predlagali obdavčitev vseh javnih poštnih storitev , ker bi s tem po naših izračunih imeli pozitivni finančni učinek okrog 850 milijonov tolarjev na leto .	pozitivni	25	Def
Animiran logotip na vaši domači strani lahko pritegne pozornost na vaše podjetje ali na ime izdelka .	Animiran	0	Ind
Avalonin glas je bil brezupno zbegan .	Avalonin	0	Ind
Niti ni poceni .	poceni	2	Ind
Vedeti moramo , da je dojenčkov želodček majhen , zato ne more pojesti velikih količin hrane .	dojenčkov	5	Ind
Semiški župan Janko Bukovec je zaželel svetnikom , da bi bili zavzeti in strpni .	Semiški	0	Def
da bi skupaj pripravili tak zakonski predlog ki bi potem držal vodo če s [gap] lahko tako rečem	zakonski	5	Def
Žleza ščitnica izloča hormon tiroksin , ki vsebuje kot sestavni del jod .	sestavni	9	Def
Slovenski komorni zbor in Zbor Consortium musicum .	Slovenski	0	Def
Po prvih počitnicah se je John vrnil bled in napet .	napet	9	Ind
zdaj nekateri pravijo da j [gap] dvojni agent trojni agent da j [gap] trojanski konj ne vem kaj	trojanski	13	Def
Če smo natančni , naj bi hrvaški mojster nogometa za igranje v naslednji sezoni prejel 150.000 evrov , kar je torej kar dvakrat manj , kot je bilo prvotno dogovorjeno .	hrvaški	6	Def
eee e [gap] enkraten no res	enkraten	3	Ind
Po besedah ameriških predstavnikov je bil posnet novembra , našli pa so ga v hiši v Afganistanu .	posnet	6	Ind
Srebrni častni znak je prejela tudi Pia Mlakar .	Srebrni	0	Def
Ko sem po odprtju Orto kluba spet prišel nazaj v Orto bar , je bil bajkerski potencial skrit na vsakem vogalu .	skrit	17	Ind
Ravne na Koroškem - Koroški fužinar , glasilo guštanjskih železarjev , praznuje 50 - letnico .	Koroški	4	Def
Pravi divji zagon obeh nemških navez se je že do tretjega raztežaja ustavil , pred četrtim pa smo spet vsi lepo na tesnem na drobni polički .	Pravi	0	Def
Očitni argument v prid tega nasveta je obsodba brezdelništva in etos dela , kar vse izhaja iz zapovedi sv. pisma .	Očitni	0	Def
Kot odgovorni urednik informativnega programa je bil Darko zaslužen za ustanovitev Studia Ljubljana pod vodstvom Tomaža Peroviča .	zaslužen	8	Ind
V njej je Akademski pevski zbor 12. decembra 1941 zaključil provokativni koncert s pesmijo Lipa in se z njo zavil v kulturni molk .	pevski	4	Def
Klub LokalPatriot iz Novega mesta v soboto ob 17. uri prireja večer , posvečen ženskim željam in potrebam .	posvečen	13	Ind
Čeprav je ta stranka zasedla največ sedežev v parlamentu , je s padcem deležev glasov s 40 odstotkov izpred štirih let na 36 odstotkov dosegla najnižji rezultat v Hamburgu po drugi svetovni vojni .	najnižji	25	Def
Če je zvok izrazit , nalivamo bolj previdno , ob stenah kozarca in pod manjšim kotom .	izrazit	3	Ind
Del je sestri hvaležen , da ga je sprejela v svoje življenje , ona pa mu predlaga , naj gre na zmenek z njeno prijateljico Cecily .	hvaležen	3	Ind
Vremenski vpliv na splošno počutje in razpoloženje ljudi bo ugoden in spodbuden .	spodbuden	11	Ind
Prejšnji lastnik je sicer obvladoval svoj posel , obračanje denarja , ni pa se spoznal na smučarijo in žičničarstvo .	Prejšnji	0	Def
Odlok o preimenovanju Vipavskega Križa je že pripravljen , o njem naj bi ajdovski občinski svet odločal v četrtek	ajdovski	13	Def
Med drugim je postal nekakšen idejni program nacistične stranke , evangelij in sveto pismo za pripadnike nacionalsocialistične stranke Nemčije tretjega rajha .	idejni	5	Def
Končana je bila obnova fresk v ladji , na ostenju gotskega okna , delno pa so tudi restavrirali stranski baročni oltar sv. Marka v cerkvi na Bregu pri Žirovnici .	stranski	18	Def
Bil je zagrizen , racionalen , neveren znanstvenik , ki je dokazal , da si lahko podaljšaš življenje , če si dobra oseba .	neveren	6	Ind
LJUBLJANA , 26. - Poljski premier Jerzy Buzek je sinoči prispel na dvodnevni uradni obisk v Slovenijo .	dvodnevni	12	Def
Predvideno je , da bo mestni svet obravnaval osnutek svojega poslovnika na seji 8. julija .	mestni	5	Def
Manjkal ne bo niti tradicionalni osmi turnir za kipec sv. Florjana , ki bo v mesecu maju .	tradicionalni	4	Def
Prav zato bi bila za mnoge zmaga Valdasa Adamkusa rešilni kompromis , ki bi vladajočim konservativcem omogočil , da bi kljub porazu na predsedniških volitvah ohranili glavne zamisli svoje politike , ki jo je zastavil njihov voditelj Vitautas Landsbergis .	rešilni	9	Def
Na svet sem prišla v ljubljanski porodnišnici , vendar za svoj rojstni kraj štejem Šmartno pri Litiji , kjer živim vseh petnajst let .	rojstni	11	Def
Slednji bo na voljo šele spomladi leta 2001 , ko bo na trgu tudi različica s petimi vrati .	Slednji	0	Def
Po vsebinskih poudarkih so sicer različni , a njihova skupna značilnost je , da poskušajo strokovni gordijski vozel razmejitve presekati tako , da pripišejo narodu druge države negativne kolektivne lastnosti .	gordijski	16	Def
Ta del je bil sila splošen , tako nabit z gradivom , da smo mu komaj sledili , ampak je sprehod povezovala nikoli moteča se Tajda Lekše , ki bi bila sposobna odrecitirati na pamet cel Krst pri Savici .	splošen	5	Ind
Vse bolj pogumno pa se malo gospodarstvo razvija tudi na področju negospodarstva in prav tu je slutiti nadaljnji razvoj .	nadaljnji	17	Def
Sem namreč zdravljeni alkoholik .	zdravljeni	2	Def
Tudi bosanje v primernem potočku ali plitvejši vodi okrepi krvni obtok in segreje noge .	krvni	9	Def
Značilni vzorec trikotnih zob morskega psa je dobro viden pri posnetku , ko je sonce že nizko .	viden	8	Ind
Logičen sklep , ki sledi , je seveda to , da se v Orto baru vedno vrti kakovostna metalska in rokerska glasba .	Logičen	0	Ind
Zasnoval jo je na fragmentih znamenitega istoimenskega dela Sigmunda Freuda , ki je ob tej priložnosti tudi dočakalo prvi knjižni prevod v slovenščino pri založbi Studia humanitatis .	knjižni	19	Def
Bil je veliko bolj divji , bolj nezmeren , iz njegovega notranjega vrenja in razkrajanja pa so rasle kalne sile , nasproti katerim se je zdelo nemško ustavno življenje pravcato zdravje .	divji	4	Def
Močno žensko osebnost , ki ima zdrav , optimističen odnos do življenja , je Cankar najbolj natančno opisal v nedokončanem romanu Marta .	optimističen	8	Ind
James Powell in Gordon Danby sta leta 1966 razvila prvi uporabni prevozni sistem na podlagi magnetne levitacije , ki se ga je kmalu prijelo ime maglev .	prevozni	11	Def
Možno je tudi predrtje ulkusa ali pa zožitev prehoda iz želodca v dvanajstnik na nekaj milimetrov , ko prehod hrane skorajda ni več mogoč .	mogoč	23	Ind
To je samo preizkušnja , v katero vas je postavil moj Božji Sin .	Božji	11	Def
eee potem pa sorte chardonnay sivi pinot laški rizling renski rizling rumeni muškat kerner eee v suhih polsuhih variantah v polsladkih odvisno od blagovne znamke	sivi	5	Def
Glasovnice je v kotu kongresne dvorane štel legendarni hrvaški vratar Mirko Bašić .	hrvaški	8	Def
Sprašujem se , zakaj niste postopka izpeljali že na seji v začetku julija in bi danes že imeli nadomestnega svetnika , je dejal svetnik Branko Grims in opozoril , da je bilo za normalen postopek dovolj časa .	normalen	33	Ind
Že naslednje leto po ustanovitvi so Božakovčani postavili gasilski dom , v katerem sta bila oder in galerija , kar je takrat veljalo za velik ugled .	gasilski	8	Def
Obarvanost : Po hrbtu je modrikaste barve , spodnji del bokov in trebuh sta srebrna .	spodnji	8	Def
Popolno ljubezen ima lahko tudi tisti , ki ni krščen , ki je druge vere , če si prizadeva živeti v skladu s svojo vestjo in svojo vero ter se svojih grehov iskreno kesa .	krščen	9	Ind
Ves blaten in lačen , moker in naveličan čakanja sem bil ob srečanju s kagujem nenadoma najsrečnejši človek .	blaten	1	Ind
Danes nam to našo strategijo priznajo , je dejal koroški deželni vladar .	deželni	10	Def
Skandinavce namreč zaznamuje drugačen , svež pristop .	svež	5	Ind
Izkazalo pa se je , da je Gregor močnejši .	močnejši	8	Def
Žal pa je mnogo členov njegove vere , ki so zanj jasni kot beli dan , jaz pa jih ne morem sprejeti za zveličavne .	beli	13	Def
Prav tako izzivalna je zelo rafinirana zgodba drame , čeprav je bil to prvenec tega avtorja ; tematsko prepoznaven in sprejemljiv za današnji čas je tudi dramatikov gnev , ki je uporaben za navezavo te igre na sodobnost .	dramatikov	26	Ind
Toda samo Casanova je bil sposoben ceniti obe strani njegove osebnosti .	sposoben	5	Ind
Justin pripelje Janet v zanemarjen stanovanjski blok , kjer živi Les , ki izdeluje maske .	stanovanjski	5	Def
Selitev iz rodnega Trebnjega je bila zanj povsem neboleča , ker je prilagodljiv .	prilagodljiv	12	Ind
MARIBOR , 11. - Tukaj so imeli dvodnevni programski sestanek vodilni sindikalisti kovinsko predelovalne in elektro industrije držav Višegrajske skupine in iz bivših republik Jugoslavije , le črnogorski sindikalist je poslal samo spodbudne telegramske pozdrave .	programski	8	Def
Packard Bell je ponudil računalnik Microsoft Station , prirejen za uporabnike samo Microsoftovih programov .	prirejen	8	Ind
— Beli labod neb nikol izkoristu dame v stiski , se zareži .	Beli	1	Def
Košarkarski klub Celjski vitez je avgusta že tretje leto zapored organiziral brezplačne treninge košarke za otroke in mladino .	Celjski	2	Def
Sedaj vemo , da bo naš jutrišnji cilj streha Evrope .	jutrišnji	6	Def
Davek obračuna pristojni davčni organ v kraju sedeža oziroma stalnega prebivališča davčnega zavezanca .	davčni	3	Def
Da bi torej dokončno razjasnili stanje in ker družba v celoti vztraja pri svojem predlogu o nezakonitosti stavke in njegovi utemeljitvi , bo Comet podal pritožbo zoper izdani sklep sodišča .	izdani	27	Def
medtem ko slovenska policija o interesu preiskave še kar molči je skop z besedami tudi bodoči pravosodni minister	skop	11	Ind
Čeprav so bili kmetje pod vodstvom Zlatka Tomčića na volitvah poraženi , saj je število njihovih mandatov padlo s šestnajst na devet , si bodo lahko izborili vpliven položaj v vladi .	vpliven	27	Ind
Bil je lepo oblečen in dobre volje .	oblečen	3	Ind
Ko pa njegov motor končno » vžge « , je Vodnar svoboden , domiseln in neverjetno vzdržljiv ljubimec .	vzdržljiv	16	Ind
Projekt Literarni vlak Evropa 2000 poteka pod pokroviteljstvom Evropske komisije .	Literarni	1	Def
Te veljajo za primer , če na kateri koli narok ( pripravljalni narok ali katerega izmed narokov za glavno obravnavo ) ne prideta obe stranki .	pripravljalni	11	Def
Vendar se ne ustavljamo , kajti Lozar je po telefonu izvedel , da nas v kampu Katra v Vinici že čaka lovski golaž .	lovski	21	Def
Na splošno , če pregledamo teh 22 let , vidimo , da se je mariborski gledališki ansambl iz svojih začetnih uspehov dvigal vedno više .	mariborski	14	Def
HiQVideo ima poleg video pospeševalnika vgrajen tudi grafični pospeševalnik .	grafični	7	Def
Misel , da se Cornelia II ne ziblje več ošabno na vodi , mu je pognala prijeten , skoraj čuten drget po telesu .	čuten	19	Ind
Končina pa je še povedal , da je strokovni direktor soodgovoren za prevelik obseg obnove operacijskih miz in njihov nestrokovni izbor .	prevelik	12	Ind
Gospod predsedujoči !	predsedujoči	1	Def
Ivje , led ali tanka snežna prevleka so nove razsežnosti , ki jih okrasnim travam doda zimski čas .	zimski	16	Def
Ko to ni pomagalo , se je domislil in se sredi jahalnice ulegel kar skupaj z jezdecem , ki je seveda pravočasno odskočil , Šimeljček pa je obležal kot je bil dolg in širok ter igral mrtvega konja .	širok	33	Ind
Potem ko se je Milan Zorman upokojil , je ostal v podjetju kot dragocen strokovni svetovalec oziroma siva eminenca .	dragocen	13	Ind
Jaz sem pacifist , nisem pa naiven .	naiven	6	Ind
V kulturni tradiciji evropskih dežel lotos ni posebej trdno zakoreninjen , saj v Evropi ni samonikla rastlina .	zakoreninjen	9	Ind
General je bil namreč pošteno popacan z omako in béchamelom .	popacan	5	Ind
Zgovornejši je bil J. L. z ministrstva za notranje zadeve , ki je vodil akcijo proti ponarejevalcem , ki so v odkup - za četrtino vrednosti - ponujali tisoč ponarejenih bankovcev po sto dolarjev .	Zgovornejši	0	Def
Zgrabil sem plašč in sledil Riti Washington v hladen , gost dež .	gost	10	Ind
Ko to ni pomagalo , se je domislil in se sredi jahalnice ulegel kar skupaj z jezdecem , ki je seveda pravočasno odskočil , Šimeljček pa je obležal kot je bil dolg in širok ter igral mrtvega konja .	dolg	31	Ind
Nedavno je postal začasno brezposeln , najdlje je na enem delovnem mestu zdržal tri leta .	brezposeln	4	Ind
Bližnji vzhod je bil že v preteklosti pogosto to , kar je tudi danes .	Bližnji	0	Def
Z dostopom do izpopolnjenega modela vesolja bodo astronomi zagotovo dali dodaten zagon raziskavam vesoljskih globin .	dodaten	10	Ind
Oba sta bila lažje poškodovana , ponesrečeno žensko pa so hudo ranjeno odpeljali v ljubljanski klinični center .	klinični	15	Def
Sam dokument torej ni sporen , a žal ni več verodostojen .	Sam	0	Ind
Svojčas je bil to najhitrejši vlak na svetu , saj je pot opravil v 84 urah .	najhitrejši	4	Def
Ugotavljam , da je amandma k 246. členu , pod številko 1 , sprejet .	sprejet	13	Ind
Bil je obtežen z nahrbtnikom , v katerem je bila vsa njuna oprema , toda bil je mlad in močan .	mlad	17	Ind
Gre za edini tovrstni čebelarski muzej v Sloveniji , ki je pod zaščito Zavoda za naravo in kulturno dediščino Maribor .	čebelarski	4	Def
Podjetje Chips and Technologies pa je ponudilo 64 - bitni video in grafični krmilnik HiQVideo .	bitni	9	Def
poklicno tehnologijo so imeli praktični del to ko sem šel to sem to sem obvladal to je bilo prav dobro skoraj odlično	praktični	4	Def
Peter je bil star osemintrideset let , bil je doktor zgodovine in skorajda briljanten .	star	3	Ind
Seveda imata pri tem največ zaslug Svetovni splet in opisni jezik HTML .	opisni	9	Def
OVEN in LEV : Vročekrvni Oven najde v Levu sorodno dušo .	Vročekrvni	4	Def
Prav tako trdno je zakoreninjen v perspektivo francoske buržoazije 19. in 20. stoletja , kot je hindujska lestvica čistosti zakoreninjena v Indiji .	zakoreninjen	4	Ind
upam da kakšen od odgovornih je že zbujen in posluša	zbujen	7	Ind
Začetek izvajanja programa je odvisen od podpisa sporazuma z republiškim zavodom za zdravstveno zavarovanje , po napovedih pa bi se naj to zgodilo prihodnji mesec .	prihodnji	23	Def
Za povečanje moči pri obeh motorjih z nespremenjeno prostornino sta zaslužna drugačen dovod zraka in prenovljen motorni menedžment .	drugačen	11	Ind
Odkar pomnim , je Orto bar edini popularen kraj v Ljubljani , kjer se lahko navadni civili srečamo s tistim skromnim preostankom ortodoksnih pripadnikov preživelih subkultur .	popularen	7	Ind
Newyorški center za poučevanje kabale pa ponuja nekaj popolnoma drugega .	Newyorški	0	Def
To je med njima povzročilo hud prepir .	hud	5	Ind
Izkazalo se je , da je zdravnik ne le zmožen , ampak tudi izjemno željan prevzeti kakršnokoli delujočo metodo , ki bi bila kos krizi .	željan	14	Ind
Tudi glede vrst in strogosti kazni spadamo v srednjeevropski krog .	srednjeevropski	8	Def
Izetbegovič je bil najbolj poetičen ; ni sicer skrival znane zadržanosti do daytonskega sporazuma , za katerega je ponovno zatrdil , da je bil velik kompromis .	poetičen	4	Ind
Poznam eno , ki se je z ljubimcem večkrat zapeljala na deželo , kjer sta poiskala samoten kotiček in se ljubila na strehi avtomobila ( na srečo ni bila platnena ) .	samoten	16	Ind
Poslanci bodo drugo obravnavo tega zakona nadaljevali prihodnji torek .	prihodnji	7	Def
Takrat bo , kot smo slišali , o njej in o scenarijih uvedbe reforme pri nas ( leta 2005 , 2006 ali 2007 ) razpravljal tudi parlamentarni odbor za kmetijstvo , gozdarstvo in prehrano .	parlamentarni	26	Def
Ste v otroštvu imeli beli kruh , namazan z marmelado ?	namazan	7	Ind
Dobr je že prbasan .	prbasan	3	Ind
Ker je neuspeli predsedniški kandidat in » edini slovenski politični zapornik « Joško Joras na dan državnosti na svoji hiši spet obesil slovenski zastavo , so jo hrvaški policisti odstranili , sodniku za prekrške pa poslali kazensko ovadbo .	politični	9	Def
Drnovšek lani izsilil hitro profesionalizacijo vojske , šolski minister Gaber pa predlaga upočasnitev projekta	šolski	7	Def
Najštevilčnejši je bil prav slednji zbor , ki ga sestavlja kar 36 pevcev .	slednji	4	Def
Desetletje trajajoč boj , v katerem se je sklicujoč na svojo bolezen izognil vrnitvi v domovino , kjer je bil obtožen vsaj 60 kaznivih dejanj , pa se je minulo nedeljo vendarle končal .	trajajoč	1	Ind
Seviljski vrh Evropske unije po vsej verjetnosti ne bo zapisan v anale evropske zgodovine kot prelomen dogodek .	zapisan	9	Ind
Izvaljen zarod je dolg 7 mm .	dolg	3	Ind
Leta 1986 je vzniknila ideja o preoblikovanju muzeja iz posebnega v splošni pokrajinski muzej , ki naj bi skrbel za varstvo premične kulturne dediščine , njeno realizacijo pa je prinesla sprememba financiranja muzeja leta 1990 .	splošni	11	Def
Ujet in zvezan na stranišču starega kina .	Ujet	0	Ind
Tečaj se zaenkrat od omenjenega povprečja ni bistveno oddaljil , kar zmanjša morebiten padec pod 20.000 tolarjev .	morebiten	12	Ind
Vsi dosedanji načrti za zmanjšanje svetovne revščine so se izjalovili , kar sta pred leti priznali tudi Svetovna banka in Mednarodni denarni sklad .	Mednarodni	20	Def
Pomemben del osnovnih značilnosti je vsekakor tudi priložena programska oprema .	Pomemben	0	Ind
A zgolj ena zgrešena investicija je bila dovolj , da je mogočnežev medijski in nepremičninski imperij Qintex propadel , v pogubo pa je skupaj z njim zdrsnilo še nekaj avstralskih podjetij in bank .	mogočnežev	11	Ind
Prvi predor je bil dolg kakih osem metrov , potem pa se je nadaljeval v nekaj več ko 30 metrov dolgo in osem metrov visoko votlino .	dolg	4	Ind
Ih , svojčas sem bil goreče med njimi , zdaj za ta uporabni sistemček vsaj malo navijam .	uporabni	12	Def
Odkar je Drow opazil temni oblak , še ni uporabil mreže .	temni	4	Def
Toda slednje velja predvsem za deskarje v prostem slogu ( freestyle ) , medtem ko se je tekmovalni del , imenovan alpine , z leti razvil v pravi profesionalni cirkus , ki ne dopušča ponočevanja in popivanja .	imenovan	20	Ind
Tako prehranjevanje kot spolnost sta prišla pod strog nadzor .	strog	7	Ind
Ob koncu potovanja bodo izdali literarni potopis .	literarni	5	Def
Biolog , ki dela za ustanovo Aventis CropScience v Frankfurtu , je črnogled .	črnogled	12	Ind
Svet je za obveščevalno delo Sorgea in njegove skupine izvedel šele iz poročila , ki ga je po 2. svetovni vojni za senatni odbor v Washingtonu izdelal šef obveščevalne službe ameriškega generala McArthurja na Japonskem .	senatni	22	Def
Občina Šempeter Vrtojba je konec leta 1999 ustanovila Mednarodni tehnološki park Plejade , v katerega so julija letos kot družbeniki pristopile občine Kanal ob Soči , Brda , Bovec in Vipava .	Mednarodni	8	Def
Kot se za ekstremne športnike spodobi , je bil pogovor ekstremno kratek .	kratek	11	Ind
LJUBLJANA , 26. - Ko sta šla policista iz Most v soboto nekaj pred 14. uro mimo gostinskega lokala Sladki greh na Brodarjevem trgu , sta opazila neznanca , ki je imel za pasom na hrbtu pištolo .	Sladki	19	Def
Razpon možnosti tako ni bil širok .	širok	5	Ind
Kulturni razcvet v prvi polovici 19. stoletja je povezan s Francetom Prešernom ( 1800 - 1848 ) in njegovim krogom .	Kulturni	0	Def
MARIBOR , 14. Mladinski kulturni center Maribor ob podpori Študentske organizacije Univerze v Mariboru pripravlja danes ob 19. uri v galeriji Abruni v Mariboru galerijski literarni večer .	Mladinski	3	Def
Legendarni reporter nekdaj mariborskega dopisništva informativnega programa TV Slovenija , ki je preraslo v Televizijo Maribor , se zadnja leta lahko pohvali s obilico potopisnih reportaž , ki nam doživeto predstavljajo oddaljene ljudi in kraje .	Legendarni	0	Def
Računalnik je sicer v mini stolpu , vendar je ta nekoliko širši in odločno težji od značilnega računalnika v podobnem ohišju .	širši	11	Def
Opozarjamo , da je izračun le približen , saj dolgoletna opazovanja kažejo , da se višina ljudi spreminja po procesu " hibridizacije " .	približen	6	Ind
Potem jo je treba peljati po sicer blagi , a neravni klančini do vhoda in jasno je , da ji vsak nepotrebni tresljaj povzroča nečloveške bolečine .	nepotrebni	21	Def
Bistvo projekta standardizacije namreč je , da bi bil denar za zdravljenje v bolnišnicah razporejen tako , da bi za vso Slovenijo veljala enaka pravila ( vsaj približno ) .	razporejen	14	Ind
Film ne vsebuje dramatičnih zapletov bolj kot z zgodbo se ukvarja z zanimivimi liki in pretanjenimi podobami sveta , ki ga glavni junak ne more doumeti v prav vsej njegovi pisani lepoti .	glavni	21	Def
Vidim te v majici , ki je bela le od daleč , tako kot je čist in lep le oddaljeni spomin , kako se počasi sprehajaš z rokami na križu , po edini cesti skozi vas .	oddaljeni	19	Def
Krivec za njegovo razvrednotenje je predsednik ECB , ki po mnenju valutnih trgov ne premore kredibilnosti ameriškega kolega Alana Greenspana in je edini krivec za nizek tečaj skupne evropske valute .	nizek	25	Ind
Tudi sam trdim , da bolan človek , odvisen od alkoholne omame , nima močne volje in da z njim lahko manipulirajo njemu enaki in vsi močnejši , saj sem to okusil na lastni koži .	bolan	5	Ind
Takšna dejanja seveda ne pripeljejo dlje od govoranc , da bi moral odstopiti tudi svet RTV , kar ni nič drugega kot tipični primer pogromaštva .	tipični	22	Def
Njihovo vlado so vodili majhni fevdalni plemiči vojščaki , ki so uporabljali na novo izumljeni bojni voz s konjsko vprego .	bojni	15	Def
Črni ponarejeni Armanijev športni plašč .	Črni	0	Def
Če ni dovolj zmogljiv , se bodo pri zajemu izgubljale sličice , če bo teh veliko , pa bo tako zajet film praktično neuporaben .	zajet	20	Ind
V združenju menimo , da trenutne oblike organiziranosti niso najpomembnejši razlog za razmere , v kakršnih so se znašli gospodarski subjekti s področja prevoza stvari v cestnem prometu .	najpomembnejši	9	Def
Rečemo lahko , da so dihala teh najpreprostejših danes živečih vretenčarjev nekakšen osnoven prototip škržnega sistema , s katerim danes dihajo v vodi vse višje razvite ribe .	osnoven	12	Ind
Fotografiram čudovite prizore in v obeh prekipeva energija - sedaj ko sva srečno zapustila brenčeči kotel ozebnika .	brenčeči	14	Def
tu se je oziroma zašla v ta nariti sneg tist [gap] po tisti oziroma pred prelomnico	nariti	7	Def
množičen morilec ali eee zakrknjen storilec kakšnega hudega kaznivega dejanja ne razmišlja o kazni	zakrknjen	4	Ind
V 63. minuti pa je Vogrinčič opravil pravi slalom skozi desni del obrambe Celjanov , podal žogo na drugo vratnico , kjer je bil z glavo najvišji Romero in postavil končni izid .	najvišji	26	Def
V širši regiji so pripravili še naravoslovno razstavo iz zapuščine Maksa Kunca in rudarsko stanovanje v muzeju Podzemlje Pece v Mežici , splavarski muzej v Javorniku ter Kamnoseški in glažutarski muzej v Josipdolu na Pohorju .	Kamnoseški	27	Def
Poleg njih bodo v Belgiji igrali še domači Qutigen in ENKA Istanbul ( Turčija ) .	domači	7	Def
Zelo kratek je bil korak od te ljubke razlage naravnega pojava do tega , da so ju šteli za zavetnika umrlih in ju zato upodobili tudi na steni Priscianove grobnice v Šempetru .	kratek	1	Ind
Živi pesek gore se je pretakal kot mivka v orjaški peščeni uri .	Živi	0	Def
Morda bi bil kdo ubit , vendar bi bil izid verjetno še vedno bolj ugoden zanje .	ubit	4	Ind
ja se mi zdi tako ful tako folk zanimiv v lokalu res	zanimiv	8	Ind
Pa vendar ju ni , obstaja le subjektiven pogled .	subjektiven	7	Ind
Preden bodo s štirinožcem stopili iz hiše in se namenili v bližnji park ali na travnik , bodo morali dobiti posebno dovoljenje lokalne policije .	bližnji	11	Def
V sredozemskih deželah je zvezdni par , ki še danes nosi njuni imeni , viden ravno pol leta .	viden	14	Ind
HELSINKI , 20. Izraelski zunanji minister Šimon Peres je včeraj med obiskom v Helsinkih izrazil previden optimizem glede morebitnega vnovičnega začetka bližnjevzhodnega mirovnega procesa po odločitvi Izraela , da se postopno umakne z območja Gaze in Betlehema .	Izraelski	3	Def
Po besedah Matjaža Šinkovca , načelnika urada uniformirane policije , je vse skupaj začel Matej , ker se je vmešal v uradni postopek .	uradni	21	Def
Večino časa so bili boljši nasprotnik in v zadnji tretjini so vodili že s 4:1 .	boljši	4	Def
S pogledom sem ošinil svojega šoferja in se prepričal , da bo ostal miren in da se mi ne bo skušal približati ali pokazati , da se poznava .	miren	13	Ind
KO JE UMRLA TUDI ONA , JE VAŠKI POGREBNIK RAZKRIL NJEN PRAVI SPOL ŠOKIRANIM MOŠKIM V BARU .	PRAVI	11	Def
medtem ko pa ta razlika začne naraščati pa ta upad ni več tako izrazit neke sorte plato dobimo	izrazit	13	Ind
Ko pa njegov motor končno » vžge « , je Vodnar svoboden , domiseln in neverjetno vzdržljiv ljubimec .	domiseln	13	Ind
Uporaba RSS - vira nikakor ne pomeni , da morate na stranski tir postaviti e - pošto .	stranski	11	Def
Igralni oddelek One Toucha 557 .	Igralni	0	Def
Saj ni treba , da čakate na evropski dan brez avtomobila sredi septembra .	evropski	7	Def
Prenašajte drug drugega in odpuščajte drug drugemu , če se ima kateri kaj pritožiti proti kateremu .	drug	1	Ind
Nepredstavljiv je bil obisk restavracije brez njenega komentarja " Kako izgleda v tej kuhinji , raje ne vem !	Nepredstavljiv	0	Ind
" Tisti , ki vodijo vojno , " je zapisal neki stari zgodovinar , " se vselej učijo drug od drugega .	drug	18	Ind
V obeh primerih je treba pisati tudi delovni dnevnik , v katerem dijak sproti zapisuje novo znanje in pomembne dogodke .	delovni	7	Def
Nastal je dober kratki film .	kratki	3	Def
Prvi dan v mesecu je bil posvečen soncu , h kateremu so se obračali verniki zjutraj , opoldne in zvečer .	posvečen	6	Ind
To je prava sramota za Kranj in občino ! je bil jezen Roman iz Vodic .	jezen	11	Ind
Močnejši in srečnejši .	srečnejši	2	Def
Alverstead je bil videti šokiran , Adam Hammond pa je hitro pogledal doktorja .	šokiran	4	Ind
Zadovoljen je bil , ko je opazil , da ima pod roko njegovo aktovko in suknjič .	Zadovoljen	0	Ind
Peter Mankoč je že prvi dan postal evropski prvak na 200 mešano v kratkih bazenih .	evropski	7	Def
Najdlje sta v soncu vztrajala visok skalnat pomol na nasprotnem bregu doline in mistična gora v daljavi .	visok	5	Ind
Morfologija : Ima majhen , krepek , sploščen trup , nekoliko daljšo spodnjo čeljust , hrbtno plavut z X , 11 plavutnicami in predrepno s III , 7 plavutnicami .	krepek	5	Ind
To nastane z enostavno delitvijo , z brstiči , živicami , cepiči in je zelo pogost način razmnoževanja pri rastlinah .	pogost	15	Ind
Mlačni poletni veter se je podil po trgu in s seboj nosil mastni vonj hotdogov s sladkastim zenfom .	poletni	1	Def
Domačini so tako minuli konec tedna v zraku opazili za današnji čas nenavadna letala , na letališču Rakitnik pa so si jih lahko pobliže pogledali .	današnji	10	Def
Takratni umetniški vodja	Takratni	0	Def
Velik del te priljubljenosti je izviral iz njegove ljudskosti .	Velik	0	Ind
Če bi bili razumni , jih ne bi vselej navdajali gon po igri , volja do moči ali smrtni strah , zato bi lahko našli kompromis .	smrtni	18	Def
Gre za prvi uradni obisk poljskega premiera v Sloveniji in hkrati prvi uradni dvostranski Buzekov obisk v tujini po imenovanju poljske vlade lansko jesen .	uradni	12	Def
Evropski finančni ministri so prepričani , da ima izbrani kandidat dovolj izkušenj in sposobnosti za tako pomemben položaj .	pomemben	16	Ind
A njihovi napadi niso bili brezglavi , zmedeni in nadigrani Rusi pa so klonili že v sedmi minuti , ko je bil za njih usoden Portov dvojec Deco - Maniche .	usoden	24	Ind
To je izpostavljena škrbina v grebenu , ki jo zapira previsen in skrajno krušljiv stolp .	previsen	10	Ind
PO DOLOČITVI OCENE JE PREDVIDEN RAZGOVOR Z URADNIKOM , KJER SE URADNIKA SEZNANI Z OCENO .	PREDVIDEN	4	Ind
Njegova mati je takrat dejala , da ji je pokojni mož zapustil skrinjo , ki je bila skrita pod posteljo in v kateri je bil kup denarja .	pokojni	9	Def
Po izidu zadnje plošče Zdravo je biti divji so odigrali približno 40 koncertov po Sloveniji , Hrvaški , Jugoslaviji .	divji	7	Def
Davek obračuna pristojni davčni organ v kraju sedeža oziroma stalnega prebivališča davčnega zavezanca .	pristojni	2	Def
Bila sem ljubosumna na železni zaklopec , ki je pogoltnil Glorijina pisma .	železni	4	Def
Da bi v ljudski stranki nastala zaradi spornih finančnih poslov kakšna posebna notranja trenja , ki bi bila lahko nevarna za Podobnikov predsedniški stolček , namreč za zdaj ni pričakovati .	predsedniški	22	Def
Djordje Žebeljan , državni podsekretar za energetiko , je po sestanku razložil , da so se pogovarjali o več različicah , saj status JE Krško v prihodnjem letu še ni dokončno opredeljen .	državni	3	Def
Bilo je pred leti na sveti večer .	sveti	5	Def
Košarkarski klub Celjski vitez je avgusta že tretje leto zapored organiziral brezplačne treninge košarke za otroke in mladino .	Košarkarski	0	Def
Ko je prišel Henrik , resnično skesan , ga je pred trojnim obzidjem grofičine trdnjave pustil čakati tri dni v januarskem mrazu , čeprav je nosil samo spokorno obleko .	skesan	6	Ind
Absurdno je , da Mestni muzej Idrija , ki ga je evropska muzejska javnost leta 1998 nagradila za njegovo skrb za tehnično dediščino , nima kustosa za to področje , je povedala direktorica Ivana Leskovec .	Mestni	4	Def
Moram pa reči , da čebele zelo dobro prenašajo nizke temperature in da jim je bolj potreben svež dotok zraka kot pa pretirana toplota .	potreben	16	Ind
Kreativni del človeške zgodovine se ne dogaja brez prehodov in razvidne kontinuitete : renesančniki so še kako študirali in odkrivali antiko in niso spregledali tudi srednjeveškega izročila .	Kreativni	0	Def
V teh okvirih se ZLSD zavzema za strpen in argumentiran nastop Slovenije v pogovorih s sosedami o odprtih vprašanjih .	argumentiran	9	Ind
Jurij Marussig in člani KUD Ig so zbranim interpretirali njihovo poezijo , medtem ko so se učenci dramskega krožka OŠ Žužemberk pod vodstvom učiteljice Vide Bukovec predstavili s krajšo igro Raztrgana Višnja Gora in zakrpani Žužemberk .	zakrpani	34	Def
Še posebno pa je ta 773 metrov visok vrh obiskan eno od nedelj v mesecu marcu , ko tu pripravijo tradicionalno prireditev Pohod po nagelj .	visok	7	Ind
Njihov osnovni del , ki omogoča le navidezni zaslon , se namesti v dodaten zavihek v Display Properties , nekaj dodatnih programčkov pa dobi svoje ikone in se namesti v menu Start .	dodaten	13	Ind
Pognal se je skozi vrsto na spodnji trg .	spodnji	6	Def
Dokazila in zapisi v portfoliu vzgojitelju pomagajo , da pripravi izčrpen in zanimiv zapis o različnih področjih otrokovega razvoja , ki temelji na dokazilih v portfoliu in ki je edinstven , kakor je izjemen vsak posameznik .	edinstven	29	Ind
kar dober spodnji del je odpeljala putzerjeva vendar na koncu vendarle tri stotinke zaostanka obe italijanki na koncu zelo zelo blizu	spodnji	2	Def
Razširjenost : Razširjen je na jugu Islandije in na odprtem morju od severne Norveške do Irske , redkeje ga najdemo na severu Severnega morja .	Razširjen	2	Ind
Gre za prehode Doljani v Hercegovini , Izačić na severozahodu države in Bosanski Brod na savskem bregu .	Bosanski	12	Def
» Resnica je kot sončni žarek .	sončni	4	Def
Občina je Lipov gaj spomeniško zaščitila , saj je eden redkih primerov ohranjenih stoletnih lip v Sloveniji .	Lipov	2	Ind
Dokler se jim zdiš prpravlen delat , ti nč ne morjo .	prpravlen	4	Ind
se zelo s [gap] zato je zelo slab izkoristek a ne	slab	7	Ind
Pogosto se omenja planinski turizem .	planinski	3	Def
Ženski tek na 100 metrov z ovirami je dobila Gail Devers z odličnih 12,47 .	Ženski	0	Def
To pa bi pomenilo , da je na robu njegove zahteve , da bi bil uslišan , že svetila želja , da ne bi bil uslišan oziroma da bi ga bog zavrnil .	uslišan	15	Ind
V sirotišnici sem se naučil enostavnega , toda pomembnega pravila : v konfrontaciji sogovorniku nikar ne zapiraj izhoda , ker se bo čutil ujetega v past in bo postal nasilen .	nasilen	29	Ind
Eden izmed teh elementov je prav kontekst , ki je definiran pravzaprav kot tisti del zunajjezikovnega sveta , na katerega se nanaša vsebina jezikovnega sporočila s pomočjo referencialne funkcije jezika .	definiran	10	Ind
Oba sta bila lažje poškodovana , ponesrečeno žensko pa so hudo ranjeno odpeljali v ljubljanski klinični center .	ljubljanski	14	Def
V revni družini se je rodil deček , ki ga je že v otroških letih očaral vojaški stan .	vojaški	16	Def
A zgolj ena zgrešena investicija je bila dovolj , da je mogočnežev medijski in nepremičninski imperij Qintex propadel , v pogubo pa je skupaj z njim zdrsnilo še nekaj avstralskih podjetij in bank .	nepremičninski	14	Def
LITIJA - V Kulturnem domu v Šmartnem pri Litiji sta pripravili pianistki , študentki 3. letnika Akademije za glasbo , Veronika Hauptman in Tina Gašperšič klavirski recital .	klavirski	25	Def
Ko sem bil že šest mesecev generalni direktor , me je svet zavoda odstavil , ne da bi za to navedli en sam razlog .	generalni	6	Def
Od 1. maja letos , ko je bil sprejet nov zakon o varnosti cestnega prometa , do 22. decembra je umrlo 188 oseb , kar je za dobro četrtino manj kot v enakem obdobju lani .	sprejet	8	Ind
Teči skozi visok gost plevel je bilo , kakor da bi brodila po vodi .	gost	3	Ind
Nekdanji diktator , general Augusto Pinochet , ki se je izmuznil evropskemu pravosodju , je zdaj , kot pravijo , na začetku poti , ki ga utegne pripeljati pred sodišče v domovini .	Nekdanji	0	Def
Čeprav nas žarki sonca ne bodo mogli ogreti , bo že njegova svetloba dovolj , da bomo pozabili na sivino , ki nas čaka , in tudi pogled na svet okoli nas bo veliko lepši .	lepši	34	Def
» Varnostni sistem v notranjosti zaznava eno osebo , « je rekla Vrana .	Varnostni	1	Def
Ob tem so ročni računalniki še bogat vir informacij , s povezavo v internet ali brez nje .	bogat	6	Ind
ZAKON IMA TUDI POSEBNO POGLAVJE O POKOJNINAH URADNIKOV OZIROMA USLUŽBENCEV ; POSEBEJ PODROBNO PA JE UREJEN TUDI DISCIPLINSKI POSTOPEK .	UREJEN	15	Ind
Njen večinski lastnik je velenjska trgovska družba Era , ki v Sloveniji razmeroma uspešno konkurira velikim sistemom .	večinski	1	Def
Prepoznaven je po naprej potegnjeni maski z dvema hudomušno okroglima žarometoma , dokaj temeljitemu vetrobranskemu steklu in kratkemu zadku , ki ga zaključujeta nosilec za kovček in strešica v spodnjem delu .	Prepoznaven	0	Ind
tudi drugi napadalec izjemni david healy je imel priložnost da premaga arturja boruca toda tudi njemu to ni uspelo	izjemni	3	Def
PD Litija vabi v nedeljo na 22. spominski planinski pohod na Tisje .	spominski	7	Def
Zgodovinarji zgodnjega krščanstva opisujejo val odpovedovanja , ki je v 3. stoletju preplavil rimski imperij in vzhodno Evropo .	rimski	13	Def
Meni , da je politični islamizem nesporno realno dejstvo .	politični	4	Def
Pri zniževanju stroškov s čiščenjem moramo vsekakor upoštevati tudi čas , saj je omejen podobno kot pitna voda in ga imamo vse manj .	omejen	13	Ind
Saj veste , da imajo tablete le prehoden učinek , sami pa potrebujete nekaj , kar vas bo poživilo za dalj časa .	prehoden	7	Ind
Uporaba Podaja nivo sklada škatle in ali škatla uvede lokalen skladovni kontekst .	skladovni	10	Def
medtem ko slovenska policija o interesu preiskave še kar molči je skop z besedami tudi bodoči pravosodni minister	pravosodni	16	Def
» Frizerski salon za moške « je bil najbolj vroč kraj za jam session v severovzhodnem Washingtonu .	vroč	9	Ind
Ko se je pojavil sedmič na površju , mu je Tomo pomolil dolg ročaj solinarske greblje .	dolg	12	Ind
Na deski ga drobno narežemo ali sesekljamo , mu primešamo drobno nastrgan hren in malo olja , kislo smetano ali jogurt .	nastrgan	11	Ind
Taka narečja tvorijo narečni kontinuum in mejo med njimi praviloma določajo politični , ne jezikovni dejavniki .	narečni	3	Def
Bil je obtežen z nahrbtnikom , v katerem je bila vsa njuna oprema , toda bil je mlad in močan .	obtežen	2	Ind
takole pire je končan en dva tri dodamo mu moko najboljša je ostra in jajca	končan	3	Ind
Komajda je stala ali celo sedela , vendar mu je namenila , za kar je mislila , da je slaboten nasmeh .	slaboten	19	Ind
Toledo V5 skriva svojih 170 konjskih moči za enako zunanjostjo , kot jo imajo šibkejše različice , zato je to rjoveči bik v ovčji koži .	rjoveči	20	Def
Vsako predstavlja določen element , ki je upodobljen na oltarni plošči ; najvišja je pater .	upodobljen	7	Ind
Očitno pa se nama je vrstni red raztežajev po tolikih letih nekoliko zmedel .	vrstni	5	Def
Četrtinski ali kontrolni delež ( 25 odstotkov in ena delnica ) Telekoma Avstrija AG so namreč prodali italijanskemu kupcu Telecom Italia za 27,2 milijarde šilingov , kar je najmanj dvakrat več , kot je avstrijska pošta pričakovala ob razpisu .	kontrolni	2	Def
Po drugi strani pa lahko dokazuješ , da je kršitev človekovih pravic manj in da si zato bolj uspešen , saj se je nate obrnilo manj ljudi .	uspešen	18	Ind
Za povečanje moči pri obeh motorjih z nespremenjeno prostornino sta zaslužna drugačen dovod zraka in prenovljen motorni menedžment .	motorni	16	Def
V nedeljo ob enih sem bil dogovorjen z dekanom , zadolženim za študentke na Duku .	dogovorjen	6	Ind
eee potem pa sorte chardonnay sivi pinot laški rizling renski rizling rumeni muškat kerner eee v suhih polsuhih variantah v polsladkih odvisno od blagovne znamke	rumeni	11	Def
Izbor je tako raznolik in pisan , da bi bilo škoda balkon prepustiti jesenski vlažni sivini .	pisan	5	Ind
Bil je mirnejši , kot sem bil mislil .	mirnejši	2	Def
Stroški vračila bančnih posojil , ki jih je zavod moral najemati za izplačilo pokojnin v zadnjih mesecih minulega leta , pa bodo bremenili zavodov finančni načrt za letošnje leto .	finančni	24	Def
V sredozemskih deželah je zvezdni par , ki še danes nosi njuni imeni , viden ravno pol leta .	zvezdni	4	Def
V Cimbelinu je to vprašanje še posebej zapleteno prav do razpleta , ki je zelo presenetljiv in nov :	presenetljiv	15	Ind
Ko je prvič za steklom zagledal starkin obraz , je prestrašen odletel , vendar se je počasi navajal na njeno navzočnost .	prestrašen	10	Ind
Tudi zato s tovrstnim nasiljem ne ravnatelji ne učitelji nimajo izkušenj in ravnateljica ljubljanske šole je ravnala prav , ko se je nemudoma po pomoč obrnila na Svetovalni center za otroke , mladostnike in starše .	Svetovalni	27	Def
To je bil hkrati tudi težko pričakovan test pnevmatik za novi razred , a posebnih težav ni bilo .	pričakovan	6	Ind
Ker sam nisem zaprisežen metalec ali roker , sem bil sprva malce skeptičen , vendar sem bil že po prvem obisku prijetno presenečen .	skeptičen	12	Ind
Ni ponujal pomehkuženih , enostavnih razlag , kako biti dober .	dober	9	Ind
zato ker mestni avtobusi imajo zelo slab izkoristek	slab	6	Ind
Kot šef stranke v koaliciji bi moral nositi soodgovornost za spodrsljaje te vlade , s čimer bi si lahko pokvaril možnosti za končni cilj postati kancler .	končni	22	Def
To je izpostavljena škrbina v grebenu , ki jo zapira previsen in skrajno krušljiv stolp .	krušljiv	13	Ind
Orto klub je res postal pravi nočni klub za alternativno mainstream sceno .	nočni	6	Def
Pravilen odgovor je bil Grad Podčetrtek , nagrajenki čestitamo in ji sporočamo , da je za nagrado dobila enodnevni izlet za dve osebi po Sloveniji , ki bo predvidoma v mesecu oktobru 1996 .	Pravilen	0	Ind
ZAKON JE IZRECNO DOLOČAL , DA DRŽAVNI USLUŽBENEC NE SME BITI , KDOR JAVNO IZRAŽA NAČELA ZOPER OBSTOJEČO DRŽAVNO UREDITEV ALI SE ZAVZEMA ZA PROTIPRAVNE SPREMEMBE DRŽAVNEGA REDA .	DRŽAVNI	6	Def
ZAKONODAJA O NACIONALNIH PARKIH V ZDA JE BILA SPREJETA NA ZAČETKU PREJŠNJEGA STOLETJA , KO JE TJA PRIŠEL VEČJI VAL PRISELJENCEV , KI NISO BILI ANGLOSAKSONSKEGA POREKLA .	VEČJI	18	Def
Toda po pogovoru z Jurijem Schollmayerjem je bilo jasno , da iz tega ne bo nič , saj naj bi mu Zeleni Jurij ponudil bistveno manj .	Zeleni	21	Def
Zaradi poškodbe so nehomologirana in neocarinjena , možen je izključno samo izvoz .	možen	7	Ind
Njegov ostri , analitični razum zna razvozlati še tako zapleten problem , zato zna odlično upravljati z denarjem .	zapleten	9	Ind
V širši regiji so pripravili še naravoslovno razstavo iz zapuščine Maksa Kunca in rudarsko stanovanje v muzeju Podzemlje Pece v Mežici , splavarski muzej v Javorniku ter Kamnoseški in glažutarski muzej v Josipdolu na Pohorju .	splavarski	22	Def
Slovenski in hrvaški premier sta se v preteklih letih srečala komaj da kdaj , pa še takrat so bili nasmehi bolj vljudnostni .	Slovenski	0	Def
Imela pa so okna tudi goli videz oken na zapuščenih hišah .	goli	5	Def
V tem duhu je Urška Lunder razložila , da je " sporazumevanje vitalni del v procesu zdravljenja , vendar je največkrat blokirano " .	vitalni	12	Def
Morfologija : Ima podolgovat , jajčast , v hrbtnem delu sploščen trup , majhna usta , v niz razporejene slabotne zobce v zgornji čeljusti , skorajda brezzobo spodnjo čeljust in v nekakšno vrsto plošč sestavljene goltne zobe .	sploščen	10	Ind
Divji zahodnik stresa bajto , ko lezemo v spalne vreče in na nebu ugaša poslednja dnevna luč .	Divji	0	Def
Zmletemu mesu dodamo namočen , dobro ožet kruh , slanino , jajce , na masti prepraženo čebulo s peteršiljem in česnom ter druge začimbe in vse zelo dobro ugnetemo .	ožet	6	Ind
Njegov ostri , analitični razum zna razvozlati še tako zapleten problem , zato zna odlično upravljati z denarjem .	analitični	3	Def
Ujela sem Jasnin presenečeni in hkrati jezni pogled .	jezni	6	Def
Bil je zagrizen , racionalen , neveren znanstvenik , ki je dokazal , da si lahko podaljšaš življenje , če si dobra oseba .	zagrizen	2	Ind
Posledično ostaja manj sredstev za javni sektor .	javni	5	Def
Lani je bila v tem tekmovanju najuspešnejša Mozambičanka Maria Mutola , ki je s samimi zmagami v teku na 800 m dobila milijon ameriških dolarjev nagrade in kot prva atletinja v zgodovini sama osvojila celoten zmagoviti delež lige .	zmagoviti	35	Def
Toda odlični trener Gregg Popovich je moštvo peljal do konca .	odlični	1	Def
Hitreje in bolj zanesljivo skozi ovinke : novi variabilni zaporni sistem odpravlja večino slabosti klasične diferencialne zapore , zato nudi več voznih užitkov na različnih cestnih podlagah .	zaporni	9	Def
Za trenutek je bilo tiho , potem pa je rekel Georgeov oče :	Georgeov	10	Ind
Ste v otroštvu imeli beli kruh , namazan z marmelado ?	beli	4	Def
Ti pa so vsaj v tretjini primerov lahko zadovoljni s paracetamolom , drugi lahko dobijo bistveno varnejši nesteroidni antirevmatik od najbolj toksičnega .	nesteroidni	17	Def
Šeligov slog je zato težak , izrazito hermetičen , poln nakazanih podob in pomenov , ki jih bralec večkrat le zasluti , povsem jasno razvozlati pa jih ne more .	poln	9	Ind
a veš zjutraj ko se zbudiš imaš vse zaležano [audience:laughter] eem pač ker se ne češem eee pol čez dan se malo stabilizira je taka normalna zvečer ko si živčen je zmeraj pol taka [gap] [audience:laughter] tako da žur	živčen	29	Ind
Priključimo ga lahko na vmesnik USB , za lastnike starejših računalnikov pa je na voljo tudi vzporedni vmesnik .	vzporedni	16	Def
Profesor Osolnik iz Ljubljane , ki je bil izbran za šefa te komisije , nas je pri tem obvestil , da je Univerza v Ljubljani odobrila tri nove programe za poljski , češki in slovaški jezik .	poljski	30	Def
to lahko pomagamo da ni tako mlad ne	mlad	6	Ind
Računalnik je sicer v mini stolpu , vendar je ta nekoliko širši in odločno težji od značilnega računalnika v podobnem ohišju .	težji	14	Def
Ko je prvič za steklom zagledal starkin obraz , je prestrašen odletel , vendar se je počasi navajal na njeno navzočnost .	starkin	6	Ind
HELSINKI , 20. Izraelski zunanji minister Šimon Peres je včeraj med obiskom v Helsinkih izrazil previden optimizem glede morebitnega vnovičnega začetka bližnjevzhodnega mirovnega procesa po odločitvi Izraela , da se postopno umakne z območja Gaze in Betlehema .	previden	15	Ind
» Pozna uveljavitev zahtevane tehnične zakonodaje za majhna in srednje velika podjetja bo pomenila izgubo koristi , ki jih bo prinesel skupni evropski trg , « je poudaril vodja delegacije Evropske komisije v Sloveniji Erwan Fouere .	skupni	21	Def
Sredi osemdesetih pa je v kritiki samoupravnega podjetja razvil teorijo dinamične zmožnosti podjetja , v katere središče je postavil produkcijski faktor podjetništva .	produkcijski	19	Def
Leta 1824 so bile dokončane ikone in velik ikonostas , ki je dolg 10 metrov in visok 6 metrov .	dolg	12	Ind
Potem ko sta v polfinalu s 6:2 , 6:0 premagala belgijski par Braband , Tinck , sta bila v finalu s 6:3 , 5:7 , 7:6 boljša od avstrijske dvojice Marach , Neumueller .	belgijski	10	Def
Samo sedla je , kot sede človek , kadar prvič pride na obisk in se trudi , da ne bi bil preveč vsiljiv .	vsiljiv	22	Ind
Popuščanje v nedogled bo oslabilo slovenski narodni značaj .	narodni	6	Def
Na redni tiskovni konferenci policijske uprave Ljubljana so nam izročili fotografije policistov , ki naj bi ju bili trije fantje pred lokalom Breskvar tako močno zbrcali , da sta zaradi poškodb morala na bolniški dopust .	bolniški	33	Def
Preveden je francoski zapis tega pogovora .	Preveden	0	Ind
Prav tako izzivalna je zelo rafinirana zgodba drame , čeprav je bil to prvenec tega avtorja ; tematsko prepoznaven in sprejemljiv za današnji čas je tudi dramatikov gnev , ki je uporaben za navezavo te igre na sodobnost .	današnji	22	Def
Kot je poročal francoski gospodarski časnik Les Echos , naj bi lani s prodajo preko 270 milijonov steklenic šampanjca porušili " vse rekorde " .	francoski	3	Def
V tujini Slovenijo predstavlja predsednik republike ; za prvega je bil decembra 1992 izvoljen Milan Kučan .	izvoljen	13	Ind
ZASTAVE - Vsak predšolski otrok bi z lahkoto preštel tistih nekaj zastav , ki so ob dnevu samostojnosti visele v Črnomlju .	predšolski	3	Def
najbolj pozitiven tak del slovenije se mi zdi morje … ja širina	pozitiven	1	Ind
skratka dogajal se je eee galaktičen kanibalizem	galaktičen	5	Ind
Šele vsi ti zakoni skupaj bodo predstavljali potrebno normativno podlago za trajno tržno zasnovan gospodarski sistem .	zasnovan	13	Ind
Avtobus je bil nabito poln .	poln	4	Ind
Seveda imata pri tem največ zaslug Svetovni splet in opisni jezik HTML .	Svetovni	6	Def
Kava tudi ni za tiste , ki imajo kronično previsok tlak in težave s srcem .	previsok	9	Ind
Ves blaten in lačen , moker in naveličan čakanja sem bil ob srečanju s kagujem nenadoma najsrečnejši človek .	naveličan	7	Ind
Hkrati je osnutek zasnovan tako , da bi lahko Bush čim bolje izkoristil prednost , ki jo ima zaradi izredno uspešnega zbiranja finančne podpore , piše časnik New York Times .	zasnovan	3	Ind
Dodal je , da nikakor niso želeli ostati pri klasičnih poimenovanjih slovenskih regij , ampak so skušali najti neki simbolen pomen , ki naj bi povezoval posebnosti s posamezne turistične poti .	simbolen	19	Ind
Radi imajo razkošno zeleno obrobje mesta , prepredeno s sprehajalnimi in kolesarskimi potmi , gozdnimi učnimi potmi , v Pot spominov , ki se kot zelen prstan vije krog mesta , barje in zelena rečna obrežja .	zelen	25	Ind
Čeprav je zaostajanje za časom pogost problem naših podjetij , pa v primeru spanja na delovnih mestih temu ni tako .	pogost	5	Ind
Senate fakultet sestavljajo redni profesorji , v naziv rednega profesorja pa voli senat univerze , sestavljen iz rednih profesorjev , ki predstavljajo posamezne fakultete .	sestavljen	15	Ind
Od srca se mi je odvalil tono težak kamen .	težak	7	Ind
Dan se nagiba v zaton , ko načenjava nekoliko lažji del stene .	lažji	9	Def
Njihov osnovni del , ki omogoča le navidezni zaslon , se namesti v dodaten zavihek v Display Properties , nekaj dodatnih programčkov pa dobi svoje ikone in se namesti v menu Start .	osnovni	1	Def
Ne uživajte sladkega korena , če imate povišan krvni tlak .	krvni	8	Def
Tip učne ure naj bo izvajan moderno , ne tradicionalno .	izvajan	5	Ind
Trebuh je bil moker .	moker	3	Ind
Po prvih počitnicah se je John vrnil bled in napet .	bled	7	Ind
Tako kot je besedni red v posameznih povedih zasnovan na podlagi členitve po aktualnosti , so med seboj povezane tudi povedi v besedilu .	besedni	3	Def
Ker je neuspeli predsedniški kandidat in » edini slovenski politični zapornik « Joško Joras na dan državnosti na svoji hiši spet obesil slovenski zastavo , so jo hrvaški policisti odstranili , sodniku za prekrške pa poslali kazensko ovadbo .	neuspeli	2	Def
Daljni smoter poučevanja v skoraj 50 podružnicah po vsem svetu je izločiti škodljive vplive iz življenja in s tem nadzirati lastno življenje .	Daljni	0	Def
Šeligov slog je zato težak , izrazito hermetičen , poln nakazanih podob in pomenov , ki jih bralec večkrat le zasluti , povsem jasno razvozlati pa jih ne more .	Šeligov	0	Ind
Natakarji v sodelovanju z varnostniki ponovijo že tradicionalni obred .	tradicionalni	7	Def
Ker sam nisem zaprisežen metalec ali roker , sem bil sprva malce skeptičen , vendar sem bil že po prvem obisku prijetno presenečen .	zaprisežen	3	Ind
Povedal mi je , da je posel neverjetno dober in mi takoj gostobesedno kot prodajalci od vrat do vrat svetoval , naj za svojega prijatelja priskrbim slovenski potni list .	potni	27	Def
Z viniškega mosta , katerega ograja je pobarvana z dvema barvama , da je že od daleč očitna meja med dvema državama , nam je pomahal policist in že smo spuščali čoln čez prvi hrvaški jez v Pribanjcih .	hrvaški	34	Def
Toda slednje velja predvsem za deskarje v prostem slogu ( freestyle ) , medtem ko se je tekmovalni del , imenovan alpine , z leti razvil v pravi profesionalni cirkus , ki ne dopušča ponočevanja in popivanja .	profesionalni	28	Def
V skladu z novo filozofijo podjetja je Borland tudi JBX pripeljal iz združenega razvojnega orodja v enotno okolje , ki spremlja celoten življenjski cikel programa .	celoten	21	Ind
Izvaljen zarod je dolg 7 mm .	Izvaljen	0	Ind
film so želeli posneti že leta dva tisoč ena a je načrte prekinil teroristični napad na ameriko da ali ne ?	teroristični	13	Def
Gre za prvi uradni obisk poljskega premiera v Sloveniji in hkrati prvi uradni dvostranski Buzekov obisk v tujini po imenovanju poljske vlade lansko jesen .	dvostranski	13	Def
Meni se zdi to najzanimivejši , obetavni del pusta in pustovanja .	najzanimivejši	4	Def
B : Najpomembnejši mi je nasvet , da kljub slavi ne smeš nikoli " poleteti med oblake " .	Najpomembnejši	2	Def
Ne uživajte sladkega korena , če imate povišan krvni tlak .	povišan	7	Ind
Idi je pomolil svoj mobilni telefon .	mobilni	4	Def
— To je dobr faširan meso .	faširan	4	Ind
Tako sta minila dva dneva , nato pa je luna obsijala temno gladino oceana , kakor da je beli dan .	beli	18	Def
Glavo tiščijo v pesek in mislijo , da bodo begunci kar odšli , « kritizira državin odnos do beguncev in uradovih predlogov Šuštar .	državin	15	Ind
Ministrstvo je tudi preučilo devizni in tolarski del cene plina ( prvi znaša dobrih 89 odstotkov ) .	devizni	4	Def
v nadaljevanju pesem iz osemdesetih belinda karlyle heaven is a place on earth pa star čebelji pregovor tudi sledi	čebelji	15	Def
Darko je do konca verjel v enopartijski sistem in vse v zvezi s civilno družbo mu je šlo neznansko na živce .	enopartijski	6	Def
Včeraj se je vnovič sestal izvršni odbor Hokejske zveze Slovenije , ki naj bi razpravljal o spremembi tekmovalnega sistema za naslov državnega prvaka , potem ko so iz lige izključili ekipo Acroni Jesenic .	izvršni	5	Def
Lokalne skupnosti so namreč lahko z dodatnim projektom kandidirale za nagrado 10.000 britanskih funtov , ki je namenjena sofinanciranju točno določenega projekta , ki je vezan na upravljanje z okoljem .	vezan	25	Ind
Antropologovo vprašanje verujočemu je , zakaj bi ga lahko zmotilo spoznanje , da ima skorajda vsako ljudstvo za boga svoj lastni opis .	lastni	20	Def
Nemški zunanji minister Joschka Fischer je v javni razpravi bistvo politike preprečevanja konfliktov povzel z besedami , da je bolje preprečiti kot zdraviti , kajti vojne je pogosto lažje preprečiti kot pa prekiniti .	Nemški	0	Def
ZVZD JE NOV , VSEOBSEŽEN PRAVNI VIR SODOBNE ZAKONSKE UREDITVE VARNOSTI IN ZDRAVJA PRI DELU , KI JE NADOMESTIL DOTLEJ VELJAVNI ZAKON O VARSTVU PRI DELU IZ LETA 1974 .	NOV	2	Ind
MARIBOR , 14. Mladinski kulturni center Maribor ob podpori Študentske organizacije Univerze v Mariboru pripravlja danes ob 19. uri v galeriji Abruni v Mariboru galerijski literarni večer .	literarni	25	Def
Slovenski in hrvaški premier sta se v preteklih letih srečala komaj da kdaj , pa še takrat so bili nasmehi bolj vljudnostni .	hrvaški	2	Def
Joj , kako sem raztresen !	raztresen	4	Ind
Kljub temu je njihov menedžer na vprašanje , ali obstaja možnost , da bi čeden Slovenec lahko postal Chippendale , odgovoril , da možnosti vedno obstajajo . . .	čeden	14	Ind
Losjon Ceramide Defining Eye Brightener , ki ga nanašamo pod ličila , je primeren za vse vrste kože , ki se spopadajo s težavami staranja .	primeren	13	Ind
Stanje se odraža v statistiki ribolova , ki je postal bolj prijeten .	prijeten	11	Ind
Zmaj , kot ga poznajo na Kitajskem , je živ , prinaša rodovitnost in zdravje .	živ	9	Ind
ker je tako čuden s [gap] v soboto če bi bil v petek bi šla	čuden	3	Ind
Mlačni poletni veter se je podil po trgu in s seboj nosil mastni vonj hotdogov s sladkastim zenfom .	Mlačni	0	Def
Slišal je nejevoljen , pridušen pogovor pijanih mož .	nejevoljen	2	Ind
Avalonin glas je bil brezupno zbegan .	zbegan	5	Ind
[:voice] drugače bo pa mali mali ostal ja takole takole visok pa takole dolg	visok	10	Ind
Želela je najverjetneje , da bi bil to le blag dotik ob srečanju , toda moje dlani so se oklenile njenih gladkih lic in je niso več spustile .	blag	9	Ind
— Ma , morš izpast totalno navdušen , sam pol pa vseen zajebat .	navdušen	6	Ind
Da bi zgradil takšnega monstruma , si moral biti ali totalno pritegnjen ali pa imeti otroško dušo .	pritegnjen	11	Ind
Seviljski vrh Evropske unije po vsej verjetnosti ne bo zapisan v anale evropske zgodovine kot prelomen dogodek .	prelomen	15	Ind
Razvoj je ključen element konkurenčnosti farmacevtske industrije .	ključen	2	Ind
Na tretji tekmi sezone za poletni Grand prix v Courchevelu se je naš obetavni smučarski skakalec kot tretji drugič v svoji karieri povzpel na posamične zmagovalne stopničke .	poletni	5	Def
“ Osrednji del naše nove pridobitve je 15 metrov visok stolp , s katerega smo za začetek speljali šest toboganov .	visok	9	Ind
Veliki brat je pozabljen , na sceno stopa Veliki želodec .	pozabljen	3	Ind
Fannyjin obraz je žarel v mrazu poleg Frankove rdečezlate barve .	Fannyjin	0	Ind
ampak nič zmatran drugi dan	zmatran	2	Ind
če eee [:voice] nam nemški avtomobilski proizvajalec zmanjša proizvodnjo za četrtino in če so na tega proizvajalca vezani naši proizvajalci potem eee nobeno zniževanje stroškov pravzaprav tukaj kaj dosti ne pomaga	avtomobilski	5	Def
Ker ima vsako svojo zgodbo o stvarjenju , lastno zgodovino božjega posega , svoje predstave o tem , kaj šteje za greh , je bog skozi prizmo verskih doktrin razcepljen v nešteto refrakcij .	razcepljen	29	Ind
Končina pa je še povedal , da je strokovni direktor soodgovoren za prevelik obseg obnove operacijskih miz in njihov nestrokovni izbor .	nestrokovni	19	Def
Videti je bil oddaljen več deset lijev , a je že bilo čutiti naraščanje vetra .	oddaljen	3	Ind
Ko bi nekdo potem na spletnem mestu zahteval abecedni seznam , bi dobil samodejno generiran seznam , ki bil tako ažuren , kot je zbirka podatkov .	generiran	14	Ind
A ob pogledu na stanovanje , ki jo je tako zelo spominjalo na njen nekdanji dom , je deklico razumela .	nekdanji	14	Def
Medtem ko je Jereb popoldne dvignil tempo , je bil na drugi strani Logar vse počasnejši , a je vseeno ostal na drugem mestu v skupni razvrstitvi .	počasnejši	15	Def
Čebelarski muzej v Gornjem Krapju je torej star sto let in je vreden ogleda .	star	7	Ind
Dokazila in zapisi v portfoliu vzgojitelju pomagajo , da pripravi izčrpen in zanimiv zapis o različnih področjih otrokovega razvoja , ki temelji na dokazilih v portfoliu in ki je edinstven , kakor je izjemen vsak posameznik .	izjemen	33	Ind
Dokazila in zapisi v portfoliu vzgojitelju pomagajo , da pripravi izčrpen in zanimiv zapis o različnih področjih otrokovega razvoja , ki temelji na dokazilih v portfoliu in ki je edinstven , kakor je izjemen vsak posameznik .	zanimiv	12	Ind
V bistvu gre za sistem Stanislavskega , prilagojen moderni senzibilnosti .	prilagojen	7	Ind
Chaiken je jasno povedal , da je bil Pete Conrad morda najbolj šegav in sproščen od vseh Apollovih astronavtov .	šegav	12	Ind
Ukrajinci so neugoden nasprotnik , a glede na vse težave s poškodbami in igralskimi spremembami v reprezentanci je za nas neugoden prav vsak nasprotnik .	neugoden	2	Ind
je sicer centralni branilec	centralni	2	Def
Ni se spomnil , kdaj se je nazadnje počutil tako odlično , tako poln upanja in tako optimistično .	poln	13	Ind
Za odpravo teh težav bomo v okviru zborničnih strokovnih služb in izvršilnega odbora Sekcije za cestni tovorni promet pripravili celovito analizo pogojev poslovanja in predlogov za odpravo nevzdržnih razmer na področju cestnega prevozništva .	cestni	15	Def
torej kaj kaj je bil končni rezultat njihovega bivanja ? smrt	končni	5	Def
To je sicer popolnoma očitno , a pri iskanju živali lahko prehitro pozabimo na cesto in si uničimo prelep dan v naravi s prometno nesrečo .	prelep	18	Ind
Njegov ostri , analitični razum zna razvozlati še tako zapleten problem , zato zna odlično upravljati z denarjem .	ostri	1	Def
Zdi se , da ta razpoloženjski moment ni mogel zgrešiti niti samega diktatorja .	razpoloženjski	5	Def
Saj je bila postavljena tam , kjer se gozdovi zakraselih Gorjancev in odljudnega močvirnega gozda Krakovo najbolj približajo in je negozdni pas med njima bil pogosto na udaru poplav reke Krke .	negozdni	20	Def
Bil redek genij , Jekyll in Hyde .	redek	1	Ind
Ruski narod naj bi bil nositelj odrešenja za vse Slovane in človeštvo .	Ruski	0	Def
A trg razvojnih orodij za javo je brutalen .	brutalen	7	Ind
Najdlje sta v soncu vztrajala visok skalnat pomol na nasprotnem bregu doline in mistična gora v daljavi .	skalnat	6	Ind
Za povečanje moči pri obeh motorjih z nespremenjeno prostornino sta zaslužna drugačen dovod zraka in prenovljen motorni menedžment .	prenovljen	15	Ind
Mnoge ženske , ki so prej imele bolj nereden ciklus , ugotavljajo , da po rojstvu prvega otroka menstruacija postane bolj redna in enakomerna .	nereden	8	Ind
eee potem pa sorte chardonnay sivi pinot laški rizling renski rizling rumeni muškat kerner eee v suhih polsuhih variantah v polsladkih odvisno od blagovne znamke	laški	7	Def
Končina pa je še povedal , da je strokovni direktor soodgovoren za prevelik obseg obnove operacijskih miz in njihov nestrokovni izbor .	soodgovoren	10	Ind
Od tedaj dalje je tako imenovani " svetilni plin " začel razsvetljevati 1300 cestnih svetilk .	svetilni	7	Def
Preveden je francoski zapis tega pogovora .	francoski	2	Def
slika tudi jasno kaže da je ta upad aktivacijske bariere najbolj izrazit kadar razlika med rotacijsko temperaturo in translacijsko temperaturo ni tako zelo velika	izrazit	11	Ind
Literarni vlak Evropa 2000 bo prepotoval Portugalsko , Španijo , Francijo , Belgijo , Nemčijo , Poljsko , Litvo , Latvijo , Estonijo , Rusijo in Belorusijo .	Literarni	0	Def
James Powell in Gordon Danby sta leta 1966 razvila prvi uporabni prevozni sistem na podlagi magnetne levitacije , ki se ga je kmalu prijelo ime maglev .	uporabni	10	Def
Vladimir Stepania , gruzijski košarkar s slovenskim potnim listom , je za Miami igral sedem minut , v tem času pa dosegel štiri točke .	gruzijski	3	Def
V ponvici raztopite maslo , primešajte sesekljan česen in timijan ter mešanico potresite čez krompirjeve rezine .	sesekljan	6	Ind
Napad na slovensko svobodo izbire pa je v primeru tokratnega štetja lahko tudi premalo premišljen .	premišljen	14	Ind
Ker je grozila nevarnost , da bodo postali plen zbirateljev in preprodajalcev , so jih preselili v manjši živalski vrt .	živalski	18	Def
Konec februarja je KZS skupaj s klubom Kreativ iz Murske Sobote v Prekmurju organizirala mednarodni turnir za kadetske reprezentance , kjer so bili najboljši slovenski 16 - letniki zelo uspešni .	mednarodni	14	Def
Vendar je bil glede prvenstva v golfu ravno na predlog LDS sprejet sklep , da se tekmovanja udeleži samo dvojica iz Slovenije in da se za izbor naredi izbirno tekmovanje .	sprejet	11	Ind
Dejaven čustven odnos do vira strahu - napadalnost pa je takšna - vsaj deloma zaduši strah oziroma ga potisne iz naše zavesti .	Dejaven	0	Ind
Za delovno mesto stažista je moral izpolnjevati dva pogoja : ni smel biti prestar in imeti je moral univerzitetno diplomo .	prestar	13	Ind
Toda Grudnov strah pred trajno zvezo z Marijo je močnejši od njegove vesti .	močnejši	9	Def
[:voice] drugače bo pa mali mali ostal ja takole takole visok pa takole dolg	mali	5	Def
no vidi se da truda je veliko na na vsak način si želi seveda zelo zelo dober rezultat ampak mislim da je	dober	16	Ind
Tudi sicer je slog » Veronike Deseniške « bogat z metaforami , ki nenehoma in neopazno prehajajo v simbole .	bogat	8	Ind
Delovni vizum je torej v bistvu dovoljenje za prebivanje tujca zaradi zaposlitve in se praviloma izdaja za čas veljavnosti delovnega dovoljenja .	Delovni	0	Def
Njun razhod je bil grši , kot je pričakovala .	grši	4	Def
Na podlagi teh in drugih proučevanih podatkov je hrvaški Jadran uvrščen med prednostna področja za proučevanje in zaščito glavatih želv v okviru načrta zaščite morskih želv Mediterana organizacije UNEP .	hrvaški	8	Def
Sta že vse pozabla , kako je ta pizda domov polcaje prvleku večkrat koker jaz ; jaz sem bil vsej tolk kulturen , da sem po svojmu lastnmu pragu sral .	kulturen	21	Ind
Zanimal jo je naturalizacijski princip , po katerem deluje institucija kot socialna organizacija .	naturalizacijski	3	Def
HiQVideo ima poleg video pospeševalnika vgrajen tudi grafični pospeševalnik .	vgrajen	5	Ind
Kljub posodabljanju blejskih hotelov raste zanimanje tujih gostov za penzionski turizem	penzionski	9	Def
Menil sem , da ni hotel režirati na Odru 57 , ker je bil takrat ideološko sumljiv teater .	sumljiv	16	Ind
Izdelava sira je kompleksen proces , sestavljen iz mnogo korakov , ki jim moramo slediti točno po vnaprej predpisanem vrstnem redu .	kompleksen	3	Ind
Lep prosto preplezljiv raztežaj privede prav na raz .	preplezljiv	2	Ind
Profesor Osolnik iz Ljubljane , ki je bil izbran za šefa te komisije , nas je pri tem obvestil , da je Univerza v Ljubljani odobrila tri nove programe za poljski , češki in slovaški jezik .	izbran	8	Ind
Italijanski premier Silvio Berlusconi je konec tedna podpisal ustrezen sklep , s katerim je organizacijskemu komiteju zimskih olimpijskih iger v Torinu za izvedbo iger 2006 ( 10. - 26. februarja ) namenil 159 milijonov evrov .	ustrezen	8	Ind
V njem je jasno zapisano , da če obstaja utemeljen sum , da je bil storjen prekršek , potem računsko sodišče predlaga uvedbo postopka zaradi prekrška .	utemeljen	9	Ind
V njej je Akademski pevski zbor 12. decembra 1941 zaključil provokativni koncert s pesmijo Lipa in se z njo zavil v kulturni molk .	provokativni	10	Def
Tačas boš podrejen generalu , ki ima na skrbi vojaške priprave .	podrejen	2	Ind
ki pol je bil kontent ki je šla proč [speaker:laughter]	kontent	4	Ind
Oče je bil še zelo mlad , oblečen v pulover in suknjič iz tvida .	oblečen	7	Ind
ČE POGODBO O ZAPOSLITVI ODPOVEDUJE DELAVEC , JE MINIMALNI ODPOVEDNI ROK 30 DNI .	MINIMALNI	8	Def
Hkrati sodeluje tudi z mnogimi podjetji kot svetovalec pri razvoju novih tehnik menedžmenta , ki predvidevajo srečne in zadovoljne uslužbence kot glavni razlog za uspešno in dobičkonosno poslovanje .	glavni	21	Def
Kralj , presenečen in ganjen zaradi tega nepričakovanega predloga in Veronikine velikodušne pripravljenosti , da poskusi tudi problematično poslanstvo in da se odpove lastnim apostolskim nalogam v Združenih državah in drugod , je ponudbo hvaležno sprejel .	ganjen	4	Ind
Lani sta pred začetkom sezone Argentinec Emanuel Ginobili in Francoz Tony Parker delovala preveč golobrado , da bi lahko skupaj s sijajnim vodjo Timom Duncanom in veteranom Davidom Robinsonom osvojila šampionski prstan .	šampionski	30	Def
Morfologija : Ima majhen , krepek , sploščen trup , nekoliko daljšo spodnjo čeljust , hrbtno plavut z X , 11 plavutnicami in predrepno s III , 7 plavutnicami .	sploščen	7	Ind
Slovar je narejen po virih ene najboljših slovarskih založb Oxford University Press , njegova gesla vsebujejo med drugim tudi primere tipične uporabe besede in slovnične posebnosti .	narejen	2	Ind
NOVO MESTO - Planinsko društvo Novo mesto vabi planince na zimski vzpon na Veliki Javornik ( 1023 m ) , ki bo v soboto , 4. februarja .	zimski	10	Def
O uničujočem požaru , ki je 17. julija 2003 popolnoma uničil svečarski objekt Milene Kostanjevec iz Stojnc , smo v Obrtniku že pisali .	svečarski	11	Def
Za večino od nas je to materni jezik naučili smo se ga v zgodnjem otroštvu v domačem okolju .	materni	6	Def
Ko bi nekdo potem na spletnem mestu zahteval abecedni seznam , bi dobil samodejno generiran seznam , ki bil tako ažuren , kot je zbirka podatkov .	abecedni	8	Def
Hvalimo se , da gre za mednarodni vrtec , šolo , maturo , in s tem ni nič narobe .	mednarodni	6	Def
Velikanski zabaviščni prostor je ograjen in mrki redarji preverjajo vsak nahrbtnik posebej .	Velikanski	0	Def
Njegov zadržani in rahločutni slog je bil v popolnem nasprotju s tedanjimi smernicami .	zadržani	1	Def
Ubogljivi in od vodilne stranke poslušni minister Jelko Kacin je s svojo operativno udarno enoto ( šest oboroženih pripadnikov Voma ) opravil še zadnje kadrovske zamenjave in prerazporeditve in tako brigadi zadal še zadnji smrtni udarec .	smrtni	34	Def
avtor ni znan	znan	2	Ind
Zmešajte skupaj napojen kruh , nasekljano polenovko , nasekljano čebulico in jajce , da nastane gosta zmes .	napojen	2	Ind
Mnogi si miren nočni spanec omogočijo s kemijo : leta 1998 je bilo v Avstriji izdanih 1,3 milijona receptov za uspavalne in pomirjevalne tablete .	miren	2	Ind
Zdi se mu , da se samo zaradi svoje pretankovestne narave bojim , da dobivam več kot svoj pravični delež ; in da v resnici nimam niti pol toliko , kakor bi moral imeti .	pravični	18	Def
Način , kako ga je Lavtižarjeva prekinila , je nedopusten in pomeni kršenje ustaljenih pravil parlamentarnega odločanja , so zapisali .	nedopusten	9	Ind
PD Litija vabi v nedeljo na 22. spominski planinski pohod na Tisje .	planinski	8	Def
Ko se bo preselil v svojo sobo , naj ostali dnevni ritem ostane nespremenjen .	nespremenjen	13	Ind
Harrisonov prijatelj Michael Palin iz ekipe Leteči cirkus Montyja Pytona mu je nekoč namreč potožil , da mu je zmanjkalo denarja za film The Life of Brian .	Leteči	6	Def
Prodajalci nafte iz drugih držav pa imajo na voljo mejne prehode Bosanska Gradiška in Orašje ob Savi , Izačić pri Bihaču in Crveni grm nad Pločami v Hercegovini .	Crveni	22	Def
Gre za prvi uradni obisk poljskega premiera v Sloveniji in hkrati prvi uradni dvostranski Buzekov obisk v tujini po imenovanju poljske vlade lansko jesen .	Buzekov	14	Ind
Bo se je prestrašen skrival za Moscovim hrbtom , ko je zagledal Prosperja .	prestrašen	3	Ind
Povprečen naklon v 16 kilometrih je le okoli 6 odstotkov .	Povprečen	0	Ind
Program je primeren predvsem za večje organizacije , kjer je v navezi s programom Symantec Enterprise Security Manager odličen par , saj slednji skrbi , da se vsi člani omrežja držijo iste varnostne politike oz. predpisov .	primeren	2	Ind
Oče je bil še zelo mlad , oblečen v pulover in suknjič iz tvida .	mlad	5	Ind
Kot bi ruj želel , da ga ne pozabimo do prihodnje pomladi , ko bo zopet lep , lepši , najlepši .	lepši	18	Def
Dnevni promet je na račun večjih svežnjev z republiškimi obveznicami presegel milijardo tolarjev , vendar je realni promet pod povprečjem .	realni	16	Def
Djordje Žebeljan , državni podsekretar za energetiko , je po sestanku razložil , da so se pogovarjali o več različicah , saj status JE Krško v prihodnjem letu še ni dokončno opredeljen .	opredeljen	31	Ind
Muzej je postavljen v avtentično okolje jaška Škale , kjer se je premogovništvo v Šaleški dolini tudi začelo .	postavljen	2	Ind
no dobro midve eee se pravi mmm predvidoma je cilj je delujoč	delujoč	11	Ind
torej volilni molk tega v združenih državah ne poznajo	volilni	1	Def
Ves blaten in lačen , moker in naveličan čakanja sem bil ob srečanju s kagujem nenadoma najsrečnejši človek .	najsrečnejši	16	Def
Sanjal je , da bo postal slaven , da ga bodo drugi občudovali .	slaven	6	Ind
Gre za edini tovrstni čebelarski muzej v Sloveniji , ki je pod zaščito Zavoda za naravo in kulturno dediščino Maribor .	tovrstni	3	Def
Prosper mu jo je prestrašen vzel iz roke in ga zvlekel iz gneče pod temno arkado .	prestrašen	4	Ind
Na posvetu vrha stranke si niso bili edini , ali je v resnici vseskozi pošten ali pa je tako zelo pokvarjen , da tega ne more nihče odkriti , so se spraševali .	pokvarjen	20	Ind
Ob 17. uri bo koncert tamburaške skupine Dobreč iz Dragatuša in črnomaljske godbe na pihala , ob 20. uri pa bo belokranjske izseljence nagovoril črnomaljski župan Andrej Fabjan .	črnomaljski	24	Def
Čeprav je opteron » zapakiran « v kompaktno , zaščiteno ohišje manjših dimenzij kot njegov predhodnik , uporablja za komunikacijo z okolico kar 940 pinov ( vmesnik socket 940 ) .	zapakiran	4	Ind
Premiera sta imela na letališču krajši pogovor , vnovič pa se bosta srečala danes , ko bosta Buzeka sprejela tudi predsednik države Milan Kučan in predsednik državnega zbora Janez Podobnik .	krajši	5	Def
Mednarodni PEN se je tako aktivno vključil v mirovna gibanja tistega časa in opravil svojo dolžnost .	Mednarodni	0	Def
medtem ko slovenska policija o interesu preiskave še kar molči je skop z besedami tudi bodoči pravosodni minister	bodoči	15	Def
Opazila sem , da se Kitijin pogled večkrat ustavi na meni .	Kitijin	5	Ind
S takšno splošnostjo se nisem strinjal in sem povedal , da je zaskrbljen sleherni vietnamski ribič ali slovenski kmet , pisatelji pa moramo narediti več .	zaskrbljen	12	Ind
To je glavni del skupine , zraven pa spada še deset plesalk .	glavni	2	Def
Stroški vračila bančnih posojil , ki jih je zavod moral najemati za izplačilo pokojnin v zadnjih mesecih minulega leta , pa bodo bremenili zavodov finančni načrt za letošnje leto .	zavodov	23	Ind
Sicer pa naj bi vsaj v začetku DURS vračala preveč plačani davek v roku 30 do 90 dni , saj sicer obstaja nevarnost , da bi se proračun " likvidnostno zlomil " .	plačani	10	Def
Za že ustanovljene avtošole sicer še velja dveletni prehodni rok , v katerem morajo uskladiti svoje delovanje z novim zakonom , za tiste , ki nastajajo v teh dneh , pa je novi zakon že obvezujoč .	prehodni	8	Def
Odbor je temeljito proučil navedeni predlog zakona in soglasno podprl , da se tak predlog zakona uvrsti na dnevni red te seje Državnega zbora .	dnevni	18	Def
Prazgodovinski strip v naših najpomembnejših dokumentih na žalost ni ravno doprinos k identiteti sodobne Slovenije , izpričuje bolj otroško dobo slovenske državnosti ( in nekaterih državnikov ) .	Prazgodovinski	0	Def
Te spremembe nastanejo zaradi skoraj nepredušno pokrite kože z debelo plastjo plenice , zaradi česar je ta predel topel in vlažen .	vlažen	20	Ind
Iščemo potrebni standardni odklon procesa , da bo zagotovljena zahtevana sposobnost procesa .	potrebni	1	Def
Podobno je ravnal prejšnji goriški župan Gaetano Valenti , ki je priznaval avtohtono prisotnost Slovencev le v šandreškem predmestju .	goriški	4	Def
Vas ni prav nič strah , da ne bi v Atene prišli optimalno pripravljeni ?	pripravljeni	13	Def
Slovenski komorni zbor in Zbor Consortium musicum .	komorni	1	Def
Celjski župan Bojan Šrot je iz Kanade sporočil , da je bil skupaj z drugimi predstavniki občine obeh nagrad zelo vesel .	vesel	20	Ind
Hrvaški predsednik je konec lanskega leta umrl , novi predsednik je postal Stipe Mesić .	Hrvaški	0	Def
Autosport poroča , da je posel sklenjen , čaka se le še na uradno potrditev , ki naj bi prišla v naslednjih dneh .	sklenjen	6	Ind
Velja za najmanjši hotel na svetu in je vpisan v Guinnessovo knjigo rekordov .	vpisan	8	Ind
Danes nam to našo strategijo priznajo , je dejal koroški deželni vladar .	koroški	9	Def
V torek zvečer bodo na dvorišču knežjega dvorca spektakularno odprli letošnji celjski poletni festival	poletni	12	Def
trenutek pomnim dragoceni pred mano blisnila si ti kakor lepote čisti genij privid ki nagloma mini	čisti	10	Def
Sam dokument torej ni sporen , a žal ni več verodostojen .	sporen	4	Ind
Zelo dobra igra domačih v obrambi je goste silila k številnim napakam , šele v 32. minuti je najaktivnejši Koprčan Ipavec prišel do strela z roba kazenskega prostora .	najaktivnejši	18	Def
Čeprav je treba pri razpisu upoštevati določene zakonske predpise , je ta še vedno lahko ustvarjalen , menita Mumel in Leber .	ustvarjalen	15	Ind
Ko se bo preselil v svojo sobo , naj ostali dnevni ritem ostane nespremenjen .	dnevni	10	Def
trenutek pomnim dragoceni pred mano blisnila si ti kakor lepote čisti genij privid ki nagloma mini	dragoceni	2	Def
Zdel se je sveže oprhan .	oprhan	4	Ind
Predlagani proračun za leto 2002 znaša 2,412 milijarde tolarjev , zadolžiti pa se nameravajo za 94 milijonov tolarjev	Predlagani	0	Def
Njihovo vlado so vodili majhni fevdalni plemiči vojščaki , ki so uporabljali na novo izumljeni bojni voz s konjsko vprego .	izumljeni	14	Def
Državni zbor mora neskladnost odpraviti v letu dni po objavi odločbe v Uradnem listu .	Državni	0	Def
Četrtinski ali kontrolni delež ( 25 odstotkov in ena delnica ) Telekoma Avstrija AG so namreč prodali italijanskemu kupcu Telecom Italia za 27,2 milijarde šilingov , kar je najmanj dvakrat več , kot je avstrijska pošta pričakovala ob razpisu .	Četrtinski	0	Def
Pripadam generaciji , ki ji je socialen čut zelo pomemben , tako sem bil vzgojen .	socialen	6	Ind
tako kot sem mu naročil tako je treba to narediti eee sem mu vse lepo povedal in razložil eee sem pa glih malo razočaran z vašo volno	razočaran	23	Ind
Gre za paviljonski čebelnjak s panji tipa neiseer , ki jih čebelarji že dolgo ne poznajo .	paviljonski	2	Def
Vzemimo za primer piranski občinski svet , čeravno je verjetno zelo podobno povsod drugod .	piranski	3	Def
Današnji tempo stvari spreminja vsak mesec , vprašanje pa je , kdaj se splača obnoviti knjižno obliko in ali je perioda petih let za to prekratka .	Današnji	0	Def
Prvi višek rokometnega dneva v Rdeči dvorani bo ob 14.30 , ko se bosta pomerili ženska reprezentanca Slovenije in selekcija tujk , ki si rokometni kruh služijo na sončni strani Alp .	rokometni	24	Def
Joao Costa pa je deseti finalni strel poslal v sosedovo tarčo , v tarčo vodilnega Rusa Vladimirja Gončarova .	finalni	5	Def
Bil sem presenečen , da ponuja slovenske papirje , saj sem vedel , da je hrvaški policist .	hrvaški	15	Def
Ta članek je Alexandra Stiglmeyer hotela uporabiti za začetek svoje antologije o posilstvih kot nekakšen tematski uvod .	tematski	15	Def
Devetindvajsetletni Matevž Hribernik je v Bruslju preživel pet mesecev kot stažist na generalnem direktoratu za zaposlovanje in socialne zadeve .	Devetindvajsetletni	0	Def
Postal sem periodični pivec .	periodični	2	Def
Spodrsljaj župana in njegove ekipe je podkrepil tudi hiter telefonski stik s predsednico občinske volilne komisije sodnico Marjeto Dvornik .	hiter	8	Ind
Iz dobro obveščenih virov smo izvedeli , da naj bi plačilo bilo izvršeno v bananah , kar pomeni , da bo Slovenija za vsak kubični kilometer neba dobila gajbo banan .	kubični	24	Def
" Napredek je očiten .	očiten	3	Ind
Predvsem moramo ugotoviti , da je termin kontekst znotraj same znanosti o jeziku večznačen , tudi ko ga pojmujemo kot sklop konkretnih okoliščin , v katerih se odvija jezikovna dejavnost .	večznačen	13	Ind
ja … no saj zato pa uvod ka ima kazalo ima ne eee miselni vzorec ka je n [gap] eee notri	miselni	13	Def
Mlačni poletni veter se je podil po trgu in s seboj nosil mastni vonj hotdogov s sladkastim zenfom .	mastni	12	Def
Koksibi te ne zaščitijo , če imaš težave z ledvicami , ki jih imajo številni bolniki , dvigujejo krvni tlak .	krvni	18	Def
Matija : Sam najraje pomagam in zato po kosilu Matija pomiva posodo .	Sam	2	Ind
Pripravite se , da boste dali kakšen poučen nasvet .	poučen	7	Ind
Lastnik Franc P. je oškodovan za kakšne tri milijone tolarjev , celjski kriminalisti pa vzrok požara še ugotavljajo .	oškodovan	4	Ind
Čeprav nam ga ni uspelo priklicati , smo izvedeli , zakaj je bil ob zadnjem snidenju s sedmo silo v četrtek , ko so se začele priprave Olimpije , tako zelo nezadovoljen .	nezadovoljen	31	Ind
Splošen skrivnopisni sestav sestavljata dva ključa in postopka .	Splošen	0	Ind
DELAVKINA ODSOTNOST Z DELA V TEM ČASU SE ZATO NE MORE ŠTETI KOT NEOPRAVIČENA IN PROTI NJEJ NE MORE BITI IZREČEN DISCIPLINSKI UKREP PRENEHANJA DELOVNEGA RAZMERJA	IZREČEN	20	Ind
Po bokih je srebrnkast , trebuh pa je bronaste ali temno rumenkaste barve .	srebrnkast	3	Ind
Pri delu uporablja Zoom Video Port , ki omogoča neposreden video prenos , brez obremenitve procesorja .	neposreden	9	Ind
SICER NAČITANI INŠPEKTOR MORA POGLEDATI V DEBELE SLOVARJE , DA NAJDE RAZLAGO BESEDE EONIZEM , KI JO JE LETA 1928 VPELJAL SEKSOLOG HAVELOCK ELLIS V KNJIGI ŠTUDIJE O PSIHOLOGIJI SPOLNOSTI , EONIZMU IN DRUGE ŠTUDIJE .	NAČITANI	1	Def
Razburjeni Rus je z dodatnim strelom zadel le 8,6 kroga in moral zlato kolajno prepustiti rojaku Mihailu Nestruevu .	Razburjeni	0	Def
Na tretji tekmi sezone za poletni Grand prix v Courchevelu se je naš obetavni smučarski skakalec kot tretji drugič v svoji karieri povzpel na posamične zmagovalne stopničke .	smučarski	14	Def
Na naše vprašanje , kdo bo plačal dogovorjeni znesek , je zatrdila , da ima GR , katerega večinska lastnica je mestna občina Ljubljana , dovolj denarja za to .	dogovorjeni	7	Def
Glas Haberlove stopi na opustošeno obalo , v opustošeni svet , razsrediščen , shizofren in absolutno razbolen .	razsrediščen	11	Ind
1676 Danski astronom Ole Romer ( 16441710 ) odkrije , da svetloba potuje s stalno hitrostjo .	Danski	1	Def
Še posebno pa je ta 773 metrov visok vrh obiskan eno od nedelj v mesecu marcu , ko tu pripravijo tradicionalno prireditev Pohod po nagelj .	obiskan	9	Ind
Pivovarna Laško je ugotovila , da multinacionalne družbe z nakupom podjetja dobijo tudi lokalni tržni delež , zato je skušala braniti svoj položaj doma in postati sama prevzemnik z nakupom Unionovih delnic .	tržni	14	Def
Ne moremo vedeti , koliko je Cankar v Maksu videl sebe , vendar ni dvoma , da mu je bil mladeničev beg pred spolno ljubeznijo zoprn .	zoprn	25	Ind
Vprašanje je , koliko časa bo Borland še lahko za najzmogljivejši različico JBX zahteval toliko denarja .	najzmogljivejši	10	Def
Sicer pa je njegov delovnik naporen .	naporen	5	Ind
Dvojčki imajo namreč drugačen odnos do vedenja drugih ljudi , kot ga imajo do lastnega .	drugačen	3	Ind
Črni ponarejeni Armanijev športni plašč .	ponarejeni	1	Def
Tudi temu je dal de Terzi na izbiro , ali bo dve leti plačeval vojaka , ki bo stražil pazinski grad , ali pa bo šel za štiri leta v ječo .	pazinski	19	Def
So pa tudi nekoliko drugačni pogledi na možni razvoj dogodkov na stanovanjskem trgu .	možni	7	Def
Končina pa je še povedal , da je strokovni direktor soodgovoren za prevelik obseg obnove operacijskih miz in njihov nestrokovni izbor .	strokovni	8	Def
Za odpravo teh težav bomo v okviru zborničnih strokovnih služb in izvršilnega odbora Sekcije za cestni tovorni promet pripravili celovito analizo pogojev poslovanja in predlogov za odpravo nevzdržnih razmer na področju cestnega prevozništva .	tovorni	16	Def
Hotel sem , da bi deklica videla in vedela , da sem v tem kinu zares domač .	domač	16	Ind
DELOVNE IN STROKOVNE KVALITETE URADNIKOV OCENI NADREJENI ENKRAT LETNO .	NADREJENI	6	Def
Bil je še bolj vznemirjen , kot če bi bil priča pri umestitvi beneškega doža .	vznemirjen	4	Ind
DELOVNI ČAS PRI OPRAVLJANJU DELA NA DOMU SE LAHKO DOLOČI NA PODLAGI VNAPREJ OPREDELJENE KOLIČINE DELA NA ČASOVNO ENOTO .	DELOVNI	0	Def
Šesta stopnja HELIODROMUS ( sončni tekač ) je pod zaščito Sonca .	sončni	4	Def
Ponavadi je najvažnejši dejavnik čas .	najvažnejši	2	Def
Iz zapora jo pospremi ambiciozni odvetnik Loudon Trott , ki ne sluti , da se mu bo njegov urejeni svet v kratkem obrnil na glavo .	urejeni	18	Def
Njegovi opogumljeni nasprotniki so prihrumeli na ulice in nenadoma je bil Milošević bivši predsednik , ne da bi bil odjeknil en sam strel .	bivši	12	Def
» Lepo je spet videti tvoj grdi ksiht , « sem rekel Sampsonu .	grdi	6	Def
Ko je izrekla te besede , se je v prostor vrnil prejšnji mrak .	prejšnji	11	Def
Več bomo fotkali in posledično tudi več tiskali , saj je že vsak drugi mobilnik opremljen z digitalno kamero .	opremljen	15	Ind
Razvil se je skriti zaslon in se osvetlil .	skriti	3	Def
Streljaj od vasi je namreč na svoji njivi pred leti postavil osemkotni sto let stari čebelnjak , ki ga je kupil v Tropovcih .	osemkotni	11	Def
Instrumentarij je bogat , saj omogoča tudi prikaz lege krmila in položaja flapov .	bogat	2	Ind
Stolp je grajen tako , da jih bo imel v končni fazi kar 24 , obstoječim toboganom pa bomo tako lahko kar nekaj let zapored dodajali nove .	grajen	2	Ind
- Katekizemski del obsega osem strani in vključuje osnovne molitve in deset zapovedi .	Katekizemski	1	Def
ja od foha ne in tam je en [name:personal] [name:surname] … ja in to je en [name:personal] [name:surname] bil zdaj dvakrat dve leti in je eee fejst poba	fejst	26	Ind
A zgolj ena zgrešena investicija je bila dovolj , da je mogočnežev medijski in nepremičninski imperij Qintex propadel , v pogubo pa je skupaj z njim zdrsnilo še nekaj avstralskih podjetij in bank .	medijski	12	Def
» Kvečjemu razočaran bo , da ne lovi njega .	razočaran	2	Ind
Mislim , da smo si sami največji zaveznik in največji možni zaviralec .	možni	10	Def
Omenimo , da te cerkve še danes jih lahko vidimo takrat še niso bile zgrajene in da je don Bosku bil neznan tudi kraj , kjer bodo stale .	neznan	21	Ind
Zahtevajte brezplačen prospekt !	brezplačen	1	Ind
S testiranjem vnetja lahko določimo , komu preti srčni napad , čeprav ima bolnik normalen ali celo nizek holesterol .	normalen	14	Ind
Urad za preseljevanje in begunce bo , če bo zakon sprejet , deloval podobno kot Študentski servis .	Študentski	15	Def
Najpomembnejši dosežek pogovorov je odločitev o sestavi tekaških reprezentanc za poolimpijsko sezono , v kateri je na sporedu tudi svetovno prvenstvo v italijanski dolini Fiemme .	Najpomembnejši	0	Def
S prvim januarjem 2003 naj bi sedanjo VVO nasledil vrtec Ciciban s sedežem v Ragovski ulici , od nje pa se bo odcepil novi javni zavod vrtec Pedenjped v Šegovi ulici .	javni	24	Def
Na polotoku Kola na oddaljenem področju blizu Murmanska poslovnim ženskam pomaga 2.000 - članski kongres žensk .	članski	13	Def
Mineva leto dni , odkar me je pot vodila v Spodnji Gasteraj k družini Bohak , Jožici , Zarji in Ernestu .	Spodnji	10	Def
Skrajni čas je , da postanejo bolj udobni .	Skrajni	0	Def
Končina je vzel pod drobnogled še trditve strokovnega direktorja KC Zorana Arneža , ki ves čas zatrjuje , da je bil nakup miz strokovno upravičen , da pa se ni spuščal v poslovne plati zadeve .	upravičen	24	Ind
Holistični pristop k zdravljenju , ki so ga zagovarjali vsi predavatelji , pomeni predvsem ukvarjanje s sabo .	Holistični	0	Def
in lep dan želim … nasvidenje	lep	1	Ind
Častihlepni arheolog amater pa si je želel še nekaj .	Častihlepni	0	Def
zdaj katalitični efekt pri dani rotacijski temperaturi smo definirali kot razliko v aktivacijski prosti energiji glede na to ravnotežno situacijo kadar je rotacijska temperatura enaka translacijski temperaturi v našem primeru je to tristo kelvinov	katalitični	1	Def
Poljski premier bo jutri nagovoril tudi poslance državnega zbora .	Poljski	0	Def
DDV naj ne bilo treba plačevati tudi ob izvozu blaga in storitev , država pa naj bi neto izvoznikom vračala plačani davek najkasneje v roku 30 dni .	plačani	20	Def
Prednji rob škržnega poklopca je opnast .	opnast	5	Ind
ROL Ko je Berlusconijev mikrokirurg zagledal Ljubljenega vodjo , ki ga je obiskal ob vrnitvi iz Davosa , se je bridko zjokal in za vedno odložil instrumente .	Berlusconijev	3	Ind
Če ni dovolj zmogljiv , se bodo pri zajemu izgubljale sličice , če bo teh veliko , pa bo tako zajet film praktično neuporaben .	zmogljiv	3	Ind
Izobčil je Henrika in razglasil , da je odstavljen z mesta cesarja .	odstavljen	8	Ind
Morfologija : Ima dolg , vitek trup , koničasto glavo in gobec z majhnimi krajnimi usti ter precej daljšo spodnjo čeljustjo .	vitek	5	Ind
Hladna rosa osveži in poživi krvni obtok , zato se noge segrejejo .	krvni	5	Def
Glas Haberlove stopi na opustošeno obalo , v opustošeni svet , razsrediščen , shizofren in absolutno razbolen .	razbolen	16	Ind
Balzac je svoja dela strnil v obsežen literarni načrt , zasnovan kot realistična raziskava sodobne družbe , ki jo je imenoval Človeška komedija .	obsežen	6	Ind
Peter je bil star osemintrideset let , bil je doktor zgodovine in skorajda briljanten .	briljanten	13	Ind
Slovenija se je uspela ločiti od bivše države na manj krvav način kot druge republike .	krvav	10	Ind
V tem primeru delodajalec delavcu ni bil dolžan omogočiti zagovora , saj so obstajale okoliščine , zaradi katerih bi bilo od delodajalca neupravičeno pričakovati , da delavcu to omogoči .	dolžan	7	Ind
mini lesi se mu reče tudi … ja ja	mini	0	Def
V naročje ji je padel zajeten programski niz .	zajeten	5	Ind
Za že ustanovljene avtošole sicer še velja dveletni prehodni rok , v katerem morajo uskladiti svoje delovanje z novim zakonom , za tiste , ki nastajajo v teh dneh , pa je novi zakon že obvezujoč .	obvezujoč	35	Ind
Svoje želje je kazal na izviren način .	izviren	5	Ind
Odslej bom trezen .	trezen	2	Ind
Spodrsljaj župana in njegove ekipe je podkrepil tudi hiter telefonski stik s predsednico občinske volilne komisije sodnico Marjeto Dvornik .	telefonski	9	Def
Kot bi tekmovali , kdo bo zagrešil hujši vojni zločin .	hujši	7	Def
Kršenju reda in miru se v nedeljo ni mogel upreti niti D. M. Pod nadzorstvom je 54 - letni Ptujčan svojo streznitev dočakal na Policijski postaji Ptuj .	letni	18	Def
" Začel se je zibati na prizadet način .	prizadet	6	Ind
Poklicna šola in izkušnje ter mojstrski izpit so pot , ki omogoča lepo kariero , sistem pa omogoča tudi nadaljevanje izobraževanja v višjih strokovnih šolah .	mojstrski	5	Def
Tako je bil včeraj obiskan profesionalni teniški turnir ATP v Domžalah , ko je nastopil Mariborčan Iztok Božič .	obiskan	4	Ind
Rodila sem se 6. februarja 1983 kot drugi in hkrati zadnji otrok Pavla in Magde Omahen .	zadnji	10	Def
Na 800 metrov je bil najhitrejši alžirski atlet Djabir Said - Guerni z 1:44,32 .	alžirski	6	Def
Nato se bolničarja ustavita , kajti nekako morata odpreti nihajna vrata , ki pa uporno silijo v svoj prvotni položaj .	prvotni	18	Def
Srebrni častni znak je prejela tudi Pia Mlakar .	častni	1	Def
kakšen je vaš generalni odgovor na to ?	generalni	3	Def
Težko razumljivo je , da na trgu ponujeni izdelki za čiščenje keramike vsebujejo natrijev hidroksid in natrijev hipoklorit .	natrijev	13	Ind
Odkar je veliki beli morski pes postal slaven , ga neusmiljeno lovijo .	slaven	7	Ind
» Gospa Ryan je potrdila , da je njen mož Jimmy , zaposlen pri gradbenem podjetju Sama Krausa , danes nameraval na sestanek na ladjico Cornelia II , « je govoril Brennan .	zaposlen	12	Ind
Pri nas je to dokaj izkrivljen pojem , ki ne pove prav dosti .	izkrivljen	5	Ind
Pripadam generaciji , ki ji je socialen čut zelo pomemben , tako sem bil vzgojen .	vzgojen	14	Ind
Ob rečnih mrtvicah se ohranja pester in slikovit življenjski prostor logov , močvirij in poplavljenih travnikov .	slikovit	7	Ind
Zgledal je kar obetavn .	obetavn	3	Ind
V 63. minuti pa je Vogrinčič opravil pravi slalom skozi desni del obrambe Celjanov , podal žogo na drugo vratnico , kjer je bil z glavo najvišji Romero in postavil končni izid .	končni	30	Def
Delni razlog za to so zasloni LCD , ki zaradi majhnosti in velike potrošnje električne moči niso kos profesionalni grafiki .	Delni	0	Def
Gre predvsem za spletni brskalnik in odjemalec elektronske pošte , nekatere druge aplikacije , kot so večigralske igre ali programi za takojšnje sporočanje , pa zahtevajo uporabnikovo potrditev za dostop do interneta .	spletni	3	Def
Dejaven čustven odnos do vira strahu - napadalnost pa je takšna - vsaj deloma zaduši strah oziroma ga potisne iz naše zavesti .	čustven	1	Ind
ampak pri nas mislim da je glede na to da je manjši zapor eee da je več ali manj bolj en šef na vrhu	manjši	11	Def
ja seveda ne [gap] včasih pa sem len ka sem tako len ka se mi nič ne da ka res sem	len	11	Ind
Ne moremo vedeti , koliko je Cankar v Maksu videl sebe , vendar ni dvoma , da mu je bil mladeničev beg pred spolno ljubeznijo zoprn .	mladeničev	20	Ind
danes kot sem že rekel igra na levi in se bo z lewandowskym ki bo prihajal pred severnoirski gol po poljski desni strani bržkone večkrat srečal	severnoirski	17	Def
Spal je kot ubit .	ubit	3	Ind
Zunanji minister Dimitrij Rupel je pisal pismo poslancem državnega zbora in jih prosil , naj premislijo o njeni kandidaturi .	Zunanji	0	Def
“ Osrednji del naše nove pridobitve je 15 metrov visok stolp , s katerega smo za začetek speljali šest toboganov .	Osrednji	1	Def
Priključek je zanimiv za kmetije , ki preko sezone krmijo z zeleno krmo v hlevu ( t. i. zeleni krmni trak ) .	krmni	19	Def
V bistvu je vse skupaj podobno popotovanjem prvih pionirjev , ki so odkrivali ameriški divji zahod .	divji	14	Def
MARIBOR , 14. Mladinski kulturni center Maribor ob podpori Študentske organizacije Univerze v Mariboru pripravlja danes ob 19. uri v galeriji Abruni v Mariboru galerijski literarni večer .	galerijski	24	Def
Zdaj premišljate o vsem tem , malce ste ljubosumni na tiste , ki zavzamejo vam nedosegljiv prostor .	nedosegljiv	15	Ind
Slovar je zares obsežen vsebuje namreč več kot 120.000 angleških besed in besednih zvez , ki jih tudi podrobno razloži .	obsežen	3	Ind
V skledo damo rezine , sok , pomarančni liker , pokrijemo in pustimo stati pol ure .	pomarančni	7	Def
Potem ko je prvo partijo z Drejevom mirno remiziral , je bil kot beli vse drugače razpoložen in v zanj značilnem slogu zanesljivo zmagal .	razpoložen	16	Ind
Kdo bi stražil vso noč z orožjem - danes si vreden toliko , kolikor imaš s seboj evrov .	vreden	10	Ind
Mali me je trdno prijel za roko .	Mali	0	Def
V moški konkurenci je bil izid zelo tesen , saj so o športniku leta odločili glasovi enega samega člana strokovne komisije .	tesen	7	Ind
Ne da bi pogledal , sem zakoračil v eno izmed vrst , z roko udaril po poklopljenem lesenem sedalu stola , da je glasno počilo , ko je skočilo v vodoravni položaj .	vodoravni	30	Def
recimo ne vem eno majico ki jo damo v prej preden jo damo v pralni stroj	pralni	14	Def
V laseh je imela črn trak .	črn	4	Ind
No , tudi nadaljnji razplet bi bil lahko zgovoren .	nadaljnji	3	Def
- Skrbi , da je vsak vodja tima sposoben posredovati potrebna znanja in informacije članom tima , ki ga vodi	sposoben	8	Ind
Leta 1824 so bile dokončane ikone in velik ikonostas , ki je dolg 10 metrov in visok 6 metrov .	visok	16	Ind
Nastal je dober kratki film .	dober	2	Ind
V letih 1907 - 1910 , ko je bil Župančič domači učitelj grofiču Manfredu Attemsu na Nemškem in v Vorarlbergu , se je njegova pozornost vnovič usmerila k mladinski literaturi .	domači	10	Def
Za to bosta poskrbela Nikki in njen štirinožni ljubljenček , divji maček Murray , ki se hočeta maščevati nepridipravom , zaradi katerih je Nikki pristala v ječi . . .	štirinožni	7	Def
Ker je več kot očitno , da je vodilna kultura že posrkala vse subkulture , jih prežvečila in zmešala z drugimi , bi bilo nespametno neki nočni klub voditi le za absolutno alter sceno .	nočni	26	Def
Če pa želite svoje čebelice toplo odeti že oktobra , naj bo opaž zračen in suh .	suh	15	Ind
Zase pa verjamem , da sem bil iz časa pregnan le zato , da bi iz njega naredil snov svoje obsedenosti .	pregnan	9	Ind
Leta 1986 je vzniknila ideja o preoblikovanju muzeja iz posebnega v splošni pokrajinski muzej , ki naj bi skrbel za varstvo premične kulturne dediščine , njeno realizacijo pa je prinesla sprememba financiranja muzeja leta 1990 .	pokrajinski	12	Def
Črni ponarejeni Armanijev športni plašč .	športni	3	Def
Njegov delovni čas se ne konča , ko se trgovina zapre .	delovni	1	Def
Morfologija : Ima podolgovat , jajčast , v hrbtnem delu sploščen trup , majhna usta , v niz razporejene slabotne zobce v zgornji čeljusti , skorajda brezzobo spodnjo čeljust in v nekakšno vrsto plošč sestavljene goltne zobe .	podolgovat	3	Ind
Toda grški časopisi so polni člankov , v katerih novinarji na dolgo in široko opisujejo njegov neprimeren način življenja .	neprimeren	16	Ind
Ključar Viktor Papler , ki mu je prvi priskočil na pomoč in bil nato tudi sam ogrožen , je povedal , kako sta tja prihitela še dva vaščana .	ogrožen	16	Ind
Najboljši način za razčlenitev izdelka ali storitve za namene trženja je uporaba sheme navpičnega trženja .	Najboljši	0	Def
Pozneje zvečer se sumljivi individuum vrne .	sumljivi	3	Def
Oblikovno najbolj radikalen se zdi manjši F 650 CS , ki tudi tehnično prinaša kar nekaj zanimivih rešitev .	radikalen	2	Ind
eem zdaj še ena zanimiv podatek se da iz tega grafa razbrati	zanimiv	4	Ind
Ne dvomim v srečnejšo prihodnost kot v času prvega NEP , saj ne računam na skorajšnji nastop kakega Stalina .	skorajšnji	15	Def
Tako kot je besedni red v posameznih povedih zasnovan na podlagi členitve po aktualnosti , so med seboj povezane tudi povedi v besedilu .	zasnovan	8	Ind
Skrajni čas je , da članice EU spet začnejo bolj poslušati druga drugo in hkrati bolj misliti na Evropo .	Skrajni	0	Def
O , a sem ti omenu , da sem seropozitiven ?	seropozitiven	9	Ind
S takšno splošnostjo se nisem strinjal in sem povedal , da je zaskrbljen sleherni vietnamski ribič ali slovenski kmet , pisatelji pa moramo narediti več .	sleherni	13	Def
Vlada je dolgo zatrjevala , da zvišanja nima v načrtu , a finančni minister Gordon Brown je nazadnje le popustil .	finančni	12	Def
Rezultate raziskav in vitro smo v nadaljevanju na enostaven način povezali z raziskavami in vivo .	enostaven	8	Ind
Morfologija : Ima visok , na bokih stisnjen trup , velika usta s številnimi majhnimi zobmi in daljšo spodnjo čeljustjo .	stisnjen	7	Ind
Izkazalo se je , da je zdravnik ne le zmožen , ampak tudi izjemno željan prevzeti kakršnokoli delujočo metodo , ki bi bila kos krizi .	zmožen	9	Ind
pregovor pravi da neumnemu kmetu zraste najdebelejši krompir in to na asfaltu ampak kaj pa če ne zraste ?	najdebelejši	6	Def
Če se bo to zares zgodilo , bom z njegovo odločitvijo zelo počaščen .	počaščen	12	Ind
Morda sem bil videti kot najbolj neizprosen zajebanec daleč naokrog , toda moje srce je bilo težko in neverjetno krhko .	neizprosen	6	Ind
Pomolila mi je rumen plastičen pretvornik valut v obliki evroračke .	plastičen	4	Ind
» Moj oče je velik strateg in velik osvajalec , dostojen dedič Velikega kana .	dostojen	10	Ind
Če je negativen , je težko reči , da je goodwill .	negativen	2	Ind
Tu je doživel totalni polom , begunce pa spravil za bodečo žico .	totalni	3	Def
Nastop Ere Koroška je dobrodošel ne le zaradi tega , ker je ohranil del domačih trgovin in tudi nekaj delovnih mest , temveč je pomagal vzpostaviti konkurenco med čedalje številčnejšimi koroškimi trgovci .	dobrodošel	4	Ind
So prvi dokument te vrste in pomenijo referenčni okvir za oblikovanje nove stopnje po drugem glavnem študijskem obdobju .	referenčni	7	Def
Kmalu nam zajeten kup konzerv na snegu ob naših ležiščih govori , da se nam danes godi prav dobro .	zajeten	2	Ind
ja seveda ne [gap] včasih pa sem len ka sem tako len ka se mi nič ne da ka res sem	len	7	Ind
Kje se bo kdo zdravil , je odvisno do tega , kako je zavarovan oziroma koliko ima denarja .	zavarovan	13	Ind
Lohk mi rečeš drkač , sam sem bil zmer mal živčen , kar se drog tiče .	živčen	10	Ind
eee da b [gap] in dodatno nih [gap] nobenemu ni dala dopusta tako da so one to vse i [name:personal] je delala celi dan in [name:personal] so delale celi dan	celi	28	Def
Nace Bratina je bil nedoumljiv .	nedoumljiv	4	Ind
Zaradi očitkov , da je nezvest ženi , v službi več let ni mogel napredovati .	nezvest	5	Ind
Stopil sem na začetek vrste , vendar so me sprva zavrnili , dokler nisem povedal , da me je poslal Nurejev .	Nurejev	20	Ind
DOGOVOR O POLITIKI PLAČ JE POMEMBEN INSTRUMENT IN IZRAZ DELUJOČEGA SOCIALNEGA PARTNERSTVA V RS .	POMEMBEN	5	Ind
Ko se je Stanislaus D. iz Avstrije v torek pripeljal na mejni prehod Holmec , je mislil , da bo v Slovenijo vstopil brez težav .	mejni	11	Def
Dolgo sem ležal buden in premišljeval o tej zadevi .	buden	3	Ind
MARIBOR , 11. - Tukaj so imeli dvodnevni programski sestanek vodilni sindikalisti kovinsko predelovalne in elektro industrije držav Višegrajske skupine in iz bivših republik Jugoslavije , le črnogorski sindikalist je poslal samo spodbudne telegramske pozdrave .	dvodnevni	7	Def
Kakor zmeraj je bil oblečen za uspeh .	oblečen	4	Ind
Desetletje trajajoč boj , v katerem se je sklicujoč na svojo bolezen izognil vrnitvi v domovino , kjer je bil obtožen vsaj 60 kaznivih dejanj , pa se je minulo nedeljo vendarle končal .	obtožen	20	Ind
S poslano dopisnico sodelujoči potrjuje , da je seznanjen s pravili nagradne igre .	seznanjen	8	Ind
ker eee gre za to da da pravzaprav človek porabi eee ogromno nekega časa ki je ki ki bi lahko bil neproduktiven ne	neproduktiven	21	Ind
Krpanke Cvetke Hojnik Dorojevič so večmetrske sestavljanke organskih in geometriziranih form , vpetih v širok izbor barvnih kombinacij , ki jih avtorica komponira analogno gradnji slike .	širok	14	Ind
Mene pri Atkinsonovi dieti najbolj moti neomejen vnos nasičenih maščob .	neomejen	6	Ind
Pripadam generaciji , ki ji je socialen čut zelo pomemben , tako sem bil vzgojen .	pomemben	9	Ind
Če se prav spominjam , je kot opravičilo navajal , da je prezaposlen v matični hiši .	prezaposlen	12	Ind
Podoben učinek ima tudi hoja po rosi , preden jo posuši sonce .	Podoben	0	Ind
Na to me je opozoril neki nadarjen avstralski filozof .	nadarjen	6	Ind
V Europarku teče dobrodelna akcija , imenovana Majhen medvedek , veliko srce .	Majhen	7	Ind
Res da se na tak način našemu raziskovanju predstavlja najznačilnejši sloj , a vendar moramo reči , da po napisih ne moremo takoj sklepati na splošno pismenost .	najznačilnejši	9	Def
Poročni zvonovi naj bi za zaljubljeni par zapeli šele prihodnje poletje .	zaljubljeni	5	Def
Tudi Guti bi se raje kot k večnim tekmecem preselil na Apeninski polotok : " Rad spoznavam nove kraje .	Apeninski	11	Def
Sam uvaja pojem » identificirajoča genitivna metafora « , saj sta oba dela identificirana .	Sam	0	Ind
Ostane še goodwill , če je kapital pozitiven .	pozitiven	7	Ind
skratka s [gap] družbena skupnost v našem primeru država naj vsakemu svojemu pripadniku zagotavljala nek dogovorjen znesek v naših razmerah bi to bilo mesečno	dogovorjen	15	Ind
Zdaj je Smart rešen , od prihodnjega leta pa v programu ostajata še Fortwo in Forfour .	rešen	3	Ind
Tako bo omogočen sprejem novega zakona Unije o prevzemu , Velika Britanija pa bo lahko bolj sprejemala politiko odprtih meja Unije .	omogočen	2	Ind
Odlično je povezan z Microsoft Office 95 in podpira OLE 2.0 .	povezan	2	Ind
ki bi rekel ti konfliktni interesi tudi ustvarjajo potem to neko nek vladajoči razred ne iz katerega pravzaprav ko enkrat prideš vanj ne moreš več izpasti	vladajoči	12	Def
To je bil imeniten obračun in upam , da jih tudi na evropskih ne bo manjkalo , " je dejal po dirki Rossi .	imeniten	3	Ind
1507 Nemški kartograf Martin Waldseemüller ( ok. 14701518 ) predlaga , da bi novi svet poimenovali Amerika .	Nemški	1	Def
Če bomo igrali tako kot znamo , bo rezultat prišel sam po sebi , " zatrjuje 28 - letni Gregor Cvijić , ki si edini med našimi igralci na SP služi kruh v tujini .	letni	18	Def
Minuli teden nas je zapustil človek , ki je pri svojem delovanju ubral precej drugačno pot , kot jo izpričujejo omenjeni novokomponirani politični petelinčki .	Minuli	0	Def
11416 Rimski cesar Trajan napade Parto ter zasede Armenijo in Mezopotamijo rimsko cesarstvo je največje v svoji zgodovini .	Rimski	1	Def
Nacionalni program predvideva tudi priprave programov na lokalni ravni .	Nacionalni	0	Def
Dobro se spomnim , ko nam je pokojni akademik Vilfan med študijem pojasnjeval to resnico .	pokojni	7	Def
S takšno splošnostjo se nisem strinjal in sem povedal , da je zaskrbljen sleherni vietnamski ribič ali slovenski kmet , pisatelji pa moramo narediti več .	vietnamski	14	Def
Ninamedia ni ne nova ne stara , je raziskovalna organizacija , ki že skoraj desetletje na profesionalen način opravlja delo , za katero je registrirana .	profesionalen	16	Ind
Zaposlen človek v naši državi je v povprečju , po podatkih iz leta 1999 , na dopustu 17 delovnih ur na mesec .	Zaposlen	0	Ind
eee in to je ta ki je bil zdaj tudi sicer pol mislim da je bil oproščen ali kako ampak je bil na zatožni klopi zaradi onega nesrečnega [name:personal]	oproščen	16	Ind
Seveda pa je bila formulacija " bi lahko pomenila precejšen preobrat " uporabljena namenoma .	precejšen	9	Ind
Pregled slednjega je pokazal , da je bil namenjen na preprodajalsko pot .	namenjen	8	Ind
Po končani karieri brazilski nogometaš Giovanni ( na sliki ) ne bo vložil denarja v gostinski lokal ali ostal v tem športu kot trener , ampak bo svoje zadovoljstvo poiskal v veri .	brazilski	3	Def
Že v Aristotelovem času so te tri domene predstavljale samo primarni princip za klasifikacijo kontekstov javne komunikacije in njenih diskurzev , saj se je v vsaki od njih pojavljalo večje število specifičnih idiomov .	primarni	10	Def
Da je večer lepo uspel , so poskrbeli še narodnozabavni ansambel Trio najstniki in Jožica Jaklič iz Dobrniča s harmoniko .	narodnozabavni	9	Def
ZAKON IMA TUDI POSEBNO POGLAVJE O POKOJNINAH URADNIKOV OZIROMA USLUŽBENCEV ; POSEBEJ PODROBNO PA JE UREJEN TUDI DISCIPLINSKI POSTOPEK .	DISCIPLINSKI	17	Def
Življenje malčka je ena sama velika dogodivščina in vaš malček bo vesel , če se mu boste pridružili v njej .	vesel	11	Ind
Strastna avantura se lahko razvije v topel , obojestransko osrečujoč zakon .	osrečujoč	9	Ind
Volan z zobato letvijo , variabilni servo , 2,8 zavrtljaja .	variabilni	5	Def
še celo spočit ker si bil dosti na zraku	spočit	2	Ind
Gre za prvi uradni obisk poljskega premiera v Sloveniji in hkrati prvi uradni dvostranski Buzekov obisk v tujini po imenovanju poljske vlade lansko jesen .	uradni	3	Def
Z zadostnim znanjem programiranja ( in poznavanjem zbirk podatkov ) lahko izdelate program , ki s spletne strani naredi poizvedovanje v zbirko podatkov in vrne lepo oblikovan seznam izdelkov .	oblikovan	26	Ind
Starostni svet puritanske družbe jo ožigosa .	Starostni	0	Def
Vodilni so zato pred slabim letom sprejeli sanacijski program , v katerem sta bila odpustitev petindvajsetih odvečnih delavcev ter najem dolgoročnih posojil .	sanacijski	7	Def
Le rahel košček neba ju je zares ločeval .	rahel	1	Ind
Filmska pripoved o slovenskih muzejih je nastala kot projekt , katerega nadaljevanje bomo za spremembo gledali že prihodnji teden .	prihodnji	17	Def
Morda ji v naročje pade drobcen prašek : nežno ga obrišite .	drobcen	5	Ind
Namesto dveh prostitutk , ki naj bi ju ob prihodu srečal don Kihot , ob vstopu v gostilniški atrij zagledam dekle , ki energično čisti stranišča .	gostilniški	17	Def
V predstavi Kapital je zelo pomembno nekaj , kar lahko odpre v gledališču nove možnosti uprizarjanja , t. j. vrtljivi prostor , v katerem sedijo gledalci in spremljajo dogajanje okoli sebe .	vrtljivi	19	Def
ne in tako eee i [gap] veš kakšen lep kostanj kako dober sladek	sladek	12	Ind
ČE POGODBO O ZAPOSLITVI ODPOVEDUJE DELAVEC , JE MINIMALNI ODPOVEDNI ROK 30 DNI .	ODPOVEDNI	9	Def
Sicer pa smo naredili začetni kompromis , kar bo verjetno sčasoma stvari malo olajšalo .	začetni	4	Def
Friderik na skrivaj pripravlja grajsko pristavo za Veronikin prihod , medtem ko zapuščena Jelisava zre že onstran življenja .	Veronikin	7	Ind
Pravilen odgovor je bil Grad Podčetrtek , nagrajenki čestitamo in ji sporočamo , da je za nagrado dobila enodnevni izlet za dve osebi po Sloveniji , ki bo predvidoma v mesecu oktobru 1996 .	enodnevni	18	Def
Njen delovni dan se začne ob pol osmih zjutraj .	delovni	1	Def
Magični in zdravilni moči menstruacijske krvi so dali negativen pomen ; imeli so jo za strupeno in škodljivo .	negativen	8	Ind
Ali ne bi zadoščalo , da bi ostali pri vprašanju : kateri je vaš materni jezik ?	materni	14	Def
Začetek izvajanja programa je odvisen od podpisa sporazuma z republiškim zavodom za zdravstveno zavarovanje , po napovedih pa bi se naj to zgodilo prihodnji mesec .	odvisen	4	Ind
V teh okvirih se ZLSD zavzema za strpen in argumentiran nastop Slovenije v pogovorih s sosedami o odprtih vprašanjih .	strpen	7	Ind
Vnovično uvajanje » pridobitev socializma « bi bilo namreč zelo nevarno za produktivnost , konkurenčnost in s tem povezan obstoj naših podjetij .	povezan	18	Ind
» Oho , ti si pa poln keša ! « ga je občudujoče pogledala Karmen .	poln	6	Ind
Glede vabe ušata res ni izbirčna , za uspešen ribolov pa jo moramo aktivirati , jih obnoreti , preslepiti .	uspešen	8	Ind
Iz podjetja , ki sem ga sam ustanovil , so me na lep način izrinili , tako da sem se moral sprijazniti s splošnim tapetništvom , ki sem ga opravljal v lokalčku na zadnji strani svoje hiše .	lep	12	Ind
Profesor Osolnik iz Ljubljane , ki je bil izbran za šefa te komisije , nas je pri tem obvestil , da je Univerza v Ljubljani odobrila tri nove programe za poljski , češki in slovaški jezik .	češki	32	Def
Kriki , ko pred stavbo bolnico premeščajo v reševalni avtomobil , pa se nekako ne skladajo s sončnim dnem .	reševalni	8	Def
Generalni direktor Mednarodnega sklada je ponavadi Evropejec , Svetovno banko pa vodi Američan .	Generalni	0	Def
Dokazila in zapisi v portfoliu vzgojitelju pomagajo , da pripravi izčrpen in zanimiv zapis o različnih področjih otrokovega razvoja , ki temelji na dokazilih v portfoliu in ki je edinstven , kakor je izjemen vsak posameznik .	izčrpen	10	Ind
Ima pa nenasiten tek .	nenasiten	2	Ind
Poleg tega pa nisem ravno po modi naravnan tip človeka .	naravnan	7	Ind
vsaj za pogovorni jezik da da ko pridem v trgovino da kaj kupim pa kaj ti jaz vem da se skregamo pa tako pač	pogovorni	2	Def
Kot je še povedal Maks Gale , stečajni dolžnik razen šivalnih strojev nima v lasti nobenih nepremičnin .	stečajni	7	Def
množičen morilec ali eee zakrknjen storilec kakšnega hudega kaznivega dejanja ne razmišlja o kazni	množičen	0	Ind
Potem bi imela lep vzrok , da bi šla malo mižat pod tisti balvan .	lep	3	Ind
Prišla je oblečena v eleganten komplet s svetlomodro bluzo , izza katere se je sem ter tja zaslutil odblesk diskretne ogrlice .	eleganten	4	Ind
ZAGREB , 6. - Hrvaški državni vrh je marsikoga presenetil s spomenico o dokončanju mirne reintegracije hrvaškega Podonavja .	Hrvaški	4	Def
Program cpio obnovi imenik in na koncu izpiše število 512 - znakovnih blokov , ki so bili zapisani na trdi disk .	trdi	19	Def
Za to bosta poskrbela Nikki in njen štirinožni ljubljenček , divji maček Murray , ki se hočeta maščevati nepridipravom , zaradi katerih je Nikki pristala v ječi . . .	divji	10	Def
Močno se je nagnil čez balkonsko ograjo in pljunil v temni kanal .	temni	10	Def
Indeks relativne moči se trenutno zadržuje okoli 35 indeksnih točk , za močnejši porast pa bi potrebovali preboj 45 točk .	močnejši	12	Def
Na slovesnosti so javno povedali , da bo stranka na predsedniških volitvah podprla neodvisnega kandidata Franceta Arharja , nekdanji guverner Banke Slovenije , ki se je slavnostne akademije tudi udeležil , pa se je zbranim zahvalil za podporo .	nekdanji	18	Def
In kaj dela ob mladoporočencema ukrajinski kitarist iz ansambla Mardjango Vitalij Osmačko ?	ukrajinski	5	Def
Še preden se mu je zasvetlikalo na ramenih ali prsih kako priznanje , ga je pokosil sovražnikov meč .	sovražnikov	16	Ind
Chaiken je jasno povedal , da je bil Pete Conrad morda najbolj šegav in sproščen od vseh Apollovih astronavtov .	sproščen	14	Ind
K sreči je brežiški poslanec DZ Jože Avšič ( LDS ) uspel kolege prepričati v škodljivost tega določila , ki bi močno skrčil območje pridelave cvička .	brežiški	3	Def
ZVZD JE NOV , VSEOBSEŽEN PRAVNI VIR SODOBNE ZAKONSKE UREDITVE VARNOSTI IN ZDRAVJA PRI DELU , KI JE NADOMESTIL DOTLEJ VELJAVNI ZAKON O VARSTVU PRI DELU IZ LETA 1974 .	VSEOBSEŽEN	4	Ind
Mojstrsko delo je najpomembnejši lesorez v Makedoniji .	najpomembnejši	3	Def
Ubogljivi in od vodilne stranke poslušni minister Jelko Kacin je s svojo operativno udarno enoto ( šest oboroženih pripadnikov Voma ) opravil še zadnje kadrovske zamenjave in prerazporeditve in tako brigadi zadal še zadnji smrtni udarec .	Ubogljivi	0	Def
Ko sem zapuščal pisarno , sem videl , kako se je mlad kriminalist , zadolžen za pogrešane osebe , nasmehnil kolegu in kolega mu je nekaj zašepetal , potem sta se oba zahahljala .	mlad	11	Ind
Poskusila bom pokazati , da skupnost , kadar obstaja , disciplinira , če uporabimo Foucaultov izraz , telo in duha .	Foucaultov	14	Ind
Italijanski premier Silvio Berlusconi je konec tedna podpisal ustrezen sklep , s katerim je organizacijskemu komiteju zimskih olimpijskih iger v Torinu za izvedbo iger 2006 ( 10. - 26. februarja ) namenil 159 milijonov evrov .	Italijanski	0	Def
Za starejše pa je res kriza , " nam je povedal eden izmed delavcev , ki ima sicer to srečo , da ni zaposlen v proizvodnji in si službo obeta vsaj do septembra .	zaposlen	23	Ind
Ker je vozil vinjen in brez veljavnega vozniškega dovoljenja , prav tako pa je večkratni kršitelj prometnih predpisov , so ga ob 19.20 metliški policisti pridržali do streznitve .	vinjen	3	Ind
Idealen čas za zalivanje v rastlinjakih so zgodnje jutranje ure .	Idealen	0	Ind
Takrat jo je slekel , se vlegel nanjo in drgnil spolni organ ob njen trebuh .	spolni	10	Def
Zdrava hrana naj bi krepila imunski sistem in ohranjala zdravo kožo .	imunski	5	Def
Ti pa so vsaj v tretjini primerov lahko zadovoljni s paracetamolom , drugi lahko dobijo bistveno varnejši nesteroidni antirevmatik od najbolj toksičnega .	varnejši	16	Def
bartosz bosacki je izkušen nogometaš triintridesetletni branilec ki igra za lech iz poznanja	izkušen	3	Ind
Vstopila sta in me začela poučevati o programu , ki je postal pozneje poznan pod imenom Anonimni Alkoholiki .	poznan	13	Ind
Bolgarska cerkev pa je popularne knjige o Harryju Potterju označila kot duhovni aids za bralce , saj naj bi oslabile imunski sistem proti črni magiji in jih napravile dovzetnejše za zlo .	duhovni	11	Def
Sledimo markirani planinski poti ; skoraj tri četrt ure smo prepuščeni doživljanju narave na hoji skozi pokljuški gozd .	pokljuški	16	Def
Če skalo , ki jo je z glasom premaknil Ali Baba , opazujemo od daleč , nikakor ne moremo vedeti , ali jo je premaknila čarovnija ali vgrajeni mehanizem s sposobnostjo prepoznave govora .	vgrajeni	27	Def
zjutraj ob štirih je dala sestra prati nočno posodo v pomivalni stroj in okoli petih je prišlo verjetno do kratkega stika in do požara	pomivalni	10	Def
Kot pravi Nika Leben , naj bi letos restavrirali v tej cerkvi glavni renesančni oltar in freske na fasadi prezbiterija ter tako zaključili obnovo .	glavni	12	Def
saj tamle ljubi je tudi fizikalec	ljubi	2	Def
Mislim , da smo si sami največji zaveznik in največji možni zaviralec .	največji	6	Def
Sam dokument torej ni sporen , a žal ni več verodostojen .	verodostojen	10	Ind
V DRUGIH DRŽAVNIH ORGANIH PRAVICE IN DOLŽNOSTI DELODAJALCA IZVRŠUJE PREDSTOJNIK , ČE ZAKON , DRUG PREDPIS ALI SPLOŠNI AKT ORGANA NE DOLOČA DRUGAČE .	DRUG	14	Ind
Na pomoč mora priskočiti najin doma tolikokrat prebrani opis , ki ga morava z mnogo mimike prevajati v francoščino in nemščino .	prebrani	7	Def
Morfologija : Ima podolgovat , jajčast , v hrbtnem delu sploščen trup , majhna usta , v niz razporejene slabotne zobce v zgornji čeljusti , skorajda brezzobo spodnjo čeljust in v nekakšno vrsto plošč sestavljene goltne zobe .	jajčast	5	Ind
Zraven tega se tud tanajhujš maček po alkoholu zdi koker pravlca .	tanajhujš	4	Def
Splošen skrivnopisni sestav sestavljata dva ključa in postopka .	skrivnopisni	1	Def
V tem dokumentu najdemo še en nasvet , ki je izjemno bistven za Lutrov program .	bistven	11	Ind
Predlog zakona o DDV v drugem branju je bil v primerjavi s prvim branjem dokaj spremenjen .	spremenjen	15	Ind
Današnji gospodarski sistem je drugačen . . .	Današnji	0	Def
NOV IZRAZ : Zemljevidi so posebne slike , pri katerih so različna območja s povezavami povezana do različnih spletnih lokacij .	NOV	0	Ind
Mnogi si miren nočni spanec omogočijo s kemijo : leta 1998 je bilo v Avstriji izdanih 1,3 milijona receptov za uspavalne in pomirjevalne tablete .	nočni	3	Def
Ob mladem , čednem Henriku v razcapani obleki je bil pritlikavi Gregor s papeško krono videti še bolj droban .	pritlikavi	10	Def
Bil sem čisto majhen , vendar pomnožen kot v labirintu zrcal v zabaviščnem parku .	pomnožen	6	Ind
Navidezno anahronistični poziv k milosrčju v sodobnem svetu vendarle ohranja posebno aktualnost .	anahronistični	1	Def
Prednji rob škržnega poklopca je opnast .	Prednji	0	Def
ampak brez dvoma pa je da so sicer očitki usmerjeni zoper ta kazenski zakonik bili da je šel preveč rigorozno za visokimi kaznimi	kazenski	12	Def
Izbran je bil za naslednika Konrada I. Švabsko in bavarsko priznanje si je moral izbojevati .	Izbran	0	Ind
» Dominantni dvojček lahko nastopa z vedenjsko strukturo modela moške vloge , « sem rekel Kate .	Dominantni	1	Def
Je pa res , da je tudi v svetu pogost odstop od tožbe ali poravnava , ker se med procesom zgodijo spremembe ali pa preprosto ugotovijo , da bodo krivdo težko dokazali .	pogost	9	Ind
Na 800 metrov je bil najhitrejši alžirski atlet Djabir Said - Guerni z 1:44,32 .	najhitrejši	5	Def
" Dušan Šešok je medtem igral kadrovske igrice , menjaval direktorje , dokler se ni pojavil uspešni Boštjan Šoba , ki je z novimi posli v kratkem času dosegel zaslužek podjetja v višini milijon mark .	uspešni	16	Def
V tem dokumentu najdemo še en nasvet , ki je izjemno bistven za Lutrov program .	Lutrov	13	Ind
Tudi v takem deluje Sveti Duh in mu podarja dar ljubezni , da z njim z Božjo ljubeznijo ljubi Boga ( kolikor ga spozna ) , sebe in bližnjega .	Sveti	4	Def
Ko se bo preselil v svojo sobo , naj ostali dnevni ritem ostane nespremenjen .	ostali	9	Def
Če ni dovolj zmogljiv , se bodo pri zajemu izgubljale sličice , če bo teh veliko , pa bo tako zajet film praktično neuporaben .	neuporaben	23	Ind
Kar solze so mi stopile v oči , je bil vznesen Tone Glavan .	vznesen	10	Ind
Kot smo izvedeli , so na ministrstvu za okolje in prostor pripravili spremembo uredbe , ki je potrojila takso za ogljikov dioksid .	ogljikov	20	Ind
Leninova nova ekonomska politika ( NEP ) je po oktobrski revoluciji predstavljala nekajletni predah , ko so dovolili delovanje trga .	nekajletni	12	Def
Kot bi ruj želel , da ga ne pozabimo do prihodnje pomladi , ko bo zopet lep , lepši , najlepši .	najlepši	20	Def
Dogovarjamo se z uglednim britanskim kustosom Henryjem Meyricem Hughesom - pripravil naj bi razstavo mednarodne umetnosti 20. stoletja , ki bo v dialogu z našo zbirko , ker bi na ta način našo zbirko postavili v mednarodni kontekst .	mednarodni	36	Def
Ujela sem Jasnin presenečeni in hkrati jezni pogled .	presenečeni	3	Def
ja predvsem gre v prvi vrsti za preventivne ukrepe [:voice] mislim da je lahko zelo preprost primer	preprost	15	Ind
Tanja se v takšnih trenutkih počuti , kot bi bila potisnjena na stranski tir .	stranski	12	Def
Rudolph je bil vreden deset Alexov Crossov in zdaj je bil mrtev .	mrtev	11	Ind
kar dober spodnji del je odpeljala putzerjeva vendar na koncu vendarle tri stotinke zaostanka obe italijanki na koncu zelo zelo blizu	dober	1	Ind
ne in tako eee i [gap] veš kakšen lep kostanj kako dober sladek	lep	8	Ind
HELSINKI , 20. Izraelski zunanji minister Šimon Peres je včeraj med obiskom v Helsinkih izrazil previden optimizem glede morebitnega vnovičnega začetka bližnjevzhodnega mirovnega procesa po odločitvi Izraela , da se postopno umakne z območja Gaze in Betlehema .	zunanji	4	Def
Namesto sedmih v evropski parlament izvoljenih slovenskih poslancev naj bi v državni zbor sedli Darja Lavtižar Bebler , Breda Pečan , Matjaž Falkner in Siniša Germovšek	evropski	3	Def
Skrajni čas je , da se odločite , komu boste naklonili svoja čustva .	Skrajni	0	Def
Najštevilčnejši je bil prav slednji zbor , ki ga sestavlja kar 36 pevcev .	Najštevilčnejši	0	Def
Tehnološki park je zasnovan kot oblika t. i. podjetniških inkubatorjev , kjer novoustanovljena inovacijska podjetja dobijo pomoč lokalne skupnosti ali države z namenom , da pod ugodnejšimi pogoji razvijejo in ustvarijo pogoje za samostojno delovanje .	zasnovan	3	Ind
V območju visokega zračnega tlaka bo nad naše kraje pritekal toplejši zrak .	toplejši	10	Def
Seveda so primerni tudi računalniki z AMD-jevimi procesorji , ki so vsaj toliko zmogljivi kot omenjeni Intelov procesor .	Intelov	16	Ind
Že vidimo , kajne , kako nam Kajn postaja bližji , kako nismo zaman njegovi potomci .	bližji	9	Def
Pravni diskurz poleg tega pripada visoko specializiranim idiomom .	Pravni	0	Def
Končana je bila obnova fresk v ladji , na ostenju gotskega okna , delno pa so tudi restavrirali stranski baročni oltar sv. Marka v cerkvi na Bregu pri Žirovnici .	baročni	19	Def
tvoja igra tvoj premierni hitri kviz se začenja zdaj	premierni	3	Def
Prav tako izzivalna je zelo rafinirana zgodba drame , čeprav je bil to prvenec tega avtorja ; tematsko prepoznaven in sprejemljiv za današnji čas je tudi dramatikov gnev , ki je uporaben za navezavo te igre na sodobnost .	sprejemljiv	20	Ind
ZVZD JE NOV , VSEOBSEŽEN PRAVNI VIR SODOBNE ZAKONSKE UREDITVE VARNOSTI IN ZDRAVJA PRI DELU , KI JE NADOMESTIL DOTLEJ VELJAVNI ZAKON O VARSTVU PRI DELU IZ LETA 1974 .	PRAVNI	5	Def
Misel , da se Cornelia II ne ziblje več ošabno na vodi , mu je pognala prijeten , skoraj čuten drget po telesu .	prijeten	16	Ind
Tako je bil včeraj obiskan profesionalni teniški turnir ATP v Domžalah , ko je nastopil Mariborčan Iztok Božič .	profesionalni	5	Def
Na to karto bo po vsej verjetnosti zdaj igral Alejandro Toledo , nesojeni zmagovalec letošnjih volitev , le da bo moral ubrati drugo pot .	nesojeni	12	Def
Ker je neuspeli predsedniški kandidat in » edini slovenski politični zapornik « Joško Joras na dan državnosti na svoji hiši spet obesil slovenski zastavo , so jo hrvaški policisti odstranili , sodniku za prekrške pa poslali kazensko ovadbo .	predsedniški	3	Def
Svetovni prvak in rekorder Maurice Greene je za zmago tekel 9,97 , a ni uresničil svojih napovedi o 9,80 .	Svetovni	0	Def
Bil je pravzaprav pošteno sit vsega .	sit	4	Ind
Če je vodilo neke nacionalne pripadnosti kakršen koli finančni , materialni ali drugi interes , potem lahko sklepamo , da je bilo leta 1991 več Italijanov zato , ker se je tedaj po takšni logiki izplačalo biti Italijan .	finančni	8	Def
Tako je vsako leto nepogrešljiv labirint , pa nogomet , je za konec Mateja poskušala preglasiti glasno glasbo , na katero so čebelica in medvedki poplesavali .	nepogrešljiv	4	Ind
Seviljski vrh Evropske unije po vsej verjetnosti ne bo zapisan v anale evropske zgodovine kot prelomen dogodek .	Seviljski	0	Def
Nasledil ga je sin Oton I. , prvi sveti rimski cesar .	rimski	9	Def
Da bi v ljudski stranki nastala zaradi spornih finančnih poslov kakšna posebna notranja trenja , ki bi bila lahko nevarna za Podobnikov predsedniški stolček , namreč za zdaj ni pričakovati .	Podobnikov	21	Ind
Uporaba Podaja nivo sklada škatle in ali škatla uvede lokalen skladovni kontekst .	lokalen	9	Ind
Velikanski zabaviščni prostor je ograjen in mrki redarji preverjajo vsak nahrbtnik posebej .	zabaviščni	1	Def
Nokia 7270 ima na boku gumb , ki je namenjen samo tej funkciji .	namenjen	9	Ind
znaš kaj to je bilo oni dan noben ni smel biti frej	frej	11	Ind
Šeligov slog je zato težak , izrazito hermetičen , poln nakazanih podob in pomenov , ki jih bralec večkrat le zasluti , povsem jasno razvozlati pa jih ne more .	hermetičen	7	Ind
Vremenski vpliv na splošno počutje in razpoloženje ljudi bo ugoden in spodbuden .	Vremenski	0	Def
Romantični sloves si je prislužil s povestmi Tisoč in ena noč .	Romantični	0	Def
MARIBOR , 11. - Tukaj so imeli dvodnevni programski sestanek vodilni sindikalisti kovinsko predelovalne in elektro industrije držav Višegrajske skupine in iz bivših republik Jugoslavije , le črnogorski sindikalist je poslal samo spodbudne telegramske pozdrave .	črnogorski	27	Def
Prav tako izzivalna je zelo rafinirana zgodba drame , čeprav je bil to prvenec tega avtorja ; tematsko prepoznaven in sprejemljiv za današnji čas je tudi dramatikov gnev , ki je uporaben za navezavo te igre na sodobnost .	prepoznaven	18	Ind
PREDVSEM JE BIL NLRA UZAKONJEN Z NAMENOM , DA DELAVCI Z ZDRUŽEVANJEM V DELAVSKA ZDRUŽENJA IN S KOLEKTIVNIM POGAJANJEM PREK TEH ZDRUŽENJ REŠUJEJO MOREBITNE PROBLEME PRI DELU TER TAKO IZBOLJŠAJO DELOVNE RAZMERE IN POGOJE NA SVOJEM DELOVNEM MESTU .	UZAKONJEN	4	Ind
V svoji vili na španskem otoku Mallorci je 52 - letni Skase umrl zaradi raka na želodcu .	letni	10	Def
Ta proces je počasen in v njem je bilo več porazov in zlomov kot pa trajnih uspehov , vendar pa počasi le oblikuje držo posameznikov in skupnosti .	počasen	3	Ind
V teh dneh pričakujejo tudi pravno mnenje , ki je drugačno od vladnega in po katerem naj bi bilo mogoče sanacijski program spreminjati tudi večkrat .	sanacijski	20	Def
Potem ko je prvo partijo z Drejevom mirno remiziral , je bil kot beli vse drugače razpoložen in v zanj značilnem slogu zanesljivo zmagal .	beli	13	Def
Organizacijski komite namreč ni uspel najti dovolj sponzorskih sredstev .	Organizacijski	0	Def
Opazen ni bil nikakršen razpoznaven red ali kronološka oziroma geografska postavitev , kategorije in klasifikacije so ostale le delno razpoznavne .	Opazen	0	Ind
Tudi Makavejev je izrazit zbiralec časopisov - skoraj vse ideje za svoje filme je našel v raznih črnih kronikah in podobnih zapisih .	izrazit	3	Ind
Koliko ta specifični način prodaje odloča o vsebini časopisa ?	specifični	2	Def
Ob mladem , čednem Henriku v razcapani obleki je bil pritlikavi Gregor s papeško krono videti še bolj droban .	droban	18	Ind
Oba sta razumela ta izbrani užitek ki je bil toliko močnejši , čim bolj prepovedan je bil .	močnejši	10	Def
Moram pa reči , da čebele zelo dobro prenašajo nizke temperature in da jim je bolj potreben svež dotok zraka kot pa pretirana toplota .	svež	17	Ind
Bolgarska cerkev pa je popularne knjige o Harryju Potterju označila kot duhovni aids za bralce , saj naj bi oslabile imunski sistem proti črni magiji in jih napravile dovzetnejše za zlo .	imunski	20	Def
Zmešajte paradižnikovo mezgo in sveži sir , da dobite gosto omako .	sveži	4	Def
Tehnološki park je zasnovan kot oblika t. i. podjetniških inkubatorjev , kjer novoustanovljena inovacijska podjetja dobijo pomoč lokalne skupnosti ali države z namenom , da pod ugodnejšimi pogoji razvijejo in ustvarijo pogoje za samostojno delovanje .	Tehnološki	0	Def
In prijateljica reka jo je vzela v svoj blagi objem , si položila njeno utrujeno glavo na prsi in utišala bolečino .	blagi	8	Def
OCENA SE VPIŠE V OSEBNI LIST .	OSEBNI	4	Def
Glede na to , da je že začetek razprave o skupnostih istospolnih partnerjev poln stereotipov in kvaziargumentov , si lahko samo mislimo , kam bo razprava zašla , ko bodo politiki nehali opletati z izbrisanimi in džamijo .	poln	13	Ind
tisti ki se bo vpisal za poklic mizar oziroma lesarski tehnik eee bo skorajda že v prvem letniku imel zagotovljeno službo	lesarski	9	Def
Na primer zdravila proti revmatizmu in strjevanju krvi so tipičen primer z zapleti na področju prebavne cevi , ki lahko delajo hude težave .	tipičen	9	Ind
Pomemben pogoj je stopnja gospodarske razvitosti , kar pomeni , da morajo pred polnopravnim članstvom Slovenije osebni dohodki njenih državljanov dosegati vsaj 50 ali 60 odstotkov povprečnega evropskega dohodka .	Pomemben	0	Ind
Gospod Bojan Prašnikar je lahko cenjeni strokovnjak , vendar bi mu morali dosmrtno prepovedati sokomentiranje nogometnih tekem .	cenjeni	5	Def
Morfologija : Ima visok , na bokih stisnjen trup , velika usta s številnimi majhnimi zobmi in daljšo spodnjo čeljustjo .	visok	3	Ind
Za generična zdravila ni potreben noben denar več za raziskave in razvoj .	potreben	4	Ind
Za mnoga podjetja je skladišče podatkov prvi program , narejen po načelu strežnik / odjemalec .	narejen	9	Ind
avtor ni poznan	poznan	2	Ind
Pravilni odgovor se glasi : knjiga je v ovitku škatli od kasete .	Pravilni	0	Def
Pomembna novost je tudi dodaten postopek za izbor izvajalcev na področju gradnje športnih objektov .	dodaten	4	Ind
Razvojni krog hruševe rje je naslednji : zelo nežne spore ( bazidiospore ) s smrdljivega brina v pozni spomladi okužijo hruševo listje .	Razvojni	0	Def
ne smemo pozabiti da je poljski nogomet v zadnjih mesecih doživljal hude pretrese s podkupovalnim škandalom v poljski nogometni zvezi	poljski	5	Def
Nujno je , da prosite svojega izbranega zdravnika , naj vas napoti na specialni pregled tja , kjer bo možno ugotoviti vzrok in naravo vašega obolenja .	specialni	13	Def
ja [gap] najbolj dobro tudi kras je blizu kar je tudi super eee pa veš tam se ti odpre nekaj česar mislim širina ja v bistvu	super	11	Ind
Pri slikanju je to , kar imate , neposreden rezultat dotikanja s čopičem .	neposreden	8	Ind
Celjski župan Bojan Šrot je iz Kanade sporočil , da je bil skupaj z drugimi predstavniki občine obeh nagrad zelo vesel .	Celjski	0	Def
Pomolila mi je rumen plastičen pretvornik valut v obliki evroračke .	rumen	3	Ind
Za pričakovani donos so pripravili tri ocene .	pričakovani	1	Def
Na podlagi teh in drugih proučevanih podatkov je hrvaški Jadran uvrščen med prednostna področja za proučevanje in zaščito glavatih želv v okviru načrta zaščite morskih želv Mediterana organizacije UNEP .	uvrščen	10	Ind
Preprost račun .	Preprost	0	Ind
tvoja igra tvoj premierni hitri kviz se začenja zdaj	hitri	4	Def
že odkar je [gap] majčken	majčken	4	Ind
Poletna suša je sicer res močno zmanjšala količino vode v njeni strugi , a to nikakor ni bila ovira za odličen spust .	odličen	20	Ind
Zanimivo je , da imajo ljudje z znižano toleranco na glukozo oba holesterola povsem normalna , imajo pa visok CRP .	visok	18	Ind
Takratni umetniški vodja	umetniški	1	Def
Če pa se tečaj ponovno odbije od 20.000 tolarjev , lahko pričakujemo vsaj petodstotni porast .	petodstotni	13	Def
Po končani karieri brazilski nogometaš Giovanni ( na sliki ) ne bo vložil denarja v gostinski lokal ali ostal v tem športu kot trener , ampak bo svoje zadovoljstvo poiskal v veri .	gostinski	15	Def
Občina Šempeter Vrtojba je konec leta 1999 ustanovila Mednarodni tehnološki park Plejade , v katerega so julija letos kot družbeniki pristopile občine Kanal ob Soči , Brda , Bovec in Vipava .	tehnološki	9	Def
Mag. Franc Avberšek , direktor velenjskega podjetja , ki je skupaj s Kulturnim centrom Ivana Napotnika iz Velenja in z mentorji zasnoval raziskovalni tabor , je zelo zadovoljen z letošnjim potekom tabora , udeleženci in z njihovimi dosežki .	raziskovalni	22	Def
Ljubiteljev konjeniškega športa je namreč v Angliji še vedno veliko in za neposredni prenos dirke Grand National jih niso želeli prikrajšati .	neposredni	12	Def
Prevzeli so me razni prehodi , luknje v steni , ki so spominjale na švicarski sir , nič manj zanimivi niso evkalipti , ki rastejo ob vznožju .	švicarski	14	Def
Vprašam ga , če je lačen .	lačen	5	Ind
Morfologija : Ima dolg , vitek trup , koničasto glavo in gobec z majhnimi krajnimi usti ter precej daljšo spodnjo čeljustjo .	dolg	3	Ind
Materina ljubezen , če je prava , ne zahteva povračila ; spolna ljubezen pa pričakuje neposredni odmev svojega dajanja .	neposredni	15	Def
Do tega je upravičen le upravljalec javne poti ( občina , komunalno podjetje ) , kamor naslovite vaš zahtevek .	upravičen	3	Ind
Toda videz , ki se ponuja naključnemu opazovalcu , ko z mostička nad avtocestno pentljo opazuje tekoči promet velikih priklopnikov , ki se vzpenjajo proti cestninski postaji , zavaja .	tekoči	16	Def
Osnovni razlogi za uporabo krajevnega spleta so enaki razlogom , ki so povzročili eksplozivni razmah Interneta v zadnjem letu in pol .	eksplozivni	13	Def
Jaka je še bolj jezen .	jezen	4	Ind
Predstavitev je potekala v sodelovanju z Osnovno šolo Ljudski vrt .	Ljudski	8	Def
Delitev na službeno in zasebno življenje je v Sloveniji vsemu družinskemu podjetništvu navkljub še zelo močna , vendar stopamo v precej drugačen svet .	drugačen	21	Ind
MURSKA SOBOTA , 21. - V sredo okrog 18. ure se je v naselju Ivanjševci pri Prosenjakovcih na Goričkem pripetila tragična prometna nesreča , v kateri je izgubil življenje dveletni otrok .	dveletni	29	Def
ni neka napetost je že nekaj časa opaziti v njeni vožnji ni tiste sproščenosti in seveda ne moreš biti hiter na silo se ne da s silo prej	hiter	19	Ind
Ko se je nadaljevalo sojenje predsedniku Clintonu , je ta v svojem letnem sporočilu predlagal , da bi okrog 2,7 bilijona dolarjev načrtovanih proračunskih presežkov v naslednjih 15 letih namenili za pokojninski sistem .	pokojninski	31	Def
Na splošno , če pregledamo teh 22 let , vidimo , da se je mariborski gledališki ansambl iz svojih začetnih uspehov dvigal vedno više .	gledališki	15	Def
Za pomemben del gospodarstva je članstvo v ERM 2 dvorezen meč .	dvorezen	9	Ind
Vsi dosedanji načrti za zmanjšanje svetovne revščine so se izjalovili , kar sta pred leti priznali tudi Svetovna banka in Mednarodni denarni sklad .	denarni	21	Def
Iz jame smo se vrnili kot prerojeni in si ogledali Predjamski grad .	Predjamski	10	Def
Naši viri nam brez dvoma predstavljajo samo določen odstotek prebivalstva .	določen	7	Ind
Mladi so se umaknili v lokal in po Šinkovčevih besedah naj bi bili vrata zaklenili , nato pa jih spet odklenili in dopustili , da so policisti opravili varnostni pregled .	varnostni	28	Def
zdaj nekateri pravijo da j [gap] dvojni agent trojni agent da j [gap] trojanski konj ne vem kaj	trojni	8	Def
[gap] recimo eem bencinski motor ima pa zelo različne izkoristke pri nizkih ali pa pri visokih obratih ne	bencinski	3	Def
Urad za preseljevanje in begunce bo , če bo zakon sprejet , deloval podobno kot Študentski servis .	sprejet	10	Ind
david healy je imel priložnost za šestintrideseti reprezentančni gol	reprezentančni	7	Def
[audience:laughter] pa še eden je eem mislim pred eno bajto stoji en ful velik snežak tako dvometrski najmanj [audience:laughter]	dvometrski	16	Def
Vrednost indeksa SBI 20 je višja za tri desetine , bila bi pa še višja , če bi izločili negativni učinek tečaja delnic Banke Koper , ki se je znašla v " poprevzemnem vakumu " .	negativni	19	Def
Za gorivo uporablja neosvinčeni bencin .	neosvinčeni	3	Def
eee sklenina ponavadi sega do dlesni potem pa če se malo odmakne pa da je tam kakšen mali žepek eee pri dlesni je potem razgaljen dentin	razgaljen	24	Ind
To je bil najdaljši polet kateregakoli space shuttla v zgodovini , preučevali pa so predvsem , kako vesoljska potovanja učinkujejo na človeški organizem .	človeški	21	Def
Odkar je veliki beli morski pes postal slaven , ga neusmiljeno lovijo .	beli	3	Def
Njej je v zbirki enajstih izbirnikov posvečen še celoten izbirnik .	posvečen	6	Ind
Takrat bo verjetno tudi že znan točen datum začetka izdaje maloobmejnih prepustnic oziroma rok , do katerega naj bi bil uveljavljen nov režim prehajanja meje v skladu s sporazumom .	uveljavljen	20	Ind
Profesor Osolnik iz Ljubljane , ki je bil izbran za šefa te komisije , nas je pri tem obvestil , da je Univerza v Ljubljani odobrila tri nove programe za poljski , češki in slovaški jezik .	slovaški	34	Def
Pojav imenujemo Meissnerjev efekt , njegova posledica pa je tako imenovana magnetna levitacija .	Meissnerjev	2	Ind
Pojasnite , da vam ni nič dolžan in da upate samo to , da bo tudi on skušal pomagati drugim alkoholikom , ko se bo sam izvlekel iz težav .	dolžan	6	Ind
Dokupljena doba je obdobje , določeno z zakonom , v katerem zavarovanec ni vključen v obvezno ali prostovoljno pokojninsko in invalidsko zavarovanje , šteje pa se v zavarovalno dobo pod pogojem plačila prispevkov .	vključen	13	Ind
Da je bil mogoče ranjen ali da je izgubil spomin .	ranjen	4	Ind
Vidim te v majici , ki je bela le od daleč , tako kot je čist in lep le oddaljeni spomin , kako se počasi sprehajaš z rokami na križu , po edini cesti skozi vas .	čist	15	Ind
LJUBLJANA Dvajsetletni B. K. iz okolice Iga in 23 - letni R. J. iz Ljubljane sta hotela iz trgovine v Čopovi ulici ukrasti jakno .	Dvajsetletni	1	Def
Ko pa njegov motor končno » vžge « , je Vodnar svoboden , domiseln in neverjetno vzdržljiv ljubimec .	svoboden	11	Ind
Odbor je temeljito proučil navedeni predlog zakona in soglasno podprl , da se tak predlog zakona uvrsti na dnevni red te seje Državnega zbora .	navedeni	4	Def
Ko sem zapuščal pisarno , sem videl , kako se je mlad kriminalist , zadolžen za pogrešane osebe , nasmehnil kolegu in kolega mu je nekaj zašepetal , potem sta se oba zahahljala .	zadolžen	14	Ind
Odlok o preimenovanju Vipavskega Križa je že pripravljen , o njem naj bi ajdovski občinski svet odločal v četrtek	občinski	14	Def
Kolpa je gotovo najbolj priljubljena reka za tovrstni aktivni oddih .	aktivni	8	Def
Po njegovih besedah je sprememba veljavnega zakona na področju olajšav začasna , saj bo novi sistemski zakon uveljavil drugačna načela .	sistemski	15	Def
Za navaden avtomobil je treba odšteti okrog 6500 tolarjev mostovine , vožnja po celotnem objektu pa traja od 15 do 20 minut .	navaden	1	Ind
Medtem ko so v središču nova stanovanja po blizu 4 tisoč mark za kvadratni meter , dosegajo v štajerski prestolnici največ 2300 mark .	kvadratni	13	Def
Zaupanje javnosti v pravosodni sistem je steber vladavine zakona .	pravosodni	3	Def
Pogovarjala sva se le nekaj dni pred njegovim odhodom na julijsko zasedanje upravnega odbora v Kopenhagnu , medtem pa je bil Koršič tudi izbran za podpredsednika izvršnega biroja Eurimagesa .	izbran	23	Ind
Kmetijski minister dr. Milan Pogačnik je o tem povedal : » Mnenja glede učinkovitosti letalske obrambe s posipavanjem srebrovega jodida so deljena .	Kmetijski	0	Def
Kolpa je gotovo najbolj priljubljena reka za tovrstni aktivni oddih .	tovrstni	7	Def
ker sem se poročil z njeno hčerko in imeli smo veliko skupnih interesov tudi glasbo no zato sem tudi eee za konec izbral eno skladbo ki jo je imela zelo rada in danes bi imela rojstni dan	rojstni	35	Def
Naš poglavitni namen je socialna pravičnost .	poglavitni	1	Def
Opombe : Je sladkovodni predstavnik rodu Aplodinotus , ki lahko z ribjim mehurjem izvabljajo glasove , podobne godrnjanju .	sladkovodni	3	Def
novi predsednik zveze je legendarni grzegorz lato	legendarni	4	Def
Ko jo je dobil Bojan Tokič , pa je moral matični klub Maximarket Olimpija za njegov nastop na evropskem prvenstvu plačati blizu 300.000 tolarjev .	matični	10	Def
V Občini Polzela so že sklicali občne zbore , na katerih so krajani predlagali člane krajevnih odborov , potrdil pa jih bo občinski svet na predlog komisije za mandatna vprašanja , volitve in imenovanja .	občinski	22	Def
Organizatorji so prepričani , da bo plesna kultura , ki je že osvojila južni del Slovenije , pritegnila na podobne prireditve tudi ostale Slovence .	južni	13	Def
OTOČEC - V soboto , 11. maja , od 15. ure dalje se bo restavracija Tango na Otočcu spremenila v pravi plesni center .	plesni	21	Def
Pevec skupine U2 Bono je znan po humanitarni pomoči žrtvam katastrof po vsem svetu .	znan	5	Ind
Kot bi tekmovali , kdo bo zagrešil hujši vojni zločin .	vojni	8	Def
Ob navedenih primerih rabe govorice naletimo tudi na različne kombinacije , kot so : “ milostni ” strel , strel iz “ usmiljenja ” , vendar bi tudi analiza teh zvez pokazala podobne rezultate .	milostni	15	Def
