Na Podkarpaciu oficjalnie kampania żniwna zacznie się w przyszłym tygodniu .	Podkarpaciu	1	Neut
Wzrasta temperatura rozmów o prawyborach w AWS .	AWS	6	Fem
Angelina oczywiście wyraziła chęć ponownego zagrania Lary Croft .	Lary	6	Fem
Wieś leży na Szlaku Zamonitu z Błędowa do Poraja .	Zamonitu	4	Masc
A Zakopane było zapyziałe .	Zakopane	1	Neut
W jakim języku rozmawia się z Japonią ?	Japonią	6	Fem
Gdy KOT usiadł na ławeczce Juliana Tuwima , poeta nie krył zdziwienia z tego niecodziennego spotkania .	Juliana	5	Masc
Polonia zagrała bez trzech piłkarzy z podstawowego składu .	Polonia	0	Fem
Polski samolot M-28 rozbił się i eksplodował kilka sekund po starcie z lotniska w Puerto Cabello , 200 km na zachód od Caracas .	Cabello	15	Neut
W stoisku PDT największe powodzenie mają fartuszki dziewczęce i chłopięce .	PDT	2	Neut
Koncern nadal ma umowy licencyjne z producentami w Japonii , Włoszech , Afryce Południowej i na Filipinach .	Filipinach	16	Neut
Przenosi obojętne spojrzenie na stronę z nekrologami , którą Gabriela przygważdża do stołu kościstym palcem .	Gabriela	9	Fem
Poproszę pana senatora Józefa Kuczyńskiego .	Kuczyńskiego	4	Masc
W metodzie Cieszyńskiej najważniejsza jest rozmowa .	Cieszyńskiej	2	Fem
W samej Warszawie w Internecie swoje auta eksponuje już kilkadziesiąt komisów .	Warszawie	2	Fem
Nie ma też dowodów , by Pietruszka był agentem KGB , choć SB ściśle współpracowała z Rosjanami .	SB	12	Fem
W Burkina Faso dominują muzułmanie .	Faso	2	Neut
Produkcję nadzorował w Krośnie Jerzy .	Krośnie	3	Neut
Oprócz absolwentów przybyli także dawni dyrektorzy i nauczyciele Nowodworka .	Nowodworka	8	Masc
Minister obrony Tengiz Kitowani , były premier Tengiz Sigua i szef milicji Mchedrioni Dżaba Joseljani obalili przed rokiem prezydenta Zwiada Gamsahurdię .	Dżaba	13	Masc
Elizabeth cofnęła się , może lepiej , żeby jej tu nikt nie widział .	Elizabeth	0	Fem
Podobną akcję przeprowadzono w czasie wojny w Zatoce Perskiej w 1990 r.	Zatoce	7	Fem
Żonę ma w Stanach Zjednoczonych , dorosłym dzieciom powodzi się dobrze .	Stanach	3	Neut
W Drygałach koło Białej Piskiej zatrzymany do kontroli 47-letni kierowca zionął na policjantów czosnkiem .	Drygałach	1	Neut
Uczestniczki wysłuchały wykładów doradców zawodowych i prawników , uczestniczyły w zajęciach psychologicznych , poznawały podstawy obsługi komputera i korzystania z Internetu .	Internetu	20	Masc
John Glenn pochodzi z Ohio .	Ohio	4	Neut
Na piersiach dyndały im krzyże z Jezusem Chrystusem .	Jezusem	6	Masc
Gdy Dominika przyjechała po matkę , Babel dożywał swych dni .	Babel	6	Masc
Po tej wypowiedzi papieża zapytaliśmy księdza Tadeusza Isakowicza - Zaleskiego , gorącego zwolennika lustracji , jak odebrał te słowa .	Isakowicza	7	Masc
Wczesnym popołudniem polska delegacja udała się do Warny .	Warny	7	Fem
40-osobowa grupa chuliganów wywołała rozróbę przed sobotnim III-ligowym meczem piłki nożnej Lublinianki z Cracovią .	Cracovią	13	Fem
A Rychtarski i Ziemiak uzyskali rezultaty lepsze niż trzeci senior .	Ziemiak	3	Masc
Amerykanie patrząc zza Oceanu na Europę myślą niemal wyłącznie kategoriami strategicznymi i gospodarczymi .	Europę	5	Fem
To jeden z najdroższych sylwestrów na Mazowszu .	Mazowszu	6	Neut
Towarzysz jego wzywał Jezusa i jego Matkę , a tacy ludzie jak Esteban wołają te słowa tylko twarzą w twarz ze śmiercią .	Jezusa	3	Masc
Niestety , Sąd Rejonowy w Kutnie nie jest w stanie takowego uzasadnienia wydać .	Kutnie	5	Neut
- Naprawdę przyjechał eś do mnie , Maksiu ?	Maksiu	7	Masc
Na parkingu do samochodu Kosińskiego dosiadł się Osiński .	Osiński	7	Masc
Mundek zasiadł jak zwykle przy pianinie , Czesiek kiwał się przy kontrabasie .	Czesiek	7	Masc
Podobnie jak we współczesnej Japonii , również w Tybecie żywe są dawne herbaciane tradycje , chociaż przyczyny ich kultywowania są zgoła odmienne .	Japonii	4	Fem
I zrozumieli ludzie , że tu Bóg był , i zburzyli ten sądowy dom , aby w nim nikt już więcej po Panu Jezusie nie sądził , a przed jabłonnymi drzewami postawili krzyż i on do dziś tam stoi .	Jezusie	23	Masc
Następnym mówcą będzie pan poseł Kazimierz Wilk .	Wilk	6	Masc
Janina Michaluk leży w szpitalu w Gryficach .	Michaluk	1	Fem
Kochał Dorę , ale nie potrafił odejść od Zofii , swej żony .	Dorę	1	Fem
Doświadczenie zawodowe zdobyła pracując w teatrze i telewizji w Polsce i na Ukrainie .	Ukrainie	12	Fem
- W Janowie to była dziecinada .	Janowie	2	Masc
Władysław Zęb szarpnął kierownicą .	Zęb	1	Masc
Dziękujemy w imieniu Agnieszki Kulig .	Kulig	4	Fem
Wykonanie całej inwestycji zlecono Przedsiębiorstwu Budowy Dróg i Mostów ze Świecia .	Świecia	10	Neut
- A jeszcze niedawno mówił eś o pani Gronkiewicz tak ciepło .	Gronkiewicz	8	Fem
TP SA chce złagodzić planowane redukcje .	TP	0	Fem
Ziuta uściskała go i ucałowała w oba policzki .	Ziuta	0	Fem
Na terenie przyległym do Kolonii Wierzbicy znajdują się dwie garbarnie .	Wierzbicy	5	Fem
Zresztą padało na północy i wschodzie , zaś susza dotknęła przede wszystkim Polskę południową .	Polskę	12	Fem
Tragiczny wypadek zdarzył się na trasie kolejowej z Piły do Chojnic .	Piły	8	Fem
Co to był COP ?	COP	3	Masc
Tu impet Luftwaffe się załamał .	Luftwaffe	2	Masc
Polak zajął drugie miejsce .	Polak	0	Masc
– Jadę do Frisco .	Frisco	3	Neut
Pani Bentley okazała się bardzo miłą i gościnną kobietą .	Bentley	1	Fem
sika w Stanach .	Stanach	2	Neut
Konwój został zaatakowany w okolicach An Numaniyah w prowincji Wasit .	An	5	Neut
– Myśli pan , że Michnik albo Geremek mają mniej ?	Michnik	5	Masc
- Najważniejsza była dla mnie w tej chwili Majka .	Majka	8	Fem
Amerykanie wzięli La Haie du Puy .	Haie	3	Neut
Sanki pomknęły po ubitym śniegu na Pohulankę .	Pohulankę	6	Fem
O planach grupy biznesmenów z Łeby mówi się coraz głośniej .	Łeby	5	Fem
Wcześniej szefował ZOZ-owi w Piasecznie .	Piasecznie	4	Neut
Na polach Domatowa i Polchowa usypano wysokie mogiły .	Polchowa	4	Neut
– Talar akurat skłócił tam tych ludzi .	Talar	1	Masc
Ashram w Magliano Sabina to ośrodek dla małych dzieci Sahaja Yoginów .	Sabina	3	Neut
- Z Torunia przybył em .	Torunia	2	Masc
Widać , że gabinet Millera stopniowo traci kontakt z rzeczywistością .	Millera	4	Masc
Dwukrotnie SKO przyznało im rację .	SKO	1	Neut
Nieoficjalnie wiadomo , że Krzysztof Jagiełło , znany w środowisku SLD jako doskonały organizator , był w tej sprawie w sobotę w Warszawie .	Warszawie	22	Fem
Wilczyński nadal był zdziwiony , ale pokiwał głową .	Wilczyński	0	Masc
Holendrzy nie mają odwagi iść za nimi .	Holendrzy	0	Masc
Jeszcze z parasolem występuje Dominika Bukowska i pani Jagoda ogłasza kolejną przerwę .	Jagoda	8	Fem
Teofil trzymał je w ręce , aby włożyć dopiero w ostatniej chwili .	Teofil	0	Masc
Przypomnijmy , że przed laty Jelcyn nie wysiadł na spotkanie z irlandzkimi władzami .	Jelcyn	5	Masc
Doron skoczył do przodu .	Doron	0	Masc
Pojawia się w niej panna Jane Marple , detektyw - amator .	Marple	6	Fem
Z oficjalnym żądaniem wobec MKOl , złożonym na piśmie , wystąpił Narodowy Komitet Olimpijski KRLD , domagając się od naczelnej władzy sportowej rewizji listy triumfatorów olimpijskich .	MKOl	4	Masc
Był pan organizatorem takiego niestrawnego politycznie obiadu w Drawsku .	Drawsku	8	Neut
W Stanach istnieje taka zasada , że pracownik naukowy uniwersytetu może raz na trzy lata startować w konkursie na innej uczelni .	Stanach	1	Neut
Piłkarze FC Porto zapewnili sobie wczoraj ponownie tytuł mistrzów Portugalii .	FC	1	Neut
Leci z Milwaukee do Pekinu na chiński Nowy Rok .	Milwaukee	2	Neut
- Przypomniał em sobie obie Prylińskie i kaszankę .	Prylińskie	5	Fem
Zajmowały się tym już Zofia Korczak - Blatonowa i Aniela Cieszkowska .	Korczak	5	Fem
O’Donellowie siedzieli przy ognisku .	O’Donellowie	0	Masc
Goran Persson , premier Szwecji , napisał niedawno książkę .	Goran	0	Masc
Mana wypiła łapczywie kilka łyków .	Mana	0	Fem
Mora nie był urodziwy .	Mora	0	Masc
Wpadł na warszawskim Bemowie .	Bemowie	3	Neut
Odeszli , choć mogli zapytać o to i owo w samym Betlejem .	Betlejem	11	Neut
Tylko w czterech państwach w Europie pojawiły się sieci DCS .	DCS	9	Neut
Złoty medal w kategorii do 68 kilogramów zdobyła Kamila Zgolak .	Kamila	8	Fem
Szef czeczeńskiej delegacji Usman Imajew , zanim zachorował , powiedział dziennikarzom , że obie strony osiągnęły już porozumienie .	Imajew	4	Masc
Eweliny nigdzie nie było widać .	Eweliny	0	Fem
Na jego otwarcie zjechali się przedstawiciele PSP w Warszawie , władze gminne , powiatowe oraz państwowe .	PSP	6	Fem
Miesiąc temu posadę stracił komendant powiatowy z Braniewa , który w komendzie był w stanie nietrzeźwości .	Braniewa	7	Neut
Wraz z kadrą wyjadą Daria Kasperska , Paulina Rytwińska i Agnieszka Karcz .	Agnieszka	10	Fem
Teraz to wszystko staje się naprawdę , doczekał się Stefan Chmura Piaskowej Góry .	Góry	12	Fem
Wówczas Martę strach przejął .	Martę	1	Fem
Wśród przyjezdnych jest młoda Jadzia Maślak .	Maślak	5	Fem
W Wielkopolsce brakuje 300 gliniarzy .	Wielkopolsce	1	Fem
Teoretycznie George powinien więc być spokojny .	George	1	Masc
Niedługo po tym apelu Kamiński , Wołek i Jurek spotkali się na podwieczorku u krzywdzonego Pinocheta .	Jurek	8	Masc
Także w ubiegłym roku zniszczono nagrobki na cmentarzach w Gdyni i Kielcach .	Kielcach	11	Neut
Ten biało - czarny kocur zdobył szturmem serca pracowników Downing Street , a z czasem jego sława rozprzestrzeniła się na cały kraj .	Street	10	Fem
Za Wojciechowską przemawia jeszcze jeden argument .	Wojciechowską	1	Fem
Do smutasów należy również minister rolnictwa Krzysztof Jurgiel .	Jurgiel	7	Masc
Zmniejszył szanse elekcyjne Marka Borowskiego .	Marka	3	Masc
Wyrok śmierci zostaje zamieniony na 10 lat Syberii .	Syberii	7	Fem
Choroba Ani zaczęła się niewinnie .	Ani	1	Fem
Po trzecie , Iwan nie czytał oczywiście ani Freuda , ani ponurej antyutopii Williama Goldinga .	Iwan	3	Masc
Luiza słyszała nad sobą kroki Weelsa .	Luiza	0	Fem
Pestka nigdy dotąd nie pytała o takie rzeczy .	Pestka	0	Fem
Twarz Gabrieli była szara .	Gabrieli	1	Fem
Wraz z kadrą wyjadą Daria Kasperska , Paulina Rytwińska i Agnieszka Karcz .	Kasperska	5	Fem
Wacek uciekł z domu .	Wacek	0	Masc
Sołtys Ligoty Stanisław Kuźnik składa serdeczne podziękowanie wszystkim sponsorom , którzy przyczynili się do zorganizowania festynu i dzięki którym dzieci z Ligoty będą mogły pojechać na wycieczkę .	Kuźnik	3	Masc
Jakimiszyn pochodzi z Baku , tu do dziś mieszka jego matka .	Baku	3	Neut
– bo ty był eś na feragosto ?	feragosto	6	Neut
On pisał odę do Matki - Syberii .	Syberii	6	Fem
Pan Janek zachodził do Ireny Rosy na kawę .	Ireny	4	Fem
Mariola odstawiła torebkę na malutki stołeczek .	Mariola	0	Fem
Ognista łapa przejechała po głowie Liścia , ledwie zdołał jej umknąć .	Liścia	5	Masc
Na MI-2 robił em .	MI-2	1	Neut
Prowadzę nadzór specjalistyczny do spraw chirurgii dziecięcej na Mazowszu .	Mazowszu	8	Neut
Od marca Barbara Piwnik zdążyła już jednak wymienić 3 prokuratorów apelacyjnych i 9 okręgowych .	Piwnik	3	Fem
Tu Roman Rudziński przechowywał truciznę i szafka była zwykle zamknięta na klucz .	Roman	1	Masc
Kaneyasu kiwał głową , akceptując pomysł Kiry .	Kiry	6	Fem
" Zuzanna lubi je tylko jesienią " .	Zuzanna	1	Fem
W Laskach w liturgii uczestniczyło się przez cały dzień i modliło się wszędzie .	Laskach	1	Neut
W środę ze Szpitala Ginekologiczno - Położniczego w Opolu wypisywano 11 noworodków .	Opolu	8	Neut
Grzanka jako jedna z pierwszych dziewczyn trafiła do zespołu i z marszu , też jako jedna z pierwszych , złapała za dwa łańcuchy .	Grzanka	0	Fem
Z Lipusza trasa powiedzie ich dalej do Sulęczyna , Sierakowic , Mirachowa i Otomina .	Sierakowic	9	Neut
MPK jest dziś spółką , od której samorząd kupuje przewozowe usługi .	MPK	0	Neut
Poseł w liście do ministra pyta o możliwość postawienia Polańskiego przed polskim sądem .	Polańskiego	9	Masc
Idziemy z Châtelet do domu na piechotę .	Châtelet	2	Neut
- Słuchaj , ty pewnie wyższą akademię talmudyczną w Mirze ukończył eś ?	Mirze	9	Fem
- Mojsze , gdzie jesteś , Mojsze ?	Mojsze	1	Masc
Arcybiskup Ochrydy przypisuje Borysowi także i inne cechy , które wzbogacają jego wizerunek .	Ochrydy	1	Fem
Juniorską reprezentację w najbliższym czasie czekają półfinały ME w Essen .	ME	7	Neut
Wardziński brał Santa Anę !	Santa	2	Masc
Lepper spotkał się wczoraj z rolnikami w Malechowie w województwie zachodniopomorskim .	Malechowie	7	Neut
TP SA chce złagodzić planowane redukcje .	TP	0	Fem
Natalia spoważniała .	Natalia	0	Fem
W Centrum Naukowym Wielkich Jezior w amerykańskim Cleveland otwarto wystawę niecodziennych pomocy naukowych dla dzieci .	Jezior	4	Neut
Z Lipusza trasa powiedzie ich dalej do Sulęczyna , Sierakowic , Mirachowa i Otomina .	Lipusza	1	Masc
Jak poinformował Cesar Fraga z Uniwersytetu w Buenos Aires , przeprowadzone tam badania wykazały , że czekolada wzmacnia antyutleniacze znajdujące się we krwi , zwiększając odporność na zaburzenia serca i naczyń wieńcowych .	Cesar	2	Masc
Kwintet poprowadził nauczyciel ze Szkoły Muzycznej , Krzysztof Garbacz .	Garbacz	8	Masc
Otyński jeszcze raz przebiegł wzrokiem pokój .	Otyński	0	Masc
Według KAI zaskarżenie ustawy do sądu zapowiedziała już organizacja American Civil Liberties Union .	Civil	10	Fem
Potem pismo prowadzić będzie Dionizy Bek .	Bek	5	Masc
Teraz wynajmuje mieszkanie w Rzeszowie .	Rzeszowie	4	Masc
Wkrótce zawiniemy do Trondheim .	Trondheim	3	Neut
Bardzo zachęcam do wizyty w ICM i stałego korzystania z jej usług .	ICM	5	Neut
Za nimi Toyotą syn Doroty wiezie Marcina .	Doroty	4	Fem
Małgorzata chodziła w letniej sukience na ciepłym wietrze .	Małgorzata	0	Fem
Kompromitowali nie tylko siebie , ale i Polskę .	Polskę	7	Fem
był eś w Meksyku ?	Meksyku	3	Masc
Też chciał em zadać Mirnalowi to pytanie !	Mirnalowi	4	Masc
IRA nie pozwoli ?	IRA	0	Fem
Towarzystwo Naukowe KUL pełni w Polsce rolę zbliżoną do Katolickiej Akademii Nauk .	KUL	2	Masc
Ewa i Ania chodziły z Agnieszką do jednej klasy trzeci rok .	Agnieszką	5	Fem
Dotychczas obowiązek donoszenia WKU o studentach , którzy przerwali naukę , spoczywał na uczelniach .	WKU	3	Fem
- Jestem sługą Jezusa .	Jezusa	3	Masc
Mundek zasiadł jak zwykle przy pianinie , Czesiek kiwał się przy kontrabasie .	Mundek	0	Masc
Po opadach deszczu nadleśniczowie z Tucholi , Woziwody , Zamrzenicy i Trzebcin podjęli decyzję o wycofaniu zakazu .	Zamrzenicy	9	Fem
Ale Rzeczpospolita jej nie potrzebuje . . .	Rzeczpospolita	1	Fem
Chorwacja jest w szoku .	Chorwacja	0	Fem
Natomiast do Tesco już wkrótce będą należały sklepy Leader Price'a .	Tesco	2	Neut
- Chodź , Kazik , nikt nie będzie wiedział .	Kazik	3	Masc
Na dworzec odprowadził nas profesor Garraud , doktor Adler i przełożona pielęgniarek , pani Grivet .	Grivet	14	Fem
Jedyny Polak , który po sprincie awansował do biegu na dochodzenie , Tomasz Sikora , nie startował .	Tomasz	12	Masc
Parokrotnie Wajdowie osobiście kwestowali na ulicach Japonii .	Japonii	6	Fem
Poza pierwszą nagrodą przyznaną przez jury , Marta Klimasara otrzymała także nagrodę publiczności .	Klimasara	8	Fem
Poseł Unii Wolności Grzegorz Schetyna uważa , że premier powinien teraz wykazać się refleksem i przedstawić pomysł na dalsze funkcjonowanie całego rządu .	Schetyna	4	Masc
Co będzie z Emilką ?	Emilką	3	Fem
Obecnie Browar Dojlidy posiada już 24 takie urządzenia .	Dojlidy	2	Neut
Do tego NBP dał mu jeszcze pamiątkową monetę .	NBP	2	Masc
Zupełnie nie udał się start naszej pięciobojowej młodzieży w mistrzostwach świata w czwórboju nowoczesnym kobiet i mężczyzn w szwedzkiej Uppsali .	Uppsali	19	Fem
W 2004 Jabil wszedł w posiadanie fabryki telewizorów w Kwidzynie .	Jabil	2	Masc
Jego zadaniem jest ponowne wylansowanie pojazdów tej marki w największym segmencie w Europie .	Europie	12	Fem
Odziedziczyła ona po bracie majątek w Galicji , uprzemysłowiony i dający duże profity .	Galicji	6	Fem
Według KAI zaskarżenie ustawy do sądu zapowiedziała już organizacja American Civil Liberties Union .	KAI	1	Fem
Oczekując na swoją kolej , rozmawiają i oglądają filmy w świetlicy pod czujnym okiem opiekuna Rudolfa Dyrksa .	Dyrksa	16	Masc
Z czasem przeprowadzą się na Plewiska .	Plewiska	5	Neut
Tygellin poczuł , że gra się rozszerza .	Tygellin	0	Masc
– ale ja się urodził em w Gorlicach . .	Gorlicach	7	Neut
Po odparciu ataku i ujęciu 10 terrorystów zawrócono konwój do bazy w Al Kut .	Kut	13	Neut
Dom jest własnością pewnej rodziny mieszkającej na stałe w Ameryce .	Ameryce	9	Fem
Wśród przyjezdnych jest młoda Jadzia Maślak .	Jadzia	4	Fem
Ţe przyszła . . .	Ţe	0	Fem
VIII Zjazd Inżynierów Mechaników Polskich obradował w Katowicach pod hasłem zbiorowego wysiłku myśli i pracy nad aktualnymi zagadnieniami technicznymi , mającego na celu rozwój techniki polskiej .	Katowicach	7	Neut
Już we wtorek prezydent Kwaśniewski wybiera się z roboczą wizytą do Paryża , by przekonywać do naszych racji prezydenta Jacquesa Chiraka .	Kwaśniewski	4	Masc
Klasztor na Jasnej Górze przeżywa prawdziwe oblężenie .	Górze	3	Fem
Saszce rzeczywiście odeszła chętka do dalszej rozmowy .	Saszce	0	Masc
Zeszła się ludność z Kraczkowa , z Cierpisza , z okolicznych wsi .	Cierpisza	7	Masc
W 1938 roku po raz pierwszy przyjechał do Narviku major Vidkun Quisling .	Vidkun	10	Masc
Pan poseł Zdobysław Milewski ma pierwszeństwo .	Zdobysław	2	Masc
Zapomniał eś dodać okultyzm Ojca Pio i Katarzyny Neuman .	Katarzyny	7	Fem
Weźmy Siedlce .	Siedlce	1	Neut
Białoruś wie , czym była Bereza .	Białoruś	0	Fem
- W Janowie to była dziecinada .	Janowie	2	Masc
Nie będzie Niejakiego Piórko .	Piórko	3	Masc
Pruszyński zaciera ręce .	Pruszyński	0	Masc
Skąd się wzięło Halloween ?	Halloween	3	Neut
Z tego też powodu cieszył em się , że prawica odbija teraz TVP .	TVP	12	Fem
Czy jest pan poseł Gabriel Janowski ?	Gabriel	4	Masc
Tym kobylim synom chodzi o to , by Francja dostała guzik .	Francja	8	Fem
Szmigielski działa też w komisji ogródków działkowych , komisji mieszkaniowej i radzie osiedla ; ma biuro w piwnicy .	Szmigielski	0	Masc
Brazylijczyk , dwukrotny zwycięzca wielkoszlemowego Roland Garros , podkreślał przed spotkaniem , że najważniejszym elementem piątkowej potyczki będzie skuteczna gra przy własnym serwisie .	Garros	6	Masc
Warunkiem będzie jednak zatrudnienie odchodzących z TP SA pracowników .	TP	6	Fem
Widawska pochodzi z Kalisza .	Widawska	0	Fem
Wanda Gąsior w to jednak powątpiewa .	Gąsior	1	Fem
Prezydenci Polski , Ukrainy i Rumunii spotkali się na roboczych rozmowach w Bukareszcie .	Ukrainy	3	Fem
Chodź , Hari , podrzucę cię do domu .	Hari	2	Masc
Przedsiębiorcę z Barda niepokoi , że w obrocie gospodarczym brakuje pieniędzy .	Barda	2	Neut
Około 15 km za Nag–czu , boczną , terenową drogą dojechali śmy do pasterskich namiotów .	Nag–czu	4	Neut
Chodzi prawdopodobnie o Burkina Faso .	Faso	4	Neut
Timoszenko goni Niemców za Rostowem .	Rostowem	4	Masc
Ponad 20 ulic będzie wyłączonych z ruchu w związku ze Świętem Zmarłych .	Świętem	10	Neut
Nika , nie gap się .	Nika	0	Fem
Określeniu daty sprzeciwiały się otwarcie Francja , Hiszpania i Finlandia .	Francja	5	Fem
Napisał ją Chilijczyk Ariel Dorfman .	Ariel	3	Masc
Wisła w Toruniu przekroczyła stan alarmowy o 80 cm , a wody wciąż przybywa .	Toruniu	2	Masc
I zapewne AWS jeszcze może się poszerzać o jakieś ugrupowania prawicowe .	AWS	2	Fem
W ataku grali Michalis Konstantinou i Nikos Liberopoulos .	Liberopoulos	7	Masc
Groszek spojrzał na nią nieprzytomnie .	Groszek	0	Masc
Sześć pięknych dziewcząt rywalizowało w Miejsko - Gminnym Ośrodku Kultury w Małogoszczu o tytuł Miss Regionu Jędrzejowskiego i Włoszczowskiego .	Małogoszczu	11	Masc
Prezydenci Polski , Ukrainy i Rumunii spotkali się na roboczych rozmowach w Bukareszcie .	Ukrainy	3	Fem
W tej sytuacji wiele przedziałów w pociągach nad morze , w góry i na Mazury zajmują koloniści .	Mazury	14	Neut
Wysiadła na zakręcie przed Hagen .	Hagen	4	Neut
Tamtędy płynie Stobrawa .	Stobrawa	2	Fem
Sanitariuszka Marynia ostrożnie otworzyła drzwi .	Marynia	1	Fem
Ułożył je ks. Wawrzyniec Beniok w 1707 roku .	Wawrzyniec	3	Masc
W ataku grali Michalis Konstantinou i Nikos Liberopoulos .	Konstantinou	4	Masc
W niedzielę 7 czerwca o godz . 17 Odra podejmuje Inę , a Mieszko o tej samej godzinie u siebie gra z Dąbrovią .	Dąbrovią	22	Fem
Każdy w Polsce słyszał o Samarkandzie , świętym mieście w Uzbekistanie .	Samarkandzie	5	Fem
Urodził się w Patarze .	Patarze	3	Masc
Niedziela Palmowa na Kociewiu różniła się zresztą od obchodów w innych częściach Polski .	Kociewiu	3	Neut
Główne dowództwo niemieckie musi objąć kierownictwo operacji wojennych we Włoszech .	Włoszech	9	Neut
Wczoraj o godz . 2 rano policjanci ruszyli pod posiadłość przestępcy w Białce na Pomorzu .	Pomorzu	14	Neut
Bóg dał , Bóg wziął .	Bóg	3	Masc
Przerwali terapię we Mstowie i w krótkim czasie zmarli z powodu narkotycznego przedawkowania .	Mstowie	3	Masc
Prokuratorowi oraz sędziom mówił , iż pojechał na Wschód , aby holować do Polski uszkodzony za Bugiem samochód .	Wschód	8	Masc
Szeląg nie mógł się uspokoić .	Szeląg	0	Masc
Juniorską reprezentację w najbliższym czasie czekają półfinały ME w Essen .	Essen	9	Neut
Stalin zaszedł , wzeszła Honda i British Airways .	British	6	Neut
Eli chwycił wiadra i ruszył za nią kamienistą dróżką .	Eli	0	Masc
W tym roku Zagłębie też nie płaci .	Zagłębie	3	Neut
Pod Wisłą buduje się wielki tunel ciepłowniczy .	Wisłą	1	Fem
Jakim dzieckiem jest Angelika ?	Angelika	3	Fem
Agnieszka Strumiłowska opowiedziała mi historię z jej czasów studenckich .	Agnieszka	0	Fem
Drugi dwumecz z łódzkimi drużynami rozegrają dziś w Skierniewicach nasi drugoligowcy .	Skierniewicach	8	Neut
– zapytała sędzia ojca dziecka Zielińskiej .	Zielińskiej	5	Fem
W Urzędzie Wojewódzkim w Skierniewicach pracuje około 230 osób .	Skierniewicach	4	Neut
Udało się niestety uratować tylko Marię Fryc , zaś dwudziestotrzyletni jej mąż utonął .	Fryc	6	Fem
Sołtys Ligoty Stanisław Kuźnik składa serdeczne podziękowanie wszystkim sponsorom , którzy przyczynili się do zorganizowania festynu i dzięki którym dzieci z Ligoty będą mogły pojechać na wycieczkę .	Ligoty	21	Fem
Na drugich drzwiach widnieje Samson , herb Wattów .	Samson	4	Masc
Jadźka z miną dumną przechodzi .	Jadźka	0	Fem
Obecni byli posłowie Pękała i Witaszczyk , ale nie przemawiali .	Witaszczyk	5	Masc
Z informacji lekarskiej o stanie zdrowia Havla , która została opublikowana w połowie grudnia , wynikało , że prezydent ma skłonności do zapadania na wirusowe schorzenia górnych dróg oddechowych .	Havla	6	Masc
Yennefer opuściła głowę , spojrzała między swoje uda , nad którymi przemykały złote rybki .	Yennefer	0	Fem
Do dziennikarki Beaty Igielskiej zatelefonowała któregoś dnia krewna , bardzo zresztą daleka .	Beaty	2	Fem
Hunt usiadł .	Hunt	0	Masc
PQBoot to narzędzie do zmiany partycji bootującej dla tych użytkowników , którzy tylko od czasu do czasu potrzebują skorzystać z innego systemu .	PQBoot	0	Masc
Jak stawiać granice dzieciom z FAS ?	FAS	5	Neut
Zosia Szymanowska była starszą siostrą Antka , mego dawnego kolegi od Batorego .	Szymanowska	1	Fem
Tak orzekł wczoraj niemiecki Trybunał Federalny w Karlsruhe .	Karlsruhe	7	Neut
NBP OBNIŻYŁ o 4 punkty procentowe stopę swoich kredytów .	NBP	0	Masc
Ale najgorszy moment tego czystego szaleństwa i paskudnego zachowania Angusa miał dopiero nastąpić .	Angusa	9	Masc
– fajna jest Zuzia . .	Zuzia	3	Fem
Policjanci użyli broni również w centrum Legnicy .	Legnicy	6	Fem
Elżbieta rozstaje się z mężem , zabiera synka i ze Śląska przenosi się do Tarnowa .	Śląska	10	Masc
Zwyciężyła po raz pierwszy kobieta , 22-letnia Portugalka .	Portugalka	7	Fem
Oczy Nony zalśniły .	Nony	1	Fem
może wpadnę do Gumy po pieróg .	Gumy	3	Fem
Ciągnęło mnie do Grażyny .	Grażyny	3	Fem
Krystyna Kofta ogłosiła , że przyjmuje na siebie misję walki o równouprawnienie Bożen z Krystynami i za dwa lata zaprosiła panie do Trójmiasta , by równość tę udowodnić .	Krystynami	14	Fem
- Pisaliśmy razem komunikaty z posiedzeń TKK .	TKK	6	Fem
Śmieszy mnie ta zabawa w barbarzyńcę , bezmyślne opróżnianie butelek pod krzyżówkę Mickiewicza z amerykańskim hamburgerem .	Mickiewicza	12	Masc
Jadźka z miną dumną przechodzi .	Jadźka	0	Fem
Amerykanie wzięli La Haie du Puy .	La	2	Neut
Wśród podhalańskich Cyganów z bezwzględności słynie jego współpracownik , współoskarżony w Oświęcimiu , Stanisław Kamiński z Czarnej Góry .	Góry	17	Fem
Obok Zofii B . siedział jeszcze członek góralskiej kapeli z Zakopanego .	Zofii	1	Fem
Uczestnicy zjazdu wypili wodę święconą z kościoła Najświętszego Zbawiciela .	Zbawiciela	8	Masc
Tenisiści stołowi Energetyka Opoki Trzebinia znają już terminy spotkań barażowych o I ligę , w których ich rywalem będzie zwycięzca II ligi łódzko - świętokrzyskiej Start Brzezina .	Energetyka	2	Masc
Podopieczni trenera Mirko Jozica obecnie przebywają na zgrupowaniu w Austrii .	Austrii	9	Fem
Jego nominacja na ministra spraw zagranicznych była największą niespodzianką rządu Angeli Merkel .	Merkel	11	Fem
Wielu uczestników tegorocznego Karnawału gościło już wcześniej na deskach Domu Ludowego w Bukowinie Tatrzańskiej .	Bukowinie	12	Fem
W Berchtesgaden specjalnością jest tor saneczkowy , na którym osiąga się niebywałe prędkości .	Berchtesgaden	1	Masc
Podobne warunki terenowe charakteryzują cmentarzysko w Předmostí .	Předmostí	6	Neut
W Małej Komorzy z tego powodu zapaliły się sadze .	Komorzy	2	Fem
Zapewne już nie wrócę do Ameryki , już nie wrócę do amerykańskich tematów .	Ameryki	5	Fem
Jurek milczał .	Jurek	0	Masc
Jako pierwszy zabierze się do ciebie honorowo obłędny rycerz Eyck z Denesle !	Eyck	9	Masc
Moda na École de Paris niewątpliwie zasłużenie dowartościowała to środowisko artystyczne , ale w przypadku niektórych nazwisk także przewartościowała .	Paris	4	Fem
Wybór padł na Stany Zjednoczone , ponieważ stamtąd przyszła pierwsza oferta pracy .	Stany	3	Neut
Obecnie mieścić się one będą w Zweibruecken i w Wormacji .	Zweibruecken	6	Neut
Zmieniłem Marka Walburga , bo rozbolał go żołądek i po prostu musiał szybko udać się do ubikacji .	Walburga	2	Masc
Kudłatemu znowu coś popieprzyło się w obliczeniach finansowych .	Kudłatemu	0	Masc
Tak ich zastał ksiądz Grozd .	Grozd	4	Masc
- Wybaczy pan , Profesorze . . .	Profesorze	4	Masc
Na czwartym rogu Żelaznej wywrócili kiosk z papierosami , jako przeszkodę , papierosy się posypały .	Żelaznej	3	Fem
Pani Władysława niecierpliwie liczy dni .	Władysława	1	Fem
Ziuta uściskała go i ucałowała w oba policzki .	Ziuta	0	Fem
Starostwo katowickie zwraca się do Giesche SA , by bezdomnych pozostawić w spokoju .	SA	6	Fem
Sprawą włamania do domu wokalistki Blue Cafe zajęli się policjanci z komisariatu przy ul . Ciesielskiej .	Cafe	6	Neut
Szmid swe wyjaśnienia przekazał prezydentowi Markowi Koćmielowi .	Szmid	0	Masc
- Nie wierzył em , że Ance uda się oderwać pana od tropienia przestępców .	Ance	6	Fem
Tusk też tak początkowo myślał lokalizując Muzeum Wojny na Westerplatte .	Tusk	0	Masc
- W Gazie wybuchnie wojna domowa .	Gazie	2	Fem
- Pani Salach kazała śledzić każdy jej krok i informować o każdym błędzie .	Salach	2	Fem
Druga kwestia zajmowała Sinego jeszcze bardziej .	Sinego	3	Masc
Niektóre sale pałacyku w Karolinie przeznaczono na małe muzeum .	Karolinie	4	Masc
Patrol saperski całą dobę dyżuruje w Kazuniu .	Kazuniu	6	Masc
Turyści z NRD odwiedzać będą Szczecin i powiat szczeciński .	NRD	2	Fem
W stolicy Podhala oczekuje na telefon około 2 tys . osób .	Podhala	2	Neut
Kontrolę w PAR zlecił jesienią ub.r . minister łączności Maciej Srebro .	PAR	2	Fem
– W HSW SA trwa obecnie wielkie liczenie .	HSW	2	Fem
Stalin zaszedł , wzeszła Honda i British Airways .	Stalin	0	Masc
Ale jak zinterpretować pojawienie się kolędników w finałowej scenie , kiedy rozjadą się już Konrad i ksiądz Piotr ?	Konrad	14	Masc
Mundzio , Sewer , Tolek i Wacek byli z jednej branży .	Sewer	2	Masc
W piątek otrzymała w nagrodę kuchenkę mikrofalową , ufundowaną przez Makro .	Makro	10	Neut
Nie zostałam więc działaczką PiS , ulubienicą Kaczyńskich i ich matki , doradczynią w PKO BP ani prezeską TVP .	TVP	18	Fem
Na Węgrzech występuje pianistka Halina Czerny - Stefańska i jej córka klawesynistka Elżbieta Stefańska - Łukowicz .	Stefańska	13	Fem
Nie wiem , czy Putin to Piotr II , który chciałby przywiązać Rosję do Zachodu , by uczynić ją silną .	Rosję	12	Fem
Po trzech dniach Śpiąca Królewna wróciła do Warszawy .	Królewna	4	Fem
Dyna nie wydawał się obrażony .	Dyna	0	Masc
- Mój ojciec pracuje w BRH , biurze radcy handlowego .	BRH	5	Neut
Grenlandia nie zniknie .	Grenlandia	0	Fem
W Pikardii ewakuowano 700 osób , woda zalała ponad 1800 domów .	Pikardii	1	Fem
Prokuratorowi oraz sędziom mówił , iż pojechał na Wschód , aby holować do Polski uszkodzony za Bugiem samochód .	Bugiem	16	Masc
Szli śmy do Harstad .	Harstad	3	Neut
Głównym jego prześladowcą był malarz , majster Gileta .	Gileta	7	Masc
Szewardnadze wygrał je i zdobył legitymację dla swojej władzy .	Szewardnadze	0	Masc
Są jeszcze dwie propozycje , na które Huntington dotąd nie odpowiedział .	Huntington	7	Masc
Kira też zobaczyła to , co chciała .	Kira	0	Fem
Po pani Florczakowej i Kropce został tylko jeden ślad .	Kropce	4	Fem
- Nyvarp zmienia kolor na zielony !	Nyvarp	1	Masc
Na terenie przyległym do Kolonii Wierzbicy znajdują się dwie garbarnie .	Wierzbicy	5	Fem
- Zobaczymy , czy RS AWS będzie już mógł samodzielnie działać .	AWS	5	Fem
Koncern nadal ma umowy licencyjne z producentami w Japonii , Włoszech , Afryce Południowej i na Filipinach .	Włoszech	10	Neut
Trzy lata temu rozstał się z górniczą spółką mieszkaniową w Nikiszowcu .	Nikiszowcu	10	Masc
Za punktualność , komfort podróżowania , czy czystość przystanków będzie dbał MZKZG .	MZKZG	11	Masc
Wyciągał jedynie wnioski z obszaru i potencjału państwa rosyjskiego twierdząc , że dwa mocarstwa , Rosja i Ameryka , określać będą przyszłość świata .	Ameryka	17	Fem
Jest wychowankiem Sportulu Studenţesc , w którym łącznie występował przez dziewięć lat .	Studenţesc	3	Masc
Ludmiła Putin , żona prezydenta Federacji Rosyjskiej Władimira Putina , rozpoczęła wczoraj wizytę w Polsce od zwiedzenia zamku na Wawelu .	Federacji	5	Fem
Wydawało się , że fiskus nie będzie dłużej gnębił Waldemara Gronowskiego , legnickiego piekarza , który przez ponad 10 lat rozdawał pieczywo najuboższym .	Gronowskiego	10	Masc
Gdańscy radni podjęli uchwałę o przekazaniu miliona złotych na odbudowę kościoła św . Katarzyny .	Katarzyny	13	Fem
Partnerem Trzebini będzie zachodnioukraińskie miasto Sokal .	Trzebini	1	Fem
Piłkarze krakowskiej Wisły sprawili wspaniały prezent wszystkim sympatykom futbolu w Polsce .	Wisły	2	Fem
Piwko siedziała z rękami zaplecionymi pod brodą .	Piwko	0	Fem
Na ekranie TV , na zatrzymanej stop–klatce Jurka Kilera idą napisy końcowe programu .	Jurka	7	Masc
Most w Kuligach na rzece Jegrzni znajduje się w fatalnym stanie i grozi zawaleniem .	Jegrzni	5	Fem
W pewnej chwili zjawiła się na ulicy Kazia .	Kazia	7	Fem
Drugiej , rozładowanej do połowy w Pruszkowie , rabusie nie tknęli .	Pruszkowie	6	Masc
Widzą nagle Cygana z Jadźką .	Jadźką	4	Fem
Gdyby kierownictwo ZUS zdecydowało się na Mercedesa lub BMW , to koszt jednego samochodu przekroczyłby 200 tys . nowych złotych .	BMW	8	Neut
Mogła by być nawet leżąca , bo Krysia lubi leżeć .	Krysia	7	Fem
A Bóg jest Prawdomówny .	Bóg	1	Masc
– Niech się pani nie martwi , ta pani Marysia to niezwykle urocze dziecko .	Marysia	9	Fem
Na terenie przyległym do Kolonii Wierzbicy znajdują się dwie garbarnie .	Kolonii	4	Fem
Michał zaczął zmagać się z niewyraźnym pismem Marka .	Michał	0	Masc
Gdy Dominika przyjechała po matkę , Babel dożywał swych dni .	Dominika	1	Fem
Kazimierz Laudański i jego bracia to znani w okolicy pszczelarze , klienci przyjeżdżają aż z Niemiec po miód .	Kazimierz	0	Masc
- Pisali śmy razem komunikaty z posiedzeń TKK .	TKK	7	Fem
Kiedy mówi się o cudach w Lourdes , kiedy ktoś dostąpił cudownego uzdrowienia , Kościół prosi lekarzy , aby wypowiedzieli się na ten temat .	Lourdes	6	Neut
W Kcyni odbyło się spotkanie z kandydatami na kierowników na samodzielny publiczny zakład opieki zdrowotnej w Kcyni i Kowalewku .	Kcyni	16	Fem
Ale dzisiaj umysł mędrca od razu uleciał w stronę Ciemnej Gwiazdy .	Gwiazdy	10	Fem
Dlaczego Bóg pogroził palcem ?	Bóg	1	Masc
Sporządzając mi drinka , Pućka kończy wcześniej rozpoczętą kwestię .	Pućka	4	Fem
Dobrze spisała się młodzież w Sterdyni , Ceranowie , Skrzeszynie , Czerwonce i Wężach .	Wężach	13	Neut
- Żydówki bywają piękne . . .	Żydówki	1	Fem
Z nieoficjalnych informacji wynika , że PSL nie wyklucza poparcia ani Borusewicza , ani Polaczka .	Polaczka	14	Masc
W kościele mariackim w Radomiu o północy mszę święto odprawił biskup senior Edward Materski .	Materski	13	Masc
Usamodzielniły się Wyry , Bojszowy , Lędziny i Bieruń .	Lędziny	6	Neut
Premier Cyrankiewicz i Pierre Lauret wygłosili krótkie przemówienia .	Pierre	3	Masc
— Wielu Europejczyków wyznaje ideologię komunistyczną .	Europejczyków	2	Masc
- Sława , Maryna i Krzysztof podbiegają i odbierają od niej paczki .	Sława	1	Fem
Anglicy tego samego pragną , lecz interes widzą w zwycięstwie Niemców .	Anglicy	0	Masc
Emma pomyślała w tej chwili , że nie jest to spostrzeżenie specjalnie odkrywcze .	Emma	0	Fem
Dotarli śmy wreszcie pod szczyt Mnicha .	Mnicha	5	Masc
Rozdzielali zwaśnione strony w ramach misji pokojowych ONZ .	ONZ	7	Fem
MPK prowadzi jeszcze rozmowy z wojskiem i PKP .	PKP	7	Neut
Nie zostałam więc działaczką PiS , ulubienicą Kaczyńskich i ich matki , doradczynią w PKO BP ani prezeską TVP .	BP	15	Masc
- Witaj , synu Arana .	Arana	4	Masc
Burmistrz Tadeusz Kowalski dogląda realizacji zadania .	Tadeusz	1	Masc
Jako pierwszy zabierze się do ciebie honorowo obłędny rycerz Eyck z Denesle !	Denesle	11	Neut
Ale Hristina nie drgnęła .	Hristina	1	Fem
Hari nie gościł u niego od dziesięciu lat .	Hari	0	Masc
Do Foggi wyjechał z kilkudziesięcioma Polakami .	Foggi	1	Fem
Do Gdyni dotarła wczoraj oczekiwana od kilku dni amerykańska koszykarka Edna Campbell .	Edna	10	Fem
Po przewiezieniu do Jeleniej Góry prokurator postawił mu zarzuty żądania i przyjęcia korzyści majątkowych .	Góry	4	Fem
Mieszkamy w Kuźni Raciborskiej .	Kuźni	2	Fem
Zaproponowano więc Krystynie , która skwapliwie skorzystała .	Krystynie	2	Fem
Prezes Bogdan Kościuczyk odesłał nas do dyrektor Anieli Kotowicz .	Anieli	7	Fem
I przeczytaj coś o Simone de Beauvoir .	Simone	4	Fem
Lolek za głowę się złapał , kiedy to usłyszał .	Lolek	0	Masc
Dziesięciu jeźdźców pokonuje trasę z Torunia do Pucka .	Pucka	7	Masc
W tym roku w kościele św . Brygidy na Wielkanoc można było obejrzeć kościotrupa trzymającego flagę UE .	Brygidy	7	Fem
Kasia zrezygnowała .	Kasia	0	Fem
Po zajęciu miejscowości Krzyżacy zmasakrowali miejscową ludność .	Krzyżacy	3	Masc
Rozbiegli się Kaszubi , pod przymusem do tej walki pędzeni .	Kaszubi	2	Masc
– Gosia już załatwiła .	Gosia	1	Fem
Działo się to podczas dochodzenia do nabrzeża w Ystad .	Ystad	8	Neut
Arkadiusza J . pogrążyły też zeznania taksówkarza , który zabrał oskarżonych sprzed Stodoły .	Arkadiusza	0	Masc
Jesienią do domu Gwiazdy zapukał mały człowiek .	Gwiazdy	3	Fem
Ranny został operator Jerzy Ernst .	Ernst	4	Masc
Ma on być gościem prezydenta Saragata .	Saragata	5	Masc
Koło urządziło również podczas wakacji obóz wędrowny po Pomorzu .	Pomorzu	8	Neut
- Zdałem maturę , jestem studentem AWF w Katowicach . . .	Katowicach	8	Neut
Liwus , Magdasf1 ma rację , lepiej dla pewności zrobić sobie test .	Magdasf1	2	Fem
De Gaulle w tych dniach pozyskał Francję .	Francję	6	Fem
Poseł Włodzimierz Wasiński sądzi , że zmiany w rządzie nie ograniczą się do dymisji wicepremiera Janusza Tomaszewskiego .	Wasiński	2	Masc
Cygan bokiem się przesuwa .	Cygan	0	Masc
Marszałek Senatu Alicja Grześkowiak zwróciła się o wyjaśnienie tej sprawy do Trybunału Konstytucyjnego .	Grześkowiak	3	Fem
Wracał em do Bud już po północy .	Bud	3	Neut
Wraz z kadrą wyjadą Daria Kasperska , Paulina Rytwińska i Agnieszka Karcz .	Karcz	11	Fem
– Przyjedź szybko do Nowolipska .	Nowolipska	4	Neut
- Znam Marzenę .	Marzenę	2	Fem
W środę ambasador USA w Pekinie przekazał ministrowi spraw zagranicznych Chin list z przeprosinami .	Chin	10	Neut
W Centrum Naukowym Wielkich Jezior w amerykańskim Cleveland otwarto wystawę niecodziennych pomocy naukowych dla dzieci .	Cleveland	7	Neut
Wiem tylko , że jego żona jeszcze w Nowym Jorku zdecydowała się wrócić z synem do kraju .	Nowym	8	Masc
Zajmowały się tym już Zofia Korczak - Blatonowa i Aniela Cieszkowska .	Cieszkowska	10	Fem
Listy Katarzyny do św . Rajmunda robią na mnie duże wrażenie .	Katarzyny	1	Fem
Przyjechali też strażacy z OSP z Poronina , Suchego i Kościeliska .	OSP	4	Fem
Podczas mojej pierwszej bytności w Londynie miałam , dzięki uprzejmości pani z biblioteki polskiej , dostęp do teczki Krystyny .	Krystyny	18	Fem
Stałą obserwacją objęta jest ulica Bohaterów Warszawy od poczty głównej do placu Wolności .	Bohaterów	5	Masc
W czasie obławy policjantom z Pieniężna udało się zatrzymać dwóch kłusowników .	Pieniężna	5	Neut
W Kcyni odbyło się spotkanie z kandydatami na kierowników na samodzielny publiczny zakład opieki zdrowotnej w Kcyni i Kowalewku .	Kowalewku	18	Neut
Syn pana Bogdana raz sam się przekonał , jak wygląda opieka nad niepełnosprawnymi na porządnym zachodnioeuropejskim poziomie .	Bogdana	2	Masc
Za co tak Semaka nie lubią partyjni towarzysze ?	Semaka	3	Masc
Adams odpowiedzialnością za tę porażkę obarczał Hamiltona i jego ludzi , którzy doprowadzili do rozłamu wśród federalistów .	Adams	0	Masc
War stanął .	War	0	Masc
Kim jest teraz Grzegorzewski ?	Grzegorzewski	3	Masc
Kaśka , co cię ugryzło ?	Kaśka	0	Fem
Gdy Cahirowi czupryna nieco mocniej przyschnie do czerepu , powędrujemy ku Toussaint .	Cahirowi	1	Masc
Nie widzieli się miesiąc i musiał ponownie oswoić Gosię .	Gosię	8	Fem
Amerykanie zajęli Carantan .	Amerykanie	0	Masc
Dobrze spisała się młodzież w Sterdyni , Ceranowie , Skrzeszynie , Czerwonce i Wężach .	Wężach	13	Neut
Większość skradziono w Berlinie , Hamburgu , Kilonii i Bremie .	Hamburgu	5	Masc
Polska wreszcie przełamała zły los , a Andrzej Wajda otrzymał Oscara .	Wajda	8	Masc
Zaproszenie Gadowskiego i jego muzyków było jej inicjatywą .	Gadowskiego	1	Masc
Na przykład z Australią łączył em się na dwudziestoletnim radiu mojego ojca .	Australią	3	Fem
Giertych robi to samo Kwachowi .	Giertych	0	Masc
Polski samolot M-28 rozbił się i eksplodował kilka sekund po starcie z lotniska w Puerto Cabello , 200 km na zachód od Caracas .	Puerto	14	Neut
Malował wówczas synagogę w Opatowie .	Opatowie	4	Masc
Jadę do Katowic w sprawach różnych , poprzecznych i podłużnych , jak mówią moje dzieci .	Katowic	2	Neut
Po odparciu ataku i ujęciu 10 terrorystów zawrócono konwój do bazy w Al Kut .	Al	12	Neut
Przystupa wzruszyła ramionami .	Przystupa	0	Fem
Ostatecznym celem był garnizon w Greifswaldzie na Pomorzu .	Pomorzu	7	Neut
Juniorską reprezentację w najbliższym czasie czekają półfinały ME w Essen .	Essen	9	Neut
Autor książki barwnie opowiadał o dziejach powstania monografii parafii Świętej Katarzyny .	Katarzyny	10	Fem
- Langer z grubasami popychał dziennikarską brać do wyjścia .	Langer	1	Masc
Warnecke , wolę tego nie opisywać .	Warnecke	0	Masc
– a do Dusznik jedziecie ?	Dusznik	3	Neut
Te grzechy spowiada tylko Chrystus .	Chrystus	4	Masc
Równie dobrze mogę to kochać na Madagaskarze .	Madagaskarze	6	Masc
Wicemistrzynie Polski z Mielca nie dały pograć w Krakowie Wiśle i opuściły ostatnie miejsce w tabeli właśnie na rzecz podopiecznych Lesława Kędryny .	Lesława	20	Masc
Wikary Pudło odprawia je żując gumę .	Pudło	1	Masc
Najbardziej popularne są mercedesy , audi , golfy i BMW .	BMW	9	Neut
O drugie miejsce zawzięcie walczyły reprezentacja Belgradu oraz Alita Alytus .	Alita	8	Fem
- Wasza gazeta od dawna robi świetne przewodniki dla poszukujących pracy w Irlandii .	Irlandii	12	Fem
Witraże projektował Jerzy Skąpski , a wykonali w 1991 r . Anna i Ireneusz Zarzyccy .	Zarzyccy	14	Masc
Jej wnuczka , dziesięcioletnia Marta , chodziła do klasy z zamordowanym Łukaszem .	Łukaszem	11	Masc
- Kapliczka przylegała do kościoła katolickiego , Łemkowie z niej od wielu lat nie korzystali .	Łemkowie	7	Masc
Na Siemiradzkiego wybrzydzali krytycy , ale publiczność uwielbiała jego obrazy .	Siemiradzkiego	1	Masc
Szarik wyszczerzył kły i warknął .	Szarik	0	Masc
Aby pozbyć się niespokojnego ducha z Apulii , Onufry wysłał Roberta do Kalabrii .	Apulii	6	Fem
Jestem za ujawnieniem dokumentów IPN-u , niech każdy je oceni .	IPN-u	4	Masc
- A czy słyszał pan o Witoldzie Michałowskim ?	Michałowskim	7	Masc
Pani Bentley okazała się bardzo miłą i gościnną kobietą .	Bentley	1	Fem
Według badań Unii Europejskiej jesteśmy najmniej aktywnym społeczeństwem w Europie .	Europie	9	Fem
Mieszka w Mysłowicach .	Mysłowicach	2	Neut
Rząd w Ułan Bator w lutym zaapelował o pomoc międzynarodową .	Bator	3	Masc
Celnikom wyjaśniła , że muszlę kupiła w Acapulco za 20 dolarów .	Acapulco	7	Neut
Grek zmarszczył czoło i chwilę jeszcze badał go uważnie wzrokiem .	Grek	0	Masc
Natomiast do Tesco już wkrótce będą należały sklepy Leader Price'a .	Price'a	9	Masc
Elton John dał pierwszy po operacji serca koncert .	Elton	0	Masc
Nie mógł zakochać się w żadnej Amerykance .	Amerykance	6	Fem
Tom nie odezwał się już więcej do babiny .	Tom	0	Masc
Jedynie opisywane przez panią żółwie na Seszelach się p . . .	Seszelach	6	Neut
Martha Kosicky ma blond włosy i dziadka z Polski .	Martha	0	Fem
I Pan Jezus krzyż nad nimi uczynił , a oni się zamienili w trzy drzewa jabłonne .	Jezus	2	Masc
W czwartkowe popołudnie gasili płonący śmietnik przy ul. Brodzińskiego w Proszowicach .	Proszowicach	10	Neut
Porad rolnikom udziela w nim Janina Zielińska .	Janina	5	Fem
Prezydenci Polski , Ukrainy i Rumunii spotkali się na roboczych rozmowach w Bukareszcie .	Rumunii	5	Fem
Nie trzeba jednak od razu spiętrzać Wisły , żeby wytwarzać energię elektryczną .	Wisły	6	Fem
Do wypadku doszło na drodze z Gilwy do Prabut .	Gilwy	6	Fem
" Dąbrowska odnotowuje , że zarys którejś z nowel Kowalska w pośpiechu rzuciła na papier po francusku " .	Dąbrowska	1	Fem
Oto ja , sponiewierana i przeklęta Żydówka , błagam was o litość .	Żydówka	6	Fem
- W Warszawie wstawała wcześnie rano .	Warszawie	2	Fem
Na Irku cały ten wywód nie zrobił żadnego wrażenia .	Irku	1	Masc
Największe zainteresowanie budzi jednak specjalne seminarium poświęcone ustaleniu budowy ludzkiego DNA .	DNA	10	Neut
Przede wszystkim zdecydował wynik w Stanach .	Stanach	5	Neut
Ognista łapa przejechała po głowie Liścia , ledwie zdołał jej umknąć .	Liścia	5	Masc
Mówić on będzie dzisiaj o sytuacji religijnej i nowych ruchach w Europie .	Europie	11	Fem
Mordowanie Pigmejów nadal trwa .	Pigmejów	1	Masc
Dżabie chrupnęło w kościach .	Dżabie	0	Masc
40-osobowa grupa chuliganów wywołała rozróbę przed sobotnim III-ligowym meczem piłki nożnej Lublinianki z Cracovią .	Lublinianki	11	Fem
Nieudanie tym razem skakał o tyczce Ukrainiec Siergiej Bubka .	Bubka	8	Masc
Tata ukrywał się na Żoliborzu u Zosi , mojej przyszłej wspaniałej macochy , jako Pan Nikt .	Zosi	6	Fem
O drugie miejsce zawzięcie walczyły reprezentacja Belgradu oraz Alita Alytus .	Belgradu	6	Masc
Zajmowały się tym już Zofia Korczak - Blatonowa i Aniela Cieszkowska .	Blatonowa	7	Fem
Turska przyznała , że jest przerażona , bo nie wyklucza , że nastolatka mogła zarazić inne osoby .	Turska	0	Fem
Wśród osób , które nielegalnie przekroczyły wschodnią granicę , było sześciu obywateli Bangladeszu , dwóch Afgańczyków i czterech Kurdów irackich , w tym kobieta z dzieckiem .	Kurdów	18	Masc
Papier płonie także w Pillow Book .	Book	5	Masc
Z Jackiem Kuroniem współpracowali śmy i nadal współpracujemy .	Kuroniem	2	Masc
Śmierć na miejscu poniosła 36-letnia kobieta , która z mężem przechodziła przez Małą Fatrę w rejonie Niskich Tatr .	Tatr	17	Neut
Po opadach deszczu nadleśniczowie z Tucholi , Woziwody , Zamrzenicy i Trzebcin podjęli decyzję o wycofaniu zakazu .	Woziwody	7	Fem
Przyszła Kryśka i zdziwiła się , że jestem taka blada .	Kryśka	1	Fem
Spece od wizerunku doradzają Jarosławowi Kaczyńskiemu , żeby zapuścił wąsy , bo to odróżni go od brata .	Jarosławowi	4	Masc
Wprost z getta wywieźli mnie do Berlina .	Berlina	6	Masc
Jeżeli zamierzasz nadal szukać Krzywosza , proszę bardzo .	Krzywosza	4	Masc
Poprawkę skrytykował już dyrektor wykonawczy Światowego Kongresu Żydów Elan Steinberg .	Elan	8	Masc
Zdaniem włoskich ekspertów , jest to słabe tłumaczenie , ponieważ wszyscy wiedzą , że region Molise leży w strefie silnej aktywności sejsmicznej .	Molise	15	Neut
Polonii aura nie przeszkadzała w odniesieniu wysokiego zwycięstwa .	Polonii	0	Fem
A władze Kielc nawet nie myślą pomagać . . .	Kielc	2	Neut
W Tczewie w Radzie Miejskiej zasiada 23 radnych .	Tczewie	1	Masc
Dobrze spisała się młodzież w Sterdyni , Ceranowie , Skrzeszynie , Czerwonce i Wężach .	Sterdyni	5	Fem
Risenius uśmiechnął się .	Risenius	0	Masc
Dębica była kolejnym miejscem rozegrania Grand Prix Polski w pływaniu .	Dębica	0	Fem
- Na jarmarku w Ostrowcu konie biedaka stratowały .	Ostrowcu	4	Masc
- Jadę w stronę Palazzo di Giustizia .	Palazzo	4	Masc
Głubczycka PSS rozpoczynała swoją działalność od jednego sklepu .	PSS	1	Fem
Stary Pancer , z rękami w kieszeniach spodni , stał oparty o biurko .	Pancer	1	Masc
Uruchamiany system ma stać się zaczątkiem większego , obejmującego całą Wielkopolskę .	Wielkopolskę	10	Fem
Piłkarze FC Porto zapewnili sobie wczoraj ponownie tytuł mistrzów Portugalii .	Portugalii	9	Fem
Rafał Blechacz zapowiedział , że w niedzielę palmową ma zamiar zagrać kolejny ważny koncert .	Rafał	0	Masc
Kongresy Międzynarodówki poruszały zawsze ważne problemy , istotne dla życia politycznego i społecznego danego okresu .	Międzynarodówki	1	Fem
Wizja Nawara Derela na stole sekcyjnym musiała być bardzo zabawna .	Derela	2	Masc
On mnie poznał z Jankiem Pospieszalskim .	Jankiem	4	Masc
W kraju działa kilka grup partyzanckich utworzonych przez patriotów Dominikany .	Dominikany	9	Fem
W tym roku stołeczni stróże prawa odkryli na Mazowszu już osiem takich fabryk .	Mazowszu	8	Neut
Nachor aż się zachłysnął z radości .	Nachor	0	Masc
Od samotności niepoczytalnej i obłędu uchroń nas , Panie .	Panie	8	Masc
Aparaturę filmową obsługuje instruktor terenowy PDK Czesław Fudala .	Fudala	7	Masc
Polonia zagrała bez trzech piłkarzy z podstawowego składu .	Polonia	0	Fem
Gdzie jest Zuza ?	Zuza	2	Fem
Oczywiście SLD mogło by być ugrupowaniem ateistycznym albo umiarkowanie areligijnym .	SLD	1	Neut
Zosia Szymanowska była starszą siostrą Antka , mego dawnego kolegi od Batorego .	Zosia	0	Fem
Będą pracować w Wilczycach i w rejonie Ćmielowa .	Wilczycach	3	Neut
CZY WARTO PISAC O INGEMARZE STENMARKU ?	STENMARKU	5	Masc
Po odparciu ataku i ujęciu 10 terrorystów zawrócono konwój do bazy w Al Kut .	Al	12	Neut
Jagienka jest młoda i nowoczesna , idzie do Iwony , by zrobić sobie pasemka .	Iwony	8	Fem
Czy naprawdę Dior nie robi nic droższego ?	Dior	2	Masc
Na wschodzie majaczą szczyty Tynioka , Ganczerki , a tam dalej , już niewidoczna , bardziej na północ , jest Barania .	Tynioka	4	Masc
Sołtys Ligoty Stanisław Kuźnik składa serdeczne podziękowanie wszystkim sponsorom , którzy przyczynili się do zorganizowania festynu i dzięki którym dzieci z Ligoty będą mogły pojechać na wycieczkę .	Ligoty	1	Fem
Spała , Wałcz czy Cetniewo są od dawna ośrodkami na najwyższym europejskim poziomie .	Cetniewo	4	Neut
Nowicki trochę zły podniósł lunetę .	Nowicki	0	Masc
CZY WARTO PISAC O INGEMARZE STENMARKU ?	INGEMARZE	4	Masc
Kiedy mijali ostatnie domy , Kajaki zbliżył się do wozu i położył łokieć na drabince .	Kajaki	5	Masc
Akurat wtedy , gdy kadrowicze rozpakowywali w Warszawie swój sprzęt po powrocie ze zgrupowania w Barsinghausen , w kościele w Kazimierzu zebrał się tłum wiernych , który modlił się o powodzenie naszej drużyny w zbliżających się mistrzostwach świata .	Barsinghausen	15	Neut
Po trzech dniach Śpiąca Królewna wróciła do Warszawy .	Królewna	4	Fem
Zyta milknie , Blanka opowiada o kłopotach małżeńskich .	Blanka	3	Fem
Nade mną stała Jędrusia .	Jędrusia	3	Fem
Po sukcesie wyborczym NSDAP w lipcu 1932 naród niemiecki zaczyna przejawiać ślady otrzeźwienia .	NSDAP	3	Fem
Kanclerz Kiesinger wyraźnie oświadczył , że jego rząd uzależnia przystąpienie NRF do układu od szeregu warunków i w ogóle odkłada ten problem na nieokreślony termin .	Kiesinger	1	Masc
I przez ten rok chodzić do AA przynajmniej trzy razy w tygodniu .	AA	6	Neut
Postój w tym byłym górniczym mieście poprzedził dyskretny telefon z ABW do władz grodu .	ABW	10	Fem
Topielec zobaczył jakiś ruch w tej martwocie .	Topielec	0	Masc
11-latek przyniósł do szkoły w Studziankach granat .	Studziankach	5	Neut
Jest też Roll Ball .	Roll	2	Masc
Do tej pory Jarosław Kret , prezenter z TVP , był nieugięty .	Jarosław	3	Masc
Pomodlę się za Polskę .	Polskę	3	Fem
Doskonale zagrał u nas Krzysztof Zych .	Zych	5	Masc
Mażoretki , mające na koncie tytułu mistrzowskie w Polsce , pojechały na europejski championat do Bratysławy .	Bratysławy	15	Fem
Ale dla mnie nie ma różnicy między Włochem , Polakiem czy Węgrem .	Polakiem	9	Masc
Wieś leży na Szlaku Zamonitu z Błędowa do Poraja .	Błędowa	6	Neut
Niezadowolenie wyrazili również jej koledzy z SDP .	SDP	6	Neut
Hanka , będę wam przysyłać .	Hanka	0	Fem
Jeszcze wczoraj Francja miała zarządzić blokadę kont Osamy bin Ladena oraz 26 innych osób i organizacji znajdujących się na amerykańskiej liście terrorystów .	Osamy	7	Masc
Lucynka spojżała w okno i zobaczyła wielkiego , kudłatego zwierzaka .	Lucynka	0	Fem
Był Szulkin .	Szulkin	1	Masc
Zadzwonimy do Patrycji . . .	Patrycji	2	Fem
Zasiedział się Lisiewicz do późna za biurkiem .	Lisiewicz	2	Masc
Może Beata trafiła tu z całkiem innego powodu ?	Beata	1	Fem
Piotr wisiał na belce .	Piotr	0	Masc
Gospodarstwo Stanisławy Sowy , Irki Paulako i Moniki Niebrzydowskiej rozszerza się powoli poza obręb zabudowań gospodarskich .	Sowy	2	Fem
Była to Zośka Buraczyńska .	Zośka	2	Fem
Protokół i listę mówców prowadzić będą pani posłanka Zdzisława Kobylińska oraz pan poseł Andrzej Zapałowski .	Kobylińska	9	Fem
Do gabinetu weszła panna Wunsch i położyła na biurku Trentscha niebieski skoroszyt .	Wunsch	4	Fem
Henryk informował , że Jenny przespała granicę i nikt jej nawet nie budził .	Jenny	4	Fem
W LIZBONIE zakończyła się 66 sesja Rady Europy na szczeblu ministrów spraw zagranicznych 21 państw kapitalistycznych naszego kontynentu .	LIZBONIE	1	Fem
Poznali się na weselu brata Edyty .	Edyty	5	Fem
Siadam w kącie i usypiam , budząc się na Gare du Nord .	Gare	9	Fem
IRA nie pozwoli ?	IRA	0	Fem
Bożenka zauważyła ją pierwsza .	Bożenka	0	Fem
Rumieniec buchnął na policzki Janka .	Janka	4	Masc
- Sława , Maryna i Krzysztof podbiegają i odbierają od niej paczki .	Maryna	3	Fem
Mankamentem rundy wiosennej były mecze wyjazdowe Obry .	Obry	6	Fem
Szmid swe wyjaśnienia przekazał prezydentowi Markowi Koćmielowi .	Koćmielowi	6	Masc
Trwa izraelska akcja zbrojna w Strefie Gazy .	Gazy	6	Fem
Liwus , Magdasf1 ma rację , lepiej dla pewności zrobić sobie test .	Liwus	0	Fem
Sto lat temu w Tucholi na gaz zapalano latarnie .	Tucholi	4	Fem
Kontrolę w PAR zlecił jesienią ub.r . minister łączności Maciej Srebro .	Srebro	10	Masc
Jeździ Pan na Żywiecczyźnie ?	Żywiecczyźnie	3	Fem
Tydzień temu na zebraniu mieszkańcy Jarosławska postanowili pozbyć się księdza .	Jarosławska	5	Neut
Jakimiszyn pochodzi z Baku , tu do dziś mieszka jego matka .	Baku	3	Neut
Oryginalne lampy zdobyto z zasobów niemieckich przeznaczonych dla Wehrmachtu .	Wehrmachtu	8	Masc
Dobrze spisała się młodzież w Sterdyni , Ceranowie , Skrzeszynie , Czerwonce i Wężach .	Ceranowie	7	Neut
Ta przekazała sprawę do PW w Lesznie .	Lesznie	6	Neut
Niestety zabrakło światowej sławy muzyka , przyjaciela Karola Szymanowskiego , Romana Totenberga , któremu choroba nie pozwoliła na przyjazd do Zakopanego .	Szymanowskiego	8	Masc
CPN szukał więc czegoś nowego .	CPN	0	Masc
On też miał we Lwowie kancelarię prawniczą .	Lwowie	4	Masc
Zajmowały się tym już Zofia Korczak - Blatonowa i Aniela Cieszkowska .	Aniela	9	Fem
Pierwsza z wymienionych sygnalizacji pojawi się u zbiegu ulic Gdyńskiej i Piaskowej w Koziegłowach .	Koziegłowach	13	Neut
Dziękujemy w imieniu Agnieszki Kulig .	Agnieszki	3	Fem
Wojska etiopskie kontynuują ofensywę w Erytrei .	Erytrei	5	Fem
A ja z Armenami świetnie się po rosyjsku dogaduję .	Armenami	3	Masc
Piłkarze FC Porto zapewnili sobie wczoraj ponownie tytuł mistrzów Portugalii .	Porto	2	Neut
Po odparciu ataku i ujęciu 10 terrorystów zawrócono konwój do bazy w Al Kut .	Kut	13	Neut
Nagle zza jej ramienia pojawiła się czarna , mała twarzyczka Kamili .	Kamili	10	Fem
– Dzwonił jakiś Kluba , pytał się , czy wiesz , że Zając nie żyje .	Kluba	3	Masc
Konwój został zaatakowany w okolicach An Numaniyah w prowincji Wasit .	Wasit	9	Neut
Adam po pobycie w Nowym Jorku nie mógł już w Krośnie złapać oddechu , postanowił zbudować dom pod Krakowem .	Krośnie	10	Neut
Do sześciu głodujących w Poznaniu dołączyło w piątek trzech związkowców ze Śremu .	Śremu	11	Masc
Przygryzając wargi z bezsilnej złości , Chmura wołał Adasia .	Adasia	8	Masc
W końcu lipca przyjechał po mnie Ojciec i pojechali śmy do Kielc .	Kielc	11	Neut
Po Jugosławii podróżowali śmy z namiotem , szukając pól campingowych .	Jugosławii	1	Fem
Zmniejszył szanse elekcyjne Marka Borowskiego .	Borowskiego	4	Masc
Tassilo de Tresckow zajechał go i ciął mieczem .	Tresckow	2	Masc
Zaangażowała się w Teatrze Dramatycznym kierowanym wówczas przez Gustawa Holoubka .	Holoubka	9	Masc
Na skrzyżowaniu Lidka zatrzymała się nagle .	Lidka	2	Fem
- I Hryćko do mnie przystał .	Hryćko	2	Masc
Tadzio śpi .	Tadzio	0	Masc
W końcu znalazł się w Lesznie .	Lesznie	5	Neut
Proszę bardzo , pan pułkownik Nowek , ekspert komisji .	Nowek	5	Masc
To pewnie porwana Angielka , cieszyły się polskie media .	Angielka	3	Fem
Niedawno wywiadu udzielił nam Bogusław Wołoszański .	Bogusław	4	Masc
Przedsiębiorcę z Barda niepokoi , że w obrocie gospodarczym brakuje pieniędzy .	Barda	2	Neut
Proszę uprzejmie , pan poseł Zbyszek Zaborowski z SLD .	SLD	8	Masc
Tadeuszowi wydało się , że w pewien sposób odgrodziła go także od Zanze .	Zanze	12	Fem
Kupuje tu nie tylko brytyjska Polonia , ale i rodowici londyńczycy .	Polonia	5	Fem
Czy w Kielcach uczył się w szkole rabinackiej i czy naprawdę był rabinem , jak zapewniał Fangora i inne osoby w Ameryce ?	Fangora	16	Masc
Nergal Sar wycofał się na górę niepostrzeżenie .	Nergal	0	Masc
Wówczas pan Olewnik jeszcze wierzył , że nowa grupa działa sprawnie i robi wszystko , by odzyskać jego syna . . .	Olewnik	2	Masc
W sobotnią noc na parkingu dyskoteki w Nowych Bielicach uszkodzono dwa samochody .	Bielicach	8	Neut
Do Gdyni dotarła wczoraj oczekiwana od kilku dni amerykańska koszykarka Edna Campbell .	Campbell	11	Fem
WITAM PANA , DROGI FIATOWCU ! ! !	FIATOWCU	4	Masc
W słowackich Tatrach piorun uderzył w parę polskich turystów .	Tatrach	2	Neut
Rosjanie zajęli Baranowicze i biją się na przedmieściach Wilna .	Baranowicze	2	Masc
A dał Kaliszowi Niderlandy .	Niderlandy	3	Neut
- Proszę bardzo , pan poseł Feliks Klimczak .	Feliks	6	Masc
Dopiero wtedy Dorcia zobaczyła , że od ostatniego widzenia bardzo się zmienił em .	Dorcia	2	Fem
Uroczysta msza święta w intencji reprezentacji Polski w piłce nożnej została odprawiona w piątek w Kazimierzu Dolnym .	Kazimierzu	15	Masc
Nadmieniamy , że w pierwszą niedzielę lutego br . przeprowadzono zbiórkę pieniędzy na zakup niezbędnego urządzenia medycznego do pracowni analitycznej w Wiejskim Ośrodku Zdrowia w Brzeziu .	Brzeziu	25	Neut
Niektórzy didżeje wpisują sobie występ w Pieksie do CV .	CV	8	Neut
Może warto odkryć Amerykę .	Amerykę	3	Fem
Izydor znieruchomiał z kopiowym ołówkiem nad blankietem reklamacyjnym .	Izydor	0	Masc
Rodzice Agnieszki nie motywowali jej do nauki .	Agnieszki	1	Fem
Pozwoliło to załatwić ostatecznie sprawę Czechowicza .	Czechowicza	5	Masc
Sprawą zajęła się już prokuratura w Gryficach .	Gryficach	6	Neut
Zdaniem ekspertów pytanych przez PG , nowe prawo farmaceutyczne nie spowoduje odpływu reklamodawców .	PG	4	Neut
Wspomina przecież , że był na Sybirze razem z Antonim Schmidtem .	Sybirze	6	Masc
Ameryka nie marzy o czymś jeszcze trudniejszym niż Irak i Afganistan .	Ameryka	0	Fem
Stęknęły sprężyny sąsiedniego łóżka i usłyszał zaspany głos Gerdy .	Gerdy	8	Fem
Nawiedzony dom w Rajsach znają wszyscy , zarówno mieszkańcy Miejsca Piastowego , jak i krośnianie .	Rajsach	3	Neut
chwalmy pana przez Maryję .	Maryję	3	Fem
Komara wyprodukowała brytyjska firma Compound Security .	Compound	4	Fem
Niemcy ciągle kontratakują w Normandii .	Normandii	4	Fem
Rzecznik przyznała , ze ministerstwa generalnie krytykują założenia przygotowane przez ministra finansów Jarosława Bauca .	Bauca	13	Masc
Trupy wrzucono do Gopła .	Gopła	3	Neut
Przecież dziecko było wielkim pragnieniem Makbeta .	Makbeta	5	Masc
Czy Lepper się zmienił ?	Lepper	1	Masc
Pomimo smutnej wymowy , sztuka obfituje w sceny humorystyczne , można również posłuchać piosenek Wasowskiego i Przybory .	Przybory	16	Masc
Chociaż faktem jest , że Hubal okropnie przeżył te zdarzenia .	Hubal	5	Masc
Do wypadku doszło na drodze z Gilwy do Prabut .	Prabut	8	Neut
Podczas obchodu można było się przekonać , że nastąpiły gruntowne zmiany w pomieszczeniach CSiK .	CSiK	13	Neut
Kuba , zbliż no się do mnie , niech cię pocałuję .	Kuba	0	Masc
Właścicielką bagażu była Polka , która wróciła do kraju z USA .	Polka	3	Fem
Jędrusia przysiadła na brzegu .	Jędrusia	0	Fem
Janina Michaluk leży w szpitalu w Gryficach .	Gryficach	6	Neut
Ashram w Magliano Sabina to ośrodek dla małych dzieci Sahaja Yoginów .	Magliano	2	Neut
W kuchni unoszą się smakowite zapachy , pani Grażyna wyciąga z szuflady sztućce .	Grażyna	8	Fem
- Zmarszczka przecięła czoło Tygellina .	Tygellina	4	Masc
Białoruś wie , czym była Bereza .	Bereza	5	Fem
Szczęsny nie wracał .	Szczęsny	0	Masc
Uniemożliwiła mu to bardzo ofensywna postawa Raftera .	Raftera	6	Masc
Wzięli w niej udział przedstawiciele policji z Niemiec , Czech , Słowacji , Węgier , Ukrainy i Polski .	Słowacji	11	Fem
nie jesteśmy państwem granicznym jak Turcja .	Turcja	5	Fem
W niedzielny wieczór premier Izraela Ariel Saron ogłosił wojnę z palestyńskim terroryzmem .	Izraela	4	Masc
Oczywiście nie zabrakło w tym momencie również opiekunki stypendystów pani Karoliny Szybki .	Szybki	11	Fem
Z każdym rokiem ruch osobowy i towarowy na przejściu granicznym w Chyżnem rośnie .	Chyżnem	11	Neut
Głos ma pan poseł Jerzy Jaskiernia , Sojusz Lewicy Demokratycznej .	Jaskiernia	5	Masc
Dziękujemy w imieniu Agnieszki Kulig .	Kulig	4	Fem
Avallac'h milczał przez chwilę .	Avallac'h	0	Masc
Dobrze spisała się młodzież w Sterdyni , Ceranowie , Skrzeszynie , Czerwonce i Wężach .	Skrzeszynie	9	Neut
Innym razem pojechała z Kaharem do portu Xiamen na południu Chin , gdzie kupili trzy japońskie magnetowidy .	Chin	10	Neut
Janka całe życie pracowała w biurze .	Janka	0	Fem
Szwedzi , biedny naród , nie znają zapachu piekarni , świeżego , prawdziwego chlebka .	Szwedzi	0	Masc
- Geralt odebrał pieniądze z rąk Przegrzybka .	Przegrzybka	6	Masc
Kazał Paoli przynieść sobie drinka .	Paoli	1	Fem
Na pewno pan nie wróci do Zakopanego ?	Zakopanego	6	Neut
Zza kulis wychodzi aktorka grająca Magdalenkę .	Magdalenkę	5	Fem
Tradycja związana ze św . Wojciechem głosi , że w X w . założył on w Trzemesznie klasztor benedyktynów .	Trzemesznie	16	Neut
Jędrusia przysiadła na brzegu .	Jędrusia	0	Fem
Prezes PZU Władysław Jamroży i członek zarządu Grzegorz Wieczerzak nadal są zawieszeni w pełnieniu swoich funkcji .	PZU	1	Masc
Adam wspaniale tańczył , okazywał Edycie dużo zainteresowania .	Edycie	5	Fem
We współczesnej dyskusji takie zarzuty stawiali H . Williams , N . Abercrombie , J . Larrain , W . Carlsnaes .	Carlsnaes	20	Masc
Za 30.000 złotych wyremontowana została ulica prowadząca do ośrodka zdrowia w Lubiewie .	Lubiewie	11	Neut
W Krakowie symbolizowały je deski .	Krakowie	1	Masc
Pierwszym zapisanym mówcą jest senator Zbigniew Kulak .	Kulak	6	Masc
Ale Europa Zachodnia jest bardzo łagodna i tolerancyjna wobec zbrodniarzy komunistycznych .	Europa	1	Fem
Rebecca Romijn - Stamos dzieli się z nami sekretami swojej urody .	Stamos	3	Fem
Na skrzyżowaniu Lidka zatrzymała się nagle .	Lidka	2	Fem
Jaro pofatygował się zadośćuczynić życzeniu klienta , a tymczasem dziewczyny na scenie dały spokój rurce .	Jaro	0	Masc
- Możliwość odejścia Leszka Balcerowicza bardzo zaniepokoiła inwestorów .	Balcerowicza	4	Masc
Kiedyś mieszkali tu razem Chorwaci i Serbowie .	Serbowie	6	Masc
Dzięki jego zaangażowaniu w naszym mieście nadal funkcjonuje sekcja piłki nożnej na odpowiednim poziomie sportowym , promująca Jarosław na terenie Polski południowo - wschodniej .	Jarosław	17	Masc
Dwaj nieznani mężczyźni okradają restauratorów we Włochach , Opaczy , Pruszkowie .	Opaczy	8	Fem
Kapitan Bayernu trafił do siatki Koeln jeszcze raz w 68 . minucie .	Koeln	5	Masc
Podkreśla się , ze był on najlepszym rozgrywającym ligi i ojcem dominacji Chicago Fire w rozgrywkach grupowych .	Fire	13	Neut
Przekonywał , że Wielkopolska jest przygotowana do skorzystania z unijnej oferty .	Wielkopolska	3	Fem
W Europie firma posiada ponad 70 sklepów , głównie w Niemczech , Holandii , Luksemburgu .	Europie	1	Fem
Właścicielom wystarcza kino domowe , a bogate panie nie potrafią docenić kunsztu Anny Jaxy - Chamiec .	Anny	12	Fem
Rudowłosa pani Hania błyskawicznie wydawała karty drogowe , tablice rajdowe , plakietki , oficjalne itinerery .	Hania	2	Fem
Ich celem był sklep spożywczy w Niedalinie .	Niedalinie	6	Neut
Grit siedziała już u Weberów .	Grit	0	Fem
Decyzja zapadła , mimo że szefowie tajnych służb ostrzegli , iż Palestyńczycy wyjdą na ulice .	Palestyńczycy	11	Masc
Po opadach deszczu nadleśniczowie z Tucholi , Woziwody , Zamrzenicy i Trzebcin podjęli decyzję o wycofaniu zakazu .	Trzebcin	11	Neut
Droga do Falsztyna prowadzi przez łagodne wzgórza Pienin Spiskich .	Pienin	7	Neut
Od dwóch lat w Woli Skolankowskiej goszczą niepełnosprawni artyści z Centrum Rehabilitacji w Grudziądzu .	Woli	4	Fem
Hiszpański wicekról Argentyny kazał wysłać znalezisko do Madrytu .	Argentyny	2	Fem
Słyszymy dzwony z oddali , szczekanie psa , odgłosy zasypiającego Przymorza .	Przymorza	10	Neut
Czy prowadzi nas jeszcze Orfeusz , czy Hermes , a może od dawna już idziemy sami ?	Orfeusz	4	Masc
Wziął em Roszka pod pachę i poszli śmy do nas do domu .	Roszka	2	Masc
I przez ten rok chodzić do AA przynajmniej trzy razy w tygodniu .	AA	6	Neut
Gdyby Celina Szulc pozostała na stanowisku , związkowcy zamierzali ogłosić wczoraj strajk okupacyjny w łomżyńskich wodociągach .	Szulc	2	Fem
Podobnie jak we współczesnej Japonii , również w Tybecie żywe są dawne herbaciane tradycje , chociaż przyczyny ich kultywowania są zgoła odmienne .	Tybecie	8	Masc
Stacja Nędza wielokrotnie zmieniała swoją nazwę .	Nędza	1	Fem
Dziękujemy w imieniu Agnieszki Kulig .	Agnieszki	3	Fem
W ten sposób Rumuni wystąpili w roli głównego mediatora pomiędzy Moskwą a Pekinem .	Pekinem	12	Masc
Z radia dobiegały ostatnie tony walca Brahmsa .	Brahmsa	6	Masc
Burmistrz Tadeusz Kowalski dogląda realizacji zadania .	Kowalski	2	Masc
Dlatego uważam , że wspólna Europa mogłaby istnieć na fundamencie kultury .	Europa	5	Fem
A tu leży Agryppa , Paracelsus i Albertus Magnus .	Albertus	7	Masc
Gdy odbywa służbę wojskową w Maroku , wielkie wrażenie robi na nim głęboka religijność wyznawców Islamu .	Maroku	5	Neut
Jaskier jęknął i pobiegł .	Jaskier	0	Masc
Ajataka wzruszyła ramionami i pociągnęła mnie do windy .	Ajataka	0	Fem
Brak drapaczom na Ś-W zaplecza w postaci sklepów spożywczych .	Ś-W	3	Fem
Według Zofii Staśkiewicz z Dworu Artusa , artyści bardzo chętnie godzą się na koncerty w Toruniu .	Zofii	1	Fem
Peter mimowolnie uśmiechnął się .	Peter	0	Masc
Mimo że Amerykanie uznali operację za udaną , z rejonu walk zdołało wymknąć się wielu partyzantów .	Amerykanie	2	Masc
- Kriszan , odwieziesz pana na Stare Delhi .	Delhi	7	Neut
Złoty medal w kategorii do 68 kilogramów zdobyła Kamila Zgolak .	Zgolak	9	Fem
Kasia zrezygnowała .	Kasia	0	Fem
Demonstranci mieli flagi Liberalno - Demokratycznej Partii Rosji , organizacji politycznej znanego nacjonalisty Żyrinowskiego .	Żyrinowskiego	13	Masc
ZSRR wypowiada wojnę Japonii .	Japonii	3	Fem
- Chłopaka w beznadziejnym stanie przywieziono do Zabrza .	Zabrza	7	Neut
Stworzyła polski oddział EquiLibre , organizowała konwoje z pomocą dla byłej Jugosławii , Kazachstanu , Czeczenii .	Jugosławii	11	Fem
- Jakie znaczenie dla śledztwa ma odkrycie dokonane w archiwach w Łomży , o którym niedawno poinformowała prof . Daria Nałęcz ?	Łomży	11	Fem
Wiezie on pismo cesarza Hajle Sellasje do pułkownika Bumediena .	Hajle	4	Masc
Przyjechał em , żeby ratować Gruzję .	Gruzję	5	Fem
W Venezii Keneth ciągle leczył kontuzje , nie doszedł do formy .	Keneth	2	Masc
Książkę wydrukowano w Polsce na zlecenie paryskiej Edition Cercle d'Arts .	Edition	7	Fem
Na Podkarpaciu oficjalnie kampania żniwna zacznie się w przyszłym tygodniu .	Podkarpaciu	1	Neut
Pan Bóg wyjął Ewę z boku Adama i to jest zboczenie .	Ewę	3	Fem
Czekał tam na mnie Holeksa .	Holeksa	4	Masc
Weronka i Janek Bajurski siedzą .	Weronka	0	Fem
Bessona Joannę d'Arc również ogląda się jak film bez dialogów .	Bessona	0	Masc
Izrael zagroził wczoraj , że wkroczy zbrojnie na tereny Autonomii , jeśli Arafat nie zapanuje nad terrorem .	Arafat	12	Masc
W Wielkopolsce na nową maturę zdecydowało się 522 abiturientów .	Wielkopolsce	1	Fem
Maria Fryc została przewieziona do szpitala .	Fryc	1	Fem
Kopaliński skwapliwie przytaknął .	Kopaliński	0	Masc
- To nasi obrońcy przed IRA !	IRA	5	Fem
Politycy opozycji poinformowali również , że zamierzają złożyć do Trybunału Konstytucyjnego wniosek w sprawie niekonstytucyjności ustawy o ABW i AW .	ABW	17	Fem
Jasieńczyk o nią zapytał .	Jasieńczyk	0	Masc
Przewiduje on wynajęcie firm zewnętrznych , które zajmą się utrzymaniem sieci abonenckiej TP SA .	TP	12	Fem
W czasie obławy policjantom z Pieniężna udało się zatrzymać dwóch kłusowników .	Pieniężna	5	Neut
Resa pośpieszyła do Ab-Rama , czekającego niecierpliwie w swoim namiocie .	Resa	0	Fem
Kino w Tuczępach posiada osiemdziesiąt miejsc .	Tuczępach	2	Neut
Pablo podszedł do Wójcika .	Wójcika	3	Masc
- Jurek mnie puścił .	Jurek	1	Masc
Przy władającym Uranie twoja twórczość może ujawniać się jako zdolności wynalazcze .	Uranie	2	Masc
Premier Józef Cyrankiewicz przyjął wicepremiera Rumunii George Radalescu .	Rumunii	5	Fem
Wikipedia , nasz siostrzany projekt , zawiera artykuł na temat nawozów zielonych .	Wikipedia	0	Fem
– Zidentyfikował z uśmiechem suknię , kupioną w salonie Coco Chanel .	Chanel	10	Fem
Produkcję nadzorował w Krośnie Jerzy .	Krośnie	3	Neut
Na czwarte miejsce finiszowała Diana Star .	Diana	4	Fem
Swoje problemy ma też Hanna Gronkiewicz - Waltz .	Gronkiewicz	5	Fem
Czy musiały śmy tu przyjechać z tą wstrętną Grochulską ?	Grochulską	8	Fem
Partia Konserwatywna zawiesiła Spencera w obowiązkach posła .	Spencera	3	Masc
Czytałem , że to dobry kryminał , poza tym lubię Ginę Gershon .	Ginę	10	Fem
Najlepszy polski tyczkarz Janusz Gronowski przebywa obecnie w Finlandii .	Finlandii	8	Fem
Wypłynęli śmy z Baški .	Baški	3	Fem
Fiokła spała w sąsiednim pokoju .	Fiokła	0	Fem
Zyta milknie , Blanka opowiada o kłopotach małżeńskich .	Blanka	3	Fem
Kranik przygodę z kapitalizmem zaczął od warsztatu z czterema krawcowymi .	Kranik	0	Masc
Przystupa odstawiła szklankę po whisky i skuliła się w fotelu , pan Cox wyglądał , jakby się właśnie obudził .	Przystupa	0	Fem
Według stołecznych policjantów , udało mu się zgromadzić wokół siebie młodych przestępców z Pragi .	Pragi	13	Fem
Beata miała wtedy 18 lat .	Beata	0	Fem
Syn ma przyjechać z Białegostoku . . .	Białegostoku	4	Masc
W 1990 r . Smolański brał czynny udział w napaści na afrykańskich studentów manifestujących na wrocławskim rynku .	Smolański	4	Masc
- Wstydź się , Zuzanno , tak kłamać , zapłacił ci za Jadzię .	Zuzanno	4	Fem
W państwach europejskich , takich jak Szwecja , które mają dużo imigrantów z tego regionu , zwyczaj zwalczany jest z całą surowością prawa .	Szwecja	6	Fem
Droga do Falsztyna prowadzi przez łagodne wzgórza Pienin Spiskich .	Falsztyna	2	Masc
Był by to trzeci z rzędu rok , kiedy Francja nie sprostała wymaganiom UE .	Francja	9	Fem
Zapomniał eś dodać okultyzm Ojca Pio i Katarzyny Neuman .	Neuman	8	Fem
Piotr A . bije go pięścią , a jego kompan Piotr G . kopie w tył głowy .	Piotr	0	Masc
Wróbel był zaskoczony wiedzą posła Grzesika .	Wróbel	0	Masc
W Kcyni odbyło się spotkanie z kandydatami na kierowników na samodzielny publiczny zakład opieki zdrowotnej w Kcyni i Kowalewku .	Kcyni	1	Fem
Do najciekawszych należą parki w Wierzonce i Owińskach .	Wierzonce	5	Fem
Proszę zobaczyć , ilu posłów AWS nie głosowało .	AWS	5	Fem
Wspomina przecież , że był na Sybirze razem z Antonim Schmidtem .	Schmidtem	10	Masc
W Betlejem zupełnie utracili ducha dociekliwości , z punktu widzenia intelektualisty zachowali się nadzwyczaj pokornie .	Betlejem	1	Neut
Uratujcie wierzącego chrześcijanina Walerego Marczenkę !	Walerego	3	Masc
Jesienią Hamid też poszedł na wojnę , by pomścić brata .	Hamid	1	Masc
- Na razie przedstawiciele SLD spotkali się z Jerzym Buzkiem .	Buzkiem	9	Masc
Szkoda , że nie można dysponować Heinzem Mirynkiem .	Heinzem	6	Masc
Jak poinformował Cesar Fraga z Uniwersytetu w Buenos Aires , przeprowadzone tam badania wykazały , że czekolada wzmacnia antyutleniacze znajdujące się we krwi , zwiększając odporność na zaburzenia serca i naczyń wieńcowych .	Buenos	7	Neut
Czy La Famille Richet istotnie została zaprezentowana w Edynburgu ?	Edynburgu	8	Masc
Na cmentarzu w Koniku Nowym leży ponad 100 psów , pięć kotów i jeden chomik .	Koniku	3	Masc
Niedługo zobaczymy Tomasza Adamka reklamującego piwo albo męską bieliznę ?	Adamka	3	Masc
Próba przekroczenia granicy Rzeczypospolitej przez grupę kolarzy spod znaku UPA wywołała ogólnopolskie oburzenie .	UPA	9	Fem
Na parkingu do samochodu Kosińskiego dosiadł się Osiński .	Kosińskiego	4	Masc
Obiecankami zakończyło się sylwestrowe połączenie z Wrocławiem .	Wrocławiem	6	Masc
W niedzielę 7 czerwca o godz . 17 Odra podejmuje Inę , a Mieszko o tej samej godzinie u siebie gra z Dąbrovią .	Mieszko	13	Masc
Tylko w czterech państwach w Europie pojawiły się sieci DCS .	Europie	5	Fem
– Mock wstał , a jego twarz nabrzmiała z gniewu .	Mock	1	Masc
Krewna Krystyny , która wciąż stała obok mnie , zajrzała mi przez ramię .	Krystyny	1	Fem
Zginęło w niej 8 żołnierzy amerykańskich , 7 współpracujących z nimi Afgańczyków oraz kilkuset Talibów i bojowników Al-Qaidy .	Al-Qaidy	17	Fem
Natomiast zdjęcia eksponowane w MDK ukazują nowe spojrzenie na fotografię , którego dominantą jest wykonywanie makrofotograficznych ujęć z bardzo bliskiej odległości przy małej głębi ostrości .	MDK	4	Masc
W Małej Komorzy z tego powodu zapaliły się sadze .	Komorzy	2	Fem
kiedy jest Boże Ciało ?	Ciało	3	Neut
Przewodniczący Rady Państwa NRD Walter Ulbricht odwiedził Jugosławię .	Jugosławię	7	Fem
Za naszym domem też tęsknił , pisał , że nie może zapomnieć Wigilii przy kolędach na Wzgórzu .	Wigilii	12	Fem
Do nich należeli niewątpliwie Mannerheim , Paasikivi i Tanner .	Mannerheim	4	Masc
Rada Nadzorcza PZU zebrała się wczoraj rano .	PZU	2	Masc
Równolegle z kilkoma innymi inwestycjami w Tucholi rozpoczęły się prace związane z budową nawierzchni asfaltowej na podbudowie z gruzobetonu na ulicy Mickiewicza .	Tucholi	6	Fem
Mały Marcel lubi oglądać kościoły .	Marcel	1	Masc
Odeszli , choć mogli zapytać o to i owo w samym Betlejem .	Betlejem	11	Neut
Misję tę powierzyła doktorowi Lane matka Oswalda , Marguerite .	Lane	4	Masc
To były Alpy .	Alpy	2	Neut
Handzia leżała na plecach , postękując lekko , Wiktor rżnął ją monotonnie i beznamiętnie .	Handzia	0	Fem
Może Teodor nadal żyje ?	Teodor	1	Masc
IV Zjazd Absolwentów Liceum Ogólnokształcącego odbył się w sobotę w Tucholi .	Tucholi	10	Fem
To w Czesławie nadal Róży się podoba .	Róży	4	Fem
Angelina oczywiście wyraziła chęć ponownego zagrania Lary Croft .	Croft	7	Fem
A przecież prezydent Kaczyński odsłaniał kiedyś pomnik Ognia i wtedy prawie nikt nie był oburzony .	Ognia	7	Masc
Wzięli w niej udział przedstawiciele policji z Niemiec , Czech , Słowacji , Węgier , Ukrainy i Polski .	Węgier	13	Neut
Spotkanie poprowadził dyrektor TVB Kazimierz Puciłowski .	TVB	3	Fem
W Pruszkowie gang zorganizowali wychowankowie słynnego w czasach PRL bandyty Barabasza .	PRL	8	Fem
Dobiszewski nie pamięta .	Dobiszewski	0	Masc
W połowie lat sześćdziesiątych łowiłem z przyjaciółmi na Biebrzy .	Biebrzy	8	Fem
Psychiatra przysuwa krzesło do leżanki i siada obok Bartodzieja z notesem w ręku .	Bartodzieja	8	Masc
– sika w Stanach ?	Stanach	3	Neut
Można też załatwić L-4 za alkohol .	L-4	3	Neut
W gościnnym pokoju u Czapków zasiadają często naukowcy .	Czapków	4	Masc
Ten Murzyn to sekretarz generalny ONZ , Kofi Annan .	ONZ	5	Fem
- Pan ma spotkanie z Zombiem ?	Zombiem	5	Masc
- Przemawiała pani poseł Maria Stolzman .	Stolzman	5	Fem
CBŚ zarządziło na poniedziałek obławę .	CBŚ	0	Neut
– w Mel Rozie była ś ?	Mel	2	Fem
pan Wassermann powoduje konflikty .	Wassermann	1	Masc
Przyjechali też strażacy z OSP z Poronina , Suchego i Kościeliska .	Kościeliska	10	Neut
Don Esteban krzyknął .	Don	0	Masc
- Mario , jesteś już w domu .	Mario	1	Fem
– Przystupa się zaczerwieniła .	Przystupa	1	Fem
Ewa i Ania chodziły z Agnieszką do jednej klasy trzeci rok .	Ania	2	Fem
Hutnictwo polskie współpracuje z hutnictwem ZSRR , NRD , Czechosłowacji i Bułgarii .	Czechosłowacji	9	Fem
Poznali się na weselu brata Edyty .	Edyty	5	Fem
Przypuszczam , że ten człowiek nie należy do SLD .	SLD	8	Masc
Giertych robi to samo Kwachowi .	Kwachowi	4	Masc
Malwina spojrzała na niego z odrazą , Kulesza się zaczerwienił , ale Ewa , o dziwo , parsknęła śmiechem .	Malwina	0	Fem
W miniony czwartek w referendum ratyfikacyjnym Irlandia odrzuciła ten Traktat , otwierający drogę do rozszerzenia Unii .	Irlandia	6	Fem
Schmidt skinął na towarzysza .	Schmidt	0	Masc
Poza Centralną Komisją Wyborczą głosy liczy także LADO .	LADO	7	Neut
- Zawsze wierzyłem w Europę .	Europę	4	Fem
Ani on , ani zastępca Grzegorz Paluch nie chcieli jednak wypowiadać się o całej sprawie na łamach prasy .	Paluch	6	Masc
Suzanne pokręciła przecząco głową .	Suzanne	0	Fem
Zdaniem senator Grześkowiak , naruszała ona zasadę zaufania obywateli do państwa .	Grześkowiak	2	Fem
- Wierzę , że kandydaci do członkostwa w NATO powinni spełniać generalne kryteria demokratycznych rządów i gospodarki wolnorynkowej , włączając w to poszanowanie dla praw człowieka oraz cywilną kontrolę nad wojskiem .	NATO	8	Fem
– Zidentyfikował z uśmiechem suknię , kupioną w salonie Coco Chanel .	Coco	9	Fem
Religijny Żyd nie wejdzie do kościoła .	Żyd	1	Masc
Tego dnia nie tylko Żanna miała swoje święto .	Żanna	4	Fem
31-letnia Karina Hoffman - Birkhead rozwiodła się w ubiegłym roku .	Karina	1	Fem
Jednak już wkrótce Nizioł i Wapiński ze zdumieniem odkryli , że Łapiński nie dotrzymuje wcześniej danego słowa .	Wapiński	5	Masc
82 proc . respondentów CBOS uważa , że różnica zarobków w Polsce jest zbyt duża .	CBOS	4	Neut
Bogusława Sztorc ze Świebodzic wróciła z pracy do domu .	Świebodzic	3	Neut
Zmarł w Livorno w roku 1846 .	Livorno	2	Neut
Ale dla mnie nie ma różnicy między Włochem , Polakiem czy Węgrem .	Włochem	7	Masc
Luiza słyszała nad sobą kroki Weelsa .	Weelsa	5	Masc
W Konstancinie-Jeziornie i Spale przygotowują się piłkarskie reprezentacje do nadzwyczaj ważnych spotkań .	Spale	3	Fem
Hinduska nie zdradza męża .	Hinduska	0	Fem
Decyzje w tej sprawie podjęły Mostostal Warszawa , Elektrim , Polifarb i Okocim .	Okocim	12	Masc
Główne dowództwo niemieckie musi objąć kierownictwo operacji wojennych we Włoszech .	Włoszech	9	Neut
Usamodzielniły się Wyry , Bojszowy , Lędziny i Bieruń .	Bojszowy	4	Neut
W stan posiadania ZPR wpisano też kasyna oraz automaty do gry .	ZPR	3	Neut
Romek stanął przed nim w postawie na baczność .	Romek	0	Masc
Rebelianci z tak zwanej Wyzwoleńczej Armii Kosowa zajęli Belacewacz tydzień temu .	Kosowa	6	Neut
Pani Maria Figiel jest teściową Barbary .	Figiel	2	Fem
Wsparł go Wierchowicz .	Wierchowicz	2	Masc
Wcześniej o ośmiu takich maturzystach informowała OKE w Łomży .	OKE	6	Fem
Jesienią zeszłego roku odwołać dyrektora Ziarkowskiego usiłowała Rada Kasy .	Ziarkowskiego	5	Masc
- Valoarna zmienia czerwony na biały !	Valoarna	1	Fem
Obecnie mieścić się one będą w Zweibruecken i w Wormacji .	Wormacji	9	Fem
" O co ci chodzi , Joasiu ?	Joasiu	6	Fem
Najpierw samodzielność uzyskał Zakład Naprawy Autobusów w Biskupicach , wcześniej stanowiący integralną część MPK .	MPK	13	Neut
Początkowo chcieli wywieźć je nad Wisłę .	Wisłę	5	Fem
Pani Alicja w sklepie sprzedaje , mąż dowozi jej towar .	Alicja	1	Fem
Goran Persson , premier Szwecji , napisał niedawno książkę .	Persson	1	Masc
Gest Handzi poruszył go głęboko .	Handzi	1	Fem
- A co jest specjalnością IV LO ?	LO	6	Neut
Reputację intelektualisty potwierdził , cytując obficie Witolda Gombrowicza i Stanisława Jerzego Leca .	Witolda	6	Masc
Suzanne pokręciła przecząco głową .	Suzanne	0	Fem
Strajk ten objął całą Francję .	Francję	4	Fem
Kontrolę prywatyzacji jednoosobowych spółek Agencji WRSP Izba przeprowadziła na zlecenie sejmowej Komisji Rolnictwa i Rozwoju Wsi .	WRSP	5	Fem
Niech żyje generał Judenicz !	Judenicz	3	Masc
Irenka była Belgijką .	Irenka	0	Fem
W drzwiach pojawił się sympatyczny mężczyzna , górnik z Borynii .	Borynii	9	Fem
Nie ma pan w Jankowicach żadnych krewnych .	Jankowicach	4	Neut
Przyjechali też strażacy z OSP z Poronina , Suchego i Kościeliska .	Suchego	8	Neut
" Pewnie mu się przyśniła Francja . . .	Francja	5	Fem
Od wolnej woli wybaw nas , Panie .	Panie	6	Masc
Swojego domku obitego papą Wanda Kędzierska trochę się wstydzi .	Kędzierska	5	Fem
W wyposażeniu podstawowym znajduje się również ABS .	ABS	6	Masc
Ale Hristina nie drgnęła .	Hristina	1	Fem
Tymczasem wiceprezes Sądu Rejonowego w Kędzierzynie , Anna Lipnicka , broni decyzji koleżanki .	Lipnicka	8	Fem
Wyraźnie za Basajewem nie przepadał .	Basajewem	2	Masc
Sprzęt należał do Stacji Doświadczalnej w Łopusznej .	Łopusznej	6	Fem
Wisła w Toruniu przekroczyła stan alarmowy o 80 cm , a wody wciąż przybywa .	Wisła	0	Fem
Niedługo po tym apelu Kamiński , Wołek i Jurek spotkali się na podwieczorku u krzywdzonego Pinocheta .	Wołek	6	Masc
Zuzanna uchyla się od mówienia o sobie .	Zuzanna	0	Fem
Rodziny , które zdecydują się kupić na kredyt własne M , mogą liczyć na pomoc finansową .	M	9	Neut
Janka bez słowa wkładała już białe sandałki , sięgnęła po torebkę .	Janka	0	Fem
Za najważniejszych nazistowskich zbrodniarzy powszechnie uznawano Hitlera , Himmlera i Goebbelsa .	Himmlera	8	Masc
Niechętnie przecież opuszczali Legnicę i inne bazy wojskowe .	Legnicę	3	Fem
Wieczorem po przyjeździe do Nowego Jorku zdążyłem jeszcze przeczytać różne materiały i przygotować swoje wystąpienie , a potem odwiedziłem sekretarza generalnego ONZ U Thanta .	ONZ	21	Fem
Hrabina odwróciła się od Mocka .	Mocka	4	Masc
Protokół i listę mówców prowadzić będą pani posłanka Zdzisława Kobylińska oraz pan poseł Andrzej Zapałowski .	Zapałowski	14	Masc
Wiele szczęścia miała grupa uczniów z Warszawy , która wybrała się w niedzielę na pieszą wycieczkę po Karkonoszach .	Karkonoszach	17	Neut
Zmiany dokonane w Oplu Fronterze wyszły mu na dobre .	Fronterze	4	Fem
Angelina Jolie jest bezgranicznie zakochana w swoim adoptowanym synku , który niedawno urodził się w Kambodży .	Jolie	1	Fem
no znam trochę Ukrainę .	Ukrainę	3	Fem
Mariusz Walter zadebiutował jako reżyser już w latach 60 . , szybko związał się z telewizją publiczną , w której pracował aż do lat 80 .	Walter	1	Masc
Martha Kosicky ma blond włosy i dziadka z Polski .	Kosicky	1	Fem
- Ekspertyza balistyczna wykluczyła udział żołnierzy niemieckich w zastrzeleniu 49-letniego mężczyzny w Koniecpolu .	Koniecpolu	12	Masc
Ile lat miał wtedy Robert ?	Robert	4	Masc
Dla Grit wszystko to nowość , słucha uważnie , żeby czegoś nie przegapić .	Grit	1	Fem
Wraz z kadrą wyjadą Daria Kasperska , Paulina Rytwińska i Agnieszka Karcz .	Agnieszka	10	Fem
Robert czekał już na mnie przy tym samym stoliku , przy którym spotkaliśmy się wczoraj rano .	Robert	0	Masc
Wśród podhalańskich Cyganów z bezwzględności słynie jego współpracownik , współoskarżony w Oświęcimiu , Stanisław Kamiński z Czarnej Góry .	Cyganów	2	Masc
Na Węgrzech występuje pianistka Halina Czerny - Stefańska i jej córka klawesynistka Elżbieta Stefańska - Łukowicz .	Halina	4	Fem
Pogłaskał ją po dłoni i znowu mimowolnie zastanowił się nad kopertą od Bazarewicza .	Bazarewicza	12	Masc
Kościański zespół przegrał je wszystkie za wyjątkiem derbowego występu w Rawiczu .	Rawiczu	10	Masc
Akcję sprawozdawczo - wyborczą w pracowniczych ogrodach działkowych zakończy ogólnopolska konferencja delegatów wybranych na zjazdach wojewódzkich POD , która będzie obradowała w maju w Warszawie .	POD	16	Masc
Zabrał głos Mussolini .	Mussolini	2	Masc
Szafir umilkł .	Szafir	0	Masc
Co kwartał wysokość tych kwot może się zmienić w związku ze zmianą ceny metra kwadratowego ogłaszaną przez GUS .	GUS	17	Masc
Czykier został ukarany za niesportowy tryb życia , zaś Gierejkiewicz stracił zaufanie szkoleniowca .	Czykier	0	Masc
Ja ich spotkał em na Mazurach .	Mazurach	5	Neut
Najpierw samodzielność uzyskał Zakład Naprawy Autobusów w Biskupicach , wcześniej stanowiący integralną część MPK .	Biskupicach	7	Neut
W tym sezonie IFK spisuje się słabo .	IFK	3	Neut
W Wielką Sobotę święci się też wodę i ogień .	Sobotę	2	Fem
Jakubowski ciężko westchnął .	Jakubowski	0	Masc
Co dziś robią ludzie z GTW ?	GTW	5	Fem
Agnieszka ma jakieś Twoje cechy ?	Agnieszka	0	Fem
Justynka była ruda .	Justynka	0	Fem
Przejazd we wrocławskich Świniarach nie jest strzeżony .	Świniarach	3	Neut
Zmarł w Livorno w roku 1846 .	Livorno	2	Neut
Niewytłumaczalna zbrodnia wstrząsnęła Polską .	Polską	3	Fem
Służba Ruchu MO interweniowała w 9 kolizjach .	MO	2	Fem
W całej Europie myślistwo to hobby , za które się płaci !	Europie	2	Fem
Większość skradziono w Berlinie , Hamburgu , Kilonii i Bremie .	Bremie	9	Fem
Szefowie Masterlink zauważyli , że chociaż nie mają pracownika obok siebie , jego efektywność wzrosła .	Masterlink	1	Masc
Tak robią wandale na wikipedii .	wikipedii	4	Fem
Nawiązano współpracę z kołami gospodyń wiejskich w Domatkowie , Kolbuszowej Górnej , Nowej Wsi , Weryni i Widełce .	Wsi	13	Fem
Niedzielny wieczór to wielki koncert w Auli UAM .	UAM	7	Masc
Przypomnijmy , że na budowę centrum hurtowego nie zgadzają się mieszkańcy Osowej .	Osowej	11	Fem
Natrafiły na ń dzieci zbierające zioła dla starej Felakowej .	Felakowej	8	Fem
W Wiśle pod koniec lat 70 . grał krótko czarnoskóry Anthony Freeman .	Wiśle	1	Fem
- Codziennie jest tu opiekunka pani Gabrysia .	Gabrysia	6	Fem
Gospodarstwo Stanisławy Sowy , Irki Paulako i Moniki Niebrzydowskiej rozszerza się powoli poza obręb zabudowań gospodarskich .	Stanisławy	1	Fem
Agnieszka Strumiłowska opowiedziała mi historię z jej czasów studenckich .	Strumiłowska	1	Fem
Od zbłąkanych misjonarzy uchroń nas , Panie .	Panie	6	Masc
Wyzwanie rzuci mu senator Jacek Bachalski .	Bachalski	5	Masc
Dzieci zaczepiali na katowickim dworcu PKP .	PKP	5	Neut
Hutnictwo polskie współpracuje z hutnictwem ZSRR , NRD , Czechosłowacji i Bułgarii .	NRD	7	Fem
Marszałek Senatu Alicja Grześkowiak zwróciła się o wyjaśnienie tej sprawy do Trybunału Konstytucyjnego .	Alicja	2	Fem
31-letnia Karina Hoffman - Birkhead rozwiodła się w ubiegłym roku .	Birkhead	4	Fem
Dlatego Marek z kartonem stał teraz na poboczu , czekając na Grzesia i jego półciężarówkę .	Grzesia	11	Masc
Niestety zabrakło światowej sławy muzyka , przyjaciela Karola Szymanowskiego , Romana Totenberga , któremu choroba nie pozwoliła na przyjazd do Zakopanego .	Zakopanego	20	Neut
Pamiętam w Iveronie w sześciu gablotach stłoczone największe relikwie .	Iveronie	2	Fem
Niemcy wyrzucają z mieszkania Konstantego Prusa .	Prusa	5	Masc
Tym samym rząd Indiry Gandhi utrzymał się przy władzy .	Indiry	3	Fem
Kaźmierz oddał stryjowi latarnię ; na ziemi położył podłużny wąski przedmiot .	Kaźmierz	0	Masc
Nie zostałam więc działaczką PiS , ulubienicą Kaczyńskich i ich matki , doradczynią w PKO BP ani prezeską TVP .	PKO	14	Fem
Tadeusz Okoniewski pisał też do samych palotynek .	Tadeusz	0	Masc
Mąż Kamy zamówił koniak .	Kamy	1	Fem
- Bo mu tu Raszewski taki wieniec plecie .	Raszewski	4	Masc
Bardzo panią proszę o interwencję w FPNP .	FPNP	6	Fem
Przez dwa ostatnie tygodnie policjanci zaczęli podejrzliwie obserwować Staszka i Dawida .	Staszka	8	Masc
Tomaszewski był rozgoryczony tak długim odroczeniem swojego procesu .	Tomaszewski	0	Masc
Idiotka Zuzia zapomniała zrobić w banku blokadę i całą forsę zajęli na długi .	Zuzia	1	Fem
Ula czuła radość .	Ula	0	Fem
Na Węgrzech występuje pianistka Halina Czerny - Stefańska i jej córka klawesynistka Elżbieta Stefańska - Łukowicz .	Stefańska	7	Fem
Dobrze spisała się młodzież w Sterdyni , Ceranowie , Skrzeszynie , Czerwonce i Wężach .	Ceranowie	7	Neut
Zresztą Batura mógłby popsuć .	Batura	1	Masc
Janusz O . przyznał się do stawianych mu zarzutów i bez poręczenia majątkowego dziś wyszedł na wolność .	Janusz	0	Masc
Trzecie miejsce przypadło Zakładowi Poprawczemu z Kcyni .	Kcyni	6	Fem
Soso namyślał się .	Soso	0	Masc
Zebrali śmy się u Nocnego Śpiewaka .	Śpiewaka	5	Masc
W czasie pobytu krótko rozmawiał em z Lechem Bądkowskim .	Bądkowskim	8	Masc
- Mama , widział em Kuferbluma !	Kuferbluma	5	Masc
Wcześniej szefował ZOZ-owi w Piasecznie .	Piasecznie	4	Neut
Usłużnym kierowcą okazał się 34-letni Rob Gatena .	Gatena	6	Masc
Nazwijmy ją Lady Iks .	Iks	3	Fem
W pół godziny po wylądowaniu samolot wystartował do Londynu , z pełną 185-osobową obsadą na pokładzie .	Londynu	8	Masc
Maciej Gielecki , wojewoda warszawski , obiecał im , że Łubna II nie zostanie wybudowana .	Gielecki	1	Masc
Parokrotnie Wajdowie osobiście kwestowali na ulicach Japonii .	Wajdowie	1	Masc
W czasie weekendu dorodny lampart spacerował ulicami stolicy Indii , Delhi .	Delhi	10	Neut
– Przystupa się zaczerwieniła .	Przystupa	1	Fem
Zmarł w klinice onkologicznej w Warszawie .	Warszawie	5	Fem
Wanda Gąsior w to jednak powątpiewa .	Wanda	0	Fem
Świniak ten jest kumplem Ałganowa .	Ałganowa	4	Masc
- Agatka mówiła , że to ją strasznie bolało , ale nie mogła nawet pisnąć . . .	Agatka	1	Fem
Zresztą jutro wraca Aliosza . . .	Aliosza	3	Masc
- Mam zamiar zagrać wraz z Sinfonią Varsovią .	Varsovią	7	Fem
I przeczytaj coś o Simone de Beauvoir .	Beauvoir	6	Fem
Na Trakcie Królewskim ma stanąć Ronald Reagan .	Ronald	5	Masc
Michaelson wyróżniał się z tłumu w siłowni .	Michaelson	0	Masc
Majka siedziała obok mnie na pniu przewróconej brzozy .	Majka	0	Fem
- Czy chcesz , niewiasto , wziąć udział w uroczystościach ku czci bogini Zirbanit ?	Zirbanit	13	Fem
W Chadaju odezwała się podlaska dusza .	Chadaju	1	Masc
Lepper spotkał się wczoraj z rolnikami w Malechowie w województwie zachodniopomorskim .	Lepper	0	Masc
Jadwiga Melnyk przeszła w człuchowskim szpitalu dwa zabiegi .	Melnyk	1	Fem
Rabi Eleazar ben Cwi nie szemrze .	Eleazar	1	Masc
Gospodarze odpowiedzieli dwoma golami Ralfa Hauptmanna i Austriaka Tony Polstera .	Ralfa	4	Masc
Resa pośpieszyła do Ab-Rama , czekającego niecierpliwie w swoim namiocie .	Ab-Rama	3	Masc
Spojrzał na Staśka .	Staśka	2	Masc
Przez tydzień włóczył się bez celu po Melbourne , wyczekiwał na rozkazy .	Melbourne	7	Neut
– Ewelinka , zamknęłaś się od środka ? !	Ewelinka	1	Fem
Moda na École de Paris niewątpliwie zasłużenie dowartościowała to środowisko artystyczne , ale w przypadku niektórych nazwisk także przewartościowała .	École	2	Fem
Aby pozbyć się niespokojnego ducha z Apulii , Onufry wysłał Roberta do Kalabrii .	Onufry	8	Masc
Następcy Piotra wybrali na siedzibę Rzym , a nie Jerozolimę .	Rzym	5	Masc
Były one niezwykle rzadkie , nadające świątyni szczególne miejsce wśród wszystkich miejsc kultu na Pomorzu Gdańskim .	Pomorzu	14	Neut
Tym razem był to Haugsdorf .	Haugsdorf	4	Masc
Rozdzielali zwaśnione strony w ramach misji pokojowych ONZ .	ONZ	7	Fem
Karlik oddychał ciężko .	Karlik	0	Masc
Z Lipusza trasa powiedzie ich dalej do Sulęczyna , Sierakowic , Mirachowa i Otomina .	Sulęczyna	7	Neut
Pod stołem bawił się granatem mały chłopiec , nazywany Osęką .	Osęką	9	Masc
Bronił eksmitowanych na bruk , naprawiając błędy przyjętej przez koalicję SLD­PSL ustawy , grzmiał na globalistów i świeżych krajowych , drapieżnych kapitalistów .	SLD­PSL	10	Masc
Można wysłać SMS-a , e-maila lub połączyć się z Internetem .	SMS-a	2	Masc
Zresztą sam lider konfederatów Adam Słomka podnosi takie argumenty i zapowiada , ze będzie domagał się dyskusji o realizacji programu AWS i konieczności rekonstrukcji rządu .	AWS	20	Fem
Plecy Dobrskiego zdradzały tak wielkie rozgoryczenie .	Dobrskiego	1	Masc
Lopez milczał .	Lopez	0	Masc
Moczarskiego znał em sprzed wojny , byli śmy razem w Wyższej Szkole Dziennikarskiej , dość zaprzyjaźnieni .	Moczarskiego	0	Masc
Zwolennicy Mossadegha , ministrowie , podejrzani oficerowie , działacze Tudeh są przesłuchiwani i torturowani .	Tudeh	9	Fem
W 1831 pod Komorzem A . Mickiewicz próbował przekroczyć granicę zaborów biegnącą na Prośnie , aby wziąć udział w powstaniu listopadowym .	Prośnie	13	Fem
Rano Odra nasyca niebieskawą mgłą ulice obu miast .	Odra	1	Fem
Z ciał potopionych stryjów wylęgły się tysiące myszy i wyruszyły wszystkie do Kruszwicy , prosto na dwór zbrodniarza .	Kruszwicy	12	Fem
Padają Zakłady Cegielskiego w Poznaniu , a dialog przenosi się na ulice .	Cegielskiego	2	Masc
Seniorska reprezentacja Polski zbliża się do zgrupowania we Wronkach .	Wronkach	8	Neut
Jeszcze mniej pewny jest los podstawówki w Klonowie .	Klonowie	7	Neut
Następnym mówcą będzie pan poseł Andrzej Gołaś .	Gołaś	6	Masc
Małachowski zarzuca Kościołowi milczenie wobec wystąpień nacjonalistycznych i antysemickich .	Małachowski	0	Masc
Więc Irenka nie wie , gdzie mieszkam .	Irenka	1	Fem
Krzesimir Dębski po obejrzeniu pierwszego montażu może wreszcie zacząć komponować muzykę , którą zresztą nosił w sobie od rozpoczęcia pierwszych zdjęć .	Dębski	1	Masc
Bardzo dobrze zaprezentował się Tomasz Robaczewski .	Robaczewski	5	Masc
Gdyby Nina Terentiew ciągle rządziła Dwójką , krzywdy pani zrobić by nie dała ?	Nina	1	Fem
W niżej położonych Puławach przekroczyła stan ostrzegawczy o 30 cm .	Puławach	3	Neut
Jarosław Kaczyński ruszył w Polskę .	Jarosław	0	Masc
W Czarnem umieszczono go w celi o zaostrzonym rygorze .	Czarnem	1	Neut
Nie wiedziała , jak długo Francuzka stała w progu .	Francuzka	5	Fem
W okolicach Ełku i Giżycka nie pracują 3 linie .	Giżycka	4	Neut
Gwyneth przyznaje , że przez tych ostatnich kilka lat dojrzewała na zdwojonych obrotach .	Gwyneth	0	Fem
Wikary Pudło odprawia je żując gumę .	Pudło	1	Masc
CZY BRZECHWA ZNAŁ TOKARSKIEGO ?	TOKARSKIEGO	3	Masc
O Wilczyńskiej mówili ludzie .	Wilczyńskiej	1	Fem
Dankowski objął Bełchatów na początku sezonu , a pierwszej porażki doznał dopiero w siódmej kolejce .	Dankowski	0	Masc
Żywiła m tym Dominikę .	Dominikę	3	Fem
śledztwo IPN nie dało żadnych efektów .	IPN	1	Masc
Propozycję tę przedstawił minister Brandt .	Brandt	4	Masc
Miejsca rozgrywania spotkań zostały ustalone w drodze losowania w siedzibie Polskiego Związku Tenisa Stołowego w Warszawie .	Warszawie	15	Fem
Moja żona wybiera się do Tunezji , strzeżcie się , Tunezyjczycy .	Tunezji	5	Fem
- dodaje gen. Biel .	Biel	3	Masc
Pseudokibicom ze Stalowej Woli upiekło się , choć nieźle w sobotę nabroili .	Woli	3	Fem
Bez przesady , nie jestem już tym , co wycierał się na Mazurach w pomarańczowy ręcznik .	Mazurach	12	Neut
Niemal wszystkie nici myśli kwestionującej prowadzą do Kartezjusza .	Kartezjusza	7	Masc
- Spodziewał em się , że tak odpowiesz , Sarai !	Sarai	9	Fem
Bardzo proszę , pan poseł Janusz Korwin - Mikke .	Janusz	5	Masc
Szwecja wymaga także odrobaczenia kota na 10 dni przed wyjazdem .	Szwecja	0	Fem
Jednak główną rolę w pracy nad brzmieniem płyty odegrały gitarzystka Wendy Melvoin i grająca na instrumentach klawiszowych Lisa Coleman .	Coleman	18	Fem
Kiedy w Banja Luce skończył się ostatni , decydujący o medalu mecz , Halina leżała na parkiecie , a na niej kłębiła się góra ciał .	Halina	13	Fem
Daniel dobrze pamiętał najstarszego .	Daniel	0	Masc
W jednej chwili zakończyły się interesy handlowo - łóżkowe pani Magdaleny i pana Wacława .	Magdaleny	10	Fem
Janina Michaluk leży w szpitalu w Gryficach .	Michaluk	1	Fem
Konkurs organizuje stacja telewizyjna ABC .	ABC	4	Neut
Pan poseł Juliusz Braun , proszę bardzo .	Juliusz	2	Masc
Patesi stanął przy królu .	Patesi	0	Masc
Mao stał się na wiele lat przywódcą największego narodu na kuli ziemskiej .	Mao	0	Masc
Do najciekawszych należą parki w Wierzonce i Owińskach .	Owińskach	7	Neut
Może w dużych ośrodkach miejskich ludzie zagłosują na Juszczenkę , ale we wsiach poparcie dla Janukowicza będzie ogromne .	Janukowicza	15	Masc
NIK skontrolowała także 21 inwestycji służby zdrowia .	NIK	0	Fem
- W 1299-tym nadał Nakłu prawa miejskie mały drobny Król Łokietek , a Dzielny Krzywousty w 12-tym wieku narobił w Nakle kapusty !	Nakłu	4	Neut
W niezwykłym spektaklu Partice'a Chfreau zabrakło głównej bohaterki .	Partice'a	3	Masc
W niedzielę 7 czerwca o godz . 17 Odra podejmuje Inę , a Mieszko o tej samej godzinie u siebie gra z Dąbrovią .	Odra	8	Fem
Już dzisiaj był nawet u Leszka w biurze , żeby mu o tym powiedzieć .	Leszka	5	Masc
Działo się to podczas dochodzenia do nabrzeża w Ystad .	Ystad	8	Neut
Prawie wszyscy komentatorzy dowodzą , że Orfeusz nie ponosi winy za utratę Eurydyki .	Eurydyki	12	Fem
Dyrektor Sender niepokoi się , czy to nie jest jakaś Solidarność .	Sender	1	Masc
W ostatecznym rozrachunku triumfuje tradycyjnie Dior .	Dior	5	Masc
Pekin nadal domaga się , aby Waszyngton wziął na siebie pełną odpowiedzialność za incydent .	Pekin	0	Masc
Ale nawet najwięksi krytycy Rutkowskiego chwalą jego zdolności autoreklamiarskie .	Rutkowskiego	4	Masc
Niemcy wyrzucają z mieszkania Konstantego Prusa .	Konstantego	4	Masc
Słońce Grecji zgasło i nad tragedią Sofoklesa zapadły egipskie ciemności .	Sofoklesa	6	Masc
Pożeracz Chmur aż się otrząsnął .	Chmur	1	Fem
Pan Janek zachodził do Ireny Rosy na kawę .	Ireny	4	Fem
KTO PIERWSZY ZAPALIŁ OGIEŃ NA ROZEWIU ?	ROZEWIU	5	Neut
Czym latają nasze VIP-y ?	VIP-y	3	Masc
Bolko nie posiadał się z radości .	Bolko	0	Masc
Wnętrze Ejakulatio błyszczało .	Ejakulatio	1	Neut
i Maciek tak zawsze robił .	Maciek	1	Masc
Chodzi o 35-letnią Małgorzatę T . , mieszkankę jednej z pobliskich gmin .	Małgorzatę	3	Fem
Zastrzeżenia wojewody dotyczyły tylko Polaków na stanowiskach kierowniczych .	Polaków	4	Masc
Rosja ma dwa oblicza .	Rosja	0	Fem
- Wiem od Kasi , że jest podejrzany o zabójstwo Wojtka .	Wojtka	10	Masc
RPO podjął się zbadania sprawy .	RPO	0	Masc
Trwa obecnie jego budowa , powstaje on przy ulicy Niepodległości .	Niepodległości	9	Fem
Wcześniej Gracen stanowczo zaprzeczała , że utrzymywała intymne kontakty z prezydentem .	Gracen	1	Fem
- Czy to prawda , że ty , Manahemie , posiadasz miecz Hyrkana ?	Manahemie	8	Masc
W hali przy ulicy Księcia Bolesława na warszawskim Bemowie gościł Tomasz Frankowski .	Frankowski	11	Masc
Pozostała mu jedynie praca naukowa w Princeton .	Princeton	6	Neut
Ktoś za plecami Bogorii westchnął rzewnie .	Bogorii	3	Fem
Dziadkowie kochali bardzo wnuki i synową , ale ich majątek , Wysokie , gonił resztkami .	Wysokie	11	Neut
Uroczystego otwarcia imprezy dokonał wojewoda nowosądecki Marek Oleksiński .	Oleksiński	7	Masc
– Martę znowu ogarnęła wściekłość .	Martę	1	Fem
- Muzyka nagrywana jest w Stanach . . .	Stanach	5	Neut
- Małą miss została Klaudia Zdunek !	Zdunek	5	Fem
Przy prezydiach GRN w Iłowie i Kamionie działają już komitety przeciwpowodziowe .	Iłowie	4	Neut
Abakanowicz pracuje seriami .	Abakanowicz	0	Fem
I chcę , aby świat cały począł służyć Jezusowi .	Jezusowi	8	Masc
Brigitte Bardot zaczęła bronić zwierząt histerycznie , szlachetne intencje popsuły się i pogniły jak robaczywe jabłka .	Bardot	1	Fem
Z dziedzińca koszar pułkownik Ahlberg obserwował przez lornetkę aeroplan .	Ahlberg	4	Masc
Ale cały czas marzył , żeby zobaczyć Samarkandę .	Samarkandę	7	Fem
Zbrodnia była dokonana pod Urlami .	Urlami	4	Neut
W grupie finałowej rozegrano mecze każdy z każdym i wyłoniono zwycięzcę , którym został zespół Warka Tuchola .	Tuchola	16	Fem
W Betlejem zupełnie utracili ducha dociekliwości , z punktu widzenia intelektualisty zachowali się nadzwyczaj pokornie .	Betlejem	1	Neut
Niemal wszystkie nici myśli kwestionującej prowadzą do Kartezjusza .	Kartezjusza	7	Masc
Gertruda nie miała pewnie licencji a zaczęła wykorzystywać komercyjnie .	Gertruda	0	Fem
Dlatego w Masterlink pojawiają się kolejne etaty na odległość .	Masterlink	2	Masc
Może być attache kulturalny na Hawajach .	Hawajach	5	Neut
Shimada wyznaczył więc ludzi i za chwilę wnętrze góry poczęło błyskać upiornym światłem palników i ożywiło się znów koszmarną krzątaniną .	Shimada	0	Masc
Gdyby Celina Szulc pozostała na stanowisku , związkowcy zamierzali ogłosić wczoraj strajk okupacyjny w łomżyńskich wodociągach .	Celina	1	Fem
Nie sądzę , żeby Aleksandra Jakubowska była jakimś głównym problemem .	Jakubowska	5	Fem
Ze swadą wyśmiał i wypunktował tę pookrągłostołową zgraję rządzącą Polską z nadania Kiszczaka .	Polską	9	Fem
Alicja milczy .	Alicja	0	Fem
Podczas obchodu można było się przekonać , że nastąpiły gruntowne zmiany w pomieszczeniach CSiK .	CSiK	13	Neut
Razem z mętami w Bornem Sulinowie pojawiły się klechy .	Bornem	4	Neut
Jedną pustą wmurowano między epitafiami porucznika Ludwika Ratajczaka i majora Leona Recheńskiego .	Recheńskiego	11	Masc
Małgorzata Supronowicz , właścicielka syberiana , jest lekarzem weterynarii .	Supronowicz	1	Fem
Tragiczny wypadek zdarzył się na trasie kolejowej z Piły do Chojnic .	Chojnic	10	Neut
Pakistańczycy zarzucają Indiom stosowanie bomb kasetowych i bomb z napalmem .	Indiom	2	Neut
Na Suwalszczyźnie złamało się 6 słupów , nie pracuje 50 stacji transformatorowych .	Suwalszczyźnie	1	Fem
Oddał em list Stefanowi bez słowa .	Stefanowi	3	Masc
Wczoraj o godz . 2 rano policjanci ruszyli pod posiadłość przestępcy w Białce na Pomorzu .	Białce	12	Fem
Mecz rozpoczął się dla niej bardzo dobrze , bo już w 2 . minucie Cezary Kucharski zdobył prowadzenie .	Kucharski	15	Masc
Przewodniczący Rady Państwa NRD Walter Ulbricht odwiedził Jugosławię .	NRD	3	Fem
– Nie wiedział em , że pani Senyszyn zna się na krowach .	Senyszyn	7	Fem
Mani wciąż nie było i Beata pomyślała , że wyjechała już na wakacje .	Mani	0	Fem
Afgańczycy nie uznawali ani wiecznych wrogów , ani wiecznych przyjaciół .	Afgańczycy	0	Masc
Doron skoczył do przodu .	Doron	0	Masc
Wieczorem przyjechała Grażyna Celińska z dziećmi i razem zjedli śmy kolację .	Grażyna	2	Fem
- Nie zorganizowano zawodów na odpowiednim poziomie , na przykład w skokach do wody czy siatkówce , bo Zimbabwe nie spodziewa się w tych dyscyplinach osiągnięć .	Zimbabwe	18	Neut
Tarnobrzescy policjanci zatrzymali w pobliżu Stalowej Woli 12 nielegalnych emigrantów .	Woli	6	Fem
– a Kaśka ma tę kartę ?	Kaśka	2	Fem
Alicja przestała się wahać .	Alicja	0	Fem
Halina i ja byli śmy zdecydowani .	Halina	0	Fem
Stacja BP dysponuje ośmioma dystrybutorami z całym zakresem paliw .	BP	1	Neut
Gra rolę Cesi .	Cesi	2	Fem
Podczas jednego harcerze zaznajomili się z działalnością organizacji młodzieżowej w Syrii .	Syrii	10	Fem
W ataku grali Michalis Konstantinou i Nikos Liberopoulos .	Michalis	3	Masc
- Pan też chciał do Cambridge ?	Cambridge	5	Masc
Posłanka Beger ma w tej sesji aż 6 egzaminów .	Beger	1	Fem
Wraz z kadrą wyjadą Daria Kasperska , Paulina Rytwińska i Agnieszka Karcz .	Karcz	11	Fem
Nie często zdarza się uczestniczyć w wydarzeniu artystycznym , a takim na pewno był koncert u Chrystusa Króla .	Chrystusa	16	Masc
Zawody będą rozgrywane na Dunajcu na odcinku od Krościenka do mostu w Gołkowicach .	Krościenka	8	Neut
Myślano o dorocznym spotkaniu ekonomistów i biznesmenów Wschodu i Zachodu w Davos .	Zachodu	9	Masc
Agnieszka jest odurzona szczęściem .	Agnieszka	0	Fem
Serena zamruczała coś przez sen i rozłożyła się na mojej połowie .	Serena	0	Fem
Szpital w Ostródzie został sprywatyzowany 7 lat temu .	Ostródzie	2	Fem
Specjalnie podesłałeś mi Celińskiego .	Celińskiego	3	Masc
Z wypłowiałego zdjęcia uśmiechała się azjatycka , młoda twarz pana Korzeniowskiego , wystrojonego w mundur zapięty pod szyją .	Korzeniowskiego	10	Masc
Chce uruchomić przewozy w Raciborzu-Markowicach i Nieborowicach .	Nieborowicach	6	Neut
Pseudokibicom ze Stalowej Woli upiekło się , choć nieźle w sobotę nabroili .	Woli	3	Fem
W okresie międzywojennym pałac w Kadynach nie był zamieszkały .	Kadynach	5	Neut
Za słabo garbowano Musze skórę w Gross Rosen .	Rosen	7	Neut
Aparaturę filmową obsługuje instruktor terenowy PDK Czesław Fudala .	PDK	5	Masc
Dowódca sił amerykańskich w Afganistanie generał Tommy Franks zapowiedział kolejne operacje lądowe .	Franks	7	Masc
W drugiej części czytelnik będzie mógł lepiej poznać cały pluton rotacyjny szeregowca Leńczyka .	Leńczyka	12	Masc
- Mila jest do mnie podobna .	Mila	1	Fem
Haberda patrzy na Gabrielę bez sympatii .	Gabrielę	3	Fem
Czy Milon zdecyduje się na powrót ?	Milon	1	Masc
Elżbieta rozstaje się z mężem , zabiera synka i ze Śląska przenosi się do Tarnowa .	Elżbieta	0	Fem
Odsłonili jednak tyły i kolejną bramkę zdobyli lechici .	lechici	7	Masc
Karina pracowała na oddziale dziecięcym .	Karina	0	Fem
Krystyna Kofta ogłosiła , że przyjmuje na siebie misję walki o równouprawnienie Bożen z Krystynami i za dwa lata zaprosiła panie do Trójmiasta , by równość tę udowodnić .	Bożen	12	Fem
Dwaj nieznani mężczyźni okradają restauratorów we Włochach , Opaczy , Pruszkowie .	Włochach	6	Neut
Tak jak prezydent Rybnika Adam Fudali , który tydzień temu gościł w tej rubryce .	Fudali	5	Masc
Jedenastkę przestrzelił także Kolumbijczyk Hamilton Ricard .	Hamilton	4	Masc
Udaliśmy się do Kroczewa .	Kroczewa	3	Neut
Wessie je mózg , wątroba , rurką pępowiny popłyną do Poli .	Poli	10	Fem
Najwyższą sumę otrzymał wójt Michał Skałecki i jest to 7100 złotych .	Skałecki	5	Masc
Jedenastkę przestrzelił także Kolumbijczyk Hamilton Ricard .	Ricard	5	Masc
Ale menażer klubu z Mannheim nalegał , aby do transferu doszło już teraz .	Mannheim	4	Neut
Basia nie dostała dziś nic na targu .	Basia	0	Fem
– Przyjedź szybko do Nowolipska .	Nowolipska	4	Neut
Leci z Milwaukee do Pekinu na chiński Nowy Rok .	Rok	8	Masc
Ten wiersz Dominika przykleiła sobie nad biurkiem , a Jadzia dziwiła się .	Jadzia	9	Fem
Patesi stanął przy królu .	Patesi	0	Masc
Pan poseł Witold Gintowt - Dziewałtowski , proszę bardzo .	Gintowt	3	Masc
W latach sześćdziesiątych , już jako sztygar oddziałowy , pamiętam odbiory przygotowywanych do rozruchu ścian dokonywane przez dyrektora Śniegonia .	Śniegonia	18	Masc
Zwycięzcą biegu maratońskiego został 87-letni dziś Koreańczyk Ki - jung Son .	Ki	7	Masc
Chodziło oczywiście o kontakty ściśle naukowe , ale umożliwiły one później wysłanie jezuity , astronoma , do Chin .	Chin	17	Neut
Tekst wyszedł spod srebrzystych parkerów Colina Rowe'a i Roberta Slutzky'ego .	Rowe'a	6	Masc
Komentatorzy powszechnie uważają , że zaszkodziła ona jednemu z głównych kandydatów na prezydenta Arturasowi Paulauskasowi .	Arturasowi	13	Masc
Czy w Kielcach uczył się w szkole rabinackiej i czy naprawdę był rabinem , jak zapewniał Fangora i inne osoby w Ameryce ?	Kielcach	2	Neut
Hempel umarł prawdopodobnie dość szybko , to był człowiek chory , słabowity i prawdopodobnie nie wytrzymał .	Hempel	0	Masc
– W HSW SA trwa obecnie wielkie liczenie .	SA	3	Fem
Tym razem atrakcyjność potyczki podniesie fakt , że Hoop i Zepter reprezentują mocno zmienione oblicza .	Zepter	10	Masc
We wtorek w Annopolu , gdzie Wisła przekroczyła stan alarmowy o 34 cm , ogłoszono alarm przeciwpowodziowy .	Annopolu	3	Masc
W tym roku w Kolnie w wyborach prezydenckich wygrał Lech Kaczyński .	Kolnie	4	Neut
Gdyby Nina Terentiew ciągle rządziła Dwójką , krzywdy pani zrobić by nie dała ?	Terentiew	2	Fem
Karolcia zaczerwieniła się i nic nie odpowiedziała .	Karolcia	0	Fem
Starał em się wejść w sytuację doktora Ciszewskiego .	Ciszewskiego	7	Masc
Ormianie w ogóle nie chcą słyszeć o pozostawaniu częścią Azerbejdżanu .	Azerbejdżanu	9	Masc
Polski samolot M-28 rozbił się i eksplodował kilka sekund po starcie z lotniska w Puerto Cabello , 200 km na zachód od Caracas .	Caracas	22	Neut
Stał przed nim Gaarb .	Gaarb	3	Masc
- Czy uważa pan , że po to , by utrzymać trzeźwość , alkoholik potrzebuje AA do końca życia ?	AA	15	Neut
Zostaje przewieziona do Centrum Zdrowia Matki Polki .	Polki	6	Fem
Księdza zatrzymano w ubiegłym tygodniu na polsko - ukraińskim przejściu granicznym w Dorohusku przy wjeździe do Polski .	Dorohusku	12	Masc
W Gnieźnie w sylwestrowy wieczór zginęli podczas pożaru trzej chłopcy , a jadący do akcji samochód strażacki wpadł na dwie kobiety .	Gnieźnie	1	Neut
Myślano o dorocznym spotkaniu ekonomistów i biznesmenów Wschodu i Zachodu w Davos .	Davos	11	Neut
Angelika przystąpi do komunii w kościele w Dytmarowie .	Angelika	0	Fem
Ułatwi ona włączenie się do ruchu jadącym z Koziegłów do Poznania .	Koziegłów	8	Neut
W Zborowie powstał obiekt o powierzchni użytkowej 3364 metrów kwadratowych , w którym zamieszka 50 osób .	Zborowie	1	Masc
- Jestem przyjacielem pana Kurtza .	Kurtza	4	Masc
Rodzina i przyjaciele powitali w sobotę uwolnione przez rosyjskie służby specjalne Polki .	Polki	11	Fem
Tymczasem w bufecie panna Tola czyściła koszyki do chleba .	Tola	4	Fem
Biznesmena Roku wybierano na Pomorzu już po raz szósty .	Pomorzu	4	Neut
Wreszcie Lem z wyjątkowym krytycyzmem oceniał sprawy polskie .	Lem	1	Masc
W 1905 roku Karl Braun zbudował detektor kryształkowy .	Karl	3	Masc
W samej Warszawie w Internecie swoje auta eksponuje już kilkadziesiąt komisów .	Warszawie	2	Fem
Szkoda , że nie można dysponować Heinzem Mirynkiem .	Mirynkiem	7	Masc
25 lat temu zaginął w Bieszczadach w tajemniczych okolicznościach Witold Gontaszewski .	Bieszczadach	5	Neut
Furorę robili sygnaliści z Tucholi .	Tucholi	4	Fem
Kaśka jeździła na nartach ?	Kaśka	0	Fem
Elizabeth uśmiechnęła się do kobiet , a one uśmiechnęły się do niej .	Elizabeth	0	Fem
Zaraz , Malwa miała gdzieś wosk .	Malwa	2	Fem
Gdy rozległ się krzyk , Guilielmo zakryl twarz rękami .	Guilielmo	5	Masc
Niemcy słuchają .	Niemcy	0	Masc
Tak pesymistyczni Francuzi byli w kwietniu , a przedtem aż przed czterema laty .	Francuzi	2	Masc
- Japońska firma Seiko wprowadziła na rynek pierwszy kwarcowy zegarek na rękę .	Seiko	3	Neut
W sobotę podporucznik Ziemba przeniósł swoje łóżko do kuchni , rowery wstawiono do pokoju podporucznika Kowalika .	Kowalika	15	Masc
- Z Lechowskim i Szamockim jest kiepsko .	Lechowskim	2	Masc
Siedzibą władz jest Zakopane .	Zakopane	3	Neut
O możliwości pracy w Azerbejdżanie wspominał już w Warszawie .	Warszawie	8	Fem
- Ale ich liczba w Europie będzie szybko rosnąć .	Europie	5	Fem
Beacie towarzyszył mój starszy kuzyn , inżynier Wacław Straszyński .	Beacie	0	Fem
A Mafia to ponoć chłop jak dąb .	Mafia	1	Masc
W poniedziałek rano do Betlejem i Kalkilli na Zachodnim Brzegu Jordanu wjechały izraelskie czołgi .	Betlejem	4	Neut
W Białce , u górali możecie się dowiedzieć na mój temat wiele .	Białce	1	Fem
Jaki jest Stoss naprawdę w łóżku ?	Stoss	2	Masc
Zdaniem Marka Markiewicza , polityczną dojrzałość polityk osiąga dopiero po czterdziestce .	Marka	1	Masc
Fałszywego księdza przewieziono do więzienia w Rawiczu .	Rawiczu	6	Masc
Adam szukał do nowego domu parkietu .	Adam	0	Masc
Wydaje mi się , że na tym odcinku Krupówek wykonano kanalizację zbyt wąskimi rurami .	Krupówek	8	Neut
- Storację zabiorę stąd .	Storację	1	Fem
W turnieju kobiet w pool - bilardzie rywalizowano o puchar burmistrza Ciechocinka .	Ciechocinka	11	Masc
Mówiła , że się nazywa Karolcia .	Karolcia	5	Fem
Komisja oceniła , że Milczanowski i funkcjonariusze urzędu popełnili przestępstwo .	Milczanowski	4	Masc
Żelazny kolos Żugajowi nie nabił nawet guza .	Żugajowi	2	Masc
Chciał by m ofiarować je Sally .	Sally	5	Fem
Osiedla się w Kafarnaum nad jeziorem i zaczyna swoją publiczną działalność .	Kafarnaum	3	Neut
Zadeklarowali , że w stacji znajdą zatrudnienie mieszkańcy Szypliszek .	Szypliszek	8	Neut
Poza pracą zawodową inżynier Tadeusz Wróblewski zasłużył się również w organizowaniu życia sportowego .	Wróblewski	5	Masc
– Ela chciała Sabę . .	Sabę	3	Fem
W roku 1912 Olga w związku z kolejną przygotowującą się pod jej nieobecność wystawą zasięgnęła rady Sainsèrea przy wyborze obrazów .	Olga	3	Fem
Dunlong zamachał rękoma .	Dunlong	0	Masc
Oficjalnie cały Sejm RP śpi .	RP	3	Fem
Rafał Blechacz zapowiedział , że w niedzielę palmową ma zamiar zagrać kolejny ważny koncert .	Blechacz	1	Masc
Lenda złożyła powoli papier .	Lenda	0	Fem
Sprawę znam z relacji mojej Irenki .	Irenki	5	Fem
Strzeż się , Segubie !	Segubie	3	Masc
Marzena znikła za progiem .	Marzena	0	Fem
Wuj matki , Bronisław Werner , spędził pięć lat w aresztanckich rotach w Orenburgu .	Werner	4	Masc
Arek jest w głębi serca monogamistą .	Arek	0	Masc
Konieczność jej przeprowadzenia uznaje nawet SLD .	SLD	5	Masc
Wkrótce zawiniemy do Trondheim .	Trondheim	3	Neut
W Wiśle pod koniec lat 70 . grał krótko czarnoskóry Anthony Freeman .	Anthony	10	Masc
Ta grupa w części pewnie będzie się składać z dawnego elektoratu SLD .	SLD	11	Masc
Selekcjoner Jerzy Engel rozdał pamiątkowe monety , wybite z okazji zbliżających się mistrzostw świata .	Engel	2	Masc
Lopez odchrząknął .	Lopez	0	Masc
Dochodzenie w sprawie wypadku wszczęła Prokuratura Rejonowa w Szczytnie .	Szczytnie	8	Neut
Bóg mnie opuścił ?	Bóg	0	Masc
W zamian kuria proboszczem tego kościoła uczyniła jego starszego brata , ks . Zdzisława Struzika .	Zdzisława	13	Masc
Według stołecznych policjantów , udało mu się zgromadzić wokół siebie młodych przestępców z Pragi .	Pragi	13	Fem
- Jaka jest Moskwa Putina ?	Moskwa	3	Fem
W styczniu pojechał do Melbourne .	Melbourne	4	Neut
Kiermasze te zapowiadały Wielki Tydzień , który charakteryzował się postem i wyrzeczeniami .	Tydzień	4	Masc
Steve zaklina się , że po każdym dyżurze szykuje ekstra posiłek czworonożnemu ratownikowi .	Steve	0	Masc
Bawi się Pan w kolejnego kundelka UPR-u ?	UPR-u	6	Masc
Puby zostawmy Anglikom .	Anglikom	2	Masc
Angelina Jolie jest bezgranicznie zakochana w swoim adoptowanym synku , który niedawno urodził się w Kambodży .	Kambodży	15	Fem
Komisja sędziego Kramarza przystąpiła do pracy .	Kramarza	2	Masc
Dlatego władze w Pekinie już dawno były gotowe wypuścić Weia na Zachód .	Weia	9	Masc
W święta głodowało już sześciu pracowników MZK , przedwczoraj dwóch z nich odmówiło przyjmowania płynów .	MZK	6	Masc
jest na niej 250 szopek nigdy dotąd poza Betlejem niepokazywanych .	Betlejem	8	Neut
Wśród juniorek w obu konkurencjach triumfowała Szczygiełówna .	Szczygiełówna	6	Fem
Wacek nie jest stary , dopiero skończył czterdziestkę . . .	Wacek	0	Masc
Reputację intelektualisty potwierdził , cytując obficie Witolda Gombrowicza i Stanisława Jerzego Leca .	Gombrowicza	7	Masc
Słońce Grecji zgasło i nad tragedią Sofoklesa zapadły egipskie ciemności .	Grecji	1	Fem
Sylwetka Golfa w porównaniu z agresywnymi liniami Focusa wygląda spokojnie , ale jego bryła może być uznana za ponadczasową .	Focusa	7	Masc
Wprowadzenie rozwiązań proponowanych przez SLD prowadziłoby do wynaradawiania .	SLD	4	Masc
- Moich zawodników zdopingowała wczorajsza porażka Górnika z Jeziorakiem .	Górnika	6	Masc
Tomasz nastawił radio .	Tomasz	0	Masc
Flora już wszystko zrobiła .	Flora	0	Fem
Dziesięciu jeźdźców pokonuje trasę z Torunia do Pucka .	Torunia	5	Masc
Surowy , suchy klimat , huraganowe wiatry oraz nieurodzajność gleb spowodowały , że odkryta w 1520 roku przez Magellana Patagonia długo nie była kolonizowana przez Europejczyków .	Magellana	18	Masc
Przewodniczący Vegów uśmiechnął się jakby z zakłopotaniem .	Vegów	1	Masc
Polonia w ostatnim swoim występie mocno rozczarowała .	Polonia	0	Fem
Ignacy nie opowiadał o swej rodzinie .	Ignacy	0	Masc
Anatom Worobjew i biochemik Zbarski mieli ten zamysł wcielić w życie .	Zbarski	4	Masc
O możliwości pracy w Azerbejdżanie wspominał już w Warszawie .	Azerbejdżanie	4	Masc
Pani Czapkowa zaścieliła stół świeżą ceratą , podała kotlety z dzika , a po obiedzie odbyło się sympozjum .	Czapkowa	1	Fem
Kontemplując Jezusa pragnę budować na takiej skale .	Jezusa	1	Masc
Za słabo garbowano Musze skórę w Gross Rosen .	Gross	6	Neut
Kulesza oczywiście nie wstał na jego powitanie .	Kulesza	0	Masc
102 lata obchodziła wczoraj Stanisława Przybyła , rodowita mieszkanka Łaz .	Przybyła	5	Fem
Alicja milczy .	Alicja	0	Fem
Piranię wyłowiono też w wodach Brdy .	Brdy	5	Fem
Czy ekonomiści liczą , że Balcerowicz będzie korzystał z ich rad ?	Balcerowicz	5	Masc
TOPR-owcy ostrzegają przed bardzo trudnymi warunkami panującymi na szlakach .	TOPR-owcy	0	Masc
Kazimierz Pytko napisał na naszych łamach , że nerwowe odruchy prawosławnych biorą się z ich poczucia słabości .	Pytko	1	Masc
Niestety , wczoraj Arkadiusz Pióro nie odbierał telefonu .	Arkadiusz	3	Masc
Ufundowanie muzeum dla zbiorów Jasieńskiego było naturalnym odruchem obywatela , miłośnika sztuki .	Jasieńskiego	4	Masc
Pierwsza dama Rosji przyleciała do Polski na zaproszenie Jolanty Kwaśniewskiej .	Jolanty	8	Fem
Są to Singapur i Jordania .	Singapur	2	Masc
Z pokoju wyszła Paulina .	Paulina	3	Fem
- Z tą Martą też nic dobrego nie wyjdzie .	Martą	3	Fem
Powstały wówczas Prusy Zakonne .	Prusy	2	Neut
Polacy jadący w autokarze spoglądają z nietajoną dumą na wielkiego rodaka .	Polacy	0	Masc
Zrobiłem krok do przodu i pociągnąłem Dorę za sobą .	Dorę	6	Fem
Obolski skwapliwie chwyta paczki .	Obolski	0	Masc
Gra rolę Pawła .	Pawła	2	Masc
I tym razem Gagarin zniósł ją ze stoickim spokojem .	Gagarin	3	Masc
- Mimo stacjonujących w Groznym wojsk i patroli Rosjanie nie będą się tam czuli bezpiecznie .	Groznym	4	Masc
Parafianie wysłali skargę do biskupa koszalińskiego Kazimierza Nycza .	Nycza	7	Masc
Ale dla Serbów Kosowo ma olbrzymią wartość emocjonalną , to kolebka ich państwowości .	Kosowo	3	Neut
W sobotę podporucznik Ziemba przeniósł swoje łóżko do kuchni , rowery wstawiono do pokoju podporucznika Kowalika .	Ziemba	3	Masc
Ewa nigdy takich nie widziała .	Ewa	0	Fem
Chodź , Kazik !	Kazik	2	Masc
Klub Przyjaciół Życia Ludzkiego działa w Nakle od 1996 roku .	Nakle	6	Neut
Wielka kanalizacja gminy Tychowa to najnowsza inwestycja tutejszych władz .	Tychowa	3	Neut
Ciężkie działa przeciw abolicji wytoczył Leszek Miller .	Miller	6	Masc
Na torze pod Kielcami odbyty się pierwsze wyścigi samochodowe .	Kielcami	3	Neut
Konwój został zaatakowany w okolicach An Numaniyah w prowincji Wasit .	Numaniyah	6	Neut
Sekretarz generalny KPZR Leonid Breżniew odwiedził Bułgarię , Jugosławię i Węgry .	Jugosławię	8	Fem
W lutym skradziono ją prawdziwemu funkcjonariuszowi w Warszawie .	Warszawie	7	Fem
Wzięli w niej udział przedstawiciele policji z Niemiec , Czech , Słowacji , Węgier , Ukrainy i Polski .	Czech	9	Neut
Zgodnie podkreślają , że bracia Kaczyńscy nie lubią hucznych imprez .	Kaczyńscy	5	Masc
Mimo tak dużych możliwości EMG , czasem nie udaje się na jej podstawie postawić trafnej diagnozy .	EMG	4	Fem
Batura wciągnął się na rękach za nim .	Batura	0	Masc
Traktuje Beatę jak córkę , służy radą i wsparciem psychicznym .	Beatę	1	Fem
Jego anegdoty traktowały o najrozmaitszych księżach dziwakach , których w okolicy nie brakło , a których przygody tchnęły często humorem z epoki Seweryna Soplicy czy nawet Paska .	Soplicy	23	Masc
Nietschke myślał chwilę o samotnym , smutnym ptaku .	Nietschke	0	Masc
Zeznania urzędniczki były elementem republikańskiej kampanii , która miała zmusić prezydenta Billa Clintona do odwołania wizyty w Chinach .	Chinach	17	Neut
" Słuchaj , to prawda z tym Spławikiem ? "	Spławikiem	7	Masc
Siedział odchylony za swoim biurkiem z taką miną , jakby dowodził całą policją , Interpolem i FBI na dodatek i delektował się kawą .	FBI	16	Neut
Geniusia przeżyła naprawdę ciężki szok .	Geniusia	0	Fem
Wydawało się , że fiskus nie będzie dłużej gnębił Waldemara Gronowskiego , legnickiego piekarza , który przez ponad 10 lat rozdawał pieczywo najuboższym .	Waldemara	9	Masc
Ali Agca przebywa w więzieniu już 18 lat .	Ali	0	Masc
Na Lower East Side straż pożarna stawia wówczas ogromne , żelazne pojemniki …	East	2	Masc
Dżabie odbiło się walerianą .	Dżabie	0	Masc
Obrady otworzył prof . Witold Hensel .	Hensel	5	Masc
Obwieszony policyjnymi kamerami i mikrofonami spotkał się z nią w jadłodajni w centrum Kielc .	Kielc	13	Neut
Przystupa otworzyła oczy .	Przystupa	0	Fem
- Uspokój się , Władeczku .	Władeczku	4	Masc
Seniorska reprezentacja Polski zbliża się do zgrupowania we Wronkach .	Wronkach	8	Neut
Wzięli w niej udział przedstawiciele policji z Niemiec , Czech , Słowacji , Węgier , Ukrainy i Polski .	Ukrainy	15	Fem
Co - to wiedzą Aleksander Kwaśniewski i Krzysztof Janik .	Kwaśniewski	5	Masc
Wzrasta temperatura rozmów o prawyborach w AWS .	AWS	6	Fem
Etiopczycy kontynuują atak , choć pod koniec ubiegłego tygodnia władze Erytrei poinformowały o wycofaniu swych oddziałów ze wszystkich spornych terenów nadgranicznych .	Erytrei	10	Fem
Chińczycy jednak wkrótce poparli interwencję na Węgrzech , bo tam już lała się krew .	Węgrzech	6	Neut
IZABELLE ADJANl , gwiazda filmu francuskiego , wygrała precedensowy proces .	ADJANl	1	Fem
Pierwsza dama Rosji przyleciała do Polski na zaproszenie Jolanty Kwaśniewskiej .	Kwaśniewskiej	9	Fem
W tym roku w Łódzkiem skradzino już prawie 4,5 tys . samochodów .	Łódzkiem	4	Neut
Na pastwisku w Uniszkach Gumowskich rolnik załadował na dwukółkę krowę .	Uniszkach	3	Neut
A musi z ZSSR i z Polską .	Polską	6	Fem
To państwo Kaczyńscy wiedzą i rządu do dymisji nie podadzą .	Kaczyńscy	2	Masc
Blish jest przede wszystkim marzycielem- propagandzistą .	Blish	0	Masc
W rozległej przestrzeni czyśćca spotyka po raz pierwszy Beatrycze .	Beatrycze	8	Fem
Stalin zaszedł , wzeszła Honda i British Airways .	Airways	7	Neut
- Rysiek , dam ci ciężarówkę , ale mi nią przywieziesz Nałkowską z Adamowizny i Gojawiczyńską ze Stawiska !	Stawiska	17	Neut
- Józwa ma konika . . .	Józwa	1	Masc
Ideą konkursu jest propagowanie kultury polskiej na Wschodzie .	Wschodzie	7	Masc
Stachurski i Janusz Olędzki zastąpili latem Janusza Lacha i Artura Mazurka .	Janusz	2	Masc
Zdawało się , że dopiero teraz Maria Rosa ją zauważyła .	Rosa	7	Fem
Dwaj wędkarze wpadli do wody , gdy wieloryb zaatakował ich łódź u południowo - wschodnich wybrzeży Australii .	Australii	16	Fem
Zdaniem Kwaśniewskiego jest to wystarczająca kara i Siwiec nie musi ustępować ze stanowiska .	Kwaśniewskiego	1	Masc
- Czy chce otrzymać azyl w Danii ?	Danii	6	Fem
Zakon wysłał do nich delegację pod wodzą siostry Gizeli .	Gizeli	8	Fem
Po ukończeniu zakopiańskiej Szkoły Przemysłu Drzewnego i warszawskiej ASP osiadł w Zakopanem .	Zakopanem	11	Neut
Wczoraj koło cmentarza w Sianowie znaleziono kilkuletniego chłopca .	Sianowie	4	Masc
Nad bezpieczeństwem w Zachodniopomorskiem czuwało 2500 policjantów , w tym 500 z drogówki .	Zachodniopomorskiem	3	Neut
11-latek przyniósł do szkoły w Studziankach granat .	Studziankach	5	Neut
Zwierzenia Ani poruszyły mnie do głębi .	Ani	1	Fem
pamiętasz tą Karolinkę ?	Karolinkę	2	Fem
Gdy rozległ się krzyk , Guilielmo zakryl twarz rękami .	Guilielmo	5	Masc
102 lata obchodziła wczoraj Stanisława Przybyła , rodowita mieszkanka Łaz .	Łaz	9	Neut
Doktor Słodkowski zapewnia , że przynajmniej raz na kwartał będzie odwiedzał Zakopane .	Zakopane	11	Neut
Razem z mętami w Bornem Sulinowie pojawiły się klechy .	Sulinowie	5	Neut
W 1932 r. wyjechał do Palestyny .	Palestyny	5	Fem
W środę do Jana Kwiatkowskiego , wujka Adama , zadzwonili policjanci z sekcji kryminalnej w Legionowie .	Kwiatkowskiego	4	Masc
Świat Michnika bez świata Rydzyka umiera .	Michnika	1	Masc
Miasto Detroit do tej pory płonie , a wyjątkowo upalna pogoda sprzyja rozszerzaniu się pożarów .	Detroit	1	Neut
Inge też się zmieniła .	Inge	0	Fem
Ja na miejscu Pana Giertycha wprowadziłbym zakaz rodzenia głupim matkom .	Giertycha	4	Masc
Na Węgrzech występuje pianistka Halina Czerny - Stefańska i jej córka klawesynistka Elżbieta Stefańska - Łukowicz .	Łukowicz	15	Fem
Rodziny osób pochowanych na cmentarzu w York domagają się ich usunięcia .	York	6	Neut
Jan Skiba odszedł w 1990 r . z resortu bez wielkiego żalu , bo zrozumiał , że jego czas już się wypełnił .	Skiba	1	Masc
Krystyna Kofta ogłosiła , że przyjmuje na siebie misję walki o równouprawnienie Bożen z Krystynami i za dwa lata zaprosiła panie do Trójmiasta , by równość tę udowodnić .	Kofta	1	Fem
Nie ma też dowodów , by Pietruszka był agentem KGB , choć SB ściśle współpracowała z Rosjanami .	Rosjanami	16	Masc
Młodzież z Mełgwi otrzymała pełnowymiarową halę sportową .	Mełgwi	2	Fem
Horti 2000 to także okazja do zapoznania się z najnowocześniejszymi sprzętami ogrodowymi , niezbędnymi nawozami , które sprawiają , ze nasza działka będzie obiektem zachwytu .	Horti	0	Neut
Tematyka prac twórcy z Jarantowic jest różnorodna i w poważnym stopniu zależy od zapotrzebowania , od zamówień odbiorców .	Jarantowic	4	Neut
Tylko w czterech państwach w Europie pojawiły się sieci DCS .	Europie	5	Fem
Czasem przyjeżdżają do Nataszy z Polski rodzice .	Nataszy	3	Fem
Miś Holender przysłał mu czerwone anemony i hiacynty na ostatek .	Holender	1	Masc
Jesteś Brytyjką ?	Brytyjką	1	Fem
Nawiązano współpracę z kołami gospodyń wiejskich w Domatkowie , Kolbuszowej Górnej , Nowej Wsi , Weryni i Widełce .	Weryni	15	Fem
Franciszek Aromiński zawiadomił o wszystkim prokuraturę .	Aromiński	1	Masc
Parlament Europejski w Strasburgu przegłosował niedawno całkowity zakaz reklamowania wyrobów tytoniowych .	Strasburgu	3	Masc
Jego nominacja na ministra spraw zagranicznych była największą niespodzianką rządu Angeli Merkel .	Angeli	10	Fem
W sobotę gmach sądu w Bielsku-Białej przypominał twierdzę .	Bielsku-Białej	5	Neut
- Ty nie śpisz , Arielu .	Arielu	5	Masc
Rodzina Chmurów zręcznie z niej wybrnęła .	Chmurów	1	Masc
Sex Pistols gramy od paru ładnych lat na specjalne okazje .	Sex	0	Masc
Gdy Cahirowi czupryna nieco mocniej przyschnie do czerepu , powędrujemy ku Toussaint .	Toussaint	11	Neut
Chodzi prawdopodobnie o Burkina Faso .	Burkina	3	Neut
Wicemistrzynie Polski z Mielca nie dały pograć w Krakowie Wiśle i opuściły ostatnie miejsce w tabeli właśnie na rzecz podopiecznych Lesława Kędryny .	Wiśle	9	Fem
Czynił to tak niezręcznie , że pani Lichoniowa spostrzegła jego manewry .	Lichoniowa	7	Fem
Oni z kolei odkryli Związek Radziecki .	Związek	4	Masc
Ilia jeszcze drzemał .	Ilia	0	Masc
Jak poinformował Cesar Fraga z Uniwersytetu w Buenos Aires , przeprowadzone tam badania wykazały , że czekolada wzmacnia antyutleniacze znajdujące się we krwi , zwiększając odporność na zaburzenia serca i naczyń wieńcowych .	Aires	8	Neut
Służby ratownicze w Stalowej Woli toczyły dziś walkę z oleistą plamą na Sanie .	Sanie	12	Masc
Korespondenci budapesztańskich gazet donoszą , że wielu miejscowych Węgrów wyjechało do krewnych na wieś albo uciekło na Węgry .	Węgry	17	Neut
Podniosła słuchawkę telefonu i wystukała numer Filipa .	Filipa	6	Masc
Napisałaby więc z pewnością o Bali , co się stało w Kucie , tuż przy głównym deptaku .	Bali	5	Neut
Prezes Bogdan Kościuczyk odesłał nas do dyrektor Anieli Kotowicz .	Kotowicz	8	Fem
Janka nic nie odpowiada i zamyka drzwi .	Janka	0	Fem
Dwukrotnie SKO przyznało im rację .	SKO	1	Neut
Wyjeżdża do Kocic , gdzie będzie odnawiał polichromię .	Kocic	2	Neut
Nie dogadał by się z ministrem Szmajdzińskim .	Szmajdzińskim	6	Masc
Iluż poważnych obecnie pisarzy czytało swe pierwsze próby literackie w sali przy Krupniczej , siedząc wokół dębowych stołów zsuniętych pośrodku .	Krupniczej	12	Fem
Rola UNPROFOR jest jednak niejasna .	UNPROFOR	1	Neut
Rosyjscy eksperci uważają , że De Beers wzbogaca się nieuczciwie kosztem innych członków kartelu .	Beers	6	Neut
Dyrektor zapoznał Grodzickiego z katechetą , potem pożegnał się i wyszedł .	Grodzickiego	2	Masc
W klasztorze mieścił się obóz przejściowy dla Niemców sprowadzonych z Rumunii .	Rumunii	10	Fem
- Powiem Agnieszce .	Agnieszce	2	Fem
Jagienka jest młoda i nowoczesna , idzie do Iwony , by zrobić sobie pasemka .	Jagienka	0	Fem
Udali śmy się do Kroczewa .	Kroczewa	4	Neut
Jak to skończysz , spróbuj Stendhala i Buddenbrooków Tomasza Manna . . .	Manna	9	Masc
Niechlubny ranking województwa wielkopolskiego otwiera Wojewódzki Szpital Zespolony w Lesznie .	Lesznie	9	Neut
Kasprowicz opuścił Wrocław i wyjechał do rodzinnego Szymborza .	Szymborza	7	Neut
Przeciwko wnioskom Komisji ostro zaprotestował radny Krzysztof Gajewski , wiceprezydent w zarządzie odpowiedzialnym za zakup Elektrociepłowni .	Gajewski	7	Masc
Tadeuszowi wydało się , że w pewien sposób odgrodziła go także od Zanze .	Tadeuszowi	0	Masc
Karolina spuściła głowę .	Karolina	0	Fem
Samolot Ignacego odrywał się od ziemi , a Dominika i Adaś nie mogli oderwać się od siebie i intensywność ich spotkań rosła kosztem ostrożności .	Dominika	8	Fem
Za Pożarowem rozpoczynają się lasy i jeziora .	Pożarowem	1	Neut
Na lewo od nich widać cylindryczny budynek mieszczący teleskop Subaru .	Subaru	9	Neut
Książę Andrzej Poniatowski , porucznik armii francuskiej , odwiedził Polskę w roku 1919 jako członek francuskiej misji wojskowej .	Poniatowski	2	Masc
Polskę reprezentowały dwie kompozycje .	Polskę	0	Fem
W hali przy ulicy Księcia Bolesława na warszawskim Bemowie gościł Tomasz Frankowski .	Bemowie	8	Neut
Wcześniej za największe osiągniecie uważał dwukrotne zwycięstwo w Memoriale Zakrzewskiego w Kędzierzynie-Koźlu .	Kędzierzynie-Koźlu	11	Neut
Cygan brzdąknął palcami po strunach .	Cygan	0	Masc
Zdążyli dojechać do Knurowa .	Knurowa	3	Masc
Potem profesor Lalos pokazał im szkołę dziecięcą .	Lalos	2	Masc
Kaneyasu kiwał głową , akceptując pomysł Kiry .	Kiry	6	Fem
Wieczorem przyjechała Jadzia .	Jadzia	2	Fem
Jedenastkę przestrzelił także Kolumbijczyk Hamilton Ricard .	Kolumbijczyk	3	Masc
Prokuratura Okręgowa w Katowicach wystąpiła do sądu o aresztowanie Krzysztofa Rutkowskiego .	Katowicach	3	Neut
- Maciek akcentuje to słowo .	Maciek	1	Masc
Piotr Aniołkiewicz i Paweł Sulikowski zginęli w 1997 r. koło Komorowa .	Paweł	3	Masc
Tatry są bezlitosne .	Tatry	0	Neut
Dwa lata temu kilkudziesięciu okolicznych rolników demonstrowało swoje niezadowolenie przed mławską Temidą .	Temidą	11	Fem
I kamera pokazuje go w panterce , na froncie w Bośni .	Bośni	10	Fem
– Joanna z lekkim wyrzutem spojrzała na młodą koleżankę .	Joanna	1	Fem
Misję tę powierzyła doktorowi Lane matka Oswalda , Marguerite .	Oswalda	6	Masc
Pięcioletnia dziewczynka , porwana wczoraj przez 65-letniego mężczyznę w Chorzowie na Śląsku , odzyskała wieczorem przytomność .	Chorzowie	9	Masc
Bartoch zapalał się coraz bardziej i zdawało się , że o Franoszkach zapomniał .	Franoszkach	11	Masc
Przestraszona Zosia schowała się za wózek .	Zosia	1	Fem
Aby pozbyć się niespokojnego ducha z Apulii , Onufry wysłał Roberta do Kalabrii .	Kalabrii	12	Fem
Do Kamienia nie pójdzie .	Kamienia	1	Masc
Agent Pawłow nieustannie wodził wzrokiem za kapitanem , pilnie nadstawiał ucha .	Pawłow	1	Masc
Znacznie lepiej zagrał przed przerwą Kwapisiewicz na lewym skrzydle .	Kwapisiewicz	5	Masc
Wieczorem przyjechała Grażyna Celińska z dziećmi i razem zjedli śmy kolację .	Celińska	3	Fem
Na ekranie TV , na zatrzymanej stop-klatce Jurka Kilera idą napisy końcowe programu .	TV	2	Fem
Ułatwi ona włączenie się do ruchu jadącym z Koziegłów do Poznania .	Koziegłów	8	Neut
i ta mała Asia się pochorowała .	Asia	3	Fem
Niezależnie od przedstawionych wyników , kontrolę przeprowadzą jeszcze policjanci z Komendy Wojewódzkiej Policji w Katowicach .	Katowicach	14	Neut
- Jakie znaczenie dla śledztwa ma odkrycie dokonane w archiwach w Łomży , o którym niedawno poinformowała prof . Daria Nałęcz ?	Daria	19	Fem
Kozubek wysyła Anglikom koronkową bieliznę .	Kozubek	0	Masc
Jak tchórzliwy jest Manifest Połaniecki Kościuszki !	Kościuszki	5	Masc
Królową Mody wybrano na rok 1935 znaną pieśniarkę Werę Bobrowską .	Werę	8	Fem
Odprawiła nawet TVN , która chciała podpisać umowę na wyłączność w informowaniu o seksaferze .	TVN	2	Fem
Edek odmówił , nie chciał zostawić Mali .	Edek	0	Masc
Czy La Famille Richet istotnie została zaprezentowana w Edynburgu ?	Richet	3	Fem
Owen wie wszystko .	Owen	0	Masc
Nasze piłkarki w grupie zmierzą się z Niemcami , Szwecją i Szwajcarią .	Szwajcarią	11	Fem
Tam odezwał się Michał Kalinowski .	Kalinowski	4	Masc
Jego wzrost i groźna twarz uczyniły na Turku wrażenie .	Turku	7	Masc
Jak to skończysz , spróbuj Stendhala i Buddenbrooków Tomasza Manna . . .	Buddenbrooków	7	Masc
Parokrotnie Wajdowie osobiście kwestowali na ulicach Japonii .	Japonii	6	Fem
Znalazł też Kwaśniewski niefortunnych obrońców .	Kwaśniewski	2	Masc
Jeszcze przez kilka minut starali się uporać z doznaną porażką i dramatyczną decyzją Beatki .	Beatki	13	Fem
Sędzia Rymarz przyznał , że telewizja miała prawo zatrzymać kasety Bubla .	Rymarz	1	Masc
Przyjechał tu na Milkowszczyznę już jako doktor .	Milkowszczyznę	3	Fem
Może w dużych ośrodkach miejskich ludzie zagłosują na Juszczenkę , ale we wsiach poparcie dla Janukowicza będzie ogromne .	Juszczenkę	8	Masc
KPN chce zaproponować własne rozwiązania tego problemu i dlatego żąda od resortu danych o imporcie .	KPN	0	Fem
Aż trudno uwierzyć , że jeszcze kilkanaście dni temu ptaszki ćwierkały , że zostawi stację Waltera i przeniesie się do TVP .	TVP	20	Fem
W 1935 roku brytyjski informatyk Alan Mathison Turing wymyślił abstrakcyjną maszynę .	Turing	7	Masc
Bożena też nie ma z czego zwrócić pożyczki .	Bożena	0	Fem
Czytałem , że to dobry kryminał , poza tym lubię Ginę Gershon .	Gershon	11	Fem
Obecnie znajdują się oni w szpitalu w Nakle .	Nakle	7	Neut
Ogonowski i Latusek tłumaczyli , że właśnie znaleźli zastrzelone zwierzę .	Latusek	2	Masc
- Marysette umilkła .	Marysette	1	Fem
Chce w Bohatyrowiczach zrobić biznes .	Bohatyrowiczach	2	Neut
Starcie między Generałem a MRP przybrało nawet formy drastyczne .	MRP	4	Neut
IZABELLE ADJANl , gwiazda filmu francuskiego , wygrała precedensowy proces .	IZABELLE	0	Fem
Bartodziej kładzie się na leżance .	Bartodziej	0	Masc
W ten sposób Rumuni wystąpili w roli głównego mediatora pomiędzy Moskwą a Pekinem .	Moskwą	10	Fem
W hali przy ulicy Księcia Bolesława na warszawskim Bemowie gościł Tomasz Frankowski .	Tomasz	10	Masc
Tenisiści stołowi Energetyka Opoki Trzebinia znają już terminy spotkań barażowych o I ligę , w których ich rywalem będzie zwycięzca II ligi łódzko - świętokrzyskiej Start Brzezina .	Trzebinia	4	Fem
– a Dorotka pracuje w banku dalej ?	Dorotka	2	Fem
Zwierzenia Ani poruszyły mnie do głębi .	Ani	1	Fem
Druga patrząc wymownie na panią Zielińską zaśmiała się wesoło .	Zielińską	5	Fem
Za pomaganie funkcjonariuszom MO Konstanty odpowie teraz przed sądem .	MO	3	Fem
Konsjerżka , jak większość konsjerżek Portugalka , szorowała chodnik i mury ryżową szczotką .	Portugalka	5	Fem
Jeden Chińczyk został zabity .	Chińczyk	1	Masc
Z pożaru uratowała się czternastoletnia Stefania Nowaczuk .	Stefania	5	Fem
Sędzia Rymarz przyznał , że telewizja miała prawo zatrzymać kasety Bubla .	Bubla	10	Masc
Beacie towarzyszył mój starszy kuzyn , inżynier Wacław Straszyński .	Beacie	0	Fem
ZSRR wypowiada wojnę Japonii .	ZSRR	0	Masc
Ameryka nie marzy o czymś jeszcze trudniejszym niż Irak i Afganistan .	Afganistan	10	Masc
Występuje w Europie .	Europie	2	Fem
Trupy wrzucono do Gopła .	Gopła	3	Neut
Jeszcze przez kilka minut starali się uporać z doznaną porażką i dramatyczną decyzją Beatki .	Beatki	13	Fem
Arcybiskup Ochrydy przypisuje Borysowi także i inne cechy , które wzbogacają jego wizerunek .	Borysowi	3	Masc
Rozpędzonej karuzeli stanowisk nie zatrzymała minister Piwnik , choć przez pierwsze pół roku urzędowania wstrzymywała się ona z ruchami kadrowymi .	Piwnik	6	Fem
Pani Kennedy siedziała przy zwłokach .	Kennedy	1	Fem
Na zakończonym wczoraj w Paryżu kongresie FPK przyjęto 1080 głosami przeciw 43 centrowy program szefa partii Roberta Hue .	FPK	6	Fem
Warunkiem będzie jednak zatrudnienie odchodzących z TP SA pracowników .	SA	7	Fem
Według KAI zaskarżenie ustawy do sądu zapowiedziała już organizacja American Civil Liberties Union .	Liberties	11	Fem
A jak to wygląda w Stalowej Woli ?	Woli	6	Fem
Rzecznik australijskiego koncernu Chris Codrington wyraził przekonanie , że przyczyną zatrucia wód Cisy nie był cyjanek .	Codrington	4	Masc
Na torze pod Kielcami odbyty się pierwsze wyścigi samochodowe .	Kielcami	3	Neut
Usamodzielniły się Wyry , Bojszowy , Lędziny i Bieruń .	Wyry	2	Neut
Studiują tutaj Łukasz Kruczek , Grzegorz Śliwka , Krystian Długopolski , teraz obok mnie studentem został Tomek Pochwała .	Pochwała	17	Masc
Szeligowa jej nie znała i udało się ciotce wywieść ją w pole .	Szeligowa	0	Fem
W czasie weekendu dorodny lampart spacerował ulicami stolicy Indii , Delhi .	Indii	8	Neut
Warta obsługuje powodzian w pierwszej kolejności .	Warta	0	Fem
– Bo chyba pana Macierewicza trzymają się żarty .	Macierewicza	4	Masc
Już widze Opłatek w kulinarnej oprawie Hejrublańskiego !	Hejrublańskiego	6	Masc
Teraz siedziała wyprostowana na łóżku , z napięciem wpatrując się w twarze Blothów .	Blothów	12	Masc
W Egipcie sporo jest Polaków ; handlowców , inżynierów .	Egipcie	1	Masc
Zośka lekko się zmieszała .	Zośka	0	Fem
Ród Piastów pochodził z plemienia Polan .	Piastów	1	Masc
Obok colonel Eddie majstruje coś we wspaniałym Kodaku .	Eddie	2	Masc
- Piotr Rokicki to twój ojciec ?	Piotr	1	Masc
Specjaliści z Centralnej Agencji Wywiadowczej mają już świadka , który widział zamachowców na kilka minut przed eksplozją w Nairobi .	Nairobi	18	Neut
W Birkenau osadzono ich oddzielnie w podziemiach Bloku Śmierci .	Birkenau	1	Neut
Dokonać charakterystyki Tatr na podstawie mapy wielkoskalowej .	Tatr	2	Neut
Szacki wytarł usta serwetką .	Szacki	0	Masc
Na pastwisku w Uniszkach Gumowskich rolnik załadował na dwukółkę krowę .	Uniszkach	3	Neut
Rosyjsko - niemiecka inwestycja ominie Polskę i inne państwa Europy Środkowej .	Polskę	5	Fem
Ulewne deszcze nawiedziły także Słupsk .	Słupsk	4	Masc
Nawiązano współpracę z kołami gospodyń wiejskich w Domatkowie , Kolbuszowej Górnej , Nowej Wsi , Weryni i Widełce .	Domatkowie	7	Masc
Marian wyciągnął wygodnie nogi przed siebie .	Marian	0	Masc
W Pruszkowie gang zorganizowali wychowankowie słynnego w czasach PRL bandyty Barabasza .	Pruszkowie	1	Masc
Paul Dellapina skazany na dwadzieścia lat ucieka po raz ósmy z więzienia .	Dellapina	1	Masc
Edek odmówił , nie chciał zostawić Mali .	Mali	6	Fem
- Johannowi Reischowi miasteczko od razu się spodobało .	Johannowi	1	Masc
Głupiego samochodu na parę minut zostawić nie można , to się nazywa MO ?	MO	12	Fem
Dominować będą piosenki do tekstów Edwarda Stachury .	Stachury	6	Masc
21-latek ostrzelał z broni ostrej mieszkanie w centrum Skarżyska .	Skarżyska	8	Neut
- Skąd ty o tym wiesz , Józiu ?	Józiu	7	Masc
Tragiczny wypadek zdarzył się na trasie kolejowej z Piły do Chojnic .	Chojnic	10	Neut
To właśnie nasza Polska , nowa Rzeczpospolita , Coraz bardziej podzielona , coraz bardziej rozbita .	Rzeczpospolita	6	Fem
Kazancewa po raz ostatni widziano , gdy podróżował śmigłowcem w rejonie walk .	Kazancewa	0	Masc
Przed tygodniem wicestarosta Hrycyna podczas wyjazdu do Gdańska uzyskał przychylność tamtejszych środowisk żydowskich .	Gdańska	7	Masc
Przecież wczoraj po południu Paulina była u niego w mieszkaniu .	Paulina	4	Fem
Sekretarz generalny KPZR Leonid Breżniew odwiedził Bułgarię , Jugosławię i Węgry .	Węgry	10	Neut
Zawód odmalował się na twarzy Feliksa .	Feliksa	5	Masc
- Zawsze wierzył em w Europę .	Europę	5	Fem
Tych zaś było dziś aż siedmiu na podwórku Adamusa .	Tych	0	Neut
Michał naciągnął mi na oczy kaptur , omotał szalikiem i kazał wracać do domu .	Michał	0	Masc
" Obywatelu Bukowiński , proponujemy wam repatriację do Polskiej Republiki Ludowej " .	Republiki	9	Fem
Przez następne 200 lat Krzyżacy kolonizowali Prusy i budowali swoje państwo .	Prusy	6	Neut
Pierwszy dzień kalendarzowej wiosny przebiegł w Kielcach spokojnie .	Kielcach	6	Neut
Poseł Cymański docenił . . .	Cymański	1	Masc
- Maniek Zieniuk jest dalej komendantem w Nowym Mieście ?	Maniek	1	Masc
Siedziała Lonia z twarzą w dłoniach .	Lonia	1	Fem
W piątek życzenia od przedstawicieli władz miejskich , kolejowych i zaproszonych gości odebrał dyrektor ZSET Kazimierz Maćkowiak .	Kazimierz	15	Masc
Świadkowie twierdzą , że spod siedziby SdRP odjechało w ostatnich kilkunastu miesiącach kilka takich grup .	SdRP	6	Fem
We wtorek prezydent Robert Choma skierował sprawę do rzecznika dyscyplinarnego UM Danuty Wiech .	Danuty	11	Fem
Niedziela Palmowa na Kociewiu różniła się zresztą od obchodów w innych częściach Polski .	Niedziela	0	Fem
Było to największe w dziejach III RP oddłużenie .	RP	6	Fem
Nie posiadała pani Klaudia urody .	Klaudia	3	Fem
Czy Dominik , broniąc się , mógł przewidzieć aż tak dramatyczne skutki ? !	Dominik	1	Masc
Był również profesorem uniwersytetów w Jenie i Berlinie .	Jenie	5	Fem
Liczba cudzoziemców na Mazowszu rośnie z roku na rok .	Mazowszu	3	Neut
Do kraju powróciły uprowadzone Polki .	Polki	4	Fem
W Zwieczycy koło Rzeszowa autobus PKS wpadł do głębokiego rowu .	Zwieczycy	1	Fem
- Powinno być łatwiej , bo Husajna nie otaczają fanatycy .	Husajna	6	Masc
– W HSW SA trwa obecnie wielkie liczenie .	HSW	2	Fem
Napisał ją Chilijczyk Ariel Dorfman .	Chilijczyk	2	Masc
MPK prowadzi jeszcze rozmowy z wojskiem i PKP .	MPK	0	Neut
Commercial Union od 1991 roku działa również na rynku naszych ubezpieczeń życiowych .	Commercial	0	Masc
Pani Rylicka odchyliła się do tyłu .	Rylicka	1	Fem
Widownia westchnęła ze współczuciem , a Iwana to uskrzydliło .	Iwana	6	Masc
Badania wielkości sił naciągu strun na torze przeprowadzono przez bezpośredni pomiar sił w poszczególnych strunach za pomocą przyrządu VOGT .	VOGT	18	Masc
Ludmiła Putin , żona prezydenta Federacji Rosyjskiej Władimira Putina , rozpoczęła wczoraj wizytę w Polsce od zwiedzenia zamku na Wawelu .	Ludmiła	0	Fem
Linia Jana kończy się na świętym Stanisławie Kostce .	Kostce	7	Masc
Denver został założony w 1858 roku i był wielkim centrum górnictwa złota i srebra ; w II połowie XIX wieku powstało Muzeum Sztuki z kolekcją sztuki Indian .	Indian	26	Masc
Niech żyje nasza Ojczyzna , Wielka Ruś !	Ruś	6	Fem
Według KPN budżet państwa traci na [import]cie paliw , a zasady koncesjonowania są niejasne .	KPN	1	Fem
Ela łyka powietrze głębiej , głębiej . . .	Ela	0	Fem
Hakerzy zaatakowali stronę internetową Watykanu .	Watykanu	4	Masc
Mariusz Łapiński nadal będzie ministrem zdrowia .	Łapiński	1	Masc
Nagle wyskoczył stamtąd ku Maćkowi i uderzył go pięścią w twarz .	Maćkowi	4	Masc
Polski samolot M-28 rozbił się i eksplodował kilka sekund po starcie z lotniska w Puerto Cabello , 200 km na zachód od Caracas .	M-28	2	Neut
Czyż ton wypowiedzi Zdziechowskiego i Courtenaya nie jest podobny ?	Courtenaya	5	Masc
Siadam w kącie i usypiam , budząc się na Gare du Nord .	Gare	9	Fem
Jednocześnie prezydent Egiptu Hosni Mubarak ogłosił , że jest możliwy kompromis .	Egiptu	2	Masc
Wychowankowie Domu Dziecka na Oruni otrzymali od policjantów prezenty mikołajkowe .	Oruni	4	Fem
Mirosław Seta , miejscowy strażak , wchodzi meldując , że sytuacja wydaje się opanowana .	Seta	1	Masc
Martyna była następna .	Martyna	0	Fem
Zaprosił do Varietes Budapest .	Varietes	2	Neut
– w Mel Rozie była ś ?	Rozie	3	Fem
Baryshnikov automatycznie skorzystał z Rangera .	Rangera	4	Masc
Kilka lat temu ofiarą wandali padły mogiły na Cmentarzu na Powązkach w Warszawie .	Warszawie	12	Fem
Ze sklepu Wedla wyszedł ciemno ubrany mężczyzna z kilkoma paczuszkami w rękach .	Wedla	2	Masc
Do wypadku doszło na drodze z Gilwy do Prabut .	Prabut	8	Neut
Wiece i akademie odbyły się również w Sofii , Damaszku , Kabulu , Surabai i innych miastach .	Surabai	13	Fem
Jak stawiać granice dzieciom z FAS ?	FAS	5	Neut
Zdziwisz się , ale wielu głosowało za Bośnią .	Bośnią	7	Fem
Rzecznik Prokuratury Okręgowej w Łodzi Krzysztof Kopania , zasłaniając się dobrem postępowania , odmówił na tym etapie śledztwa odpowiedzi na pytanie , czy ksiądz przyznał się do stawianych mu zarzutów .	Kopania	6	Masc
I wziął niebieską kredkę od Karolci , aby zabrać się do roboty .	Karolci	5	Fem
Ta przekazała sprawę do PW w Lesznie .	Lesznie	6	Neut
Doktor Słodkowski zapewnia , że przynajmniej raz na kwartał będzie odwiedzał Zakopane .	Słodkowski	1	Masc
Podopieczni trenera Mirko Jozica obecnie przebywają na zgrupowaniu w Austrii .	Mirko	2	Masc
- Według konstytucji wasz Wałęsa nie ma takich uprawnień jak prezydent Białorusi .	Białorusi	11	Fem
Przystupa otworzyła oczy .	Przystupa	0	Fem
Czy pan poseł Chmielewski chce zadać pytanie ?	Chmielewski	3	Masc
Mój Piotrek uchodzi za speca w dziedzinie drewnianego budownictwa na Podhalu .	Podhalu	10	Neut
Sąd Rejonowy w Olsztynie wczoraj postanowił przekazać ją Sądowi Okręgowemu .	Olsztynie	3	Masc
W Burkina Faso dominują muzułmanie .	Burkina	1	Neut
Niemcy słuchają .	Niemcy	0	Masc
Na polach Domatowa i Polchowa usypano wysokie mogiły .	Domatowa	2	Neut
- A czy słyszał pan o Witoldzie Michałowskim ?	Witoldzie	6	Masc
Pamiętam w Iveronie w sześciu gablotach stłoczone największe relikwie .	Iveronie	2	Fem
Od tego zależą losy SLD .	SLD	4	Masc
Bardzo zachęcam do wizyty w ICM i stałego korzystania z jej usług .	ICM	5	Neut
- Maniek Zieniuk jest dalej komendantem w Nowym Mieście ?	Mieście	8	Neut
Zacznę od dziś nazywać Lewickiego Anakondą .	Lewickiego	4	Masc
W Warszawie jest ulica Nowy Świat .	Warszawie	1	Fem
ŻYCIE przedstawiło w sądzie świadków , którzy widzieli Kwaśniewskiego w Cetniewie .	Cetniewie	10	Neut
Natomiast Rada Państwa NRD podjęła decyzja podpisania układu .	NRD	3	Fem
Juniorską reprezentację w najbliższym czasie czekają półfinały ME w Essen .	ME	7	Neut
W Radlinie trafiła do szpitala .	Radlinie	1	Masc
W poniedziałek rano do Betlejem i Kalkilli na Zachodnim Brzegu Jordanu wjechały izraelskie czołgi .	Jordanu	10	Masc
Z jednym z nich , Witkiem , rozmawialiśmy przez CB-radio .	CB-radio	9	Neut
Celnikom wyjaśniła , że muszlę kupiła w Acapulco za 20 dolarów .	Acapulco	7	Neut
Dlaczego nie mogę włożyć swetra Anki ?	Anki	5	Fem
Na twarzy Marii zgasł uśmiech .	Marii	2	Fem
Trzecioligowcy strzelili kontaktowego gola , ale w ostatnim kwadransie dwie bramki dla Lecha wypracował Remień .	Remień	14	Masc
Pan Janek zachodził do Ireny Rosy na kawę .	Rosy	5	Fem
Nie zdążył Serab dać odpowiedzi .	Serab	2	Masc
Andrzej Micewski zrobił to dopiero w roku 1956 .	Micewski	1	Masc
Na scenie bez przerwy prezentowały się zespoły młodzieżowe z Reska , Szczecina , Polic i Wolina .	Reska	9	Neut
Kto by uwierzył , że kiedykolwiek będziemy się chlubić kopalniami , nie mówiąc o obiektach PKP ?	PKP	15	Neut
Janka nic nie odpowiada i zamyka drzwi .	Janka	0	Fem
Suger Land jest najdynamiczniej rozwijającym się teksańskim miastem .	Suger	0	Masc
Niezadowolenie wyrazili również jej koledzy z SDP .	SDP	6	Neut
W świecie nauki początek jesieni to emocje towarzyszące Nagrodom Nobla .	Nobla	9	Masc
Na reklamowanie Heyah nie ma szans .	Heyah	2	Neut
Krzysztofowi K . grozi kara do 12 lat pozbawienia wolności .	Krzysztofowi	0	Masc
Zapomniał eś dodać okultyzm Ojca Pio i Katarzyny Neuman .	Pio	5	Masc
Kiedy wyciągnęli Wandzię na brzeg , z ust wypłynęła jej piana . . .	Wandzię	2	Fem
Lucyfer wyczarował sobie stołek i też usiadł .	Lucyfer	0	Masc
Dlatego też dojrzewanie w Chrystusie nie jest łatwe .	Chrystusie	4	Masc
Zagraniczne agencje informacyjne i prasa obszernie zrelacjonowały sobotnią konferencję prasową wicepremiera Janusza Obodowskiego .	Obodowskiego	12	Masc
Przyjechał tu na Milkowszczyznę już jako doktor .	Milkowszczyznę	3	Fem
Jan Paweł II może być niebawem beatyfikowany .	Paweł	1	Masc
Ten Murzyn to sekretarz generalny ONZ , Kofi Annan .	Kofi	7	Masc
Pan Klimaszewski pomylił lata .	Klimaszewski	1	Masc
Prokuratura Apelacyjna współpracuje w tej sprawie z oddziałami CBŚ we wspomnianych miastach i Urzędami Kontroli Skarbowej .	CBŚ	8	Neut
Stryjna przyjechała i mieszkanie wypełniło się jej obecnością .	Stryjna	0	Fem
Jeżeli Golędzinów nadjedzie , wygra wielką stawkę .	Golędzinów	1	Masc
Potem na aryjską stronę przeszli Tetka i Ojciec , a także inni przyjaciele rodziców .	Tetka	5	Fem
Tenisiści stołowi Energetyka Opoki Trzebinia znają już terminy spotkań barażowych o I ligę , w których ich rywalem będzie zwycięzca II ligi łódzko - świętokrzyskiej Start Brzezina .	Start	25	Masc
Orfeusz zmierza pewnie ku światłu , pomyślnie wyprowadzając Eurydykę z krainy zmarłych .	Eurydykę	8	Fem
Chodzi prawdopodobnie o Burkina Faso .	Faso	4	Neut
IZABELLE ADJANl , gwiazda filmu francuskiego , wygrała precedensowy proces .	ADJANl	1	Fem
Wędrował po Tatrach od 1914 r. , wspinał się od 1924 .	Tatrach	2	Neut
Jadzia nie przyjechała .	Jadzia	0	Fem
Trwa izraelska akcja zbrojna w Strefie Gazy .	Gazy	6	Fem
Sekretarz generalny KPZR Leonid Breżniew odwiedził Bułgarię , Jugosławię i Węgry .	Bułgarię	6	Fem
Naukowcy z Uniwersytetu w Portland w USA sklonowali rezusa , czyli małpę należącą do rzędu naczelnych .	Portland	4	Neut
Na Węgrzech występuje pianistka Halina Czerny - Stefańska i jej córka klawesynistka Elżbieta Stefańska - Łukowicz .	Węgrzech	1	Neut
Polskich komunistów nie łączyły nigdy żadne specjalne więzy z przywódcami ludowych Chin .	Chin	11	Neut
Stali na chodniku przed odrapanym budynkiem w Erewanie , w którym mieścił się Komitet Karabachu .	Karabachu	14	Masc
W pierwszej części obrad sekretarzami będą pani posłanka Zdzisława Kobylińska i pan poseł Mieczysław Jedoń .	Zdzisława	8	Fem
Nie znał Ilony .	Ilony	2	Fem
Ostatnia wizyta we Włoszech miała przede wszystkim charakter gospodarczy .	Włoszech	3	Neut
Austria i carska Rosja niszczyły je dalej systematycznie .	Austria	0	Fem
Weź Lolkę i idźcie na górę .	Lolkę	1	Fem
Poszły nad Ślęzę .	Ślęzę	2	Fem
Faktem jest , że nawet Hitler nie oczekiwał aż takiej reakcji Stalina .	Stalina	11	Masc
Do wypadku doszło w Kwidzynie na ulicy 15 Sierpnia .	Kwidzynie	4	Masc
Koncern nadal ma umowy licencyjne z producentami w Japonii , Włoszech , Afryce Południowej i na Filipinach .	Afryce	12	Fem
Ale nie rozumiem , jak można w imię ekumenizmu wysuwać roszczenia do tworzenia w Europie stref monopolistycznych wpływów religijnych .	Europie	14	Fem
Rzeczywiście Stopina rozwieszała w ogrodzie bieliznę .	Stopina	1	Fem
Nasze piłkarki w grupie zmierzą się z Niemcami , Szwecją i Szwajcarią .	Niemcami	7	Neut
Ale Hanka tylko się odwróciła .	Hanka	1	Fem
Była to Angielka w średnim wieku .	Angielka	2	Fem
Zasapany Mock zszedł ze stołu i włożył głowę do żeliwnego zlewu .	Mock	1	Masc
Na rozbiegu staje Jussilainen .	Jussilainen	3	Masc
Teraz Jasienica będzie musiała usunąć część wodociągu , który bezprawnie postawiła na prywatnej ziemi Pałuchy .	Jasienica	1	Fem
ŻYCIE przedstawiło w sądzie świadków , którzy widzieli Kwaśniewskiego w Cetniewie .	Kwaśniewskiego	8	Masc
Uczył się w Liceum Technik Plastycznych w Zakopanem prowadzonym przez Antoniego Kenara .	Zakopanem	7	Neut
Położenie geopolityczne i ropa sprawiają , że tu krzyżują się interesy wielu państw , w tym Rosji , USA i Turcji .	Turcji	20	Fem
Zatrzymali śmy się także na jeden dzień w Bourges , a stamtąd pojechali śmy już do Niemiec .	Bourges	8	Neut
Premier Cyrankiewicz i Pierre Lauret wygłosili krótkie przemówienia .	Lauret	4	Masc
W końcu znalazł się w Lesznie .	Lesznie	5	Neut
Najciekawiej zapowiada się w Moskwie , gdzie miejscowy Spartak podejmuje Ajax Amsterdam .	Moskwie	4	Fem
Przyjechali też strażacy z OSP z Poronina , Suchego i Kościeliska .	Poronina	6	Masc
Ale Ika potrząsnęła przecząco głową .	Ika	1	Fem
102 lata obchodziła wczoraj Stanisława Przybyła , rodowita mieszkanka Łaz .	Stanisława	4	Fem
o o czyżby Krzysiu szedł . .	Krzysiu	3	Masc
- Dużo o tym pisał Antoni Słonimski , mój stryj .	Antoni	5	Masc
Według Zofii Staśkiewicz z Dworu Artusa , artyści bardzo chętnie godzą się na koncerty w Toruniu .	Staśkiewicz	2	Fem
Chodzi prawdopodobnie o Burkina Faso .	Burkina	3	Neut
Zenek prosił kolegów , żeby nic nie mówili mamie , gdyby go przysypało .	Zenek	0	Masc
Pudel wabił się Oskar .	Oskar	3	Masc
Zawody będą rozgrywane na Dunajcu na odcinku od Krościenka do mostu w Gołkowicach .	Dunajcu	4	Masc
Elizabeth nie wiedziała , jak jej powiedzieć , że przywiozła chore dziecko .	Elizabeth	0	Fem
We wtorek prezydent Robert Choma skierował sprawę do rzecznika dyscyplinarnego UM Danuty Wiech .	Wiech	12	Fem
Czy ma pani jakiś szczególny stosunek do Izraela ?	Izraela	7	Masc
Pomiaukując alarmująco , zaprowadził Adama do dużego pokoju .	Adama	4	Masc
Paweł nie rozumie Antoniego .	Antoniego	3	Masc
Długie lata praktyki w kontaktach z nadkastowymi pozwoliły Hariemu zachować kamienną twarz .	Hariemu	8	Masc
Muzeum homoseksualizmu otwierał nadburmistrz Berlina Klaus Wowereit .	Klaus	5	Masc
Resa pośpieszyła do Ab–Rama , czekającego niecierpliwie w swoim namiocie .	Ab–Rama	3	Masc
Według KAI zaskarżenie ustawy do sądu zapowiedziała już organizacja American Civil Liberties Union .	American	9	Fem
Nowoczesną motorówkę do patrolowania Wisły ukradziono policjantom z Torunia .	Wisły	4	Fem
" Obywatelu Bukowiński , proponujemy wam repatriację do Polskiej Republiki Ludowej " .	Bukowiński	2	Masc
Gospodarstwo Stanisławy Sowy , Irki Paulako i Moniki Niebrzydowskiej rozszerza się powoli poza obręb zabudowań gospodarskich .	Irki	4	Fem
- Oddaję ci , bracie Nachorze , terafim ojca naszego .	Nachorze	5	Masc
3-letnia Joasia wybierała się z dziadkiem na weekend .	Joasia	1	Fem
Na nasz rozum z Polmosu najzwyczajniej wyprowadzono 2 mln euro .	Polmosu	4	Masc
Mateo mieszka na Elbie , gdzie latem wynajmuje turystom motorówki .	Elbie	3	Fem
Most w Kuligach na rzece Jegrzni znajduje się w fatalnym stanie i grozi zawaleniem .	Kuligach	2	Neut
Dobrze spisała się młodzież w Sterdyni , Ceranowie , Skrzeszynie , Czerwonce i Wężach .	Skrzeszynie	9	Neut
Kilka lat temu ofiarą wandali padły mogiły na Cmentarzu na Powązkach w Warszawie .	Powązkach	10	Neut
- Pawle , nie jedź do Jerozolimy !	Jerozolimy	6	Fem
Dystychy , analizowane dotąd oddzielnie , złóżmy obecnie w całość , bo przecież w Dusiołku tworzą one taką całość .	Dusiołku	14	Masc
Nawiązano współpracę z kołami gospodyń wiejskich w Domatkowie , Kolbuszowej Górnej , Nowej Wsi , Weryni i Widełce .	Kolbuszowej	9	Fem
Polak potrafi .	Polak	0	Masc
Pestka nie przejęła się tym okrzykiem .	Pestka	0	Fem
Informacje na temat historii zen i różnych szkół znajdzie Czytelnik w chronologicznym zestawieniu najważniejszych wydarzeń z historii zen w Chinach i Japonii .	Chinach	19	Neut
To jest w programie PiS-u .	PiS-u	4	Masc
Konferencji przewodniczył Antoni Żeglej .	Antoni	2	Masc
Czy on nie był Mazurem ?	Mazurem	4	Masc
Gospodarze odpowiedzieli dwoma golami Ralfa Hauptmanna i Austriaka Tony Polstera .	Tony	8	Masc
Parafia Pozezdrze jeszcze w 1890 na 2630 parafian liczyła 658 Polaków .	Pozezdrze	1	Neut
Ocean wtargnął w głąb lądu i nie odpłynął cały , tworząc jeziora rozmiaru mórz , bo głęboka płyta litosferycznego płaszcza Kwinty uległa zgnieceniu , a wody zapełniły powstałe na powierzchni depresje .	Kwinty	20	Fem
Pożeracz Chmur przełknął ostatni kęs i oblizał palce .	Chmur	1	Fem
Sprawy zasadnicze to niemiecka marka i Europa .	Europa	6	Fem
Mówiły one o uniezależnieniu się Prus Książęcych od Polski .	Prus	5	Neut
Siedziba gminy to Olecko .	Olecko	3	Neut
— Jakie jest oblicze tego komunizmu , które pani widzi w Europie ?	Europie	11	Fem
Amerykanie wzięli La Haie du Puy .	Puy	5	Neut
Zdaniem Kwaśniewskiego jest to wystarczająca kara i Siwiec nie musi ustępować ze stanowiska .	Siwiec	7	Masc
Była to wieś Dolsko .	Dolsko	3	Neut
Po długo obowiązującym zakazie , znowu do Japonii przybyli katoliccy misjonarze .	Japonii	7	Fem
W Nowym Tomyślu wiatr zerwał dach urzędu skarbowego i pasażu handlowego .	Tomyślu	2	Masc
Chciałbym podzielić się kilkoma przemyśleniami z Mikołajem Szymańskim .	Mikołajem	6	Masc
Na Węgrzech występuje pianistka Halina Czerny - Stefańska i jej córka klawesynistka Elżbieta Stefańska - Łukowicz .	Elżbieta	12	Fem
Nie czekając na decyzję Akcji , Unia Wolności zaczęła lansować na prezesa Karola Modzelewskiego , historyka i polityka związanego z Unią Pracy .	Modzelewskiego	13	Masc
- Mana poczuła , że znowu robi się jej trochę niedobrze .	Mana	1	Fem
Saszka podszedł do Handzi , usiadł obok na kłodzie .	Handzi	3	Fem
Zdaniem Marka Markiewicza , polityczną dojrzałość polityk osiąga dopiero po czterdziestce .	Markiewicza	2	Masc
Komendanta wojewódzkiego powoła więc ostatecznie szef MSWiA .	MSWiA	6	Neut
Tylko w czterech państwach w Europie pojawiły się sieci DCS .	DCS	9	Neut
Florek wzruszył ramionami .	Florek	0	Masc
BMW wspomaga Rolls-Royce'a .	BMW	0	Neut
W wyniku wyborów Kohl utrzymał przewagę w Bundestagu .	Kohl	3	Masc
Indie stanowczo zaprzeczają .	Indie	0	Neut
Królowała wśród nich pani Gieniuchna .	Gieniuchna	4	Fem
Spustoszył potem Kujawy i zabrał wielkie łupy , które jednak mistrz prowincji mu wydarł .	Kujawy	2	Neut
50.000 złotych kosztowała modernizacja ul . Hallera w Lubiewie .	Lubiewie	8	Neut
Prezydenci Polski , Ukrainy i Rumunii spotkali się na roboczych rozmowach w Bukareszcie .	Rumunii	5	Fem
Policjanci z Pieniężna od dawna szykowali się do akcji przeciwko miejscowym kłusownikom .	Pieniężna	2	Neut
Minister obrony Tengiz Kitowani , były premier Tengiz Sigua i szef milicji Mchedrioni Dżaba Joseljani obalili przed rokiem prezydenta Zwiada Gamsahurdię .	Joseljani	14	Masc
Przypomniał swą pierwszą sprzed kilku lat wizytę w Ludwinowie w 1860 roku , zabawił kilka dni , zburzył spokój samotniczki .	Ludwinowie	8	Neut
Kompromitowali nie tylko siebie , ale i Polskę .	Polskę	7	Fem
Po dziesięciu rozegranych kolejkach MG MZKS ma zaledwie dwa punkty .	MG	4	Masc
Niektórzy didżeje wpisują sobie występ w Pieksie do CV .	CV	8	Neut
Kos aż gwizdnął z uciechy .	Kos	0	Masc
Urząd nie będzie porównywał obu PIT-ów .	PIT-ów	5	Masc
Tor tymczasem pochylił się nad ekranem .	Tor	0	Masc
Minister obrony Tengiz Kitowani , były premier Tengiz Sigua i szef milicji Mchedrioni Dżaba Joseljani obalili przed rokiem prezydenta Zwiada Gamsahurdię .	Tengiz	7	Masc
Karina pracowała na oddziale dziecięcym .	Karina	0	Fem
W niedzielę po południu turysta schodzący z Zawratu usłyszał głosy we mgle .	Zawratu	7	Masc
NIK podkreśla , że w czasie prywatyzacji AWRSP następowało pogorszenie sytuacji ekonomicznej Polski .	NIK	0	Fem
Jednak już wkrótce Nizioł i Wapiński ze zdumieniem odkryli , że Łapiński nie dotrzymuje wcześniej danego słowa .	Łapiński	11	Masc
Rebelianci z tak zwanej Wyzwoleńczej Armii Kosowa zajęli Belacewacz tydzień temu .	Belacewacz	8	Neut
I ma w dodatku zorganizowane oparcie w ZNP .	ZNP	7	Masc
Najbliżsi rywale Orfe także nie rezygnują z przejęcia kolejnych mniejszych dystrybutorów .	Orfe	2	Neut
Studiują tutaj Łukasz Kruczek , Grzegorz Śliwka , Krystian Długopolski , teraz obok mnie studentem został Tomek Pochwała .	Śliwka	6	Masc
Najlepiej to widać w zlewni Przemszy na Górnym Śląsku .	Przemszy	5	Fem
- Przyrzekniesz mi coś , Hunt .	Hunt	5	Masc
W zakładzie wszyscy współczują dyrektorowi Szwonderowi .	Szwonderowi	5	Masc
Adrian lubi sie uczyć .	Adrian	0	Masc
Starostwo katowickie zwraca się do Giesche SA , by bezdomnych pozostawić w spokoju .	Giesche	5	Neut
Przewodniczący Rady Państwa NRD Walter Ulbricht odwiedził Jugosławię .	Walter	4	Masc
Proszę uprzejmie , pan poseł Zbyszek Zaborowski z SLD .	Zaborowski	6	Masc
Żelazny kolos Żugajowi nie nabił nawet guza .	Żugajowi	2	Masc
Ale sam Gordon też się zmienił .	Gordon	2	Masc
Oprócz słuchania Steczkowskiej delegaci zajmowali się dyskusją o strajku generalnym .	Steczkowskiej	2	Fem
Kazimierz pobladł .	Kazimierz	0	Masc
Janina Michaluk leży w szpitalu w Gryficach .	Gryficach	6	Neut
Wczoraj w podobnych okolicznościach wpadł technik Wydziału Kryminalnego w Nowym Mieście Lubawskim .	Mieście	10	Neut
Tenisiści stołowi Energetyka Opoki Trzebinia znają już terminy spotkań barażowych o I ligę , w których ich rywalem będzie zwycięzca II ligi łódzko - świętokrzyskiej Start Brzezina .	Opoki	3	Fem
Nazywa się Golan Drozdeck .	Drozdeck	3	Masc
Wiem , że Duda cholernie jest pani wdzięczna za Draba .	Duda	3	Fem
Wardziński brał Santa Anę !	Anę	3	Masc
Gdy Cahirowi czupryna nieco mocniej przyschnie do czerepu , powędrujemy ku Toussaint .	Toussaint	11	Neut
Informacje na temat historii zen i różnych szkół znajdzie Czytelnik w chronologicznym zestawieniu najważniejszych wydarzeń z historii zen w Chinach i Japonii .	Japonii	21	Fem
- Małą miss została Klaudia Zdunek !	Klaudia	4	Fem
- Jaki los czeka Czeczenię ?	Czeczenię	4	Fem
Przypomnijmy , że 16 lipca 1994 r . dziadkowie półtorarocznej wówczas Moniki zostawili ją przed legnicką apteką pod opieką ojca , Roberta Bielawskiego .	Moniki	11	Fem
Długo machali rękami zostającemu na peronie Staszkowi Kuli .	Kuli	7	Masc
Sędziował Paweł Ochab z Dębicy .	Dębicy	4	Fem
W pobliżu granicy Kosowa z Albanią zginęło w walkach z serbskimi żołnierzami co najmniej ośmiu albańskich separatystów .	Kosowa	3	Neut
Ten biało - czarny kocur zdobył szturmem serca pracowników Downing Street , a z czasem jego sława rozprzestrzeniła się na cały kraj .	Downing	9	Fem
Dziś mieszka w Arkansas .	Arkansas	3	Neut
Zwiedzili także Warszawę .	Warszawę	2	Fem
Sam Misztal nie ukrywa , że chce zamknięcia dyskoteki .	Misztal	1	Masc
Reynevan odetchnął głęboko .	Reynevan	0	Masc
- Fred przeczuwał kłopoty .	Fred	1	Masc
Dratewkę pani Joasia wyrwała z bestialskich łap pewnego szewca , którego niech piekło pochłonie .	Joasia	2	Fem
Tak jak upiekło im się po Zatoce i Afganistanie .	Zatoce	6	Fem
Stacja Nędza wielokrotnie zmieniała swoją nazwę .	Nędza	1	Fem
Na scenie bez przerwy prezentowały się zespoły młodzieżowe z Reska , Szczecina , Polic i Wolina .	Polic	13	Neut
Wysunięta ręka Kołodzieja wyrwała go z zauroczenia .	Kołodzieja	2	Masc
Niemiecka liga hokeja należy do jednej z najlepszych lig w Europie .	Europie	10	Fem
Nieudanie tym razem skakał o tyczce Ukrainiec Siergiej Bubka .	Siergiej	7	Masc
Podporucznik Stryjek zamknął okno .	Stryjek	1	Masc
- Wybaczy pan , Profesorze . . .	Profesorze	4	Masc
Hill startował z pole position , ale już na pierwszych metrach wyprzedził go kolega z zespołu David Coulthard .	Coulthard	17	Masc
Pan Bielski pełni teraz publiczne funkcje . . .	Bielski	1	Masc
Natomiast Gorczyca pominął w ogóle sprawę milczeniem .	Gorczyca	1	Masc
Wtedy do akcji wkroczyli rodzice Marianny Czupinki .	Czupinki	6	Fem
Wraz z kadrą wyjadą Daria Kasperska , Paulina Rytwińska i Agnieszka Karcz .	Rytwińska	8	Fem
Było też paru oficerów z polskiej jednostki w Legnicy .	Legnicy	8	Fem
Biernacki może liczyć na poparcie polityków koalicji .	Biernacki	0	Masc
W Venezii Keneth ciągle leczył kontuzje , nie doszedł do formy .	Venezii	1	Fem
Prezydenci Polski , Ukrainy i Rumunii spotkali się na roboczych rozmowach w Bukareszcie .	Bukareszcie	12	Masc
W Czarnem umieszczono go w celi o zaostrzonym rygorze .	Czarnem	1	Neut
Halina Auderska we wszystkich książkach każe swoim bohaterom szukać tożsamości .	Auderska	1	Fem
Według KAI zaskarżenie ustawy do sądu zapowiedziała już organizacja American Civil Liberties Union .	Union	12	Fem
Rebecca Romijn - Stamos dzieli się z nami sekretami swojej urody .	Romijn	1	Fem
Solenizantki złożyły życzenia sąsiadującym z nimi w kalendarzu Ernestom i Bożenom .	Bożenom	10	Fem
- Chłopaka w beznadziejnym stanie przywieziono do Zabrza .	Zabrza	7	Neut
Kim są osoby z syndromem DDA ?	DDA	5	Neut
– no ja jestem Magda no .	Magda	4	Fem
Rosemarie siada .	Rosemarie	0	Fem
Co ś zrobił z babcią i Czerwonym Kapturkiem ?	Czerwonym	6	Masc
Wcześniej o ośmiu takich maturzystach informowała OKE w Łomży .	Łomży	8	Fem
Z jego zeznań wynika , że wczoraj około godziny 15 podjechał samochodem na ulicę Grażyńskiego .	Grażyńskiego	14	Masc
Nowość polegała na tym , że nauczyciele chrześcijańscy wykazywali , iż w osobie Jezusa Chrystusa wypełniły się wszystkie przepowiednie proroków .	Chrystusa	14	Masc
Może jesteśmy przeczuleni , ale nazwa sugeruje , że Uniqua unika płacenia odszkodowań .	Uniqua	9	Fem
Nie mam wyboru , pomyślał Tadeusz .	Tadeusz	5	Masc
W Europie firma posiada ponad 70 sklepów , głównie w Niemczech , Holandii , Luksemburgu .	Luksemburgu	14	Masc
Bracie Gęgaczu , rozchmurz swą fizys !	Gęgaczu	1	Masc
Wyzwanie rzuci mu senator Jacek Bachalski .	Jacek	4	Masc
Malwina spojrzała na niego z odrazą , Kulesza się zaczerwienił , ale Ewa , o dziwo , parsknęła śmiechem .	Ewa	12	Fem
Zginęło wielu ochotników z Wielkopolski , między nimi 68 uczniów gimnazjum w Trzemesznie .	Trzemesznie	12	Neut
Pod uniesionymi zasłonami rozległego łoża z trudem udało mu się dostrzec ginącą w powodzi koronek , pomarszczoną twarz pani Lamaire .	Lamaire	19	Fem
Tak jest w perfumerii na MDM .	MDM	5	Fem
Każdy w Breslau wie , że hrabina siedzi w tym obozie . . .	Breslau	2	Neut
Mimo że na koncie ma już osiem wyroków , nadal okrada turystów odwiedzających Kraków .	Kraków	13	Masc
Po odejściu Stasiaka w MSWiA będzie wakat .	MSWiA	4	Neut
Z czasem przeprowadzą się na Plewiska .	Plewiska	5	Neut
Pierwszym wojewodą zostaje były naczelnik Zakopanego , Lech Bafia .	Zakopanego	5	Neut
Mariola odstawiła torebkę na malutki stołeczek .	Mariola	0	Fem
– Modesta dotykała ust serwetką , ostrożnie , żeby nie rozmazać szminki .	Modesta	1	Fem
Spotkał Brońcię z białą kózką .	Brońcię	1	Fem
W godzinach wieczornych premier Cyrankiewicz przybył do Tuluzy .	Cyrankiewicz	4	Masc
– Ojciec Benedykt służył tutaj ?	Benedykt	2	Masc
W Netii taniej będzie jeszcze jutro przez cały dzień .	Netii	1	Fem
A teraz oddajemy głos naszej drogiej doktor Bernie .	Bernie	7	Fem
Do dziennikarki Beaty Igielskiej zatelefonowała któregoś dnia krewna , bardzo zresztą daleka .	Igielskiej	3	Fem
- Jaki los czeka Czeczenię ?	Czeczenię	4	Fem
Drgnęła na głos Mory .	Mory	3	Masc
W czwartkowe popołudnie gasili płonący śmietnik przy ul. Brodzińskiego w Proszowicach .	Brodzińskiego	8	Masc
Na tegorocznym inauguracyjnym balu tradycyjnego karnawału w Rio pracowały równolegle dwie komisje sędziowskie .	Rio	7	Neut
W pierwszej części obrad sekretarzami będą pani posłanka Zdzisława Kobylińska i pan poseł Mieczysław Jedoń .	Kobylińska	9	Fem
Pamiętał teraz także , że Rychezę polecili mu poniekąd margrabiowie .	Rychezę	5	Fem
Przy uśmiechu Giocondy , dyskretnym i tajemniczym , nikt nie zauważy szczerby z lewej strony .	Giocondy	2	Fem
Alona wybierała produkty ze straganów , a pan Jeffrey nosił za nią koszyk .	Alona	0	Fem
Czy nie było by prościej , gdyby śmy należeli do Tuplic ?	Tuplic	10	Neut
Zenek prosił kolegów , żeby nic nie mówili mamie , gdyby go przysypało .	Zenek	0	Masc
Wikipedia , nasz siostrzany projekt , zawiera artykuł na temat nawozów zielonych .	Wikipedia	0	Fem
Adasia ogarnął niepokój .	Adasia	0	Masc
Napisałaby więc z pewnością o Bali , co się stało w Kucie , tuż przy głównym deptaku .	Kucie	11	Neut
Zapewne dla wielu kobiet słowa Jana Pawła II są ważne i zbawienne , ale słowa nie wystarczą .	Pawła	6	Masc
Od 1996 w Ekstraklasie gra drużyna miejscowej Odry .	Odry	7	Fem
Również szefowie konkurencyjnych rolniczych związków zawodowych uważają , że Lepper zrobi wszystko , by doszło do konfrontacji rolników z policją .	Lepper	9	Masc
Zaangażowała się w Teatrze Dramatycznym kierowanym wówczas przez Gustawa Holoubka .	Gustawa	8	Masc
Proponuję Włosiaka .	Włosiaka	1	Masc
Ustalili śmy ze Stachem , że jeszcze trochę pociągnę pismo dla honoru domu i odejdę .	Stachem	3	Masc
Oglądała niedawno coś takiego na TVP Kultura .	TVP	5	Fem
Ale Hanka tylko się odwróciła .	Hanka	1	Fem
Który naród w Europie najbardziej kocha telefony komórkowe ?	Europie	3	Fem
Tylko dzięki temu Kamila się nie wykrwawiła .	Kamila	3	Fem
– akurat Kasi pasowała .	Kasi	2	Fem
W środę do Jana Kwiatkowskiego , wujka Adama , zadzwonili policjanci z sekcji kryminalnej w Legionowie .	Legionowie	15	Neut
Poparła przyjaciółkę Marychna .	Marychna	2	Fem
Z wnioskiem takim wystąpił naczelnik OSP Arkadiusz Pindral .	Arkadiusz	6	Masc
Rebecca Romijn - Stamos dzieli się z nami sekretami swojej urody .	Rebecca	0	Fem
Jego żona to Żydówka .	Żydówka	3	Fem
MPK prowadzi jeszcze rozmowy z wojskiem i PKP .	MPK	0	Neut
Zaczęła opowiadać o Marii .	Marii	3	Fem
Dziękuję Ci , Agnieszko .	Agnieszko	3	Fem
Gdyby wybory ukraińskie odbywały się w Polsce , zdecydowanie wygrałby Juszczenko .	Juszczenko	10	Masc
Nad Halberdą nie rozpiął parasola .	Halberdą	1	Masc
Ewa ma 50 lat , krótką sukienkę w kwiatki i złote serce .	Ewa	0	Fem
De Berle wątpił .	Berle	1	Masc
Krysia pociągnęła nosem i zaśmiała się .	Krysia	0	Fem
Hunt rozwinął z prawego przedramienia ledpad .	Hunt	0	Masc
- Mój ojciec pracuje w BRH , biurze radcy handlowego .	BRH	5	Neut
To najgorszy wstrząs sejsmiczny zarejestrowany w Kolumbii .	Kolumbii	6	Fem
Wypytywała rodaków o Warszawę , interesowała się przeżyciami Tomka w czasie wyprawy i nawet namawiała go usilnie , aby pozostał w Australii .	Australii	21	Fem
Gratulowali Adrianowi wyróżnienia .	Adrianowi	1	Masc
Stachurski i Janusz Olędzki zastąpili latem Janusza Lacha i Artura Mazurka .	Stachurski	0	Masc
Braliśmy udział w walkach o niepodległość Stanów Zjednoczonych Ameryki Południowej .	Ameryki	8	Fem
Wiece i akademie odbyły się również w Sofii , Damaszku , Kabulu , Surabai i innych miastach .	Kabulu	11	Masc
Przede wszystkim zdecydował wynik w Stanach .	Stanach	5	Neut
Janina Michaluk leży w szpitalu w Gryficach .	Janina	0	Fem
Do nich należeli niewątpliwie Mannerheim , Paasikivi i Tanner .	Paasikivi	6	Masc
Wielu partyjnych kolegów chętnie widziałoby go na stanowisku prezydenta Łodzi , ponieważ Marcisz ma opinię dobrego menadżera .	Marcisz	12	Masc
Większość skradziono w Berlinie , Hamburgu , Kilonii i Bremie .	Kilonii	7	Fem
TP SA chce złagodzić planowane redukcje .	SA	1	Fem
Położył rękę na ręce Tereski .	Tereski	4	Fem
Ja nawet premiera Oleksego lubię " .	Oleksego	3	Masc
Ale Rzeczpospolita jej nie potrzebuje . . .	Rzeczpospolita	1	Fem
Bandyci pobili Rosjanina i wyrzucili z samochodu na Pradze .	Rosjanina	2	Masc
tutaj obcięła m Ewelinę .	Ewelinę	3	Fem
Irenka także nie śpi .	Irenka	0	Fem
Spotkali się wzrokiem z Polkiem .	Polkiem	4	Masc
Premier Cyrankiewicz i Pierre Lauret wygłosili krótkie przemówienia .	Cyrankiewicz	1	Masc
Ajataka wzruszyła ramionami i pociągnęła mnie do windy .	Ajataka	0	Fem
W piątek życzenia od przedstawicieli władz miejskich , kolejowych i zaproszonych gości odebrał dyrektor ZSET Kazimierz Maćkowiak .	Maćkowiak	16	Masc
Pan lepiej wie , z kim się pan umówił przy Wolnicy .	Wolnicy	10	Fem
Z Lipusza trasa powiedzie ich dalej do Sulęczyna , Sierakowic , Mirachowa i Otomina .	Mirachowa	11	Neut
Trzymiesięczne owczarki niemieckie pochodzą z wyspecjalizowanej hodowli ze Słowacji .	Słowacji	8	Fem
- Jestem Nona .	Nona	2	Fem
Krystyna Kofta ogłosiła , że przyjmuje na siebie misję walki o równouprawnienie Bożen z Krystynami i za dwa lata zaprosiła panie do Trójmiasta , by równość tę udowodnić .	Trójmiasta	22	Neut
Wreszcie ruszył em do Wrocławia .	Wrocławia	4	Masc
Mieszka w Warszawie .	Warszawie	2	Fem
Wzdłuż płotu cmentarnego przy ul . Ku Słońcu ma się pojawić więcej drzew .	Słońcu	7	Neut
Panie ze Skarszew pełniły rolę obserwatorek .	Skarszew	2	Neut
Na terenie przyległym do Kolonii Wierzbicy znajdują się dwie garbarnie .	Kolonii	4	Fem
- Dziękuję panu posłowi Eugeniuszowi Janule .	Eugeniuszowi	4	Masc
Zawody będą rozgrywane na Dunajcu na odcinku od Krościenka do mostu w Gołkowicach .	Gołkowicach	12	Neut
Paul Broca , lekarz paryski , zachował mózgi swoich pierwszych pacjentów dla potomności .	Paul	0	Masc
Książę Andrzej Poniatowski , porucznik armii francuskiej , odwiedził Polskę w roku 1919 jako członek francuskiej misji wojskowej .	Polskę	9	Fem
O’Donellowie siedzieli przy ognisku .	O’Donellowie	0	Masc
Michel mógł jeszcze długo mówić o lunarnej symbolice srebra .	Michel	0	Masc
Zakup tego urządzenia pozwoli wykonywać podstawowe analizy na miejscu w Brzeziu , bez konieczności wyjazdu chorego do Gminnego Ośrodka w Kłaju .	Brzeziu	10	Neut
Po incydentach w meczu derbowym ukarali ście Cracovię zamknięciem stadionu na dwa mecze .	Cracovię	7	Fem
Modigliani budził w nim pewne zastrzeżenia .	Modigliani	0	Masc
Aneta pochodzi z domu byłych gospodarzy .	Aneta	0	Fem
Przemawiał pan poseł Czesław Pogoda .	Czesław	3	Masc
Wisła w Toruniu przekroczyła stan alarmowy o 80 cm , a wody wciąż przybywa .	Wisła	0	Fem
Dla pozostałych autobusów jadących w kierunku Śródki , dopuszczony zostanie przejazd ul . Estkowskiego .	Śródki	6	Fem
Tekst wyszedł spod srebrzystych parkerów Colina Rowe'a i Roberta Slutzky'ego .	Colina	5	Masc
Tusk też tak początkowo myślał lokalizując Muzeum Wojny na Westerplatte .	Westerplatte	9	Neut
Poszukiwała go policja z Gostynia za kilka innych przestępstw .	Gostynia	4	Masc
Brazylijczyk , dwukrotny zwycięzca wielkoszlemowego Roland Garros , podkreślał przed spotkaniem , że najważniejszym elementem piątkowej potyczki będzie skuteczna gra przy własnym serwisie .	Brazylijczyk	0	Masc
W styczniu radni Darłowa oficjalnie nadali swemu miastu miano królewskiego .	Darłowa	3	Neut
