My takiej nie prowadzimy , nie wykonujemy zadań publicznych dla zysku , ale dla dobra mieszkańców .	zysku	10	Masc
W pierwszych wiekach jego wyznawcy doznali okrutnych prześladowań .	prześladowań	7	Neut
- dodaje gen. Biel .	gen.	2	Masc
Do atrakcyjnej pani bosman podchodzi zniecierpliwiony wczasowicz .	bosman	3	Fem
Malwina spojrzała na niego z odrazą , Kulesza się zaczerwienił , ale Ewa , o dziwo , parsknęła śmiechem .	dziwo	15	Neut
Dawaliśmy mu złoto . . .	złoto	2	Neut
– Bywa , że rolnicy jeszcze przynoszą pisma .	rolnicy	4	Masc
Niektóre sprawy trafiły nawet do kolegium .	kolegium	5	Neut
Sołtys Ligoty Stanisław Kuźnik składa serdeczne podziękowanie wszystkim sponsorom , którzy przyczynili się do zorganizowania festynu i dzięki którym dzieci z Ligoty będą mogły pojechać na wycieczkę .	festynu	15	Masc
W niezwykłym spektaklu Partice'a Chfreau zabrakło głównej bohaterki .	bohaterki	7	Fem
- W iluż miastach w okresie letnim odbywa się tyle bezpłatnych występów artystycznych .	miastach	3	Neut
Najlepszy księgowy województwa śląskiego to rybniczanin .	województwa	2	Neut
Tymczasem korki paraliżują okolice ul . Saskiej , bo kierowcy , aby dostać się na Wał , muszą dojechać na niego wąskimi ulicami Saskiej Kępy .	Wał	15	Masc
- Zakłady i instytucje państwowe działają na podstawie decyzji urzędniczych .	instytucje	3	Fem
Coś notowali , robili fotografie .	fotografie	4	Fem
Aż trudno uwierzyć , że jeszcze kilkanaście dni temu ptaszki ćwierkały , że zostawi stację Waltera i przeniesie się do TVP .	ptaszki	9	Masc
Jego życie było wypełnione dążeniami do Dobra i Sprawiedliwości .	Dobra	6	Neut
Tamta urodziła dziecko z wielkim okiem pośrodku czoła .	okiem	5	Neut
Niewiele brakowało , by zaproponowała odstrzał niegrzecznych myśliwych polujących na kuropatwy .	kuropatwy	10	Fem
Poza wymienionymi , charakterystycznymi rodzajami przebiegu akumulacji w ciągu roku stwierdza się ich modyfikacje lub rodzaje pośrednie .	modyfikacje	13	Fem
Mogą jednak interweniować , gdy mają dowody przestępczej działalności .	dowody	6	Masc
MPK prowadzi jeszcze rozmowy z wojskiem i PKP .	wojskiem	5	Neut
To pierwszy sezon 11-letniego Jurka w amatorskiej lidze małopolskiej , a już wywalczył trzecie miejsce .	lidze	7	Fem
Tematyka prac twórcy z Jarantowic jest różnorodna i w poważnym stopniu zależy od zapotrzebowania , od zamówień odbiorców .	twórcy	2	Masc
W tych miastach znaczne wpływy zdobyła sobie wiara protestancka .	miastach	2	Neut
Przesłuchanie odbędzie się w poniedziałek .	Przesłuchanie	0	Neut
Prokuratura Okręgowa w Krakowie , która prowadzi śledztwo w sprawie wycieku testów w 2000 r . , potwierdziła , że sprzedawano testy w cenach od kilkuset złotych do 15 tysięcy .	testy	21	Masc
Skąd wzięto tyle szmalu ?	szmalu	3	Masc
I mimo chciwości cieszyli się w miasteczku dużym szacunkiem .	chciwości	2	Fem
Radni poruszyli problem złych nawierzchni dróg , domagając się ich remontu .	nawierzchni	4	Fem
Doroczny Bal Mody w salonach Hotelu Europejskiego zgromadził najpiękniejsze panie stolicy .	Mody	2	Fem
Przecież jestem najsławniejszym gliną Federacji " .	Federacji	4	Fem
- Z remontami kapitalnymi jest marnie .	remontami	2	Masc
Stanowczo odradza się naśladowanie ich przez turystów , ponieważ dla człowieka wejście na leżący na zboczu płat śniegu kończy się tragicznie .	zboczu	15	Neut
– Jeden z nich zaczął napierać na mnie ciałem .	ciałem	8	Neut
Ci oczywiście nie zrobili mu najmniejszej krzywdy , gdyż gość był szmalowny .	krzywdy	6	Fem
Nazwisko wyleciało z głowy .	Nazwisko	0	Neut
Za nic nie zrobię z siebie pajaca .	pajaca	6	Masc
Tego nie zastąpi żaden artykuł w gazecie czy debata w telewizji .	debata	8	Fem
Dziś już wiadomo , że powszechnie akceptowany na świecie jest model bazujący na podejściu bilansowym , koncepcji pełnej alokacji i metodzie zobowiązań .	podejściu	13	Neut
Przerwali terapię we Mstowie i w krótkim czasie zmarli z powodu narkotycznego przedawkowania .	przedawkowania	12	Neut
Czytanie jest u kalwinów powinnością religijną , obowiązkiem wierzącego .	kalwinów	3	Masc
Podczas ceremonii otwarcia Spływu organizatorzy przyznali liczne odznaczenia zasłużonym kajakarzom .	odznaczenia	7	Neut
Niedawno premier Pawlak sformułował publicznie , w specjalnym wystąpieniu telewizyjnym , swoje własne zastrzeżenia .	wystąpieniu	8	Neut
– Do dzisiaj , przez prawie półtora roku , nie występowaliśmy o nic .	półtora	6	Neut
To zwierzę wyróżnia się umiejętnością niesienia pomocy .	umiejętnością	4	Fem
Wargi nie pulsowały triumfującą czerwienią .	czerwienią	4	Fem
Poirytowani posłowie - projektodawcy sprawdzili te informacje .	posłowie	1	Masc
Uruchamiany system ma stać się zaczątkiem większego , obejmującego całą Wielkopolskę .	zaczątkiem	5	Masc
Za linią lasu błysnęła w słońcu blacha na wieży kościoła .	linią	1	Fem
Haberda patrzy na Gabrielę bez sympatii .	sympatii	5	Fem
W minionym tygodniu w Poznaniu dyskutowali o niej samorządowcy i przedstawiciele administracji rządowej województwa .	województwa	13	Neut
Nie dostawał przepustek .	przepustek	2	Fem
Jest mowa i o plastikach w paski na kurtki dla pocztów sztandarowych .	pocztów	10	Masc
W Egipcie sporo jest Polaków ; handlowców , inżynierów .	inżynierów	8	Masc
Petronakt nie zgodził się z umorzeniem i złożył na nie zażalenie .	umorzeniem	5	Neut
Czy nowa białoruska elita intelektualna jest już ukształtowana ?	elita	3	Fem
Pomagają okłady z rumianku .	okłady	1	Masc
Ustalono to na podstawie mutacji zachodzących w wirusie .	wirusie	7	Masc
Siano chrzęści w zębach wołów , słychać tylko chrupot i głębokie oddechy zwierząt .	zębach	3	Masc
Księgowe potwierdziły , że działały w porozumieniu z kilkoma członkami spółdzielni .	porozumieniu	6	Neut
Jak poinformował Cesar Fraga z Uniwersytetu w Buenos Aires , przeprowadzone tam badania wykazały , że czekolada wzmacnia antyutleniacze znajdujące się we krwi , zwiększając odporność na zaburzenia serca i naczyń wieńcowych .	zaburzenia	27	Neut
Pamiętam w Iveronie w sześciu gablotach stłoczone największe relikwie .	relikwie	8	Fem
Wprowadzenie rozwiązań proponowanych przez SLD prowadziło by do wynaradawiania .	Wprowadzenie	0	Neut
Przybysz ze Szwecji wyznał , iż od dawna interesuje się malarstwem .	malarstwem	10	Neut
Zwykły mieszkaniec kraju ma się leczyć ziołami , które zaleca tradycyjna medycyna koreańska .	ziołami	6	Neut
Dzięki archiwum zachowały się kopie .	archiwum	1	Neut
Wśród poplenerowych prac królują grafiki i szkice .	szkice	6	Masc
Jest najwyższym mężczyzną w oddziałach Agencji Restrukturyzacji i Modernizacji Rolnictwa w Polsce .	mężczyzną	2	Masc
Pan asesor zamilkł i więcej już do końca sądu nie otworzył ust swoich .	asesor	1	Masc
Malarz uspokoił się .	Malarz	0	Masc
Nie wykluczył zwolnień .	zwolnień	2	Neut
Sklejka , która była tegorocznym pewniakiem do prywatyzacji , nie ma żadnego szefa .	pewniakiem	5	Masc
Miał oczy przymknięte , blada twarz była bez wyrazu , jakby zabierał się do wysłuchania banalnej spowiedzi .	wysłuchania	14	Neut
Rozumiem twoją żałość , Mikołaju . . .	żałość	2	Fem
W ZUS nie ukrywają , że lekarzom trudno udowodnić , iż nadużywają swych kompetencji .	kompetencji	13	Fem
Sprzedaż monti i stanowisk nie pokrywała chronicznego deficytu .	monti	1	Masc
Chodzi przede wszystkim o obniżenie funduszy strukturalnych i 25-procentowy wyjściowy poziom dopłat dla rolników .	obniżenie	4	Neut
Zmarł w klinice onkologicznej w Warszawie .	klinice	2	Fem
Reagując na stan zaspokojenia tych potrzeb , przeżywa emocje .	zaspokojenia	3	Neut
Uszanowanie i respekt przed Bogiem są bardzo mocno zaakcentowane w doświadczeniu proroków .	Uszanowanie	0	Neut
- Mów że składniej , frater !	frater	5	Masc
Poczta zmniejsza swój deficyt i już w 1997 r. powinna zacząć przynosić zyski .	deficyt	3	Masc
Wczoraj , po zamknięciu lokali wyborczych , niemieckie media zapowiedziały , że pani minister ustąpi ze stanowiska .	zamknięciu	3	Neut
Milicjant i ratownik zaczynają od powrzaskiwań i epitetów .	powrzaskiwań	5	Neut
Równie dobrze mógł by m być chyba biologiem , geometrą .	geometrą	9	Masc
Na parę minut przedtem Roman przyszedł do bufetu z pustym koszykiem do bułek .	bufetu	7	Masc
Ich przedstawiciele , służąc w Gwardii Szlacheckiej , dodawali splendoru Stolicy Piotrowej , a jednocześnie znajdowali tam niejednokrotnie środki dla wygodnego życia , ponieważ za swą służbę otrzymywali pensje .	splendoru	9	Masc
Policjanci odpowiedzieli strzałami .	strzałami	2	Masc
Po ostrej wymianie zdań chłopak wszedł do środka , niestety nie zdążył już niczego zamówić .	zdań	3	Neut
W dziesięciu wsiach przybyło 424 nowych abonentów .	abonentów	6	Masc
Ale płód nie jest dzieckiem .	płód	1	Masc
Krzysztof postanowił dorzucić do maila trochę autentyzmu .	maila	4	Masc
Dziesięciu jeźdźców pokonuje trasę z Torunia do Pucka .	trasę	3	Fem
Wzdłuż kamiennej podmurówki obszedł dom wokoło .	podmurówki	2	Fem
Mój Piotrek uchodzi za speca w dziedzinie drewnianego budownictwa na Podhalu .	budownictwa	8	Neut
Kobieta obracała karty z cichym szelestem .	szelestem	5	Masc
Opony delahaye jednostajnie szumią po asfalcie .	Opony	0	Fem
Hodowla owiec jest do dzisiaj jedną z głównych gałęzi gospodarki tych nadal słabo zaludnionych rejonów .	gospodarki	9	Fem
Od tego czasu sprawa czekała na wyznaczenie terminu .	wyznaczenie	6	Neut
W sobotę podporucznik Ziemba przeniósł swoje łóżko do kuchni , rowery wstawiono do pokoju podporucznika Kowalika .	podporucznika	14	Masc
Pierwszy numer wyjdzie przed świętami .	świętami	4	Neut
Towarzysz jego wzywał Jezusa i jego Matkę , a tacy ludzie jak Esteban wołają te słowa tylko twarzą w twarz ze śmiercią .	Towarzysz	0	Masc
W czasie pozorowanych działań bojowych jednostki z pozycji obronnych dokonają przegrupowania , aby po sforsowaniu szerokiej przeszkody wodnej wyjść na nowe rubieże aktywnych działań zaczepnych .	sforsowaniu	14	Neut
- Znowu zajmujesz się jakimś morderstwem ?	morderstwem	5	Neut
Orkiestry murzyńskie grają ragtime'y , tłum cheerleaderek tworzy radosny , falujący szpaler .	ragtime'y	3	Masc
Mężczyźni po pierwszej łyżce wstali od stołu .	łyżce	3	Fem
Nie żyje już Kunz Aulock ani nikt z jego kompanii .	kompanii	9	Fem
Zauważono też nagminne zaniżanie zarobków pracowników za dni urlopowe lub chorobowe .	zarobków	4	Masc
W depresjach organicznych chory często czuje się zagubiony , bezradny , opuszczony i samotny .	depresjach	1	Fem
Działo się to podczas dochodzenia do nabrzeża w Ystad .	nabrzeża	6	Neut
W opinii BCC dzięki kompromisowi politycznemu , którego zwolennikiem był ekspremier , Polska jest obecnie gospodarczym tygrysem Europy Środkowo - Wschodniej .	tygrysem	16	Masc
Brytyjczycy są więc dominującym udziałowcem w największym polskim towarzystwie emerytalnym .	towarzystwie	8	Neut
Marek mógł by doznać szoku .	szoku	4	Masc
Jednak sam chipset nie stanowi jeszcze o atrakcyjności danej płyty dla użytkownika .	chipset	2	Masc
Skazał go na wiele niepotrzebnych cierpień .	cierpień	5	Neut
Następnie podgrzewamy i przesączamy przez gęste sito .	sito	6	Neut
– i takie akordeony kupują zawodowi akordeoniści ?	akordeoniści	6	Masc
Ale poczucie krzywdy i duma były silniejsze niż zdrowy rozsądek .	krzywdy	2	Fem
Wojewódzki Inspektorat IH był pierwszym w Polsce , który jeszcze na podstawie starych przepisów zawarł porozumienie z Polskim Towarzystwem Towaroznawczym .	Towarzystwem	18	Neut
Uroczysta msza święta w intencji reprezentacji Polski w piłce nożnej została odprawiona w piątek w Kazimierzu Dolnym .	intencji	4	Fem
W takich warunkach wielu duchownych decydowało się na organizowanie katakumbowego życia religijnego .	organizowanie	8	Neut
Dziewczynę bolało kolano .	Dziewczynę	0	Fem
Słucham i uszom nie dowierzam .	uszom	2	Neut
Wyniki badań nad wszystkimi 13 właściwościami doskonale ilustruje przejrzysty wykres na 165 stronie książki .	właściwościami	5	Fem
Biedny ptak , z szeroko otwartym dziobem , zwisał głową w dół , niby ułamana z krzewu kiść .	ptak	1	Masc
Chciał by być teraz w namiocie , oddzielony od wszystkiego .	namiocie	5	Masc
– to zero .	zero	2	Neut
Doświadczenie zawodowe zdobyła pracując w teatrze i telewizji w Polsce i na Ukrainie .	Doświadczenie	0	Neut
Zawrzały dusze , serca i umysły .	dusze	1	Fem
Trzeszczą cekaemy i tną powietrze .	powietrze	4	Neut
Wystarczy zwisający kabel od czajnika elektrycznego .	kabel	2	Masc
Dżabie chrupnęło w kościach .	kościach	3	Fem
Krzyczy na mnie tylko trochę , kiedy się biję ze starszym bratem .	bratem	11	Masc
Więc może odpolitycznić ten sport ?	sport	4	Masc
Wszyscy używają żabek do firanek .	żabek	2	Fem
Załamała się tradycja zbiorowych wystąpień i manifestacji .	tradycja	2	Fem
Trzeba pousuwać z działek stojącą wodę i uporządkować strychy oraz piwnice .	działek	3	Fem
Teraz kmieci zamieniono w niewolników .	kmieci	1	Masc
To nie jest coś , co było moim celem .	celem	8	Masc
Coraz częściej spotykamy się z tragedią samobójstw .	samobójstw	6	Neut
U nas takie imprezy są zupełną nowością , ale na Zachodzie to bardzo popularna dyscyplina .	nowością	6	Fem
To jakiś dziwak albo pomylony .	dziwak	2	Masc
Kiedy rysuje , odlewa wielkie postaci w brązie i tworzy delikatne maski z żywicy , nigdy nie zatrzymuje się na jednym egzemplarzu .	brązie	7	Masc
Ibsen zamieniał z żoną kilka wyrazów jedynie w wigilię i urodziny .	żoną	3	Fem
Z Karolem weszli śmy w ścisłą sztamę w podchorążówce .	sztamę	6	Fem
Na bezdomne po Powstaniu Warszawskim dwie głośne pisarki czekały w Łodzi zarezerwowane dla nich mieszkania .	Powstaniu	3	Neut
Choinka mieni się różnobarwnie , z bożonarodzeniowego bierwiona w kominku bije przytulne ciepło .	bierwiona	7	Neut
Skończył technikum budowlane , klasę konstrukcji stolarskich .	technikum	1	Neut
Wraz z kolejnymi minutami potrawa zmieniała się z płynnej w coraz bardziej stałą .	potrawa	4	Fem
Niezależnie od przedstawionych wyników , kontrolę przeprowadzą jeszcze policjanci z Komendy Wojewódzkiej Policji w Katowicach .	Komendy	10	Fem
- Czy w Sejmie powstaje koalicja wszystkich partii przeciw Prawu i Sprawiedliwości ?	Sprawiedliwości	11	Fem
Dziecko utopiło się w żwirowisku w okolicach Wrocławia .	Dziecko	0	Neut
Żelazny kolos Żugajowi nie nabił nawet guza .	guza	6	Masc
Przekazał policjantowi dziewczynę i popłynął do brzegu .	policjantowi	1	Masc
Jak stawiać granice dzieciom z FAS ?	dzieciom	3	Neut
Pod władzą nowego proboszcza rozpoczęła się reforma skostniałej kościelnej instytucji .	proboszcza	3	Masc
Poprawkę skrytykował już dyrektor wykonawczy Światowego Kongresu Żydów Elan Steinberg .	Poprawkę	0	Fem
Dębski z przyjemnością zapadł w kąt kanapy .	kanapy	6	Fem
Przez tydzień włóczył się bez celu po Melbourne , wyczekiwał na rozkazy .	rozkazy	11	Masc
Horti 2000 to także okazja do zapoznania się z najnowocześniejszymi sprzętami ogrodowymi , niezbędnymi nawozami , które sprawiają , ze nasza działka będzie obiektem zachwytu .	obiektem	23	Masc
W jego głosie Kloss usłyszał wahanie .	wahanie	5	Neut
Zatrzymał potop .	potop	1	Masc
Dotknął wilgotnego ręcznika w łazience , pogładził mięsistą połę szlafroka , powąchał mydło w cedrowej kasetce .	mydło	12	Neut
Ale dla mnie nie ma różnicy między Włochem , Polakiem czy Węgrem .	różnicy	5	Fem
Czasem wraca jakieś niezłe szyderstwo Wojtasa .	szyderstwo	4	Neut
Ale kłamstwa się wydały .	kłamstwa	1	Neut
Kadencja rady potrwa do 2007 r.	Kadencja	0	Fem
Z jego zeznań wynika , że wczoraj około godziny 15 podjechał samochodem na ulicę Grażyńskiego .	zeznań	2	Neut
- To sprawiło by waszemu nauczycielowi dużą przyjemność .	nauczycielowi	5	Masc
Gazety o nim piszą .	Gazety	0	Fem
Skórkę zostawia się na talerzu .	Skórkę	0	Fem
– Zamierzam rozmawiać i dzielę się z panią różnymi wrażeniami .	wrażeniami	9	Neut
Napastnicy grozili nastolatkom , że ich pobiją .	nastolatkom	2	Masc
Po utrwaleniu ich w formalinie przekazał je do muzeum w Paryżu .	utrwaleniu	1	Neut
- A kto by tam mierzył kawałki ? . . .	kawałki	6	Masc
Nowa kamera Canona automatycznie ustawia wszystkie parametry nagrywania , bardziej ambitnym użytkownikom pozwala jednak samodzielnie kontrolować ostrość obrazu i ekspozycję .	ekspozycję	19	Fem
Poczęstowano nas kawą , a nie wódą .	wódą	6	Fem
Od poniedziałku toczyły się walki o jego odbicie .	poniedziałku	1	Masc
- Mleko już się rozlało .	Mleko	1	Neut
Partie polityczne oraz reprezentujący ich politycy stanęli w wyborcze szranki .	szranki	9	Neut
w głębi duszy tłumisz pragnienie ucieczki od samej siebie .	głębi	1	Fem
Inwestycję wznowiono w połowie 2004 roku , a wartość zadania wynosi 5,6 miliona złotych .	Inwestycję	0	Fem
Oprócz słuchania Steczkowskiej delegaci zajmowali się dyskusją o strajku generalnym .	słuchania	1	Neut
Zagrać kawalerowi ?	kawalerowi	1	Masc
Miejsca rozgrywania spotkań zostały ustalone w drodze losowania w siedzibie Polskiego Związku Tenisa Stołowego w Warszawie .	Miejsca	0	Neut
Miał em je pobierać w miesięcznych ratach .	ratach	6	Fem
Miasto otuliła mgła .	mgła	2	Fem
Dzięki poradnikowi dowiadujemy się , że roczną deklarację oznaczają cyfry 01 .	01	10	Neut
Czy jednak tak jest i czy podjęcie zatrudnienia przywróci wewnętrzny spokój ?	podjęcie	6	Neut
Po drugie , wkraczali śmy na wyjątkowo niewdzięczny teren .	teren	8	Masc
Ponadto zastosował środek zapobiegawczy w postaci zakazu opuszczania kraju , zawieszenia w czynnościach służbowych oraz poręczenie majątkowe w wysokości 10 tys . zł .	poręczenie	15	Neut
Miłość nie jest nadopiekuńczością .	nadopiekuńczością	3	Fem
Miasto Detroit do tej pory płonie , a wyjątkowo upalna pogoda sprzyja rozszerzaniu się pożarów .	rozszerzaniu	12	Neut
Luksusowego forda explorera nieznani sprawcy skradli wczoraj w Warszawie generałowi rosyjskiej milicji .	generałowi	9	Masc
Kontrolerzy nie wzięli pogróżek poważnie , bo wiedzieli z doświadczenia , że w podobnej sytuacji prawie każdy podatnik powołuje się na możnego protektora . . .	pogróżek	3	Fem
– Ma Pan już hasło wyborcze i pomysł na kampanię ?	hasło	4	Neut
- Jakie znaczenie dla śledztwa ma odkrycie dokonane w archiwach w Łomży , o którym niedawno poinformowała prof . Daria Nałęcz ?	odkrycie	6	Neut
Biznesmena Roku wybierano na Pomorzu już po raz szósty .	Biznesmena	0	Masc
Drzwi uchyliły się z lekkim skrzypieniem nie naoliwionych zawiasów .	skrzypieniem	5	Neut
Sprawiłoby to , że Radzie Bezpieczeństwa znacznie trudniej byłoby podjąć niezbędne decyzje .	decyzje	11	Fem
Aby pomóc przewodnikom w sporządzeniu spisu potrzebnych rzeczy , podajemy przykładowe zestawy sprzętu dla poszczególnych działów prac na kolonii .	sprzętu	12	Masc
Dlatego ceni się sumienność , odpowiedzialność , perspektywiczne myślenie .	myślenie	8	Neut
Iluż poważnych obecnie pisarzy czytało swe pierwsze próby literackie w sali przy Krupniczej , siedząc wokół dębowych stołów zsuniętych pośrodku .	stołów	17	Masc
Duże kontrowersje wzbudził zapis wywalczony przez Związek Nauczycielstwa Polskiego .	Nauczycielstwa	7	Neut
Neandertalczycy żyli w Europie dwieście tysięcy lat .	Neandertalczycy	0	Masc
Megane oddał synowi , pracownikowi dydaktycznemu warszawskiej uczelni .	Megane	0	Neut
W samej końcówce rozpaczliwe broniliśmy się i naprawdę radomianie napędzili nam wielkiego stracha .	stracha	12	Masc
Wspominają wspólne biesiadowanie .	biesiadowanie	2	Neut
Taki czek nie może być bezpośrednio zamieniony na gotówkę .	czek	1	Masc
Turkowska mleczarnia od dłuższego czasu ma problemy finansowe .	mleczarnia	1	Fem
Nie złożyłem podpisu pod wnioskiem o wotum nieufności skierowanym do marszałka Sejmu .	nieufności	7	Fem
Umyślił teraz opowiedzieć to zdarzenie choremu wnuczkowi .	zdarzenie	4	Neut
Pojawiła się nawet sama prezes Urzędu Mieszkalnictwa Barbara Blida .	Urzędu	5	Masc
Pannę Wiosnę rozpiera młodzieńcza energia .	energia	4	Fem
Wziąłeś slipki ?	slipki	1	Neut
Podręczniki powinny uwzględniać zasadę równych praw kobiet i mężczyzn .	zasadę	3	Fem
- Stara ogrodnicza prawda mówi , że każdemu drzewu i krzewowi przycięcie zrobi dobrze .	przycięcie	11	Neut
Chodzę w czarnych okularach nawet w pochmurne dni .	okularach	3	Neut
Załamała się tradycja zbiorowych wystąpień i manifestacji .	tradycja	2	Fem
Bardzo często , kiedy był em wściekły i napięty , wypijał em na rozluźnienie piwko czy setkę .	rozluźnienie	13	Neut
W stanie obrzydzenia przyprawiającego o nowe mdłości nie zauważył nawet , że wielki ból zaczyna z wolna zanikać .	mdłości	6	Neut
Pokrzepiła mnie tym na duchu .	duchu	4	Masc
Jego usuwaniem zajęli się strażacy ze specjalistycznym sprzętem .	usuwaniem	1	Neut
Oczywiście , to było konstruktywne myślenie .	myślenie	5	Neut
W niedzielę rano odprawiono z okazji rocznicy śmierci kompozytora msze święte w kościołach sióstr Wizytek i św . Krzyża , gdzie spoczywa serce Chopina .	serce	22	Neut
I w Ławrze palił em świeczki cienkie jak włos . . .	włos	8	Masc
Zanieczyszczenia cytoplazmatyczne i błonowe są również groźne , stanowiąc prawdopodobne źródło zarówno aktywności proteolitycznej , jak i białek cytoplazmatycznych w puli niehistonowej .	Zanieczyszczenia	0	Neut
Proponuje za to referendum w sprawie przekształcenia AWS w jedną partię .	przekształcenia	6	Neut
Potępiamy prezydenta Kaczyńskiego za podłość .	podłość	4	Fem
Godzinami , chmurni , łazili po mieście , ciągała go po galeriach , muzeach , teatrach .	galeriach	11	Fem
Jeden z mężczyzn przystąpił do majstrowania przy kablach telefonicznych .	kablach	7	Masc
Kilka dni po ukazaniu się ogłoszenia telefon dzwonił 24 godziny na dobę .	dobę	11	Fem
Był ostro atakowany przez endecję .	endecję	4	Fem
Nadmieniamy , że w pierwszą niedzielę lutego br . przeprowadzono zbiórkę pieniędzy na zakup niezbędnego urządzenia medycznego do pracowni analitycznej w Wiejskim Ośrodku Zdrowia w Brzeziu .	lutego	6	Masc
Cała nadzieja na przerwanie szaleństwa tworzenia urzędów centralnych tkwi w prezydencie .	nadzieja	1	Fem
- Blondynka popatrzyła na tancerzy , którzy przy bufecie głośno rozmawiali z właścicielem knajpy .	tancerzy	4	Masc
Oczywiście , to było konstruktywne myślenie .	myślenie	5	Neut
Tak już chyba na serio nie mówimy , a nasz cyniczny wiek jakąś aurę śmieszności wokół słowa zbudował .	aurę	13	Fem
W czwartek Prokuratura Okręgowa w Warszawie skierowała do sądu wniosek o aresztowanie .	aresztowanie	11	Neut
Pod tą opinią z raportu organizacji katolickich podpisałyby się obiema rękami także feministki .	rękami	10	Fem
Pojawia się w niej panna Jane Marple , detektyw - amator .	detektyw	8	Masc
Według jego oceny niezbędne będą dalsze spotkania przed podpisaniem porozumienia .	podpisaniem	8	Neut
Lekcja kończy się rozczarowaniem , ale mistrz wydaje się daleki od rezygnacji .	rozczarowaniem	3	Neut
Ewa ma klucze .	klucze	2	Masc
Szereg takich poleceń składałby się na całą procedurę , którą urządzenie byłoby sterowane .	poleceń	2	Neut
Na tegorocznym inauguracyjnym balu tradycyjnego karnawału w Rio pracowały równolegle dwie komisje sędziowskie .	balu	3	Masc
W początkach następnego tysiąclecia jej ruiny pokrył śmietnik .	początkach	1	Masc
Tu latają cyklony , podejdą wyżej , będzie wiało od wyżu .	wyżu	10	Masc
Zapalono wszystkie lampy , ustawiono ruchome wieszadła , kelnerzy w oczekiwaniu gości spacerowali po korytarzach hotelowych .	wieszadła	6	Neut
Nie chcesz łykać lewej gorzały ?	gorzały	4	Fem
- Posiada osobowość prawną .	osobowość	2	Fem
W deklaracji żądają , by prezydent złożył dymisję .	deklaracji	1	Fem
Tymczasem w liceach prowadzonych przez Społeczne Towarzystwo Oświatowe zdanie egzaminu dojrzałości nie należy do najłatwiejszych .	liceach	2	Neut
Dochodzą niepokojące sygnały dotyczące prywatyzacji stoczni .	sygnały	2	Masc
- Zgromadziliśmy tu najstarsze i najładniejsze kostiumy .	kostiumy	6	Masc
Po 20 minutach helikopter ląduje na dachu szpitala .	helikopter	3	Masc
W związku z wyrażonym wotum nieufności , Ponikowski w imieniu całego gabinetu poprosił o dymisję , która została przyjęta .	dymisję	14	Fem
- Dobre prognozy są trudniejsze do sformułowania ?	prognozy	2	Fem
Jest sobie system języka i teksty tego języka .	teksty	5	Masc
Magazyn pozwoli firmie na zaspokojenie potrzeb rynku poprzez zapewnienie odpowiednich zapasów ogumienia .	Magazyn	0	Masc
Powrót odbywa się w tempie przyspieszonym .	Powrót	0	Masc
Przykręca knot i dmucha w płomień lampy .	knot	1	Masc
Finansowo wspiera Trutnia Gminny Ośrodek Kultury w Rabie Wyżnej , a także skawiańscy biznesmeni z Polski i Chicago .	Kultury	5	Fem
" Obywatelu Bukowiński , proponujemy wam repatriację do Polskiej Republiki Ludowej " .	Obywatelu	1	Masc
- Wrogowie czyhają na nasze ziemie !	ziemie	5	Fem
Naszym zadaniem było jedynie znalezienie i wyremontowanie pomieszczenia .	znalezienie	4	Neut
To informacja poprzedzona chrząknięciem , ściszeniem głosu , podana jakby mimochodem .	ściszeniem	5	Neut
Warszawski Indeks Giełdowy zyskał 5 procent , a WIG20 , indeks największych spółek na parkiecie , wzrósł o 6,1 procent .	parkiecie	14	Masc
Starym kawalerem zostanie i następcy zabraknie , tradycja garncarska w rodzinie Kraszewskich zaginie . . .	kawalerem	1	Masc
Muszę przyznać , że troszkę pogubił em się w tych wszystkich liczbach i datach .	liczbach	11	Fem
Wyszliśmy na dwór , a potem kroczyliśmy smutno ulicą Wolności , obok naszej piekarni , naszego fryzjera , naszej apteki .	fryzjera	16	Masc
Wykop i południowe baraki są w jednej linii .	Wykop	0	Masc
Rozbili śmy na jezdni dwa świeże jaja .	jezdni	3	Fem
Ale bycie symbolem nie jest wcale zajęciem lukratywnym .	bycie	1	Neut
Ceną za to opóźnienie okazał się udział w rynku francuskim .	Ceną	0	Fem
Jeśli spojrzymy na inicjatywę polityczną liderów pierwszej dziesiątki , to okaże się , że aż szóstka zaczynała swą karierę w PZPR .	szóstka	15	Fem
- Ale mogę zostawić swoje nauszniki .	nauszniki	5	Masc
Dodatkowym zabezpieczeniem będzie unikanie kwiatowych deseni .	unikanie	3	Neut
Niebacznie stanął pod nawisem , oberwało się i przywaliło .	nawisem	3	Masc
Dziś już wiadomo , że powszechnie akceptowany na świecie jest model bazujący na podejściu bilansowym , koncepcji pełnej alokacji i metodzie zobowiązań .	zobowiązań	21	Neut
Zdarza się , że ich sprawcy z powodu przedawnienia w ogóle nie zostają osądzeni .	przedawnienia	8	Neut
- Liczne przykłady coraz bardziej wyrafinowanych działań terrorystycznych na świecie uświadamiają społeczeństwu potrzebę ochrony przed tego typu zagrożeniami .	potrzebę	12	Fem
Czyżby jakieś złe moce zawisły nie tylko nad publicznymi mediami , ale również nad Warszawiakami ?	mediami	9	Neut
Cały ten materiał mam w małym palcu .	materiał	2	Masc
Chłopczyk z miejsca się budzi .	Chłopczyk	0	Masc
Wystawa w Tel Awiwie przyciągnęła ponad 5 tysięcy zwiedzających , pokazano ją we wszystkich izraelskich telewizjach , pisały o niej wszystkie gazety .	telewizjach	15	Fem
Dlaczego euro przez ostatnie trzy miesiące wbrew prognozom osłabło ?	euro	1	Neut
Piotr A . bije go pięścią , a jego kompan Piotr G . kopie w tył głowy .	pięścią	5	Fem
Na tych przejazdach woda była płytka , ale dno piaszczyste nie groziło uszkodzeniem łodzi .	uszkodzeniem	12	Neut
Z przykrością stwierdzam , że zawiera on nieprawdziwe informacje .	przykrością	1	Fem
Marta poczuła ukłucie .	ukłucie	2	Neut
Hotel został otoczony .	Hotel	0	Masc
Teraz czuł się jakoś raźniej , przygnębienie trochę minęło .	przygnębienie	6	Neut
W ostatniej sekundzie uniknął zderzenia z mercedesem .	zderzenia	4	Neut
Konsorcjum umożliwiło by wspólne finansowanie inwestycji .	finansowanie	4	Neut
Związkowcy podkreślili jednak , że mają gwarancje ministra w sprawie modelu PKP i przyszłych przekształceń kolei oraz dalszych rozmów z nimi .	gwarancje	6	Fem
Olimpijskie szaleństwo na dobre opanowało media .	szaleństwo	1	Neut
Płacimy i idziemy na dworzec .	dworzec	4	Masc
Określeniu daty sprzeciwiały się otwarcie Francja , Hiszpania i Finlandia .	daty	1	Fem
Zbliżone są też poglądy obu środowisk na prostytucję .	prostytucję	7	Fem
W czwartek do egzaminu ustnego z historii przystąpiło 94 maturzystów , w piątek natomiast 59 miłośników biologii popisywało się wiedzą z tej dziedziny .	wiedzą	19	Fem
Ludzie podchodzili do okien i wpatrywali się w niebo .	okien	3	Neut
Niedźwiedź broniąc się przed napastnikiem uciekł na drzewo .	drzewo	7	Neut
Widzę na tej rycinie stojącą po lewej stronie grupkę ludzi ubranych w proste , długie szaty , którzy wskazują palcem na człowieka pogrążonego w przyjacielskiej pogawędce z diabłem .	grupkę	8	Fem
Ale sposobu na usmażenie mózgu ode mnie nie dostaniesz .	usmażenie	3	Neut
Doszło do kraksy .	kraksy	2	Fem
Na weselu bawiło się prawie 150 gości .	weselu	1	Neut
Zarzucił mu Pan , że utrwala sejmokrację .	sejmokrację	6	Fem
W dusznej od papierosowego dymu izbie tłoczono się okropnie .	dymu	4	Masc
Bobu zadać !	Bobu	0	Masc
Doświadczenia z dzieciństwa spędzonego w rodzinie alkoholowej u wielu mężczyzn i kobiet owocują w dorosłym życiu utrwalonymi schematami odczuwania , zachowania i myślenia .	dzieciństwa	2	Neut
Otwarcie granic nie poprawiło sytuacji plantatorów .	plantatorów	5	Masc
Minuty ciągną się niemiłosiernie długo .	Minuty	0	Fem
Co ty możesz wiedzieć o głodzie , chłodzie i bezdomności ?	głodzie	5	Masc
Na polach Domatowa i Polchowa usypano wysokie mogiły .	mogiły	7	Fem
Na tych przejazdach woda była płytka , ale dno piaszczyste nie groziło uszkodzeniem łodzi .	dno	8	Neut
Teraz zrobi się podpory i będzie .	podpory	3	Fem
I kamera pokazuje go w panterce , na froncie w Bośni .	froncie	8	Masc
Obie też towarzyszyły swoim synom na uroczystości wręczenia stypendiów w Pałacu Prezydenckim .	wręczenia	7	Neut
Taboret upadł z dramatycznym łoskotem , a on , wierzgając nogami , zawisł niczym gotowy do wypatroszenia wieprz .	wypatroszenia	16	Neut
Tam nawiązuje kontakt z grupą partyzancką o zabarwieniu skrajnym , likwidującą komunistów i uciekinierów z gett .	gett	15	Neut
Kilka osób spytało mnie , czy jestem dzięki feminizmowi szczęśliwsza .	feminizmowi	8	Masc
Według KPN budżet państwa traci na [import]cie paliw , a zasady koncesjonowania są niejasne .	koncesjonowania	11	Neut
Miłość nie jest potrzebą .	potrzebą	3	Fem
Niemcy byli faworytami sztafet .	sztafet	3	Fem
Nie wspominajcie o ojczyźnie , jej mitach i tradycjach .	mitach	6	Masc
Właściwie tylko Białostockie Przedsiębiorstwo Budownictwa Przemysłowego posiada laboratorium z prawdziwego zdarzenia .	Przedsiębiorstwo	3	Neut
Na ścianach wisiały pamiątkowe fotografie i adresy gratulacyjne .	fotografie	4	Fem
Budowę murów aureliańskich rozpoczęto w 271 roku .	Budowę	0	Fem
Był z żoną , Wandą .	żoną	2	Fem
Gagosian nadal milczał , siedząc za biurkiem na swój sztywny sposób .	biurkiem	6	Neut
Zaraz potem , bez żadnych ceregieli , skoczyła Filomena .	ceregieli	5	Neut
W pierwszych wiekach jego wyznawcy doznali okrutnych prześladowań .	prześladowań	7	Neut
Megane oddał synowi , pracownikowi dydaktycznemu warszawskiej uczelni .	Megane	0	Neut
Denver został założony w 1858 roku i był wielkim centrum górnictwa złota i srebra ; w II połowie XIX wieku powstało Muzeum Sztuki z kolekcją sztuki Indian .	górnictwa	10	Neut
Wyróżniał się licznymi szybami górniczymi , kryjącymi w swych wnętrzach wieże wyciągowe i windy do przewozu ludzi i węgla .	szybami	3	Masc
Olbrzymy zazwyczaj są barwy czerwonej .	barwy	3	Fem
W rogu pokoju skrzypią klepki podłogi .	klepki	4	Fem
Jednocześnie następują dynamiczne , ale dostosowane do realiów społecznych i kapitałowych przekształcenia własnościowe .	przekształcenia	11	Neut
" Zła organizacja pracy powoduje przede wszystkim brak prawidłowej i dobrej kontroli przełożonych nad podwładnymi " .	przełożonych	12	Masc
Ojciec zdmuchnął świece w latarniach , przykucnął za plecami syna .	latarniach	4	Fem
Złożoność biografii Wilhelma bez wątpienia nie stanowiła tajemnicy dla jego współczesnych .	Złożoność	0	Fem
Grób Pikusia i Miśka rozświetlają znicze .	znicze	5	Masc
Niemal od razu pojawiła się przed kamerami .	kamerami	6	Fem
to jest jagoda .	jagoda	2	Fem
Okazuje się , że właściciel mieszka za siatką .	właściciel	4	Masc
- Langer z grubasami popychał dziennikarską brać do wyjścia .	grubasami	3	Masc
Skojarzenia nie biorą się z powietrza .	Skojarzenia	0	Neut
Istotnie , oznakowanie było w języku rosyjskim .	oznakowanie	2	Neut
Naciąg strun odbywał się jednocześnie dla całego masztu , czyli w zależności od typu masztu naciągano 12 , 16 lub 18 strun .	strun	1	Fem
Samozwańczy gliniarz posługuje się oryginalną legitymacją .	legitymacją	5	Fem
Podzielam ten pogląd .	pogląd	2	Masc
Gdyby śmy wobec tych przeciwności zareagowali negatywnym myśleniem lub działaniem , pomnożymy tylko złe siły , a te zrealizują się w naszym życiu .	przeciwności	4	Fem
Uszanowanie i respekt przed Bogiem są bardzo mocno zaakcentowane w doświadczeniu proroków .	doświadczeniu	10	Neut
Są to bardzo spóźnione rewelacje .	rewelacje	4	Fem
Nowi ustne rozpoczęli od geografii .	geografii	4	Fem
Stojąc , mógł się od biedy bronić .	biedy	5	Fem
Poseł Andrzej Pęczak musiał się z powodu zarzutów Nowaka tłumaczyć w prokuraturze .	prokuraturze	11	Fem
Starcia zaczęły się koło południa .	Starcia	0	Neut
Ksiądz Korniłowicz odmawiał brewiarz , chodząc tutaj po ścieżkach .	ścieżkach	8	Fem
Akcje tego typu podejmowane samorzutnie w roku 1956 przyniosły cenne zdobycze .	Akcje	0	Fem
Prosiła , żeby ucałować ciotkę i podziękować jej za paczkę .	paczkę	9	Fem
Banki mogą żądać prowizji od kredytu .	Banki	0	Masc
Kilka dni temu na oddział trafiła prątkująca absolwentka gimnazjum .	gimnazjum	8	Neut
Abakanowicz pracuje seriami .	seriami	2	Fem
Drzwi do łazienki , wyjęte z zawiasów , stały oparte o ścianę .	zawiasów	6	Masc
Jednego z zatrzymanych sąd aresztował pod zarzutem rozboju i uszkodzenia ciała .	zatrzymanych	2	Masc
Rano Odra nasyca niebieskawą mgłą ulice obu miast .	mgłą	4	Fem
Życie ojca , surowe i ciężkie , całkowicie poświęcone rodzinie i opiece nad innymi ludźmi , budzi dziś zdumienie nieprawdopodobną obowiązkowością , odpowiedzialnością i pogodą ducha .	zdumienie	18	Neut
Nawiedzony dom w Rajsach znają wszyscy , zarówno mieszkańcy Miejsca Piastowego , jak i krośnianie .	Miejsca	9	Neut
Narkotyki stają się coraz większą plagą wśród czeskiej młodzieży .	plagą	5	Fem
Kolejny etap to muzyka .	etap	1	Masc
Pełniący obecnie obowiązki szefa rosyjskiego państwa Putin był jeszcze niedawno szefem służb specjalnych .	służb	11	Fem
We wspomnieniu samego Zalewskiego metamorfoza była dość szybka i prosta .	wspomnieniu	1	Neut
Obietnice Boga są językiem Jego miłości do nas .	Obietnice	0	Fem
Westchnienia Ruskina i Prousta trafiają na podatny grunt .	Westchnienia	0	Neut
Faktem jest również starcie na schodach i sieni .	starcie	3	Neut
- Nigdy zapalniczkami nie handlował em .	zapalniczkami	2	Fem
Podstawowe nazewnictwo łacińskie zostało przetłumaczone na język polski .	nazewnictwo	1	Neut
Fotoreporterzy utrwalili polityka w pozie modlitwy lub zadumy nad grobem dziewczynki .	modlitwy	5	Fem
Dalej autor artykułu sugestywnie opisuje , jak na ów obszar spada potężna rakieta z głowicą wodorową , powodując kolosalną eksplozję .	obszar	9	Masc
Po obejżeniu tych trzech filmów z niepokojem oglądam wiadomości .	obejżeniu	1	Neut
Na tej klepce bracia mocno się poślizgnęli .	klepce	2	Fem
W lasach pasły się krowy i owce , czasem ozwał się poryk niedźwiedzia lub gniewne parsknięcie rysia .	parsknięcie	15	Neut
Był człowiekiem o wielkiej kulturze osobistej .	kulturze	4	Fem
Samolot wylądował punktualnie o 11 . 10 , a pierwsi podróżni dostali róże od obsługi lotniska .	lotniska	15	Neut
Z nadbrzeża woła mnie Lazo Jowanowski .	nadbrzeża	1	Neut
Łamią się piersi , trzeszczy kość , próchnieją dłonie , twarze bledną . . .	kość	5	Fem
Wczoraj ciśnienie wynosiło ponad 1000 hektopaskali .	hektopaskali	5	Masc
A poza tym , w kwestiach kuchni w szkołach i sprzątania szkół , dobrem dzieci zasłania się przede wszystkim chęć utrzymania własnego stołka .	chęć	19	Fem
Oczywiście do zerwania zmówin dochodziło .	zmówin	3	Neut
Zakończył się VIII Raciborski Rajd Rowerowy Środowisk Trzeźwościowych Dookoła Polski .	Rajd	4	Masc
- Każdy z liderów partyjnych musi rozliczać się wobec swojego zaplecza politycznego .	zaplecza	10	Neut
Podobne warunki terenowe charakteryzują cmentarzysko w Předmostí .	cmentarzysko	4	Neut
Na przyszłe dożynki wybiera się do Warszawy .	dożynki	2	Neut
Rodziny osób pochowanych na cmentarzu w York domagają się ich usunięcia .	usunięcia	10	Neut
Leżała na wersalce z nosem wtulonym we włochatą poduszeczkę .	nosem	4	Masc
Po zetknięciu z ziemią maszyna wybuchła , a siła eksplozji wyrzuciła dwóch słowackich mechaników i Marka Panasia .	zetknięciu	1	Neut
Machała m mu fartuchem , żeby lądował na łące pod lasem , ale ten chłopak chyba się przestraszył , że zawadzi o druty .	fartuchem	3	Masc
– Dziennikarze wmówili sądowi i ludziom , że Róża musi wrócić do biologicznych rodziców .	sądowi	3	Masc
Panny Adeli już nie było .	Panny	0	Fem
W styczniu kredytowy ruch jeszcze się zwiększył .	styczniu	1	Masc
Dynamiczny spektakl przyciągnął uwagę przechodniów .	spektakl	1	Masc
Jeśli pogoda dopisze , będziemy wykonywać te prace bez przerwy .	pogoda	1	Fem
Dla światowych producentów odzieży Polska staje się coraz ważniejszym rynkiem zbytu .	rynkiem	9	Masc
Który milioner żył by w takim syfie ?	milioner	1	Masc
KTO PIERWSZY ZAPALIŁ OGIEŃ NA ROZEWIU ?	OGIEŃ	3	Masc
Większość to uciekinierzy i ich potomkowie .	potomkowie	5	Masc
Wcześniej za największe osiągniecie uważał dwukrotne zwycięstwo w Memoriale Zakrzewskiego w Kędzierzynie-Koźlu .	osiągniecie	3	Neut
Wizyta ma charakter prywatny .	Wizyta	0	Fem
Wieczorem działki otuliły się dymem .	dymem	4	Masc
– Widownia ze zrozumieniem pokiwała głowami .	Widownia	1	Fem
Spirytus jest rozlewany do kartoników litrowych , półlitrowych i ćwiartek .	kartoników	4	Masc
- Pytał em też Mędrców , ale pokiwali tylko głowami i orzekli , że ich komputery nie są w stanie tej zagadki rozwikłać .	komputery	15	Masc
- Komar to żywa istota .	Komar	1	Masc
Wprowadzenie planu w życie wymaga uchwalenia bądź zmiany kilkunastu ustaw .	uchwalenia	5	Neut
Sprawy budżetowe zajmą więc zapewne sporo czasu na czwartkowej sesji .	Sprawy	0	Fem
Zbiegł po płycie .	płycie	2	Fem
Zdjąć te cholerne obrazki po właścicielu .	obrazki	3	Masc
Dowódca odczytywał ostatni rozkaz komendanta Armii Krajowej .	Dowódca	0	Masc
Niedługo kasa popłynie jeszcze większym strumieniem .	kasa	1	Fem
Federaliści przegrali wybory .	Federaliści	0	Masc
Policja wszczęła śledztwo w sprawie wybuchu .	wybuchu	5	Masc
Także miasto Bielsko-Biała włączyło się w finansowanie dokumentacji .	dokumentacji	7	Fem
Jakże mało zostało by na drogi , zieleń , tereny dla dzieci , sklepy .	tereny	9	Masc
Jednocześnie polecił zająć się milicjantem prowadzącym śledztwo .	milicjantem	4	Masc
Nawet Nagroda Nobla mu nie dorównuje !	Nagroda	1	Fem
Dębica była kolejnym miejscem rozegrania Grand Prix Polski w pływaniu .	rozegrania	4	Neut
Przed weselem jak zwykle szły zapowiedzi .	weselem	1	Neut
Krystyna Kofta ogłosiła , że przyjmuje na siebie misję walki o równouprawnienie Bożen z Krystynami i za dwa lata zaprosiła panie do Trójmiasta , by równość tę udowodnić .	równouprawnienie	11	Neut
Koniec przedstawienia , teraz kretyni biją brawa i proszą o bisy . . .	brawa	6	Neut
Po spłukaniu ulega biodegradacji .	spłukaniu	1	Neut
A potem po jakimś czasie zaczęło się nawet przyzywanie szatana .	przyzywanie	8	Neut
Jadący motorem 22-letni mężczyzna na łuku drogi stracił panowanie nad pojazdem i uderzył w betonowe ogrodzenie .	ogrodzenie	15	Neut
Armia izraelska odwołała ćwiczenia i manewry .	manewry	5	Neut
Nadążacie , Towarzysze ?	Towarzysze	2	Masc
Najgłośniejsza draka wybuchła o Tywonka .	draka	1	Fem
Ale nie rozumiem , jak można w imię ekumenizmu wysuwać roszczenia do tworzenia w Europie stref monopolistycznych wpływów religijnych .	wpływów	17	Masc
Tu też przyrządzał wspaniałe słodkości .	słodkości	4	Fem
- Gdyby nie zwilżać gardła , można by zdechnąć w ten upał .	gardła	4	Neut
Nad nim stał Vilo w słonecznej aureoli .	aureoli	6	Fem
Po zdjęciu serwetki i położeniu jej na kolanach na małym talerzyku spożyjemy przekąskę .	położeniu	4	Neut
Czołgi i wozy pancerne strzegą więzienia , do którego ciężarówki wojskowe bez przerwy przywożą aresztowanych .	więzienia	5	Neut
Z oficjalnym żądaniem wobec MKOl , złożonym na piśmie , wystąpił Narodowy Komitet Olimpijski KRLD , domagając się od naczelnej władzy sportowej rewizji listy triumfatorów olimpijskich .	rewizji	22	Fem
Wszystko by tu poszło z dymem w jednej chwili .	dymem	5	Masc
– Zwierzęta skinęły głowami .	Zwierzęta	1	Neut
Ostatecznym celem był garnizon w Greifswaldzie na Pomorzu .	celem	1	Masc
Jakiś chłopak postanowił wspiąć się na słup , by osobiście zdementować bzdury o magicznym prądzie elektrycznym .	bzdury	11	Fem
Pracował własnej roboty heblami , wiertłami , młotkami , nożami , dłutami .	heblami	3	Masc
Kropidłami żegnają granaty i rynsztokami płynie woda święcona .	Kropidłami	0	Neut
Ja nie mam takich uprawnień i nie uczestniczę w przesłuchaniach .	przesłuchaniach	9	Neut
Nieruchomo stojąc w powietrzu nad kwiatami lecimy .	powietrzu	3	Neut
Przez wiele lat uchodził za radykalnego antykomunistę .	antykomunistę	6	Masc
Z prawej wyskoczył cwałem ciężkozbrojny bez hełmu , schylił się , usiłując chwycić za szory zaprzęgu .	zaprzęgu	15	Masc
Lubuscy policjanci rozbili grupę zajmującą się włamaniami do kościołów i kradzieżami figur oraz przedmiotów kultu religijnego .	figur	11	Fem
Dom aż pachnie od farby i mydła .	farby	4	Fem
Teraz będzie musiał zmienić miasto albo przyzwyczajenia .	przyzwyczajenia	6	Neut
Zrób kolację .	kolację	1	Fem
Dlatego Marek z kartonem stał teraz na poboczu , czekając na Grzesia i jego półciężarówkę .	półciężarówkę	14	Fem
Ale , Yennefer , wydaj te polecenia szybko .	polecenia	6	Neut
Doroczny Bal Mody w salonach Hotelu Europejskiego zgromadził najpiękniejsze panie stolicy .	salonach	4	Masc
Poruszyły się wskaźniki na podświetlanych zegarach .	wskaźniki	2	Masc
Ważniejszy od niego jest parametr Name , który pozwala na nadanie nazwy danemu formularzowi .	parametr	4	Masc
Zbierał te suche rozstajne krótkie drogi , wiązał w pokaźne drapadła o ściśniętym kierunku .	drapadła	10	Neut
Dokonawszy pośpiesznie wieczornej toalety , ułożyłem się w łóżku i zaraz zgasiłem światło .	toalety	3	Fem
Mężczyźni urządzili sobie tam imprezę alkoholową .	imprezę	4	Fem
To po to zafundowali ci laptopa ?	laptopa	5	Masc
Zaraz wydam dyspozycje .	dyspozycje	2	Fem
I odnowi oblicze ziemi .	oblicze	2	Neut
W drugiej części czytelnik będzie mógł lepiej poznać cały pluton rotacyjny szeregowca Leńczyka .	czytelnik	3	Masc
Wpadł jej w oko królewicz .	królewicz	4	Masc
Jakie renty otrzymują u was inwalidzi ?	renty	1	Fem
Wtedy też powiadomiono straż pożarną .	straż	3	Fem
Oczywiście , określenie to jest bardzo umowne .	określenie	2	Neut
Obsługa korzysta z okazji , w budynku sejmowym odbywa się wielkie sprzątanie .	sprzątanie	11	Neut
Rano , w cieniu kościoła spotkał em mera .	mera	7	Masc
Lokal ten otrzymał nowe pomieszczenia dla kuchni i podręcznych magazynów , oraz szatnię .	szatnię	12	Fem
Dla trzeźwego jest to tylko bełkot .	bełkot	5	Masc
Teraz siedziała wyprostowana na łóżku , z napięciem wpatrując się w twarze Blothów .	napięciem	7	Neut
Przebrzmiała już wiadomość zaczęła powracać , jakby m cofał taśmę magnetofonową i wysłuchiwał fatalnego technicznie nagrania .	taśmę	9	Fem
Jak nauczyć psa skakania przez przeszkody ?	przeszkody	5	Fem
Ulice zamieniły się w nieprzejezdne rozlewiska .	rozlewiska	5	Neut
Może w styczniu zaproszę cię na chrzciny .	chrzciny	6	Neut
Papieros sparzył mi palce , rzuciłem go w śnieg .	palce	3	Masc
dało by radę ?	radę	2	Fem
Uważa się , że od bhang pochodzi nazwa tradycyjnego indyjskiego tańca bhangra .	bhangra	11	Masc
Zakończyły się ligowe rozgrywki drużynowych mistrzostw Polski w zapasach .	zapasach	8	Neut
Ze swadą wyśmiał i wypunktował tę pookrągłostołową zgraję rządzącą Polską z nadania Kiszczaka .	nadania	11	Neut
- Spotkaliśmy się , towarzyszu rektorze . . .	towarzyszu	4	Masc
Mundek zasiadł jak zwykle przy pianinie , Czesiek kiwał się przy kontrabasie .	pianinie	5	Neut
Nazajutrz było zwiedzanie kościołów stolicy .	zwiedzanie	2	Neut
Niedobory pozostałych składników , które biorą aktywny udział w przemianie białkowej , mogą powodować schorzenia włosów i paznokci .	składników	2	Masc
Powierzchnię morza pruły statki , oczekujące pojawienia się ostatniego członu rakiety .	statki	3	Masc
Pod żadnym pozorem nie zgadzaj się na pozostanie w domu w przyszły weekend .	pozostanie	7	Neut
Dzięki temu po wyjęciu dwóch foteli uzyskamy dodatkową powierzchnię bagażową .	powierzchnię	8	Fem
Topielec zobaczył jakiś ruch w tej martwocie .	martwocie	6	Fem
Rodzice ze wzruszeniem prezentowali dziennikarzom swoje maleństwa i dziękowali za pomoc .	maleństwa	6	Neut
Wiele ptaków owadożernych zimą zmienia jadłospis na roślinny .	ptaków	1	Masc
A potem będę składać apelację .	apelację	4	Fem
We współczesnej dyskusji takie zarzuty stawiali H . Williams , N . Abercrombie , J . Larrain , W . Carlsnaes .	dyskusji	2	Fem
Hutnictwo polskie współpracuje z hutnictwem ZSRR , NRD , Czechosłowacji i Bułgarii .	Hutnictwo	0	Neut
Cipkę sygnowała dodatkowo autografem .	Cipkę	0	Fem
Potem zostaną ulokowani w hotelach i ośrodkach wypoczynkowych .	ośrodkach	6	Masc
Leczenie ataków padaczkowych polega na podawaniu leków przerywających drgawki niezależnie od ich przyczyny .	Leczenie	0	Neut
Pan hrabia wie , że jesteśmy niewinni .	hrabia	1	Masc
Nachor aż się zachłysnął z radości .	radości	5	Fem
Mrok starł z jej ramion i piersi śliczną pozłocistość .	pozłocistość	8	Fem
Na torze pod Kielcami odbyty się pierwsze wyścigi samochodowe .	torze	1	Masc
Inwestorzy zagraniczni muszą wpłacić pieniądze z góry w nadziei , że biuro maklerskie wywiąże się ze zobowiązania .	biuro	11	Neut
Na szczęście nikt nie odniósł obrażeń .	obrażeń	5	Neut
Słuchaj , co ci rzeknie herold !	herold	5	Masc
– Joanna z lekkim wyrzutem spojrzała na młodą koleżankę .	koleżankę	8	Fem
Miał em zapas na dole wózka .	wózka	5	Masc
Przedstawiciele Stalexportu zapewniają , że banki chcą dalej finansować holding .	holding	9	Masc
Użytkownik ma do dyspozycji 6 baz zawierających informacje posortowane według wybranego kryterium .	kryterium	11	Neut
Funkcję tę pełnił przez 35 lat i wywarł ogromne piętno na prawodawstwie amerykańskim .	prawodawstwie	11	Neut
Ranny został operator Jerzy Ernst .	operator	2	Masc
Niestety , niektórzy czytelnicy wierzą , że mogła m takie głupawe wierszydło napisać .	wierszydło	11	Neut
Bracie Gęgaczu , rozchmurz swą fizys !	fizys	5	Fem
Wracamy do szosy i jedziemy w stronę sąsiedniego Falsztyna .	szosy	2	Fem
Sędzia także to zauważył .	Sędzia	0	Masc
Świadkowie twierdzą , że pieszy rzucił się pod koła rozmyślnie .	koła	8	Neut
Ponadto prezes powiadomił o przestępstwie tutejszą prokuraturę .	prokuraturę	6	Fem
43-letni młodszy brygadier dmuchnął w alkomat .	alkomat	5	Masc
Portal Wirtualna Polska gościł wczoraj premiera Jerzego Buzka .	premiera	5	Masc
Zwierzę polubiło piwko i bez kufla nie daje się wydoić .	piwko	2	Neut
- Jego twarz jest zazwyczaj dość blada , czasami ma nieco zielonkawy odcień .	odcień	12	Masc
Akceptacja wyraża obiektywną prawdę o człowieku , a nie tylko subiektywne przeżycia jednostki .	jednostki	12	Fem
Ani mu się śniło opowiadać o słonecznej wiośnie .	wiośnie	7	Fem
Zdarzenie z kamykiem nie wychodziło mu z głowy .	Zdarzenie	0	Neut
Dymek w tym czasie ekspanderem przymocował otwartą klapę .	klapę	7	Fem
Dlatego Marek z kartonem stał teraz na poboczu , czekając na Grzesia i jego półciężarówkę .	poboczu	7	Neut
Wtedy dziewczynka zdjęła spodnie i kurtkę , a także buty .	kurtkę	5	Fem
Machała m mu fartuchem , żeby lądował na łące pod lasem , ale ten chłopak chyba się przestraszył , że zawadzi o druty .	łące	8	Fem
Projekt przewiduje postawienie 7-kondygnacyjnego biurowca z dwupoziomowym garażem podziemnym na 450 samochodów oraz częścią handlową i usługową .	postawienie	2	Neut
Dzięki temu mogł em dotrwać kilka lat do emerytury bez zmieniania pracy .	zmieniania	10	Neut
Oprócz okradania opolan eseldziaki kantowały również kumpli w interesach .	opolan	2	Masc
MPK prowadzi jeszcze rozmowy z wojskiem i PKP .	wojskiem	5	Neut
Błogosławieństwa nowożeńcom udzielił ks. kanonik Wesołowski .	ks.	3	Masc
Chorują na sepsę .	sepsę	2	Fem
Poczuli lodowate zimno .	zimno	2	Neut
Pożar ugasiła miejska straż .	straż	3	Fem
Ambicje polityków coraz mocniej ciągną nas na dno .	Ambicje	0	Fem
Latem wyganiano zwierzęta przed świtem .	zwierzęta	2	Neut
- Dajemy sygnał organizacjom terrorystycznym .	organizacjom	3	Fem
Wzrasta temperatura rozmów o prawyborach w AWS .	temperatura	1	Fem
To jeden z najdroższych sylwestrów na Mazowszu .	sylwestrów	4	Masc
Jaro pofatygował się zadośćuczynić życzeniu klienta , a tymczasem dziewczyny na scenie dały spokój rurce .	życzeniu	4	Neut
Zdesperowany doktor wlał płyn do dezynfekowania narzędzi chirurgicznych do dużego naczynia , włożył w płyn zaganiacza , zamieszał .	narzędzi	6	Neut
Jakie renty otrzymują u was inwalidzi ?	inwalidzi	5	Masc
Trzy osoby podejrzane o korupcję , w tym profesora , który przewodniczył komisji egzaminującej weterynarzy , zatrzymali warmińsko - mazurscy policjanci .	weterynarzy	14	Masc
Ręką wskazał mi fotel .	Ręką	0	Fem
Poza pierwszą nagrodą przyznaną przez jury , Marta Klimasara otrzymała także nagrodę publiczności .	nagrodę	11	Fem
Gdy wchodziła w życie reforma edukacji , Jerzy Buzek otwierał rok szkolny i prezentował gimbusy .	reforma	4	Fem
Nastrój jesiennej majówki zepsuła ta dziewczyna .	majówki	2	Fem
Myśli Pani , że jestem odosobnionym egzemplarzem ?	egzemplarzem	6	Masc
Bzykali śmy się na boczku , na kogutka , na suczkę , na peryskop .	kogutka	7	Masc
Mamy do wyremontowania wiele instalacji wodno - kanalizacyjnych w gimnazjach .	wyremontowania	2	Neut
Facet musiał wyłączyć silnik .	silnik	3	Masc
Żonę ma w Stanach Zjednoczonych , dorosłym dzieciom powodzi się dobrze .	Żonę	0	Fem
Deser zostanie podany po sprzątnięciu talerza głównego .	sprzątnięciu	4	Neut
Ciała te noszą ślady tortur .	tortur	4	Fem
Woda zalała zasiewy i drogi lądowe .	zasiewy	2	Masc
Prasa podwoiła liczbę tytułów .	tytułów	3	Masc
Rada ma co najmniej trzy miesiące na zbieranie wniosków o koncesje .	zbieranie	7	Neut
Decyzja zapadła , mimo że szefowie tajnych służb ostrzegli , iż Palestyńczycy wyjdą na ulice .	Decyzja	0	Fem
Szkoła ma dwie kondygnacje , 9 izb lekcyjnych , kuchnię i kotłownię .	izb	6	Fem
Astma trapi ludzkość od zarania dziejów .	zarania	4	Neut
Radny Krzysztof Krzeszowski wylicza podobne przypadki także w innych szkołach .	szkołach	9	Fem
Parę kontaktów się urwało .	kontaktów	1	Masc
Funkcję tę pełnił przez 35 lat i wywarł ogromne piętno na prawodawstwie amerykańskim .	Funkcję	0	Fem
Wieczorem wymykają się z hoteliku , by spojrzeć na ulubioną maszynę i pocałować ją na dobranoc .	dobranoc	15	Fem
- A ja się nigdy nie przyzwyczaję do tego barbarzyństwa .	barbarzyństwa	9	Neut
Rzecznik armii powiedział , iż na miejscu dokonano aresztowań .	aresztowań	8	Neut
O zaliczeniu maszyny , urządzenia lub aparatu do odpowiedniej podgrupy decyduje jej przeznaczenie oraz konstrukcja i wyposażenie .	maszyny	2	Fem
Ja na miejscu Pana Giertycha wprowadziłbym zakaz rodzenia głupim matkom .	rodzenia	7	Neut
Trwa dochodzenie w tej sprawie .	dochodzenie	1	Neut
Starczy tego rzępolenia , łajzy !	łajzy	4	Masc
Podczas mojej pierwszej bytności w Londynie miałam , dzięki uprzejmości pani z biblioteki polskiej , dostęp do teczki Krystyny .	bytności	3	Fem
Stanowią one razem z rzodkiewką potrawę pełnowartościową , dając jednocześnie ciekawy efekt dekoracyjny .	potrawę	5	Fem
- Proszę o zajmowanie miejsc .	zajmowanie	3	Neut
W Pruszkowie gang zorganizowali wychowankowie słynnego w czasach PRL bandyty Barabasza .	bandyty	9	Masc
Proboszcz wzniósł oczy w sufit i westchnął o świętą cierpliwość .	cierpliwość	9	Fem
Zgodnie z ustaleniami nie udzielił żadnych wywiadów ani nie wydał żadnego oświadczenia politycznego .	ustaleniami	2	Neut
Niebo było pokryte białymi barankami .	Niebo	0	Neut
W porównaniu z innymi miastami zachodniopomorskiego Szczecinek jest oazą porządku i bezpieczeństwa .	oazą	8	Fem
Siedzieli w zmroku .	zmroku	2	Masc
Miś Holender przysłał mu czerwone anemony i hiacynty na ostatek .	anemony	5	Masc
tam są różne różki .	różki	3	Masc
Czy coś takiego może być lotniskiem ?	lotniskiem	5	Neut
Zginęło wielu ochotników z Wielkopolski , między nimi 68 uczniów gimnazjum w Trzemesznie .	gimnazjum	10	Neut
Niektóre sale pałacyku w Karolinie przeznaczono na małe muzeum .	sale	1	Fem
Nie kieruję się przy tym ideologią wegetariańską , choć z nią sympatyzuję .	ideologią	5	Fem
Kilka lat temu ofiarą wandali padły mogiły na Cmentarzu na Powązkach w Warszawie .	wandali	4	Masc
Czy pan zna inżyniera Jarzęckiego ?	inżyniera	3	Masc
Związkowcy podkreślili jednak , że mają gwarancje ministra w sprawie modelu PKP i przyszłych przekształceń kolei oraz dalszych rozmów z nimi .	Związkowcy	0	Masc
Bo jest tylko czas na zarabianie pieniędzy i klepanie biedy .	zarabianie	5	Neut
W połączeniu z manipulowaniem ostrością tworzy to klimat z pogranicza jawy i nierzeczywistości o niejasnej proweniencji .	manipulowaniem	3	Neut
Brzęcząc pustymi kuflami , weszła do środka .	kuflami	2	Masc
Niestety , wykonane opodal obwałowania niewiele dały .	obwałowania	4	Neut
Według islamu świnia jest uznawana za zwierzę nieczyste .	świnia	2	Fem
Tu składała ręce błagalnie , tam rozkładała je gestem perswazji .	perswazji	9	Fem
Panie pośle , czy wolno dawać łapówki ?	łapówki	6	Fem
Papież Formosus zmarł w kwietniu 896 w wyniku nieznanej choroby lub otrucia .	otrucia	11	Neut
Rybka powędrowała do akwarium ustawionego przez asystentkę na stoliku .	Rybka	0	Fem
o wzięło by się czyściochę . .	czyściochę	4	Fem
Najder nie godził się na takie załatwienie sprawy .	załatwienie	6	Neut
W Berchtesgaden specjalnością jest tor saneczkowy , na którym osiąga się niebywałe prędkości .	prędkości	12	Fem
Rysiek dziękował Bogu , że nie wręczył prezesowi dolara w parku , bo by wtedy nie miał czego szukać .	dolara	8	Masc
W sobotę podporucznik Ziemba przeniósł swoje łóżko do kuchni , rowery wstawiono do pokoju podporucznika Kowalika .	podporucznik	2	Masc
Przede wszystkim wywozili ruchomy majątek i żywność .	żywność	6	Fem
Nie byłoby może przez to głupich córek i skończyłby się problem aborcji .	córek	6	Fem
— Jakie jest oblicze tego komunizmu , które pani widzi w Europie ?	komunizmu	5	Masc
Marta ciskała nuty , zamykała się z trzaskiem u siebie .	nuty	2	Neut
Bardzo często , kiedy był em wściekły i napięty , wypijał em na rozluźnienie piwko czy setkę .	piwko	14	Neut
- Może spotkasz swojego starego znajomego , Szmidta .	znajomego	5	Masc
Wtedy bandyci atakują chłopaka .	bandyci	1	Masc
Pierwsze gwiazdy toną w duszy młodego człowieka jak w górskim jeziorze .	gwiazdy	1	Fem
Marchewki obrać i zetrzeć na tarce o dużych oczkach .	oczkach	8	Neut
Podczas którejś kolacji wyznał , że przez kilkanaście lat uprawiał pięściarstwo .	pięściarstwo	10	Neut
Nie sprzyja to oczywiście bezusterkowemu oddawaniu obiektów .	obiektów	6	Masc
Wniesienie skargi o wznowienie nie tamuje wykonania zaskarżonego wyroku .	wznowienie	3	Neut
I to wydaje mi się dobrą pointą .	pointą	6	Fem
Tak przynajmniej wynika z zachowanych dokumentów i relacji .	relacji	7	Fem
Do akcji plebiscytowej włączają się działy sportowe poszczególnych gazet .	działy	5	Masc
Mimo wprowadzenia stanu wojennego i militaryzacji kopalń czterobrygadówka nie powraca .	militaryzacji	5	Fem
Pod żadnym pozorem nie zgadzaj się na pozostanie w domu w przyszły weekend .	pozostanie	7	Neut
Po paru dniach znał już wszystko i wszystkich i spędzał na górnych piętrach każdą wolną chwilę , wychodząc tylko w porze posiłków i oczywiście snu .	piętrach	12	Neut
Lecz kontynuował polemikę .	polemikę	2	Fem
Zgodnie z oczekiwaniami po złoto sięgnęły ekipy gospodarzy .	oczekiwaniami	2	Neut
Powoduje wysokie bezrobocie i sprawia , że państwo zadłuża się na bardzo wysoki procent .	bezrobocie	2	Neut
Mówić on będzie dzisiaj o sytuacji religijnej i nowych ruchach w Europie .	ruchach	9	Masc
Natomiast zdjęcia eksponowane w MDK ukazują nowe spojrzenie na fotografię , którego dominantą jest wykonywanie makrofotograficznych ujęć z bardzo bliskiej odległości przy małej głębi ostrości .	ujęć	16	Neut
Wszedł do wagonu , w przejściu natknął się na konduktora - służbistę , który zrobił mu wykład o niebezpieczeństwie związanym ze wskakiwaniem do pociągu w biegu .	niebezpieczeństwie	18	Neut
Nie byłoby może przez to głupich córek i skończyłby się problem aborcji .	aborcji	11	Fem
- On nigdy nie zjedzie chłopu z drogi , choćby był w próżni .	próżni	12	Fem
Artyści z trzech akademii sztuk pięknych oglądali wczoraj budynki przy ulicy Zamkowej .	Artyści	0	Masc
Ani złotówka nie trafia do stoczniowców .	stoczniowców	5	Masc
Ciało Gwieździka znaleziono przypadkiem .	Ciało	0	Neut
Tysiące zwiedzających oblegało stoiska .	stoiska	3	Neut
Teraz składamy paskowy patchwork , ocieplenie i podszewkę , zszywamy wzdłuż prostego brzegu i obszywamy lamówką .	podszewkę	7	Fem
Potem profesor Lalos pokazał im szkołę dziecięcą .	szkołę	5	Fem
Posiadł tę umiejętność szybko .	umiejętność	2	Fem
– w plecaku też nie masz . .	plecaku	2	Masc
W następnym oknie będzie można samodzielnie skonfigurować menu bootmanagera .	menu	7	Neut
Zrobienie takiego wzoru zajmie kilka godzin .	Zrobienie	0	Neut
Ale dzieciaki i tak odbijają piłki o ściany pod oknami .	oknami	9	Neut
On tu miał pełnić straż .	straż	4	Fem
Ostatecznie o ewentualnej winie Nowaka wypowie się sąd .	winie	3	Fem
Palcem rysuje na wykładzinie małe syrenki .	syrenki	5	Fem
Już nie patrząc na niego , sięgnęła do gumy majtek .	majtek	9	Neut
Orfeusz zmierza pewnie ku światłu , pomyślnie wyprowadzając Eurydykę z krainy zmarłych .	światłu	4	Neut
21 sierpnia 1944 roku rozegrała się w tym miejscu pierwsza po 1939 roku regularna bitwa pomiędzy oddziałami Armii Krajowej i Armii Czerwonej .	oddziałami	16	Masc
Tym świadkom , którzy powiedzą całą prawdę , przestępstwo ujdzie zupełnie bezkarnie .	świadkom	1	Masc
W dalsze wędrówki udaje się tylko dla zmiany ostoi .	wędrówki	2	Fem
Skarżył się jej przecież , że w kieracie prozaicznych zajęć , wśród ludzi zajętych tylko sprawami chleba powszedniego , brak mu rozmów na poważne tematy .	zajęć	9	Neut
Dzięki lekarzom , wsparciu rodziny i samozaparciu pokonał chorobę .	wsparciu	3	Neut
Kolejny pijany policjant straci pracę .	policjant	2	Masc
Brazylijczyk , dwukrotny zwycięzca wielkoszlemowego Roland Garros , podkreślał przed spotkaniem , że najważniejszym elementem piątkowej potyczki będzie skuteczna gra przy własnym serwisie .	spotkaniem	10	Neut
Mgły nie dźwignęły się jeszcze .	Mgły	0	Fem
Beczący głos uciszył sprzysiężonych .	sprzysiężonych	3	Masc
Może w styczniu zaproszę cię na chrzciny .	styczniu	2	Masc
Stanęła w progu , ręce oparła na biodrach .	biodrach	7	Neut
Jego Ryzyko było by Ryzykiem doprowadzonym do ostateczności .	Ryzykiem	4	Neut
Czy przyszłość świata należeć będzie do narodów ubogich , ale licznych i młodych ?	narodów	6	Masc
Kompletnie pijany zjechał na lewe pobocze drogi i uderzył w drzewo .	drzewo	10	Neut
- Pożar grozi ludzkiemu życiu ; ofiarą płomieni najczęściej są dzieci .	płomieni	7	Masc
- Czy zatrzymają pana strefy ochronne wokół siedzib władzy ?	siedzib	7	Fem
- Jedyna wartość obiektywna to profesjonalizm wykonawcy .	profesjonalizm	5	Masc
Ciągnąc go za rękaw , zmusiła do obrócenia się wśród otaczającego ich korowodu .	obrócenia	7	Neut
Z drugiej strony pisowcy chyba mnie polubili .	pisowcy	3	Masc
Sztuka miała premierę w maju 2001 .	premierę	2	Fem
Geje robią wokół siebie szum , żeby tylko się wypromować .	Geje	0	Masc
Operację na lotnisku przeprowadzono na 10 godzin przed upływem ultimatum postawionego przez porywaczy .	porywaczy	12	Masc
Zrobił eś wóz ?	wóz	2	Masc
Zwierzę polubiło piwko i bez kufla nie daje się wydoić .	piwko	2	Neut
Przypomnijmy , że 16 lipca 1994 r . dziadkowie półtorarocznej wówczas Moniki zostawili ją przed legnicką apteką pod opieką ojca , Roberta Bielawskiego .	opieką	18	Fem
Małżonka dyplomaty przez 13 lat była nauczycielką w szkole podstawowej .	nauczycielką	6	Fem
Krzysztof postanowił dorzucić do maila trochę autentyzmu .	autentyzmu	6	Masc
Szef Polsatu zapowiedział , że złoży dziś do NSA wniosek o zmianę postanowienia .	postanowienia	12	Neut
Skończyła makijaż i zaczęła przeglądać ciuchy .	ciuchy	5	Masc
Na sali gimnastycznej panował przenikliwy ziąb .	ziąb	5	Masc
Bracia Kaczyńscy chcą w tej chwili albo koalicji na swoich warunkach , albo przyspieszonych wyborów .	koalicji	7	Fem
Ukląkł em przy Mateuszu i szybko wcisnął em mu woreczek do ręki .	woreczek	9	Masc
Obstawimy łoże tabliczkami . . .	tabliczkami	2	Fem
- A obywatelka skąd o tym wie ?	obywatelka	2	Fem
Na czas akcji z kamienicy ewakuowano 10 osób , które nad ranem wróciły do swoich mieszkań .	mieszkań	15	Neut
Dla zdobywców pięciu pierwszych miejsc przewidziano regulaminowe nagrody .	zdobywców	1	Masc
Znów są na schodach i po chwili wszystko się uspokaja .	schodach	3	Neut
Pan Korzeniowski zerwał się z krzesła , podbiegł do szafy , wysunął dolną szufladę , chwilę grzebał w papierzyskach .	szufladę	13	Fem
Orzechy i migdały zemleć , wymieszać z cukrem oraz 3 łyżkami masła na gładką masę i połączyć z kuskusem .	cukrem	7	Masc
Oficer SS wyznaczył żołnierzy do plutonu egzekucyjnego .	Oficer	0	Masc
Jeden z mężczyzn przystąpił do majstrowania przy kablach telefonicznych .	majstrowania	5	Neut
Zgodnie z oczekiwaniami po złoto sięgnęły ekipy gospodarzy .	złoto	4	Neut
Z chwilą urodzenia dziecko może żądać naprawienia szkód doznanych przed urodzeniem .	naprawienia	6	Neut
Dlatego prośba o przebaczenie jest tak trudna .	przebaczenie	3	Neut
I znów poczuł eś się zwycięzcą !	zwycięzcą	5	Masc
Uczestniczki wysłuchały wykładów doradców zawodowych i prawników , uczestniczyły w zajęciach psychologicznych , poznawały podstawy obsługi komputera i korzystania z Internetu .	obsługi	15	Fem
Jednocześnie zmienia się jego skład chemiczny i ubytek ciężaru właściwego .	ciężaru	8	Masc
Patrzył na firankę , lecz tak roztargnionym wzrokiem , że nie zauważył , jak wydyma się od wiatru .	firankę	2	Fem
Homogeniczności ekspresji sprzyja izomorfizm faktury chóralnej .	faktury	4	Fem
Tutaj wyraźnie widać wrażliwe , skłonne do ufności i entuzjazmu oblicze eseisty .	eseisty	11	Masc
Lotnictwo szaleje .	Lotnictwo	0	Neut
Pracował własnej roboty heblami , wiertłami , młotkami , nożami , dłutami .	dłutami	11	Neut
W dalszym ciągu tej książki chcę Ci w tym wyzwoleniu pomóc .	wyzwoleniu	9	Neut
Dyrekcja ma też nadzieję , że w przyszłym roku znajdą się kolejne fundusze na ukończenie całego przedsięwzięcia .	przedsięwzięcia	16	Neut
Pod szczytnymi hasłami kryją się głównie ambicje polityczne i ogromna hipokryzja .	hasłami	2	Neut
Ta masa wodna , nieraz podnosząca poziom Wiku o jeden metr ponad równię Puckiej Zatoki , spotyka się przy dziobie gołębia z silnym prądem zachodnim .	równię	12	Fem
Zwykle w zimę odżywiamy się nieźle .	zimę	2	Fem
W pewnej chwili otworzył em oczy , wyrwany z gorączkowej drzemki jakimś ruchem .	drzemki	10	Fem
Dzisiejsza konfrontacja z łódzkimi zespołami , które mają pierwszoligowe aspiracje , zapowiada się niezwykle ciekawie .	aspiracje	9	Fem
Pierwsze i drugie miejsce zajęły słowackie dziewczęta , ubrane w getry i krótkie falbankowe spódniczki .	getry	10	Neut
Tu mogłem obserwować rzetelną , telewizyjną realizację bez pośpiechu , w której uczestniczenie było naprawdę przyjemnością .	uczestniczenie	12	Neut
Nadal będą funkcjonować w mediach dzięki swemu wiecznie odrębnemu zdaniu .	mediach	4	Neut
Od lat siedemdziesiątych coraz większą popularność zdobywa nurt neuroteologiczny .	popularność	5	Fem
O ileż ciekawiej rozwijała by się nasza znajomość , gdyby jakiś elegant próbował stanąć na drodze naszych uczuć .	elegant	11	Masc
Widzę Łzy w kącikach jego oczu .	Łzy	1	Fem
Ale rozumiem , że do ślubu , prędzej czy później , dojdzie ?	ślubu	5	Masc
Specjaliści z Centralnej Agencji Wywiadowczej mają już świadka , który widział zamachowców na kilka minut przed eksplozją w Nairobi .	eksplozją	16	Fem
- Sapnęła , ale pod warstwą chłodu zamajaczyła iskierka rozbawienia .	rozbawienia	9	Neut
- Czy zatrzymają pana strefy ochronne wokół siedzib władzy ?	władzy	8	Fem
Jakiś chłopak postanowił wspiąć się na słup , by osobiście zdementować bzdury o magicznym prądzie elektrycznym .	prądzie	14	Masc
Jedną rękę trzymał na pniu .	pniu	4	Masc
O ziemię zastukały ciężkie buty .	buty	4	Masc
- Bo ście moje kury w sąsieku zamknęli .	kury	4	Fem
Czarna suka posapuje .	suka	1	Fem
Społeczeństwo wychowywano w ślepym posłuszeństwie wobec Cesarstwa .	posłuszeństwie	4	Neut
Całej imprezie groziła katastrofa , mimo że istniała możliwość otrzymania odszkodowania z towarzystwa ubezpieczeniowego .	katastrofa	3	Fem
- Przechodzimy do głosowania nad założeniami polityki pieniężnej na 1995 r .	założeniami	5	Neut
Zdaniem lekarzy , szpitale cierpiące na brak pieniędzy podejmują drastyczne programy oszczędnościowe .	lekarzy	1	Masc
Wtedy będzie mogła z radością oddać się rowerowym szaleństwom .	szaleństwom	8	Neut
Z kolejnej po jabłkach , wiśniach i porzeczkach klęski urodzaju cieszą się konsumenci .	porzeczkach	7	Fem
Przed oczyma Angusa przesuwały się obrazy z przebytej epopei .	epopei	8	Fem
Można , bo istnieją historyczne analogie .	analogie	5	Fem
Wynikła awantura , ale w duchu przyznano bosmanowi rację .	awantura	1	Fem
Kropidłami żegnają granaty i rynsztokami płynie woda święcona .	rynsztokami	4	Masc
W grudniu 1996 roku Havlovi wraz z górnym płatem prawego płuca usunięto niewielki nowotwór złośliwy .	płuca	10	Neut
Sytuacja wyglądała bardzo groźnie .	Sytuacja	0	Fem
Przed tygodniem wicestarosta Hrycyna podczas wyjazdu do Gdańska uzyskał przychylność tamtejszych środowisk żydowskich .	tygodniem	1	Masc
Trudniejsze jest wtedy automatyczne sprawdzanie kompletności .	sprawdzanie	4	Neut
Tacy obserwatorzy na pewno nie wnoszą nic do naszej pracy pełnej poświęcenia .	poświęcenia	11	Neut
W obliczu trudnej sytuacji na rynku pracy , 9-miesięczna przygoda w wojsku wydaje się dla nich niemiłą perspektywą .	obliczu	1	Neut
W innym przypadku nastąpi natychmiastowe spożycie powodujące zwiększenie siły lub ochłodzenie robota .	spożycie	5	Neut
Stopniowo dół się sam zasypie śmieciami .	śmieciami	5	Masc
To był naprawdę rockowy boom .	boom	4	Masc
Użytkownik ma do dyspozycji 6 baz zawierających informacje posortowane według wybranego kryterium .	Użytkownik	0	Masc
O zaliczeniu maszyny , urządzenia lub aparatu do odpowiedniej podgrupy decyduje jej przeznaczenie oraz konstrukcja i wyposażenie .	wyposażenie	16	Neut
Kot obejrzał się na mnie i usiadł , starannie zawijając ogon na przednie łapki .	ogon	10	Masc
Pozytywne zdanie miała garstka z nich .	garstka	3	Fem
- Dziękuję , nie piję kawy o tak późnej porze .	porze	9	Fem
Jego serce ledwie się ruszało .	serce	1	Neut
Arkadiusza J . pogrążyły też zeznania taksówkarza , który zabrał oskarżonych sprzed Stodoły .	taksówkarza	6	Masc
Kością niezgody jest nadal powstanie niezależnej korporacji prokuratorów .	powstanie	4	Neut
Podniósł się , w ręku trzymał pusty słoik .	słoik	7	Masc
Naukowcy z Uniwersytetu w Portland w USA sklonowali rezusa , czyli małpę należącą do rzędu naczelnych .	rezusa	8	Masc
Część z nich była wypełniona cieczą .	cieczą	5	Fem
Poranione potłuczoną butelką zwierzę trafiło do weterynarza .	weterynarza	6	Masc
Pomaga w sprzątaniu i wszelkich kłopotach zdrowotnych .	sprzątaniu	2	Neut
Po mszy świętej wyruszyła z bazyliki katedralnej i okrążyła Stary Rynek .	bazyliki	5	Fem
Choć pod tym względem ci obecni ani trochę nie ustępują poprzednikom .	obecni	5	Masc
One potrzebują równego traktowania .	traktowania	3	Neut
Uszanowanie i respekt przed Bogiem są bardzo mocno zaakcentowane w doświadczeniu proroków .	respekt	2	Masc
Napisałaby więc z pewnością o Bali , co się stało w Kucie , tuż przy głównym deptaku .	deptaku	16	Masc
- Kto jest sukcesorem prawnym pana naczelnika ?	sukcesorem	3	Masc
Kiedy ja grzeję mleko , ty zawsze musisz zrobić awanturę .	mleko	3	Neut
Pokoje stanowią wyłączną własność poszczególnych lokatorów .	Pokoje	0	Masc
W pierwszych dniach tygodnia czekają Cię ożywione spotkania z przyjaciółmi lub kolegami .	kolegami	11	Masc
Była to jakaś specjalna lampka .	lampka	4	Fem
W miniony czwartek w referendum ratyfikacyjnym Irlandia odrzuciła ten Traktat , otwierający drogę do rozszerzenia Unii .	rozszerzenia	14	Neut
- Będzie biegł od zatoczki autobusowej przy Sandomierskiej do budynku Urzędu Gminy .	zatoczki	4	Fem
Jest to pierwszy przypadek ciąży mnogiej u żyjącej w niewoli pandy .	ciąży	4	Fem
Są to dramatyczne liczby .	liczby	3	Fem
Odpowiedź przyniosą najbliższe tygodnie i wówczas możemy spodziewać się weryfikacji wartości tych spółek .	weryfikacji	9	Fem
Gwiazda przemieniła się w inkwizytora .	inkwizytora	4	Masc
Właściwie tylko Białostockie Przedsiębiorstwo Budownictwa Przemysłowego posiada laboratorium z prawdziwego zdarzenia .	Budownictwa	4	Neut
- Poseł Janusz Wójcik sam zrzeknie się immunitetu .	immunitetu	7	Masc
Ciężki , kleisty lęk wypełnił jej serce .	serce	6	Neut
Bierzemy pod lupę najbliższych sąsiadów .	lupę	2	Fem
Ktoś inny w złości kopie ławkę i rzuca głośno soczyste przekleństwa .	przekleństwa	10	Neut
Oparła się na wypiętych za plecami rękach i z lekka wyprężyła przy tym tułów .	tułów	13	Masc
Przeciętne świadczenie emeryta , rencisty wzrośnie o 33 zł .	świadczenie	1	Neut
Zwierzę polubiło piwko i bez kufla nie daje się wydoić .	Zwierzę	0	Neut
Idziemy jeszcze do bistra na grog z sacharyną .	sacharyną	7	Fem
Odbudujmy porozumienie ponad różnicami , tak mało istotnymi wobec rzeczywistych problemów !	porozumienie	1	Neut
Asystent już podawał chirurgowi fartuch .	chirurgowi	3	Masc
Wczoraj kolegium Instytutu usiłowało wyłonić nowego kandydata na prezesa .	kolegium	1	Neut
Córka studiuje , jest na bezrobotnym .	Córka	0	Fem
Zawód przeżyły grupy protestujących warszawiaków , które licznie przybyły na wczorajszą sesję rady miasta .	Zawód	0	Masc
Rozumowanie Angusa nie było więc pozbawione podstaw , ale jeszcze zbyt daleko biegło w przyszłość .	Rozumowanie	0	Neut
PZN to jest zrzeszenie wszystkich podmiotów , które działają na terenie kraju .	zrzeszenie	3	Neut
W pierwszej części obrad sekretarzami będą pani posłanka Zdzisława Kobylińska i pan poseł Mieczysław Jedoń .	sekretarzami	4	Masc
Jak poinformował Cesar Fraga z Uniwersytetu w Buenos Aires , przeprowadzone tam badania wykazały , że czekolada wzmacnia antyutleniacze znajdujące się we krwi , zwiększając odporność na zaburzenia serca i naczyń wieńcowych .	odporność	25	Fem
Jej celem jest ukazanie roli mediów w życiu dzieci i młodzieży .	celem	1	Masc
W następstwie tego procesu dokonuje się racjonalizacja wiary .	procesu	3	Masc
To wystarczyło , żeby przestraszyć pozostałych kierowców trójkołowych pojazdów , którzy też pracowali nielegalnie .	pojazdów	8	Masc
Burza toczyła się leniwie , zanim zapadła w zachodnią czeluść nieba .	nieba	10	Neut
Po chwili ponowił pukanie , już znacznie energiczniej .	pukanie	3	Neut
Znajomość karate pomińmy . . .	karate	1	Neut
Mam swoje , bo babcia mi daje .	babcia	4	Fem
Mogą jedynie domagać się wynagrodzeń po wydaniu orzeczenia .	wynagrodzeń	4	Neut
Jak ustalili policjanci , podawał alkohol 16-letniej dziewczynie .	dziewczynie	7	Fem
- To anteny Polcomtelu .	anteny	2	Fem
Braków wtenczas nawet poeci nie wypuszczali .	Braków	0	Masc
Na ich temat nic również nie powiedzieli płatni informatorzy , do których w tej sprawie zwrócili się policjanci prowadzący dochodzenie .	dochodzenie	19	Neut
Oprócz okradania opolan eseldziaki kantowały również kumpli w interesach .	interesach	8	Masc
Tarot Marsylski powstał prawdopodobnie w końcu średniowiecza , gdy świeże były jeszcze skojarzenia Czyśćca z refrigerum .	średniowiecza	6	Neut
Prezydent Bush zapewniał w środowym przemówieniu telewizyjnym , że siły koalicji będą maksymalnie oszczędzały ludność cywilną .	przemówieniu	5	Neut
Z tych powodów w innych krajach ministrowie starają się mówić tym samym głosem .	ministrowie	6	Masc
Słuchaj , Piotr był zalany , spadał ze schodów , wyskakiwał z okna .	schodów	8	Neut
Tutaj wyraźnie widać wrażliwe , skłonne do ufności i entuzjazmu oblicze eseisty .	oblicze	10	Neut
Wyszedł po chwili z tej balowej sali , ustawił nas w rzędzie , według instrumentów , skrzypce , altówka , klarnet , trąbka , puzon , perkusja i ja , saksofon .	klarnet	20	Masc
Zajęły one terytoria w sąsiedztwie swych matek .	terytoria	2	Neut
Magnat ulega pokusie .	Magnat	0	Masc
Właściciele muszą czekać na większą imprezę .	Właściciele	0	Masc
- Wolfgang przestawił swoje krzesełko w cień .	krzesełko	4	Neut
Droga do Falsztyna prowadzi przez łagodne wzgórza Pienin Spiskich .	wzgórza	6	Neut
Pozbył się balastu , nim ten balast odebrała mu zamieć historii .	balastu	2	Masc
- Złożę też za chwilę na ręce pana marszałka ową poprawkę formalną , uzgodnioną z Biurem Legislacyjnym .	Biurem	15	Neut
Czuł em wonny zapach po uchyleniu wieka skrzynki .	wieka	6	Neut
Sprawą włamania do domu wokalistki Blue Cafe zajęli się policjanci z komisariatu przy ul . Ciesielskiej .	wokalistki	4	Fem
Rękopisy zostały przyniesione przez lwowianina , który po wojnie osiedlił się w tych stronach .	lwowianina	4	Masc
- Synek ma zespół Downa .	Synek	1	Masc
Odkryto wiele nadużyć .	nadużyć	2	Neut
Listonosz Perez pokręcił z niedowierzaniem głową .	niedowierzaniem	4	Neut
Nagle usłyszałem strzał , wpadłem do warsztatu i zastałem trupa .	warsztatu	6	Masc
Staruszkę ze zmiażdżoną prawą stopą przewieziono do szpitala przy ulicy Cegłowskiej .	Staruszkę	0	Fem
Przez takiego drania wpakowali nas wszystkich czterech na dwa dni do łóżek .	drania	2	Masc
On dał nam Siebie w Eucharystii .	Eucharystii	5	Fem
- Nie wystarczyło być na Syberii , aby otrzymać takie odznaczenie .	odznaczenie	10	Neut
Palestyńczycy będą mogli nawet sprowadzić czołg .	czołg	5	Masc
- Czy nie zabrakło woli politycznej do osądzenia komunistycznych zbrodniarzy ?	osądzenia	7	Neut
Po spotkaniu w magistracie faktycznie ją wynajął za własne pieniądze .	magistracie	3	Masc
Odnalazł Jaskra , kibicującego łupiącym w gwinta krasnoludom .	krasnoludom	7	Masc
Podporucznik Kowalik oddał pług oraczowi .	pług	3	Masc
Czemu mięsa nie je ?	mięsa	1	Neut
Echo zadzwoniło we wnętrzu złomobusu .	Echo	0	Neut
Poseł Grzegorz Skwierczyński z Samoobrony przekonuje , że jest to spełnienie oczekiwań wyborców .	oczekiwań	11	Neut
Dozorca i drugi mężczyzna , stojący obok , wzięli kobietę pod ręce i wyprowadzili na korytarz .	kobietę	9	Fem
Przeciwko wnioskom Komisji ostro zaprotestował radny Krzysztof Gajewski , wiceprezydent w zarządzie odpowiedzialnym za zakup Elektrociepłowni .	Elektrociepłowni	15	Fem
Znaleźli się wkrótce przy przesypie .	przesypie	4	Masc
Czasem krzyżowały się statki .	statki	3	Masc
Dyrekcja ma też nadzieję , że w przyszłym roku znajdą się kolejne fundusze na ukończenie całego przedsięwzięcia .	ukończenie	14	Neut
RADA BEZPIECZEŃSTWA omawia skargę Zambii z powodu powtarzających się aktów agresji ze strony rasistowskiej RPA .	BEZPIECZEŃSTWA	1	Neut
Dystychy , analizowane dotąd oddzielnie , złóżmy obecnie w całość , bo przecież w Dusiołku tworzą one taką całość .	Dystychy	0	Masc
Już Pitagorejczycy znali podobno wszystkie najbardziej regularne wielościany nazywane foremnymi .	wielościany	7	Masc
Jeśli weźmiemy pod uwagę sprawność i wydajność akumulatorów wanadowych , projekt wydaje się zupełnie realny .	sprawność	4	Fem
Przewodniczący Vegów uśmiechnął się jakby z zakłopotaniem .	Przewodniczący	0	Masc
Dalej autor artykułu sugestywnie opisuje , jak na ów obszar spada potężna rakieta z głowicą wodorową , powodując kolosalną eksplozję .	autor	1	Masc
Długo oczekiwana wiosna przyjdzie do nas już jutro !	wiosna	2	Fem
Do obserwatorium waszyngtońskiego ściągały tłumy ciekawych .	obserwatorium	1	Neut
Chłopiec wynurza się spod stołu , trzymając na dłoni rozbite jajko , strzaskaną skorupkę , rozlane żółtko i oślizłe białko .	żółtko	16	Neut
- Kto uczestniczy w tej naradzie ?	naradzie	5	Fem
Jest to też jedna z najbardziej trwałych zdobyczy solidarnościowego przełomu .	przełomu	9	Masc
Ktoś wołał za ścianą , na podwórzu , na drodze .	ścianą	3	Fem
Warta obsługuje powodzian w pierwszej kolejności .	kolejności	5	Fem
Nie miała m wtedy żadnych doświadczeń seksualnych .	doświadczeń	5	Neut
Blok ten jest na ukończeniu .	ukończeniu	4	Neut
Praca pedagogiczna na uniwersytecie japońskim różni się znacznie od pracy na uniwersytecie europejskim .	Praca	0	Fem
Sześć skarg pacjentów bada prokuratura .	prokuratura	4	Fem
No kto , na przykład , zbudował radziecką bombę atomową ?	przykład	4	Masc
Sygnalizuje pan brak odpowiedzi na pytanie dotyczące rencistów i emerytów .	rencistów	7	Masc
Jest szczęśliwy , zauważa moją nową fryzurę .	fryzurę	6	Fem
Siostrzyczki emanowały szlachetnością i pobożnością .	Siostrzyczki	0	Fem
Podczas niemieckiej okupacji spotykali śmy się , należąc do podziemnej literackiej Warszawy .	okupacji	2	Fem
Zresztą , to już zaczyna przypominać jakiś nałóg .	nałóg	7	Masc
Nie spowoduje żadnego niebezpieczeństwa dla otoczenia .	otoczenia	5	Neut
Twoja maska spadła .	maska	1	Fem
Sam Misztal nie ukrywa , że chce zamknięcia dyskoteki .	zamknięcia	7	Neut
– zwężał się ku górze odrobinę .	odrobinę	5	Fem
Czynił to tak niezręcznie , że pani Lichoniowa spostrzegła jego manewry .	manewry	10	Masc
- Zgromadzili śmy tu najstarsze i najładniejsze kostiumy .	kostiumy	7	Masc
Wypraszam sobie takie porównania .	porównania	3	Neut
- Zdarzało się , że uderzyłem butnego Niemca z Wehrwolfu , ale tego nie obejmuje akt oskarżenia .	oskarżenia	16	Neut
Witold poszedł w jego ślady i również poświęcił się dziennikarstwu .	dziennikarstwu	9	Neut
Twoi pasterze błogosławią ciągnące na wojnę armaty .	pasterze	1	Masc
Jako pierwszy zabierze się do ciebie honorowo obłędny rycerz Eyck z Denesle !	rycerz	8	Masc
Streścił em jej dalszy ciąg i bardzo chichotała .	ciąg	4	Masc
Ojciec chciał , żeby m został inżynierem .	inżynierem	6	Masc
- Skąd mogę mieć zaufanie ?	zaufanie	4	Neut
Czemu kogut głośno pieje ?	kogut	1	Masc
Istotą rozmów o sprawach seksualnych jest klimat zaufania i szczerości .	zaufania	7	Neut
Nikt się nie lituje , nie pieści z przyjeżdżającymi na zarobek .	zarobek	10	Masc
W grudniu 1996 roku Havlovi wraz z górnym płatem prawego płuca usunięto niewielki nowotwór złośliwy .	nowotwór	13	Masc
Porosła by gęstym lasem , jak cała okolica , gdyż chudy piasek nie dał by życia .	okolica	7	Fem
W innym przypadku nastąpi natychmiastowe spożycie powodujące zwiększenie siły lub ochłodzenie robota .	zwiększenie	7	Neut
Z klatki wyszedł sąsiad i w pijackim amoku rzucił się na niego z siekierą .	amoku	7	Masc
- Gówno rozumiesz .	Gówno	1	Neut
Wyciągnął ręce , żeby je ostrożnie odebrać i w tym momencie dziwny świst przeszył powietrze .	powietrze	14	Neut
Pomysłodawcą zmian w ordynacji samorządowej była Samoobrona .	ordynacji	3	Fem
- Jaka jest skuteczność leczenia ?	leczenia	4	Neut
Czy jest Ksiądz Arcybiskup zadowolony z ostatecznego brzmienia wspólnego oświadczenia biskupów polskich i niemieckich na czterdziestolecie Orędzia ?	oświadczenia	9	Neut
Jak wygląda ochrona polskich więzień , skoro bandyta może z nich spokojnie wyjść ?	więzień	4	Neut
Dalej jest granica .	granica	2	Fem
Ekolodzy zaopatrzyli młodszych kolegów w worki na śmieci i rękawiczki .	Ekolodzy	0	Masc
Przewaga któregokolwiek układu skurczowego lub niedowład któregokolwiek układu rozkurczowego powoduje skurcz mięśni gładkich oskrzeli .	mięśni	11	Masc
Gwiazda przemieniła się w inkwizytora .	Gwiazda	0	Fem
Jest najwyższym mężczyzną w oddziałach Agencji Restrukturyzacji i Modernizacji Rolnictwa w Polsce .	Rolnictwa	9	Neut
Na terenie przyległym do Kolonii Wierzbicy znajdują się dwie garbarnie .	garbarnie	9	Fem
Denver został założony w 1858 roku i był wielkim centrum górnictwa złota i srebra ; w II połowie XIX wieku powstało Muzeum Sztuki z kolekcją sztuki Indian .	kolekcją	24	Fem
Nowy gadżet wymaga od właściciela kwiatków , czekoladek , randek w barach karaoke i miłosnych liścików .	barach	11	Masc
Opolscy ciepłownicy obawiają się , że ich straty w pierwszych miesiącach nowego roku mogą się okazać horrendalne , bo na podwyżkę ceny węgla nałożyła się także wyjątkowo łagodna zima , która zmniejszyła zapotrzebowanie na ciepło .	zapotrzebowanie	32	Neut
Na pewno ściągnięte przez niego duszyczki nie płaciły składek .	składek	8	Fem
Z kolejnej po jabłkach , wiśniach i porzeczkach klęski urodzaju cieszą się konsumenci .	konsumenci	12	Masc
Weronika wytężyła wzrok i ze zdumieniem poznała Krzysztofa .	zdumieniem	5	Neut
Usiadła na fotelu , zakładając nogę na nogę , miała spódniczkę przed kolana .	spódniczkę	10	Fem
Część młodych osób chce pracować w państwowej firmie , bo to daje zabezpieczenie socjalne .	zabezpieczenie	12	Neut
A wieś szaleje z radości .	wieś	1	Fem
Maturzyści - internauci zdający na pisemnym egzaminie język polski i historię najczęściej typują tematy związane z przełomem wieków .	Maturzyści	0	Masc
Siedzi na schodach z czapką w ręku i robi z siebie widowisko .	widowisko	11	Neut
Ktoś się na skraju półkola rozchichotał , ale zaraz swój chichot połknął .	półkola	4	Neut
Używając pożyczonych magnetofonów szpulowych połączył em dźwięki suity z fragmentami poematu Wergilego .	magnetofonów	2	Masc
Słuszne pytania i odpowiedzi mieszają się z podłymi .	podłymi	7	Neut
To wpływa demoralizująco na szkołę .	szkołę	4	Fem
Czym te kontrakty się różnią poza wielkością dostaw ?	wielkością	6	Fem
Jest to oczywistość , ale ta oczywistość konkretnie umiejscowiona , dla mnie przynajmniej , była jednak czymś wartym zastanowienia .	oczywistość	6	Fem
Występuje stałe obniżanie się poziomów wód w rzekach i potokach .	rzekach	7	Fem
W niedzielę rano odprawiono z okazji rocznicy śmierci kompozytora msze święte w kościołach sióstr Wizytek i św . Krzyża , gdzie spoczywa serce Chopina .	Krzyża	18	Masc
Po naszym reportażu punkt o odwołaniu zarządu zdjęto z porządku obrad .	punkt	3	Masc
Już po raz drugi oglądam tę chorobę w działaniu .	chorobę	6	Fem
- Bo oni nie są katolikami .	katolikami	5	Masc
Pragnę nadmienić , że nie wszystkie marzenia i oczekiwania wywołują sny odwrotne .	marzenia	6	Neut
Dyżurna siostra niemiłosiernie długo sprawdzała w rejestrach .	rejestrach	6	Masc
Przygoda u czoła Lodowca Hansa uświadomiła mi , że lepiej bezpośrednio nie dotykać lodowego klifu .	Lodowca	3	Masc
Kiedy wdychasz powietrze , czuj to .	powietrze	2	Neut
Choć dziecko złożyło na policji zeznania , sprawców nie zatrzymano .	zeznania	5	Neut
Na nocleg zatrzymali się przy małej kępie drzew akacjowych .	kępie	6	Fem
Podobno seryjni mordercy różnią się od innych ludzi chromosomalnie ?	mordercy	2	Masc
Po powrocie zauważył , że drzwi do komórki , zawsze zamknięte na skobel , są otwarte .	skobel	12	Masc
Detektyw precyzyjnym sztychem przeszył jego prawe ramię .	Detektyw	0	Masc
O zaliczeniu maszyny , urządzenia lub aparatu do odpowiedniej podgrupy decyduje jej przeznaczenie oraz konstrukcja i wyposażenie .	aparatu	6	Masc
Duże kontrowersje wzbudził zapis wywalczony przez Związek Nauczycielstwa Polskiego .	zapis	3	Masc
Tempo zajęć programowych wzrasta .	zajęć	1	Neut
W tym celu należałoby wprowadzić do komina specjalną sondę .	sondę	8	Fem
Kilka innych firm ogłosiło zamiar podwyższenia kapitału .	kapitału	6	Masc
I było newsem przez kilka dni .	newsem	2	Masc
Do drugiego wypadku doszło wieczorem na przejściu dla pieszych koło poczty .	przejściu	6	Neut
- Już ze wstępnych oględzin wiadomo było , że kobieta została zamordowana .	oględzin	4	Neut
Dociekał , czy lubi seks , bo on w tym względzie ma duże doświadczenie .	seks	4	Masc
Rozdzielali zwaśnione strony w ramach misji pokojowych ONZ .	misji	5	Fem
Oskarżano nas , że w Bielicznej sprzedali śmy prywatnemu nabywcy kilkaset hektarów wraz z cmentarzem i cerkwią .	cmentarzem	14	Masc
Wszystko zniechęca do prowadzenia dziennika .	prowadzenia	3	Neut
Nad ranem z soboty na niedzielę z pędzącego pociągu wyskoczyła 17-letnia dziewczyna .	soboty	3	Fem
Z początkiem wojny przenosi się do dworku w Krzykawce .	dworku	6	Masc
Opracowuje się w tej sprawie szczegółowy program dla województwa .	województwa	8	Neut
Rodzice ze wzruszeniem prezentowali dziennikarzom swoje maleństwa i dziękowali za pomoc .	wzruszeniem	2	Neut
Moment bezwładności to miara bezwładności ciała w ruchu obrotowym względem określonej , ustalonej osi obrotu .	obrotu	14	Masc
- Reforma na pewno nie zostanie zaniechana .	Reforma	1	Fem
- Ale jak będzie z meldowaniem w hotelu ?	meldowaniem	5	Neut
Policja od razu wszczęła dochodzenie .	dochodzenie	4	Neut
Agent Pawłow nieustannie wodził wzrokiem za kapitanem , pilnie nadstawiał ucha .	Agent	0	Masc
Niektórzy nawet nie zauważyli , że domek już od paru sezonów stoi pusty .	sezonów	10	Masc
Taki stosunek nie może sprzyjać należytemu rozwojowi myśli twórczej wśród pracowników Stoczni , a tym samym przynosi straty państwu .	stosunek	1	Masc
W szerokim pęknięciu fosforycznie świeciło próchno .	próchno	5	Neut
Wyroki dochodziły często do 10 lat więzienia .	więzienia	6	Neut
Lech przynajmniej przeskoczył przez płot .	płot	4	Masc
Protokół i listę mówców prowadzić będą pani posłanka Zdzisława Kobylińska oraz pan poseł Andrzej Zapałowski .	Protokół	0	Masc
Z oceanicznego epicentrum rozbiegły się fale tsunami .	tsunami	6	Neut
Wymaga to zainstalowania odpowiednich zbiorników .	zainstalowania	2	Neut
Detektyw precyzyjnym sztychem przeszył jego prawe ramię .	sztychem	2	Masc
- Nie zajmujemy się leczeniem , ale poprawiamy społeczne funkcjonowanie .	funkcjonowanie	9	Neut
Nie żyje już Kunz Aulock ani nikt z jego kompanii .	kompanii	9	Fem
Jestem w troszeczkę lepszym usposobieniu .	usposobieniu	4	Neut
Dlatego skończył polonistykę i dziennikarstwo .	dziennikarstwo	4	Neut
W ten sposób wzrasta częstotliwość sygnałów .	sygnałów	5	Masc
Taka jest siła propagandy .	propagandy	3	Fem
Dla zdławienia partyzantów działających w górach rząd mobilizuje poważne siły zbrojne .	zdławienia	1	Neut
Parowozy zawsze fascynowały i przerażały .	Parowozy	0	Masc
Jeśli weźmiemy pod uwagę sprawność i wydajność akumulatorów wanadowych , projekt wydaje się zupełnie realny .	akumulatorów	7	Masc
Możesz mieć skłonność do przesady .	przesady	4	Fem
Fotoreporterzy utrwalili polityka w pozie modlitwy lub zadumy nad grobem dziewczynki .	pozie	4	Fem
Szef aż podskoczył !	Szef	0	Masc
Kłusownictwo w tym rejonie jest wciąż popularne .	Kłusownictwo	0	Neut
Wyobraź sobie , że znalazła m coś dziwacznego w kieszeni palta . . .	palta	10	Neut
- Długi górnictwa sięgają 11,5 mld zł ; kopalnie same tego nie spłacą .	górnictwa	2	Neut
Na parterze remonty trwały w najlepsze .	parterze	1	Masc
Historycy nadal spierają się o pochodzenie Mwisków .	pochodzenie	5	Neut
Ktoś położył mu na ramiona prześcieradło .	prześcieradło	5	Neut
Humphrey zmarł w wieku 18 lat , dziewięć lat po odejściu na emeryturę .	emeryturę	12	Fem
W naszej kantynie fabrycznej zmniejszono nam obiad o jedno danie .	kantynie	2	Fem
- W Janowie to była dziecinada .	dziecinada	5	Fem
Maksymalizację wydajności skrawania osiąga się dzięki maksymalizacji przekroju warstwy skrawanej i prędkości skrawania .	Maksymalizację	0	Fem
ZChN-owcy argumentują , że w klubie nie odbyła się żadna debata na temat polityki gospodarczej prowadzonej przez koalicję .	koalicję	17	Fem
Przed wojną jej osobiście nie znał em .	wojną	1	Fem
Ten , porwawszy swój kord , pobiegł za nim .	kord	4	Masc
Podajemy w miseczkach lub na talerzach .	miseczkach	2	Fem
Ponownie musiał użyć ręcznika .	ręcznika	3	Masc
Pierwsze i jedyne auto zatrzymało się przy nich dopiero po kilku kwadransach !	auto	3	Neut
Informacje na temat historii zen i różnych szkół znajdzie Czytelnik w chronologicznym zestawieniu najważniejszych wydarzeń z historii zen w Chinach i Japonii .	Czytelnik	9	Masc
Nie chciała jeść pizzy rodzinnej od tej kobiety .	pizzy	3	Fem
Zażerała się orzechami w czekoladzie i kasztanami mrożonymi , oblizując swoim obyczajem czubki palców .	czubki	12	Masc
Błogosławieństwa nowożeńcom udzielił ks. kanonik Wesołowski .	Błogosławieństwa	0	Neut
Jego zadaniem jest ponowne wylansowanie pojazdów tej marki w największym segmencie w Europie .	zadaniem	1	Neut
Istnieją też miasta , dla których nigdy nie ustaje karnawał .	karnawał	9	Masc
Dokonać charakterystyki Tatr na podstawie mapy wielkoskalowej .	charakterystyki	1	Fem
Planiści wypracowali już koncepcję drogi , na której przeobrażenie to winno się odbyć kosztem możliwie minimalnych ofiar .	przeobrażenie	8	Neut
Na trotyl natrafiono w miejscu , które wskazał radiesteta , zatrudniony przez rodzinę zaginionego .	trotyl	1	Masc
Między wami narasta konflikt , powietrze gęstnieje , znajomi pośpiesznie się żegnają .	powietrze	5	Neut
Należy tutaj zaznaczyć , iż w wielu przedsięwzięciach doradczych występuje konieczność współudziału kilku wymienionych typów doradztwa .	doradztwa	15	Neut
On pisał odę do Matki - Syberii .	odę	2	Fem
Uzywa Pan terminów , których pan nie zdefiniował .	terminów	2	Masc
Ula czuła radość .	radość	2	Fem
Kim jest strażnik łowiecki ?	strażnik	2	Masc
Barszczucha rozwinęła kabel i włączyła do kontaktu .	kontaktu	6	Masc
Henryk Sadurski , inżynier metalurg , nie ma pracy od kilku lat .	inżynier	3	Masc
Kolejny pijany policjant straci pracę .	policjant	2	Masc
- Nie jestem przestępcą . . .	przestępcą	3	Masc
Porządek musi być .	Porządek	0	Masc
W ostatniej minucie klęskę kolończyków przypieczętował Marcel Witeczek .	minucie	2	Fem
Janos wykonywał stoły , zydle , półeczki dla siebie , rodziny , sąsiadów , płacił nimi za pomoc przy gospodarstwie .	zydle	4	Masc
Policję zaalarmowała pracownica jednego z krakowskich szpitali .	Policję	0	Fem
Choć ja też znam dekalog .	dekalog	4	Masc
Przygoda u czoła Lodowca Hansa uświadomiła mi , że lepiej bezpośrednio nie dotykać lodowego klifu .	Przygoda	0	Fem
Radiotelegrafista skłonił się z uszanowaniem .	uszanowaniem	4	Neut
Zaczyna padać deszcz łez .	łez	3	Fem
W 2007 roku neurolodzy amerykańscy wyciągnęli je z muzeum i poddali badaniu rezonansem magnetycznym .	rezonansem	12	Masc
Życia nie wróci .	Życia	0	Neut
Zatrzymał doktorwagena przed samym wejściem , przywiązał lejce do barierki przy krawężniku , pogłaskał konia po chrapach i wszedł do królestwa Polizeiwachtmeistra Starkego .	lejce	7	Neut
Między miniaturowym arcydziełem a banalną grafomanią wyrasta obszar kompletnej pustki .	obszar	7	Masc
Część młodych osób chce pracować w państwowej firmie , bo to daje zabezpieczenie socjalne .	zabezpieczenie	12	Neut
Urodę stołu znakomicie podniosą antyczne lichtarze ze świecami , kryształy i srebra .	świecami	7	Fem
Adam wygrał ostatni etap , w lutym .	etap	3	Masc
Nie spowoduje żadnego niebezpieczeństwa dla otoczenia .	niebezpieczeństwa	3	Neut
Uniewinnienie przełożonych ich synów wstrząsnęło zbolałymi kobietami .	Uniewinnienie	0	Neut
Nie piszą o nim podręczniki , tradycja nie przekazuje jego zasług potomnym .	tradycja	6	Fem
Zdaniem lekarzy , szpitale cierpiące na brak pieniędzy podejmują drastyczne programy oszczędnościowe .	szpitale	3	Masc
Znał Andrzeja Zawadę i innych polskich himalaistów .	himalaistów	6	Masc
Napis czeka na policję .	Napis	0	Masc
Dziecko krzywdzone potrzebuje wszechstronnej pomocy .	Dziecko	0	Neut
- Wierzę , że kandydaci do członkostwa w NATO powinni spełniać generalne kryteria demokratycznych rządów i gospodarki wolnorynkowej , włączając w to poszanowanie dla praw człowieka oraz cywilną kontrolę nad wojskiem .	poszanowanie	22	Neut
Może wolał przemilczeć tragedię .	tragedię	3	Fem
Zaczynam odczuwać tęsknotę za utworami o głębszej treści i większym sensie .	sensie	10	Masc
Uczy się wykorzystania odpowiednich narzędzi .	narzędzi	4	Neut
Gdy zgasło światło , kamera pokazała , że zabawiali się ze sobą pod kołdrą .	kamera	4	Fem
Gdzie jest fabryka ?	fabryka	2	Fem
- Czy w zaświatach dalej puszczasz się z żydowskimi demonami ?	demonami	9	Masc
Mówi , że za komuny było lepiej , bo można było iść do sekretarza partii .	komuny	4	Fem
Powołanie Semaka wzburzyło pracowników opolskiej rozgłośni .	Powołanie	0	Neut
On należał do tych chłopaków , którym się udało , którzy na przemianie zyskali .	chłopaków	4	Masc
Zupełnie nie udał się start naszej pięciobojowej młodzieży w mistrzostwach świata w czwórboju nowoczesnym kobiet i mężczyzn w szwedzkiej Uppsali .	czwórboju	12	Masc
Trafiła do więzienia .	więzienia	2	Neut
Dzięki lekarzom , wsparciu rodziny i samozaparciu pokonał chorobę .	chorobę	8	Fem
Alkohol przestaje działać i ten czy ów zaczyna ziewać .	Alkohol	0	Masc
Podczas którejś kolacji wyznał , że przez kilkanaście lat uprawiał pięściarstwo .	kolacji	2	Fem
Na płachetce spał robotnik .	płachetce	1	Fem
Systematycznie prowadzili kontrole , zmierzające do ujawnienia różnego rodzaju piractwa .	ujawnienia	6	Neut
Ale wrażenia z tych dwu spotkań są odmienne .	spotkań	5	Neut
Kupili jakieś zmiotki w ruskiej hurtowni i zbijają na mnie kasę .	zmiotki	2	Fem
Czyżby muzyka w nim nie wzbierała , nie domagała się ujścia ?	ujścia	10	Neut
Jego karogga zagłębiła się w płomienie , sięgnęła czegoś twardego .	karogga	1	Fem
Przy wynoszeniu rannego w pojedynkę ujmujemy go oburącz pod ramiona .	wynoszeniu	1	Neut
Teraz wybiorą go spośród swego grona członkowie Rady .	grona	5	Neut
- Oczy bankiera wyrażały życzliwość i zaciekawienie .	Oczy	1	Neut
Hmmm ja mam ochotę na kebaba .	kebaba	5	Masc
Konkurs składał się z etapu ustnego i pisemnego .	Konkurs	0	Masc
Wszystko inne to pozory , dekoracje .	dekoracje	5	Fem
Otaczają one miasto od południa i zachodu .	południa	4	Neut
Przyszedł oto nierychło na wołanie Józefa .	wołanie	4	Neut
Nieruchomo stojąc w powietrzu nad kwiatami lecimy .	powietrzu	3	Neut
W tym wypadku także była pewna analogia w przeszłości .	analogia	6	Fem
Narażenie rozgrzanego psa na przeciągi grozi poważnymi komplikacjami ze zdrowiem .	przeciągi	4	Masc
– Ten komplet narzędzi służył do ćwiartowania korpusów .	narzędzi	3	Neut
Są już 233 ofiary zimy .	ofiary	3	Fem
Mimo obietnic złożonych pacjentom , stwardnienia rozsianego nadal nie ma na liście chorób przewlekłych .	chorób	12	Fem
Hazard pochłonął go bez reszty .	Hazard	0	Masc
Ceny towarów i usług od stycznia ubiegłego roku wzrosły o 10,1 proc .	usług	3	Fem
Leżał już ubrany w trumnie .	trumnie	4	Fem
Ceną za to opóźnienie okazał się udział w rynku francuskim .	opóźnienie	3	Neut
- Szczęka mi opada .	Szczęka	1	Fem
Bydgoszczanin ogłosił w prasie , że poszukuje panienek do pracy w Niemczech .	panienek	7	Fem
Potem zatopił w miąższu czarne palce .	palce	5	Masc
Na kapitał zagraniczny otwiera się też sektor bankowy i ubezpieczeniowy .	sektor	6	Masc
- Stwierdzam , że Sejm odrzucił poprawkę Senatu bezwzględną większością głosów .	większością	9	Fem
Na trasie przejazdu stały tłumy oklaskując samochody , które wiozły maleństwa i ich rodzinę .	przejazdu	2	Masc
Zagonił go aż na drzewo .	drzewo	4	Neut
Dla tej ojczyzny nawet lepiej było , kiedy owi emigranci nie odwracali się za siebie , nie próbowali powrotu .	emigranci	9	Masc
I wróżą dobrą pogodę do inwestowania w akcje .	inwestowania	5	Neut
Powoduje bowiem utratę białka ze skóry i krwi , podczas jej stosowania maleje masa serca i spada wskaźnik podstawowej przemiany materii .	białka	3	Neut
Chodziło o wyliczenie przyczyn bezrobocia na wsi .	bezrobocia	4	Neut
Ciągnął je ukryty wewnątrz drewnianego pudła muł .	muł	6	Masc
Andrew dodatkowo zażyczył sobie jajecznicę na boczku , bo stwierdził , że po tak cienkim śniadanku nie dotrwał by do obiadu .	boczku	6	Masc
Lampa gaśnie .	Lampa	0	Fem
Szukając zysku , musiały ryzykować .	zysku	1	Masc
Trzydzieste piąte Targi zostały rozpoczęte .	Targi	2	Masc
Niestety , wbrew pozorom inflacja nie pomaga bezpośrednio giełdom .	pozorom	3	Masc
To okres na zamykanie , kończenie różnych spraw .	zamykanie	3	Neut
Lepiej mieć czyste sumienie .	sumienie	3	Neut
Lęk przed nicością łączy się z doświadczeniem pustki .	doświadczeniem	6	Neut
Książę Andrzej Poniatowski , porucznik armii francuskiej , odwiedził Polskę w roku 1919 jako członek francuskiej misji wojskowej .	misji	16	Fem
Przebiegające pod miastem chodniki kopalni zalano wodą , a wzgórze zgniło i zapadło się w ziemię jak przydeptane .	kopalni	4	Fem
Pozostałoby do rozstrzygnięcia pytanie , dlaczego paradoks , występujący w odniesieniu do przenoszenia masy i energii w przeszłość , nie obowiązuje w stosunku do przyszłości .	masy	13	Fem
Sekretarz Łapa społecznie działa w poradni małżeńskiej , ale z podobnym postępowaniem kobiety nie spotkał się .	postępowaniem	11	Neut
Zbrodnia była dokonana pod Urlami .	Zbrodnia	0	Fem
Na Ziemi Lubuskiej prace przedsiewne , zwłaszcza na glebach lekkich przybierają na sile .	glebach	8	Fem
Aż siedem kraks spowodowali motocykliści .	motocykliści	4	Masc
Przed rozpoczęciem zdjęć przez dwa tygodnie spotykali śmy się na próbach .	rozpoczęciem	1	Neut
Czy ty masz duszę i sumienie ?	sumienie	5	Neut
Radio zapisuje tekst komunikatu .	komunikatu	3	Masc
Steve zaklina się , że po każdym dyżurze szykuje ekstra posiłek czworonożnemu ratownikowi .	ratownikowi	12	Masc
Że nie potrafi kupić żadnego piłkarza do Legii .	piłkarza	5	Masc
Wojsko się skasuje .	Wojsko	0	Neut
Gdzieś tam w toalecie cicho zaskrzypiały drzwi , a na dużej sali czyjeś kroki szybko zdążały w tę stronę .	kroki	13	Masc
Zwycięzcy grup awansowali do półfinałów .	Zwycięzcy	0	Masc
W ten sposób zaaprobowane zostało wstępne porozumienie , osiągnięte w ubiegłym roku przez ministrów zdrowia Piętnastki .	ministrów	13	Masc
Działajmy nocą , najlepiej na kolanach .	kolanach	5	Neut
tam jest łazienka . .	łazienka	2	Fem
Akurat wtedy , gdy kadrowicze rozpakowywali w Warszawie swój sprzęt po powrocie ze zgrupowania w Barsinghausen , w kościele w Kazimierzu zebrał się tłum wiernych , który modlił się o powodzenie naszej drużyny w zbliżających się mistrzostwach świata .	powodzenie	30	Neut
Polska winna się wyrzec tradycji , mumii , księcia Józefa i teatru .	tradycji	4	Fem
Zachłanność i zawiść , zazdrość i nienawiść kurczą wszystkie twarze .	twarze	9	Fem
Oficer wyszedł , rencistka odkręciła gaz .	Oficer	0	Masc
Zazwyczaj młodym kobietom z zagranicy , zwabionym i przymuszanym do nierządu , sutenerzy odbierają paszporty .	kobietom	2	Fem
Nerwy jej niepotrzebnie puściły .	Nerwy	0	Neut
Ktoś szarpnął wrota i karczma zaczęła się zapełniać .	karczma	4	Fem
Nawet nie wiedział em , że pisze ona także poezję .	poezję	9	Fem
To była elektryczna maszynka do golenia .	maszynka	3	Fem
Ogromnym wzięciem cieszą się przed sezonem urlopowym jednorazowe nakładki toaletowe .	wzięciem	1	Neut
Złamanie tego zakazu powinno spowodować odwołanie faceta z funkcji .	Złamanie	0	Neut
Na ganek wyszła starsza pani , ubrana w niemodną sukienkę z koronkowym kołnierzykiem i mankietami .	mankietami	14	Masc
Tegoroczną nowością raportu jest skala krajowego seksu wirtualnego .	skala	4	Fem
- Wierzę , że kandydaci do członkostwa w NATO powinni spełniać generalne kryteria demokratycznych rządów i gospodarki wolnorynkowej , włączając w to poszanowanie dla praw człowieka oraz cywilną kontrolę nad wojskiem .	wojskiem	30	Neut
Gdy dojeżdżał do bramy ogrodzenia , spojrzał za siebie .	ogrodzenia	4	Neut
Najbliżsi rywale Orfe także nie rezygnują z przejęcia kolejnych mniejszych dystrybutorów .	rywale	1	Masc
Rzecz dotyczy berlińskiej olimpiady w 1936 roku i przynależności państwowej triumfatora .	triumfatora	10	Masc
Poznał kosmetyczkę i przybory toaletowe .	przybory	3	Masc
Przed wejściem do parku wszyscy zostali wyposażeni w lornetki .	wejściem	1	Neut
W całej Europie myślistwo to hobby , za które się płaci !	myślistwo	3	Neut
Wtedy Bóg złapie to całe towarzystwo łącznie ze mną i wrzuci w ogień piekielny , a będzie tam płacz i zgrzytanie zębów .	zębów	21	Masc
Na ekranie TV , na zatrzymanej stop–klatce Jurka Kilera idą napisy końcowe programu .	stop–klatce	6	Fem
Odstąpienie od sprzedaży Kuźni nie skutkowałoby jednak karami za zerwanie umowy przedwstępnej .	karami	7	Fem
Budynek będzie miał elewację w tonacji pistacjowo - kremowej .	elewację	3	Fem
Poznali śmy też nowych drugoligowców .	drugoligowców	4	Masc
Policja z uwagi na prowadzone wciąż czynności operacyjne nie ujawnia szczegółów dotyczących tej sprawy .	szczegółów	10	Masc
Oznacza to , że odbierze każde przychodzące wywołanie .	wywołanie	7	Neut
Jest to istotne , zwłaszcza dla internautów korzystających z modemów .	modemów	9	Masc
Podstawowe terminy powstały podczas badań lodowców w górach umiarkowanej strefy klimatycznej .	górach	7	Fem
Pomaga w sprzątaniu i wszelkich kłopotach zdrowotnych .	sprzątaniu	2	Neut
Niezwyciężony lęk przed dziwem w każdym momencie serca przychodniów przeszywał .	lęk	1	Masc
Opiekę sprawuje opiekun .	Opiekę	0	Fem
Włącza radio , znajduje muzykę , wraca do naczyń .	naczyń	8	Neut
Balkon był pusty .	Balkon	0	Masc
Piłsudczycy nie dopuścili do dyskusji w Sejmie , który zresztą został rozwiązany 30 sierpnia 1930 r . , w połowie kadencji .	dyskusji	4	Fem
Najwyraźniej przebiegł przez holo tej reklamy .	reklamy	5	Fem
Cała delegacja była ubrana w czarne smokingi .	delegacja	1	Fem
Gorące spojrzenia towarzyszyły kandydatkom do korony podczas całego rejsu .	kandydatkom	3	Fem
Większość nie stosowała się do obowiązujących zakazów zatrzymywania i postoju .	postoju	9	Masc
- Lud jest nasz !	Lud	1	Masc
Twarz Gabrieli była szara .	Twarz	0	Fem
Wyciągał jedynie wnioski z obszaru i potencjału państwa rosyjskiego twierdząc , że dwa mocarstwa , Rosja i Ameryka , określać będą przyszłość świata .	mocarstwa	13	Neut
Nietschke myślał chwilę o samotnym , smutnym ptaku .	ptaku	7	Masc
Odwołany rząd , który zostaje przez Sejm zmuszony do rządzenia , zwykle przestaje pracować .	rządzenia	9	Neut
W ten sposób Sejm miałby szansę mieć prawdziwy mandat społeczny .	szansę	5	Fem
W sidła oszustów - pośredników oferujących pracę Polacy wpadają także w Hiszpanii .	pośredników	4	Masc
Kuskus przygotować według przepisu na opakowaniu , dodając 2 łyżki masła i szczyptę soli .	szczyptę	12	Fem
Tam kierowca forda , wymijając volkswagena golfa , uderzył w niego .	volkswagena	5	Masc
- Analfabetyzmowi wydali śmy zdecydowaną walkę , spodziewamy się niebawem zlikwidować go całkowicie .	Analfabetyzmowi	1	Masc
Według dyżurnego Komendy Miejskiej Policji w Chorzowie po przebudzeniu dziecka stwierdzono , że zostało ono upite .	Komendy	2	Fem
Andrzej Lepper miał zamówić wiersze podczas swoich urodzin .	urodzin	7	Neut
Czy mogę złożyć wspólne zeznanie z byłą żoną ?	żoną	7	Fem
W ostrym tempie przejechali sześćdziesiąt kilometrów na szosie modlińskiej .	tempie	2	Neut
Decyzja zapadnie dzisiaj rano .	Decyzja	0	Fem
Nakładamy rękawice ochronne , zapinamy swetry i wychodzimy na pokład .	rękawice	1	Fem
Członkowie nakielskiego stowarzyszenia podczas spotkania omówili główne cele swojej działalności .	cele	7	Masc
Za klechami Zyga nie jest .	klechami	1	Masc
- Niedługo będzie oczko .	oczko	3	Neut
Tematyka prac twórcy z Jarantowic jest różnorodna i w poważnym stopniu zależy od zapotrzebowania , od zamówień odbiorców .	zamówień	16	Neut
- Czy różnice interesów w koalicji nie przeszkodzą w kontynuowaniu reform ?	kontynuowaniu	9	Neut
W sprasowanych autach zginęły cztery osoby .	autach	2	Neut
Toż ja pisał em o monitorze komputera .	komputera	6	Masc
Hiszpański wicekról Argentyny kazał wysłać znalezisko do Madrytu .	znalezisko	5	Neut
Początek przedstawienia to bardzo delikatny moment wchodzenia w fikcję .	wchodzenia	6	Neut
Sanitariusz wyciągnął ze skrzyni dwa gumowe fartuchy .	skrzyni	3	Fem
Eli chwycił wiadra i ruszył za nią kamienistą dróżką .	wiadra	2	Neut
- Sapnęła , ale pod warstwą chłodu zamajaczyła iskierka rozbawienia .	chłodu	6	Masc
A więc teraz szczodrze wynagrodzi mu niedosyt !	niedosyt	6	Masc
Listę tę prezydent Stanów Zjednoczonych przekazał w poniedziałek innym państwom .	państwom	9	Neut
Komisja Europejska traci cierpliwość .	cierpliwość	3	Fem
Tym razem postawiono na casting także w mniejszych miastach .	miastach	8	Neut
Swą ważność utraciły one w czerwcu .	ważność	1	Fem
Ilość plam pulsujących w jego oczach mnożyła się w zastraszającym tempie .	tempie	10	Neut
Wybrałbyś życie matki czy świni przy tej operacji przeszczepu wątroby ?	przeszczepu	8	Masc
Sądził em , że szarość nie powinna być niema .	szarość	4	Fem
Siła uderzenia wbiła renaulta w innego tira .	uderzenia	1	Neut
" W dzieciństwie byłem często rozpieszczany przez mamę , ale tato mnie lał " .	mamę	7	Fem
W kontekście emocjonalnych , osobistych wypowiedzi ta budzi podejrzenie o nieautentyczność .	podejrzenie	8	Neut
Na cóż pogłębiać straszliwy kryzys ?	kryzys	4	Masc
Śmieszy mnie ta zabawa w barbarzyńcę , bezmyślne opróżnianie butelek pod krzyżówkę Mickiewicza z amerykańskim hamburgerem .	opróżnianie	8	Neut
Rosną tutaj , w okolicy , całe sady jarzębinowe .	sady	7	Masc
Tylko wyszła z koła dwa razy .	koła	3	Neut
Stan termiczny lodowca jest rezultatem współdziałania kilku procesów .	współdziałania	5	Neut
Jest to duże urządzenie , ale dzięki wprowadzonym ostatnio znacznym usprawnieniom łatwe jest jego obsługiwanie .	urządzenie	3	Neut
Ale ambicja kazała mu natychmiast odrzucać obrzydzenie i opory .	opory	8	Masc
Jego anegdoty traktowały o najrozmaitszych księżach dziwakach , których w okolicy nie brakło , a których przygody tchnęły często humorem z epoki Seweryna Soplicy czy nawet Paska .	humorem	19	Masc
Przewaga któregokolwiek układu skurczowego lub niedowład któregokolwiek układu rozkurczowego powoduje skurcz mięśni gładkich oskrzeli .	skurcz	10	Masc
Wojna tak długo nie potrwa .	Wojna	0	Fem
Pogoda psuła się .	Pogoda	0	Fem
Hindusi i ja wybrali śmy się na zielone gołębie .	gołębie	8	Masc
Osadza się na odzieży oraz trwałych nieprzepuszczalnych powierzchniach takich jak beton czy asfalt .	powierzchniach	7	Fem
Jeden hotel musiał być oddany po wygaśnięciu dzierżawy , drugi sprzedano , aby pokryć dług w Funduszu Społecznym Żołnierza .	wygaśnięciu	6	Neut
Mówiły one o uniezależnieniu się Prus Książęcych od Polski .	uniezależnieniu	3	Neut
Mamy dziesięcioletnie doświadczenie z samorządami gminnymi .	samorządami	4	Masc
Wojsko się skasuje .	Wojsko	0	Neut
- Nasi żarłoczni przyjaciele ciągle są w amoku . . .	amoku	7	Masc
Receptą Hewitta na zmianę tego stanu rzeczy jest odformalizowanie fizyki .	odformalizowanie	8	Neut
Największy na świecie producent sieci komórkowych zamierza skupić się na podstawowej działalności , a aparaty będzie kupował od producenta zewnętrznego z siedzibą w Singapurze i tylko sygnował je własnym znakiem towarowym .	siedzibą	21	Fem
- Czy reżyser z pewnym sukcesem , taki jak pan , może sobie w Polsce jakoś zaplanować karierę ?	reżyser	2	Masc
A znał arytmetykę ?	arytmetykę	2	Fem
Zatrzymanym przedstawiano zarzuty udziału w zorganizowanej grupie przestępczej i wprowadzenia na rynek narkotyków .	narkotyków	12	Masc
Ten okres minnesangu zakończył się w ostatniej dekadzie XII wieku , gdy naśladownictwa ustąpiły nowym tematom i formom wypracowanym przez miejscowych poetów .	formom	17	Fem
W schronisku tym przebywają bezdomne dzieci ze swoimi matkami .	schronisku	1	Neut
Fluor uszkadza nerki , zmniejsza odporność na infekcje i sprzyja rozwojowi alergii .	nerki	2	Fem
Rośnie pokolenie ludzi straconych , wyrzuconych . . .	pokolenie	1	Neut
Przez godzinę z boiska wiało nudą , a piłkarze prezentowali futbol plażowy .	futbol	10	Masc
Świadkowie twierdzą , że spod siedziby SdRP odjechało w ostatnich kilkunastu miesiącach kilka takich grup .	siedziby	5	Fem
Dankowski objął Bełchatów na początku sezonu , a pierwszej porażki doznał dopiero w siódmej kolejce .	sezonu	5	Masc
Śledztwo przeciwko świadkowi koronnemu zostanie umorzone dopiero , gdy bez zarzutu wypełni swoją rolę .	świadkowi	2	Masc
To okres na zamykanie , kończenie różnych spraw .	kończenie	5	Neut
Ci z dołu łapią ich za nogawki , żeby ściągnąć do swojego poziomu .	nogawki	6	Fem
Nie wstąpi jego stopa junacka w strzemiona ojcowe .	strzemiona	6	Neut
Co kwartał wysokość tych kwot może się zmienić w związku ze zmianą ceny metra kwadratowego ogłaszaną przez GUS .	zmianą	11	Fem
Podróżujący pierwszą klasą będą odtąd mogli wypoczywać podczas lotu na rozkładanych podwójnych siedzeniach .	klasą	2	Fem
Antybiotyki to związki chemiczne wytwarzane w naturze przez same drobnoustroje .	drobnoustroje	9	Masc
Truchtali spokojnie , bez pośpiechu , z przodu dostrzegli sylwetkę w zielonym mundurze , zbliżyli się powoli .	mundurze	12	Masc
Są to jedynie najważniejsze , opisane dość pobieżnie , zranienia w dziedzinie seksualnej , które wymagają uzdrowienia .	uzdrowienia	16	Neut
To zwierzę wyróżnia się umiejętnością niesienia pomocy .	niesienia	5	Neut
Chodzi o to , żeby demonstracje odbywały się w spokoju , żeby w minimalnym stopniu zakłócały życie innych ludzi i żeby nie było polską normą bicie policjantów , okupowanie budynków , wyrywanie znaków drogowych czy niszczenie samochodów .	okupowanie	28	Neut
Który nie dostarczył zboża na przemiał , będzie odpowiadał .	zboża	3	Neut
- Nie mogę już , kapralu , nie mogę .	kapralu	5	Masc
Wiatr przynosił ostry alkoholowy zapach traw .	traw	5	Fem
Ofiarą neofaszystów może być każdy , bo na zdjęciach są też ludzie , którzy jedynie znaleźli się w pobliżu różnych manifestacji .	Ofiarą	0	Fem
Przewiduje on wynajęcie firm zewnętrznych , które zajmą się utrzymaniem sieci abonenckiej TP SA .	utrzymaniem	9	Neut
Mieszkał em w domu polskich księży , niedaleko osobliwej piramidy , grobowca Cestiusza .	piramidy	9	Fem
Nie wyklucza się , że powodem wypadku było zaśnięcie kierowcy .	zaśnięcie	8	Neut
Tymczasem w bufecie panna Tola czyściła koszyki do chleba .	bufecie	2	Masc
Kobieta w fartuchu sprzedaje jej papierowy bilet .	fartuchu	2	Masc
Dyrektor archiwum na Łubiance przekazał te materiały synowi Stanisława Głąbińskiego .	archiwum	1	Neut
Nakazał też zdemontowanie istniejących terminali .	terminali	4	Masc
Kilka razy pociągnął nosem .	nosem	3	Masc
Leki na obniżenie temperatury nie działały , a sytuacja , według słów Havlovej , w nocy z poniedziałku na wtorek stała się krytyczna .	temperatury	3	Fem
Jeśli spojrzymy na inicjatywę polityczną liderów pierwszej dziesiątki , to okaże się , że aż szóstka zaczynała swą karierę w PZPR .	karierę	18	Fem
Dębski z przyjemnością zapadł w kąt kanapy .	kąt	5	Masc
Aspirant przerzucił kilka kartek w notesie .	kartek	3	Fem
Unosiła się wokół nich anielska aura .	aura	5	Fem
Znacznie lepiej zagrał przed przerwą Kwapisiewicz na lewym skrzydle .	skrzydle	8	Neut
Policjanci z pobliskiego komisariatu przyznają , że docierają do nich sygnały o rozbojach .	komisariatu	3	Masc
Wszystko zniechęca do prowadzenia dziennika .	dziennika	4	Masc
Ciało , które ginie , jest jedynie opakowaniem dla duszy .	opakowaniem	7	Neut
Amerykanie patrząc zza Oceanu na Europę myślą niemal wyłącznie kategoriami strategicznymi i gospodarczymi .	Oceanu	3	Masc
Proboszcz wzniósł oczy w sufit i westchnął o świętą cierpliwość .	Proboszcz	0	Masc
Nim przekroczy granice raju , musi wyrazić skruchę .	skruchę	7	Fem
Na piątym był ostatni etap .	etap	4	Masc
Na tej klepce bracia mocno się poślizgnęli .	bracia	3	Masc
Jak zwykle , kiedy wpadał w falset , uderzał laską o podłogę .	falset	6	Masc
Kłótnia trwa .	Kłótnia	0	Fem
Krzywulą wędrowca podwajał stare swe kroki .	Krzywulą	0	Fem
Po odbyciu kary Zdankiewicz znów brylował w podrzędnych knajpach .	kary	2	Fem
A seks jest przymusem .	przymusem	3	Masc
Dlatego uniknęli śmy krwawej dyzenterii lub tyfusu .	tyfusu	6	Masc
Na bezdomne po Powstaniu Warszawskim dwie głośne pisarki czekały w Łodzi zarezerwowane dla nich mieszkania .	pisarki	7	Fem
Już we wtorek prezydent Kwaśniewski wybiera się z roboczą wizytą do Paryża , by przekonywać do naszych racji prezydenta Jacquesa Chiraka .	wizytą	9	Fem
Zamek chętnie zwiedzają cudzoziemcy .	cudzoziemcy	3	Masc
Latem ubiegłego roku Kubańczyk przybył do kliniki wrocławskiej .	Latem	0	Neut
Wykręcił się na pięcie i wybiegł na dwór z rozpaloną głową .	dwór	7	Masc
Istnieje wiele mechanizmów powstawania oporności wśród bakterii chorobotwórczych .	oporności	4	Fem
Doznał poważnych obrażeń ciała i przebywa w szpitalu .	obrażeń	2	Neut
Czy gdzieś było gniazdko elektryczne ?	gniazdko	3	Neut
Naprawdę rzadko zdarza mi się puszczać tak głupie bramki .	bramki	8	Fem
Z pism Slazskiej Energetiki wynika , że opalana węglem nowa elektrociepłownia w Trzyńcu będzie spełniała wszystkie europejskie normy ekologiczne .	Energetiki	3	Fem
Cichociemni spotkali się w GROM-ie .	Cichociemni	0	Masc
Ostatnim akcentem uroczystości było wciągnięcie flagi państwowej na maszt w Dworze Artusa .	maszt	8	Masc
Sprawą zajmują się policjanci z 6 komisariatu na Górnej .	komisariatu	6	Masc
Na tym zapleczu też w istocie opiera się jednostkowa , personalna władza generała de Gaulle'a .	zapleczu	2	Neut
Miał eś żonę i trzech braci .	żonę	2	Fem
Widać , że gabinet Millera stopniowo traci kontakt z rzeczywistością .	rzeczywistością	9	Fem
Już nie patrząc na niego , sięgnęła do gumy majtek .	gumy	8	Fem
Struś nic nie szczerzy .	Struś	0	Masc
Zachód nadal robi groźne miny , mimo uspokajającego wystąpienia Klasy .	Klasy	9	Fem
Dziecko niespodziewanie wsiadło do czekającej na piętrze windy .	Dziecko	0	Neut
W ciągu godziny można było zaobserwować około stu meteorów .	meteorów	8	Masc
Dziewczynka prawidłowo szła poboczem .	poboczem	3	Neut
Polska i Izrael podpisały wczoraj umowę o zniesieniu obowiązku wizowego .	zniesieniu	7	Neut
Po urodzeniu odżywia się mlekiem matki .	urodzeniu	1	Neut
Przez uczony wywód autorki przewijają się dzieła współczesnych filozofów , od Ricoeura po Levinasa .	dzieła	6	Neut
Naukowcy z Uniwersytetu w Portland w USA sklonowali rezusa , czyli małpę należącą do rzędu naczelnych .	małpę	11	Fem
Truchtali spokojnie , bez pośpiechu , z przodu dostrzegli sylwetkę w zielonym mundurze , zbliżyli się powoli .	mundurze	12	Masc
- Uznał sprawę za skończoną i , nie zawracając sobie więcej głowy dziewczynkami , pomaszerował przez boisko .	dziewczynkami	12	Fem
Dankowski objął Bełchatów na początku sezonu , a pierwszej porażki doznał dopiero w siódmej kolejce .	porażki	9	Fem
Rzeczywiście prace organizacyjne nieco się opóźniły , ale już wkrótce biuro zacznie działać pełną parą .	biuro	10	Neut
Roboty finansowało w całości uzdrowisko .	Roboty	0	Neut
Dlatego też dojrzewanie w Chrystusie nie jest łatwe .	dojrzewanie	2	Neut
Tymczasem wiadomo , że 37-letnia gwiazda jest uzależniona od alkoholu i narkotyków .	gwiazda	5	Fem
Ma wnuczkę w takim wieku , że można się już z nią bawić .	wnuczkę	1	Fem
Zrobił em szybko dwa przysiady i skierował em się do łazienki .	łazienki	10	Fem
- Polska przez wiele lat korzystała z pomocy Zachodu .	Zachodu	8	Masc
Po trzecie , Iwan nie czytał oczywiście ani Freuda , ani ponurej antyutopii Williama Goldinga .	antyutopii	12	Fem
Wprowadzenie planu w życie wymaga uchwalenia bądź zmiany kilkunastu ustaw .	Wprowadzenie	0	Neut
Proboszcz wzniósł oczy w sufit i westchnął o świętą cierpliwość .	sufit	4	Masc
Z drugiej strony oskarżyciel potwierdza , że on sam w czasach próby był inny i pozostał inny .	oskarżyciel	3	Masc
Gospodarz milczał opuściwszy powieki , jakby się lękał zdradzić spojrzeniem .	spojrzeniem	9	Neut
Trwa dochodzenie w tej sprawie .	dochodzenie	1	Neut
Kanclerz Kiesinger wyraźnie oświadczył , że jego rząd uzależnia przystąpienie NRF do układu od szeregu warunków i w ogóle odkłada ten problem na nieokreślony termin .	przystąpienie	9	Neut
Połączono go z obchodami 70-lecia szkoły .	70-lecia	4	Neut
To poemat dla romantycznych głów .	poemat	1	Masc
Nacisnąłem przycisk piątego piętra , ale winda zatrzymała się na parterze .	przycisk	1	Masc
Świadkowie twierdzą , że przy nazwisku figuruje jego stopień .	nazwisku	5	Neut
W innych spotkaniach towarzyskich uzyskano następujące wyniki .	spotkaniach	2	Neut
Czy malował je kiedyś dla sprawdzenia samego siebie ?	sprawdzenia	5	Neut
Pies musi być podwórzowy , zły , w budzie na łańcuchu siedzący .	łańcuchu	10	Masc
Szafę widział wtedy .	Szafę	0	Fem
Taki jest głos ludu .	ludu	3	Masc
Nie dopuszcza żadnej kontroli , nie uznaje żadnych norm , nie widzi żadnych granic .	granic	13	Fem
- Czy polscy kierowcy zawodowi rzeczywiście są profesjonalistami ?	profesjonalistami	7	Masc
Wojna wdarła się w naszą młodość .	Wojna	0	Fem
Powstała nawet nauka o snach , nazywana onejrologią .	snach	4	Masc
Bez pardonu wpychały rzeczy do kieszeni i toreb .	pardonu	1	Masc
Z ciał potopionych stryjów wylęgły się tysiące myszy i wyruszyły wszystkie do Kruszwicy , prosto na dwór zbrodniarza .	dwór	16	Masc
Nie uważam , żeby na przykład Marksa szczególnie kompromitował romans ze służącą .	służącą	11	Fem
Najbliżsi rywale Orfe także nie rezygnują z przejęcia kolejnych mniejszych dystrybutorów .	dystrybutorów	10	Masc
MPK jest dziś spółką , od której samorząd kupuje przewozowe usługi .	usługi	10	Fem
Radny Eugeniusz Morta chciał przed głosowaniem usłyszeć silne argumenty za wydaniem tak dużej kwoty .	kwoty	13	Fem
Obcowanie z księgą może odbywać się w całkowitej pustce .	pustce	8	Fem
- Pisaliśmy razem komunikaty z posiedzeń TKK .	komunikaty	3	Masc
W Birkenau osadzono ich oddzielnie w podziemiach Bloku Śmierci .	Śmierci	8	Fem
ty próbowała ś to mleko dla dzieci ?	mleko	4	Neut
Dzięki temu pracownicy bardzo szybko ustalili , kto może być odpowiedzialny za zdarzające się coraz częściej w firmie tajemnicze manka .	manka	19	Neut
Jakieś światła błyszczą z prawej burty .	światła	1	Neut
To jest środowisko , które dzisiaj narzuca ton władzy w Polsce .	środowisko	2	Neut
Dzień po śmierci matka powiadomiła prokuraturę o popełnieniu przestępstwa przez lekarzy pogotowia .	lekarzy	10	Masc
Brzegi chodników były zastawione ławkami .	chodników	1	Masc
W sobotę podporucznik Ziemba przeniósł swoje łóżko do kuchni , rowery wstawiono do pokoju podporucznika Kowalika .	podporucznika	14	Masc
Antyterroryści spuścili się po linach ze śmigłowca wprost pod drzwi gangstera .	gangstera	10	Masc
Podrzuciłem kluczyki w dłoni .	kluczyki	1	Masc
Czy ich gospodynie nie prasują im na starość bielizny ?	starość	7	Fem
Zdesperowany doktor wlał płyn do dezynfekowania narzędzi chirurgicznych do dużego naczynia , włożył w płyn zaganiacza , zamieszał .	dezynfekowania	5	Neut
Miało płonąć mieszkanie na dziewiątym piętrze jednego z bloków .	piętrze	5	Neut
- Nie ma trybu .	trybu	3	Masc
Kiedy mijali ostatnie domy , Kajaki zbliżył się do wozu i położył łokieć na drabince .	drabince	14	Fem
Na farmę weszli dopiero z policjantami po 3 nad ranem .	farmę	1	Fem
Mężczyzna wpadł w ręce funkcjonariuszy dzięki opanowaniu .	opanowaniu	6	Neut
Nagle wzrok funkcjonariusza padł na pudło z płytami kompaktowymi bez hologramów .	płytami	7	Fem
Poznali się na weselu brata Edyty .	weselu	3	Neut
Miejsca rozgrywania spotkań zostały ustalone w drodze losowania w siedzibie Polskiego Związku Tenisa Stołowego w Warszawie .	siedzibie	9	Fem
Usiadła przy maszynie , taśma szybko biegła .	taśma	4	Fem
Szóstke miała m .	Szóstke	0	Fem
Wczoraj o incydencie szeroko informowała rosyjska prasa .	incydencie	2	Masc
Widać , że położył się w ubraniu , bo spod kołdry wystają stopy i nieco obszarpane nogawki spodni .	nogawki	16	Fem
Cofnął się jak oparzony , gdy fala obmyła mu łapy .	fala	6	Fem
Wykonany z asferycznych soczewek ze szkła fluorytowego , pozwala na uzyskanie bardzo dobrej jakości obrazu .	uzyskanie	10	Neut
Dobre imię dano ci na chrzcie , nasz drogi radco .	radco	9	Masc
( Przepisuję z karty po włosku dla większej autentyczności ) .	autentyczności	8	Fem
Stawiasz to na gazie .	gazie	3	Masc
Odzyskanie rodowej siedziby jest jednym z głównych celów Fundacji założonej w latach 90 . przez ks . Adama Czartoryskiego .	Odzyskanie	0	Neut
O zaliczeniu maszyny , urządzenia lub aparatu do odpowiedniej podgrupy decyduje jej przeznaczenie oraz konstrukcja i wyposażenie .	podgrupy	9	Fem
W kłamstwie czy w prawdzie , nie znam nic lepszego niż życie .	kłamstwie	1	Neut
Taka jest czasem droga do poezji , do liryki , do wyrażania Niewyrażalnego .	liryki	8	Fem
Prezes PiS-u piątkowym wystąpieniem tę opinię potwierdził .	wystąpieniem	3	Neut
W aptekach prawdziwe oblężenie zapanowało jeszcze w ostatnich dniach starego roku .	oblężenie	3	Neut
Wojskowy kandydat nie rozdawał ulotek ze swoim programem wyborczym .	programem	7	Masc
W opinii BCC dzięki kompromisowi politycznemu , którego zwolennikiem był ekspremier , Polska jest obecnie gospodarczym tygrysem Europy Środkowo - Wschodniej .	ekspremier	10	Masc
Rok funkcjonowania wyższych szczebli samorządów nie upoważnia jeszcze do ocen .	szczebli	3	Masc
Kiedy nie mamy ochoty na towarzystwo , każdy ma swój pokój .	pokój	10	Masc
Interesująco wypadła sala wystawiennicza na poddaszu , chociaż widać , że w budynku jest jeszcze parę rzeczy do robienia .	poddaszu	5	Neut
Kia sephia , którą kierował 67-letni Henryk M . , nie zatrzymała się przed przejściem i potrąciła staruszkę .	przejściem	14	Neut
Statut określa zasady wynagradzania za użytkowanie tych wkładów .	Statut	0	Masc
Spojrzał nawet porozumiewawczo na babuszkę .	babuszkę	4	Fem
Liście są kolorowe .	Liście	0	Masc
Analiza krzywych wysychania ma duże znaczenie w aspekcie poznania reżimu cieków i rzek oraz rezerw wód podziemnych .	wysychania	2	Neut
Jadący motorem 22-letni mężczyzna na łuku drogi stracił panowanie nad pojazdem i uderzył w betonowe ogrodzenie .	panowanie	8	Neut
Obudziło mnie zimne dotknięcie .	dotknięcie	3	Neut
Ministerstwo Rolnictwa , które przed rokiem obłożyło miód importowany opłatami wyrównawczymi , opracowało długofalowy program rozwoju pszczelarstwa .	opłatami	9	Fem
Czy pan zna inżyniera Jarzęckiego ?	inżyniera	3	Masc
Z początkiem bieżącego roku Ministerstwo Oświaty i Wychowania podwyższyło uczniowskie stypendia .	Oświaty	5	Fem
Kobietom odpowiadał uwodzicielsko nastrojony głos ukrytego w jakiejś dziupli wodzireja .	Kobietom	0	Fem
Moja babka jest odważna .	babka	1	Fem
Czy w różnych stadiach ewolucji Wszechświata aktywne jądra galaktyk były identyczne ?	galaktyk	8	Fem
Korespondenci budapesztańskich gazet donoszą , że wielu miejscowych Węgrów wyjechało do krewnych na wieś albo uciekło na Węgry .	krewnych	11	Masc
Uczestniczki wysłuchały wykładów doradców zawodowych i prawników , uczestniczyły w zajęciach psychologicznych , poznawały podstawy obsługi komputera i korzystania z Internetu .	prawników	6	Masc
- A ja wam mówię , że jesteście na bańce .	bańce	9	Fem
Jedenaście dni po pojawieniu się opisanej wizji sennej czar zaczął działać .	pojawieniu	3	Neut
Jego kompan uważnie obserwuje teren .	kompan	1	Masc
Rządowy projekt chroni dzieci i młodzież .	młodzież	5	Fem
W niedzielę po parkiecie snuje się już tylko kilkanaście osób .	parkiecie	3	Masc
Umyte brokuły dzielimy na cząstki i układamy w naczyniu .	naczyniu	8	Neut
Po utrwaleniu ich w formalinie przekazał je do muzeum w Paryżu .	formalinie	4	Fem
Były one niezwykle rzadkie , nadające świątyni szczególne miejsce wśród wszystkich miejsc kultu na Pomorzu Gdańskim .	kultu	12	Masc
Wyschły źródła .	źródła	1	Neut
W momencie trafienia śmigłowiec znajdował się na wysokości około 1000 metrów .	trafienia	2	Neut
- Czy chcesz , niewiasto , wziąć udział w uroczystościach ku czci bogini Zirbanit ?	niewiasto	4	Fem
Nie wiedzą , że brak jednej maszyny ?	maszyny	6	Fem
Sprytny oszust jest przekonujący , swym ofiarom proponuje pozostawienie obrączki lub innej bezwartościowej rzeczy w zastaw i zwrot gotówki za kilkadziesiąt minut .	obrączki	9	Fem
Czemu godzę się na tortury pod obojętnym światłem wielkiej lampy ?	światłem	7	Neut
Szły dzieci przez pole minowe i wesoło machały rączkami .	rączkami	8	Fem
Wydawało się , że fiskus nie będzie dłużej gnębił Waldemara Gronowskiego , legnickiego piekarza , który przez ponad 10 lat rozdawał pieczywo najuboższym .	pieczywo	21	Neut
Potem opłukała naczynia i ustawiła na drucianej kratce , by obeschły .	naczynia	2	Neut
Poseł Włodzimierz Wasiński sądzi , że zmiany w rządzie nie ograniczą się do dymisji wicepremiera Janusza Tomaszewskiego .	dymisji	13	Fem
- Najprostszym sposobem ukrycia miejsca do pracy jest korzystanie z wsuwanych blatów .	korzystanie	8	Neut
Zimą , przylatując na popas do Polski , zadowala się pozostałymi na krzakach jagodami .	popas	4	Masc
– Próbował em teraz w lecie na jachcie .	lecie	5	Neut
Widownia westchnęła ze współczuciem , a Iwana to uskrzydliło .	współczuciem	3	Neut
W wielu przypadkach powoduje to albo likwidację działalności , albo popadanie tych organizacji w długi .	długi	14	Masc
Władysław P . miał też długi , był schorowany i zażywał duże ilości leków .	długi	5	Masc
Z każdym rokiem ruch osobowy i towarowy na przejściu granicznym w Chyżnem rośnie .	rokiem	2	Masc
Prócz akcji upowszechniania czytelnictwa wśród dzieci Warszawy , podjęła prace o charakterze ogólnym , często prekursorskim .	czytelnictwa	3	Neut
Pojawia się drapanie w gardle , wysypka , nagły spadek ciśnienia , duszność , trudności w oddychaniu , bóle brzucha .	gardle	4	Neut
Pawłowi M . zarzuca się również , że działał z zamiarem spowodowania ciężkiego kalectwa rzucając nożem w głowę włoskiego piłkarza Dino Baggio .	spowodowania	11	Neut
U młodej dziewczyny psychiatra z Modusa rozpoznał początki choroby psychicznej , dziewczyna myśli o samobójstwie .	początki	7	Masc
Trzeba rozstawić gmachy ministerstw w różnych punktach miasta , również na Pradze .	ministerstw	3	Neut
To już ich zmartwienie .	zmartwienie	3	Neut
W Kcyni odbyło się spotkanie z kandydatami na kierowników na samodzielny publiczny zakład opieki zdrowotnej w Kcyni i Kowalewku .	kandydatami	6	Masc
Stanisław Mróz prawie nigdy nie rozstawał się z dudami .	dudami	8	Neut
Polacy jadący w autokarze spoglądają z nietajoną dumą na wielkiego rodaka .	dumą	7	Fem
Użytkownik ma do dyspozycji 6 baz zawierających informacje posortowane według wybranego kryterium .	baz	5	Fem
On również myśli o przyszłości .	przyszłości	4	Fem
Zajmujemy się sobą , myślimy o swoich ambicjach , urazach .	urazach	9	Fem
W Niemczech płaci sie rolnikom za nieuprawianie ziemi .	nieuprawianie	6	Neut
Znaczna koncentracja tego gazu w przyziemnej warstwie atmosfery sprzyja więc podwyższaniu temperatury powierzchni Ziemi .	atmosfery	7	Fem
Dzieli wizja kierowania partią .	wizja	1	Fem
I z drżeniem serca zadzwonił em !	drżeniem	2	Neut
Lekarze opatrzyli stłuczenia , zwichnięcia i złamania u 14 pacjentów .	stłuczenia	2	Neut
Także w ubiegłym roku zniszczono nagrobki na cmentarzach w Gdyni i Kielcach .	nagrobki	5	Masc
W święta głodowało już sześciu pracowników MZK , przedwczoraj dwóch z nich odmówiło przyjmowania płynów .	przyjmowania	13	Neut
Neapolitańska policja zatrzymała czterech młodych Polaków pod zarzutem wymuszania pieniędzy i rabunku .	zarzutem	7	Masc
Większość z nas czuje się reklamami znudzona .	reklamami	5	Fem
Habit zwisał luźno z jej ramion .	ramion	5	Neut
Śmiał się wesoło , nacisnął dziewuszce nos , a ona obruszyła się , grożąc palcem .	dziewuszce	5	Fem
Sprytny oszust jest przekonujący , swym ofiarom proponuje pozostawienie obrączki lub innej bezwartościowej rzeczy w zastaw i zwrot gotówki za kilkadziesiąt minut .	pozostawienie	8	Neut
Dotąd absolutną większość w parlamencie mieli zwolennicy Radovana Karadżicia .	parlamencie	4	Masc
- Wysłaliśmy ponad 500 zapytań , systematycznie przeglądamy odpowiedzi i nie natrafiliśmy jeszcze na urzędnika , na którym ciąży prawomocny wyrok sądowy .	zapytań	4	Neut
Angażowały też prywatnych przewoźników .	przewoźników	3	Masc
Okazało się , że 22-latek jest żołnierzem służby czynnej .	żołnierzem	6	Masc
Pomimo smutnej wymowy , sztuka obfituje w sceny humorystyczne , można również posłuchać piosenek Wasowskiego i Przybory .	wymowy	2	Fem
Nad falami sterczał jeszcze tylko wystrzelający pionowo dziób .	falami	1	Fem
I taka sytuacja może powtarzać się w nieskończoność .	nieskończoność	7	Fem
Zgadzając się co do celu , uważamy , że metoda jego osiągnięcia nie jest dobra .	metoda	9	Fem
Ale wstrząsające relacje wywołały debatę na temat stosowania przymusu przy kontroli urodzin .	urodzin	11	Neut
Ostatnim wysiłkiem naprowadza płonący samolot wprost na wieżyczkę u-boota .	wieżyczkę	7	Fem
Dzięki nim zmniejsza się u chorego zaleganie afektu , rozładowują się utrwalone stereotypy uczuciowe , obiektywniej widzi swoją sytuację .	zaleganie	6	Neut
Mężczyzna doznał licznych obrażeń .	obrażeń	3	Neut
Na ramiona zarzuciła starą liliową chustę .	chustę	5	Fem
Jeżeli ciąża zagraża życiu matki , trzeba dokonać aborcji .	ciąża	1	Fem
Potem zadzwonił ksiądz Franciszek Blachnicki z gratulacjami .	gratulacjami	6	Neut
Poruszał rytmicznie kolanami , unosząc lekko siedzącą na nich kobietę .	kolanami	2	Neut
Tylko powszechne uwłaszczenie obywateli stwarza dla Polaków ostatnią szansę na uzyskanie realnych praw własności .	własności	13	Fem
Ogolić jaja na skina ?	skina	3	Masc
Trwają przygotowania do likwidacji Zakładu Naprawy Tramwajów w zajezdni przy ul . Gajowej .	likwidacji	3	Fem
Pod koniec gotowania dodajemy sos sojowy i na kilka minut pozostawiamy pod przykryciem .	sos	4	Masc
Na Siemiradzkiego wybrzydzali krytycy , ale publiczność uwielbiała jego obrazy .	krytycy	3	Masc
Wspieramy bezpieczną aborcję .	aborcję	2	Fem
Kiedy dziecko nie wróciło do domu , rodzina samodzielnie rozpoczęła poszukiwania .	poszukiwania	10	Neut
Więc jednak się znalazła rada !	rada	4	Fem
Popędzali swoje konie , bo koniecznie chcieli dopaść upatrzonej zwierzyny .	zwierzyny	9	Fem
Śpiącego , zielem odurzonego zabiła m sztyletem .	sztyletem	6	Masc
W wielu wsiach i miasteczkach do dzisiaj mieszkańcy kultywują sztukę ludową .	sztukę	9	Fem
Nie boi się pani tak improwizować w czasie swoich koncertów ?	koncertów	9	Masc
Miś Holender przysłał mu czerwone anemony i hiacynty na ostatek .	ostatek	9	Masc
Kiedy w Banja Luce skończył się ostatni , decydujący o medalu mecz , Halina leżała na parkiecie , a na niej kłębiła się góra ciał .	góra	23	Fem
Sterowali ruchem w pobliżu cmentarzy , kontrolowali trzeźwość kierowców poruszających się drogami województwa .	cmentarzy	4	Masc
Nie odpowiada ono na przykład prototypowi stalinowskiemu .	prototypowi	5	Masc
- Matce wyrwał by m serce .	serce	5	Neut
Wydeptuję schody , duszę dzwonki .	schody	1	Neut
- Nie mówiłem mu , kim jestem , ojcze .	ojcze	8	Masc
Skrzypnęły drzwi i Liść wszedł do środka .	środka	6	Masc
Kazancewa po raz ostatni widziano , gdy podróżował śmigłowcem w rejonie walk .	walk	11	Fem
To się nazywało teatr , ale to było mieszkanie cioci Lecha Emfazego .	teatr	3	Masc
Próbował bronić swej dyktatury , Osi , paktu z Hitlerem .	Osi	5	Fem
Nadal jednak będzie PSL przeciwnikiem gospodarki wolnorynkowej , partią w podejściu do gospodarki lewicową .	partią	8	Fem
Rodzice Agnieszki nie motywowali jej do nauki .	Rodzice	0	Masc
- A jaka to rola ?	rola	4	Fem
Mają zapewnić przychylność świata .	przychylność	2	Fem
Mózg pracował intensywnie .	Mózg	0	Masc
Moje pojawienie się w studiu przyjęto oklaskami .	studiu	4	Neut
Zwłaszcza przed znajomością z Affleckiem , kiedy była dziewczyną Brada Pitta .	znajomością	2	Fem
Gdzieś daleko warczał motor niewidzialnego samolotu .	motor	3	Masc
Po czym ogłoszono , że olimpiadę zawiesza się do odwołania .	olimpiadę	5	Fem
Taki stosunek nie może sprzyjać należytemu rozwojowi myśli twórczej wśród pracowników Stoczni , a tym samym przynosi straty państwu .	państwu	18	Neut
Z jego przepalonego i odsłaniającego rusztowanie kręgów gardła wydobył się syk .	gardła	7	Neut
Walka z pomówieniem jest jak walka z cieniem .	cieniem	7	Masc
Bawiąc się chwastami swojej simlah Manahem mrużył coraz podstępniej oczy .	simlah	4	Fem
To nasza ostatnia polemika z radnymi PO .	polemika	3	Fem
- A gdzie leżą ci , którzy pójdą do piekła ?	piekła	9	Neut
Czy wybór między czołowymi producentami nart jest istotny dla wyniku , czy to tylko kwestia pieniędzy ?	producentami	4	Masc
Porad rolnikom udziela w nim Janina Zielińska .	Porad	0	Fem
Natomiast zwierzęta znają lepiej .	zwierzęta	1	Neut
To znaczy , że konsjerżki miały rację .	konsjerżki	4	Fem
Wymaga to wielkiego samozaparcia i silnej woli , żeby nie ulec presji otoczenia .	otoczenia	12	Neut
Śpiewali całą gromadą .	gromadą	2	Fem
Powoduje bowiem utratę białka ze skóry i krwi , podczas jej stosowania maleje masa serca i spada wskaźnik podstawowej przemiany materii .	materii	20	Fem
Serduszka czekoladowe będą rozdawane w autobusach dla par .	par	7	Fem
Trąba zaś staje się w tych sprawach podstawowym kierunkowskazem .	Trąba	0	Fem
– Nie dokuczam , mamo !	mamo	4	Fem
Już dali upust swoim emocjom , nie hamowali łez .	emocjom	4	Fem
Celowo wyrażał em także inne wątpliwości .	wątpliwości	5	Fem
Stolicę zamieszkuje dziś 1,115.000 ludzi .	Stolicę	0	Fem
Wirują mu musztardowe księżyce i słońca , a na samym dole żagla zjawia się łeb wieloryba o mikroskopijnych , czerwonych oczach .	żagla	11	Masc
Do odgruzowania ulic nie brak ochotników .	odgruzowania	1	Neut
Winko odstawił em , bo mnie do grobu zaprowadzi .	Winko	0	Neut
Ciało znalazło nareszcie dla siebie miejsce .	Ciało	0	Neut
Cukier puder podać w osobnym naczyniu .	puder	1	Masc
Ufundowanie muzeum dla zbiorów Jasieńskiego było naturalnym odruchem obywatela , miłośnika sztuki .	obywatela	8	Masc
Sekcja zwłok wykazała , że przyczynami zgonu były zakrzepica żyły udowej , zator tętnicy płucnej i niewydolność krążeniowo - oddechowa .	niewydolność	16	Fem
Krzywulą wędrowca podwajał stare swe kroki .	kroki	5	Masc
Mój Piotrek uchodzi za speca w dziedzinie drewnianego budownictwa na Podhalu .	speca	4	Masc
Karolowi głowa pęka z bólu , całe ciało płonie .	bólu	4	Masc
Ludzie wyjechali w poszukiwaniu wygody .	poszukiwaniu	3	Neut
Na tym zapleczu też w istocie opiera się jednostkowa , personalna władza generała de Gaulle'a .	de	13	Masc
Z pozostałymi członkami dawnego kierownictwa związanymi z Gomułką plenum obeszło się bezceremonialnie , usuwając ich w większości ze składu KC .	kierownictwa	4	Neut
Cały kraj był zdławiony tym okropnym cieniem .	kraj	1	Masc
U nas takie imprezy są zupełną nowością , ale na Zachodzie to bardzo popularna dyscyplina .	Zachodzie	10	Masc
Z konarów i pni wyczarowywał dziwne figury przywołujące na myśl słowiańskich bogów .	bogów	11	Masc
Społeczeństwo wychowywano w ślepym posłuszeństwie wobec Cesarstwa .	Cesarstwa	6	Neut
Horti 2000 to także okazja do zapoznania się z najnowocześniejszymi sprzętami ogrodowymi , niezbędnymi nawozami , które sprawiają , ze nasza działka będzie obiektem zachwytu .	działka	21	Fem
Kołdra i ściągnięte z materaca prześcieradło dziwaczną draperią zwisało z łóżka .	Kołdra	0	Fem
Dzięki temu po wyjęciu dwóch foteli uzyskamy dodatkową powierzchnię bagażową .	wyjęciu	3	Neut
W wielkim domu znajdziesz dwie malowane brody .	brody	6	Fem
Do pupy polecam maść robioną w aptece .	aptece	6	Fem
Okulary od siebie z pokoju przynosi , druty za uszy zawija .	druty	7	Masc
Jeśli w młodości nie przyzwyczaimy organizmu do tego życiodajnego płynu , organizm przestanie wytwarzać laktozę , enzym niezbędny do trawienia cukru mlecznego .	płynu	9	Masc
Nie jedzmy margaryny .	margaryny	2	Fem
To samo dotyczy leczenia , służba zdrowia praktycznie przestała istnieć .	leczenia	3	Neut
Czy to ta niemoc grzybowa zwiastowała ?	niemoc	3	Fem
Większość wpływów banku z kredytów wynika z ich oprocentowania .	banku	2	Masc
Wojna i okupacja były tylko finałem , nieuchronnie wynikającym z samej istoty faszyzmu .	finałem	5	Masc
W styczniu radni Darłowa oficjalnie nadali swemu miastu miano królewskiego .	miastu	7	Neut
- Jeżeli można , Panie Prezesie . . .	Prezesie	5	Masc
Ambona była wyjałowiona .	Ambona	0	Fem
Tak już chyba na serio nie mówimy , a nasz cyniczny wiek jakąś aurę śmieszności wokół słowa zbudował .	śmieszności	14	Fem
Dzisiaj robotnicy zaczną frezować nawierzchnię .	robotnicy	1	Masc
Kibice przyjęli mnie niezwykle serdecznie .	Kibice	0	Masc
Zorganizowano również dla nich warsztaty rękodzielnicze z zakresu robienia na drutach , haftowania , tkania , wykonywania makram .	haftowania	12	Neut
Był brytyjski lotniskowiec , amerykańskie fregaty , hiszpańska piechota morska , portugalscy komandosi , polscy lotnicy .	fregaty	5	Fem
W czołówce znajduje się też słynna Zielona Budka , ale firma nie jest już polska .	czołówce	1	Fem
- Poszedł pod kościół .	kościół	3	Masc
W Wielkopolsce na nową maturę zdecydowało się 522 abiturientów .	maturę	4	Fem
Ponadto prezes powiadomił o przestępstwie tutejszą prokuraturę .	prezes	1	Masc
Każdy duży sklep samoobsługowy lub mięsny wyposażono w krajalnice do wędlin .	krajalnice	8	Fem
Zawahała się , chwyciła plik , położyła na stoliku i podniosła słuchawkę .	plik	4	Masc
- Ludzie starsi gubią się w technicznych problemach z tym związanych , a takie ciągłe zabawy ze zmianą pasma nadawania to brak szacunku dla abonentów .	zmianą	17	Fem
Kobieta z rozciętą głową i wstrząśnieniem mózgu trafiła do szpitala .	wstrząśnieniem	5	Neut
Na konferencji mówiono też o stanie gospodarki europejskiej .	gospodarki	6	Fem
jak skorzystać z usług akwizytora , a jednocześnie nie paść ofiarą przestępstwa ?	akwizytora	4	Masc
Shimada wyznaczył więc ludzi i za chwilę wnętrze góry poczęło błyskać upiornym światłem palników i ożywiło się znów koszmarną krzątaniną .	światłem	12	Neut
Pogotowie natychmiast odwiozło rannych pasażerów do szpitala w Rybniku .	Pogotowie	0	Neut
Stoję przed obliczem celnika .	celnika	3	Masc
Potem ból stał się tak silny , że przesłonił wszystko ciemnością pozbawioną woni i dźwięków .	dźwięków	14	Masc
Czy to znaczy , że Odessa podda się zukrainizowaniu ?	zukrainizowaniu	8	Neut
Samo pojęcie wywodzi się ze średniowiecznej filozofii .	pojęcie	1	Neut
Wydaje się , że powrót do pracy jest swoistym lekarstwem .	lekarstwem	9	Neut
Termin ten nie może przekraczać dwóch tygodni .	Termin	0	Masc
- Człowieku , ten nowy też już zdążył się zestarzeć .	Człowieku	1	Masc
Nigdy nie mieszkał em w żadnym schronisku .	schronisku	6	Neut
Przysiadł na oparciu fotela , objął mnie ramieniem .	oparciu	2	Neut
Nie czekając na decyzję Akcji , Unia Wolności zaczęła lansować na prezesa Karola Modzelewskiego , historyka i polityka związanego z Unią Pracy .	historyka	15	Masc
Czarodziejka usiadła , wracając do przerwanej czynności .	Czarodziejka	0	Fem
Wojskowy kandydat nie rozdawał ulotek ze swoim programem wyborczym .	kandydat	1	Masc
Małżonka krewnego przezornie schowała się do skrzyni i to ją uratowało .	Małżonka	0	Fem
Towarzyszyli mu polscy policjanci ze specjalnego wydziału zajmującego się deportacją z Komendy Głównej Policji .	deportacją	9	Fem
Zawsze można liczyć na zrozumienie i zaufanie kolegów , a wspólne poznawanie choroby pomaga zaakceptować fakt , że jest się alkoholikiem .	zaufanie	6	Neut
Nie puszczamy w powietrze materiałów obciążających .	powietrze	3	Neut
- Ostatnio powiedział Pan , że Trybunał zachował się w sprawie konkordatu jak Piłat .	konkordatu	11	Masc
Jeszcze sprawdza zapięcia uprzęży i sprawność swego radia .	zapięcia	2	Neut
Statut określa zasady wynagradzania za użytkowanie tych wkładów .	użytkowanie	5	Neut
Miał kochającą rodzinę , swoje pasje i marzenia .	marzenia	7	Neut
Może ma pan jakieś inne życzenie ?	życzenie	5	Neut
- Codziennie jest tu opiekunka pani Gabrysia .	opiekunka	4	Fem
Przez 26 lat pracował w Komendzie Rejonowej Policji w Jarosławiu .	Komendzie	5	Fem
Można pochwalić drużynę za walkę . "	drużynę	2	Fem
Obaj chorążowie zostali natychmiast zatrzymani i osadzeni w areszcie .	chorążowie	1	Masc
Mam prawo przypuszczać , że reakcje Polaków w takim wypadku odbiegały by od zachowania Amerykanów .	reakcje	5	Fem
- Zakłady i instytucje państwowe działają na podstawie decyzji urzędniczych .	instytucje	3	Fem
Jak to wygląda w praktyce ?	praktyce	4	Fem
Maturzyści - internauci zdający na pisemnym egzaminie język polski i historię najczęściej typują tematy związane z przełomem wieków .	tematy	13	Masc
Oczekując na swoją kolej , rozmawiają i oglądają filmy w świetlicy pod czujnym okiem opiekuna Rudolfa Dyrksa .	kolej	3	Fem
500 chuliganów zorganizowało protest przeciw złej sytuacji finansowej klubu .	chuliganów	1	Masc
Chód ich był jak muzyka .	Chód	0	Masc
Etiopczycy kontynuują atak , choć pod koniec ubiegłego tygodnia władze Erytrei poinformowały o wycofaniu swych oddziałów ze wszystkich spornych terenów nadgranicznych .	wycofaniu	13	Neut
W ubiegłym roku trzynastki pochłonęły 54.537 złotych .	trzynastki	3	Fem
Ale on już nie mógł powstrzymać się od mówienia .	mówienia	8	Neut
Nauczyciel szybko uporał się z zakupami i , nie powracając już do poprzedniego tematu , z widoczną ulgą pożegnał chałupniczkę .	Nauczyciel	0	Masc
Różnica między tymi ugrupowaniami jest niewielka .	Różnica	0	Fem
Chociaż zimą też można się świetnie bawić .	zimą	1	Fem
33-letniemu mężczyźnie przedstawiono zarzut usiłowania zabójstwa ochroniarza .	ochroniarza	6	Masc
Po kilku godzinach wycofuje oskarżenia .	oskarżenia	4	Neut
Zza kamiennej podpory mostu , kilkanaście metrów od brzegu słychać było wołanie o pomoc .	podpory	2	Fem
W Charkowie 300 osób odkryło ostatnio karaimskie korzenie .	korzenie	7	Neut
Gospodarstwo Stanisławy Sowy , Irki Paulako i Moniki Niebrzydowskiej rozszerza się powoli poza obręb zabudowań gospodarskich .	Gospodarstwo	0	Neut
Ochmistrz ma otwartą kabinę , dla przyzwoitości pukam w uchylone drzwi .	kabinę	3	Fem
Gdy wchodziła w życie reforma edukacji , Jerzy Buzek otwierał rok szkolny i prezentował gimbusy .	gimbusy	14	Masc
- Strajk nie zostanie przerwany .	Strajk	1	Masc
Czy senator rzuci rękawicę wszechwładnemu przewodniczącemu ?	rękawicę	3	Fem
Przygrywały kapele , występowały zespoły i soliści .	soliści	6	Masc
Do oficjalnych transportów robotnicy dorzucali swoje ładunki .	transportów	2	Masc
Nagrody przyznała specjalna Kapituła , pragnąc uhonorować osoby i instytucje , których działalność wniosła znaczący wkład w krzewienie tolerancji .	krzewienie	17	Neut
Bardzo podobał mu się plac Centralny , wszechobecna symetria i wolne przestrzenie .	symetria	8	Fem
A poza tym , w kwestiach kuchni w szkołach i sprzątania szkół , dobrem dzieci zasłania się przede wszystkim chęć utrzymania własnego stołka .	kwestiach	5	Fem
- Spojrzał triumfalnie po obecnych , jakby przypuszczał , że ktoś mógł by nie znać tego cytatu .	cytatu	16	Masc
Według relacji świadków , gdy biały opel frontera zbliżył się do ambasady , wyskoczył z niego człowiek ubrany w panterkę , z granatnikiem w ręku , i próbował odpalić granat w kierunku ambasady .	granatnikiem	22	Masc
Po ukończeniu zakopiańskiej Szkoły Przemysłu Drzewnego i warszawskiej ASP osiadł w Zakopanem .	ukończeniu	1	Neut
Nagrody i poczęstunek był dla wszystkich , a najlepsi zawodnicy otrzymali ponadto puchary .	poczęstunek	2	Masc
koło tesko jest tektilandia i tam też są ładne .	tesko	1	Neut
Rodzice nie będą już mogli wmawiać swoim pociechom , że przynosi je bocian bądź znaleziono je w kapuście .	kapuście	17	Fem
Nigdy nie budował fantastycznych hipotez .	hipotez	4	Fem
- To te sosny za torami ?	sosny	3	Fem
– Robię to tylko z nudów .	nudów	5	Fem
W zaborze rosyjskim po śmierci Aleksandra II , który zginął w zamachu terrorystycznym , nastąpiło gwałtowne zaostrzenie polityki represyjnej we wszystkich dziedzinach życia publicznego .	dziedzinach	21	Fem
Marta straciła orientację w najprostszych sprawach .	orientację	2	Fem
Czemu godzę się na tortury pod obojętnym światłem wielkiej lampy ?	tortury	4	Fem
Zaczął em się obawiać , że wyrządził em mu krzywdę .	krzywdę	9	Fem
Rządy muszą się z nimi porozumieć w każdej poważniejszej sprawie .	Rządy	0	Masc
– Listę masz ?	Listę	1	Fem
Halina Auderska we wszystkich książkach każe swoim bohaterom szukać tożsamości .	bohaterom	7	Masc
Kiermasze te zapowiadały Wielki Tydzień , który charakteryzował się postem i wyrzeczeniami .	wyrzeczeniami	11	Neut
Nawet dla słabo zorganizowanych grup , przewalanie towaru będzie kaszką z mlekiem .	mlekiem	11	Neut
- Pozwólmy mu trochę pomyśleć nad swoimi manierami .	manierami	7	Neut
Z jakiego powodu tak zaskoczyło ono paleoantropologów ?	paleoantropologów	6	Masc
Izydor znieruchomiał z kopiowym ołówkiem nad blankietem reklamacyjnym .	blankietem	6	Masc
Proszę uzgodnić z recepcją terminy , przełączam .	terminy	4	Masc
Większość to uciekinierzy i ich potomkowie .	uciekinierzy	2	Masc
Na tej podstawie otrzymają diety , od 1500 do 2000 złotych .	diety	4	Fem
Była to procedura dość długa i niezbyt przyjemna .	procedura	2	Fem
Liczb jeszcze nie ma , ale powinny pojawić się w najbliższym czasie .	Liczb	0	Fem
Wyróżniał się licznymi szybami górniczymi , kryjącymi w swych wnętrzach wieże wyciągowe i windy do przewozu ludzi i węgla .	przewozu	15	Masc
Do dziś w sądownictwie pracują osoby , które rozpoczynały swoją karierę w latach stalinowskich .	sądownictwie	3	Neut
Adams odpowiedzialnością za tę porażkę obarczał Hamiltona i jego ludzi , którzy doprowadzili do rozłamu wśród federalistów .	federalistów	16	Masc
Pałęczkę przejęła Ciri .	Pałęczkę	0	Fem
Miłość nie jest wzajemną zależnością , ani uzależnieniem .	zależnością	4	Fem
Francuskie Zgromadzenie Narodowe uchwaliło wczoraj kontrowersyjną ustawę o skróceniu obowiązkowego tygodnia pracy z 39 do 35 godzin .	skróceniu	8	Neut
Nagrali razem pierwszą płytę .	płytę	3	Fem
Tata musiał pojechać do domu .	Tata	0	Masc
Rok funkcjonowania wyższych szczebli samorządów nie upoważnia jeszcze do ocen .	samorządów	4	Masc
Dotychczasowa siedziba Archiwum jest przede wszystkim za mała w stosunku do wzrastających w szybkim tempie zbiorów .	Archiwum	2	Neut
W tej lecznicy usunięto pacjentce martwą ciążę , a także macicę i fragment jelita .	jelita	13	Neut
Z relacji świadków wynika , że 60-latek nagle upadł .	60-latek	6	Masc
Mężczyzna z sumiastymi wąsami nazwany kawalerem wyraźnie się speszył .	wąsami	3	Masc
Jeżeli nasz samochód to combi lub van , a zwierzak jest duży , możemy przewozić go w odpowiednio przygotowanym bagażniku .	van	6	Masc
Ja stoję w bruździe i w uniesionej ręce trzymam zapalony fanarek .	fanarek	10	Masc
Zza kulis wychodzi aktorka grająca Magdalenkę .	aktorka	3	Fem
Dopuszczenie do takiego podziału jest porażką .	Dopuszczenie	0	Neut
Jest to nakrycie do lunchu .	nakrycie	2	Neut
Niby napisał Poskromienie złośnicy , ale co zrobić z Miarką za miarkę ?	złośnicy	3	Fem
Tymczasem smutny urzędnik konsulatu zajął się moim bagażem .	bagażem	7	Masc
Z lodówki wyjęła niewielki dozownik wypełniony rubinową cieczą i bardzo ostrożnie wcisnęła go do otworu w pudełku .	pudełku	16	Neut
W zgodnej opinii sztabu szkoleniowego radomian , wszyscy mają równe szanse .	sztabu	3	Masc
Sznur tirów przecina niemal cały Wrocław , ma dziesięć kilometrów długości , stoi w nim kilkaset ciężarowek .	ciężarowek	16	Fem
W lesie zające występują raczej na pobrzeżach , w głąb idą tylko w silne mrozy .	zające	2	Masc
Uczestniczki wysłuchały wykładów doradców zawodowych i prawników , uczestniczyły w zajęciach psychologicznych , poznawały podstawy obsługi komputera i korzystania z Internetu .	zajęciach	10	Neut
Wino białe pije się inaczej .	Wino	0	Neut
Mają prąd na swoje potrzeby , a nadwyżki sprzedają .	nadwyżki	7	Fem
– ale kolację zaraz będziemy szykować .	kolację	2	Fem
Statut określa zasady wynagradzania za użytkowanie tych wkładów .	wynagradzania	3	Neut
Dziecko niespodziewanie wsiadło do czekającej na piętrze windy .	windy	7	Fem
Tworzyły się tajne wspólnoty religijne , klasztory , seminaria duchowne .	seminaria	8	Neut
Kto wiatr sieje , ten burzę zbiera .	burzę	5	Fem
Woły stąpały ospale , skrzypiały jarzma .	jarzma	5	Neut
Po zakończeniu kariery Perry rok w rok komentował Wimbledon .	zakończeniu	1	Neut
Już na schodach usłyszała dźwięki dobiegające z komnaty dziadka .	dziadka	8	Masc
W dyskusji zgłoszono wniosek o odrzucenie projektu uchwały w sprawie założeń polityki pieniężnej na 1995 r .	dyskusji	1	Fem
- Komora będzie gotowa do wszczepienia za jakieś półtora roku .	półtora	8	Neut
Także usługi ogólnobudowlane prowadzi drugi z odznaczonych , pan Marek Nosal .	usługi	1	Fem
Poza tym zawsze proponuję lewicy , by odeszła od ideologicznej walki z prawicą i przeszła na spory o gospodarkę .	gospodarkę	18	Fem
Oprócz Polaków odpływali na tę wyprawę także i cudzoziemcy , wszyscy spod znaku republikańskiego .	cudzoziemcy	8	Masc
Wcześniej kupił dwie łodzie rybackie dla 12 rodzin .	łodzie	3	Fem
Poza tym boiskiem panuje chaos .	boiskiem	2	Neut
Jedziemy do Havru , ten stary kozioł płaci .	kozioł	6	Masc
Geday wymyślił depilator , cudeńko .	cudeńko	4	Neut
Prowadził też agencję reklamową .	agencję	2	Fem
Od trzeciego rozbioru Polski do odzyskania niepodległości minęły 123 lata .	odzyskania	5	Neut
Czy komornik poprzestanie na aucie byłego ministra , skoro śledczy kazali zabezpieczyć majątek wart 150 tys . zł ?	aucie	4	Neut
Za dwa dni miał em gotową pieczątkę .	pieczątkę	6	Fem
Drugi pod względem kapitalizacji giełdowej Wielkopolski Bank Kredytowy osiągnął bardzo dobrą miesięczną dynamikę zysków wynoszącą 81,4 proc .	Bank	6	Masc
Wychowałam tam 10 specjalistów chirurgii dziecięcej .	chirurgii	4	Fem
Czy wszystkie drabiny należą do drabów ?	drabiny	2	Fem
Bo chciały uratować zaskrońca , ale teraz są w kropce .	kropce	9	Fem
Tłum domaga się wydania zbiega .	Tłum	0	Masc
Wyprowadzają one małe koźlęta na płaty śniegu i uczą je zjeżdżać na racicach .	koźlęta	3	Neut
Biała plama zniknęła , cały glob był opasany siecią wspólnot .	plama	1	Fem
Maksymalizację wydajności skrawania osiąga się dzięki maksymalizacji przekroju warstwy skrawanej i prędkości skrawania .	skrawania	2	Neut
Jestem proboszczem liczącej 1180 osób parafii , która posiada zabytkowy kościół wpisany do rejestru zabytków .	kościół	10	Masc
- Będzie realizowana jedna polityka uzgodniona na posiedzeniach Rady Ministrów .	posiedzeniach	7	Neut
Zadanie dotyczy odcinka o długości 0,46438 km .	Zadanie	0	Neut
Mag osunął się bezwładnie .	Mag	0	Masc
W grupie finałowej rozegrano mecze każdy z każdym i wyłoniono zwycięzcę , którym został zespół Warka Tuchola .	Warka	15	Fem
Posiadanie pełnych praw akademickich oznacza , że uczelnia nadaje stopień naukowy doktora , przeprowadza przewody habilitacyjne oraz występuje z wnioskiem o nadanie tytułu naukowego profesora .	tytułu	22	Masc
Jej facet jest zmęczony pracą , pomidorówką oraz żoną .	pomidorówką	6	Fem
A teraz ma krowę piwoszkę .	piwoszkę	4	Fem
- Seneszal Guthlaf wypełni każde twoje odnośne polecenie .	Seneszal	1	Masc
Nie tylko on uległ czarowi tego zakątka .	zakątka	6	Masc
Słońce wyrwało się z pęt horyzontu i zaczęło uwalniać dusze z martwych ciał żołnierzy .	dusze	9	Fem
Tu biło serce Orkiestry .	serce	2	Neut
Poprawkę 45 . już rozpatrzyli śmy .	Poprawkę	0	Fem
Burmistrz , Zbigniew Grzesiak , wyjaśnił , że są trudności w porozumieniu się z Urzędem Rejonowym .	Urzędem	14	Masc
Zorganizowano również dla nich warsztaty rękodzielnicze z zakresu robienia na drutach , haftowania , tkania , wykonywania makram .	tkania	14	Neut
Do tego czasu kierowcy muszą liczyć się z poważnymi utrudnieniami w ruchu .	utrudnieniami	9	Neut
Ale dwa razy do roku kumulują się we mnie smutki , niezrealizowane sprawy i ogarnia mnie przygnębienie .	smutki	9	Masc
Poczucie realizmu , pragmatyzmu , interesu narodowego nakazuje nazywać po imieniu błędy i zaniechania rządu Jerzego Buzka .	Poczucie	0	Neut
Nie bój się niepowodzenia .	niepowodzenia	3	Neut
Matka kilkakrotnie dziennie karmi małe .	małe	4	Neut
Po powrocie do Polski Gronowska wraz z mężem zaczęła walczyć o sprowadzenie syna do kraju .	sprowadzenie	11	Neut
Mogę walczyć , choć z zasady nie biję kobiet .	zasady	5	Fem
Michel mógł jeszcze długo mówić o lunarnej symbolice srebra .	symbolice	7	Fem
Józek frotem suszy głowę .	frotem	1	Neut
Oczywiście nie zabrakło w tym momencie również opiekunki stypendystów pani Karoliny Szybki .	opiekunki	7	Fem
Ale ci politycy z kolei nie gwarantują przeprowadzenia koniecznych reform gospodarczych .	politycy	2	Masc
– przebierze się za aniołka . .	aniołka	4	Masc
Nie ma nic gorszego niż deszcz i mgła .	mgła	7	Fem
Kością niezgody jest nadal powstanie niezależnej korporacji prokuratorów .	Kością	0	Fem
Ale jak zinterpretować pojawienie się kolędników w finałowej scenie , kiedy rozjadą się już Konrad i ksiądz Piotr ?	kolędników	5	Masc
PQBoot to narzędzie do zmiany partycji bootującej dla tych użytkowników , którzy tylko od czasu do czasu potrzebują skorzystać z innego systemu .	użytkowników	9	Masc
Dolną część garderoby osłaniamy papierowymi ręcznikami , aby nie pobrudzić jej później jajkami .	jajkami	12	Neut
Polski nie stać na płacenie za naukę za granicą .	płacenie	4	Neut
W poniedziałek tamtejsze giełdy były zamknięte z powodu święta .	giełdy	3	Fem
Nad tujami gasło czyste , wysokie niebo .	tujami	1	Fem
Po ślubie wynajęli mieszkanie w starej kamienicy .	kamienicy	6	Fem
Bo później rodzice słyszeli od niego dziwne sformułowania w zabawnych kontekstach .	sformułowania	7	Neut
Wykonanie całej inwestycji zlecono Przedsiębiorstwu Budowy Dróg i Mostów ze Świecia .	Wykonanie	0	Neut
Wszystkie one znalazły zastosowanie w teologii .	teologii	5	Fem
O tym , że pogoda ostatnio nas nie rozpieszcza , przekonał się właściciel lubelskiego sklepu futrzarskiego .	właściciel	12	Masc
Był mój protest na Konwencie Seniorów .	Konwencie	4	Masc
Wprowadzenie planu w życie wymaga uchwalenia bądź zmiany kilkunastu ustaw .	Wprowadzenie	0	Neut
Zgłoszenia przyjmowane są do 1 października 2007 roku .	Zgłoszenia	0	Neut
Tam dyżurna kosmetyczka obejrzy pani cerę , udzieli porady i wskaże , jakie mleczko będzie najwłaściwsze , a może jeszcze doradzi jakiś krem .	cerę	5	Fem
Naraz usłyszał em gwałtowne otwarcie drzwi i szuranie po podłodze .	szuranie	7	Neut
I miał też inne gusty .	gusty	4	Masc
Drugi pod względem kapitalizacji giełdowej Wielkopolski Bank Kredytowy osiągnął bardzo dobrą miesięczną dynamikę zysków wynoszącą 81,4 proc .	kapitalizacji	3	Fem
W głębi izby ktoś nagle zapłakał .	głębi	1	Fem
Wystarczy , że celnik na niego spojrzy .	celnik	3	Masc
Przewodnictwo , ruch lodu i przesiąkanie wody przemieszczają ciepło w obrębie lodowca .	przesiąkanie	5	Neut
Do spa udają się osoby świadome , dla których dbanie o siebie to przyjemność .	dbanie	9	Neut
- Jak często występujecie przed publicznością ?	publicznością	5	Fem
Linia Jana kończy się na świętym Stanisławie Kostce .	Linia	0	Fem
Daje on młodym ludziom szansę wykazania się umiejętnościami organizatorskimi .	wykazania	5	Neut
Brakuje również sportowego sukcesu , zgodnego z oczekiwaniami kibiców i sympatyków Klubu .	oczekiwaniami	7	Neut
Nasze uczestnictwo też ma swój udział .	uczestnictwo	1	Neut
Nie budzi go huk przejeżdżającego pociągu ani blask słońca , kiedy odpływa kolejny obłok .	obłok	13	Masc
Nikt nie zatrzyma rozwoju medycyny .	medycyny	4	Fem
Zdjąć te cholerne obrazki po właścicielu .	obrazki	3	Masc
Dach przypomina fale morskie , które często zdobią japońskie drzeworyty .	fale	2	Fem
Zawołać taksówkę ?	taksówkę	1	Fem
Następna sprawa , czy opuścił Państwowy Zakład Higieny z powodu antysemickich prześladowań , jak opowiadał po wojnie ?	prześladowań	11	Neut
Jednak tym razem do zwycięstwa wiodła nie umiejętność fechtunku , lecz znajomość spraw strażackich .	umiejętność	7	Fem
Na cmentarzu w Koniku Nowym leży ponad 100 psów , pięć kotów i jeden chomik .	kotów	11	Masc
Komputery podłączone do Sieci mogą skorzystać z okna zadań badawczych .	Komputery	0	Masc
Od instynktu samozachowania wybaw nas , Panie .	instynktu	1	Masc
Intencją wszystkich jest przecież wyjaśnianie problemu .	wyjaśnianie	4	Neut
- Skoro to tylko głowica . . .	głowica	4	Fem
Dzięki poradnikowi dowiadujemy się , że roczną deklarację oznaczają cyfry 01 .	poradnikowi	1	Masc
Wizja Nawara Derela na stole sekcyjnym musiała być bardzo zabawna .	Wizja	0	Fem
Grają muzykę będącą unikalnym mariażem form i stylów , zachwycają jurorów na wszelkich konkursach .	jurorów	10	Masc
- Wiele złudzeń padło przez te dwa czy trzy lata .	złudzeń	2	Neut
JANUSZOWI PANASEWICZOWI nawet retusz nie pomoże .	retusz	3	Masc
- Pytał em też Mędrców , ale pokiwali tylko głowami i orzekli , że ich komputery nie są w stanie tej zagadki rozwikłać .	Mędrców	4	Masc
jestem w stanie zgodzić się na utrzymywanie emeryta , gdyż przepracował swoje życie i coś dobrego dla społeczeństwa zrobił .	utrzymywanie	6	Neut
Którędy się idzie , by zejść na manowce ?	manowce	7	Masc
Po przewiezieniu do Jeleniej Góry prokurator postawił mu zarzuty żądania i przyjęcia korzyści majątkowych .	korzyści	12	Fem
Miłość nie jest troską i lękiem o siebie nawzajem .	troską	3	Fem
Politycy opozycji poinformowali również , że zamierzają złożyć do Trybunału Konstytucyjnego wniosek w sprawie niekonstytucyjności ustawy o ABW i AW .	niekonstytucyjności	14	Fem
Że takie określenie to banał .	określenie	2	Neut
Mankamentem rundy wiosennej były mecze wyjazdowe Obry .	Mankamentem	0	Masc
W wydanym wczoraj oświadczeniu Rada podkreśliła , że wstrzymanie wykonania koncesji , gdy jednocześnie toleruje się działalność piratów , niszczy podstawy ładu w eterze .	oświadczeniu	3	Neut
Biernacki może liczyć na poparcie polityków koalicji .	koalicji	6	Fem
Częstuje herbatą i własnego wypieku ciasteczkami .	herbatą	1	Fem
PiS okazało się osamotnione w swojej argumentacji .	argumentacji	6	Fem
Kuskus przygotować według przepisu na opakowaniu , dodając 2 łyżki masła i szczyptę soli .	Kuskus	0	Masc
Widać , że położył się w ubraniu , bo spod kołdry wystają stopy i nieco obszarpane nogawki spodni .	kołdry	10	Fem
Łzy padały na cremoński lakier .	lakier	4	Masc
Ufundowanie muzeum dla zbiorów Jasieńskiego było naturalnym odruchem obywatela , miłośnika sztuki .	odruchem	7	Masc
Natomiast tutaj chodzi o zachowanie pewnej symboliki .	symboliki	6	Fem
Jak widzę procesy zachodzące w sztuce ostatniego stulecia ?	stulecia	7	Neut
Inwestor chce wystartować za kilka miesięcy .	Inwestor	0	Masc
Bóg jeden wie , czym się kierował premier Miller w doborze kolejnych ministrów .	ministrów	12	Masc
Społeczność ludzka funkcjonuje w strukturach zapewniających formę organizacyjną .	Społeczność	0	Fem
Większość wpływów banku z kredytów wynika z ich oprocentowania .	oprocentowania	8	Neut
Na kartce należy wypisać plusy i minusy ?	kartce	1	Fem
Bandzior wynajmował posła do niszczenia konkurencji .	konkurencji	5	Fem
Po Jugosławii podróżowali śmy z namiotem , szukając pól campingowych .	namiotem	5	Masc
W lutym skradziono ją prawdziwemu funkcjonariuszowi w Warszawie .	funkcjonariuszowi	5	Masc
Na ścianach wisiały pamiątkowe fotografie i adresy gratulacyjne .	adresy	6	Masc
Podczas przyjęcia dowiedziała m się , dlaczego tak uczynił .	przyjęcia	1	Neut
Twierdzi , że po operacjach jej pęcherz przypomina piłkę futbolową .	operacjach	4	Fem
Ja nie byłem zbyt głodny , więc poprzestałem na sałatce .	sałatce	9	Fem
Skarżył się jej przecież , że w kieracie prozaicznych zajęć , wśród ludzi zajętych tylko sprawami chleba powszedniego , brak mu rozmów na poważne tematy .	sprawami	15	Fem
Pan de Berle stał przy oknie i patrzył na park .	de	1	Masc
Siedzę w archiwum i kartkuję dwie najbardziej zajmujące książki z jego biblioteki .	archiwum	2	Neut
- Czy księdzu wolno publicznie krytykować przełożonych ?	przełożonych	6	Masc
Pierwsze krople deszczu zadudniły o trumnę i zmieszały się ze święconą wodą , którą ksiądz rozpryskiwał z kropidła podobnego do królewskiego berła .	berła	21	Neut
I mnie o waszych spotkaniach powiedzieli uczynni sąsiedzi .	spotkaniach	4	Neut
Po ich koncercie ludzie przychodzili do mnie i dziękowali , że zaprosiłem tak widowiskową grupę .	grupę	14	Fem
Uświadamiają sobie , że aborcja to zabijanie .	zabijanie	6	Neut
Szerzyła się filozofia w najszerszym znaczeniu .	filozofia	2	Fem
Chyba dam radę .	radę	2	Fem
Straciła w powstaniu dwóch synów i męża .	powstaniu	2	Neut
Czy senator rzuci rękawicę wszechwładnemu przewodniczącemu ?	rękawicę	3	Fem
Stałą obserwacją objęta jest ulica Bohaterów Warszawy od poczty głównej do placu Wolności .	placu	11	Masc
Piłkarze FC Porto zapewnili sobie wczoraj ponownie tytuł mistrzów Portugalii .	tytuł	7	Masc
Złem jest jego uprawianie .	uprawianie	3	Neut
Uznano , że poszlaki były wątłe i niepewne , zwłaszcza podobieństwo papieru i sznurka .	sznurka	13	Masc
Zawiedziona szlachecka fantazja przeglądała mu z niebieskich oczek .	oczek	7	Neut
Nakładkę rozkłada się na desce sedesowej .	Nakładkę	0	Fem
On jest zakochany , na trąbie siedzi mrówka i wysyła serduszka .	serduszka	10	Neut
Potem założył prywatny kantor .	kantor	3	Masc
Z jego przepalonego i odsłaniającego rusztowanie kręgów gardła wydobył się syk .	syk	10	Masc
Zaczęło się od tego , że kupili śmy koledze na urodziny tarczę i sami zaczęli śmy grać .	tarczę	11	Fem
Nie opal sobie skrzydeł , zbyt wysoko wylatując pod słońce .	skrzydeł	3	Neut
Na koniec wyniki podliczono by w blasku jupiterów na wielkiej konwencji ogólnopolskiej .	blasku	6	Masc
W bieżącym sezonie ma ogromną szansę przełamać tę barierę .	sezonie	2	Masc
Życie ojca , surowe i ciężkie , całkowicie poświęcone rodzinie i opiece nad innymi ludźmi , budzi dziś zdumienie nieprawdopodobną obowiązkowością , odpowiedzialnością i pogodą ducha .	pogodą	24	Fem
Związkowcy podkreślili jednak , że mają gwarancje ministra w sprawie modelu PKP i przyszłych przekształceń kolei oraz dalszych rozmów z nimi .	modelu	10	Masc
Zgodził się , dał kilka dobrych rad i wyznaczył Polluksa na dowódcę .	dowódcę	11	Masc
Tylko powszechne uwłaszczenie obywateli stwarza dla Polaków ostatnią szansę na uzyskanie realnych praw własności .	uzyskanie	10	Neut
Ale hodowcy stworzyli nowe , bardziej atrakcyjne odmiany o cechach uniwersalnych .	hodowcy	1	Masc
Teraz zwłoki Odiego leżą w chłodni .	chłodni	5	Fem
Zatrzymały się w odległości kilkudziesięciu metrów od miejsca narodzin Chrystusa .	narodzin	8	Neut
Niedobory pozostałych składników , które biorą aktywny udział w przemianie białkowej , mogą powodować schorzenia włosów i paznokci .	schorzenia	14	Neut
To jest mój debiut w kierowaniu kropidłem .	kierowaniu	5	Neut
W połączeniu z manipulowaniem ostrością tworzy to klimat z pogranicza jawy i nierzeczywistości o niejasnej proweniencji .	połączeniu	1	Neut
Konieczność jej przeprowadzenia uznaje nawet SLD .	Konieczność	0	Fem
Świniak ten jest kumplem Ałganowa .	Świniak	0	Masc
Taki zapis spowoduje obligatoryjność podjęcia przez rzecznika praw obywatelskich spraw skierowanych przez rzecznika praw dziecka .	podjęcia	4	Neut
Ale demokrata Al Gore obiecał emerytom dopłaty państwa do leków . . .	emerytom	5	Masc
Wyłączyła komputer i podeszła do lustra .	komputer	1	Masc
Wasza wiara jest naprawdę żywa .	wiara	1	Fem
Chyba mnie jeszcze zaprosisz , bo mi leczo bardzo smakowało ?	leczo	7	Neut
Wczoraj w nocy zziębnięci złodzieje skradli mu kilkadziesiąt skórzanych ubrań o wartości ponad 65000 zł .	złodzieje	4	Masc
Podawali sobie z rąk do rąk legitymację podporucznika rezerwy .	podporucznika	7	Masc
Wiele ptaków owadożernych zimą zmienia jadłospis na roślinny .	zimą	3	Fem
Próbował bronić swej dyktatury , Osi , paktu z Hitlerem .	paktu	7	Masc
Giełda ogłosiła oficjalnie , że pełną gotowość systemu przywrócono dopiero w nocy .	Giełda	0	Fem
Bandytów nie złapano .	Bandytów	0	Masc
Nie sprzyja to oczywiście bezusterkowemu oddawaniu obiektów .	oddawaniu	5	Neut
Ze ścian mrugają kolorowe neony świąteczne w kształcie choinek , bombek i dzwonków .	dzwonków	12	Masc
Szmigielski działa też w komisji ogródków działkowych , komisji mieszkaniowej i radzie osiedla ; ma biuro w piwnicy .	radzie	11	Fem
Papier wydaje mi się ciepły .	Papier	0	Masc
Na progu stał wysoki , zarośnięty mężczyzna .	progu	1	Masc
Zawód odmalował się na twarzy Feliksa .	Zawód	0	Masc
Uderzył kastetem w samochodzie , potem udusił .	kastetem	1	Masc
Trupy wrzucono do Gopła .	Trupy	0	Masc
Ilu prezesów pani przetrzymała ?	prezesów	1	Masc
Ciągle jeszcze wybieramy naszych bohaterów i ich losy z miarką społeczną .	miarką	9	Fem
Wydarzeniu patronował marszałek województwa mazowieckiego Adam Struzik .	Wydarzeniu	0	Neut
Halina Auderska we wszystkich książkach każe swoim bohaterom szukać tożsamości .	tożsamości	9	Fem
Parówki gotowane we wrzątku i podawane wprost z rondla bierze się na talerz i usuwa błonę , w której były gotowane .	błonę	15	Fem
W piątek wieczorem odwiedziły ją w domu i namówiły na spacer .	spacer	10	Masc
W tej lecznicy usunięto pacjentce martwą ciążę , a także macicę i fragment jelita .	lecznicy	2	Fem
Doznały jedynie stłuczeń kończyn i po opatrzeniu ran w szpitalu w Broumovie zostały zwolnione .	ran	7	Fem
Do sotni przemawia pułkownik .	sotni	1	Fem
Przedsiębiorca wpadł w długi .	długi	3	Masc
Ciotka odpycha go łokciem .	łokciem	3	Masc
Członkowie nakielskiego stowarzyszenia podczas spotkania omówili główne cele swojej działalności .	stowarzyszenia	2	Neut
Spaceruję sobie wzrokiem po ścianach , suficie , meblach i przedmiotach .	przedmiotach	10	Masc
Dzieci się uczą na pamięć długości rzek , głębokości jezior . . .	głębokości	8	Fem
- Czy chcesz , niewiasto , wziąć udział w uroczystościach ku czci bogini Zirbanit ?	bogini	12	Fem
Dopóki nie miała m opiekunki , sypiała m po trzy godziny .	opiekunki	4	Fem
Dowódca sił amerykańskich w Afganistanie generał Tommy Franks zapowiedział kolejne operacje lądowe .	Dowódca	0	Masc
Dopuszczenie do takiego podziału jest porażką .	porażką	5	Fem
– Ten komplet narzędzi służył do ćwiartowania korpusów .	narzędzi	3	Neut
Redukcja zatrudnienia obejmie przede wszystkim pracowników administracji i obsługi produkcji .	administracji	6	Fem
Gdy na miejscu zjawili się policjanci z komisariatu kolejowego policji , schronisko znajdowało się w opłakanym stanie .	schronisko	11	Neut
- Obecnie proszę o odczytanie komunikatów .	odczytanie	4	Neut
Komputery podłączone do Sieci mogą skorzystać z okna zadań badawczych .	Komputery	0	Masc
Wówczas warto pospieszyć się z odpowiedzią , bo od złożenia takiej deklaracji operator w ciągu miesiąca musi wprowadzić nowe , korzystniejsze opłaty .	złożenia	9	Neut
Czy wszystkie drabiny należą do drabów ?	drabiny	2	Fem
- Nie mam czasu chodzić do doktora , ani mi się śni !	doktora	6	Masc
Zaczął się wielki exodus .	exodus	3	Masc
Nie przechowuje fotografii ze spektakli ani taśm ze swoimi filmami .	filmami	9	Masc
I próbuje temu oczekiwaniu sprostać .	oczekiwaniu	3	Neut
- A rozmawiałeś choć raz z jego żoną ?	żoną	7	Fem
Rozkaz jej rozpoczęcia wydał oddziałom armii prezydent Boris Trajkovski .	oddziałom	4	Masc
Ojciec chciał przepić pieniądze ze skarbonki syna .	skarbonki	5	Fem
Obecnie dzierżawi ponad 8 tys . km łączy cyfrowych .	łączy	7	Neut
Ludzie uważają , że do kłopotów z uzyskaniem zgody przyczynili się inwestorzy starający się o pozwolenie na budowę małego osiedla na działce sąsiadującej z ogródkami mieszkańców .	kłopotów	5	Masc
Wiedziałam , gdzie są fotografie z naszych pogrzebów ; wystarczyło , żeby poszperał trochę w szufladach .	fotografie	4	Fem
O’Donellowie siedzieli przy ognisku .	ognisku	3	Neut
kanapy się dorobili śmy .	kanapy	0	Fem
Zaprószono ogień i wybuchł poważny pożar na górnych piętrach .	pożar	5	Masc
– Twoja twarz z profilu jest półksiężycem .	profilu	4	Masc
Było to umycie rąk .	umycie	2	Neut
Lekcja kończy się rozczarowaniem , ale mistrz wydaje się daleki od rezygnacji .	rezygnacji	11	Fem
Akredytacja państwowa jest obowiązkowa i powszechna .	Akredytacja	0	Fem
Trąba zaś staje się w tych sprawach podstawowym kierunkowskazem .	kierunkowskazem	8	Masc
Ale ambicja kazała mu natychmiast odrzucać obrzydzenie i opory .	ambicja	1	Fem
Wzorem większości producentów przeczytał wyłącznie krótkie streszczenie zawarte na pierwszej stronie , ale po jego minie można było wyczytać , że sama koncepcja go urzekła .	streszczenie	6	Neut
Jaka jest między nimi relacja ?	relacja	4	Fem
W kilka godzin później wyjechałem z ciężkim sercem i obietnicą szybkiego spotkania .	obietnicą	9	Fem
Wydawało się nieprawdopodobne , by po tylu godzinach wydostać malca żywego z pułapki .	pułapki	12	Fem
Zamknął em tylko oczy , aby lepiej czuć dotyk i słyszeć własne myśli .	dotyk	8	Masc
Dębica była kolejnym miejscem rozegrania Grand Prix Polski w pływaniu .	miejscem	3	Neut
Równolegle z kilkoma innymi inwestycjami w Tucholi rozpoczęły się prace związane z budową nawierzchni asfaltowej na podbudowie z gruzobetonu na ulicy Mickiewicza .	nawierzchni	13	Fem
Nowe realia wymagają innego typu zachowań i pomysłów .	realia	1	Neut
W Fundacji można też uzyskać wyczerpujące informacje na temat fachowej opieki nad kotami domowymi .	opieki	10	Fem
Poruszał rytmicznie kolanami , unosząc lekko siedzącą na nich kobietę .	kobietę	9	Fem
Pat wokół Instytutu Pamięci Narodowej trwa .	Pamięci	3	Fem
Za punktualność , komfort podróżowania , czy czystość przystanków będzie dbał MZKZG .	podróżowania	4	Neut
Ale ambasada nie słyszała , by kasy stanowiły zagrożenie dla finansów państwa .	zagrożenie	8	Neut
Oprócz wiśni i czereśni zawierają go truskawki i winogrona oraz orzechy włoskie .	orzechy	10	Masc
Zeznania te potwierdzili pozostali członkowie załogi karetki .	Zeznania	0	Neut
- Liczne przykłady coraz bardziej wyrafinowanych działań terrorystycznych na świecie uświadamiają społeczeństwu potrzebę ochrony przed tego typu zagrożeniami .	zagrożeniami	17	Neut
- W każdym państwie jesienią dochodzi do politycznego napięcia , ponieważ ustawa budżetowa zawsze wywołuje emocje .	państwie	3	Neut
Noc zamazała fantastyczne kolory i wszystkie klomby wyglądały teraz jednakowo .	kolory	3	Masc
Margit również przykucnęła i wybierała zwierzątka .	zwierzątka	5	Neut
Mam nadzieję , że za Dziurowiczem pójdą następni .	następni	7	Masc
Auta są kradzione dla okupu .	Auta	0	Neut
Spada koniunktura dla brunatnych koszul .	koszul	4	Fem
Generał za swoje publikowane w prasie artykuły nie przyjmuje honorariów .	Generał	0	Masc
- Miasto wydzierżawiło teren bez problemów .	teren	3	Masc
Panowie nie mieli najmniejszych problemów z dziwnie skleconą reprezentacją Reszty Świata , panie też gładko wygrały z osłabioną ekipą USA .	Reszty	9	Fem
- Jestem głuchoniema .	głuchoniema	2	Fem
Kontrakty te są nowym instrumentem polityki rozwoju regionalnego .	Kontrakty	0	Masc
Pięcioletnia dziewczynka , porwana wczoraj przez 65-letniego mężczyznę w Chorzowie na Śląsku , odzyskała wieczorem przytomność .	mężczyznę	7	Masc
Do najważniejszej pracy przystąpiono w farbiarni .	farbiarni	5	Fem
Decyzja zapadnie dzisiaj rano .	Decyzja	0	Fem
Dziś w biznesowej działalności wspiera młodzieńca mamusia .	młodzieńca	5	Masc
Sztuka miała premierę w maju 2001 .	maju	4	Masc
Fluor uszkadza nerki , zmniejsza odporność na infekcje i sprzyja rozwojowi alergii .	Fluor	0	Masc
Ostre cięcia grożą też prezesom państwowych spółek .	cięcia	1	Neut
Dostrzegają je twoje oczy , słyszą je twoje uszy .	uszy	8	Neut
Anglosasi sądzą , że czas jest ich sprzymierzeńcem .	sprzymierzeńcem	7	Masc
Żegnamy się nowo poznaną piosenką i okolicznościowym hasłem .	hasłem	7	Neut
Dotychczas lokatorzy budynków , w których zainstalowane są gazomierze , płacili za gaz co dwa miesiące .	gaz	12	Masc
Powiązanie domów wskazuje również na zdobywanie wiedzy poprzez podróże .	zdobywanie	5	Neut
Nie jest to jednak recepta .	recepta	4	Fem
Mankamentem był jedynie brak krzeseł .	krzeseł	4	Neut
W stoisku PDT największe powodzenie mają fartuszki dziewczęce i chłopięce .	stoisku	1	Neut
Ten kierownik to ma chyba fioła .	fioła	5	Masc
Opanowało ją swoiste zniewolenie , niemoc przeciwstawienia się .	niemoc	5	Fem
W tym przypadku również zalano odcinek asfaltem .	asfaltem	6	Masc
Obok klatek z dorosłymi ptakami krążyły dwa małe kazuary , grzebiąc w odpadkach w poszukiwaniu pożywienia .	kazuary	8	Masc
Spojrzałem na kobietę i stwierdziłem , że po raz pierwszy jej twarz zasługiwała na uwagę .	kobietę	2	Fem
Po spełnieniu toastu świeżo upieczeni małżonkowie rzucają za siebie kieliszki .	kieliszki	9	Masc
Siostrzyczki emanowały szlachetnością i pobożnością .	Siostrzyczki	0	Fem
Saszka podszedł do Handzi , usiadł obok na kłodzie .	kłodzie	8	Fem
Przekupnie w bazarowych zaułkach opowiadali , że upadek rządu jest bliski i nieuchronny , a ministrowie i generałowie knują spiski albo pakują walizy i szykują się do ucieczki za granicę .	upadek	7	Masc
i to był by komplet . .	komplet	4	Masc
Zerwałem suchą trawkę i zacząłem ją powoli żuć .	trawkę	2	Fem
- Co robicie , by w tak świetnej kondycji dotańczyć do finału ?	kondycji	8	Fem
Jutro czy pojutrze mamy przekroczyć koło polarne .	pojutrze	2	Neut
Słuchacze poznają wiele elementów prawa , psychologii , socjologii , polityki społecznej , informatyki .	informatyki	13	Fem
Za pomaganie funkcjonariuszom MO Konstanty odpowie teraz przed sądem .	pomaganie	1	Neut
RADA BEZPIECZEŃSTWA omawia skargę Zambii z powodu powtarzających się aktów agresji ze strony rasistowskiej RPA .	RADA	0	Fem
Dopiero dzisiaj w trędowatej kaplicy rozdzielili się na kata i ofiarę .	kata	8	Masc
Nie przeprowadził etnicznych czystek , nawet w policji i prasie .	czystek	3	Fem
Nagranie wykazało , że w przestępstwie pomagali ochroniarzowi dwaj inni młodzi mężczyźni .	Nagranie	0	Neut
Nowość polegała na tym , że nauczyciele chrześcijańscy wykazywali , iż w osobie Jezusa Chrystusa wypełniły się wszystkie przepowiednie proroków .	Nowość	0	Fem
Nie piszą o nim podręczniki , tradycja nie przekazuje jego zasług potomnym .	podręczniki	4	Masc
Wcześniej nie zauważyła m , że z tego palanta wycieka palantyna .	palanta	8	Masc
Z oficjalnym żądaniem wobec MKOl , złożonym na piśmie , wystąpił Narodowy Komitet Olimpijski KRLD , domagając się od naczelnej władzy sportowej rewizji listy triumfatorów olimpijskich .	żądaniem	2	Neut
Kwiaty otrzymali nauczyciele , którzy przed laty kształcili kolejarskich specjalistów .	nauczyciele	2	Masc
Ten mnie po plecach kordialnie klepnął .	plecach	3	Neut
Czerń , ulubiona barwa , ostro podkreślała niezwykłą , niemal ascetyczną bladość oblicza emira .	Czerń	0	Fem
- Tam napijemy się kawy .	kawy	4	Fem
Jeśli weźmiemy pod uwagę sprawność i wydajność akumulatorów wanadowych , projekt wydaje się zupełnie realny .	wydajność	6	Fem
Prawdopodobnie w toalecie przestępcy zaopatrzyli się w granaty i pistolet .	przestępcy	3	Masc
- To są wąsy Stalina na wyższym szczeblu .	szczeblu	7	Masc
Prezes ma całkowitą kontrolę nad swoją firmą , a bezpośrednia władza premiera kończy się na progu jego sekretariatu .	firmą	6	Fem
Na inwestycję przyznano 28 milionów marek kredytu , który przyznano na 15 lat z pięcioletnią karencją spłaty odsetek .	marek	5	Fem
Potem proszono ich o wykonanie odwrotnego zadania .	wykonanie	4	Neut
Zrozpaczona matka nie może sobie darować , że nie odczytała wezwania na pomoc w słowach dziecka .	wezwania	10	Neut
- Wiosną zdał maturę , będzie studiował nauki polityczne w Hamburgu .	maturę	3	Fem
Za kratami sprawował się tak dobrze , że więzienne władze chcą , by wyszedł przed końcem kary .	kratami	1	Fem
A poza tym , w kwestiach kuchni w szkołach i sprzątania szkół , dobrem dzieci zasłania się przede wszystkim chęć utrzymania własnego stołka .	stołka	22	Masc
- Nie zorganizowano zawodów na odpowiednim poziomie , na przykład w skokach do wody czy siatkówce , bo Zimbabwe nie spodziewa się w tych dyscyplinach osiągnięć .	zawodów	3	Neut
To bilans kilku ostatnich miesięcy działalności Szpitala Wojewódzkiego w Olsztynie .	bilans	1	Masc
Frajerów kroić !	Frajerów	0	Masc
Ja rewelacji nie szukam , bo ich nie ma , ale w każdym człowieku jest inność .	rewelacji	1	Fem
Wreszcie zdarzyła się prawdziwa katastrofa .	katastrofa	4	Fem
Kobiety w więzieniu doskonale łagodzą obyczaje .	obyczaje	5	Masc
Polscy producenci nie dają za wygraną , dotrzymując kroku modzie i zachodnim nowinkom .	nowinkom	12	Fem
Chociaż i tym zdarza się nie przestrzegać niektórych paragrafów prawa pracy .	paragrafów	8	Masc
Ryzykowały i sposobem lokat .	lokat	3	Fem
- Długi górnictwa sięgają 11,5 mld zł ; kopalnie same tego nie spłacą .	Długi	1	Masc
To pan postawił tę tezę .	tezę	4	Fem
Partia Konserwatywna zawiesiła Spencera w obowiązkach posła .	Partia	0	Fem
Do tego doszła rada od organizatora Wiesława Szczygielskiego .	rada	3	Fem
Napastnik skuł ofiarę kajdankami i zgwałcił .	kajdankami	3	Neut
Magazyn pozwoli firmie na zaspokojenie potrzeb rynku poprzez zapewnienie odpowiednich zapasów ogumienia .	ogumienia	11	Neut
Z zestawienia sporządzanego przez starostwo wynika , że podmioty gospodarcze działające w powiecie działdowskim dokonują rocznie ponad 6000 odpraw celnych .	zestawienia	1	Neut
Mamy na górze radar , a zaraz będziemy mieli zenitówkę z termowizorem i czołg .	radar	3	Masc
Do podlewania sadzonek wyśmienicie nadają się filtrowane ścieki .	podlewania	1	Neut
Wybrał em wydział techniczny .	wydział	2	Masc
Uzdrowienie sfery seksualnej nie dokonuje się jednak przez jednorazowy zryw duchowy .	zryw	9	Masc
Ostatnim punktem ćwiczeń było gaszenie pożaru .	gaszenie	4	Neut
Wszystkie pokoje wyposażone w szafy wnękowe są już gotowe .	szafy	4	Fem
W tych okolicznościach , po gruntownym przeanalizowaniu sytuacji , widział em przed sobą dwie drogi .	przeanalizowaniu	6	Neut
- Ekspertyza balistyczna wykluczyła udział żołnierzy niemieckich w zastrzeleniu 49-letniego mężczyzny w Koniecpolu .	zastrzeleniu	8	Neut
A ty jesteś cząstką swojego ojca , więc kocham również ciebie .	cząstką	3	Fem
Wczoraj , po zamknięciu lokali wyborczych , niemieckie media zapowiedziały , że pani minister ustąpi ze stanowiska .	zamknięciu	3	Neut
Tacy obserwatorzy na pewno nie wnoszą nic do naszej pracy pełnej poświęcenia .	obserwatorzy	1	Masc
W latach sześćdziesiątych , już jako sztygar oddziałowy , pamiętam odbiory przygotowywanych do rozruchu ścian dokonywane przez dyrektora Śniegonia .	ścian	14	Fem
Ja też miewał em pokusy .	pokusy	4	Fem
Posiadanie pełnych praw akademickich oznacza , że uczelnia nadaje stopień naukowy doktora , przeprowadza przewody habilitacyjne oraz występuje z wnioskiem o nadanie tytułu naukowego profesora .	Posiadanie	0	Neut
Zmienia się też skład wspólnoty żydowskiej w stolicy .	wspólnoty	4	Fem
Mężczyzna próbował prosić w ratuszu o upust lub rozłożenie na raty należności .	należności	11	Fem
W treści oskarżenia rysuje się droga tożsamości .	tożsamości	6	Fem
Szczegółowo analizowane są zapisy z kamer monitorujących , które znajdują się na terenie Kwidzyna .	kamer	5	Fem
Zapalono wszystkie lampy , ustawiono ruchome wieszadła , kelnerzy w oczekiwaniu gości spacerowali po korytarzach hotelowych .	oczekiwaniu	10	Neut
- Skąd ty bierzesz takie powiedzonka ?	powiedzonka	5	Neut
Czasy się zmieniają .	Czasy	0	Masc
Maksymalizację wydajności skrawania osiąga się dzięki maksymalizacji przekroju warstwy skrawanej i prędkości skrawania .	skrawania	12	Neut
- Spotkali śmy się , towarzyszu rektorze . . .	rektorze	6	Masc
Stanowisko rolników w tej sprawie przekazał podczas sesji Zygmunt Kiersznicki .	Stanowisko	0	Neut
Funkcjonariusze inspekcji celnej przy pomocy biegłych ustalili , że przy próbie wywozu najprawdopodobniej naruszone zostały przepisy Kodeksu celnego .	Kodeksu	16	Masc
Było przestronnie , panowała spokojna , sympatyczna atmosfera .	atmosfera	7	Fem
Po ponad dwóch tygodniach brak mi będzie telewizyjnej , turyńskiej zimy .	zimy	10	Fem
Po badaniach w szpitalu został wypuszczony do domu .	badaniach	1	Neut
