Na dziobie , bodącym niebo , przerzucony przez poręcz wisiał mister Dawid Lingslay .	bodącym	3	Imp
Z tak zlokalizowanym wrogiem łatwiej walczyć . . .	zlokalizowanym	2	Perf
Hodowla owiec jest do dzisiaj jedną z głównych gałęzi gospodarki tych nadal słabo zaludnionych rejonów .	zaludnionych	13	Perf
Poranione potłuczoną butelką zwierzę trafiło do weterynarza .	Poranione	0	Perf
Pomorska Regionalna Kasa Chorych jest od wczoraj kontrolowana przez pracowników Urzędu Nadzoru Ubezpieczeń Zdrowotnych .	kontrolowana	7	Imp
Widzę na tej rycinie stojącą po lewej stronie grupkę ludzi ubranych w proste , długie szaty , którzy wskazują palcem na człowieka pogrążonego w przyjacielskiej pogawędce z diabłem .	pogrążonego	22	Perf
Mimo obietnic złożonych pacjentom , stwardnienia rozsianego nadal nie ma na liście chorób przewlekłych .	złożonych	2	Perf
W czasie II wojny światowej miasto było poważnie zniszczone .	zniszczone	8	Perf
Do pupy polecam maść robioną w aptece .	robioną	4	Imp
Miała swoiście wyrobiony smak .	wyrobiony	2	Perf
Uszkodzone zostały wówczas 932 zabytkowe drzewa .	Uszkodzone	0	Perf
Cofnął się jak oparzony , gdy fala obmyła mu łapy .	oparzony	3	Perf
Teraz siedziała wyprostowana na łóżku , z napięciem wpatrując się w twarze Blothów .	wyprostowana	2	Perf
Dotknięta wojennymi ciężarami buntowała się i odmawiała odrabiania pańszczyzny .	Dotknięta	0	Perf
Projekt był omawiany dwukrotnie .	omawiany	2	Imp
Po naszym telefonie na miejscu pojawiła się policja , by ocenić , czy jest to krzew znajdujący się na liście zakazanych używek halucynogennych .	znajdujący	16	Imp
Dziewczyna obracająca się kusząco na parkiecie wydała mu się wyjątkowo wyjątkowa .	obracająca	1	Imp
W wspomnianych zestawach nie figurują te nazwiska .	wspomnianych	1	Perf
Są oni gorąco pozdrawiani przez zgromadzone na trasie tłumy .	zgromadzone	5	Perf
Śpiącego , zielem odurzonego zabiła m sztyletem .	odurzonego	3	Perf
Wydaje mi się , że na tym odcinku Krupówek wykonano kanalizację zbyt wąskimi rurami .	wykonano	9	Perf
Dłużej żyjący Polacy będą oczywiście mieli wpływ na wiele procesów gospodarczych .	żyjący	1	Imp
Polskie zasady zestrzeliwania opisano w niewielkiej czerwonej książeczce .	opisano	3	Perf
Tymczasem miednice wypełnione podrobami przenoszono do kuchni .	wypełnione	2	Perf
Z informacji lekarskiej o stanie zdrowia Havla , która została opublikowana w połowie grudnia , wynikało , że prezydent ma skłonności do zapadania na wirusowe schorzenia górnych dróg oddechowych .	opublikowana	10	Perf
Jeszcze przez kilka minut starali się uporać z doznaną porażką i dramatyczną decyzją Beatki .	doznaną	8	Perf
Nie czuje się pani trochę odsunięta przez Leppera ?	odsunięta	5	Perf
Stalowa linka była opuszczona , deskę umocowano do zaczepu i uniesiono do pionu .	opuszczona	3	Perf
Budynek podpalono .	podpalono	1	Perf
Kilka dni temu na oddział trafiła prątkująca absolwentka gimnazjum .	prątkująca	6	Imp
Przebiegające pod miastem chodniki kopalni zalano wodą , a wzgórze zgniło i zapadło się w ziemię jak przydeptane .	Przebiegające	0	Imp
Ochmistrz ma otwartą kabinę , dla przyzwoitości pukam w uchylone drzwi .	uchylone	9	Perf
W dorożce siedział rozparty chirurg Tamten .	rozparty	3	Perf
Zaproponowano więc Krystynie , która skwapliwie skorzystała .	Zaproponowano	0	Perf
Inaczej mogą zostać pobite .	pobite	3	Perf
I czy muszą być potwierdzone korpusowo ?	potwierdzone	4	Perf
Był em tym zachwycony i chodził em po Akademii dumny jak paw .	zachwycony	3	Perf
Grają muzykę będącą unikalnym mariażem form i stylów , zachwycają jurorów na wszelkich konkursach .	będącą	2	Imp
Osadzony powtórnie na 15 lat , umiera w więzieniu .	Osadzony	0	Perf
W innych miejscach znaleziono wyszlifowane i porysowane przedkarbońskie skały podłoża .	porysowane	6	Perf
W sztuce miecza faza oddechu jest bardzo ważna , bo szermierz biorący oddech jest wtedy najsłabszy .	biorący	11	Imp
Są już nawet zaczernione sufity ?	zaczernione	3	Perf
Wtedy też powiadomiono straż pożarną .	powiadomiono	2	Perf
Po 1956 r . dekret o wysiedleniach został anulowany .	anulowany	8	Perf
Poczuł em się wyróżniony ponad zasługę .	wyróżniony	3	Perf
Odkryto wiele nadużyć .	Odkryto	0	Perf
To to było z życia wzięte ?	wzięte	5	Perf
Plac masz już przekazany przez inwestora , zaraz dostaniesz koparkę " .	przekazany	3	Perf
Był wzywany do Seneki . . .	wzywany	1	Imp
Potem , gdy próbowali je sprzedać w Szanghaju , zostali zauważeni przez policję .	zauważeni	10	Perf
Jakby tego było mało , podczas kontroli technicznej stwierdzono , że oba pojazdy są niesprawne .	stwierdzono	8	Perf
15 naukowców uczestniczących w sesji otrzymało pamiątkowe medale wybite z okazji jubileuszu .	uczestniczących	2	Imp
Zawody będą rozgrywane na Dunajcu na odcinku od Krościenka do mostu w Gołkowicach .	rozgrywane	2	Imp
W egzekucjach przeprowadzonych w Miednoje , Charkowie i Katyniu zabito 15 tys . polskich oficerów .	zabito	9	Perf
Związany z kapistami , wielokrotnie jednak przekraczał wyznaczone przez nich malarskie granice .	Związany	0	Perf
Powołana przez burmistrza komisja dokonała kontroli w Ośrodku .	Powołana	0	Perf
Przed oczyma Angusa przesuwały się obrazy z przebytej epopei .	przebytej	7	Perf
Użyto gazów łzawiących i ogłuszających granatów .	ogłuszających	4	Imp
Księdza zatrzymano w ubiegłym tygodniu na polsko - ukraińskim przejściu granicznym w Dorohusku przy wjeździe do Polski .	zatrzymano	1	Perf
W wypadku na miejscu zginęła 19-letnia dziewczyna kierująca toyotą corollą oraz 23-letni mężczyzna .	kierująca	7	Imp
Pod uniesionymi zasłonami rozległego łoża z trudem udało mu się dostrzec ginącą w powodzi koronek , pomarszczoną twarz pani Lamaire .	uniesionymi	1	Perf
Tam skrzyżowanie przypominało wzburzone jezioro .	wzburzone	3	Perf
Umyte brokuły dzielimy na cząstki i układamy w naczyniu .	Umyte	0	Perf
Zabezpieczone zostały też ścięte już rośliny , przygotowane do dalszej obróbki .	Zabezpieczone	0	Perf
Poza tym powinna być bardziej dostępna dla zainteresowanych osób , które zechcą przechować w nim ważne osobiste dokumenty .	zainteresowanych	7	Perf
A to pewnie był akurat chwyt zamierzony przez autora i głęboko uzasadniony .	zamierzony	6	Perf
Ludzie uważają , że do kłopotów z uzyskaniem zgody przyczynili się inwestorzy starający się o pozwolenie na budowę małego osiedla na działce sąsiadującej z ogródkami mieszkańców .	sąsiadującej	22	Imp
Na przełomie czerwca i lipca Stomil - Olsztyn SA zamierza oddać do użytku budowany właśnie magazyn opon .	budowany	13	Imp
- Jeśli lud przestanie słuchać naszych nauk , zostanie pożarty przez pogan !	pożarty	9	Perf
Wymiana metra bariery energochłonnej , montowanej na mostach i wiaduktach , to wydatek kilkuset złotych .	montowanej	5	Imp
— Dlaczego nie osądzono komunistów ?	osądzono	3	Perf
Chyba sam miałem mokro w oczach ; zawsze miałem oczy ustawione w mokrym miejscu .	ustawione	10	Perf
Zwiększa się też ilość przestępstw popełnianych i wykrywanych na granicy .	popełnianych	5	Imp
- Raport o stanie państwa nie został ogłoszony przed Wigilią na osobisty wniosek premiera .	ogłoszony	7	Perf
Świat z coraz większym trudem akceptuje trwającą na drogach hekatombę i związane z tym straty ekonomiczne .	trwającą	6	Imp
Dlatego problem ten musi zostać wnikliwie rozpatrzony , a większość obiektów powinna być bezwzględnie zwrócona społeczeństwu , bo za jego pieniądze zostały wzniesione .	rozpatrzony	6	Perf
Z połączonych dłoni zrobili koło .	połączonych	1	Perf
Oddzielnie myjemy rzodkiewki i jej liście , od których oddzielamy części zepsute .	zepsute	11	Perf
Uroczysta msza święta w intencji reprezentacji Polski w piłce nożnej została odprawiona w piątek w Kazimierzu Dolnym .	odprawiona	11	Perf
Kto odpowiada za szkody wyrządzone w lesie przez zwierzynę ?	wyrządzone	4	Perf
Tekst ten jest zniszczony i w wielu miejscach nieczytelny .	zniszczony	3	Perf
Według legend , w studni głębokiej na ponad 30 metrów znajdują się wejścia do lochów i tajnych chodników łączących posiadłości właścicieli zamku .	łączących	18	Imp
Farba powinna być na włosie ok . 30 minut , by pigmenty w niej zawarte mogły w pełni zadziałać .	zawarte	14	Perf
Pokój 240 naparł silnie na dziennikarzy i prawem fizyki wywalił ich z przepełnionego namiotu .	przepełnionego	12	Perf
Wyprawa , zmuszona do przyjęcia walki , rozbiła się na wiele części .	zmuszona	2	Perf
Sławny pianista utracił dłonie w wypadku , ale przeszczepiono mu ręce straconego mordercy .	straconego	11	Perf
Szereg takich poleceń składałby się na całą procedurę , którą urządzenie byłoby sterowane .	sterowane	12	Imp
Nagrobek zniszczono podczas pospiesznej rozbiórki opactwa w 1529 roku .	zniszczono	1	Perf
Użyto gazów łzawiących i ogłuszających granatów .	ogłuszających	4	Imp
W przypadku grożących gołoledzią opadów deszczu lub śniegu , komputer włącza ogrzewanie jezdni .	grożących	2	Imp
Wtem jakby uśmiechnął się do nas spod przymkniętych powiek .	przymkniętych	7	Perf
Za chwilę w ciemnościach rozlega się łoskot zasuwającego się opornie betonu .	zasuwającego	7	Imp
Na czas akcji z kamienicy ewakuowano 10 osób , które nad ranem wróciły do swoich mieszkań .	ewakuowano	5	Perf
Ich zdaniem , proponowane rekompensaty są za niskie .	proponowane	3	Imp
( Ilustruje to zamieszczony aneks ) .	zamieszczony	3	Perf
Protestują przeciwko zamierzonej budowie .	zamierzonej	2	Perf
Twoi pasterze błogosławią ciągnące na wojnę armaty .	ciągnące	3	Imp
Polacy jadący w autokarze spoglądają z nietajoną dumą na wielkiego rodaka .	jadący	1	Imp
- Przy bramie leżał zabity doberman , który pilnował wejścia .	zabity	4	Perf
Pierwsza udana synteza nowego pierwiastka przeprowadzona została w 1940 roku .	przeprowadzona	5	Perf
Doświadczenia z dzieciństwa spędzonego w rodzinie alkoholowej u wielu mężczyzn i kobiet owocują w dorosłym życiu utrwalonymi schematami odczuwania , zachowania i myślenia .	spędzonego	3	Perf
Wzorem większości producentów przeczytał wyłącznie krótkie streszczenie zawarte na pierwszej stronie , ale po jego minie można było wyczytać , że sama koncepcja go urzekła .	zawarte	7	Perf
Zatopieni w pełnym kontakcie , przestali śmy zauważać resztę świata .	Zatopieni	0	Perf
Po kolejnych wstrząsach wszyscy zostali ewakuowani i nie mają dostępu do swoich domów , z których wiele grozi zawaleniem .	ewakuowani	5	Perf
Maluje na wypełzłym jedwabiu twarze jakby oglądane przez zasłonę z gazy .	oglądane	6	Imp
Piwko siedziała z rękami zaplecionymi pod brodą .	zaplecionymi	4	Perf
Słońce , rozgrzewające żołądek Gregora Smidda , rozgrzało i granat .	rozgrzewające	2	Imp
Leżącego na trawie obok drogi mężczyznę zauważyły przejeżdżające tamtędy przypadkowe osoby .	Leżącego	0	Imp
Angelina Jolie jest bezgranicznie zakochana w swoim adoptowanym synku , który niedawno urodził się w Kambodży .	adoptowanym	7	Perf
Nie zrobiono nic .	zrobiono	1	Perf
Saperzy wydobyli we wtorek sześć artyleryjskich pocisków burzących z czasów II wojny światowej , odkrytych na terenie budowy na krakowskim Prądniku Czerwonym .	burzących	7	Imp
Staruszka wyjęła z kredensu album oprawiony w zniszczoną ciemnowiśniową skórę .	oprawiony	5	Perf
Poszkodowany do dnia dzisiejszego nie otrzymał zakupionego telefonu .	zakupionego	6	Perf
Zdecydowano także zdjąć z programu salwę honorową .	Zdecydowano	0	Perf
Niosła się w obłoku , zakurzona .	zakurzona	5	Perf
Odkrycie jest ważnym głosem w dyskusji dotyczącej bezpieczeństwa przeszczepów pochodzących od zwierząt .	pochodzących	9	Imp
- To stary , rozpadający się budynek .	rozpadający	4	Imp
Surowy , suchy klimat , huraganowe wiatry oraz nieurodzajność gleb spowodowały , że odkryta w 1520 roku przez Magellana Patagonia długo nie była kolonizowana przez Europejczyków .	kolonizowana	23	Imp
Rząd zamierza pomóc rolnikom dotkniętym przez suszę .	dotkniętym	4	Perf
Przebiegające pod miastem chodniki kopalni zalano wodą , a wzgórze zgniło i zapadło się w ziemię jak przydeptane .	zalano	5	Perf
- W naszej drużynie nie ma gwiazd , potrzebni są ludzie nieprawdopodobnie zaangażowani w grę .	zaangażowani	12	Perf
Praca w okupowanych szpitalach przebiega normalnie .	okupowanych	2	Imp
Pierwsze brawa zebrał Bugaj polemizujący z Rakowskim .	polemizujący	4	Imp
W tegorocznym VIII turnieju wystartowało 18 drużyn podzielonych na 6 grup .	podzielonych	7	Perf
Ogłoszone wczoraj dane Narodowego Banku Polskiego , dotyczące wielkości deficytu na rachunku obrotów bieżących , zaskoczyły ekonomistów .	Ogłoszone	0	Perf
A to może uratować od śmierci , bo początek choroby zostanie w porę wykryty .	wykryty	13	Perf
Policja przypuszcza , że najnowszy ładunek został porzucony przez spłoszonego niedoświadczonego terrorystę .	spłoszonego	9	Perf
Odnalazł Jaskra , kibicującego łupiącym w gwinta krasnoludom .	łupiącym	4	Imp
Obaj chorążowie zostali natychmiast zatrzymani i osadzeni w areszcie .	osadzeni	6	Perf
Jednak główną rolę w pracy nad brzmieniem płyty odegrały gitarzystka Wendy Melvoin i grająca na instrumentach klawiszowych Lisa Coleman .	grająca	13	Imp
W 2000 r . na światowych giełdach nastąpił krach , a zawyżone kursy akcji spółek internetowych spadły na łeb .	zawyżone	11	Perf
Trzy osoby podejrzane o korupcję , w tym profesora , który przewodniczył komisji egzaminującej weterynarzy , zatrzymali warmińsko - mazurscy policjanci .	egzaminującej	13	Imp
W każdą cząstkę koła wpisany jest inny fragment waśni .	wpisany	4	Perf
Pokój , do którego zaprowadzono gości , miał zaokrąglone wszystkie ściany .	zaokrąglone	8	Perf
ZChN-owcy argumentują , że w klubie nie odbyła się żadna debata na temat polityki gospodarczej prowadzonej przez koalicję .	prowadzonej	15	Imp
Wtedy moje życie będzie potwierdzone .	potwierdzone	4	Perf
Już Pitagorejczycy znali podobno wszystkie najbardziej regularne wielościany nazywane foremnymi .	nazywane	8	Imp
Związkowcom udało się przedłużyć okres przejściowy dla nauczycieli mianowanych , którzy nie mają odpowiednich kwalifikacji .	mianowanych	8	Perf
Ksiądz zajął fotel dyrektora , oparł o brzeg biurka splecione dłonie , czekał .	splecione	9	Perf
Oto ja , sponiewierana i przeklęta Żydówka , błagam was o litość .	sponiewierana	3	Perf
W opisywanej już szczegółowo scenie przy stole każda mówi w innym języku . . .	opisywanej	1	Imp
( Michał krzywi się , wyraźnie zirytowany . )	zirytowany	6	Perf
Od kolebki , od małych lat jestem tu wychowany , na tym placu .	wychowany	8	Perf
Język telenowel jest ujednolicony , mało barwny , ogólnopolski .	ujednolicony	3	Perf
Nie wiadomo też , kto nam odda pieniądze , jeśli obiecanej nagrody nigdy nie zobaczymy .	obiecanej	10	Perf
Nasz artykuł o zakupie przez wojsko kurtek dla pilotów od firmy kierowanej przez Bogusława Bagsika spowodował kontrolę Najwyższej Izby Kontroli .	kierowanej	11	Imp
Zasięg prac był dokładnie określony .	określony	4	Perf
To informacja poprzedzona chrząknięciem , ściszeniem głosu , podana jakby mimochodem .	poprzedzona	2	Perf
Dziś już wiadomo , że powszechnie akceptowany na świecie jest model bazujący na podejściu bilansowym , koncepcji pełnej alokacji i metodzie zobowiązań .	akceptowany	6	Imp
W ten sposób zaaprobowane zostało wstępne porozumienie , osiągnięte w ubiegłym roku przez ministrów zdrowia Piętnastki .	osiągnięte	8	Perf
W sobotę podporucznik Ziemba przeniósł swoje łóżko do kuchni , rowery wstawiono do pokoju podporucznika Kowalika .	wstawiono	11	Perf
Będzie pewnie załadowany .	załadowany	2	Perf
Nagle z ciemności wyłoniło się trzech mężczyzn kryjących twarze pod kominiarkami .	kryjących	7	Imp
Myślano o dorocznym spotkaniu ekonomistów i biznesmenów Wschodu i Zachodu w Davos .	Myślano	0	Imp
Tezy są skonfiskowane , ale to są rzeczy wiadome .	skonfiskowane	2	Perf
Wystawa w Tel Awiwie przyciągnęła ponad 5 tysięcy zwiedzających , pokazano ją we wszystkich izraelskich telewizjach , pisały o niej wszystkie gazety .	pokazano	10	Perf
Z pociętego nożem brzucha kobiety sączyła się krew .	pociętego	1	Perf
– Leżał na rękawicach ochronnych i też był popaprany ziemią .	popaprany	8	Perf
Na lewo od nich widać cylindryczny budynek mieszczący teleskop Subaru .	mieszczący	7	Imp
Obaj chorążowie zostali natychmiast zatrzymani i osadzeni w areszcie .	zatrzymani	4	Perf
Największe zainteresowanie budzi jednak specjalne seminarium poświęcone ustaleniu budowy ludzkiego DNA .	poświęcone	6	Perf
Już na schodach usłyszała dźwięki dobiegające z komnaty dziadka .	dobiegające	5	Imp
Wiele zbrodni nigdy nie zostało ujawnionych .	ujawnionych	5	Perf
Tymczasem ten istniejący był gruntownie remontowany kilka lat temu .	remontowany	5	Imp
- Bardzo trudne jest przejście z naszych pontonów na opanowywany statek .	opanowywany	9	Imp
Po odparciu ataku i ujęciu 10 terrorystów zawrócono konwój do bazy w Al Kut .	zawrócono	7	Perf
Prawdopodobnie po zakończeniu prac wszystkie znaleziska znajdą się tam na specjalnie przygotowanej wystawie .	przygotowanej	11	Perf
Tutaj także zostały podmyte piwnice domów .	podmyte	3	Perf
Wczepiony w worki , ściąga je na podłogę .	Wczepiony	0	Perf
Rodzina i przyjaciele powitali w sobotę uwolnione przez rosyjskie służby specjalne Polki .	uwolnione	6	Perf
Kilka par tańczyło w przyćmionym świetle , które zdawało się być substancją podobną do mgły z tiulu .	przyćmionym	4	Perf
Z pozostałymi członkami dawnego kierownictwa związanymi z Gomułką plenum obeszło się bezceremonialnie , usuwając ich w większości ze składu KC .	związanymi	5	Perf
Wargi nie pulsowały triumfującą czerwienią .	triumfującą	3	Imp
Projekty w kierunku zachodnim zostaną zrobione w przyszłym roku .	zrobione	5	Perf
Powinna ona również być akredytowana , gwarantowana .	akredytowana	4	Imp
Musieli się przebić przez ludzkie gromady idące w przeciwnym kierunku .	idące	6	Imp
W latach 90 . wielu duszpasterzy , kierując się potrzebą posiadania wyrazistego wroga , wskazuje z ambony na wyraźnie nazwany obóz polityczny , lożę , fundację czy partię .	nazwany	19	Perf
Jest zadowolona i ma portret jeden zamówiony .	zamówiony	6	Perf
- Ustępstwa wobec anestezjologów zostały wymuszone .	wymuszone	5	Perf
Ultimatum postawione przez Izrael minęło wczoraj .	postawione	1	Perf
Pogłębiły się zmarszczki , sczerniały sińce pod oczami ; był blady i jakby przygarbiony .	przygarbiony	13	Perf
Jeżeli nasz samochód to combi lub van , a zwierzak jest duży , możemy przewozić go w odpowiednio przygotowanym bagażniku .	przygotowanym	18	Perf
Dotychczasowa siedziba Archiwum jest przede wszystkim za mała w stosunku do wzrastających w szybkim tempie zbiorów .	wzrastających	11	Imp
TP SA chce złagodzić planowane redukcje .	planowane	4	Imp
Większość skradziono w Berlinie , Hamburgu , Kilonii i Bremie .	skradziono	1	Perf
Tymczasem polska motoryzacja nie ma żadnej przyszłości poza prostym składaniem zestawów samochodowych , a planowana operacja ma zabezpieczyć interesy banków .	planowana	14	Imp
Stanowi to 0,7 proc . budżetu państwa i jest najniższą od trzech lat sumą przeznaczaną na kulturę .	przeznaczaną	14	Imp
Zbiornik został niemal całkowicie zniszczony .	zniszczony	4	Perf
Często oglądanym w tych dniach obrazkiem byli ludzie wylewający wiadrami wodę z piwnic , komórek i garaży .	wylewający	8	Imp
Poruszyły się wskaźniki na podświetlanych zegarach .	podświetlanych	4	Imp
Wszystkie pieniądze z aukcji zostaną przeznaczone na budowę nowego oddziału przeszczepowego dla dzieci z białaczką przy szpitalu w Poznaniu .	przeznaczone	5	Perf
Wybielona światłem twarz nie miała żadnego wyrazu .	Wybielona	0	Perf
Drzymałowie mieszkali w bocznej , zacisznej uliczce , w nowo zbudowanym domu .	zbudowanym	10	Perf
- Był zabezpieczony .	zabezpieczony	2	Perf
Na szczęście voyagerom wyznaczono cele .	wyznaczono	3	Perf
Podobno były nawet pokazywane na wystawie przemysłowej , która odbyła się tu w zeszłym roku .	pokazywane	3	Imp
O godzinie dziewiątej rewiry były już zapchane .	zapchane	6	Perf
Czy wszystkie galaktyki Seyferta typu 2 mają pierścień pyłowy i ukryty obszar szybkich obłoków gazowych ?	ukryty	10	Perf
Rzadki sosnowy las był połamany i dymił .	połamany	4	Perf
- Uznał sprawę za skończoną i , nie zawracając sobie więcej głowy dziewczynkami , pomaszerował przez boisko .	skończoną	4	Perf
Wobec tego zamykam listę pytających .	pytających	4	Imp
Niewiele brakowało , by zaproponowała odstrzał niegrzecznych myśliwych polujących na kuropatwy .	polujących	8	Imp
Kompromis na pewno zostanie szybko znaleziony .	znaleziony	5	Perf
Pomnik , zniszczony przez hitlerowców , został odbudowany w 1984 r.	zniszczony	2	Perf
Nawóz zielony to zielona masa roślinna pozostawiona w glebie .	pozostawiona	6	Perf
W pustym hallu , zebrani przy swoich skrzynkach żołnierskich , stali nasi chłopcy .	zebrani	4	Perf
W ciemnym miejscu chodnika do samotnie idącej dziewczyny podbiegł mężczyzna i zgwałcił ją .	idącej	6	Imp
Do przechodzącego ulicą 28-letniego mieszkańca Ostrowca Świętokrzyskiego oddał dwa strzały .	przechodzącego	1	Imp
Odzyskanie rodowej siedziby jest jednym z głównych celów Fundacji założonej w latach 90 . przez ks . Adama Czartoryskiego .	założonej	9	Perf
Zorganizowano również dla nich warsztaty rękodzielnicze z zakresu robienia na drutach , haftowania , tkania , wykonywania makram .	Zorganizowano	0	Perf
Przewodniczącym , po raz kolejny , wybrano Zbigniewa Wiktora , wykładowcę akademickiego z Wrocławia .	wybrano	6	Perf
Zatrzymanym przedstawiano zarzuty udziału w zorganizowanej grupie przestępczej i wprowadzenia na rynek narkotyków .	zorganizowanej	5	Perf
To bardzo denerwujące , bo nie wiesz , o czym mówisz .	denerwujące	2	Imp
Jeden Chińczyk został zabity .	zabity	3	Perf
Potem polski papież zostałby w Watykanie kanonizowany .	kanonizowany	6	Perf
Pierwsze i drugie miejsce zajęły słowackie dziewczęta , ubrane w getry i krótkie falbankowe spódniczki .	ubrane	8	Perf
Pod uniesionymi zasłonami rozległego łoża z trudem udało mu się dostrzec ginącą w powodzi koronek , pomarszczoną twarz pani Lamaire .	ginącą	11	Imp
Ostatnią decyzją Adamsa , podjętą przed opuszczeniem Białego Domu , było podpisanie nominacji dla Johna Marshalla na prezesa Sądu Najwyższego .	podjętą	4	Perf
Wróbel był zaskoczony wiedzą posła Grzesika .	zaskoczony	2	Perf
- Na tym wyczerpali śmy listę posłów zapisanych do zabrania głosu .	zapisanych	7	Perf
Udzielając poparcia świętej wojnie , mogli poprawić swoją nadszarpniętą reputację .	nadszarpniętą	8	Perf
Teraz zaczynał się najbardziej pokreślony fragment .	pokreślony	4	Perf
TOPR-owcy ostrzegają przed bardzo trudnymi warunkami panującymi na szlakach .	panującymi	6	Imp
Zwolnienia zostaną rozłożone na cały 2001 r.	rozłożone	2	Perf
Potem , gdy próbowali je sprzedać w Szanghaju , zostali zauważeni przez policję .	zauważeni	10	Perf
A towarzyszą temu okrzyki i gesty wyrażające pogardę , wrogość , zawziętość .	wyrażające	6	Imp
Jeśli zostanie on zrealizowany , to za pięć lat będziemy mieli w kraju ok . półtora miliona rodzin pszczelich .	zrealizowany	3	Perf
Niestety był to wpływ negatywny , pogłębiający istotniejące już uprzedzenia .	istotniejące	7	Imp
Biblioteki kościelne zostały także obdarowane kolekcjami .	obdarowane	4	Perf
- Złożę też za chwilę na ręce pana marszałka ową poprawkę formalną , uzgodnioną z Biurem Legislacyjnym .	uzgodnioną	13	Perf
Rozegrano dwa wyścigi .	Rozegrano	0	Perf
- Muzyka nagrywana jest w Stanach . . .	nagrywana	2	Imp
W ciemnym miejscu chodnika do samotnie idącej dziewczyny podbiegł mężczyzna i zgwałcił ją .	idącej	6	Imp
W tym krótkim okresie okazało się , że wielu kierowców nie stosuje się do wprowadzonych ograniczeń .	wprowadzonych	14	Perf
Energia ta może być sublimowana , przekształcana .	sublimowana	4	Imp
Na zakończonym wczoraj w Paryżu kongresie FPK przyjęto 1080 głosami przeciw 43 centrowy program szefa partii Roberta Hue .	przyjęto	7	Perf
PiS okazało się osamotnione w swojej argumentacji .	osamotnione	3	Perf
Kaczyńscy i ich główni zausznicy są postrzegani jako politycy niebezpieczni , nieobliczalni .	postrzegani	6	Imp
I ostatecznie załoga została wyznaczona .	wyznaczona	4	Perf
I ręka albo noga mają wyrobione gusta kulinarne ?	wyrobione	5	Perf
Użytkownik ma do dyspozycji 6 baz zawierających informacje posortowane według wybranego kryterium .	posortowane	8	Perf
Należała do mojego pokolenia , została też przez to pokolenie dobrze przyjęta .	przyjęta	11	Perf
- Z naszych danych wynika , że przybywa kontraktów denominowanych w złotych .	denominowanych	9	Imp
Skarżył się jej przecież , że w kieracie prozaicznych zajęć , wśród ludzi zajętych tylko sprawami chleba powszedniego , brak mu rozmów na poważne tematy .	zajętych	13	Perf
jest zatruta woda .	zatruta	1	Perf
Jeden z architektów przybija na ocalałej bramie kartkę wyrwaną z notesu .	wyrwaną	8	Perf
Zbrodnia była dokonana pod Urlami .	dokonana	2	Perf
Ulice zajmą pojazdy napędzane siłą ludzkich mięśni .	napędzane	3	Imp
Do sali zjechaliśmy godnie , windę znarowioną już naprawili .	znarowioną	6	Perf
Kiepsko wyglądała , musiała być wykończona tą dobą .	wykończona	5	Perf
Administracja Lecha Wałęsy nie przewidziała w nim puli na nagradzanie wyróżniających się młodych Polaków .	wyróżniających	10	Imp
Oparła się na wypiętych za plecami rękach i z lekka wyprężyła przy tym tułów .	wypiętych	3	Perf
Pięcioletnia dziewczynka , porwana wczoraj przez 65-letniego mężczyznę w Chorzowie na Śląsku , odzyskała wieczorem przytomność .	porwana	3	Perf
W Wojewódzkim Szpitalu Zespolonym odbyła się pierwsza w Poznaniu udana operacja przeszczepienia rogówki .	Zespolonym	3	Perf
Wezwana na miejsce żandarmeria wojskowa stwierdziła , że skrzynki , w których przechowywane były materiały wybuchowe , są puste .	przechowywane	12	Imp
Uważa ona , że błaha w gruncie rzeczy sprawa jest wyolbrzymiana przez media .	wyolbrzymiana	10	Imp
Dobył go z ukrytej pod kaftanem pochwy .	ukrytej	3	Perf
W większości jest on przeznaczany na budowę plastrów .	przeznaczany	4	Imp
Dzieci i niektórzy renciści byli by zwolnieni z opłaty .	zwolnieni	6	Perf
Wczoraj dopiął swego , chociaż musiał sporo dołożyć do umówionych wcześniej 300 tysięcy .	umówionych	9	Perf
Przygotowane składniki wymieszać z serkiem i przyprawami .	Przygotowane	0	Perf
W Czarnem umieszczono go w celi o zaostrzonym rygorze .	zaostrzonym	7	Perf
- Zbita z tropu uśmiechnęła się niepewnie .	Zbita	1	Perf
Każdy zbombardowany , okaleczony , nieszczęśliwy dom stawał się teraz ich celem .	okaleczony	3	Perf
Trzeba pousuwać z działek stojącą wodę i uporządkować strychy oraz piwnice .	stojącą	4	Imp
- Jest uzbrojony po zęby .	uzbrojony	2	Perf
- Ale kto decyduje , czy działanie jest wymierzone przeciwko ustrojowi ?	wymierzone	8	Perf
- A te szacunki były publikowane ?	publikowane	5	Imp
Zaangażowała się w Teatrze Dramatycznym kierowanym wówczas przez Gustawa Holoubka .	kierowanym	5	Imp
Ciała 7 turystów nie zostały jeszcze zidentyfikowane .	zidentyfikowane	6	Perf
Nakazuje je Konstytucja RP oraz przewidywany harmonogram reform ustrojowych .	przewidywany	5	Imp
Na posłanie z ziół i kwiatów ułożono kości i pokryto je szczątkami sztandaru .	ułożono	6	Perf
W stodole spostrzegła zarys postaci w nieheblowanych deskach .	nieheblowanych	6	Imp
Związki zawodowe reprezentują przecież grupy obywateli i są zobligowane do dbania o ich interesy .	zobligowane	8	Perf
ZSRR zgodził się zwolnić zatrzymanych marynarzy .	zatrzymanych	4	Perf
Oto ja , sponiewierana i przeklęta Żydówka , błagam was o litość .	przeklęta	5	Perf
Te wszystkie fakty zostają ocenione w urnie wyborczej .	ocenione	4	Perf
PQBoot to narzędzie do zmiany partycji bootującej dla tych użytkowników , którzy tylko od czasu do czasu potrzebują skorzystać z innego systemu .	bootującej	6	Imp
Czynią tak wspomniani starościna i starosta .	wspomniani	2	Perf
Ale po pierwsze czuł się głęboko skompromitowany , a po drugie wydawało się wątpliwe , żeby mógł jeszcze coś w tamtym środowisku osiągnąć .	skompromitowany	6	Perf
W piątek życzenia od przedstawicieli władz miejskich , kolejowych i zaproszonych gości odebrał dyrektor ZSET Kazimierz Maćkowiak .	zaproszonych	10	Perf
Barok ambony , kiedyś dla niej naturalny , płynący dzielnie przez wieki , sprawiał teraz wrażenie kłopotliwego dodatku , fanaberii artysty , był nieznośnie kiczowaty , jarmarczny .	płynący	8	Imp
Użyto gazów łzawiących i ogłuszających granatów .	Użyto	0	Perf
200 z nich chronionych jest jako zabytki architektury ogrodniczej .	chronionych	3	Imp
Leczenie podtrzymujące za pomocą steroidów jest oczywiście gorszym rozwiązaniem niż leczenie polegające na usunięciu przyczyny .	podtrzymujące	1	Imp
Mam najnowsze zestawy osób nagrodzonych .	nagrodzonych	4	Perf
Jeśli jednak różnice te nie pozwalają wam zbudować takiego formalnego porozumienia , dajcie zielone światło do współdziałania ludziom tworzącym wasze ugrupowania .	tworzącym	18	Imp
Policja po kilku godzinach odzyskała skradziony samochód , jeszcze przed oficjalnym zgłoszeniem przestępstwa .	skradziony	5	Perf
Rzecznik Praw Obywatelskich wystąpił w obronie inwalidów wojennych i wojskowych , którym wprowadzono obowiązek płacenia za pobyt w sanatoriach uzdrowiskowych .	wprowadzono	12	Perf
Śledztwo przeciwko świadkowi koronnemu zostanie umorzone dopiero , gdy bez zarzutu wypełni swoją rolę .	umorzone	5	Perf
Jadący motorem 22-letni mężczyzna na łuku drogi stracił panowanie nad pojazdem i uderzył w betonowe ogrodzenie .	Jadący	0	Imp
Przypuśćmy , że stoi ono w związku z postępującą chorobą .	postępującą	8	Imp
Rok temu okazało się , że mieszka w lokalu należącym do sąsiadki .	należącym	9	Imp
Parkowanie na wyznaczonych miejscach wymaga posiadania karty parkingowej .	wyznaczonych	2	Perf
Z wykrzywioną z wysiłku twarzą leżał na plecach na ławce do wyciskania .	wykrzywioną	1	Perf
- Zacisnęła pięści pochlapane krwią .	pochlapane	3	Perf
Załadował na wóz wynajętych gazeciarzy i rozwiózł po mieście , każąc rozdawać list przechodniom .	wynajętych	3	Perf
Dopiero po 5 minutach zamieszanie zostało opanowane przez policję .	opanowane	6	Perf
W 1993 roku , jeżeli zostanie utrzymana dyscyplina finansowa , prognoza CUP może okazać się realna .	utrzymana	6	Perf
W tegorocznym VIII turnieju wystartowało 18 drużyn podzielonych na 6 grup .	podzielonych	7	Perf
Manifestanci próbowali uniemożliwić policji zamykanie biur zdelegalizowanego ugrupowania .	zdelegalizowanego	6	Perf
Nawiązano współpracę z kołami gospodyń wiejskich w Domatkowie , Kolbuszowej Górnej , Nowej Wsi , Weryni i Widełce .	Nawiązano	0	Perf
Okna były pozamykane .	pozamykane	2	Perf
Uwolniono też polskiego ambasadora w Jemenie .	Uwolniono	0	Perf
Usiedli na zwalonej kłodzie .	zwalonej	2	Perf
Jadący z nadmierną szybkością wartburgiem Marek Ch . , będąc pod wpływem alkoholu , został wyrzucony na łuku jezdni na pobocze , a następnie przekoziołkował i uderzył w drzewo .	wyrzucony	15	Perf
Równocześnie wznoszono nowoczesne dzielnice mieszkaniowe .	wznoszono	1	Imp
Jest wyprasowana .	wyprasowana	1	Perf
Powołana przez burmistrza komisja dokonała kontroli w Ośrodku .	Powołana	0	Perf
Posiadał wszechstronny , uniwersalny umysł obejmujący szereg nauk specjalnych .	obejmujący	5	Imp
Z tych samych powodów mile widziane są również małżeństwa .	widziane	5	Imp
Systematycznie prowadzili kontrole , zmierzające do ujawnienia różnego rodzaju piractwa .	zmierzające	4	Imp
Przedstawiamy dziś rasę niezwykle rzadką , niehodowaną w Polsce .	niehodowaną	6	Imp
Pochłania go opieka nad trójką dorastających dzieci .	dorastających	5	Imp
Chłopiec wynurza się spod stołu , trzymając na dłoni rozbite jajko , strzaskaną skorupkę , rozlane żółtko i oślizłe białko .	rozlane	15	Perf
- Nie tęskni Pan za niespełnionym marzeniem ?	niespełnionym	5	Perf
- Reforma na pewno nie zostanie zaniechana .	zaniechana	6	Perf
Wszystkie inne warunki miały być ustalone później , na konferencji pokojowej .	ustalone	5	Perf
Zostało ono zorganizowane przez Radę Konferencji Episkopatów Europy .	zorganizowane	2	Perf
Działacze liczą , że związek nie będzie ścigany z całą surowością .	ścigany	7	Imp
Wszelkie informacje podane poniżej dotyczą jedynie wypadków sprawdzonych .	sprawdzonych	7	Perf
Trzymający ją mężczyzna roześmiał się .	Trzymający	0	Imp
Na pewno też wywołał by protesty spowodowane dalszym naruszaniem stabilności sytuacji podatników .	spowodowane	6	Perf
Zwolennicy Mossadegha , ministrowie , podejrzani oficerowie , działacze Tudeh są przesłuchiwani i torturowani .	torturowani	13	Imp
Praca w okupowanych szpitalach przebiega normalnie .	okupowanych	2	Imp
Co zrobić z ukrytym bezrobociem na wsi ?	ukrytym	3	Perf
Deklaracja została natychmiast nadana przez rozgłośnię bagdadzką .	nadana	3	Perf
Na szczególną uwagę zasługują wyraźnie zaakcentowane potrzeby pracy nad własnym charakterem .	zaakcentowane	5	Perf
– Czy zdarzyło ci się kiedykolwiek tańczyć w windzie zawieszonej między piętrami ?	zawieszonej	9	Perf
Owinięty w zwiewne szaty , zasiadał na schodach świątyń , medytując godzinami .	Owinięty	0	Perf
Zgłoszenia przyjmowane są do 1 października 2007 roku .	przyjmowane	1	Imp
Dochodzę do wniosku , że w Sejmie to nie są przedstawiciele narodu , a gromada głupców handlujących między sobą stanowiskami .	handlujących	16	Imp
Uruchamiany system ma stać się zaczątkiem większego , obejmującego całą Wielkopolskę .	obejmującego	8	Imp
W innych miejscach znaleziono wyszlifowane i porysowane przedkarbońskie skały podłoża .	wyszlifowane	4	Perf
Stanął em na przybitych deskach , a Judasz podszedł do mnie , chwiejąc się na stromiźnie .	przybitych	3	Perf
Niedzielny mecz rozgrywany był przy ciągle padającym deszczu .	padającym	6	Imp
Chyba to nieprecyzyjnie powiedziane .	powiedziane	3	Perf
Wkrótce też natknęli się na mężczyzn ściągających skórę z zabitego kozła .	ściągających	6	Imp
W tym przypadku również zalano odcinek asfaltem .	zalano	4	Perf
Opaski przeglądamy w lipcu i niszczymy znajdujące się tam gąsienice .	znajdujące	6	Imp
Kolejną aferę w zakładach pracy chronionej ujawnili policjanci z wydziału do walki z przestępczością gospodarczą Komendy Wojewódzkiej w Olsztynie .	chronionej	5	Imp
Niedawno została opatentowana .	opatentowana	2	Perf
Ponoć dawano Edkowi możliwość ucieczki z więzienia w Bielsku , gdzie trzymano ich przed odesłaniem do obozu .	dawano	1	Imp
Tymczasem wiadomo , że 37-letnia gwiazda jest uzależniona od alkoholu i narkotyków .	uzależniona	7	Perf
Nikt się nie lituje , nie pieści z przyjeżdżającymi na zarobek .	przyjeżdżającymi	8	Imp
Zapomnij też o wszelkich środkach uśmierzających ból .	uśmierzających	5	Imp
W środku był też ciężko poparzony inny mężczyzna .	poparzony	5	Perf
Wtedy wyciąga zawieruszony w pomiętej pościeli telefon komórkowy , by wszystkie je po kolei załatwić .	pomiętej	4	Perf
Rozbiegli się Kaszubi , pod przymusem do tej walki pędzeni .	pędzeni	9	Imp
Szedł w pełnym słońcu , skronie przygniatał piekący ciężar .	piekący	7	Imp
Zostawiono drzewa wskazane przez specjalistów .	wskazane	2	Perf
To były z filcu utoczone dzwony .	utoczone	4	Perf
Jak ta Mirta miała wszystko uporządkowane i przemyślane !	uporządkowane	5	Perf
- Czy policjanci powinni ścigać złodzieja przyłapanego na gorącym uczynku , czy poprzestać na zabezpieczeniu mienia ?	przyłapanego	6	Perf
- Mimo stacjonujących w Groznym wojsk i patroli Rosjanie nie będą się tam czuli bezpiecznie .	stacjonujących	2	Imp
Na ich stoliku leżały pokruszone papierosy , cygara , przewrócone filiżanki .	przewrócone	9	Perf
Pogładził łaskawą pieszczotą wyślizgane drewienka .	wyślizgane	3	Perf
Dla wielu Polaków Hiszpania miała być tą ziemią obiecaną .	obiecaną	8	Perf
W grupie finałowej rozegrano mecze każdy z każdym i wyłoniono zwycięzcę , którym został zespół Warka Tuchola .	wyłoniono	9	Perf
Zebranych powitał burmistrz Bogdan Małecki , on też wygłosił okolicznościowe przemówienie .	Zebranych	0	Perf
Okazuje się , że zaproszona grupa baletowa prawdopodobnie będzie musiała zrezygnować z udziału w festiwalu .	zaproszona	4	Perf
Przygwożdżonemu ich argumentacją Mister O'Gorckowi zawsze pozostawało się wycofać .	Przygwożdżonemu	0	Perf
Właściwie nie czułem się jeszcze senny , chociaż miałem za sobą dość długi i męczący dzień .	męczący	14	Imp
Przechodzień , który pomógł bitemu policjantowi , już dostaje pogróżki .	bitemu	4	Imp
Mieszkający samotnie w starej drewnianej chałupie inwalida nie ukrywa , że jest rozczarowany .	Mieszkający	0	Imp
Zajmowała się tym głównie Maryla Wacławkówna , wygnana ongiś z przedszkola za klerykalizm .	wygnana	7	Perf
Obwieszony policyjnymi kamerami i mikrofonami spotkał się z nią w jadłodajni w centrum Kielc .	Obwieszony	0	Perf
- Posłannictwo lekarzy nie może być realizowane bez pieniędzy .	realizowane	6	Imp
W lutym skradziono ją prawdziwemu funkcjonariuszowi w Warszawie .	skradziono	2	Perf
Niechlubny ranking województwa wielkopolskiego otwiera Wojewódzki Szpital Zespolony w Lesznie .	Zespolony	7	Perf
- Czy byli śmy inwigilowani ?	inwigilowani	4	Imp
" W dzieciństwie byłam często dołowana " .	dołowana	5	Imp
Już prawie jesteś wybudzona .	wybudzona	3	Perf
Za 30.000 złotych wyremontowana została ulica prowadząca do ośrodka zdrowia w Lubiewie .	prowadząca	6	Imp
Gdyby Bergvall zdecydował się przewieźć wydobyty alkohol do Finlandii , zapłaciłby ogromny podatek .	wydobyty	5	Perf
Opchał em się na całą pojemność skurczonego żołądka .	skurczonego	6	Perf
Nikomu nie postawiono zarzutów .	postawiono	2	Perf
Technologię montażu zatrudnieni przy tym pracownicy poznają pod okiem koreańskich specjalistów .	zatrudnieni	2	Perf
Policja przypuszcza , że najnowszy ładunek został porzucony przez spłoszonego niedoświadczonego terrorystę .	spłoszonego	9	Perf
Podobały jej się ogrody otaczające stare wille .	otaczające	4	Imp
Nieznani sprawcy ostrzelali jego samochód zaparkowany przed sklepem .	zaparkowany	5	Perf
Jeszcze po południu zawieszony prezes największego polskiego ubezpieczyciela nie wiedział , czy członkowie rady podejmą jakieś decyzje w jego sprawie .	zawieszony	3	Perf
– Osoba mojego kontrkandydata z racji jego pracy zawodowej była na pewno bardziej znana w gminie .	znana	13	Imp
Na razie jednak wiatr zerwał w ubiegły czwartek blachę będącą elementem ozdobnym wiaty stacji .	będącą	9	Imp
Nawiedzony dom w Rajsach znają wszyscy , zarówno mieszkańcy Miejsca Piastowego , jak i krośnianie .	Nawiedzony	0	Perf
Radykalnie negując ład istniejący na ziemiach ukraińskich w Polsce i ZSRR , nacjonalizm odrzucał każdą próbę prowadzenia polityki w ramach realnego układu sił .	istniejący	3	Imp
Potem często pokazywano ich przytulających się lub całujących .	przytulających	4	Imp
W roku 2001 został powołany na stanowisko kierownika Zakładu Filozofii Współczesnej Instytutu Filozofii UŁ .	powołany	4	Perf
Drugiej , rozładowanej do połowy w Pruszkowie , rabusie nie tknęli .	rozładowanej	2	Perf
– Nie zostanie pan jednak całkiem odsunięty od śledztwa .	odsunięty	6	Perf
Ale ona tylko skinęła na okrwawionego fenomulata .	okrwawionego	5	Perf
Sprawy te nie są regulowane prawem Unii , nie skutkują także dla budżetu państwa .	regulowane	4	Imp
Może to falsyfikat namalowany specjalnie pod prasowe ogłoszenie ?	namalowany	3	Perf
Zazwyczaj młodym kobietom z zagranicy , zwabionym i przymuszanym do nierządu , sutenerzy odbierają paszporty .	przymuszanym	8	Imp
Przejazd we wrocławskich Świniarach nie jest strzeżony .	strzeżony	6	Imp
Praca z książką to metoda oparta na słowie drukowanym .	oparta	5	Perf
Dymek w tym czasie ekspanderem przymocował otwartą klapę .	otwartą	6	Perf
Komputery podłączone do Sieci mogą skorzystać z okna zadań badawczych .	podłączone	1	Perf
Ostatnio wydzierżawił rolnikom pod uprawy 70 ha leżących w otulinie lotniska .	leżących	7	Imp
Omawiana książka jeszcze raz to potwierdza .	Omawiana	0	Imp
Solenizantki złożyły życzenia sąsiadującym z nimi w kalendarzu Ernestom i Bożenom .	sąsiadującym	3	Imp
W nadchodzącym tygodniu wyznaczone zostały posiedzenia czterech komisji sejmowych .	wyznaczone	3	Perf
Stanął w nich ubrany w piżamę , zakrwawiony 12-letni Łukasz , wnuk gospodarzy , po chwili osunął się na ziemię .	zakrwawiony	7	Perf
W rozbite pojazdy uderzyła jeszcze jedna ciężarówka .	rozbite	1	Perf
Na ich stoliku leżały pokruszone papierosy , cygara , przewrócone filiżanki .	pokruszone	4	Perf
Podczas ostatniego spotkania przywódców Piętnastki w Brukseli rozstrzygnięto też kilka spornych kwestii związanych z miejscem przyszłych członków w unijnych instytucjach .	rozstrzygnięto	7	Perf
Myślałem , że pan jest poważnie myślącym młodym człowiekiem .	myślącym	6	Imp
Powodem był ulatniający się z nieszczelnej instalacji gaz .	ulatniający	2	Imp
Do niedawna twierdziła , że to plotki wyssane z palca .	wyssane	7	Perf
Niosło wonią smoły i wodorostów , woda pluskała cicho o łódki przywiązane do omszałych pali .	przywiązane	11	Perf
Odwołany rząd , który zostaje przez Sejm zmuszony do rządzenia , zwykle przestaje pracować .	Odwołany	0	Perf
Wyróżniał się licznymi szybami górniczymi , kryjącymi w swych wnętrzach wieże wyciągowe i windy do przewozu ludzi i węgla .	kryjącymi	6	Imp
Ułatwi ona włączenie się do ruchu jadącym z Koziegłów do Poznania .	jadącym	6	Imp
Przywołał żołnierza niosącego wiadro .	niosącego	2	Imp
Stary Pancer , z rękami w kieszeniach spodni , stał oparty o biurko .	oparty	10	Perf
Nie czekał długo , po kilku minutach wybiegła , wyraźnie spłoszona .	spłoszona	10	Perf
Później połączono go z lądem groblą .	połączono	1	Perf
Panującej atmosferze uległa również obsada maszynowni .	Panującej	0	Imp
Tak to przynamniej wynika z danych statystycznych zebranych przez Komendę Wojewódzką Policji w Szczecinie .	zebranych	7	Perf
W czasie pozorowanych działań bojowych jednostki z pozycji obronnych dokonają przegrupowania , aby po sforsowaniu szerokiej przeszkody wodnej wyjść na nowe rubieże aktywnych działań zaczepnych .	pozorowanych	2	Imp
Dyna nie wydawał się obrażony .	obrażony	4	Perf
Szofer niecierpliwił się przy załadowanej ciężarówce .	załadowanej	4	Perf
Akcja propagująca eutanazję rozkręca się .	propagująca	1	Imp
W ten sposób zaaprobowane zostało wstępne porozumienie , osiągnięte w ubiegłym roku przez ministrów zdrowia Piętnastki .	zaaprobowane	3	Perf
Kilka dni temu na oddział trafiła prątkująca absolwentka gimnazjum .	prątkująca	6	Imp
Stanowczo odradza się naśladowanie ich przez turystów , ponieważ dla człowieka wejście na leżący na zboczu płat śniegu kończy się tragicznie .	leżący	13	Imp
Bronił eksmitowanych na bruk , naprawiając błędy przyjętej przez koalicję SLD­PSL ustawy , grzmiał na globalistów i świeżych krajowych , drapieżnych kapitalistów .	eksmitowanych	1	Imp
Przy końcu alei stał świeżo wkopany słup , pomalowany na jasnoniebieski kolor .	wkopany	5	Perf
I te bilety uśmierzyły wzburzone umysły golibrody i wynalazcy .	wzburzone	4	Perf
Chcemy , by byli wybierani przez radnych .	wybierani	4	Imp
Widział em też węże na drodze , przejechane przez samochody .	przejechane	7	Perf
Polacy jadący w autokarze spoglądają z nietajoną dumą na wielkiego rodaka .	nietajoną	6	Imp
33-letniemu mężczyźnie przedstawiono zarzut usiłowania zabójstwa ochroniarza .	przedstawiono	2	Perf
Zazwyczaj młodym kobietom z zagranicy , zwabionym i przymuszanym do nierządu , sutenerzy odbierają paszporty .	przymuszanym	8	Imp
Długo oczekiwana wiosna przyjdzie do nas już jutro !	oczekiwana	1	Imp
A to pewnie był akurat chwyt zamierzony przez autora i głęboko uzasadniony .	uzasadniony	11	Perf
W sprasowanych autach zginęły cztery osoby .	sprasowanych	1	Perf
Do tej pory w Polsce około tysiąc aut ma zamontowany system tej amerykańskiej firmy .	zamontowany	9	Perf
Arcybiskup Ochrydy dostarcza nam również bardzo konkretnych informacji dotyczących Borysa .	dotyczących	8	Imp
Aresztowanego na 48 godzin mistrza zwolniono po poręczeniu majątkowym .	Aresztowanego	0	Perf
Wykaz obejmował 33 rasy psów wymagających rejestracji i szkolenia .	wymagających	5	Imp
Rękopisy zostały przyniesione przez lwowianina , który po wojnie osiedlił się w tych stronach .	przyniesione	2	Perf
Maksymalizację wydajności skrawania osiąga się dzięki maksymalizacji przekroju warstwy skrawanej i prędkości skrawania .	skrawanej	9	Imp
Widzę sterczące w górę żurawie studzienne .	sterczące	1	Imp
Została przyjęta .	przyjęta	1	Perf
Okaz ten jest chroniony przez Konwencję Waszyngtońską .	chroniony	3	Imp
Dziewczyna obracająca się kusząco na parkiecie wydała mu się wyjątkowo wyjątkowa .	obracająca	1	Imp
Konwój został zaatakowany w okolicach An Numaniyah w prowincji Wasit .	zaatakowany	2	Perf
Zamki przemycała kobieta handlująca na bazarze Różyckiego w Warszawie .	handlująca	3	Imp
Po miesiącu zdałam egzamin i przeniesiono mnie do drugiej klasy , do innej szkoły .	przeniesiono	5	Perf
Ale ona tylko skinęła na okrwawionego fenomulata .	okrwawionego	5	Perf
Sklepy były pozamykane .	pozamykane	2	Perf
Ten dialog został odtworzony w śledztwie bez trudu .	odtworzony	3	Perf
W czwartkowe popołudnie gasili płonący śmietnik przy ul. Brodzińskiego w Proszowicach .	płonący	4	Imp
Samochód był w pełni ubezpieczony w Hestii .	ubezpieczony	4	Perf
Łódź odnaleziono porzuconą i ogołoconą z silnika i kosztownego wyposażenia .	ogołoconą	4	Perf
Obok wspomnianych przedmiotów ścisłych lubi biologię , przykłada się do angielskiego .	wspomnianych	1	Perf
Wysunięte pretensje pod adresem autorów słownika nie zmienią językowej rzeczywistości .	Wysunięte	0	Perf
Jest tu 16 jezior , łącznie z 4 jeziorami na obrzeżu , znajdującymi się już poza administracyjną granicą WPN .	znajdującymi	12	Imp
Lecz w tym celu będą stosować katorżnicze kryteria i wyśrubowane standardy .	wyśrubowane	9	Perf
Ptaki te chętnie korzystają z pokarmu wykładanego dla parkowych łabędzi .	wykładanego	6	Imp
Staruszkowie skwapliwie wyściskali Pindla , a on stał oszołomiony .	oszołomiony	8	Perf
Pod jej nosem błyszczał pot , musiała biec , widocznie firma pilnująca mieszkania nie zawiadomiła jej o wyłączeniu alarmu .	pilnująca	11	Imp
Partie polityczne oraz reprezentujący ich politycy stanęli w wyborcze szranki .	reprezentujący	3	Imp
Nie kryją się z tym , chcą być widziani , rozpoznani ?	widziani	8	Imp
Twarz ojca wydawała się dziwnie zasępiona .	zasępiona	5	Perf
Naukowcy z Uniwersytetu w Portland w USA sklonowali rezusa , czyli małpę należącą do rzędu naczelnych .	należącą	12	Imp
PiS okazało się osamotnione w swojej argumentacji .	osamotnione	3	Perf
Są to w przeważającej większości lasy sosnowe .	przeważającej	3	Imp
Załadowano się na pięć barek i o zmierzchu wyruszono .	wyruszono	8	Perf
Okazuje się przy tym , że pewne czynniki mogą realizować swój wpływ na kilku etapach zachowań absencyjnych , następujących po sobie .	następujących	18	Imp
- W spadku po odchodzącej ekipie nowy rząd otrzymuje olbrzymi deficyt w bilansie handlowym .	odchodzącej	4	Imp
Wstępna analiza Inspektoratu wskazuje , że sąd w Jeleniej Górze nie jest przystosowany do procesów , w których oskarżonymi są członkowie zorganizowanych grup przestępczych .	zorganizowanych	21	Perf
Po dwóch miesiącach przyprowadzono kotce jej własne dzieci .	przyprowadzono	3	Perf
Prokuratura Okręgowa w Krakowie , która prowadzi śledztwo w sprawie wycieku testów w 2000 r . , potwierdziła , że sprzedawano testy w cenach od kilkuset złotych do 15 tysięcy .	sprzedawano	20	Imp
W sprasowanych autach zginęły cztery osoby .	sprasowanych	1	Perf
Pod stołem bawił się granatem mały chłopiec , nazywany Osęką .	nazywany	8	Imp
Każdy upływający dzień przejmował go strachem .	upływający	1	Imp
Ogień trzaskał w ciszy , dzieci wybiegły na dwór przestraszone .	przestraszone	9	Perf
Popędzali swoje konie , bo koniecznie chcieli dopaść upatrzonej zwierzyny .	upatrzonej	8	Perf
W 1991 dokonano kolejnych zmian administracyjnych .	dokonano	2	Perf
Zazwyczaj młodym kobietom z zagranicy , zwabionym i przymuszanym do nierządu , sutenerzy odbierają paszporty .	zwabionym	6	Perf
Trzeba mocy Bożej , żeby został wyrzucony .	wyrzucony	6	Perf
Rozumowanie Angusa nie było więc pozbawione podstaw , ale jeszcze zbyt daleko biegło w przyszłość .	pozbawione	5	Perf
Dlatego problem ten musi zostać wnikliwie rozpatrzony , a większość obiektów powinna być bezwzględnie zwrócona społeczeństwu , bo za jego pieniądze zostały wzniesione .	zwrócona	14	Perf
Kolega Jamrozik został zaproszony na pogrzeb .	zaproszony	3	Perf
Wśród ludzi wybranych na najwyższe urzędy zjawiają się bandyci , gangsterzy , szpiedzy .	wybranych	2	Perf
Faceci są dyskryminowani !	dyskryminowani	2	Imp
Powracali tam ci dawno pożegnani .	pożegnani	4	Perf
Dziś zdecydowana większość spółek notowanych na giełdzie chce podwyższać swój kapitał .	notowanych	4	Imp
Została ona zachwiana po październikowych wyborach .	zachwiana	2	Perf
Jeszcze dozwolono ci wybrać . . .	dozwolono	1	Perf
moje chamstwo jest przereklamowane .	przereklamowane	3	Perf
Niektóre sale pałacyku w Karolinie przeznaczono na małe muzeum .	przeznaczono	5	Perf
Leżeli później zlani potem .	zlani	2	Perf
W weekend na zachodnich przejściach granicznych trwały wzmożone kontrole .	wzmożone	7	Perf
Dlatego też uważam , że najwłaściwsze były by gwarancje udzielone przez premiera .	udzielone	9	Perf
Dystychy , analizowane dotąd oddzielnie , złóżmy obecnie w całość , bo przecież w Dusiołku tworzą one taką całość .	analizowane	2	Imp
Jego Ryzyko było by Ryzykiem doprowadzonym do ostateczności .	doprowadzonym	5	Perf
- Nie tęskni Pan za niespełnionym marzeniem ?	niespełnionym	5	Perf
Prawdopodobnie powiaty będą wykonywać zarówno zadania zlecone przez rząd , jak i zadania gmin .	zlecone	6	Perf
Według dyżurnego Komendy Miejskiej Policji w Chorzowie po przebudzeniu dziecka stwierdzono , że zostało ono upite .	upite	15	Perf
Co roku ustalane są nowe listy .	ustalane	2	Imp
– nie wszystkie są zawężone równocześnie .	zawężone	4	Perf
Powstała nawet nauka o snach , nazywana onejrologią .	nazywana	6	Imp
Poruszyły się wskaźniki na podświetlanych zegarach .	podświetlanych	4	Imp
Smażyli ryby złowione w strumieniu .	złowione	2	Perf
Beata nigdy nie zobaczyła swojego wydrukowanego Aniołka .	wydrukowanego	5	Perf
Żegnamy się nowo poznaną piosenką i okolicznościowym hasłem .	poznaną	3	Perf
W innym przypadku nastąpi natychmiastowe spożycie powodujące zwiększenie siły lub ochłodzenie robota .	powodujące	6	Imp
– pokryte mają wszystkie języki . .	pokryte	1	Perf
Powstawały robotnicze kolonie przyfabryczne wiążące pracobiorcę z pracodawcą .	wiążące	4	Imp
Skupieni operatorzy delikatnie manipulowali skomplikowanymi urządzeniami odbioru przekazywanej informacji .	przekazywanej	7	Imp
I szedł em przez te stygnące odchody coraz bardziej markotny , a przygnębienia przybywało mi z każdym krokiem .	stygnące	5	Imp
Nie złożyłem podpisu pod wnioskiem o wotum nieufności skierowanym do marszałka Sejmu .	skierowanym	8	Perf
Każdy zbombardowany , okaleczony , nieszczęśliwy dom stawał się teraz ich celem .	zbombardowany	1	Perf
Pozostawili szklanki z nie dopitą kawą .	dopitą	4	Perf
Były napisane tak , jakby świadomość społeczna w ogóle nie istniała .	napisane	1	Perf
Wcześniej jednak na tapetę wzięły przedstawiony przez Zarząd Gminy projekt budżetu .	przedstawiony	5	Perf
Majka siedziała obok mnie na pniu przewróconej brzozy .	przewróconej	6	Perf
Uchwała rady powinna być podjęta w ciągu miesiąca od dnia doręczenia wniosku Naczelnej Rady Aptekarskiej .	powinna	2	Imp
Skupieni operatorzy delikatnie manipulowali skomplikowanymi urządzeniami odbioru przekazywanej informacji .	przekazywanej	7	Imp
Podstawowe problemy przemysłowej produkcji i masowych zastosowań półprzewodnikowych źródeł światła niebieskiego wydają się już rozwiązane .	rozwiązane	14	Perf
Taki zapis spowoduje obligatoryjność podjęcia przez rzecznika praw obywatelskich spraw skierowanych przez rzecznika praw dziecka .	skierowanych	10	Perf
Do tragedii doszło na łuku drogi ; rozpędzony pojazd zjechał do wypełnionego wodą rowu i przycisnął dziecko .	wypełnionego	11	Perf
Reprezentujący konsorcjum Bank Przemysłowo - Handlowy poinformował o tym ministra gospodarki oraz skarbu państwa .	Reprezentujący	0	Imp
W tym roku w Łódzkiem skradzino już prawie 4,5 tys . samochodów .	skradzino	5	Perf
Iwan delikatnie postawił Sibircewa na oblodzonej ziemi .	oblodzonej	5	Perf
Głosować będziemy zgodnie z zasadami sformułowanymi w poprzednim punkcie porządku dziennego .	sformułowanymi	5	Perf
Niektóre inwestycje były dzielone na części , by uniknąć stosowania reguł przetargowych .	dzielone	3	Imp
Po badaniach w szpitalu został wypuszczony do domu .	wypuszczony	5	Perf
Wtedy wyciąga zawieruszony w pomiętej pościeli telefon komórkowy , by wszystkie je po kolei załatwić .	zawieruszony	2	Perf
Za chwilę zjawią się kapłanki , a ja , jako bezbożnica , zostanę zelżona i wyrzucona stąd na zbity pysk .	zelżona	13	Perf
– Zidentyfikował z uśmiechem suknię , kupioną w salonie Coco Chanel .	kupioną	6	Perf
Zazwyczaj młodym kobietom z zagranicy , zwabionym i przymuszanym do nierządu , sutenerzy odbierają paszporty .	zwabionym	6	Perf
Po awanturze z rodziną K . wygrzebano przeciwko niemu stare sprawy .	wygrzebano	6	Perf
Mógł być nadawany pośmiertnie .	nadawany	2	Imp
Zmieniały się tylko nazwiska i wielkość zdeprawowanych pieniędzy .	zdeprawowanych	6	Perf
Ponoć dawano Edkowi możliwość ucieczki z więzienia w Bielsku , gdzie trzymano ich przed odesłaniem do obozu .	trzymano	11	Imp
Michnik jest czwartym laureatem ustanowionej w 1996 r . nagrody .	ustanowionej	4	Perf
– a dużo osób ma odrobiony piątek . .	odrobiony	5	Perf
I było wysoko cenione ?	cenione	3	Imp
- Powiewy bliskich gór przyniosły mu buntownicze słowa chłopskiej pieśni , zasłyszanej w dzieciństwie .	zasłyszanej	11	Perf
Beczący głos uciszył sprzysiężonych .	Beczący	0	Imp
Podano do stołu .	Podano	0	Perf
Kabiny obu samochodów zostały doszczętnie zmiażdżone .	zmiażdżone	5	Perf
Jestem proboszczem liczącej 1180 osób parafii , która posiada zabytkowy kościół wpisany do rejestru zabytków .	wpisany	11	Perf
" Tak chciał Bóg , żeby nasz umysł w sprawach matematycznych osiągał pewność logiczną , ale w religii osiągał ją dzięki prawdopodobieństwu nagromadzonemu . "	nagromadzonemu	22	Perf
Drżące dłonie opadły .	Drżące	0	Imp
Potem , przez kolejne dwa tygodnie , ciało było bardzo starannie bandażowane .	bandażowane	11	Imp
Prezes PZU Władysław Jamroży i członek zarządu Grzegorz Wieczerzak nadal są zawieszeni w pełnieniu swoich funkcji .	zawieszeni	11	Perf
Ale dwa razy do roku kumulują się we mnie smutki , niezrealizowane sprawy i ogarnia mnie przygnębienie .	niezrealizowane	11	Perf
- Do sypialni Polaków coraz częściej wchodzą istoty posiadające zdolność przenikania przez ściany .	posiadające	8	Imp
W Polsce przedwrześniowej mieli śmy jedynie 600 zelektryfikowanych wsi .	zelektryfikowanych	7	Perf
Ochmistrz ma otwartą kabinę , dla przyzwoitości pukam w uchylone drzwi .	otwartą	2	Perf
Skóra wokół poczerwieniała , a w kącikach ust pojawił się grymas skrywanego bólu .	skrywanego	11	Imp
Jeden hotel musiał być oddany po wygaśnięciu dzierżawy , drugi sprzedano , aby pokryć dług w Funduszu Społecznym Żołnierza .	sprzedano	10	Perf
W Denver można znaleźć ogród zoologiczny , który jest najchętniej w tym mieście odwiedzaną atrakcją .	odwiedzaną	13	Imp
Oprócz PartitionMagic instalowane są aplikacje pomocnicze .	instalowane	2	Imp
Kołdra i ściągnięte z materaca prześcieradło dziwaczną draperią zwisało z łóżka .	ściągnięte	2	Perf
Jeśli zostanie uzdrowiona dusza , szybko do zdrowia powróci i ciało .	uzdrowiona	2	Perf
Z zestawienia sporządzanego przez starostwo wynika , że podmioty gospodarcze działające w powiecie działdowskim dokonują rocznie ponad 6000 odpraw celnych .	sporządzanego	2	Imp
Ale zapytany , dlaczego lubi szachy , znudzony zsuwa się z kanapy .	zapytany	1	Perf
Ich angielska interpretacja jest bardzo zróżnicowana .	zróżnicowana	5	Perf
Według dyżurnego Komendy Miejskiej Policji w Chorzowie po przebudzeniu dziecka stwierdzono , że zostało ono upite .	stwierdzono	10	Perf
Zwierzę unieruchomione w pułapce nie mogło wydostać się stamtąd o własnych siłach .	unieruchomione	1	Perf
Na szczęście pościel , którą na nich położono , była miękka i ciepła .	położono	7	Perf
Ja stoję w bruździe i w uniesionej ręce trzymam zapalony fanarek .	zapalony	9	Perf
Sporządzono listę przedmiotów , które zrabowali z mieszkania brutalni przestępcy .	Sporządzono	0	Perf
Jest to aminokwas poprawiający pamięć starzejącej się komórki .	starzejącej	5	Imp
Zeznał on , iż został pobity przez nieznanego osobnika .	pobity	5	Perf
jest zatrute powietrze .	zatrute	1	Perf
Organizatorzy przygotowali także wiele imprez towarzyszących .	towarzyszących	5	Imp
Pieniądze muszą być przeznaczone na konkretne zadania .	przeznaczone	3	Perf
Pierwsze krople deszczu zadudniły o trumnę i zmieszały się ze święconą wodą , którą ksiądz rozpryskiwał z kropidła podobnego do królewskiego berła .	święconą	10	Imp
Sprawa została pomyślnie rozstrzygnięta dopiero w ostatnim czasie .	rozstrzygnięta	3	Perf
Prototyp zminiaturyzowanej komory jest już gotowy .	zminiaturyzowanej	1	Perf
Szli szosą warszawską , skąpo oświetloną latarniami , wzdłuż nowego cmentarza .	oświetloną	5	Perf
Dzieje się to zazwyczaj w pionowo rozbudowanych , konwekcyjnych chmurach kłębiastych .	rozbudowanych	6	Perf
Jest to duża armia , łącznie z oddziałami policji licząca 100 tysięcy ludzi .	licząca	9	Imp
W Hongkongu spędzałem codziennie kilka godzin w szpitalach zaimprowizowanych naprędce w budynkach szkolnych lub koszarowych .	zaimprowizowanych	8	Perf
Dozorca i drugi mężczyzna , stojący obok , wzięli kobietę pod ręce i wyprowadzili na korytarz .	stojący	5	Imp
Niedługo po tym apelu Kamiński , Wołek i Jurek spotkali się na podwieczorku u krzywdzonego Pinocheta .	krzywdzonego	14	Imp
Tomaszewski był rozgoryczony tak długim odroczeniem swojego procesu .	rozgoryczony	2	Perf
Do sali zjechali śmy godnie , windę znarowioną już naprawili .	znarowioną	7	Perf
Usiedli śmy , zamówili śmy do picia napoje chłodzące .	chłodzące	8	Imp
Napięta żyłka świsnęła i pękła w przeponie .	Napięta	0	Perf
Organem prowadzącym przychodnię jest gmina Kcynia .	prowadzącym	1	Imp
Transmisja z jego strony szła przez dwa serwery anonimizujące , mógł przebywać w dowolnym miejscu na Ziemi .	anonimizujące	8	Imp
- Lista posłów zapisanych do głosu została wyczerpana .	wyczerpana	7	Perf
Opracował program dydaktyczny wychowania seksualnego , którego realizacja została ostatnio wstrzymana .	wstrzymana	10	Perf
Wtedy jest szczęśliwy , odprężony .	odprężony	4	Perf
- Polacy cenią polityków sytuujących się ponad podziałami .	sytuujących	4	Imp
Sprawa nie była jeszcze rozpatrywana .	rozpatrywana	4	Imp
Aminokwasy zawierające siarkę są niezbędne dla prawidłowej syntezy keratyny , która jest podstawowym składnikiem włosów i paznokci .	zawierające	1	Imp
W czasach elektronicznych rozmyła się wartość mozolnie zapisywanych karteczek i pedantycznie prowadzonych kartotek .	prowadzonych	11	Imp
Wiele spraw do tego czasu powinno się już wyjaśnić .	powinno	5	Imp
Został potraktowany łagodnie .	potraktowany	1	Perf
Na ekranie TV , na zatrzymanej stop–klatce Jurka Kilera idą napisy końcowe programu .	zatrzymanej	5	Perf
RADA BEZPIECZEŃSTWA omawia skargę Zambii z powodu powtarzających się aktów agresji ze strony rasistowskiej RPA .	powtarzających	7	Imp
Ciągnąc go za rękaw , zmusiła do obrócenia się wśród otaczającego ich korowodu .	otaczającego	10	Imp
Niestety , z tym jest najgorzej i najlepsze koncepcje mogą nie zostać zrealizowane .	zrealizowane	12	Perf
Proszowiccy strażacy wyjeżdżali w ostatnim czasie do dwóch pożarów , spowodowanych prawdopodobnie przez podpalaczy .	spowodowanych	10	Perf
Tymczasem miednice wypełnione podrobami przenoszono do kuchni .	przenoszono	4	Imp
Na zakończonym wczoraj w Paryżu kongresie FPK przyjęto 1080 głosami przeciw 43 centrowy program szefa partii Roberta Hue .	zakończonym	1	Perf
15 naukowców uczestniczących w sesji otrzymało pamiątkowe medale wybite z okazji jubileuszu .	wybite	8	Perf
Cały teren splantowano , a niedługo zostanie wykonane nowe ogrodzenie .	wykonane	7	Perf
Polacy jadący w autokarze spoglądają z nietajoną dumą na wielkiego rodaka .	jadący	1	Imp
Sporządzając mi drinka , Pućka kończy wcześniej rozpoczętą kwestię .	rozpoczętą	7	Perf
Panowie nie mieli najmniejszych problemów z dziwnie skleconą reprezentacją Reszty Świata , panie też gładko wygrały z osłabioną ekipą USA .	skleconą	7	Perf
- Czy wniosek był zgłoszony na 12 godzin wcześniej ?	zgłoszony	4	Perf
Były one niezwykle rzadkie , nadające świątyni szczególne miejsce wśród wszystkich miejsc kultu na Pomorzu Gdańskim .	nadające	5	Imp
Gdyby udało się skompletować księgę obdarowanych , zawierałaby ona listę nazwisk tworzących znaczną część żelaznego elektoratu SLD .	obdarowanych	5	Perf
Nie stwierdzono żadnych uchybień .	stwierdzono	1	Perf
Fabrykę zaplombowano , konfiskując także podejrzane materiały .	zaplombowano	1	Perf
W niedzielę rano rozpoczęła się zapowiadana przez władze macedońskie ofensywa przeciwko albańskim separatystom działającym na północy kraju .	działającym	13	Imp
Prezes OSP Stanisław Kocot wyjaśniał , że będą to nowoczesne , otwierane za pomocą pilota bramy , które znacznie ułatwią strażakom wyjazdy do akcji .	otwierane	11	Imp
Piłsudczycy nie dopuścili do dyskusji w Sejmie , który zresztą został rozwiązany 30 sierpnia 1930 r . , w połowie kadencji .	rozwiązany	11	Perf
Bo niby premier coś mówi , ale przecież wiadomo , że on jest w coś uwikłany .	uwikłany	15	Perf
Rzecznik Prokuratury Okręgowej w Łodzi Krzysztof Kopania , zasłaniając się dobrem postępowania , odmówił na tym etapie śledztwa odpowiedzi na pytanie , czy ksiądz przyznał się do stawianych mu zarzutów .	stawianych	27	Imp
Z konarów i pni wyczarowywał dziwne figury przywołujące na myśl słowiańskich bogów .	przywołujące	7	Imp
Zatrzymani wczoraj przestępcy od roku działali na własną rękę .	Zatrzymani	0	Perf
Oznacza to , że nie przetworzone przez przemysł produkty mają największe walory .	przetworzone	5	Perf
Marks był by przerażony efektami .	przerażony	3	Perf
Także usługi ogólnobudowlane prowadzi drugi z odznaczonych , pan Marek Nosal .	odznaczonych	6	Perf
Czy pieniędzy zabraknie dla wszystkich potrzebujących ?	potrzebujących	5	Imp
Podróżujący pierwszą klasą będą odtąd mogli wypoczywać podczas lotu na rozkładanych podwójnych siedzeniach .	Podróżujący	0	Imp
Tam , gdzie byli prześladowani przez muzułmanów , musiał wystarczyć chaczkar .	prześladowani	4	Imp
Podczas nabożeństwa poświęcony został świeżo ufundowany sztandar szkoły .	ufundowany	5	Perf
W latach sześćdziesiątych , już jako sztygar oddziałowy , pamiętam odbiory przygotowywanych do rozruchu ścian dokonywane przez dyrektora Śniegonia .	przygotowywanych	11	Imp
Dzięki znajdującym się u podstawy każdego wibrysa komórkom mięśniowym zwierzę potrafi dowolnie poruszać wąsami niemal na wszystkie strony .	znajdującym	1	Imp
Akcja zostanie wznowiona we wtorek rano .	wznowiona	2	Perf
Postanowienie może być wydane na posiedzeniu niejawnym .	wydane	3	Perf
Różnymi technikami były również nanoszone poszczególne rysunki .	nanoszone	4	Imp
Stali wśród namiotów , w których krzątali się nadwołżańscy Niemcy , zruszczeni po wiekach .	zruszczeni	11	Perf
Należała do mojego pokolenia , została też przez to pokolenie dobrze przyjęta .	przyjęta	11	Perf
Ciężarówka wpadła między rosnące na skarpie drzewa .	rosnące	3	Imp
Trzy strzały trafiły przebywających w wartowni żołnierzy .	przebywających	3	Imp
Będzie to film szerokoekranowy , składający się z dwóch części .	składający	5	Imp
Przeprowadził wówczas kilka niebłahych akcji , tu zrelacjonowanych z detalami . . .	zrelacjonowanych	7	Perf
Parówki gotowane we wrzątku i podawane wprost z rondla bierze się na talerz i usuwa błonę , w której były gotowane .	podawane	5	Imp
Ta grupa została wymieniona na pierwszym miejscu .	wymieniona	3	Perf
Ta opinia jest utworzona z chorego uogólniania .	utworzona	3	Perf
Próba obalenia rządu ujawniła dziwne mechanizmy istniejące w naszym państwie .	istniejące	6	Imp
Georges Mathieux w kostiumie szermierza dźga płótno pędzlem umieszczonym na szpadzie .	umieszczonym	8	Perf
Ale taki film został nakręcony .	nakręcony	4	Perf
Dante miał wzrok utkwiony w jego usta .	utkwiony	3	Perf
W głowach łóżka na słupku od kwiatów paliła się zdjęta ze ściany gromnica .	zdjęta	9	Perf
- Porywacze uwolnili na naszą prośbę część kobiet oraz akredytowanych w naszym kraju dyplomatów .	akredytowanych	9	Perf
Uczył się w Liceum Technik Plastycznych w Zakopanem prowadzonym przez Antoniego Kenara .	prowadzonym	8	Imp
Dwa tygodnie temu prezydent podpisał znowelizowaną ustawę .	znowelizowaną	5	Perf
Są to rurki szklane cylindryczne o zwężonym końcu .	zwężonym	6	Perf
Oznacza to , że odbierze każde przychodzące wywołanie .	przychodzące	6	Imp
Miejsca pomiarów sił zaznaczono na rys . 4 .	zaznaczono	3	Perf
Drzwi do łazienki , wyjęte z zawiasów , stały oparte o ścianę .	wyjęte	4	Perf
Ranni żołnierze zostali przewiezieni do szpitala w Białogardzie .	przewiezieni	3	Perf
Walczak poczuł dręczące pragnienie .	dręczące	2	Imp
Resa pośpieszyła do Ab–Rama , czekającego niecierpliwie w swoim namiocie .	czekającego	5	Imp
- Panie majorze , nasza siatka jest odbudowana .	odbudowana	7	Perf
Chciałby być teraz w namiocie , oddzielony od wszystkiego .	oddzielony	6	Perf
Wazopresyna jest szybko unieczynniana przez peptydy osocza .	unieczynniana	3	Imp
Byli zmarznięci i wystraszeni .	zmarznięci	1	Perf
Wyszedł em od nich pod wieczór zupełnie wybity z czasu i z epoki .	wybity	7	Perf
Ponadto można eksportować dane do pliku tekstowego z uwzględnieniem wybranych kolumn i sposobu sortowania .	wybranych	9	Perf
Dzięki temu pracownicy bardzo szybko ustalili , kto może być odpowiedzialny za zdarzające się coraz częściej w firmie tajemnicze manka .	zdarzające	12	Imp
Myślał już o czekającym go etapie .	czekającym	3	Imp
Ofiara miała przy sobie polski paszport i dzięki temu łatwo ją zidentyfikowano .	zidentyfikowano	11	Perf
Elektromagnetyczne promieniowanie każdego rodzaju sprzętu elektronicznego ma z reguły odmienny , tylko jemu przypisywany charakter .	przypisywany	13	Imp
Rozpoczyna się teraz emocjonujący wyścig ze zbliżającą się burzą .	zbliżającą	6	Imp
Sól , z jakiej była uczyniona , rozpuściła się całkowicie . . .	uczyniona	5	Perf
Małgorzatka zbudziła się zlana potem .	zlana	3	Perf
W grupie finałowej rozegrano mecze każdy z każdym i wyłoniono zwycięzcę , którym został zespół Warka Tuchola .	rozegrano	3	Perf
Węże są zwierzętami mało poznanymi , niezwykłymi i fascynującymi .	poznanymi	4	Perf
Upragnioną miłość zanurzyłeś w najpodlejszym , cuchnącym bagnie .	cuchnącym	6	Imp
Zarazem na wszystkich studentach zaciążyłby obowiązek przedstawiania WKU dokumentów świadczących , że nadal studiują .	świadczących	9	Imp
Została by zdemaskowana jako zła żona .	zdemaskowana	2	Perf
Na centralnie umieszczonym bolcu osadzamy krążek i dopiero wtedy naklejamy na nim gotową etykietę .	umieszczonym	2	Perf
Drzwi były zamknięte .	zamknięte	2	Perf
Ustalono to na podstawie mutacji zachodzących w wirusie .	zachodzących	5	Imp
Po chwili odsłonił głowę i uważnie lustrował zaniepokojone twarze .	zaniepokojone	7	Perf
Poruszał rytmicznie kolanami , unosząc lekko siedzącą na nich kobietę .	siedzącą	6	Imp
Coraz gorzej się chodzi po remontowanym fragmencie kieleckiego deptaka .	remontowanym	5	Imp
Po naszym telefonie na miejscu pojawiła się policja , by ocenić , czy jest to krzew znajdujący się na liście zakazanych używek halucynogennych .	zakazanych	20	Perf
Rumuński parlament odrzucił rządowy projekt ustawy przewidujący likwidację kar za homoseksualizm .	przewidujący	6	Imp
Nie składają donosów do prokuratury , nie przejmują się całodobowym uśmiercaniem poczętych ?	poczętych	11	Perf
W Polsce wyniki leczenia nowotworów dlatego są dwukrotnie gorsze od uzyskiwanych na Zachodzie , ponieważ na terapię trafiają chorzy przeważnie już z zaawansowanym guzem .	uzyskiwanych	10	Imp
Chłopiec posłusznie ukląkł i mełł pacierz obok żarliwie modlącej się i popłakującej matki .	modlącej	8	Imp
Odkrycie jest ważnym głosem w dyskusji dotyczącej bezpieczeństwa przeszczepów pochodzących od zwierząt .	dotyczącej	6	Imp
W przyszłości zostanie przeniesiony do sąsiedniego pawilonu , którego budowa jeszcze trwa .	przeniesiony	3	Perf
– edwansa ma zrobionego ?	zrobionego	3	Perf
Melodia płynąca ze skrzypiec jest smętna , żałosna .	płynąca	1	Imp
Pięcioletnia dziewczynka , porwana wczoraj przez 65-letniego mężczyznę w Chorzowie na Śląsku , odzyskała wieczorem przytomność .	porwana	3	Perf
Leczenie podtrzymujące za pomocą steroidów jest oczywiście gorszym rozwiązaniem niż leczenie polegające na usunięciu przyczyny .	polegające	11	Imp
Obrazy cyfrowe składają się z połączonych ze sobą pikseli o różnych barwach lub tonach .	połączonych	5	Perf
Po rozwodzie zwykle pozbawiano ich prawa do opieki nad dziećmi .	pozbawiano	3	Imp
Zostało ono przygotowane z wielką starannością .	przygotowane	2	Perf
Gdyby nie było przemocy , porozumienie zostałoby już dawno zawarte .	zawarte	9	Perf
Oszołomiony znalazł się na ulicy .	Oszołomiony	0	Perf
Szybsze topnienie brzegów lodowca kompensowane jest przez zwiększone opady w środku kontynentu .	zwiększone	7	Perf
Jak urządzony jest Wasz dom ?	urządzony	1	Perf
Dostrzegł pędzącego byka .	pędzącego	1	Imp
Cebulę i zasmażkę dodać do gotowanej wody i gotować razem 15 minut .	gotowanej	5	Imp
Na bezdomne po Powstaniu Warszawskim dwie głośne pisarki czekały w Łodzi zarezerwowane dla nich mieszkania .	zarezerwowane	11	Perf
3 . Unikaj dudniących , hałaśliwych kolumn .	dudniących	3	Imp
To informacja poprzedzona chrząknięciem , ściszeniem głosu , podana jakby mimochodem .	podana	8	Perf
Sztandar bojowy podniosły także narody podbite i uciemiężone przez carat .	uciemiężone	7	Perf
Poza wymienionymi , charakterystycznymi rodzajami przebiegu akumulacji w ciągu roku stwierdza się ich modyfikacje lub rodzaje pośrednie .	wymienionymi	1	Perf
Maszyny były opanowane .	opanowane	2	Perf
Zapach kawy przeważał nad odorem spalonego tłuszczu z kuchni i chloraminy z toalet .	spalonego	5	Perf
Na rozwieszonej chustce do nosa ujrzał em film .	rozwieszonej	1	Perf
Cały kraj był zdławiony tym okropnym cieniem .	zdławiony	3	Perf
W środę ze Szpitala Ginekologiczno - Położniczego w Opolu wypisywano 11 noworodków .	wypisywano	9	Imp
Leżał już ubrany w trumnie .	ubrany	2	Perf
W ostatnich dniach klub został niemal sparaliżowany przez wewnętrzne konflikty .	sparaliżowany	6	Perf
Skazani rozwożeni są natychmiast do więzień na terenie całego kraju .	rozwożeni	1	Imp
Nie ukrywam , że mój kalendarz jest raczej zapełniony .	zapełniony	8	Perf
Po chwili do jej pokoju wbiegł zaniepokojony akuszer .	zaniepokojony	6	Perf
W tej lecznicy usunięto pacjentce martwą ciążę , a także macicę i fragment jelita .	usunięto	3	Perf
Rozmaite padliny wieszano na Sienkiewiczu , ale ja w jego obronie zawsze staję .	wieszano	2	Imp
Ona czuje się beze mnie tak zgubiona !	zgubiona	6	Perf
Na placu Wolności wisiało jeszcze wtedy kilka plakatów , zachęcających do głosowania na Tadeusza Zwiefkę .	zachęcających	9	Imp
Postulaty protestujących zarząd miasta uznał za bezzasadne .	protestujących	1	Imp
To impreza pomagająca wyjść z nałogu alkoholowego .	pomagająca	2	Imp
Świadczenia były by mniej spłaszczone .	spłaszczone	4	Perf
Ojciec ofiary uważa , że w sprawę zamieszani są policjanci i dlatego śledztwo prowadzone było tak niemrawo .	zamieszani	7	Perf
W środowisku olkuskim była osobą znaną , często w miejscowej resursie organizowano jej wystawy .	organizowano	11	Imp
Zastygła m z lekko przechylonym dzbankiem .	przechylonym	4	Perf
By wdrożyć projektowany przez rząd nowy system taniego budownictwa mieszkaniowego , konieczne jest szybkie wyszkolenie kadr .	projektowany	2	Imp
Sanki pomknęły po ubitym śniegu na Pohulankę .	ubitym	3	Perf
Po jego obu bokach zwisają nawleczone na sznur perły nazywane Paternoster .	nazywane	9	Imp
Polskie kopalnie zostaną sprywatyzowane .	sprywatyzowane	3	Perf
Wobec wniosku o uznanie tej odpowiedzi za wystarczającą zgłoszono sprzeciw .	zgłoszono	8	Perf
Postanowienie może być wydane na posiedzeniu niejawnym .	wydane	3	Perf
Dla oddziału chirurgicznego znajdującego się na pierwszym piętrze jest to siedziba tymczasowa .	znajdującego	3	Imp
Robi wrażenie wyluzowanego .	wyluzowanego	2	Perf
Jednocześnie następują dynamiczne , ale dostosowane do realiów społecznych i kapitałowych przekształcenia własnościowe .	dostosowane	5	Perf
Byli zmarznięci i wystraszeni .	wystraszeni	3	Perf
Zamiast nich na głębokości 3 m spoczywał trotyl uzbrojony w dwa palniki i lonty .	uzbrojony	8	Perf
Jego dyrektor tłumaczy , że to za sprawą długów zostawionych przez poprzedników .	zostawionych	9	Perf
Obok miasta umieszczono cmentarz żydowski z wyeksponowanym nagrobkiem do złudzenia przypominającym ohel Sonnenberga .	wyeksponowanym	6	Perf
Ledwie sformowany rząd ustąpił protestującej grupie zawodowej .	protestującej	4	Imp
Serduszka czekoladowe będą rozdawane w autobusach dla par .	rozdawane	3	Imp
Słuchawka leżała odłożona na stoliku obok czyjejś niedopitej herbaty .	niedopitej	7	Perf
Stary zegar stojący na komodzie tyka natrętnie .	stojący	2	Imp
Wystarczyło paru lat , aby konkret został wyklęty .	wyklęty	7	Perf
Połączono go z obchodami 70-lecia szkoły .	Połączono	0	Perf
Ciągnął je ukryty wewnątrz drewnianego pudła muł .	ukryty	2	Perf
Janusz O . przyznał się do stawianych mu zarzutów i bez poręczenia majątkowego dziś wyszedł na wolność .	stawianych	6	Imp
Wprowadzenie rozwiązań proponowanych przez SLD prowadziłoby do wynaradawiania .	proponowanych	2	Imp
Zamkniętych zostało kilka autostrad .	Zamkniętych	0	Perf
Postulaty protestujących zarząd miasta uznał za bezzasadne .	protestujących	1	Imp
Mogę także powiedzieć , że transmitowany będzie w programie 2 Polskiego Radia .	transmitowany	5	Imp
Wyjaśnił w niej , że został wychowany w bardzo purytańskim domu , w którym wpojono mu szacunek dla takich cnót jak skromność i oszczędność .	wpojono	14	Perf
Czy ta wasza przyjaźń została nazwana , wyznana ?	wyznana	7	Perf
Tam czekał już pluton egzekucyjny , dowodzony przez podoficera .	dowodzony	6	Imp
Wojna i okupacja były tylko finałem , nieuchronnie wynikającym z samej istoty faszyzmu .	wynikającym	8	Imp
W wspomnianych zestawach nie figurują te nazwiska .	wspomnianych	1	Perf
W mieście zainstalowana jest starego typu centrala elektromechaniczna .	zainstalowana	2	Perf
Tak często są postrzegane szkoły niepubliczne .	postrzegane	3	Imp
Sprzeciwili się projektowi ustawy , która pozwoli na przynoszący zysk import odpadów nuklearnych .	przynoszący	8	Imp
Za granicą sprzedawane są nasiona w mieszankach i pojedynczych kolorach .	sprzedawane	2	Imp
Staruszkę ze zmiażdżoną prawą stopą przewieziono do szpitala przy ulicy Cegłowskiej .	zmiażdżoną	2	Perf
Uwodzić zapładniającego skutecznie mężczyznę .	zapładniającego	1	Imp
Hotel został otoczony .	otoczony	2	Perf
Dlatego problem ten musi zostać wnikliwie rozpatrzony , a większość obiektów powinna być bezwzględnie zwrócona społeczeństwu , bo za jego pieniądze zostały wzniesione .	wzniesione	22	Perf
Agnieszka jest odurzona szczęściem .	odurzona	2	Perf
Umowa została zawarta pod koniec listopada .	zawarta	2	Perf
Te wszystkie rogi zostały zdemontowane i wywiezione do Szczecina .	zdemontowane	4	Perf
Spośród trzystu ochotników Polluks wybrał stu najlepiej znających się na morzu .	znających	7	Imp
Wszelkie informacje podane poniżej dotyczą jedynie wypadków sprawdzonych .	sprawdzonych	7	Perf
Selekcjoner Jerzy Engel rozdał pamiątkowe monety , wybite z okazji zbliżających się mistrzostw świata .	wybite	7	Perf
Jak widzę procesy zachodzące w sztuce ostatniego stulecia ?	zachodzące	3	Imp
Po kompromitującym czynie , logiczna jest likwidacja świadków , to typowy sposób postępowania wszystkich szanujących się gangsterów .	szanujących	14	Imp
to jest robione dłuższym obiektywem . .	robione	2	Imp
– bo był pożyczony . .	pożyczony	3	Perf
Na pozostałym oleju podsmażyć mięso z roztartym na miazgę czosnkiem .	roztartym	6	Perf
W latach sześćdziesiątych , już jako sztygar oddziałowy , pamiętam odbiory przygotowywanych do rozruchu ścian dokonywane przez dyrektora Śniegonia .	dokonywane	15	Imp
Białe policyjne motocykle są doskonale oznakowane .	oznakowane	5	Perf
Inwestycję wznowiono w połowie 2004 roku , a wartość zadania wynosi 5,6 miliona złotych .	wznowiono	1	Perf
- Reforma na pewno nie zostanie zaniechana .	zaniechana	6	Perf
Po pewnym czasie pojawiła się też mniejsza grupa , zmierzająca w odwrotną stronę .	zmierzająca	9	Imp
Teraz sprawa zostanie przekazana rzecznikowi dyscyplinarnemu .	przekazana	3	Perf
Myślał już o czekającym go etapie .	czekającym	3	Imp
Stałą obserwacją objęta jest ulica Bohaterów Warszawy od poczty głównej do placu Wolności .	objęta	2	Perf
Po dziesięciu latach wraca do Petersburga i do przerwanej pracy pisarskiej .	przerwanej	8	Perf
Zjadano dziennie stado baranów , setki kur , górę ryżu , sadzawkę jogurtu , piramidę melonów i wypijano wagon coca-coli .	Zjadano	0	Imp
Dodany został nowy § 3 .	Dodany	0	Perf
Policja przypuszcza , że najnowszy ładunek został porzucony przez spłoszonego niedoświadczonego terrorystę .	porzucony	7	Perf
Premier nazwał pieniądze przeznaczone na utrzymanie Kancelarii Prezydenta i swojej wartościami .	przeznaczone	3	Perf
Chłopiec wynurza się spod stołu , trzymając na dłoni rozbite jajko , strzaskaną skorupkę , rozlane żółtko i oślizłe białko .	rozbite	9	Perf
Omawiana książka jeszcze raz to potwierdza .	Omawiana	0	Imp
Słuchaj , Piotr był zalany , spadał ze schodów , wyskakiwał z okna .	zalany	4	Perf
Zostały one przewiezione do szpitala .	przewiezione	2	Perf
Na wczorajszej rozprawie zeznania składali kolejni świadkowie w procesie , który niedawno został rozpoczęty ponownie .	rozpoczęty	13	Perf
- W spadku po odchodzącej ekipie nowy rząd otrzymuje olbrzymi deficyt w bilansie handlowym .	odchodzącej	4	Imp
Biura Nowego Stylu przeniesiono do Krakowa .	przeniesiono	3	Perf
Ślizgawki są organizowane cyklicznie .	organizowane	2	Imp
Żołnierze okopali się tam i celnymi strzałami odpierali atakujących .	atakujących	8	Imp
Wprowadzenie rozwiązań proponowanych przez SLD prowadziło by do wynaradawiania .	proponowanych	2	Imp
Architekci opracowujący rysunki robocze są zazwyczaj wieloletnimi praktykami .	opracowujący	1	Imp
Podejmowane są zobowiązania indywidualne i zespołowe .	Podejmowane	0	Imp
Pod pachą trzymała jakąś paczkę zawiniętą w gazetę .	zawiniętą	5	Perf
Rozszerzone źrenice skierował na moją twarz , ale pod nimi była pustka .	Rozszerzone	0	Perf
Patrzyła biernie , nie widząc niczego , na mijające za oknem podmiejskie pejzaże .	mijające	8	Imp
Taki czek nie może być bezpośrednio zamieniony na gotówkę .	zamieniony	6	Perf
Z 13 do 27 zwiększa się w Łodzi liczba opiekunów , przeprowadzających dzieci idące na lekcje przez najruchliwsze jezdnie i skrzyżowania .	idące	13	Imp
Spirytus jest rozlewany do kartoników litrowych , półlitrowych i ćwiartek .	rozlewany	2	Imp
Właściwie powinni wyrzucić .	powinni	1	Imp
Gdy dorośnie , zbuduje swoją katedrę , tworząc powieściowy świat W poszukiwaniu straconego czasu .	straconego	12	Perf
W 1831 pod Komorzem A . Mickiewicz próbował przekroczyć granicę zaborów biegnącą na Prośnie , aby wziąć udział w powstaniu listopadowym .	biegnącą	11	Imp
Popędzali swoje konie , bo koniecznie chcieli dopaść upatrzonej zwierzyny .	upatrzonej	8	Perf
Słyszymy dzwony z oddali , szczekanie psa , odgłosy zasypiającego Przymorza .	zasypiającego	9	Imp
Ale czy naprawdę jest już pani przekonana o tym , że tak było .	przekonana	6	Perf
– wrażenie było piorunujące . .	piorunujące	3	Imp
W środku był też ciężko poparzony inny mężczyzna .	poparzony	5	Perf
Z chwilą urodzenia dziecko może żądać naprawienia szkód doznanych przed urodzeniem .	doznanych	8	Perf
Ludzie uważają , że do kłopotów z uzyskaniem zgody przyczynili się inwestorzy starający się o pozwolenie na budowę małego osiedla na działce sąsiadującej z ogródkami mieszkańców .	starający	12	Imp
Mieli śmy już za sobą wzniesienie i za zakrętem opadającej łagodnie drogi wyłonił się skraj cmentarza .	opadającej	9	Imp
Wystarczy zwisający kabel od czajnika elektrycznego .	zwisający	1	Imp
Aby udowodnić winę osobie opalającej zabronionymi materiałami , należałoby przeprowadzić specjalistyczne badania wydobywającego się z komina dymu .	opalającej	4	Imp
Z oficjalnym żądaniem wobec MKOl , złożonym na piśmie , wystąpił Narodowy Komitet Olimpijski KRLD , domagając się od naczelnej władzy sportowej rewizji listy triumfatorów olimpijskich .	złożonym	6	Perf
Powiększona kuchnia stała się obszernym pomieszczeniem mieszczącym duży stół .	Powiększona	0	Perf
Związany z kapistami , wielokrotnie jednak przekraczał wyznaczone przez nich malarskie granice .	wyznaczone	7	Perf
Uważano więc w partii , że Gierek , po antrakcie Ochaba , powrócił do praktyki niszczenia poprzedników przez następców .	Uważano	0	Imp
W ten sposób mieli oni zakończyć dwuletnie studia podnoszące kwalifikacje zawodowe .	podnoszące	8	Imp
Bóg nigdy nie karał sam występujących przeciwko niemu .	występujących	5	Imp
Wniesienie skargi o wznowienie nie tamuje wykonania zaskarżonego wyroku .	zaskarżonego	7	Perf
Miejsca rozgrywania spotkań zostały ustalone w drodze losowania w siedzibie Polskiego Związku Tenisa Stołowego w Warszawie .	ustalone	4	Perf
Bardzo często , kiedy był em wściekły i napięty , wypijał em na rozluźnienie piwko czy setkę .	napięty	8	Perf
Przy władającym Uranie twoja twórczość może ujawniać się jako zdolności wynalazcze .	władającym	1	Imp
Do poradni chirurgicznej i pogotowia ratunkowego napływali poszkodowani piesi .	poszkodowani	7	Perf
- Lista posłów zapisanych do głosu została wyczerpana .	zapisanych	3	Perf
Wtedy wystarczyło by zawołać go do sitwy i sprawa była by ubita .	ubita	11	Perf
Nastroszony w telewizorze Biernacki jest równie zabawny jak nastroszony Buzek .	Nastroszony	0	Perf
Związany z kapistami , wielokrotnie jednak przekraczał wyznaczone przez nich malarskie granice .	wyznaczone	7	Perf
Ostatnim wysiłkiem naprowadza płonący samolot wprost na wieżyczkę u-boota .	płonący	3	Imp
W samym tylko Katyniu rozstrzelano prawie 4,5 tys . osób .	rozstrzelano	4	Perf
Za sobą mieli martwą rzekę , która leżała wśród piasków jak rozbity dzban .	rozbity	11	Perf
W niedzielę rano odprawiono z okazji rocznicy śmierci kompozytora msze święte w kościołach sióstr Wizytek i św . Krzyża , gdzie spoczywa serce Chopina .	odprawiono	3	Perf
To były największe , najdłuższe i zorganizowane najdalej od Europy ćwiczenia 8 tys . żołnierzy NATO .	zorganizowane	6	Perf
Podróżujący pierwszą klasą będą odtąd mogli wypoczywać podczas lotu na rozkładanych podwójnych siedzeniach .	rozkładanych	10	Imp
Sterowali ruchem w pobliżu cmentarzy , kontrolowali trzeźwość kierowców poruszających się drogami województwa .	poruszających	9	Imp
Nikt wcześniej nie wyszedł do protestujących pielęgniarek .	protestujących	5	Imp
Resa pośpieszyła do Ab-Rama , czekającego niecierpliwie w swoim namiocie .	czekającego	5	Imp
Zanim wiązanki kwiatów przykryły mogiłę , słowa modlitwy prowadzonej przez ks . Pawła Dorucha splatały się z wyrazami bólu i wspomnieniami przyjaciół .	prowadzonej	8	Imp
Ponad 20 ulic będzie wyłączonych z ruchu w związku ze Świętem Zmarłych .	wyłączonych	4	Perf
Połączono go z obchodami 70-lecia szkoły .	Połączono	0	Perf
Spojrzał des Noyers na zegar gdański , stojący w rogu komnaty .	stojący	7	Imp
Farba powinna być na włosie ok . 30 minut , by pigmenty w niej zawarte mogły w pełni zadziałać .	powinna	1	Imp
Jeśli to jest absolutnie niemożliwe , znaczy to , że twój charakter jest czymś pośrednim pomiędzy dwoma opisanymi w rozwiązaniu przy odpowiednich numerach .	opisanymi	17	Perf
- Będzie realizowana jedna polityka uzgodniona na posiedzeniach Rady Ministrów .	uzgodniona	5	Perf
Dzięki nim zmniejsza się u chorego zaleganie afektu , rozładowują się utrwalone stereotypy uczuciowe , obiektywniej widzi swoją sytuację .	utrwalone	11	Perf
Operację na lotnisku przeprowadzono na 10 godzin przed upływem ultimatum postawionego przez porywaczy .	przeprowadzono	3	Perf
Dla zdobywców pięciu pierwszych miejsc przewidziano regulaminowe nagrody .	przewidziano	5	Perf
Użytkownik ma do dyspozycji 6 baz zawierających informacje posortowane według wybranego kryterium .	wybranego	10	Perf
Środek był ocenzurowany .	ocenzurowany	2	Perf
- W Krzyczkach leży jeszcze kilkadziesiąt zakopanych psów .	zakopanych	6	Perf
Na szczęście , polichlorek winylu jest już stosowany na znacznie mniejszą skalę , a wyroby z niego są wyraźnie oznakowane .	oznakowane	19	Perf
Mężczyzna z sumiastymi wąsami nazwany kawalerem wyraźnie się speszył .	nazwany	4	Perf
Twoi pasterze błogosławią ciągnące na wojnę armaty .	ciągnące	3	Imp
Trzydzieste piąte Targi zostały rozpoczęte .	rozpoczęte	4	Perf
Są oni gorąco pozdrawiani przez zgromadzone na trasie tłumy .	pozdrawiani	3	Imp
Stamtąd przywieziono do Poznania obie rogówki zmarłego .	przywieziono	1	Perf
Czy nauki empiryczne są istotnie na takim doświadczeniu zbudowane , jeśli ono istnieje ?	zbudowane	8	Perf
Ośrodek będzie finansowany z budżetu miasta .	finansowany	2	Imp
Również absolutorium dla dotychczasowych władz partii będzie głosowane w sobotę .	głosowane	7	Imp
Społeczność ludzka funkcjonuje w strukturach zapewniających formę organizacyjną .	zapewniających	5	Imp
Odzyskano ukradzione przedmioty .	ukradzione	1	Perf
Po badaniach w szpitalu został wypuszczony do domu .	wypuszczony	5	Perf
- Przeprowadzono w nich kontrole .	Przeprowadzono	1	Perf
Wybuch poważnie uszkodził luksusowe auto , ucierpiały też cztery inne samochody stojące na placu .	stojące	11	Imp
Maria Kadłubek odebrała wydany zaocznie wyrok sądu grodzkiego .	wydany	3	Perf
Policja z uwagi na prowadzone wciąż czynności operacyjne nie ujawnia szczegółów dotyczących tej sprawy .	dotyczących	11	Imp
- Ma bardzo napięty plan .	napięty	3	Perf
- Czas koronowanych głów minął .	koronowanych	2	Perf
Uratujcie wierzącego chrześcijanina Walerego Marczenkę !	wierzącego	1	Imp
Jej facet jest zmęczony pracą , pomidorówką oraz żoną .	zmęczony	3	Perf
Wezwane pogotowie ratunkowe odwiozło go do szpitala .	Wezwane	0	Perf
Pierwsza uczestniczka zaśpiewa o miłości przyprawianej różnymi smakami .	przyprawianej	5	Imp
Milion konsumentów nieprzestrzegających zasad koszerności dokonało przełomu na rynku spożywczym .	nieprzestrzegających	2	Imp
Policja identyfikowała ofiary na podstawie znalezionych przy nich przedmiotów osobistych .	znalezionych	5	Perf
Nie składają donosów do prokuratury , nie przejmują się całodobowym uśmiercaniem poczętych ?	poczętych	11	Perf
Salony na parterze udostępniono publiczności i pełniły one rolę muzeum .	udostępniono	3	Perf
Dziś , po odkryciach Zygmunta Freuda , to zapomniane w średniowieczu dziedzictwo wchodzi do naszej codzienności i znajduje w niej swoje miejsce .	zapomniane	8	Perf
Według islamu świnia jest uznawana za zwierzę nieczyste .	uznawana	4	Imp
Ze stara wyciekał olej i płyn chłodzący , a przyczepa miała zdemontowany hamulec awaryjny .	zdemontowany	11	Perf
Drzwi uchyliły się z lekkim skrzypieniem nie naoliwionych zawiasów .	naoliwionych	7	Perf
" Skrupulatnie przestrzegane zasady od dziesiątków lat współtworzą jej autorytet i wyjątkową pozycję na rynkach całego świata " .	przestrzegane	2	Imp
Nocą słyszymy skrzypienie , jakby ktoś przechadzał się po niebie ułożonym ze starych , drewnianych desek .	ułożonym	10	Perf
Można wracać , zadanie jest już wykonane .	wykonane	6	Perf
Pod uniesionymi zasłonami rozległego łoża z trudem udało mu się dostrzec ginącą w powodzi koronek , pomarszczoną twarz pani Lamaire .	pomarszczoną	16	Perf
Ulice były jeszcze zapełnione ludźmi i pojazdami .	zapełnione	3	Perf
Mniej zapłacimy za transakcje związane z nieruchomościami .	związane	4	Perf
Bądź wyczulony na poczucie godności .	wyczulony	1	Perf
Wypadek mógł być przecież upozorowany .	upozorowany	4	Perf
Podwyżki zostaną wypłacone dzięki ustawie , którą uchwalił Sejm poprzedniej kadencji .	wypłacone	2	Perf
Brzegi chodników były zastawione ławkami .	zastawione	3	Perf
Przedstawione powyżej podejścia , koncepcje i metody dają duży wybór w określeniu docelowego modelu alokacji .	Przedstawione	0	Perf
Chmury rozsunęły się na moment , odsłaniając wytarty miedziak słońca .	wytarty	7	Perf
Stwierdziła z zadowoleniem , że całość prezentuje się bardzo wiarygodnie , zwłaszcza w przyćmionym świetle .	przyćmionym	13	Perf
Myślałem zrazu , że szkło jest zabrudzone .	zabrudzone	6	Perf
Dlatego problem ten musi zostać wnikliwie rozpatrzony , a większość obiektów powinna być bezwzględnie zwrócona społeczeństwu , bo za jego pieniądze zostały wzniesione .	powinna	11	Imp
Ostatecznie ten przemysł został stworzony przez Europejczyków .	stworzony	4	Perf
Wczoraj w nocy zziębnięci złodzieje skradli mu kilkadziesiąt skórzanych ubrań o wartości ponad 65000 zł .	zziębnięci	3	Perf
- Biznesplan na 2001 r . nie został jeszcze nam przedstawiony .	przedstawiony	10	Perf
Faktyczny strajk , który jest im zabroniony , oprócz wymiernych kosztów dla tysięcy firm naraził państwo polskie na kompromitację .	zabroniony	6	Perf
Zachowała się jego piękna fotografia w powstańczym stroju , wykonana w jednym z krakowskich atelier , a także oryginalne dokumenty , powstańcza prasa i ulotki .	wykonana	9	Perf
Kierowca widział w rękach J . długi zakrwawiony nóż .	zakrwawiony	7	Perf
Następnie chcieli przejechać interweniujących policjantów .	interweniujących	3	Imp
Nieźle tam zarabia , ale niejednokrotnie chwali się drogimi rzeczami kupionymi za pieniądze , które syn tego pana zostawia na utrzymanie ojca .	kupionymi	10	Perf
- Naukowo udokumentowano przypadek Francuzki , która zmarła w wieku 122 lat .	udokumentowano	2	Perf
Odrzucił płaszcz , czoło miał zroszone potem .	zroszone	5	Perf
Na szczęście , polichlorek winylu jest już stosowany na znacznie mniejszą skalę , a wyroby z niego są wyraźnie oznakowane .	stosowany	7	Imp
Prokuratorowi oraz sędziom mówił , iż pojechał na Wschód , aby holować do Polski uszkodzony za Bugiem samochód .	uszkodzony	14	Perf
Wilk patrzył zafascynowany .	zafascynowany	2	Perf
Na zakończenie przedstawiona zostanie syntetycznie współzależność sztuki ruchu z innymi rodzajami sztuk .	przedstawiona	2	Perf
Hotel posiadać będzie trzydzieści stylowo umeblowanych pokojów .	umeblowanych	5	Perf
Do zdarzenia doszło na dość oblodzonej ulicy .	oblodzonej	5	Perf
Kilkuletnia inicjatywa organizowania zajęć w czasie ferii w Miejskim Ośrodku Kultury realizowana była także w tym roku .	realizowana	11	Imp
– bo tam nie jest mięso zamrożone .	zamrożone	6	Perf
Nie puszczamy w powietrze materiałów obciążających .	obciążających	5	Imp
W czasach elektronicznych rozmyła się wartość mozolnie zapisywanych karteczek i pedantycznie prowadzonych kartotek .	zapisywanych	7	Imp
Sprawę poruszono na ostatniej sesji rady powiatu .	poruszono	1	Perf
Tymczasem komandor zatrzaśnięty w samochodzie wydzwaniał z telefonu komórkowego do znajomych .	zatrzaśnięty	2	Perf
Za stanami zniechęcenia i depresji kryją się zwykle głębsze konflikty i problemy wewnętrzne , wyniesione głównie ze środowiska rodzinnego .	wyniesione	14	Perf
A przynajmniej choćby na jakiś czas powstrzymać zalewający kraj rewolucyjny potop .	zalewający	7	Imp
Kelnerka miała narzucony płaszcz .	narzucony	2	Perf
Na czele stoi król - Ashantehene , otoczony radą starszych .	otoczony	7	Perf
Do Gdyni dotarła wczoraj oczekiwana od kilku dni amerykańska koszykarka Edna Campbell .	oczekiwana	4	Imp
Prokuratura ma też kilka filmów nagranych amatorskimi kamerami .	nagranych	5	Perf
Rodzice są właścicielami gospodarstwa rolnego , liczącego około 7 ha powierzchni .	liczącego	6	Imp
W tym roku w kościele św . Brygidy na Wielkanoc można było obejrzeć kościotrupa trzymającego flagę UE .	trzymającego	14	Imp
Rezultat wydaje się z góry przesądzony , ale każdy z autorów chciał by dorzucić własne argumenty .	przesądzony	5	Perf
W tajnym głosowaniu żaden z pretendentów nie uzyskał wymaganej większości .	wymaganej	8	Imp
Zdaniem ekspertów pytanych przez PG , nowe prawo farmaceutyczne nie spowoduje odpływu reklamodawców .	pytanych	2	Imp
Rękaw pięknie wyszywanego fraka prędko nasiąkł krwią .	wyszywanego	2	Imp
Najpierw operatorzy będą mieli miesiąc na poinformowanie klientów o nadchodzących zmianach i zadanie im rutynowego pytania , czy chcą obniżki opłat roamingowych .	nadchodzących	9	Imp
Po dziesięciu rozegranych kolejkach MG MZKS ma zaledwie dwa punkty .	rozegranych	2	Perf
Przy okazji zauważył , że wcale nie była skończoną pięknością , lecz tylko doprowadziła do artyzmu trudną sztukę makijażu .	skończoną	8	Perf
Chaim został stracony .	stracony	2	Perf
Poranione potłuczoną butelką zwierzę trafiło do weterynarza .	potłuczoną	1	Perf
Prowadzi ich dowódca z obnażonym mieczem .	obnażonym	4	Perf
Jeszcze wczoraj Francja miała zarządzić blokadę kont Osamy bin Ladena oraz 26 innych osób i organizacji znajdujących się na amerykańskiej liście terrorystów .	znajdujących	16	Imp
W jej twarzy , mokrej od łez rozmazanych i czerwonej , tężały w osłupieniu szkliste , bladoniebieskie oczy .	rozmazanych	7	Perf
Prowadzący śledztwo oskarżył o spowodowanie wypadku polskiego kierowcę .	Prowadzący	0	Imp
Chmury rozsunęły się na moment , odsłaniając wytarty miedziak słońca .	wytarty	7	Perf
Lisiecki nie włączył się w żadną z grup rozmawiających o rajdzie .	rozmawiających	8	Imp
Z przodu oboma dłońmi chwytamy za przedramię zgięte w stawie łokciowym .	zgięte	7	Perf
Nad ranem z soboty na niedzielę z pędzącego pociągu wyskoczyła 17-letnia dziewczyna .	pędzącego	7	Imp
O zawilgoceniu gruntu i budynków informowali jedynie archeolodzy prowadzący wykopaliska na starówce .	prowadzący	8	Imp
Bandytów nie złapano .	złapano	2	Perf
Wczoraj koło cmentarza w Sianowie znaleziono kilkuletniego chłopca .	znaleziono	5	Perf
Kontrast ten może nawet świadczyć o jakiejś obojętności czy martwocie religijnej panującej w czasach proroka .	panującej	11	Imp
Lista posłów zapisanych do głosu została wyczerpana .	zapisanych	2	Perf
Na nasz rozum z Polmosu najzwyczajniej wyprowadzono 2 mln euro .	wyprowadzono	6	Perf
A to może uratować od śmierci , bo początek choroby zostanie w porę wykryty .	wykryty	13	Perf
Wśród przywiezionych jest jeden noworodek .	przywiezionych	1	Perf
I ma w dodatku zorganizowane oparcie w ZNP .	zorganizowane	4	Perf
Zimna woda tryskała na głowę , szyję i płonące uszy .	płonące	8	Imp
Sprawa została upubliczniona na ostatniej miejskiej sesji .	upubliczniona	2	Perf
- Zrobiła ręką gest zapraszający do środka .	zapraszający	4	Imp
Szczegółowo analizowane są zapisy z kamer monitorujących , które znajdują się na terenie Kwidzyna .	analizowane	1	Imp
Poruszał rytmicznie kolanami , unosząc lekko siedzącą na nich kobietę .	siedzącą	6	Imp
Cóż , dobrze wychowany człowiek po prostu nie zadaje takich pytań .	wychowany	3	Perf
Aby udowodnić winę osobie opalającej zabronionymi materiałami , należałoby przeprowadzić specjalistyczne badania wydobywającego się z komina dymu .	zabronionymi	5	Perf
- Wasza gazeta od dawna robi świetne przewodniki dla poszukujących pracy w Irlandii .	poszukujących	9	Imp
Rozśpiewały się ptaki , powracające gromadami w mury Zamku .	powracające	4	Imp
Jego życie było wypełnione dążeniami do Dobra i Sprawiedliwości .	wypełnione	3	Perf
Duże kontrowersje wzbudził zapis wywalczony przez Związek Nauczycielstwa Polskiego .	wywalczony	4	Perf
Miejsce poszukiwań oznaczono bojami .	oznaczono	2	Perf
Tylko pani Ludwika Trol chodziła podenerwowana i trochę zła .	podenerwowana	5	Perf
Miał kochającą rodzinę , swoje pasje i marzenia .	kochającą	1	Imp
Rękaw pięknie wyszywanego fraka prędko nasiąkł krwią .	wyszywanego	2	Imp
Swojego domku obitego papą Wanda Kędzierska trochę się wstydzi .	obitego	2	Perf
Odziedziczyła ona po bracie majątek w Galicji , uprzemysłowiony i dający duże profity .	dający	10	Imp
O klasztornym piekle , zgotowanym przez trzy potwory w habitach , pisaliśmy w kwietniu br .	zgotowanym	4	Perf
Czujka jest zasadniczo nieuzbrojona .	nieuzbrojona	3	Perf
Na morskiej jednostce mogą być zatrudnione tylko te osoby , które posiadają aktualne świadectwo zdrowia .	zatrudnione	5	Perf
Dzięki cyfrowej telewizji satelitarnej istnieje też możliwość połączenia z Internetem czy udziału w kursach przygotowujących do matury albo egzaminu na studia .	przygotowujących	14	Imp
Często śniło się jej , że biegnie za oderwaną ręką i nie może jej dogonić .	oderwaną	8	Perf
Zakurzoną perukę otrzepał o kolano .	Zakurzoną	0	Perf
Nieleczona choroba przerodziła się w złośliwego chłoniaka .	Nieleczona	0	Imp
Włoski rząd na nadzwyczajnym posiedzeniu przeznaczył wczoraj 50 milionów euro dla dotkniętego trzęsieniem ziemi regionu .	dotkniętego	11	Perf
Na szybko pokonywanych zakrętach pojazd wykazuje delikatną nadsterowność .	pokonywanych	2	Imp
Zawodowe uprawianie miłości bywa w Polsce ganione .	ganione	6	Imp
W niedzielę rano rozpoczęła się zapowiadana przez władze macedońskie ofensywa przeciwko albańskim separatystom działającym na północy kraju .	zapowiadana	5	Imp
A tak nazywały się serwowane tam alkohole .	serwowane	4	Imp
Operację na lotnisku przeprowadzono na 10 godzin przed upływem ultimatum postawionego przez porywaczy .	postawionego	10	Perf
Najpierw samodzielność uzyskał Zakład Naprawy Autobusów w Biskupicach , wcześniej stanowiący integralną część MPK .	stanowiący	10	Imp
Sprawa została upubliczniona na ostatniej miejskiej sesji .	upubliczniona	2	Perf
Ten okres minnesangu zakończył się w ostatniej dekadzie XII wieku , gdy naśladownictwa ustąpiły nowym tematom i formom wypracowanym przez miejscowych poetów .	wypracowanym	18	Perf
Kochamy Polskę , lecz fakty składające się na polską rzeczywistość działają nam na nerwy .	składające	5	Imp
Wszelkie informacje podane poniżej dotyczą jedynie wypadków sprawdzonych .	podane	2	Perf
Algorytm modelu stanowią równania empiryczne , a parametry równania są identyfikowane w procesie optymalizacji .	identyfikowane	10	Imp
Oryginalne lampy zdobyto z zasobów niemieckich przeznaczonych dla Wehrmachtu .	przeznaczonych	6	Perf
W krem wcisnąć osączone i pokrojone ananasy .	osączone	3	Perf
W grudniu 1996 roku Havlovi wraz z górnym płatem prawego płuca usunięto niewielki nowotwór złośliwy .	usunięto	11	Perf
Nie pomyślał em o tym , że nie był on przytwierdzony do postumentu , zdejmowano go przecież rokrocznie .	przytwierdzony	10	Perf
Nie wiemy jeszcze , na ile uniwersalny jest przedstawiony model .	przedstawiony	8	Perf
Powiększona kuchnia stała się obszernym pomieszczeniem mieszczącym duży stół .	mieszczącym	6	Imp
Przed światłami kierujący ruchem zatrzymał tira , a za nim stanęła skoda .	kierujący	2	Imp
Po długo obowiązującym zakazie , znowu do Japonii przybyli katoliccy misjonarze .	obowiązującym	2	Imp
Z jego przepalonego i odsłaniającego rusztowanie kręgów gardła wydobył się syk .	przepalonego	2	Perf
Tylko w tym celu został w kosmos zaproszony .	zaproszony	7	Perf
Ofiary następnej deportacji to rodziny represjonowanych .	represjonowanych	5	Imp
Teraz wylegitymowani na granicy , jeśli nie zapłacą , mogą nawet stracić samochód .	wylegitymowani	1	Perf
Szpital w Ostródzie został sprywatyzowany 7 lat temu .	sprywatyzowany	4	Perf
Pobity kijem bejsbolowym mężczyzna trafił z licznymi obrażeniami do szpitala .	Pobity	0	Perf
Wielu obawia się , że będzie skazany na typowe pieskie życie .	skazany	6	Perf
- Jakie znaczenie dla śledztwa ma odkrycie dokonane w archiwach w Łomży , o którym niedawno poinformowała prof . Daria Nałęcz ?	dokonane	7	Perf
Jego oczy przestraszone , rozbiegane cofnęły się jeszcze bardziej .	przestraszone	2	Perf
Siedział odchylony za swoim biurkiem z taką miną , jakby dowodził całą policją , Interpolem i FBI na dodatek i delektował się kawą .	odchylony	1	Perf
Syna Włodzimierza Olewnika porwano jesienią 2001 r .	porwano	3	Perf
Służy do tego oddzielne naczynko o chropowatym dnie , pozwalającym ptakowi w kąpieli pewnie stać na nóżkach .	pozwalającym	9	Imp
Przed drzwiami sali rozpraw siedzieli uzbrojeni antyterroryści .	uzbrojeni	5	Perf
Przegląd najistotniejszych badań alokacji podatku dochodowego zamieszczono w następnym punkcie niniejszego rozdziału .	zamieszczono	6	Perf
– antykoncepcje też jest zabroniona ?	zabroniona	4	Perf
– Czy zaprawiony w biznesie człowiek może być bez skazy ?	zaprawiony	2	Perf
A pań Gąsowski , też jakby urzeczony , podniósł ją ręką i spojrzał na nią ze zdziwieniem .	urzeczony	6	Perf
Dlaczego ugrupowanie , które będzie rozliczane przez wyborców z efektów rządzenia , ma sobie utrudniać pracę ?	rozliczane	5	Imp
Z jego przepalonego i odsłaniającego rusztowanie kręgów gardła wydobył się syk .	odsłaniającego	4	Imp
- Niestety , niestety byłem uważany za aroganta .	uważany	5	Imp
Nieleczona choroba przerodziła się w złośliwego chłoniaka .	Nieleczona	0	Imp
Wiadomo jednak , że podłożem tego przestępstwa były tak zwane taryfy pracownicze .	zwane	9	Imp
W 1990 r . Smolański brał czynny udział w napaści na afrykańskich studentów manifestujących na wrocławskim rynku .	manifestujących	13	Imp
Zamierzamy dotrzymywać zawartych umów i porozumień .	zawartych	2	Perf
Suchocka nie jest osamotniona w swej walce z prokuratorami .	osamotniona	3	Perf
Te wszystkie rogi zostały zdemontowane i wywiezione do Szczecina .	wywiezione	6	Perf
Na dziobie , bodącym niebo , przerzucony przez poręcz wisiał mister Dawid Lingslay .	przerzucony	6	Perf
Prześcieradło było częściowo z materaca ściągnięte .	ściągnięte	5	Perf
Dzięki ich ofiarnej postawie las został uratowany .	uratowany	6	Perf
Nie było to oczywiście zamierzone , wynikło z pośpiechu .	zamierzone	4	Perf
Przebiegające pod miastem chodniki kopalni zalano wodą , a wzgórze zgniło i zapadło się w ziemię jak przydeptane .	przydeptane	17	Perf
Wstępna analiza Inspektoratu wskazuje , że sąd w Jeleniej Górze nie jest przystosowany do procesów , w których oskarżonymi są członkowie zorganizowanych grup przestępczych .	przystosowany	12	Perf
Niebo było pokryte białymi barankami .	pokryte	2	Perf
Który wyszedł usprawiedliwiony ?	usprawiedliwiony	2	Perf
Nie kryją się z tym , chcą być widziani , rozpoznani ?	rozpoznani	10	Perf
Czy my wszyscy zasługujemy na życie w państwie rządzonym przez państwa Kaczyńskich ?	rządzonym	8	Imp
Łódź odnaleziono porzuconą i ogołoconą z silnika i kosztownego wyposażenia .	porzuconą	2	Perf
Tam znajdują się dane o poszukiwanych przestępcach .	poszukiwanych	5	Imp
Została ona zachwiana po październikowych wyborach .	zachwiana	2	Perf
Rybka powędrowała do akwarium ustawionego przez asystentkę na stoliku .	ustawionego	4	Perf
Także w ubiegłym roku zniszczono nagrobki na cmentarzach w Gdyni i Kielcach .	zniszczono	4	Perf
Zza kulis wychodzi aktorka grająca Magdalenkę .	grająca	4	Imp
- Czy czarny scenariusz jest brany pod uwagę w zachodnich kołach finansowych ?	brany	5	Imp
Do poradni chirurgicznej i pogotowia ratunkowego napływali poszkodowani piesi .	poszkodowani	7	Perf
W wysokiej trawie leżały setki stygnących ludzkich ciał .	stygnących	5	Imp
Po ponad 30 godzinach od katastrofy żadna z poszukiwanych osób nie ma szans na przeżycie w lodowatej wodzie .	poszukiwanych	8	Imp
Nie wyobrażała sobie dnia bez muzyki , ale słuchała jej w czterech ścianach , odtwarzanej z płyt .	odtwarzanej	14	Imp
Przedstawiony przez was budynek to prosta forma ze szkła .	Przedstawiony	0	Perf
Czarodziejka usiadła , wracając do przerwanej czynności .	przerwanej	5	Perf
Podtopiony dom , to była łódź z ludźmi zakotwiczona na środku Sanu .	Podtopiony	0	Perf
Odebrano im łup i zrabowaną broń .	zrabowaną	4	Perf
Pomysł powstał podczas uzupełniania ksiąg parafialnych , które były skrupulatnie sprawdzane podczas duszpasterskich wizytacji .	sprawdzane	10	Imp
Jest to aminokwas poprawiający pamięć starzejącej się komórki .	poprawiający	3	Imp
Zjadano dziennie stado baranów , setki kur , górę ryżu , sadzawkę jogurtu , piramidę melonów i wypijano wagon coca-coli .	wypijano	17	Imp
W przypadku grożących gołoledzią opadów deszczu lub śniegu , komputer włącza ogrzewanie jezdni .	grożących	2	Imp
Wśród trzech pozostałych młodych rysi śledzonych telemetrycznie , które osiedliły się w Puszczy Białowieskiej , były dwie samice .	śledzonych	5	Imp
Protestują przeciwko zamierzonej budowie .	zamierzonej	2	Perf
Ukonstytuowały się już wszystkie komisje działające przy Radzie Gminy i od razu zabrały się do roboty nad sporządzeniem planu działania na rok 1999 .	działające	5	Imp
Wzdłuż alejek ustawionych zostanie osiemdziesiąt ławek .	ustawionych	2	Perf
Był to ostatni ze zgłoszonych mówców .	zgłoszonych	4	Perf
Do skomplikowanych wzorów używamy deski przywiązanej do sznurka .	przywiązanej	5	Perf
Mówi się przecież , że broń była w szkole schowana jeszcze latem w czasie remontu .	schowana	9	Perf
Tego nie wiemy na pewno , mimo że zacytowane wyżej zdanie stało się znakiem rozpoznawczym .	zacytowane	8	Perf
Betonowe fundamenty zostały wykonane już wcześniej .	wykonane	3	Perf
W kwietniu tegoż 1981 r . w naszych zachodnich okręgach wojskowych przeprowadzona została nadzwyczaj długa sztabowa gra wojenna .	przeprowadzona	11	Perf
Starem z przyczepą załadowaną piaskiem kierował kursant .	załadowaną	3	Perf
Spostrzegł , że opuściła głowę i zaciskała poruszające się nerwowo usta .	poruszające	7	Imp
Tereska mrugnęła do mnie porozumiewawczo i opuściła głowę , jak każda strofowana uczennica .	strofowana	11	Imp
Wobec niektórych z notowanych firm toczy się obecnie postępowanie upadłościowe .	notowanych	3	Imp
Maturzyści - internauci zdający na pisemnym egzaminie język polski i historię najczęściej typują tematy związane z przełomem wieków .	zdający	3	Imp
Mógł się zmieścić w złożonych dłoniach .	złożonych	4	Perf
- Będzie realizowana jedna polityka uzgodniona na posiedzeniach Rady Ministrów .	realizowana	2	Imp
Do nowotarskiej tradycji weszły organizowane przez burmistrza spotkania noworoczne .	organizowane	4	Imp
Listy leżały przed nim zamknięte , zżółkłe , stare .	zamknięte	4	Perf
Nagrody nie mogą być przyznawane pośmiertnie .	przyznawane	4	Imp
Myślę , że tak właśnie powinni zachowywać się odpowiedzialni kandydaci .	powinni	5	Imp
Badania wielkości sił naciągu strun na torze przeprowadzono przez bezpośredni pomiar sił w poszczególnych strunach za pomocą przyrządu VOGT .	przeprowadzono	7	Perf
Najbardziej narażone na skargi niezadowolonych klientów są placówki handlowe .	narażone	1	Perf
Otrzymuje wyrok śmierci , zamieniony na dziesięć lat łagru .	zamieniony	4	Perf
Do poszukiwań człowieka oskarżonego o ludobójstwo i zbrodnie przeciwko ludzkości włączyli się amerykańscy i brytyjscy agenci .	oskarżonego	3	Perf
Na pewno ściągnięte przez niego duszyczki nie płaciły składek .	ściągnięte	2	Perf
Potrząsnął em głową ; połączenie zostało zerwane .	zerwane	6	Perf
W Polsce przedwrześniowej mieliśmy jedynie 600 zelektryfikowanych wsi .	zelektryfikowanych	6	Perf
Do kraju powróciły uprowadzone Polki .	uprowadzone	3	Perf
Cofnął się jak oparzony , gdy fala obmyła mu łapy .	oparzony	3	Perf
Sprowadzeni na miejsce strażacy i policjanci nie ukrywali zdziwienia .	Sprowadzeni	0	Perf
Na inwestycję przyznano 28 milionów marek kredytu , który przyznano na 15 lat z pięcioletnią karencją spłaty odsetek .	przyznano	2	Perf
Kochamy Polskę , lecz fakty składające się na polską rzeczywistość działają nam na nerwy .	składające	5	Imp
Szybsze topnienie brzegów lodowca kompensowane jest przez zwiększone opady w środku kontynentu .	kompensowane	4	Imp
Szczegółowo analizowane są zapisy z kamer monitorujących , które znajdują się na terenie Kwidzyna .	monitorujących	6	Imp
Jeżeli człowiek silnie reaguje na różne zjawiska , może być tak odbierany .	odbierany	11	Imp
Załogi z niepokojem śledzą ciche chmury nadchodzące z południa .	nadchodzące	6	Imp
Tutaj jedynie pokrótce opiszemy ten standard i nieco uzupełnimy zaprezentowane w wymienionych artykułach informacje .	wymienionych	11	Perf
Potrawy były oceniane przez 110 niezależnych sędziów .	oceniane	2	Imp
Ze stara wyciekał olej i płyn chłodzący , a przyczepa miała zdemontowany hamulec awaryjny .	zdemontowany	11	Perf
TP SA chce złagodzić planowane redukcje .	planowane	4	Imp
Nie było krzyku ani wymierzonych w nas luf .	wymierzonych	4	Perf
Ojciec Tadeusz Rydzyk po emisji poświęconego mu filmu mówił na antenie swego radia , że to zemsta TVP za jego plany stworzenia telewizji .	poświęconego	5	Perf
– Leżał na rękawicach ochronnych i też był popaprany ziemią .	popaprany	8	Perf
Nad falami sterczał jeszcze tylko wystrzelający pionowo dziób .	wystrzelający	5	Imp
Nie ma dawno Babilonu , ale o łzach wylanych na brzegi jego rzek pamięta świat .	wylanych	8	Perf
Zapytany przez nas radiotelegrafista zdradził treść oddanej depeszy .	oddanej	6	Perf
Na konferencji mówiono też o stanie gospodarki europejskiej .	mówiono	2	Imp
Policja przypuszcza , że najnowszy ładunek został porzucony przez spłoszonego niedoświadczonego terrorystę .	porzucony	7	Perf
Orkiestry murzyńskie grają ragtime'y , tłum cheerleaderek tworzy radosny , falujący szpaler .	falujący	10	Imp
Ten wszechstronny , nowoczesny obiekt jest wyposażony w profesjonalny sprzęt pożarniczy .	wyposażony	6	Perf
Całość w formie tekstowej zostanie opublikowana po autoryzacji .	opublikowana	5	Perf
Drugi pod względem kapitalizacji giełdowej Wielkopolski Bank Kredytowy osiągnął bardzo dobrą miesięczną dynamikę zysków wynoszącą 81,4 proc .	wynoszącą	14	Imp
- Ważne są opinie ludzi mówiące o pozostawieniu miejskiej komunikacji .	mówiące	5	Imp
Jak poinformował Cesar Fraga z Uniwersytetu w Buenos Aires , przeprowadzone tam badania wykazały , że czekolada wzmacnia antyutleniacze znajdujące się we krwi , zwiększając odporność na zaburzenia serca i naczyń wieńcowych .	znajdujące	19	Imp
Ze sklepu Wedla wyszedł ciemno ubrany mężczyzna z kilkoma paczuszkami w rękach .	ubrany	5	Perf
Ułatwi ona włączenie się do ruchu jadącym z Koziegłów do Poznania .	jadącym	6	Imp
Jest dobrze uzbrojona .	uzbrojona	2	Perf
Maciej Gielecki , wojewoda warszawski , obiecał im , że Łubna II nie zostanie wybudowana .	wybudowana	14	Perf
Prezydent zapowiada , że w ciągu półtora roku plan zostanie zmieniony .	zmieniony	10	Perf
Doświadczenia z dzieciństwa spędzonego w rodzinie alkoholowej u wielu mężczyzn i kobiet owocują w dorosłym życiu utrwalonymi schematami odczuwania , zachowania i myślenia .	utrwalonymi	16	Perf
Nie czuję się przekonany .	przekonany	3	Perf
Ich znajomość , zaczęta w pośpiechu i sekrecie , nigdy nie zmieniła swojego charakteru .	zaczęta	3	Perf
Musi uwierzyć , że pisane jej jest życie tylko z tobą .	pisane	4	Imp
Po kwadransie poproszono go na górę .	poproszono	2	Perf
Położono na niej nową nawierzchnię asfaltową .	Położono	0	Perf
Zostało zapakowane w paczkę , wysłane w przeszłość .	wysłane	5	Perf
Sprawdź dokumenty osoby zbierającej datki .	zbierającej	3	Imp
Zdenerwowani są także kierowcy .	Zdenerwowani	0	Perf
Twierdzą , że ich skargi są ignorowane .	ignorowane	6	Imp
Zrobiono to poza moimi plecami .	Zrobiono	0	Perf
Tradycja związana ze św . Wojciechem głosi , że w X w . założył on w Trzemesznie klasztor benedyktynów .	związana	1	Perf
Często tu goszczę i jestem serdecznie przyjmowany .	przyjmowany	6	Imp
Podczas ostatniego spotkania przywódców Piętnastki w Brukseli rozstrzygnięto też kilka spornych kwestii związanych z miejscem przyszłych członków w unijnych instytucjach .	związanych	12	Perf
Podwyżka zmniejszy ponoszone przez spółkę straty .	ponoszone	2	Imp
Chłopiec wynurza się spod stołu , trzymając na dłoni rozbite jajko , strzaskaną skorupkę , rozlane żółtko i oślizłe białko .	strzaskaną	12	Perf
Zostało zapakowane w paczkę , wysłane w przeszłość .	zapakowane	1	Perf
Powstała nawet nauka o snach , nazywana onejrologią .	nazywana	6	Imp
– Konecczanin wysłał pieniądze na podane konto .	podane	5	Perf
Irga rozkrzewiona to jeden z najpiękniejszych gatunków o wspaniałym jesiennym przebarwieniu liści , również obficie owocujący .	owocujący	15	Imp
Wszystko tu było zrobione z myślą o wygodzie i miłosnych uciechach .	zrobione	3	Perf
Urząd , nawet na podstawie wadliwej decyzji , mógł ściągnąć niesłusznie naliczony podatek .	naliczony	11	Perf
Słuchali śmy chciwie tej nocy otaczającej nas ciasno .	otaczającej	5	Imp
Ale tego rodzaju zabiegi mogą być wykonywane tylko przez specjalnie przeszkolone ekipy zwalczania szkodników .	wykonywane	6	Imp
Ponieważ ciągle nie została ujawniona publicznie statystyka represji poczerwcowych , trudno powiedzieć cokolwiek na temat ich zasięgu .	ujawniona	4	Perf
Pozbierał em rozrzucone papierzyska i przypomniał em sobie sen .	rozrzucone	2	Perf
– Była bardzo prześladowana .	prześladowana	3	Imp
W Centrum Naukowym Wielkich Jezior w amerykańskim Cleveland otwarto wystawę niecodziennych pomocy naukowych dla dzieci .	otwarto	8	Perf
Łukasz zatrzymał przejeżdżającą taksówkę .	przejeżdżającą	2	Imp
Zajmował się innymi sprawami , raczej oddalonymi od zainteresowań pisarskich .	oddalonymi	6	Perf
Ostra sauna , potem pływa się w basenie okolonym drzewami .	okolonym	8	Perf
Ciemne włosy , spięte w koczek , podtrzymywała złocista spinka .	spięte	3	Perf
Warunkiem będzie jednak zatrudnienie odchodzących z TP SA pracowników .	odchodzących	4	Imp
Odnalazł Jaskra , kibicującego łupiącym w gwinta krasnoludom .	kibicującego	3	Imp
Wierni poczuli się zawiedzieni .	zawiedzieni	3	Perf
Istnieje jeszcze jedna dieta , której skuteczność jest niedoceniana ze względu na jej kontrowersyjność .	niedoceniana	8	Imp
A to dlatego , że norwescy słuchacze nie cenią artystów wykreowanych przez wielkie wytwórnie .	wykreowanych	10	Perf
Jest to istotne , zwłaszcza dla internautów korzystających z modemów .	korzystających	7	Imp
Czy jest Ksiądz Arcybiskup zadowolony z ostatecznego brzmienia wspólnego oświadczenia biskupów polskich i niemieckich na czterdziestolecie Orędzia ?	zadowolony	4	Perf
Z zestawienia sporządzanego przez starostwo wynika , że podmioty gospodarcze działające w powiecie działdowskim dokonują rocznie ponad 6000 odpraw celnych .	działające	10	Imp
Wysunięta ręka Kołodzieja wyrwała go z zauroczenia .	Wysunięta	0	Perf
Przebiegające pod miastem chodniki kopalni zalano wodą , a wzgórze zgniło i zapadło się w ziemię jak przydeptane .	przydeptane	17	Perf
Bracia Kaczyńscy chcą w tej chwili albo koalicji na swoich warunkach , albo przyspieszonych wyborów .	przyspieszonych	13	Perf
W 20 polach diagramu ukryto skarby .	ukryto	4	Perf
Niewielkie zmiany odczują osoby oddające krew .	oddające	4	Imp
Jan Paweł II może być niebawem beatyfikowany .	beatyfikowany	6	Imp
W dyskusji zgłoszono wniosek o odrzucenie projektu uchwały w sprawie założeń polityki pieniężnej na 1995 r .	zgłoszono	2	Perf
- Chłopaka w beznadziejnym stanie przywieziono do Zabrza .	przywieziono	5	Perf
- To nie może wpływać na osoby zainteresowane .	zainteresowane	7	Perf
Biała plama zniknęła , cały glob był opasany siecią wspólnot .	opasany	7	Perf
Leżącego na trawie obok drogi mężczyznę zauważyły przejeżdżające tamtędy przypadkowe osoby .	przejeżdżające	7	Imp
Studenci będą mogli korzystać z wprowadzonego pilotażowo od października br . systemu pożyczek studenckich .	wprowadzonego	5	Perf
Po powrocie zauważył , że drzwi do komórki , zawsze zamknięte na skobel , są otwarte .	zamknięte	10	Perf
Tymczasem ten istniejący był gruntownie remontowany kilka lat temu .	istniejący	2	Imp
Na ich temat nic również nie powiedzieli płatni informatorzy , do których w tej sprawie zwrócili się policjanci prowadzący dochodzenie .	prowadzący	18	Imp
Rośnie pokolenie ludzi straconych , wyrzuconych . . .	straconych	3	Perf
Jest to choroba wzrostowa zwana także bolesną kifozą młodzieńczą .	zwana	4	Imp
Drużynowymi finałami zakończona została w poniedziałek rywalizacja pływaków o medale i dolarowe premie w Igrzyskach Dobrej Woli .	zakończona	2	Perf
Warto zwrócić uwagę na to , by worek do śpiwora był ściągany na co najmniej dwóch wysokościach .	ściągany	11	Imp
Zazwyczaj pojawiający się problem zajmuje twoje myśli przez cały dzień .	pojawiający	1	Imp
Na trotyl natrafiono w miejscu , które wskazał radiesteta , zatrudniony przez rodzinę zaginionego .	natrafiono	2	Perf
W stanie obrzydzenia przyprawiającego o nowe mdłości nie zauważył nawet , że wielki ból zaczyna z wolna zanikać .	przyprawiającego	3	Imp
Radni Malborka podjęli uchwałę w sprawie nowych stawek za wodę i odprowadzane ścieki .	odprowadzane	11	Imp
Zakończono już inwentaryzację majątku w warszawskiej centrali .	Zakończono	0	Perf
Harcerze właśnie rozpoczęli naprawę przekazanych im rowerów .	przekazanych	4	Perf
Jest jak wielka rozrastająca się tkanka rakowata .	rozrastająca	3	Imp
Suger Land jest najdynamiczniej rozwijającym się teksańskim miastem .	rozwijającym	4	Imp
Polska winna się wyrzec tradycji , mumii , księcia Józefa i teatru .	winna	1	Imp
Przedstawiono też realistyczną wizję postaci z Całunu Turyńskiego .	Przedstawiono	0	Perf
Wśród 65-tysięcznej publiczności oglądającej uroczyste otwarcie igrzysk będzie 40 najwyższych dostojników różnych państw .	oglądającej	3	Imp
Wszyscy mieli przypięte kolorowe identyfikatory Orkiestry oraz specjalne puszki .	przypięte	2	Perf
Przez kilka miesięcy był aresztowany .	aresztowany	4	Perf
Drugim ważnym wydarzeniem był run na giełdę firm poszukujących kapitału .	poszukujących	8	Imp
Stanął w nich ubrany w piżamę , zakrwawiony 12-letni Łukasz , wnuk gospodarzy , po chwili osunął się na ziemię .	ubrany	3	Perf
W półfinałach rozegrano mecze systemem pucharowym , a zwycięzcy awansowali do finałów .	rozegrano	2	Perf
Dzicy plakaciarze zaśmiecający miasto są bezkarni .	zaśmiecający	2	Imp
Młoda demokracja została siłą wtłoczona w ramy półautorytarnej republiki prezydenckiej .	wtłoczona	4	Perf
Alkoholu jeszcze nie podano , popielniczki błyszczały czyste i nie skażone .	skażone	10	Perf
Zmiany dokonane w Oplu Fronterze wyszły mu na dobre .	dokonane	1	Perf
Woda dokoła niej poróżowiała od zmytego kurzu .	zmytego	5	Perf
Przez wiele ostatnich lat te działania ośmieszano i uznawano za coś , co nas nie dotyczy .	uznawano	8	Imp
Pamiętam w Iveronie w sześciu gablotach stłoczone największe relikwie .	stłoczone	6	Perf
Ma liczne rany tłuczone , poważny uraz głowy .	tłuczone	3	Imp
To zakazane nie jest .	zakazane	1	Perf
Rozmowę uznałem za skończoną .	skończoną	3	Perf
Uhonorowani zostali także inni muzycy .	Uhonorowani	0	Perf
Nie mogła się mylić , bo odbite od łez światło dawało wyraźny błysk .	odbite	6	Perf
W świecie nauki początek jesieni to emocje towarzyszące Nagrodom Nobla .	towarzyszące	7	Imp
Polacy jadący w autokarze spoglądają z nietajoną dumą na wielkiego rodaka .	nietajoną	6	Imp
Regina z ciekawością słuchała czytającego z kartki Bornsteina .	czytającego	4	Imp
Miejmy nadzieję , że ich nowa redakcja zawierać będzie wnioski autorów omawianej publikacji .	omawianej	11	Imp
Sześć cebul kupiła na kiermaszu zorganizowanym w pobliskiej szkole .	zorganizowanym	5	Perf
Cela była wesoła , to byli komuniści przyzwyczajeni do defensywy .	przyzwyczajeni	7	Perf
Długo machali rękami zostającemu na peronie Staszkowi Kuli .	zostającemu	3	Imp
Przyjrzyj się fotografiom i rysunkom w podręczniku przedstawiającym przykład krajobrazu śródziemnomorskiego .	przedstawiającym	7	Imp
Leczenie ataków padaczkowych polega na podawaniu leków przerywających drgawki niezależnie od ich przyczyny .	przerywających	7	Imp
Kartka zaadresowana do mnie czekała w Teatrze Powszechnym .	zaadresowana	1	Perf
Zaprojektowano specjalną okazałą szafę z 205 boksami .	Zaprojektowano	0	Perf
Tam znajdują się dane o poszukiwanych przestępcach .	poszukiwanych	5	Imp
To właśnie nasza Polska , nowa Rzeczpospolita , Coraz bardziej podzielona , coraz bardziej rozbita .	rozbita	14	Perf
Dymek w tym czasie ekspanderem przymocował otwartą klapę .	otwartą	6	Perf
Dziecko niespodziewanie wsiadło do czekającej na piętrze windy .	czekającej	4	Imp
Nie musi znać tekstu , bo na kredensie , na stole , na krześle ma przypięte kartki z dialogami , których kamera nie widzi .	przypięte	15	Perf
Podniosła m oczy znad talerzyka z malinami , posypanymi cukrem .	posypanymi	8	Perf
Dobrze zbudowana , na starość otyła , poruszała się szybko i zręcznie .	zbudowana	1	Perf
Spojrzał na mnie zaskoczony .	zaskoczony	3	Perf
Śpiącego , zielem odurzonego zabiła m sztyletem .	Śpiącego	0	Imp
Pokój , do którego zaprowadzono gości , miał zaokrąglone wszystkie ściany .	zaprowadzono	4	Perf
Taksówka czekała z zapalonym silnikiem , a ci od pomocy drogowej wkładali jeepa na podnośnik .	zapalonym	3	Perf
Zginęło w niej 8 żołnierzy amerykańskich , 7 współpracujących z nimi Afgańczyków oraz kilkuset Talibów i bojowników Al-Qaidy .	współpracujących	8	Imp
Na posłanie z ziół i kwiatów ułożono kości i pokryto je szczątkami sztandaru .	pokryto	9	Perf
Wyborcy zdecydowali , że powinni zasiąść w Sejmie .	powinni	4	Imp
Udało się to osiągnąć połowicznie , bo wszystkie szczegóły umowy nie zostały ujawnione .	ujawnione	12	Perf
Wódz Samoobrony ma być umoczony w molestowanie seksualne .	umoczony	4	Perf
Zasypiam , ssąc chrupką skórkę przy migoczącym w telewizji Człowieku z żelaza .	migoczącym	6	Imp
Dla mnie kwestia aborcji powinna być oddzielona i rozpatrywana oddzielnie od spraw religijnych .	oddzielona	6	Perf
Kiedy miałam pięć lat , posłano mnie do szkoły .	posłano	5	Perf
Dostał oklaski od zebranych , ale odpowiedzi oficjalnej nie otrzymał .	zebranych	3	Perf
Wystraszona niewiasta nie protestowała .	Wystraszona	0	Perf
– Nie zostanie pan jednak całkiem odsunięty od śledztwa .	odsunięty	6	Perf
Śpiewającą męską siódemką dyryguje na estradzie po mistrzowsku Charles Bailly .	Śpiewającą	0	Imp
Sztandar bojowy podniosły także narody podbite i uciemiężone przez carat .	podbite	5	Perf
A teraz , przez tę ciążę , jesteśmy uziemieni .	uziemieni	8	Perf
Temu sukcesowi w znacznej mierze przysłużył się również Szymon , który wywalczył 10 z 18 zdobytych przez Polaków punktów .	zdobytych	15	Perf
Patrzył na Petera ze smutkiem i zdumieniem zmieszanym z podziwem .	zmieszanym	7	Perf
Czarne mają znaczną przewagę , a Biały Hetman jest atakowany .	atakowany	9	Imp
Słuchawka leżała odłożona na stoliku obok czyjejś niedopitej herbaty .	odłożona	2	Perf
Siedzibą tej parafii jest usytuowany przy skrzyżowaniu ulicy Zamoyskiego i Sabały nowoczesny kościół Świętego Krzyża .	usytuowany	4	Perf
Radar emituje impulsy fal radiowych , rozchodzących się z prędkością światła .	rozchodzących	6	Imp
Na ostatniej sesji Rady Gminy w Dobrej Szczecińskiej nadano nazw nowym ulicom .	nadano	8	Perf
Padały jeszcze pytania o drogi krajowe biegnące przez wsie .	biegnące	6	Imp
Niezależnie od przedstawionych wyników , kontrolę przeprowadzą jeszcze policjanci z Komendy Wojewódzkiej Policji w Katowicach .	przedstawionych	2	Perf
– a są pozamykane ?	pozamykane	3	Perf
W numerze wydanym przez Movex rzuca się w oczy kilkustronicowy wstępniak .	wydanym	2	Perf
Zaangażowano mnie w celu udowodnienia , że Mojka miał wspólników w Banku Prowincjonalnym .	Zaangażowano	0	Perf
Bracia Kaczyńscy chcą w tej chwili albo koalicji na swoich warunkach , albo przyspieszonych wyborów .	przyspieszonych	13	Perf
Ukrywający się od wielu lat serbski zbrodniarz wojenny gen . Ratko Mladić nie może już czuć się bezpieczny .	Ukrywający	0	Imp
Udało się dopiero wtedy , gdy zorientowałem się , co jest grane .	grane	11	Imp
Kto tak ubrane dziecko pozostawił w deszczowy , zimny i wietrzny dzień ?	ubrane	2	Perf
Maturzyści zakładają , że podczas tegorocznej matury nie będzie tematów , wymagających znajomości twórczości tylko jednego pisarza .	wymagających	11	Imp
Biedny ptak , z szeroko otwartym dziobem , zwisał głową w dół , niby ułamana z krzewu kiść .	ułamana	14	Perf
Na szczęście któryś z bliżej stojących chłopaków podskoczył i podtrzymał go .	stojących	5	Imp
Ogłuszający stukot kół nie obudził smacznie śpiącego mężczyzny .	śpiącego	6	Imp
Na zapleczu wszystkie leżą popakowane w specjalne skrzynki .	popakowane	4	Perf
Nie wiadomo , ile głowic zostało już wywiezionych do Rosji .	wywiezionych	7	Perf
" W dzieciństwie byłam często wyzywana i bita " .	wyzywana	5	Imp
Wodzi oczyma po stojących postaciach .	stojących	3	Imp
Po bombardowaniach wojsko przeczesuje dom po domu , starając się odnaleźć porwanego w niedzielę swego kolegę , Gilada Shalita .	porwanego	11	Perf
Uczniowie są tym przedsięwzięciem bardzo zainteresowani .	zainteresowani	5	Perf
Skulona , ze spuszczoną głową , zniknęła na schodach .	spuszczoną	3	Perf
Mam przynieść wypełnioną deklarację członkowską oraz partyjną ankietę .	wypełnioną	2	Perf
Budowę murów aureliańskich rozpoczęto w 271 roku .	rozpoczęto	3	Perf
Dotychczas odwołujący się mogą pozostawać w Niemczech przez wiele miesięcy .	odwołujący	1	Imp
Jest wysoko zapięta pod szyję , wysmukła jak kwiat .	zapięta	2	Perf
W ciszy zapadającego wieczoru głos się roznosił i każde słowo słychać było z daleka .	zapadającego	2	Imp
Z wypłowiałego zdjęcia uśmiechała się azjatycka , młoda twarz pana Korzeniowskiego , wystrojonego w mundur zapięty pod szyją .	wystrojonego	12	Perf
Jeżeli człowiek silnie reaguje na różne zjawiska , może być tak odbierany .	odbierany	11	Imp
Często oglądanym w tych dniach obrazkiem byli ludzie wylewający wiadrami wodę z piwnic , komórek i garaży .	oglądanym	1	Imp
Wniesienie skargi o wznowienie nie tamuje wykonania zaskarżonego wyroku .	zaskarżonego	7	Perf
Już trzykrotnie odwoływali się do Samorządowego Kolegium Odwoławczego , by unieważnić decyzję o warunkach zabudowy wydaną przez Wydział Architektury .	wydaną	15	Perf
W wydanym wczoraj oświadczeniu Rada podkreśliła , że wstrzymanie wykonania koncesji , gdy jednocześnie toleruje się działalność piratów , niszczy podstawy ładu w eterze .	wydanym	1	Perf
Opieka naprzemienna jest konsekwencją sprzeciwu ojców , którzy poczuli się skrzywdzeni orzeczeniami sądów .	skrzywdzeni	10	Perf
Tysiące zwiedzających oblegało stoiska .	zwiedzających	1	Imp
Na koniec wyniki podliczono by w blasku jupiterów na wielkiej konwencji ogólnopolskiej .	podliczono	3	Perf
Oryginalne lampy zdobyto z zasobów niemieckich przeznaczonych dla Wehrmachtu .	zdobyto	2	Perf
Lodów jeszcze nie sprzedawano .	sprzedawano	3	Imp
Brytyjczycy są więc dominującym udziałowcem w największym polskim towarzystwie emerytalnym .	dominującym	3	Imp
W związku z wyrażonym wotum nieufności , Ponikowski w imieniu całego gabinetu poprosił o dymisję , która została przyjęta .	przyjęta	18	Perf
Rodziny osób pochowanych na cmentarzu w York domagają się ich usunięcia .	pochowanych	2	Perf
To były z pewnością Narodziny , mieli śmy na to dowód wykluczający zwątpienie .	wykluczający	11	Imp
Energia ta może być sublimowana , przekształcana .	przekształcana	6	Imp
Dzięki jego zaangażowaniu w naszym mieście nadal funkcjonuje sekcja piłki nożnej na odpowiednim poziomie sportowym , promująca Jarosław na terenie Polski południowo - wschodniej .	promująca	16	Imp
Widział eś kiedyś nienawidzącego swej ofiary drapieżnika ?	nienawidzącego	3	Imp
- Czy policjanci powinni ścigać złodzieja przyłapanego na gorącym uczynku , czy poprzestać na zabezpieczeniu mienia ?	powinni	3	Imp
Nie sądź , a nie będziesz sądzony , uspokoiła się .	sądzony	6	Imp
Skulona , ze spuszczoną głową , zniknęła na schodach .	Skulona	0	Perf
Są razem osadzone w istnieniu .	osadzone	2	Perf
Pozostałoby do rozstrzygnięcia pytanie , dlaczego paradoks , występujący w odniesieniu do przenoszenia masy i energii w przeszłość , nie obowiązuje w stosunku do przyszłości .	występujący	8	Imp
Z 13 do 27 zwiększa się w Łodzi liczba opiekunów , przeprowadzających dzieci idące na lekcje przez najruchliwsze jezdnie i skrzyżowania .	przeprowadzających	11	Imp
Ze stara wyciekał olej i płyn chłodzący , a przyczepa miała zdemontowany hamulec awaryjny .	chłodzący	6	Imp
Był sparaliżowany , stracił mowę i pamięć .	sparaliżowany	1	Perf
System ma 27 stanowisk i zatwierdzony jest do roku 2100 .	zatwierdzony	5	Perf
Niedzielny mecz rozgrywany był przy ciągle padającym deszczu .	rozgrywany	2	Imp
Powstawały robotnicze kolonie przyfabryczne wiążące pracobiorcę z pracodawcą .	wiążące	4	Imp
W związku z wyrażonym wotum nieufności , Ponikowski w imieniu całego gabinetu poprosił o dymisję , która została przyjęta .	wyrażonym	3	Perf
Zaraz wszedł podniecony Zdzisio .	podniecony	2	Perf
- Musimy zebrać ludzi , którzy chcą dokończyć rozpoczęte w 1981 roku dzieło .	rozpoczęte	8	Perf
Dla pozostałych autobusów jadących w kierunku Śródki , dopuszczony zostanie przejazd ul . Estkowskiego .	dopuszczony	8	Perf
Chłopiec przebywa w greckim przytułku prowadzonym przez organizację o złej reputacji .	prowadzonym	5	Imp
Skąd wiemy , że ten cmentarz jest zamknięty ?	zamknięty	7	Perf
Na kolację , oprócz gulaszu , był chleb i masło , a do masła dodano nóż .	dodano	14	Perf
Chciał by być teraz w namiocie , oddzielony od wszystkiego .	oddzielony	7	Perf
Dostrzegł pędzącego byka .	pędzącego	1	Imp
Naciąg strun odbywał się jednocześnie dla całego masztu , czyli w zależności od typu masztu naciągano 12 , 16 lub 18 strun .	naciągano	15	Imp
Sprzęt nie był ubezpieczony .	ubezpieczony	3	Perf
Deser zostanie podany po sprzątnięciu talerza głównego .	podany	2	Perf
Wtem jakby uśmiechnął się do nas spod przymkniętych powiek .	przymkniętych	7	Perf
Jest unerwiona przez nerw trójdzielny .	unerwiona	1	Perf
Potem polski papież został by w Watykanie kanonizowany .	kanonizowany	7	Perf
Substancje zapachowe są również dodawane do środków czystości oraz żywności .	dodawane	4	Imp
Jednostkę zlikwidowano w ramach reorganizacji polskiej armii .	zlikwidowano	1	Perf
Trzymający ją mężczyzna roześmiał się .	Trzymający	0	Imp
Aby udowodnić winę osobie opalającej zabronionymi materiałami , należałoby przeprowadzić specjalistyczne badania wydobywającego się z komina dymu .	wydobywającego	12	Imp
Mimo realizacji wielu programów adresowanych do osób niepełnosprawnych oraz możliwości zakupu sprzętu rehabilitacyjnego , nadal dla wielu osób problemem jest zdobycie wózka inwalidzkiego .	adresowanych	4	Imp
Jest to pierwszy przypadek ciąży mnogiej u żyjącej w niewoli pandy .	żyjącej	7	Imp
Jednak temperatura ta jest niższa od wartości otrzymanych w pomiarach .	otrzymanych	7	Perf
- Jeżeli ćwiczący źle dobiorą rakiety , piloci nie zniszczą przeciwnika .	ćwiczący	2	Imp
Przygotowana na najgorsze Małgorzata dziwi się , że list jest aż tak jałowy .	Przygotowana	0	Perf
Zdarza się , że ich sprawcy z powodu przedawnienia w ogóle nie zostają osądzeni .	osądzeni	13	Perf
Z połączonych dłoni zrobili koło .	połączonych	1	Perf
- Miałeś rację , grzywka też powinna być krótka .	powinna	6	Imp
Wiemy , że Niemcy nasyłali na te tereny duchownych germanizujących tubylców .	germanizujących	9	Imp
Późnym wieczorem już był na nogach i mógł wsiąść na japoński statek płynący do USA .	płynący	12	Imp
Serwisy , które go oferują , często zawierają wiele odnośników prowadzących do przykładowych , działających już stron .	prowadzących	10	Imp
Zarzuty postawiono czterem .	postawiono	1	Perf
Czuł em jego mięśnie napięte pod skórą , twarde jak drewno .	napięte	4	Perf
Przed wejściem do parku wszyscy zostali wyposażeni w lornetki .	wyposażeni	6	Perf
Z ciał potopionych stryjów wylęgły się tysiące myszy i wyruszyły wszystkie do Kruszwicy , prosto na dwór zbrodniarza .	potopionych	2	Perf
Zasklepiamy się w pozycji skrzywdzonego , dotkniętego nieszczęściem .	skrzywdzonego	4	Perf
Mają ciałka masywnie zbudowane , raczej krępe .	zbudowane	3	Perf
Już dochodząc do ulicy Krupskiej , spotkaliśmy przy jakimś domku babcię , która dziarskimi ruchami próbowała miotłą zatrzymać potok wypełzającego na ganek błota .	wypełzającego	19	Imp
Potem ból stał się tak silny , że przesłonił wszystko ciemnością pozbawioną woni i dźwięków .	pozbawioną	11	Perf
Rozdzielali zwaśnione strony w ramach misji pokojowych ONZ .	zwaśnione	1	Perf
W sidła oszustów - pośredników oferujących pracę Polacy wpadają także w Hiszpanii .	oferujących	5	Imp
Czy po uchwaleniu Konstytucji zostanę zgładzony ?	zgładzony	5	Perf
Iluż poważnych obecnie pisarzy czytało swe pierwsze próby literackie w sali przy Krupniczej , siedząc wokół dębowych stołów zsuniętych pośrodku .	zsuniętych	18	Perf
Za chwilę zjawią się kapłanki , a ja , jako bezbożnica , zostanę zelżona i wyrzucona stąd na zbity pysk .	wyrzucona	15	Perf
Zasadzka była starannie przygotowana .	przygotowana	3	Perf
Jeszcze przez kilka minut starali się uporać z doznaną porażką i dramatyczną decyzją Beatki .	doznaną	8	Perf
Codziennie nakładam nawilżający krem na całe ciało .	nawilżający	2	Imp
Zaniepokojona , otworzyła oczy .	Zaniepokojona	0	Perf
W naszej kantynie fabrycznej zmniejszono nam obiad o jedno danie .	zmniejszono	4	Perf
Chłopiec przebywa w greckim przytułku prowadzonym przez organizację o złej reputacji .	prowadzonym	5	Imp
Gdy we wspomnianych dwu pionach narożnikowych ktoś się kąpie , wówczas woda spływa w dół nawilgacając po drodze niżej położone mieszkania .	wspomnianych	2	Perf
Są to jedynie najważniejsze , opisane dość pobieżnie , zranienia w dziedzinie seksualnej , które wymagają uzdrowienia .	opisane	5	Perf
Z lodówki wyjęła niewielki dozownik wypełniony rubinową cieczą i bardzo ostrożnie wcisnęła go do otworu w pudełku .	wypełniony	5	Perf
We znaki dały się też niewyczyszczone przed zimą przewody kominowe .	niewyczyszczone	5	Perf
Od czterech tygodni w centrum Gdańska znajdują się nieuprzątnięte śmieci .	nieuprzątnięte	8	Perf
Z trudem dostrzegam siedzących pod oknem Stefana i Wiktora .	siedzących	3	Imp
Prawdopodobnie część sprzętu rozkradziono .	rozkradziono	3	Perf
Dla mnie kwestia aborcji powinna być oddzielona i rozpatrywana oddzielnie od spraw religijnych .	rozpatrywana	8	Imp
Zawiadomiono policję i prokuraturę .	Zawiadomiono	0	Perf
Stwierdziła z zadowoleniem , że całość prezentuje się bardzo wiarygodnie , zwłaszcza w przyćmionym świetle .	przyćmionym	13	Perf
Zaproponowane odszkodowanie pokazuje , że pan minister dotrzymał słowa .	Zaproponowane	0	Perf
Płonącą Warszawę widać było z dużej odległości .	Płonącą	0	Imp
Rodzice nie będą już mogli wmawiać swoim pociechom , że przynosi je bocian bądź znaleziono je w kapuście .	znaleziono	14	Perf
Jemiołuszka na przykład w ciepłych porach roku jest amatorką much łapiącą w locie owady .	łapiącą	10	Imp
A potem dowiedziałem się , że nie mogę nie pójść na obiad wydawany w restauracji przez znajomego Chenga , bo w czasie ostatniego spotkania znajomy dał mi twarz .	wydawany	12	Imp
Zgodnie z podjętymi na wtorkowym spotkaniu ustaleniami , targi eksporterów oraz wystawy turystyczne odbędą się w przyszłym roku .	podjętymi	2	Perf
Rozpędzonej karuzeli stanowisk nie zatrzymała minister Piwnik , choć przez pierwsze pół roku urzędowania wstrzymywała się ona z ruchami kadrowymi .	Rozpędzonej	0	Perf
W tym roku zakres targów został rozszerzony o telekomunikację .	rozszerzony	6	Perf
Obok miasta umieszczono cmentarz żydowski z wyeksponowanym nagrobkiem do złudzenia przypominającym ohel Sonnenberga .	przypominającym	10	Imp
Gdy rozpędzał je kamień , uciekały w krzaki z pyskami wbitymi w puszki po konserwach .	wbitymi	10	Perf
– Mieliśmy listę Wildsteina , teraz wypłynęła tak zwana lista 500 , o której istnieniu poinformował prezes IPN Janusz Kurtyka .	zwana	8	Imp
" W dzieciństwie zawsze byłam kochana " .	kochana	5	Imp
Na północy i wschodzie strzelano .	strzelano	4	Imp
Pijak został zwolniony z pracy .	zwolniony	2	Perf
I wyrzucano .	wyrzucano	1	Imp
W miniony czwartek w referendum ratyfikacyjnym Irlandia odrzuciła ten Traktat , otwierający drogę do rozszerzenia Unii .	otwierający	11	Imp
W programie obchodów przewidziano spotkanie uczestników ówczesnych wydarzeń , wystawę fotograficzną i sesję naukową .	przewidziano	3	Perf
Przy bezpośrednim wprowadzaniu danych dowody księgowe są indywidualnie przekazywane do przetwarzania .	przekazywane	8	Imp
Decyzja Rady Polityki Pieniężnej o obniżeniu oprocentowania powinna teoretycznie osłabić złotówkę .	powinna	7	Imp
Strawione jedzenie krąży po organizmie , odżywiając komórki .	Strawione	0	Perf
W Czarnem umieszczono go w celi o zaostrzonym rygorze .	zaostrzonym	7	Perf
Darowizny przekazane na jej rzecz podlegają odpisowi podatkowemu .	przekazane	1	Perf
Łukasz zatrzymał przejeżdżającą taksówkę .	przejeżdżającą	2	Imp
Maciej R . został już dyscyplinarnie zwolniony .	zwolniony	6	Perf
Niestety był to wpływ negatywny , pogłębiający istotniejące już uprzedzenia .	pogłębiający	6	Imp
Usiedli obydwaj przy herbacie zaparzonej w grubych szklankach .	zaparzonej	4	Perf
W październiku zeszłego roku w Warszawie odzyskano skradzionego opla .	skradzionego	7	Perf
Akcje funduszy jak najszybciej mają być wprowadzane na giełdę .	wprowadzane	6	Imp
Długo oczekiwana wiosna przyjdzie do nas już jutro !	oczekiwana	1	Imp
Wkrótce też natknęli się na mężczyzn ściągających skórę z zabitego kozła .	zabitego	9	Perf
Mógł się zmieścić w złożonych dłoniach .	złożonych	4	Perf
Wszedł do wagonu , w przejściu natknął się na konduktora - służbistę , który zrobił mu wykład o niebezpieczeństwie związanym ze wskakiwaniem do pociągu w biegu .	związanym	19	Perf
- Żeby być przyjętym na Uniwersytet w Cambridge , trzeba mieć 45 punktów .	przyjętym	3	Perf
Ich mieszkańcy do dzisiaj pamiętają wojnę z rozwydrzoną młodzieżą , wojnę o prawo do spokojnego snu , którą w końcu wygrały dla nich oddziały gestapowskiej policji .	rozwydrzoną	7	Perf
Biała prawica w RPA zarzucała Treurnichtowi nadmierną ugodowość wobec rządzącej Partii Narodowej , a także pasywność .	rządzącej	9	Imp
Wreszcie na ludzi głodnych przybywających ze wsi czekały rozwijające się gwałtownie w XIX w . miasta .	rozwijające	8	Imp
Społeczność ludzka funkcjonuje w strukturach zapewniających formę organizacyjną .	zapewniających	5	Imp
Panowie nie mieli najmniejszych problemów z dziwnie skleconą reprezentacją Reszty Świata , panie też gładko wygrały z osłabioną ekipą USA .	osłabioną	17	Perf
Nad ranem z soboty na niedzielę z pędzącego pociągu wyskoczyła 17-letnia dziewczyna .	pędzącego	7	Imp
Tu Roman Rudziński przechowywał truciznę i szafka była zwykle zamknięta na klucz .	zamknięta	9	Perf
W sidła oszustów - pośredników oferujących pracę Polacy wpadają także w Hiszpanii .	oferujących	5	Imp
Rozmawiali odwróceni plecami .	odwróceni	1	Perf
Skrzykują te , które wzbiły się za wysoko na wschodzący księżyc .	wschodzący	9	Imp
Po jego obu bokach zwisają nawleczone na sznur perły nazywane Paternoster .	nawleczone	5	Perf
Podczas pobytu w elbląskim garnizonie najczęściej towarzyszyli mu dowódca stacjonującej tam dywizji , komendant szpitala wojskowego i kapelan .	stacjonującej	9	Imp
Oszołomiony Jerzy rusza ku wyjściu .	Oszołomiony	0	Perf
Bo krzyż zdążono już umieścić na ścianie katedry górującej nad miastem .	górującej	8	Imp
Po wizycie papieża płyty mają zostać zwrócone powiatowi kartuskiemu .	zwrócone	6	Perf
Antena powinna być skierowana na południowy wschód .	skierowana	3	Perf
Do sześciu głodujących w Poznaniu dołączyło w piątek trzech związkowców ze Śremu .	głodujących	2	Imp
- Najprostszym sposobem ukrycia miejsca do pracy jest korzystanie z wsuwanych blatów .	wsuwanych	10	Imp
Kątem oka widział matkę , wierzchem dłoni ocierającą łzy .	ocierającą	7	Imp
- To bywa męczące .	męczące	3	Imp
Mieszkający samotnie w starej drewnianej chałupie inwalida nie ukrywa , że jest rozczarowany .	rozczarowany	12	Perf
Moment bezwładności to miara bezwładności ciała w ruchu obrotowym względem określonej , ustalonej osi obrotu .	ustalonej	12	Perf
Zawód przeżyły grupy protestujących warszawiaków , które licznie przybyły na wczorajszą sesję rady miasta .	protestujących	3	Imp
Dokładne dane już są przygotowane .	przygotowane	4	Perf
Wykonanie całej inwestycji zlecono Przedsiębiorstwu Budowy Dróg i Mostów ze Świecia .	zlecono	3	Perf
Co kwartał wysokość tych kwot może się zmienić w związku ze zmianą ceny metra kwadratowego ogłaszaną przez GUS .	ogłaszaną	15	Imp
Z obu stron drogi zaczęto strzelać do nich z granatników i broni maszynowej .	zaczęto	4	Perf
Dla pozostałych autobusów jadących w kierunku Śródki , dopuszczony zostanie przejazd ul . Estkowskiego .	jadących	3	Imp
Jednocześnie polecił zająć się milicjantem prowadzącym śledztwo .	prowadzącym	5	Imp
Jednak już wkrótce Nizioł i Wapiński ze zdumieniem odkryli , że Łapiński nie dotrzymuje wcześniej danego słowa .	danego	15	Perf
I czy muszą być potwierdzone korpusowo ?	potwierdzone	4	Perf
Związane ciała poruszyły się słabo .	Związane	0	Perf
To najgorszy wstrząs sejsmiczny zarejestrowany w Kolumbii .	zarejestrowany	4	Perf
Kłopoty z tym związane trwają do dziś .	związane	3	Perf
Spora część delegatów , reprezentujących zwłaszcza środowiska młodzieżowe , zaprezentowała alternatywny wobec projektu kierownictwa program .	reprezentujących	4	Imp
Ranni żołnierze zostali przewiezieni do szpitala w Białogardzie .	przewiezieni	3	Perf
Zasklepiamy się w pozycji skrzywdzonego , dotkniętego nieszczęściem .	dotkniętego	6	Perf
- Już ze wstępnych oględzin wiadomo było , że kobieta została zamordowana .	zamordowana	11	Perf
Jak poinformował Cesar Fraga z Uniwersytetu w Buenos Aires , przeprowadzone tam badania wykazały , że czekolada wzmacnia antyutleniacze znajdujące się we krwi , zwiększając odporność na zaburzenia serca i naczyń wieńcowych .	przeprowadzone	10	Perf
W samolocie myślała m o tych dniach spędzonych z Kowerskim .	spędzonych	7	Perf
Kierująca samochodem kobieta była trzeźwa .	Kierująca	0	Imp
Jest to jeden ciągnący się taras kwietny .	ciągnący	3	Imp
Widzę na tej rycinie stojącą po lewej stronie grupkę ludzi ubranych w proste , długie szaty , którzy wskazują palcem na człowieka pogrążonego w przyjacielskiej pogawędce z diabłem .	stojącą	4	Imp
W poniedziałek ustalony został ostateczny podział funkcji w radzie nadzorczej tucholskiej Spółdzielni Mieszkaniowej .	ustalony	2	Perf
Po co w ogóle kastrować wolno żyjące koty ?	żyjące	6	Imp
Samoloty rozrzucają ulotki wzywające powstańców do kapitulacji .	wzywające	3	Imp
Dwa duże statki zostały zatopione przez powstańców .	zatopione	4	Perf
Na muzeum przeznaczono część parteru drewnianego budynku .	przeznaczono	2	Perf
Według relacji świadków , gdy biały opel frontera zbliżył się do ambasady , wyskoczył z niego człowiek ubrany w panterkę , z granatnikiem w ręku , i próbował odpalić granat w kierunku ambasady .	ubrany	17	Perf
W weekend na zachodnich przejściach granicznych trwały wzmożone kontrole .	wzmożone	7	Perf
W zarządzie przedsiębiorstwa potwierdzono tę informację .	potwierdzono	3	Perf
Doznały jedynie stłuczeń kończyn i po opatrzeniu ran w szpitalu w Broumovie zostały zwolnione .	zwolnione	13	Perf
Inaczej mogą zostać pobite .	pobite	3	Perf
Do sześciu głodujących w Poznaniu dołączyło w piątek trzech związkowców ze Śremu .	głodujących	2	Imp
W umówionym miejscu ciągle jeszcze nie widział em Lilka .	umówionym	1	Perf
Oddając zużyte elektrolity , które tam będą regenerowane , napełnimy zbiorniki nowymi roztworami .	zużyte	1	Perf
Kobieta z rozciętą głową i wstrząśnieniem mózgu trafiła do szpitala .	rozciętą	2	Perf
Dlatego zwiększone zostaną nakłady na modernizację armii .	zwiększone	1	Perf
Światełko migotało przy zamkniętym kiosku .	zamkniętym	3	Perf
Trzy maszyny zostały zestrzelone .	zestrzelone	3	Perf
Może ich zgubić choćby zapach palącego papierosy .	palącego	5	Imp
Maria Fryc została przewieziona do szpitala .	przewieziona	3	Perf
Przebieg incydentu został sfilmowany przez reportera rosyjskiej prywatnej telewizji NTV .	sfilmowany	3	Perf
Panią prezes noszono na rękach .	noszono	2	Imp
Publiczność z akademii szła na zawczasu przygotowane miejsca .	przygotowane	6	Perf
Wyrok śmierci zostaje zamieniony na 10 lat Syberii .	zamieniony	3	Perf
Zwiększa się też ilość przestępstw popełnianych i wykrywanych na granicy .	wykrywanych	7	Imp
Rząd stara się spowolnić proces demonopolizacji rynku telekomunikacyjnego pod hasłem ochrony wartości prywatyzowanego właśnie narodowego operatora .	prywatyzowanego	12	Imp
Pierwsze trwałe osady założono dopiero w drugiej połowie XIX wieku .	założono	3	Perf
Jej wnuczka , dziesięcioletnia Marta , chodziła do klasy z zamordowanym Łukaszem .	zamordowanym	10	Perf
Robotnik spadł na leżący pod drabiną gruz .	leżący	3	Imp
Potem często pokazywano ich przytulających się lub całujących .	całujących	7	Imp
Jął przeciskać się przez zaporę , czołgał się przez rumowisko , zmiażdżone wózki .	zmiażdżone	11	Perf
Rany odniosła także jeszcze jedna bawiąca wówczas w lokalu ukraińska niewiasta .	bawiąca	5	Imp
Zimna woda tryskała na głowę , szyję i płonące uszy .	płonące	8	Imp
W tajnym głosowaniu żaden z pretendentów nie uzyskał wymaganej większości .	wymaganej	8	Imp
Później samochód poświęcili biskupi uczestniczący w uroczystościach .	uczestniczący	4	Imp
Płaczącym wybacza się łatwiej i chętniej .	Płaczącym	0	Imp
I ta wierność zostaje nagrodzona .	nagrodzona	4	Perf
Serwal to rzadko spotykany w polskich ogrodach drapieżnik z rodziny kotów .	spotykany	3	Imp
Zobowiązanie to zostało już wykonane .	wykonane	4	Perf
Jadący z nadmierną szybkością wartburgiem Marek Ch . , będąc pod wpływem alkoholu , został wyrzucony na łuku jezdni na pobocze , a następnie przekoziołkował i uderzył w drzewo .	Jadący	0	Imp
Jeżeli jeszcze przed dwudziestu laty w zasadzie obowiązywała surowa formalna wykładnia przepisów kanonicznego prawa małżeńskiego , to obecnie stosuje się wykładnię rozszerzającą , a więc łagodną .	rozszerzającą	21	Imp
Spytała m o niego mężczyznę siedzącego obok .	siedzącego	5	Imp
Niedługo zobaczymy Tomasza Adamka reklamującego piwo albo męską bieliznę ?	reklamującego	4	Imp
Spośród trzystu ochotników Polluks wybrał stu najlepiej znających się na morzu .	znających	7	Imp
Nie budzi go huk przejeżdżającego pociągu ani blask słońca , kiedy odpływa kolejny obłok .	przejeżdżającego	4	Imp
Poderwali się z ziemi i skoczyli ku leżącym Niemcom .	leżącym	7	Imp
Niedługo po tym apelu Kamiński , Wołek i Jurek spotkali się na podwieczorku u krzywdzonego Pinocheta .	krzywdzonego	14	Imp
Narażenie rozgrzanego psa na przeciągi grozi poważnymi komplikacjami ze zdrowiem .	rozgrzanego	1	Perf
Ze swadą wyśmiał i wypunktował tę pookrągłostołową zgraję rządzącą Polską z nadania Kiszczaka .	rządzącą	8	Imp
Dzieci były zachwycone prezentami od Michała .	zachwycone	2	Perf
Uruchamiany system ma stać się zaczątkiem większego , obejmującego całą Wielkopolskę .	Uruchamiany	0	Imp
Zachód nadal robi groźne miny , mimo uspokajającego wystąpienia Klasy .	uspokajającego	7	Imp
Frenoplast , to inwestor produkujący okładziny hamulcowe .	produkujący	4	Imp
W ubiegłym roku w czerwcu okna w komunalnym mieszkaniu Salwockich wybijano trzy razy .	wybijano	10	Imp
Nie wystarczy już sam preparat o działaniu nawilżającym .	nawilżającym	7	Imp
Taka forma publikacji wynikała po części z objętości publikowanego materiału , ale trzeba przyznać , że kierowaliśmy się przede wszystkim wygodą użytkowania .	publikowanego	8	Imp
Rodzina i przyjaciele powitali w sobotę uwolnione przez rosyjskie służby specjalne Polki .	uwolnione	6	Perf
Preferujesz moralnośc opartą na miłosci bliźniego ?	opartą	2	Perf
Nauczycielka została zatrzymana .	zatrzymana	2	Perf
Wreszcie na ludzi głodnych przybywających ze wsi czekały rozwijające się gwałtownie w XIX w . miasta .	przybywających	4	Imp
Rośnie pokolenie ludzi straconych , wyrzuconych . . .	wyrzuconych	5	Perf
- Już ze wstępnych oględzin wiadomo było , że kobieta została zamordowana .	zamordowana	11	Perf
A potem wywieszono listę przyjętych , i mnie tam nie było .	wywieszono	2	Perf
Kot wyjeżdżający do Finlandii musi być dodatkowo odrobaczony na 30 dni przed wyjazdem .	wyjeżdżający	1	Imp
Część z nich była wypełniona cieczą .	wypełniona	4	Perf
Do skomplikowanych wzorów używamy deski przywiązanej do sznurka .	przywiązanej	5	Perf
Zostaje przewieziona do Centrum Zdrowia Matki Polki .	przewieziona	1	Perf
Cztery kowane wozy pojechały za siostrami .	kowane	1	Imp
Roszczenia , jak się zakłada , były by załatwiane w trybie administracyjnym .	załatwiane	8	Imp
Budynek ma być niebawem remontowany , dlatego lokatorzy go opuścili .	remontowany	4	Imp
Dlatego demokracja musi być podbudowana aksjologią , bo bez tego jest groźniejsza niż dobra dyktatura .	podbudowana	4	Perf
Do tragedii doszło na łuku drogi ; rozpędzony pojazd zjechał do wypełnionego wodą rowu i przycisnął dziecko .	rozpędzony	7	Perf
Obowiązują wizy , odprawa paszportowa , a przy wyjeździe celnik gruntownie przeszukuje rzeczy w poszukiwaniu skarbów , których tak wiele stąd ukradziono .	ukradziono	21	Perf
Zbierał te suche rozstajne krótkie drogi , wiązał w pokaźne drapadła o ściśniętym kierunku .	ściśniętym	12	Perf
Do zdarzenia doszło na dość oblodzonej ulicy .	oblodzonej	5	Perf
Sylwetka Golfa w porównaniu z agresywnymi liniami Focusa wygląda spokojnie , ale jego bryła może być uznana za ponadczasową .	uznana	16	Perf
Czułem jego mięśnie napięte pod skórą , twarde jak drewno .	napięte	3	Perf
Młody mężczyzna wychylił się z pędzącego pociągu i uderzył głową w słup .	pędzącego	5	Imp
Przewidziany jest udział lekarzy w dalszych pracach identyfikacyjnych .	Przewidziany	0	Perf
Spojrzała m na jej męża , ale oczy miał zasłonięte kapeluszem .	zasłonięte	9	Perf
Rzecznik Białego Domu odmówił jednak ich podania , informując tylko , że dowody zostaną przekazane inspektorom ONZ w Iraku .	przekazane	14	Perf
Do mieszkania Desselbergerów trafiają ptaki z połamanymi skrzydłami , przemarznięte , wyczerpane .	połamanymi	6	Perf
Stołki , zachęcająco odsunięte , czekały na biesiadników .	odsunięte	3	Perf
Żeby wrogów zwabić w zakreślone koło .	zakreślone	4	Perf
Serwisy , które go oferują , często zawierają wiele odnośników prowadzących do przykładowych , działających już stron .	działających	14	Imp
Nad ranem cała trójka zostaje wyciągnięta ze swych domów i trafia do aresztu .	wyciągnięta	5	Perf
Z wypłowiałego zdjęcia uśmiechała się azjatycka , młoda twarz pana Korzeniowskiego , wystrojonego w mundur zapięty pod szyją .	zapięty	15	Perf
Przez wiele ostatnich lat te działania ośmieszano i uznawano za coś , co nas nie dotyczy .	ośmieszano	6	Imp
Kiedy w Banja Luce skończył się ostatni , decydujący o medalu mecz , Halina leżała na parkiecie , a na niej kłębiła się góra ciał .	decydujący	8	Imp
Posiadał wszechstronny , uniwersalny umysł obejmujący szereg nauk specjalnych .	obejmujący	5	Imp
Gdyby udało się skompletować księgę obdarowanych , zawierałaby ona listę nazwisk tworzących znaczną część żelaznego elektoratu SLD .	tworzących	11	Imp
Rzecznik przyznała , ze ministerstwa generalnie krytykują założenia przygotowane przez ministra finansów Jarosława Bauca .	przygotowane	8	Perf
Przestraszona Zosia schowała się za wózek .	Przestraszona	0	Perf
Celników wspomagały specjalnie szkolone psy oraz sprzęt techniczny .	szkolone	3	Imp
Pootwierało wiele zamkniętych dotąd drzwi .	zamkniętych	2	Perf
Dlatego podwyższa oprocentowanie udzielanych kredytów .	udzielanych	3	Imp
Dla zdławienia partyzantów działających w górach rząd mobilizuje poważne siły zbrojne .	działających	3	Imp
Po co w ogóle kastrować wolno żyjące koty ?	żyjące	6	Imp
Powinna ona również być akredytowana , gwarantowana .	gwarantowana	6	Imp
Chciałem , żeby była zjednoczona , byłem posłem w Parlamencie Europejskim .	zjednoczona	4	Perf
Wygłodzona , śmiertelnie wystraszona kobieta godziła się na wszystko .	wystraszona	3	Perf
Słuszna jest uwaga o wyrwanej kartce z Gazety .	wyrwanej	4	Perf
W grudniu 1992 roku , po trzech miesiącach , Honecker został zwolniony przez sąd w Berlinie za względów humanitarnych .	zwolniony	11	Perf
Wykonany z asferycznych soczewek ze szkła fluorytowego , pozwala na uzyskanie bardzo dobrej jakości obrazu .	Wykonany	0	Perf
Potrząsnąłem głową ; połączenie zostało zerwane .	zerwane	5	Perf
Uszanowanie i respekt przed Bogiem są bardzo mocno zaakcentowane w doświadczeniu proroków .	zaakcentowane	8	Perf
Został zbawiony bez swej woli .	zbawiony	1	Perf
Za każdy samochód zabierali się od razu mechanicy , zmieniali koła , usuwali uszkodzenia powstałe w czasie forsownego treningu , wymieniali zdarte nakładki hamulcowe , regulowali silniki .	zdarte	21	Perf
Teraz trwają intensywne przygotowania organizacyjne , sporządzane są ekspertyzy i bilanse .	sporządzane	6	Imp
Mimo że na koncie ma już osiem wyroków , nadal okrada turystów odwiedzających Kraków .	odwiedzających	12	Imp
- A nie zapomnij wypisać mnie z czytelni , abonament zapłacony do dwudziestego .	zapłacony	10	Perf
Chodzi o przedsiębiorstwo z tradycjami , założone jeszcze przez ojca pana Piotra .	założone	6	Perf
Mażoretki , mające na koncie tytułu mistrzowskie w Polsce , pojechały na europejski championat do Bratysławy .	mające	2	Imp
Zawiedziona szlachecka fantazja przeglądała mu z niebieskich oczek .	Zawiedziona	0	Perf
Auto zostało całkowicie zniszczone , a kierowcę strażacy wydobyli za pomocą narzędzi hydraulicznych .	zniszczone	3	Perf
Ogarnięci paniką mieszkańcy porzucili swe mieszkania wybiegając na ulicę .	Ogarnięci	0	Perf
Ale zdecydowanie nie pozwalam , abyś nazywał mnie głupią albo pozbawioną rozumu .	pozbawioną	10	Perf
Każdy duży sklep samoobsługowy lub mięsny wyposażono w krajalnice do wędlin .	wyposażono	6	Perf
Sprawą zainteresował się referat I-szy i przez kontrolę korespondencji może uzyskamy dalsze miejsca zachowanych rzeczy .	zachowanych	13	Perf
Antybiotyki to związki chemiczne wytwarzane w naturze przez same drobnoustroje .	wytwarzane	4	Imp
Podwyżka zmniejszy ponoszone przez spółkę straty .	ponoszone	2	Imp
Tak przynajmniej wynika z zachowanych dokumentów i relacji .	zachowanych	4	Perf
Zaproponowane odszkodowanie pokazuje , że pan minister dotrzymał słowa .	Zaproponowane	0	Perf
– co tu jest napisane ?	napisane	4	Perf
Wyznaczeni posłowie zajęli miejsca .	Wyznaczeni	0	Perf
Miał oczy przymknięte , blada twarz była bez wyrazu , jakby zabierał się do wysłuchania banalnej spowiedzi .	przymknięte	2	Perf
Trupy wrzucono do Gopła .	wrzucono	1	Perf
Zatrzymanym przedstawiano zarzuty udziału w zorganizowanej grupie przestępczej i wprowadzenia na rynek narkotyków .	przedstawiano	1	Imp
Głosy radnych są podzielone .	podzielone	3	Perf
Powierzchnię morza pruły statki , oczekujące pojawienia się ostatniego członu rakiety .	oczekujące	5	Imp
Młodego dja , pochodzącego z Głogowa , wylansował dj Adamus .	pochodzącego	3	Imp
W roku 1912 Olga w związku z kolejną przygotowującą się pod jej nieobecność wystawą zasięgnęła rady Sainsèrea przy wyborze obrazów .	przygotowującą	8	Imp
Parówki gotowane we wrzątku i podawane wprost z rondla bierze się na talerz i usuwa błonę , w której były gotowane .	gotowane	20	Imp
Do tej pory wyroby spółdzielni nigdy nie były eksportowane poza kraje europejskie .	eksportowane	8	Imp
Zaprószono ogień i wybuchł poważny pożar na górnych piętrach .	Zaprószono	0	Perf
Akcję sprawozdawczo - wyborczą w pracowniczych ogrodach działkowych zakończy ogólnopolska konferencja delegatów wybranych na zjazdach wojewódzkich POD , która będzie obradowała w maju w Warszawie .	wybranych	12	Perf
Nie czekając na decyzję Akcji , Unia Wolności zaczęła lansować na prezesa Karola Modzelewskiego , historyka i polityka związanego z Unią Pracy .	związanego	18	Perf
Jest to duże urządzenie , ale dzięki wprowadzonym ostatnio znacznym usprawnieniom łatwe jest jego obsługiwanie .	wprowadzonym	7	Perf
Numer jego samochodu nie został odnotowany .	odnotowany	5	Perf
Jednocześnie jedynie co dziesiąty katolik uczestniczy regularnie w niedzielnej mszy , a co drugi wyjawia , że nie znajduje w Kościele odpowiedzi na nurtujące go pytania .	nurtujące	23	Imp
Wchodzimy w wiraż , coraz bardziej zbliżając się do sklepienia kanału , które naraz przybiera jaskrawoniebieski kolor z domieszką fosforyzującego fioletu .	fosforyzującego	19	Imp
A ogrzewania wyłączyć nie możemy , bo to zaszkodzi świeżo zakonserwowanym freskom w obu synagogach .	zakonserwowanym	10	Perf
Wysiedli z samochodów , zaniepokojeni , szukają .	zaniepokojeni	4	Perf
Porozumienie zostało podpisane pod koniec 1997 roku w Waszyngtonie .	podpisane	2	Perf
Saperzy wydobyli we wtorek sześć artyleryjskich pocisków burzących z czasów II wojny światowej , odkrytych na terenie budowy na krakowskim Prądniku Czerwonym .	odkrytych	14	Perf
Uważa się , że codziennie powinno się spożywać około 10 dag owoców bogatych w kwas elagowy .	powinno	5	Imp
Większość z nas czuje się reklamami znudzona .	znudzona	6	Perf
Sprawą zainteresował się referat I-szy i przez kontrolę korespondencji może uzyskamy dalsze miejsca zachowanych rzeczy .	zachowanych	13	Perf
Pamiętam w Iveronie w sześciu gablotach stłoczone największe relikwie .	stłoczone	6	Perf
Wypowiedź ta sugerowała by , że akcja była przeprowadzona z niedzieli na poniedziałek .	przeprowadzona	8	Perf
Od tego czasu gnębiony przez feudałów lud rumuński niejednokrotnie chwytał za broń .	gnębiony	3	Imp
W pewnej chwili otworzył em oczy , wyrwany z gorączkowej drzemki jakimś ruchem .	wyrwany	7	Perf
Nie czuje się pani trochę odsunięta przez Leppera ?	odsunięta	5	Perf
Załadowano się na pięć barek i o zmierzchu wyruszono .	Załadowano	0	Perf
Niemal wszystkie nici myśli kwestionującej prowadzą do Kartezjusza .	kwestionującej	4	Imp
Dziewczyny są zachwycone .	zachwycone	2	Perf
Jeżeli ciasto troszeczkę rozlatuje się w oleju , oznacza to , że zostało prawidłowo przyrządzone .	przyrządzone	14	Perf
Zza ciemniejących pni drzew wyłonił się strzelec .	ciemniejących	1	Imp
Zostały one przetransportowane helikopterami .	przetransportowane	2	Perf
Użytkownik ma do dyspozycji 6 baz zawierających informacje posortowane według wybranego kryterium .	zawierających	6	Imp
Ale taki film został nakręcony .	nakręcony	4	Perf
Przecież były zawalone dachy w Polsce , Niemczech , Rosji , były też ofiary .	zawalone	2	Perf
Ministerstwo Rolnictwa , które przed rokiem obłożyło miód importowany opłatami wyrównawczymi , opracowało długofalowy program rozwoju pszczelarstwa .	importowany	8	Imp
To jeden z najważniejszych postulatów protestujących rolników .	protestujących	5	Imp
Majątek został przejęty na zasadach leasingu .	przejęty	2	Perf
Podróżujący pierwszą klasą będą odtąd mogli wypoczywać podczas lotu na rozkładanych podwójnych siedzeniach .	rozkładanych	10	Imp
Gdy we wspomnianych dwu pionach narożnikowych ktoś się kąpie , wówczas woda spływa w dół nawilgacając po drodze niżej położone mieszkania .	położone	19	Perf
Deser zostanie podany po sprzątnięciu talerza głównego .	podany	2	Perf
Całe rodziny słoni są także przenoszone do nowych rezerwatów .	przenoszone	5	Imp
- Wierzę , że kandydaci do członkostwa w NATO powinni spełniać generalne kryteria demokratycznych rządów i gospodarki wolnorynkowej , włączając w to poszanowanie dla praw człowieka oraz cywilną kontrolę nad wojskiem .	powinni	9	Imp
Nagle stanęła przygwożdżona do ziemi .	przygwożdżona	2	Perf
Rozformowanie ma być zakończone do końca roku .	zakończone	3	Perf
Często karani kielczanie raz za razem grali w osłabieniu .	karani	1	Imp
Nastroszony w telewizorze Biernacki jest równie zabawny jak nastroszony Buzek .	nastroszony	8	Perf
Został obezwładniony przez policjantów .	obezwładniony	1	Perf
Czy produkty żywnościowe są u was w wystarczającej ilości ?	wystarczającej	7	Imp
Jest ciekawie napisana .	napisana	2	Perf
W piątek otrzymała w nagrodę kuchenkę mikrofalową , ufundowaną przez Makro .	ufundowaną	8	Perf
Używając pożyczonych magnetofonów szpulowych połączył em dźwięki suity z fragmentami poematu Wergilego .	pożyczonych	1	Perf
Upragnioną miłość zanurzył eś w najpodlejszym , cuchnącym bagnie .	cuchnącym	7	Imp
Paul Dellapina skazany na dwadzieścia lat ucieka po raz ósmy z więzienia .	skazany	2	Perf
Tymczasem komandor zatrzaśnięty w samochodzie wydzwaniał z telefonu komórkowego do znajomych .	zatrzaśnięty	2	Perf
Nie zdołałeś do dna wyrwać tej maleńkiej drobiny , zachowanej w czeluści mego serca .	zachowanej	9	Perf
Kilka dwupiętrowych bloków , dookoła suszy się porozwieszana na drzewach i krzakach bielizna .	porozwieszana	7	Perf
Kot wyjeżdżający do Finlandii musi być dodatkowo odrobaczony na 30 dni przed wyjazdem .	odrobaczony	7	Perf
Spłata pozostałych 80 proc . zostałaby odroczona do 30 czerwca 2005 roku .	odroczona	6	Perf
Kuczma oświadczył , że gospodarka będzie reformowana na zasadach rynkowych .	reformowana	6	Imp
Starem z przyczepą załadowaną piaskiem kierował kursant .	załadowaną	3	Perf
Ale myśli nabyte od ikon pozostały .	nabyte	2	Perf
Wtedy stosowano materiały niskiej jakości .	stosowano	1	Imp
Ambona była wyjałowiona .	wyjałowiona	2	Perf
Zatrzymał się , zaskoczony .	zaskoczony	3	Perf
Woda dostała się do tonącego samochodu .	tonącego	4	Imp
Ta masa wodna , nieraz podnosząca poziom Wiku o jeden metr ponad równię Puckiej Zatoki , spotyka się przy dziobie gołębia z silnym prądem zachodnim .	podnosząca	5	Imp
Wysoka liczba urodzeń hamuje także rozwój gospodarczy kraju , w którym znaczny procent mieszkańców żyje poniżej uznanego progu ubóstwa .	uznanego	16	Perf
Poza pierwszą nagrodą przyznaną przez jury , Marta Klimasara otrzymała także nagrodę publiczności .	przyznaną	3	Perf
Jedenaście dni po pojawieniu się opisanej wizji sennej czar zaczął działać .	opisanej	5	Perf
Wygłodzona , śmiertelnie wystraszona kobieta godziła się na wszystko .	Wygłodzona	0	Perf
Od stycznia na ich drodze pojawiły się niespotykane dotąd rafy .	niespotykane	7	Imp
Pełniący obecnie obowiązki szefa rosyjskiego państwa Putin był jeszcze niedawno szefem służb specjalnych .	Pełniący	0	Imp
Jedynie opisywane przez panią żółwie na Seszelach się p . . .	opisywane	1	Imp
Lubuscy policjanci rozbili grupę zajmującą się włamaniami do kościołów i kradzieżami figur oraz przedmiotów kultu religijnego .	zajmującą	4	Imp
Z połamanymi kończynami i uszkodzonym kręgosłupem przestępca trafił do szpitala .	uszkodzonym	4	Perf
Ale trzeba na niego zapracować , zwłaszcza przed stresującym dniem .	stresującym	8	Imp
Bo nie przemija miłość do słów wypowiadających prawdę stałą , wieczną .	wypowiadających	6	Imp
Dziś stąd wyruszamy , może jeszcze zdążę ucałować jego stygnącą rękę .	stygnącą	9	Imp
Nie jest on spotykany zbyt często .	spotykany	3	Imp
Istnieje kilka ośrodków przygotowujących lekarzy .	przygotowujących	3	Imp
Ustalono to na podstawie mutacji zachodzących w wirusie .	Ustalono	0	Perf
Wyobrażał sobie minę Każe-duba czytającego jego raport .	czytającego	4	Imp
Kobietom odpowiadał uwodzicielsko nastrojony głos ukrytego w jakiejś dziupli wodzireja .	nastrojony	3	Perf
Na razie nikomu nie przedstawiono zarzutów .	przedstawiono	4	Perf
Nawet dla słabo zorganizowanych grup , przewalanie towaru będzie kaszką z mlekiem .	zorganizowanych	3	Perf
- Czytałem , choć czułem się coraz mocniej poniżony .	poniżony	8	Perf
Jest to przekład interpretujący .	interpretujący	3	Imp
Po latach dowie się , że zostali rozstrzelani jeszcze przed jego aresztowaniem .	rozstrzelani	7	Perf
Wyobraź sobie człowieka znajdującego się na ogromnej górze .	znajdującego	3	Imp
Wśród oceniających zasiadły trzy blondynki .	oceniających	1	Imp
Nie muszę używać trybu przypuszczającego .	przypuszczającego	4	Imp
W Gnieźnie w sylwestrowy wieczór zginęli podczas pożaru trzej chłopcy , a jadący do akcji samochód strażacki wpadł na dwie kobiety .	jadący	12	Imp
Za 30.000 złotych wyremontowana została ulica prowadząca do ośrodka zdrowia w Lubiewie .	wyremontowana	3	Perf
Stare gmachy , dostojne i omszałe , coraz bardziej upodobniają się do mamutów , wchłanianych w błoto epoki polodowcowej .	wchłanianych	14	Imp
- Lista posłów zapisanych do głosu została wyczerpana .	wyczerpana	7	Perf
- Była naprawdę zła , a rozzłoszczeni ludzie zwykle używają ojczystego języka .	rozzłoszczeni	6	Perf
Świeżo upieczony hejnalista ma już swoją trąbkę .	upieczony	1	Perf
Również uwłaszczenia dotyczyła jedyna zaakceptowana poprawka .	zaakceptowana	4	Perf
W Senacie zgłosił swoje przystąpienie do komunistów senator Boguszewski , wybrany z listy BBWR , już przedtem miał kontakty .	wybrany	10	Perf
Dom jest własnością pewnej rodziny mieszkającej na stałe w Ameryce .	mieszkającej	5	Imp
Obrazy cyfrowe składają się z połączonych ze sobą pikseli o różnych barwach lub tonach .	połączonych	5	Perf
Był by znakomitym pedagogiem uwielbianym przez studentów .	uwielbianym	4	Imp
Monarchia Habsburgów została rozczłonkowana .	rozczłonkowana	3	Perf
Dziś zgromadzili śmy się tu , zwabieni staropolską gościnnością twoją , ażeby uczcić dzień twego imienia .	zwabieni	6	Perf
Czy La Famille Richet istotnie została zaprezentowana w Edynburgu ?	zaprezentowana	6	Perf
Oddając zużyte elektrolity , które tam będą regenerowane , napełnimy zbiorniki nowymi roztworami .	regenerowane	7	Imp
- Zamykaj buzię , bo ci świecący ptak do niej wleci .	świecący	6	Imp
Stojący w drzwiach hotelu Wyroba natychmiast ruszył w jego kierunku .	Stojący	0	Imp
Ono w 65 proc . jest uwarunkowane genetycznie .	uwarunkowane	6	Perf
Cały kurs nadany będzie w Łodzi .	nadany	2	Perf
Wyjaśnia on w przystępny sposób tajniki stosowanych w programie konwencji .	stosowanych	6	Imp
Chłopiec posłusznie ukląkł i mełł pacierz obok żarliwie modlącej się i popłakującej matki .	popłakującej	11	Imp
Ptaki te chętnie korzystają z pokarmu wykładanego dla parkowych łabędzi .	wykładanego	6	Imp
Oryginalne lampy zdobyto z zasobów niemieckich przeznaczonych dla Wehrmachtu .	przeznaczonych	6	Perf
Siedział już w oknie , z nogami wystawionymi na zewnątrz , ale w porę obezwładnili go i ściągnęli z okna strażnicy miejscy .	wystawionymi	7	Perf
Trzy strzały trafiły przebywających w wartowni żołnierzy .	przebywających	3	Imp
Nie wprowadzono prywatnej własności ziemi , nie zniszczono feudalnego imperium dyrektorów kołchozów .	zniszczono	7	Perf
Zdaniem lekarzy , szpitale cierpiące na brak pieniędzy podejmują drastyczne programy oszczędnościowe .	cierpiące	4	Imp
Potem zostaną ulokowani w hotelach i ośrodkach wypoczynkowych .	ulokowani	2	Perf
Planiści wypracowali już koncepcję drogi , na której przeobrażenie to winno się odbyć kosztem możliwie minimalnych ofiar .	winno	10	Imp
Pomogli mu , podnieśli też z trudem kolumnę zaklinowaną w kącie i osadzili na trzonie .	zaklinowaną	8	Perf
Do podlewania sadzonek wyśmienicie nadają się filtrowane ścieki .	filtrowane	6	Imp
Widoczny na niebie rozbłysk to kolumna zjonizowanego powietrza .	zjonizowanego	6	Perf
- Napiłbym się grzanego piwa .	grzanego	3	Imp
- Ten rozciągnięty szyk drogo nas kosztował .	rozciągnięty	2	Perf
Wyjaśnił w niej , że został wychowany w bardzo purytańskim domu , w którym wpojono mu szacunek dla takich cnót jak skromność i oszczędność .	wychowany	6	Perf
Tam nawiązuje kontakt z grupą partyzancką o zabarwieniu skrajnym , likwidującą komunistów i uciekinierów z gett .	likwidującą	10	Imp
Tym razem głód został pokonany .	pokonany	4	Perf
W wielkim domu znajdziesz dwie malowane brody .	malowane	5	Imp
Jeden hotel musiał być oddany po wygaśnięciu dzierżawy , drugi sprzedano , aby pokryć dług w Funduszu Społecznym Żołnierza .	oddany	4	Perf
Ilość plam pulsujących w jego oczach mnożyła się w zastraszającym tempie .	pulsujących	2	Imp
- Lista posłów zapisanych do głosu została wyczerpana .	zapisanych	3	Perf
- Ludzie starsi gubią się w technicznych problemach z tym związanych , a takie ciągłe zabawy ze zmianą pasma nadawania to brak szacunku dla abonentów .	związanych	10	Perf
Kazancewa po raz ostatni widziano , gdy podróżował śmigłowcem w rejonie walk .	widziano	4	Imp
W stan posiadania ZPR wpisano też kasyna oraz automaty do gry .	wpisano	4	Perf
Historia przedstawiona w tej książce zawiera mniej znane fragmenty dziejów zjawiska , które tak straszliwie poraziło ludzkość .	przedstawiona	1	Perf
W tej sytuacji prokuratura wysłała do magistratu pismo ponaglające .	ponaglające	8	Imp
Dom jest nieocieplony .	nieocieplony	2	Perf
Związany z kapistami , wielokrotnie jednak przekraczał wyznaczone przez nich malarskie granice .	Związany	0	Perf
W przypadku kręgowców naszej strefy klimatycznej były by to zależności zbyt uproszczone .	uproszczone	11	Perf
Po upieczeniu można zdjąć ze strąków oddzielającą się skórkę .	oddzielającą	6	Imp
- Czytał em , choć czuł em się coraz mocniej poniżony .	poniżony	10	Perf
Pies musi być podwórzowy , zły , w budzie na łańcuchu siedzący .	siedzący	11	Imp
Przed światłami kierujący ruchem zatrzymał tira , a za nim stanęła skoda .	kierujący	2	Imp
Z tak zlokalizowanym wrogiem łatwiej walczyć . . .	zlokalizowanym	2	Perf
Generał za swoje publikowane w prasie artykuły nie przyjmuje honorariów .	publikowane	3	Imp
Wyobraź sobie człowieka znajdującego się na ogromnej górze .	znajdującego	3	Imp
Coraz częściej ludzi trapi poczucie małej wartości , obawa , że nie uda się im zrobić odpowiedniego wrażenia na rzadko widywanych bliskich .	widywanych	20	Imp
Prawo precedensowe jest ustalane przez sędziego .	ustalane	3	Imp
Istotne jest , aby cele edukacji ekologicznej zostały przełożone na język konkretów mających zastosowanie w codziennych działaniach ucznia .	przełożone	8	Perf
Na ekranie TV , na zatrzymanej stop-klatce Jurka Kilera idą napisy końcowe programu .	zatrzymanej	5	Perf
Wszystko to razem drzemało oderwane od czasu i przestrzeni , bez radia i gazet .	oderwane	4	Perf
Dziecko ma przerąbane .	przerąbane	2	Perf
Cały czas sprawdzana jest ich skuteczność .	sprawdzana	2	Imp
Gabor został przydzielony do grupy sturmbannführera Zeliga .	przydzielony	2	Perf
Rozdzielali zwaśnione strony w ramach misji pokojowych ONZ .	zwaśnione	1	Perf
Podtopiony dom , to była łódź z ludźmi zakotwiczona na środku Sanu .	zakotwiczona	8	Perf
Od strony wjazdu zbliżał się ubłocony fiat Kosińskiego .	ubłocony	5	Perf
Zarzuca mu pranie brudnych pieniędzy , płatną protekcję i udział w zorganizowanej grupie przestępczej .	zorganizowanej	11	Perf
Jak widzę procesy zachodzące w sztuce ostatniego stulecia ?	zachodzące	3	Imp
Przy końcu alei stał świeżo wkopany słup , pomalowany na jasnoniebieski kolor .	pomalowany	8	Perf
Ukryty za maćkowymi plecami Łagiewka przytaknął .	Ukryty	0	Perf
Wrzucony do grobu , nie mógł stanąć nad grobem .	Wrzucony	0	Perf
Drwale ściągali już z roboty do swoich rzeczy leżących przy drodze .	leżących	8	Imp
- Kiedy zostanie odtajnione uzasadnienie do wyroku sądu w sprawie pana pułkownika Kuklińskiego ?	odtajnione	3	Perf
Wszystko było przysypane żółtoszarym pyłem .	przysypane	2	Perf
Pierwszym zapisanym mówcą jest senator Zbigniew Kulak .	zapisanym	1	Perf
Dziecko krzywdzone potrzebuje wszechstronnej pomocy .	krzywdzone	1	Imp
Teraz na zamówienie mafii gangi złożone z zamieszkałych w Niemczech Polaków kradną samochody wybranej marki .	wybranej	13	Perf
jest na niej 250 szopek nigdy dotąd poza Betlejem niepokazywanych .	niepokazywanych	9	Imp
Pewną aktywność przejawiają tylko mieszkańcy domów sąsiadujących ze świątynią .	sąsiadujących	6	Imp
Taki czek nie może być bezpośrednio zamieniony na gotówkę .	zamieniony	6	Perf
Tam czekały już na nich armatki wodne , podstawione przez władze .	podstawione	8	Perf
Załogi z niepokojem śledzą ciche chmury nadchodzące z południa .	nadchodzące	6	Imp
Byli chłopi zwiezieni autobusami .	zwiezieni	2	Perf
Znaleziono ich w opuszczonym domu z dowodami winy .	Znaleziono	0	Perf
Dlaczego chrześcijanie mają być popierani przez państwo ?	popierani	4	Imp
Fałszywego księdza przewieziono do więzienia w Rawiczu .	przewieziono	2	Perf
Od czasu do czasu słychać było głosy pierwszych ptaków , brzmiące świeżo i przenikliwie .	brzmiące	10	Imp
Zwierzętarnia , wciśnięta między gmach zakładu doświadczalnego a kotłownię , stanowiła całe odrębne królestwo .	wciśnięta	2	Perf
Uwielbia tańczyć , kołysana na rękach .	kołysana	3	Imp
W kraju działa kilka grup partyzanckich utworzonych przez patriotów Dominikany .	utworzonych	6	Perf
Przebiegające pod miastem chodniki kopalni zalano wodą , a wzgórze zgniło i zapadło się w ziemię jak przydeptane .	Przebiegające	0	Imp
Szpital w Ostródzie został sprywatyzowany 7 lat temu .	sprywatyzowany	4	Perf
W jego siedzibie znajdowało się centrum festiwalowe , tam grane były najważniejsze spektakle .	grane	9	Imp
Nadmieniamy , że w pierwszą niedzielę lutego br . przeprowadzono zbiórkę pieniędzy na zakup niezbędnego urządzenia medycznego do pracowni analitycznej w Wiejskim Ośrodku Zdrowia w Brzeziu .	przeprowadzono	9	Perf
Z całego nakładu książki Witkacego wycięto stronę przedtytułową .	wycięto	5	Perf
Jest ciekawa i starannie opracowana .	opracowana	4	Perf
Ojciec ofiary uważa , że w sprawę zamieszani są policjanci i dlatego śledztwo prowadzone było tak niemrawo .	prowadzone	13	Imp
- Nie ma ludzi zdrowych , są tylko źle zdiagnozowani .	zdiagnozowani	9	Perf
Zapory takie zazwyczaj mogą być zaminowane .	zaminowane	5	Perf
Trzeba wreszcie usprawnić system zabezpieczeń społecznych , aby skutecznie dotrzeć do osób i rodzin naprawdę potrzebujących pomocy .	potrzebujących	15	Imp
Żółty krawat tylko mu fruwa na wietrze , kurtka rozpięta .	rozpięta	9	Perf
W krajach zazwyczaj triumfujących filmy o ciężkich chwilach są przypomnieniem czegoś , co zagrażało .	triumfujących	3	Imp
Stan czterech z 15 uratowanych pasażerów jest krytyczny .	uratowanych	4	Perf
Pomysł wynalazcy został opatentowany .	opatentowany	3	Perf
Został em zmobilizowany do przemysłu .	zmobilizowany	2	Perf
Mimo ciepłego dnia pani domu przyjęła ją otulona w brązowy blezer , spod ciemnej spódnicy wystawały chude łydki .	otulona	7	Perf
Dla mnie kwestia aborcji powinna być oddzielona i rozpatrywana oddzielnie od spraw religijnych .	powinna	4	Imp
W państwach europejskich , takich jak Szwecja , które mają dużo imigrantów z tego regionu , zwyczaj zwalczany jest z całą surowością prawa .	zwalczany	17	Imp
Już nie nosi starych butów z pourywanymi sznurówkami .	pourywanymi	6	Perf
Była tam nagrana jakaś muzyka .	nagrana	2	Perf
Jego wiarygodność sprawdzono poprzez Krajową Izbę Gospodarczą .	sprawdzono	2	Perf
– Pokazał ręką przeszklone okna penthausu .	przeszklone	3	Perf
Zwolnienia zostaną rozłożone na cały 2001 r .	rozłożone	2	Perf
Renowacja postumentu , na którym ponownie umieszczone zostanie popiersie , kosztować będzie 12 tys . złotych .	umieszczone	6	Perf
Natrafiły na ń dzieci zbierające zioła dla starej Felakowej .	zbierające	4	Imp
Na zorganizowany z tej okazji piknik przybyło kilka tysięcy opolan .	zorganizowany	1	Perf
Popatrzyli śmy z Ludwikiem na siebie , zaskoczeni , bez słowa .	zaskoczeni	7	Perf
Ośrodki badania opinii publicznej publikują właśnie swe najświeższe sondaże , które potwierdzają utrzymujące się od wielu miesięcy trendy .	utrzymujące	12	Imp
Przewidziana jest także dyskusja .	Przewidziana	0	Perf
Był sparaliżowany , stracił mowę i pamięć .	sparaliżowany	1	Perf
Natomiast zdjęcia eksponowane w MDK ukazują nowe spojrzenie na fotografię , którego dominantą jest wykonywanie makrofotograficznych ujęć z bardzo bliskiej odległości przy małej głębi ostrości .	eksponowane	2	Imp
Niestety , wykonane opodal obwałowania niewiele dały .	wykonane	2	Perf
Przez pierwszy tydzień leżą ukryte w wysokiej trawie , a następnie zaczynają wędrować za matką .	ukryte	4	Perf
Rozbity samochód trafił na policyjny parking .	Rozbity	0	Perf
Na inwestycję przyznano 28 milionów marek kredytu , który przyznano na 15 lat z pięcioletnią karencją spłaty odsetek .	przyznano	9	Perf
Leżała na wersalce z nosem wtulonym we włochatą poduszeczkę .	wtulonym	5	Perf
Czykier został ukarany za niesportowy tryb życia , zaś Gierejkiewicz stracił zaufanie szkoleniowca .	ukarany	2	Perf
Doświadczenia laboratoryjne wykazały , że gąsienice motyli monarchów , karmione transgeniczną żywnością , miały kłopoty ze zdrowiem .	karmione	9	Imp
Nie znam przecież obyczajów panujących w jej kraju , nie interesowały mnie .	panujących	4	Imp
Bar , rozległą antresolę , poręcze i schody zrobiono z wypolerowanej stali .	wypolerowanej	10	Perf
Auta są kradzione dla okupu .	kradzione	2	Imp
Poszedł żuraw obrażony .	obrażony	2	Perf
- Będzie dalej atakowany , bo dzieciaki mu nie popuszczą .	atakowany	3	Imp
my byli śmy pod to podpinani . .	podpinani	5	Imp
Komputerowy montaż grafiki nie jest domeną zastrzeżoną wyłącznie dla profesjonalistów .	zastrzeżoną	6	Perf
Ma wobec niej myśli uwolnione z więzów .	uwolnione	4	Perf
Po oblodzonych schodach wspinamy się na pokład szalupowy .	oblodzonych	1	Perf
klatka była niedokończona .	niedokończona	2	Perf
- Czy ktoś z pań posłanek i panów posłów pragnie zabrać głos w sprawie przedstawionych propozycji ?	przedstawionych	14	Perf
Obu szwedzkim dyplomatom zarzucono też działalność wykraczającą poza ich oficjalny status .	wykraczającą	6	Imp
Wszelkie informacje podane poniżej dotyczą jedynie wypadków sprawdzonych .	podane	2	Perf
- Nie zdarza się , aby przedmiotu wykładanego w gimnazjum nie było w jego oddziale zamiejscowym .	wykładanego	7	Imp
Są to placówki przeważnie prowadzące działalność pensjonatowo - hotelową .	prowadzące	4	Imp
Trzymiesięczne owczarki niemieckie pochodzą z wyspecjalizowanej hodowli ze Słowacji .	wyspecjalizowanej	5	Perf
Był ostro atakowany przez endecję .	atakowany	2	Imp
Zostaliśmy postawieni pod murem , nie mamy innego wyjścia .	postawieni	1	Perf
Przy ulicy Kawęczyńskiej w Warszawie , w Wyższej Szkole Menedżerskiej , trwają prace remontowe w budynku zaadaptowanym na nowy dziekanat i rektorat .	zaadaptowanym	16	Perf
Często karani kielczanie raz za razem grali w osłabieniu .	karani	1	Imp
Późna wiosna była dla księdza proboszcza najbardziej znienawidzoną porą roku .	znienawidzoną	7	Perf
Czy ta wasza przyjaźń została nazwana , wyznana ?	nazwana	5	Perf
Dante raczył zajmować się przede wszystkim potępionymi .	potępionymi	6	Perf
Kuśtykając ruszyli wolno pod górę , w stronę prześwitującego między drzewami kościoła .	prześwitującego	8	Imp
Podczas nabożeństwa poświęcony został świeżo ufundowany sztandar szkoły .	ufundowany	5	Perf
Ten ogromny magazyn przez całe wieki pozostawał niewykorzystany .	niewykorzystany	7	Perf
Maturzyści - internauci zdający na pisemnym egzaminie język polski i historię najczęściej typują tematy związane z przełomem wieków .	związane	14	Perf
Przekonywał , że Wielkopolska jest przygotowana do skorzystania z unijnej oferty .	przygotowana	5	Perf
Dzieci są okaleczone na całe życie .	okaleczone	2	Perf
Powinno być odwrotnie .	Powinno	0	Imp
W próbie tej potrzebujemy pocieszającej pomocy .	pocieszającej	4	Imp
Surowy , suchy klimat , huraganowe wiatry oraz nieurodzajność gleb spowodowały , że odkryta w 1520 roku przez Magellana Patagonia długo nie była kolonizowana przez Europejczyków .	odkryta	13	Perf
Prowadzone obecnie postępowanie rozstrzygnie , kto zawinił .	Prowadzone	0	Imp
Tutaj mamy jakąś pomieszaną wersję .	pomieszaną	3	Perf
Ze stara wyciekał olej i płyn chłodzący , a przyczepa miała zdemontowany hamulec awaryjny .	chłodzący	6	Imp
- Poza tym Jan Paweł II nie został jeszcze ogłoszony świętym .	ogłoszony	9	Perf
Czekolada , spożywana w umiarkowanych ilościach , może chronić nas przed chorobami serca .	spożywana	2	Imp
" W dzieciństwie byłem często rozpieszczany przez mamę , ale tato mnie lał " .	rozpieszczany	5	Imp
Była zniszczona również przez żołnierzy napoleońskich .	zniszczona	1	Perf
Odnotowano ponadto kilkanaście zachorowań .	Odnotowano	0	Perf
" W dzieciństwie byłam często wyzywana i bita " .	bita	7	Imp
WDT jest państwową jednostką organizacyjną nieposiadającą osobowości prawnej .	nieposiadającą	5	Imp
Zapytany przez nas radiotelegrafista zdradził treść oddanej depeszy .	Zapytany	0	Perf
Stwierdzono , że stosunkowo wysokie zarobki mają pielęgniarki bloku operacyjnego .	Stwierdzono	0	Perf
Było tak zmasakrowane , że myśliwi z trudem ustalili jego płeć .	zmasakrowane	2	Perf
Chciałem podziękować za inicjatywę , z której zrodziło się pytanie , umożliwiającą mi pokazanie prawdy .	umożliwiającą	11	Imp
Rebelianci z tak zwanej Wyzwoleńczej Armii Kosowa zajęli Belacewacz tydzień temu .	zwanej	3	Imp
Są legalnie działające firmy zajmujące się przeróbkami .	zajmujące	4	Imp
Z wykrzywioną z wysiłku twarzą leżał na plecach na ławce do wyciskania .	wykrzywioną	1	Perf
To właśnie nasza Polska , nowa Rzeczpospolita , Coraz bardziej podzielona , coraz bardziej rozbita .	podzielona	10	Perf
I wszystkim obalonym zwyczajom wrócono ich dobre imię .	obalonym	2	Perf
Dyna nie wydawał się obrażony .	obrażony	4	Perf
Wyznaczeni posłowie zajęli miejsca .	Wyznaczeni	0	Perf
Poinformował w nim , że około godz . 19 . 30 w poniedziałek wartownik wojskowy zauważył zerwane plomby i kłódki do garnizonowego składu amunicji .	zerwane	16	Perf
Komory zadziałały , ale organizm był już zbyt wycieńczony .	wycieńczony	8	Perf
Biedny ptak , z szeroko otwartym dziobem , zwisał głową w dół , niby ułamana z krzewu kiść .	otwartym	5	Perf
Podstawą każdego programu tłumaczącego jest słownik .	tłumaczącego	3	Imp
Przewidywał to i myślał , że jest gotowy , ale skwierczący żar w piersi uświadomił mu , że nigdy nie byłby na to gotowy .	skwierczący	10	Imp
Odwołany rząd , który zostaje przez Sejm zmuszony do rządzenia , zwykle przestaje pracować .	zmuszony	7	Perf
Po dwóch tygodniach na jej rozkładające się zwłoki natrafił w lesie rowerzysta .	rozkładające	5	Imp
Jeszcze w marcu spali w jednej sypialni na złączonych łóżkach .	złączonych	8	Perf
Jesteś ugotowany .	ugotowany	1	Perf
To pewnie porwana Angielka , cieszyły się polskie media .	porwana	2	Perf
Czy monde jest jeszcze urażony ?	urażony	4	Perf
Także on został uznany za winnego .	uznany	3	Perf
Zabezpieczone zostały też ścięte już rośliny , przygotowane do dalszej obróbki .	przygotowane	7	Perf
Czy nowa białoruska elita intelektualna jest już ukształtowana ?	ukształtowana	7	Perf
- Nabywca był podstawiony przez nas .	podstawiony	3	Perf
Podstawowe nazewnictwo łacińskie zostało przetłumaczone na język polski .	przetłumaczone	4	Perf
Z napotkanych przeze mnie stanowisk handlowych wyróżniam dwa .	napotkanych	1	Perf
Istotne jest , aby cele edukacji ekologicznej zostały przełożone na język konkretów mających zastosowanie w codziennych działaniach ucznia .	mających	12	Imp
Czy zdajesz sobie sprawę z tego , że nie jesteś ochrzczony ?	ochrzczony	10	Perf
Zabezpieczone zostały też ścięte już rośliny , przygotowane do dalszej obróbki .	ścięte	3	Perf
Zasnął z głową opartą o skraj łóżka .	opartą	3	Perf
Ogonowski i Latusek tłumaczyli , że właśnie znaleźli zastrzelone zwierzę .	zastrzelone	8	Perf
Dzięki temu przekonano się , że galaktyki aktywne nie tworzą jednolitej grupy , ale mają dość zróżnicowane własności .	przekonano	2	Perf
Rozpoczyna się teraz emocjonujący wyścig ze zbliżającą się burzą .	zbliżającą	6	Imp
Szedłem niskim i wąskim korytarzykiem , oświetlając sobie drogę uniesioną ku górze latarką .	uniesioną	9	Perf
Każde nowo przyniesione kartonowe pudło natychmiast któryś zajmuje .	przyniesione	2	Perf
Akcja zostanie wznowiona we wtorek rano .	wznowiona	2	Perf
Widelczyk leżący nad talerzami jest widelczykiem deserowym .	leżący	1	Imp
Prokuratura Apelacyjna współpracuje w tej sprawie z oddziałami CBŚ we wspomnianych miastach i Urzędami Kontroli Skarbowej .	wspomnianych	10	Perf
Rośnie aktywność polityczna i sprzeciw wobec istniejącego porządku , a jednocześnie nasila się presja , by tę aktywność uciszyć .	istniejącego	6	Imp
Sprawa została jednak skierowana do niemieckiego Urzędu Prasy i Informacji przy urzędzie kanclerza Niemiec .	skierowana	3	Perf
Pierwszy cios , który później okazał się śmiertelny , został zadany metalowym krzesłem w tył głowy .	zadany	10	Perf
Ale tego rodzaju zabiegi mogą być wykonywane tylko przez specjalnie przeszkolone ekipy zwalczania szkodników .	przeszkolone	10	Perf
Gwyneth przyznaje , że przez tych ostatnich kilka lat dojrzewała na zdwojonych obrotach .	zdwojonych	11	Perf
Rozbity samochód trafił na policyjny parking .	Rozbity	0	Perf
Napisy okrążały schematyczny wizerunek wypieczonego chleba .	wypieczonego	4	Perf
Maszynista nie miał szans na zatrzymanie rozpędzonego elektrowozu .	rozpędzonego	6	Perf
Wszystkie zamieszczone na stronie internetowej numery telefoniczne były nieaktualne .	zamieszczone	1	Perf
Stań prosto , ze stopami rozstawionymi na szerokość ramion , wyprostuj plecy i wciągnij brzuch .	rozstawionymi	5	Perf
Potem zostaną ulokowani w hotelach i ośrodkach wypoczynkowych .	ulokowani	2	Perf
Dziewczyny mówią , że piszczała , płakała , śmiała się , przykucnęła , usiłując uspokoić drżące od wysiłku mięśnie i wtedy rzuciły się na nią . . .	drżące	15	Imp
Z pism Slazskiej Energetiki wynika , że opalana węglem nowa elektrociepłownia w Trzyńcu będzie spełniała wszystkie europejskie normy ekologiczne .	opalana	7	Imp
Jest to oczywistość , ale ta oczywistość konkretnie umiejscowiona , dla mnie przynajmniej , była jednak czymś wartym zastanowienia .	umiejscowiona	8	Perf
Teraz straszą budynki ogołocone z szyb i armatury .	ogołocone	3	Perf
Nie były nigdy wydawane , przechowywali śmy je w archiwum rodzinnym .	wydawane	3	Imp
Jestem proboszczem liczącej 1180 osób parafii , która posiada zabytkowy kościół wpisany do rejestru zabytków .	liczącej	2	Imp
Aktualnie nieczynny teleporter zostanie adaptowany na kolejny sklep spożywczy .	adaptowany	4	Perf
W jej twarzy , mokrej od łez rozmazanych i czerwonej , tężały w osłupieniu szkliste , bladoniebieskie oczy .	rozmazanych	7	Perf
W niedzielę po południu turysta schodzący z Zawratu usłyszał głosy we mgle .	schodzący	5	Imp
Prawem opozycji nazwał szef Agencji Bezpieczeństwa Wewnętrznego Andrzej Barcikowski zapowiedź ewentualnego wniosku o odwołanie go z pełnionej funkcji .	pełnionej	16	Imp
Mam najnowsze zestawy osób nagrodzonych .	nagrodzonych	4	Perf
Czuł em , że patrzy , choć miał em zamknięte oczy .	zamknięte	9	Perf
Le Pen straszy zjednoczoną Europą .	zjednoczoną	3	Perf
Ekspozycja zawiera kilkaset zdjęć przedstawiających życie codzienne ludzi w NRD .	przedstawiających	4	Imp
Dzięki temu przekonano się , że galaktyki aktywne nie tworzą jednolitej grupy , ale mają dość zróżnicowane własności .	zróżnicowane	16	Perf
Mucha spaceruje też po ścianie , dostrzegam ją spod przymrużonych powiek .	przymrużonych	9	Perf
Potem często pokazywano ich przytulających się lub całujących .	pokazywano	2	Imp
- Dlatego nie mogł em rozmawiać z interesującymi mnie bokserami .	interesującymi	7	Imp
Ponieważ nie posiadała pozwolenia na jej przewóz , muszlę zatrzymano w depozycie .	zatrzymano	9	Perf
Znaleziono przy nich skradzione zegarki oraz pistolet - straszak .	skradzione	3	Perf
Darowizny przekazane na jej rzecz podlegają odpisowi podatkowemu .	przekazane	1	Perf
Tutaj jedynie pokrótce opiszemy ten standard i nieco uzupełnimy zaprezentowane w wymienionych artykułach informacje .	zaprezentowane	9	Perf
Zanim został złapany przez pracowników ogrodu zoologicznego , odwiedził co najmniej dwa domy .	złapany	2	Perf
Liczyli zdobyte łupy , oglądali własne i nieprzyjacielskie straty .	zdobyte	1	Perf
Pani Adamowa Ostrzeńska leżała przykryta już nie kołdrą , lecz prześcieradłem po szyję .	przykryta	4	Perf
Cztery kowane wozy pojechały za siostrami .	kowane	1	Imp
Zwolennicy Mossadegha , ministrowie , podejrzani oficerowie , działacze Tudeh są przesłuchiwani i torturowani .	przesłuchiwani	11	Imp
Dziś zostanie rozegrana ostatnia kolejka ekstraklasy .	rozegrana	2	Perf
- Nie jestem typowym jazzmanem , choć tak bywam oceniany .	oceniany	9	Imp
Powołano sejmową komisję śledczą do wyjaśnienia tej sprawy .	Powołano	0	Perf
Kobietom odpowiadał uwodzicielsko nastrojony głos ukrytego w jakiejś dziupli wodzireja .	ukrytego	5	Perf
Niemal wszystkie nici myśli kwestionującej prowadzą do Kartezjusza .	kwestionującej	4	Imp
Z połamanymi kończynami i uszkodzonym kręgosłupem przestępca trafił do szpitala .	połamanymi	1	Perf
Komputery podłączone do Sieci mogą skorzystać z okna zadań badawczych .	podłączone	1	Perf
Ale armia niemiecka nie została stworzona przez Hitlera .	stworzona	5	Perf
Reformy ograniczono do totalnej prywatyzacji , która przyjęła raczej ramy wyprzedaży majątku narodowego .	ograniczono	1	Perf
Są legalnie działające firmy zajmujące się przeróbkami .	działające	2	Imp
Parówki gotowane we wrzątku i podawane wprost z rondla bierze się na talerz i usuwa błonę , w której były gotowane .	gotowane	1	Imp
W kraju nad Wisłą dominującym gatunkiem jest Polakatolik .	dominującym	4	Imp
Dziś już wiadomo , że powszechnie akceptowany na świecie jest model bazujący na podejściu bilansowym , koncepcji pełnej alokacji i metodzie zobowiązań .	bazujący	11	Imp
Uchwała rady powinna być podjęta w ciągu miesiąca od dnia doręczenia wniosku Naczelnej Rady Aptekarskiej .	podjęta	4	Perf
- Napił by m się grzanego piwa .	grzanego	5	Imp
W klasztorze mieścił się obóz przejściowy dla Niemców sprowadzonych z Rumunii .	sprowadzonych	8	Perf
Świadek ten był wezwany na wniosek Rzecznika Interesu Publicznego .	wezwany	3	Perf
Wśród zarejestrowanych bezrobotnych kobiety stanowią prawie 55 proc .	zarejestrowanych	1	Perf
Tymczasem w liceach prowadzonych przez Społeczne Towarzystwo Oświatowe zdanie egzaminu dojrzałości nie należy do najłatwiejszych .	prowadzonych	3	Imp
Ekipa ekspertów przy jednej z ulic znajduje dom niewiele uszkodzony .	uszkodzony	9	Perf
Jak ta Mirta miała wszystko uporządkowane i przemyślane !	przemyślane	7	Perf
Tymczasem miednice wypełnione podrobami przenoszono do kuchni .	wypełnione	2	Perf
Klasztor fundacji Gaszynów posiada sklepione cele i korytarze komunikacyjne .	sklepione	4	Perf
Podróżujący pierwszą klasą będą odtąd mogli wypoczywać podczas lotu na rozkładanych podwójnych siedzeniach .	Podróżujący	0	Imp
Potem były one sumowane .	sumowane	3	Imp
Pei Fan nie odzywał się , pogrążony we własnych myślach .	pogrążony	6	Perf
Ulice pokryły się także gałęziami połamanymi przez wiatr .	połamanymi	5	Perf
Spadek bezrobocia odnotowano we wszystkich województwach .	odnotowano	2	Perf
Coraz większym zainteresowaniem cieszą się fundusze inwestycyjne działające na terenie Szwecji .	działające	7	Imp
Żeby jednak mieć dobrą samoocenę , lubić siebie , dziecko musi mieć jakieś zasoby wynikające z relacji z najbliższymi .	wynikające	14	Imp
Zza kulis wychodzi aktorka grająca Magdalenkę .	grająca	4	Imp
Tak przynajmniej wynika z zachowanych dokumentów i relacji .	zachowanych	4	Perf
Życie ojca , surowe i ciężkie , całkowicie poświęcone rodzinie i opiece nad innymi ludźmi , budzi dziś zdumienie nieprawdopodobną obowiązkowością , odpowiedzialnością i pogodą ducha .	poświęcone	8	Perf
Po chwili odsłonił głowę i uważnie lustrował zaniepokojone twarze .	zaniepokojone	7	Perf
Tym razem atrakcyjność potyczki podniesie fakt , że Hoop i Zepter reprezentują mocno zmienione oblicza .	zmienione	13	Perf
W czerwcu zgłoszono 262 oferty pracy , z tego 56 to oferty robót publicznych i dla absolwentów .	zgłoszono	2	Perf
Choć dziecko złożyło na policji zeznania , sprawców nie zatrzymano .	zatrzymano	9	Perf
Nie są przeprowadzane bezpośrednio na ludziach .	przeprowadzane	2	Imp
Byłem przyzwyczajony do dość dużej samodzielności .	przyzwyczajony	1	Perf
Manifestanci próbowali uniemożliwić policji zamykanie biur zdelegalizowanego ugrupowania .	zdelegalizowanego	6	Perf
Ledwie sformowany rząd ustąpił protestującej grupie zawodowej .	sformowany	1	Perf
Transportowany do szpitala zakopiańskiego zmarł w drodze .	Transportowany	0	Imp
Kocham polskich chłopów hodujących polską brukselkę . . .	hodujących	3	Imp
Nie będzie postulowanego przez PiS samorozwiązania Sejmu , bo nie godzi się na nie Platforma Obywatelska .	postulowanego	2	Imp
Smażyli ryby złowione w strumieniu .	złowione	2	Perf
List ten nie został jeszcze wysłany .	wysłany	5	Perf
Tamta patrzyła zaskoczona .	zaskoczona	2	Perf
Dotychczas lokatorzy budynków , w których zainstalowane są gazomierze , płacili za gaz co dwa miesiące .	zainstalowane	6	Perf
Jego odejście od lewaków do religijnych ortodoksów spowodowało , rzecz jasna , szyderstwa i krytykę , ale wbrew powszechnym oczekiwaniom nie został odrzucony przez media .	odrzucony	22	Perf
Kryteria do odstrzału selekcyjnego są zróżnicowane w zależności od rejonu siedliska .	zróżnicowane	5	Perf
