Після того як людина перехворіла на грип , у неї виробляється несприйнятність до цього різновиду вірусу грипу .	перехворіла	4	Fem
Ця заввага літературознавця погано корелює зі свідченням самої поетеси у листі до Ольги Кобилянської : « … вчилась тільки того , що мені подобалось , а читала все , що запорву , без жадної заборони .	подобалось	23	Neut
Наймолодший грав у сопілку , дивився на зорі , і очі йому були спокійні , як зорі .	дивився	5	Masc
А матуся сьогодні в білій спідничці з мереживом ходила вже коридором !	ходила	8	Fem
Дзядзьо тим часом стукав якимось патиком у стелю , бо думав , що тамтешні діти їздять серед ночі на ровері , а мама питалася у брата , нащо він трясе ліжком .	думав	10	Masc
Наша вчителька називала нас гнилою інтелігенцією , буржуазними націоналістами , і ми писали безконечні диктанти з книжок Брежнєва « Мала земля » , « Відродження » , « Цілина » і « Спогади » .	називала	2	Fem
Маленька рудувата жіночка перетворилася на яскраво рожеву , її рот відкривався та закривався неначе у риби що потрапила на суходіл .	закривався	12	Masc
Діафрагма Вінстона стислася .	стислася	2	Fem
Але заки мр . Морріс встиг повідомити свого земляка , що передучора безробітні витовкли в його ресторані всі вікна , то галаслива й нестримна людська повінь віднесла обох джентльменів на яких двадцять ярдів одного від другого .	віднесла	26	Fem
З того часу вже ніщо не могло спокусити її .	могло	6	Neut
Він зовсім забув , що тільки тиждень минув , як покинув село .	забув	2	Masc
Нова журба нізвідки узялась .	узялась	3	Fem
А я ж добре знаю , що він закінчив перший курс біофаку заочно , а з другого його вигнали за " хвости " .	закінчив	8	Masc
Суперник довго оглядав поле , уважно вивчив свої нотатки і відмовився .	відмовився	10	Masc
Тому , якщо вона там робила щось , то явно це пішло її на користь .	робила	5	Fem
( Щодо марксизму , захоплення яким нібито знівелювало « згубний » вплив Драгоманова , то коментаторам зоставалося тільки сподіватися , ніби читачі обмежаться лише їхніми примітками .	знівелювало	7	Neut
Уже значно пізніше у тому басейні працювала тренеркою молода жінка , яка закохалася в мого знайомого .	закохалася	12	Fem
Він сказав собі : погляну на діло рук моїх !	сказав	1	Masc
Майже так само пояснив правоохоронцям наявність у власній кишені пакету з канабісом і 34-річний глухівчанин , що прямував на заробітки своєю машиною .	прямував	17	Masc
Полісмени припустили , що , судячи з зовнішніх ознак , в одному з пакетів знаходилась марихуана , в іншому знаходився – амфетамін .	знаходився	19	Masc
Казала , що ночувала в Домахи , але злі язики говорили , що вона деінде проводила свої ночі .	Казала	0	Fem
Марія іноді кидала на неї погляд змії і не раз мала бажання впитися пазурами в ясні глибокі і невинні очі .	кидала	2	Fem
І дівчинка в матроському костюмчику , що , сама того не відаючи , вишила йому останню зброю , теж була тут і дивилась на нього з любов’ю .	дивилась	22	Fem
Одно дерево упало на віз і розтрощило його на шматочки , друге вбило коня ; насилу той чоловік вискочив з лісу .	вискочив	18	Masc
Злий дух вернувся у підземну країну і ждав .	ждав	7	Masc
Умочав мішок у воду і клав один на інший .	Умочав	0	Masc
" До Умані завітав представник села Дзензелівка і попросив нас приїхати до них на тиждень з виставами , – пише актор Василь Василько .	завітав	3	Masc
Минуло сто літ , — на могилах людей , що погинули від зарази , ярий моріг зеленів , а нащадки їх спокійно ходили по горах - полонинах , весело грали в сопілки , скликали незліченні отари .	Минуло	0	Neut
А вже Михайла Грушевського та Володимира Винниченка очорнено найстрашнішими епітетами , і зостається тільки дивом дивуватися , як же могла Лариса Косач знатися та ще й листуватися з такими звироднілими й аморальними людьцями .	могла	19	Fem
Усе це збереглося як у Луганському природному заповіднику , так і в дикій природі .	збереглося	2	Neut
Решту дурман - зілля після того він поклав до гаманця й забув .	забув	11	Masc
Вона впала на високу гору , і на горі спалахнуло світло , горіло і вабило серце .	вабило	14	Neut
Прийшов додому , показав бабі кісточки .	Прийшов	0	Masc
Киця ходила у пуделко з піском , постійно щось там загрібала , а дзядзьо надто сильно відчував уночі запах її непомитих лап .	ходила	1	Fem
А як з другого боку гримнув якийсь постріл , роздягнутий сердито кричав :	гримнув	5	Masc
Сказала і відійшла .	Сказала	0	Fem
Сю ніч снилася мені моя сосна .	снилася	2	Fem
Злий дух вийшов чорним димом з лона землі і огненною хмарою полинув понад землею .	вийшов	2	Masc
Тоді кам’яною дорогою текла суцільна ріка , змиваючи насипаний шутер аж до старих кам’яних плит .	текла	3	Fem
Коли назбирувалося більше талонів , я запрошував своїх приятелів у дієтичну їдальню , і ми влаштовували собі бенкет з бабки , политої киселем .	запрошував	6	Masc
Довелося йому ретируватися від пропозицій поїсти плов " на честь свята " .	Довелося	0	Neut
Проти виступив Сталін : сказав , що не хоче бачити чоловіків у спідницях і вважає шкідливими для здоров'я часті там тумани .	сказав	4	Masc
Доскуб руками .	Доскуб	0	Masc
Але вона визнавала , що — попри відсутність освіти — він є надзвичайно інтеліґентним .	визнавала	2	Fem
Його двоюрідний брат Раїль ніколи не знав жінки і не їздив на мотоциклі .	їздив	10	Masc
Молода вчителька математики , яка занадто близько підпускала деяких старшокласників , кожного уроку перевіряла письмове домашнє завдання .	підпускала	7	Fem
Я мусив переходити від одного до іншого , щоби вислуховувати історії їхнього життя і давати мудрі поради .	мусив	1	Masc
Я собі вже сьогодні зробила " подарунок " у чорну п'ятницю .	зробила	4	Fem
Відбій — роздягання , складання одежі і вискакування на другий ярус тривав стільки , скільки горів сірник .	тривав	11	Masc
Це було через атмосферу хокейних полів , крижаних ванн , громадських піших маршів і загального порожньодумства яка кружляючи навколо неї постійно приходила разом .	приходила	21	Fem
Зміїна дочка зробилась ізнов людиною , а той дід зробився парубком , та давай утікати .	зробився	9	Masc
Мене там мати повивала .	повивала	3	Fem
Вся камера пирснула , скинулась від несподіванки й обернулася до того , що ставив запитання .	скинулась	4	Fem
Потім сів на лавицю і гріється .	сів	1	Masc
Але склалося так , що пізніше нас несподівано зводило ще і ще у зовсім інших сферах — виробництві і продажу шипучих вин , представництві найпопулярнішого тижневика , створенні модного журналу , ловленні форелі .	зводило	8	Neut
ледь не забула вкотре сказати , що джуд лоу звісно ж неймовірний актор .	забула	2	Fem
Більшість прочитаних книжок вона відразу ж здавала у комісійний відділ іншої книгарні .	здавала	6	Fem
А от у кіновсесвіті Чужих людство , схоже , деградувало , до небаченої позначки , раз на максимально відповідальні посади набрали клінічних ідіотів , істеричок і некомпетентних суїцидників .	деградувало	9	Neut
Це була програма Метрополітен - опери на сьогоднішній вечір , в якій стояло , що нині відбуватимуться незвичайно цікаві продукції великого українського хору під проводом містера Кошиця .	стояло	12	Neut
Тепер тільки Оришка розібрала своє лихо .	розібрала	3	Fem
Натерпілася страху Мотря од тих хитрих спросів та переспросів ; набралася горя Оришка , глядя на свою дитину .	Натерпілася	0	Fem
Ви уступалися йому з дороги або , кинувши всі скарби , стрімголов бігли в сіни і причиняли за собою двері , коли він надходив занадто близько .	надходив	23	Masc
Фацик був одним із тих трьох людей у моєму житті , яких я вважав досконалішими у всьому без винятку .	вважав	13	Masc
У вестибюлі тхнуло вареною капустою та старими драними килимками .	тхнуло	2	Neut
Він крикнув уголос : « Дивіться , дивіться ! » — і всі дивились туди , куди показувала його рука , — там упала зоря .	крикнув	1	Masc
— Лягай же тепер спати , а завтра рано щоб устав та понесеш змії паляницю .	устав	10	Masc
Він заглянув на піч — там висить торбинка .	заглянув	1	Masc
Більшість цих сімнадцятирічних хлопчиків і дівчаток перейшла через справжні бої з озброєними і бєзпрєдєльними заготівельниками ікри , червоної риби , ведмежого жиру , тисячолітньої модрини , гагачого пуху , тигрячих шкір , женьшеневого кореня .	перейшла	6	Fem
У кабінеті цього вчителя на кожній парті лежала підбірка основних словників , він вимагав , щоби кожен навчився писати друкованими літерами і мав записник з виписаними латинськими висловами .	навчився	17	Masc
Спочатку вироблялися стінки її від вінця аж до ноги , а тоді виготовлялося додатково ніжку , вмащуючи глину з двох боків так , щоб постало дно та частинне або повне виповнення ніжки .	виготовлялося	12	Neut
Настав день , а вона не верталась , і ніхто не знайшов її .	верталась	6	Fem
Була якось в садибі - музеї Карла Мая в Радебойлі , нарешті дізналась про нього більше .	дізналась	12	Fem
Часом казали , що урвалася хмара .	урвалася	4	Fem
Він , світ , справді опинився поза звичною дихотомією « правда – брехня » , а тому давній солженіцинський заклик « Жить не по лжи » сьогодні втрачає свій сенс .	опинився	5	Masc
В один момент я відрізала все .	відрізала	4	Fem
Поки я доходив з лопатою до кінця стежки , початок знову виглядав недоторканим .	виглядав	11	Masc
Тоді ж перестав розуміти математику і решту школи провів у цілковитих математичних сутінках .	перестав	2	Masc
На одного воно глянуло коханими очима , іншому заблищало золотом , іншому засіяло світлом слави .	заблищало	8	Neut
Там відбувалася таємна конференція всесоюзної нелеґальної студентської природоохоронної екстремістської організації , і я був делеґатом від Львова і Західної України .	відбувалася	1	Fem
А тому навіть не намагалася вийти з кімнати .	намагалася	4	Fem
А безпекові і гуманітарні питання мають бути першочерговими » , — підкреслила вона .	підкреслила	11	Fem
Вона не могла навіть цілувати його перстень .	могла	2	Fem
Але вона послухала Тіріона і допомогла Джону .	послухала	2	Fem
Потім у барах ніколи не користувався калькулятором і жодного разу не помилився у рахунках .	помилився	11	Masc
Із Батумі приїхала десятикласниця , котра вже понад рік терпіла без Каракєджби .	приїхала	2	Fem
У Підлютому , де учениці гімназії проводили частину літніх вакацій поруч з патроном гімназії митрополитом Шептицьким , тета Міра ніколи не брала участі у ранкових дівчачих боях за право застеляти ліжко митрополита .	брала	21	Fem
— Що вона загадала ?	загадала	3	Fem
Після того бідний розжився трохи , як у нього не стало злиднів , а багатий ще бідніший став , як той був .	розжився	3	Masc
( Пасковою керамікою О . Кандиба називав неолітичну « Вапсікегатік » ) .	називав	6	Masc
В неокласичний французький рух не можна не зарахувати ще й Мусса , вояку й патріота , який , побиваючи « бошів » , дістав медаль , а виспівуванням війни дістав поетичну премію Сюллі Прюдома .	дістав	23	Masc
Байдужим поглядом вона пробігала по юнаках і одверталася .	пробігала	3	Fem
Марфа ворушить губами і проводжає мене далі , аж доки я не увійду в сосну “ велику ” ( у нас її називають ще : “ та , що твій тато садив ” ) .	садив	31	Masc
Тому відомий рецепт сінгапурського прем’єра звучав так : « Посадіть трьох своїх найкращих друзів .	звучав	5	Masc
Пуні попався справжній професіонал — після першого ж ходу суперник вийняв блокнот і записав Пунин хід пішаком .	записав	13	Masc
Одходячи на спокій , сонце обдало землю блискучим промінням ; земля на прощання усміхнулася — і потемніла .	усміхнулася	13	Fem
Прийшов кінець і соняшному квітневому дню , і все товариство опинилося під піччю .	опинилося	10	Neut
Збереглося кілька її дуже добрих робіт , але вона чомусь скоро закинула живопис .	закинула	11	Fem
Я налічила 6 великих яхт і 18 менших , а три великі пароходи стоять увесь час напроти нас нерухомо і щовечора наводять світло електричне на Сан-Ремо .	налічила	1	Fem
Киця ходила у пуделко з піском , постійно щось там загрібала , а дзядзьо надто сильно відчував уночі запах її непомитих лап .	відчував	16	Masc
Але в той день нескінченно йшов дощ і все було мокре і не припиняло мокріти знову .	припиняло	13	Neut
Потім , стрепенувшись , підкидає їх угору , перебиваючи їхню дерев’яну говірку так , щоб у прорив шелепаво дзвякали мідні тарілки , дзенькав трикутник і наддавала в ритм свою мелодію струнна армія рояля .	наддавала	25	Fem
Щоби не згубити свою родину , я мусив негайно повертатися додому .	мусив	7	Masc
Покійний акад . Ф . І . Успенський в свій час вповні виявив значіння татар в балканських подіях XIII — XIV ст .	виявив	12	Masc
Тут слово « тітка » позначало японців , « Оля » позначало — провідника націоналістичної групи .	позначало	5	Neut
Полеміка із Соболевським утратила гостроту після української національної революції 1917 - 1920 рр . , тож поле стало вільним для конструктивного й об’єктивного дослідження .	утратила	3	Fem
Артистка , яка читала тексти , теж не бачила , тому на цьому місці запнулась .	читала	3	Fem
Він зробив собі лижі і вивчав ліси .	вивчав	5	Masc
Роздіймав він їм руки , роздіймав , нічого не вдіє .	Роздіймав	0	Masc
Приїхавши після Чити до Делятина , тато кілька місяців удавав у школі , що не розуміє української .	удавав	9	Masc
Вона глянула ще раз на Мотрю , поступилася назад , простогнала , сіла мовчки на піл , узявшись холодними руками за крайню дошку , щоб не впасти .	поступилася	7	Fem
Ти людина культурна , і невже ти ніколи не чув про поета , якого , крім руської , перекладають на польську , французьку , чеську , єврейську і німецьку мови .	чув	9	Masc
Став широко відомим після перемоги у фіналі Олімпіади 2000 над найкращим борцем греко - римського стилю XX століття Олександром Кареліним .	Став	0	Masc
Гонки сі робляться зовсім не так , як я собі думала .	думала	10	Fem
На спеціальному згортку паперу Юрко виписував з усіх доступних джерел імена письменників і назви їхніх творів .	виписував	5	Masc
- Зайшов , - каже , - якось до мене земляк .	Зайшов	1	Masc
Той теж , як прийшов , то такого Лазаря скорчив ...	скорчив	9	Masc
8 лютого 1965-го парламент Великої Британії заборонив рекламу сигарет на телебаченні .	заборонив	6	Masc
На крильцях залишилося декілька пір'їн .	залишилося	2	Neut
Дитинка на екрані заскочила на місце .	заскочила	3	Fem
У цю другу хвилину Ненависть розрослася до справжнього божевілля .	розрослася	5	Fem
Про це повідомив у « Фейсбуці » друг Валентина Щербачова , журналіст Віталій Довгич .	повідомив	2	Masc
І не тільки бачу , але й чую , бо запах розповсюдився по всьому поверху .	розповсюдився	11	Masc
Ім'я Волтера Вайта нагадує поета Волта Вітмена , що відіграло важливу роль у сюжеті , аж до середини фінального п'ятого сезону .	відіграло	9	Neut
( І це вперше цьогоріч я виспалася , бо спала до 1 юху )	спала	9	Fem
Покинув його й сам поїхав .	Покинув	0	Masc
Машиніст загальмував , вискочив зі своєї кабіни і скотився в яр .	скотився	8	Masc
Так сприймала свій національний гімн ґенерація , яка й спромоглася відродити державу , це якраз із цього кола вийшло чимало провідних діячів Української Народної Республіки .	спромоглася	9	Fem
Зовсім загубила спокій Мотря : водять її то в город , то з города ...	загубила	1	Fem
Вона впала на високу гору , і на горі спалахнуло світло , горіло і вабило серце .	впала	1	Fem
Людське життя плило тихими хвилями і зливалося з тією мрією в одне осяйне , спокійне море .	зливалося	6	Neut
Я вчився тоді у Львові і відповідав за організацію зустрічей .	відповідав	6	Masc
Була якось в садибі - музеї Карла Мая в Радебойлі , нарешті дізналась про нього більше .	Була	0	Fem
— Завагітніла ...	Завагітніла	1	Fem
Він пролітав над долинами , де хвилювало золоте збіжжя , де рясні дерева клонили додолу важкі віти .	хвилювало	6	Neut
Катя - мала бути місс могилою !	мала	2	Fem
Ефектна співачка Бейонсе , яка цьогоріч “ загребла ” аж шість статуеток , прибула з донькою , схудла Кім Кардаш’ян прибула — з чоловіком .	прибула	20	Fem
Мальована кераміка Болгарії виявила лише дуже нечисленні форми на ніжці .	виявила	3	Fem
Він відригнув .	відригнув	1	Masc
— Чого ти здихаєш ? — гримнув на неї голова .	гримнув	6	Masc
Вона й пізніше радо виступала з Лесем " .	виступала	4	Fem
Біжи вдруге за ними , та щоб доконче розірвав !	розірвав	8	Masc
І після розмови відзвітувала : ціни знижено на 25 % !	відзвітувала	3	Fem
Я навіть не намагався задержати втечі , бо ситуація була доволі безвиразна й не хотілось попасти у полон або губити даремно людей .	хотілось	14	Neut
Я хотів його звідти забрати , але міліціянт вхопив мене за руку і заборонив користуватися кишенями .	вхопив	8	Masc
Ефектна співачка Бейонсе , яка цьогоріч “ загребла ” аж шість статуеток , прибула з донькою , схудла Кім Кардаш’ян прибула — з чоловіком .	прибула	13	Fem
Деґрадація сягнула такого рівня , що багато наших місцевих сімей влаштовувало домашні гостини першого травня і сьомого листопада .	влаштовувало	10	Neut
Оришка пильно дивилася на неї .	дивилася	2	Fem
Я спав серед іграшок на підлозі у залі для музики і танців .	спав	1	Masc
Не знаю , чи цільно стріляв той прилад , але признаюся , що тоді вперше доводилось бачити таке дивовижжа та подивляти стрілецьку вигадливість .	стріляв	5	Masc
Змія прокинулася , вийшла в двір та й дивиться на той луг , тільки сама стерня та скирти стоять .	вийшла	3	Fem
Одходячи на спокій , сонце обдало землю блискучим промінням ; земля на прощання усміхнулася — і потемніла .	потемніла	16	Fem
Ніхто не згадував про лиху заразу .	згадував	2	Masc
Пустиня давно обернулася знову в розкішну країну , знову хвилювало золоте збіжжя , рясні дерева знов клонили додолу важкі віти .	обернулася	2	Fem
Вийшов і вп'ять прив'язав до вугла колодочку , а сам потяг додому .	прив'язав	3	Masc
— Іди собі ! — гукнув голова , бачачи , що в неї й річ відтяло .	гукнув	5	Masc
Її багато чого нервувало у дзядзеві .	нервувало	3	Neut
У Юрка була ціла купа запраних вишуканих тонких білих сорочок з мереживами , перламутровими ґудзиками і вигаптуваними монограмами , які не хотів брати ніхто з тих , кому призначалася допомога .	призначалася	28	Fem
А менш ніж за рік позбулася " вагітних " кіло та позувала у купальнику .	позувала	11	Fem
Вона погостювала трохи , дала батькові грошей та й поїхала в город , купила там собі будинок і зажила панію .	зажила	18	Fem
Годують такою смачною юшкою , що навіть Карпо Ярковий п’ятнадцять мисок умолотив би , ще й добавки попросив !	умолотив	11	Masc
Під час таких нічних розмов , де узгоджувалися погляди на найважливіші речі , мене найбільше нервувало те , що тато безперервно курив , а я не міг собі того ніяк дозволити у його присутності .	нервувало	15	Neut
Інтерпретаторам достатньо було просто називати чорне білим , видавцям і редакторам велося складніше й клопітніше : тут ані напівправда , ні одверта коментаторська брехня не допомагали .	велося	11	Neut
Проведене у 2016 році дослідження Держстату виявило , що в 45 , 7 % домогосподарств грошей було достатньо , але заощаджень не робили , 43 , 2 % постійно відмовляли собі в найнеобхіднішому , окрім харчування .	виявило	6	Neut
Долучені до інших підпільників , яких спіткала така сама доля , ці троє націоналістів у середині 1930-х візьмуть участь у вишколах хорватських підпільників - « усташів » в Італії , а в 1937-му вирушать на Далекий Схід .	спіткала	6	Fem
Невроз сформувався через те , що її сестрі лікарі заборонили вживати багато рідини .	сформувався	1	Masc
Старе тіло тремтіло , колихалося , стара голова не здержувалась на в'язах — хилилася на груди .	здержувалась	9	Fem
Щоразу , коли вертоліт знижувався і заходив на близьке коло , ми маскувалися серед ялівців , потім перебігали схилом далі і знову мусили ховатися .	заходив	6	Masc
Хотів відігнати , а вона тої ж хвилини щезла .	Хотів	0	Masc
Тільки от писання патріотичних віршів поетка вже служінням і обов’язком не вважала .	вважала	11	Fem
Відчуття повної безпорадності переслідувало його .	переслідувало	3	Neut
Погородив він загороди великі , розбив те яйце , випустив скот і забагатів .	випустив	9	Masc
Після опитування громадян у соцмережі директор відмовився від цієї пропозиції .	відмовився	6	Masc
— не бачив , коли з’явилася , не бачив , куди й зникла .	з’явилася	5	Fem
— Щоб ти оту гору розкопав , і щоб туди Дніпро йшов , а коло того Дніпра побудуй комори : щоб байдаки туди приставали , й щоб ти ту пшеницю продав на байдаки .	продав	30	Masc
Від такої точної відповіді він втягнув голову в плечі й боязко заморгав білявими віями .	втягнув	5	Masc
І темніли вони для дочки й для матері ; здавалась темною хата , й світ що вривався у вікна , чорнів у віччю в них ...	чорнів	20	Masc
— Чи ти не збожеволіла , дочко ?	збожеволіла	4	Fem
Оте заплющування очей не дало розгледіти початок великої трагедії , яка торкнулася всієї нашої частини континенту .	торкнулася	11	Fem
Мр . Фред Кетлінг прочитав програму від дошки до дошки , потім добув годинник , що вказував чверть на сему , і сказав коротко :	прочитав	4	Masc
Одно руденьке з двома блакитними латочками на спинці курча зацікавилося маминою бородою , підскочило і повисло на ній .	підскочило	13	Neut
Під час показу у США , що розпочався 18 вересня 2015 року , протягом першого тижня фільм був показаний у 545 кінотеатрах і зібрав 7_222_035 $ , що на той час дозволило йому зайняти 5 місце серед усіх прем'єр .	розпочався	7	Masc
Знову сховався .	сховався	1	Masc
Одно дерево упало на віз і розтрощило його на шматочки , друге вбило коня ; насилу той чоловік вискочив з лісу .	вбило	12	Neut
Прокинувся злий дух і покликнув : « Лихі сни мучать мене !	Прокинувся	0	Masc
Але він уже не слухав — перед ним підносилася велетенська темна стіна , більша за все , що він здолав досі , й він сказав тій , що не пускала його туди , втримуючи при життю :	пускала	29	Fem
Нарешті я отримала свою довгоочікувану книгу , з таким нетерпінням летіла на пошту в дощ , як не знаю що ...	отримала	2	Fem
Дуже вимовною видається її реакція на польську рецепцію « Кассандри » : « З польської статті мені найбільше сподобалось те , що « Кассандра » страшна для поляків .	сподобалось	18	Neut
Проте ще у 2006 році Обухівська міськрада здала цю територію в оренду забудовнику .	здала	7	Fem
Мама маленького Зайчика застудилася , і він вирішив піти купити для неї меду , адже чай з медом — найкращі ліки на горло .	застудилася	3	Fem
Журився чоловік , що йому робити з діточками , бо був такий бідний , як церковна миша .	Журився	0	Masc
Моя подруга отримала біометричний паспорт і вже їздила з ним до Франції .	отримала	2	Fem
« Камену » я Вам уже послав .	послав	6	Masc
Пів на третю ночі я дописала статтю і через помилку Віндоус жодного слова не збереглося .	збереглося	14	Neut
Деніелс просто прожила найдовше , ото й усе .	прожила	2	Fem
Врешті якась комісія з Києва виявила , що засуджений такий - то все ще числиться за місцевим слідчим ізолятором , хоча йому цілком виважено призначено перебувати у східних областях Радянського союзу .	виявила	5	Fem
Татів тато називався Роберт .	називався	2	Masc
Під час поглибленого огляду салону службовий собака виявив сховок з наркотиками : в попільничці одного із сидінь були приклеєні клейкою стрічкою два прозорі поліетиленові пакети .	виявив	7	Masc
Коли їхали вантажні , тряслася хата .	тряслася	4	Fem
Запала тиша .	Запала	0	Fem
Сьогодні Індія має 850 тис . програмістів , вона стала світовим лідером у створенні програмного забезпечення і експортує його більше ніж на 30 млрд . дол .	стала	9	Fem
Вона його питалась :	питалась	2	Fem
Тоді ж перестав розуміти математику і решту школи провів у цілковитих математичних сутінках .	провів	8	Masc
В мене просто відвисла щелепа від отриманого !!	відвисла	3	Fem
Мій e - mail зареєстрований на gmail , я ніколи не реєстрував пошту на icloud " , - зазначив Лещенко .	реєстрував	11	Masc
Ефектна співачка Бейонсе , яка цьогоріч “ загребла ” аж шість статуеток , прибула з донькою , схудла Кім Кардаш’ян прибула — з чоловіком .	загребла	7	Fem
Чіпка бачив , як вона поблідла , як заблищали в неї очі , як дві гарячі сльози скотилося по личку ... додолу .	скотилося	17	Neut
Той , хто програв , мусив заколоти випадкового глядача , що опинився у цей час у цьому місці .	мусив	5	Masc
Вийшов із землянки , взяв колодочку , прив'язав до вугла , а сам потяг додому .	взяв	4	Masc
Тоді сніг не потрапляв у ноги .	потрапляв	3	Masc
І навіть послав його .	послав	2	Masc
Вийде перший , під білим прапором — під оцим - о , — взяв сорочку до рук , але вона не пахла : він перестав чути запахи , чув лиш паленизну .	пахла	21	Fem
Цей спосіб ліг в основу розвитку поодиноких форм , що на перший погляд навіть не мають між собою нічого спільного .	ліг	2	Masc
В одній з кімнат стояла велика фізгармонія , правдоподібно , лишилася з часів дяківки .	стояла	4	Fem
Просто був хтось моринський , хто захотів прославити рідне село і підробив документи .	захотів	6	Masc
Бензину в один політ можна було взяти стільки , що дельтаплан тримався у небі шість годин .	тримався	11	Masc
У його бейсболці був приклеєний папірчик з написом латинкою — дорогая , під’їжджаючи до дівчат , він кланявся , знімав шапку і вичитував слово , яке ніяк не міг запам’ятати .	знімав	19	Masc
Він оповив їй рукою стан , і вона , припавши головою до плеча , тремтіла від далекої вільгості води й теплої вогкості очей .	оповив	1	Masc
Ото вона пішла та й жене .	пішла	2	Fem
Молода вчителька математики , яка занадто близько підпускала деяких старшокласників , кожного уроку перевіряла письмове домашнє завдання .	перевіряла	13	Fem
Я не малюватиму вам щастя матері , коли тріснула перша шкарлупина і звідти почулось жалібне хлипання немовляти .	тріснула	8	Fem
І ще більше мене тоді вразило , що чехи преспокійно , роздяглись до половини , милися під оком москаля .	вразило	5	Neut
Благо , до цього не дійшло , бо навіть за таких несприятливих обставин її напарник - геолог надто вже хотів жити і , завдяки професійним знанням та ерудиції , зумів облаштувати цілком адекватний побут на наступні роки .	дійшло	5	Neut
Вінстон повернув вимикача і голос дещо вщух , одначе слова що лунали ще можна було розібрати .	вщух	6	Masc
Кілька разів мені доводилося витягати непритомним дівчатам язик і пришпилювати їх аграфкою до комірця , щоби язик не перекрив дихальні шляхи .	доводилося	3	Neut
Ми вчилися знімати фольґову накривку з пляшки так , щоби вона не помнулася , і тримаючи її між двома пальцями , запускали фольґу , як планер , через цілий клас .	помнулася	12	Fem
Вінстону вона дуже не сподобалася з найпершої миті як тільки він її побачив .	сподобалася	4	Fem
Вона принесла її до школи , вчительці історії , яка була найліберальнішою і гралася у справжню дружбу учнів і вчительки .	гралася	13	Fem
Скло у передніх бічних вікнах постійно западало .	западало	6	Neut
Усіма військовими справами ЗУНР відав ДСВС , що діяв до 9 червня 1919 року та поділявся на Військову канцелярію ДСВС і 16 відділів .	діяв	8	Masc
— Го-го ! — закричав чорт .	закричав	4	Masc
І виграв .	виграв	1	Masc
Її учителем української мови був Василь Щурат , біологію викладав Мельник , а географію викладала Олена Степанів .	викладала	14	Fem
Показ в Україні тривав 7 тижнів і завершився 8 листопада 2015 року , за час прокату було продано 442_509 квитків та зібрано 29_037_892 ₴ , або ж 1,357,145 $ .	завершився	7	Masc
спочатку розчепірила ноги , потім щось в кущах робила , потім дитятко дельфіна .... ???	робила	8	Fem
Збереглася гарна знимка , зроблена з балкона спортивного залу .	Збереглася	0	Fem
Тому Тіріон говорить прямо , що Джон вклепався по самі вуха .	вклепався	7	Masc
Марія Василівна , як актриса після важкої ролі , інколи виходила з образу “ вчительки з великої літери ” й ставала тією , кого треба покарати .	ставала	20	Fem
Поки я лапаю останні промінчики сонечка і намагаюся зрозуміти , коли я стала рудою - питання , чи не є порушенням Правил адвокатської етики публікація адвокатом своїх знимків у купальнику в соціальних мережах , своєї актуальності не втратило	втратило	37	Neut
Свого часу пів - Ірландії виїхало в штати , і чи згубило це Ірландію ?	згубило	11	Neut
Треба зазначити , що питання петиції розглядала земельна комісія , яка рекомендувала її підтримати .	рекомендувала	11	Fem
Як розповів іноземець , він повертався додому з Російської Федерації , і в автобусі познайомився з чоловіком , з яким вони дорогою вживали амфетамін .	розповів	1	Masc
І все ж після маневрів особісти збиралися посадити сержанта за те , що він залишав секретну апаратуру без охорони .	залишав	14	Masc
– Село святкувало храм .	святкувало	2	Neut
За спиною Вінстона голос з телезахисту все ще белькотів про чушковий чавун та про перевиконання Дев’ятого Трирічного Плану .	белькотів	8	Masc
Застала його така ніч , що в потемок можна би сокирою затяти .	Застала	0	Fem
Твоє ім’я видаляли з усіх реєстрів , кожен запис про те що ти коли-небудь робив начисто стирався , в одну єдину мить саме твоє існування повністю заперечувалося , а згодом і забувалося повністю .	заперечувалося	26	Neut
Загуло - закрутилося .	Загуло	0	Neut
Він їй і розказав .	розказав	3	Masc
Ми поговорили про це з татом однієї ночі , і тато визнав , що настав час мого покоління і мого вибору .	настав	14	Masc
Одна з них була навіть на острові , що дзядзя дуже звеселяло .	звеселяло	11	Neut
Але злий дух не спав .	спав	4	Masc
Проголошуй свою промову до мужиків , як може робити це Жан , мужик , що добре поснідав кашею .	поснідав	16	Masc
Він сказав — а вдруг станеться крушеніє .	сказав	1	Masc
І вони виходили з хати зі спеченими обличчями , які сонце довгі роки пражило ; воно й тепер зараз увіссалося в них , та й вони його несли до своїх домів .	увіссалося	19	Neut
Оте заплющування очей не дало розгледіти початок великої трагедії , яка торкнулася всієї нашої частини континенту .	дало	4	Neut
На жаль , забув ім'я чоловіка , але його син у ті часи був моїм приятелем .	забув	3	Masc
У його поляресі лежала квитанція на штраф за безквитковий проїзд у підміському поїзді Стрий — Івано-Франківськ , виписана гражданіну Сідхардхє .	лежала	3	Fem
Літак до Львова летів так низько , що в якомусь місці біля Криму було видно два моря .	летів	3	Masc
Я зберігав бузькове прощальне перо у військовому білеті , доки його не поточили якісь паразити .	зберігав	1	Masc
Шоб не муляло у флуді , і шоб не викинуте було ( флуд же чиститься ) , переніс сюди .	переніс	17	Masc
У багатьох з нас були завузькі чоботи , тому відбій повторювався багато разів .	повторювався	10	Masc
Соболевський і Яґіч здебільшого не виходили за рамці філологічної школи , хоча перший також приділяв увагу дослідженню діалектів .	приділяв	14	Masc
Останнє питання було найгострішим , тож до Відня було надіслано телеграму : « Посварилася з тіткою .	Посварилася	13	Fem
Тут мені на думку сплив уривок з фільму Мориса Шевальє під назвою “ Любов опівдні ” , в якому тато - детектив відгадав , що його донька закохалася , бо що не день стала мити голову .	закохалася	27	Fem
Вона засотувала мене і я западав у довгі , хвилясті години півсну , пів'яву .	западав	5	Masc
Я старанно відхиляв поли , намагаючись не зачепити нікого чимось важким , що мотулялося на рівні колін .	відхиляв	2	Masc
Загуло - закрутилося .	закрутилося	2	Neut
Присідав і дивився вниз .	Присідав	0	Masc
Збереглося кілька її дуже добрих робіт , але вона чомусь скоро закинула живопис .	Збереглося	0	Neut
Ця заввага літературознавця погано корелює зі свідченням самої поетеси у листі до Ольги Кобилянської : « … вчилась тільки того , що мені подобалось , а читала все , що запорву , без жадної заборони .	читала	26	Fem
Також поніс втрати і місцевий зоопарк : через спеку загинуло 7 тварин .	поніс	1	Masc
Молодший син випав з ліжечка і розбив собі чоло .	розбив	6	Masc
Виявилося , що кава там коштує один долар .	Виявилося	0	Neut
До цього часу , на жаль , ще велика частина наших матерей , бодай , як твердять наші поети , постала з цілком іншого матеріялу .	постала	20	Fem
Це був поліцейський патруль , що шпигував по людських вікнах .	шпигував	6	Masc
– Не одержуючи ніяких стипендій , напівголодна , погано одягнена молодь могла цілими ночами " висіти " й бігати на конструкціях , репетируючи чергову постановку .	могла	11	Fem
Особливо вбилась мені в тямку одна сценка , що застановила мене зовсім іншими очима глядіти на Український Легіон .	вбилась	1	Fem
У них вставив гумові ребристі пальці сантиметрів по десять .	вставив	2	Masc
Догнав чоловіка саме в ту хвилину , коли вже той повертав до себе у двір .	Догнав	0	Masc
Після довгої співбесіди версія розсипалася , але брата про всяке передали на облік до дитячої кімнати міліції .	розсипалася	4	Fem
Убиралася в барвисті спідниці , голову накривала по-дівочому , заплела розплетену дружками косу .	накривала	6	Fem
Але терпіла , робила усмішки , танцювала на музиках , верталася поночі додому .	танцювала	6	Fem
Тільки прийшла та збудила його , щоб він пшеницю видав купцям на байдаки з тих комор .	збудила	3	Fem
Коли б я не прийшла надвечір , занесеш веприкові .	прийшла	4	Fem
Почув оце чоловік , і аж мороз пішов по ньому .	Почув	0	Masc
Ще одного близького приятеля Лариси Косач , перекладача Максима Славинського , замученого по другій світовій у радянській тюрмі , звинувачено в тому , що « опинився в таборі буржуазно - націоналістичної еміграції у Празі » .	опинився	25	Masc
Полісмени припустили , що , судячи з зовнішніх ознак , в одному з пакетів знаходилась марихуана , в іншому знаходився – амфетамін .	знаходилась	14	Fem
Я чоловікові нового светра купила , сам попросив .	попросив	7	Masc
Там спустився злий дух , — і збіжжя вигоріло , мов від огню , овоч на деревах почорнів , трави пожовкли , квітки посохли , стала пустиня .	вигоріло	8	Neut
Він пропонував одружитися , але тета Міра навіть думати про таке не збиралася , бо Галан постійно шпортався і падав на усіх гірських стежках .	шпортався	17	Masc
Андрій на всі запитання відповідав щиро .	відповідав	4	Masc
Далай - лама , що здійснював 10-денну поїздку в Австралію і Нову Зеландію , закликав пам'ятати про проблему глобальної зміни клімату .	закликав	14	Masc
Господи ! і за що ти мене отак караєш на сім світі ? — скрикнула Мотря і знову залилась сльозами .	скрикнула	14	Fem
Байдужість Європи в 1930-х до подій в Іспанії , заплющування очей на те , що насправді відбувалося , здається , можна порівняти з байдужістю сучасної Європи до того , що відбувається на її теренах , в Україні .	відбувалося	16	Neut
У нього навіть з’явилася думка що вона може бути агентом Поліції Думок .	з’явилася	3	Fem
Цілком можливо , що насправді зросла кількість тих читачів , які з більшою недовірою ставляться до будь-яких матеріалів ЗМІ і які схильні називати « джинсою » все , що викликає в них підозру .	зросла	5	Fem
Ініціатор акції – доцент кафедри філософії та теорії права нашого університету Сергій Мисевич , висловив окремі слова вдячності :	висловив	14	Masc
І я нєзамєдлітєльно в ньому сфотографувалася .	сфотографувалася	5	Fem
Він узяв з полиці пляшку з безбарвною рідиною на якій була простенька біла етикетка з написом ДЖИН ПЕРЕМОГА .	узяв	1	Masc
Уся сім’я завжди ходила з карабінами .	ходила	3	Fem
У попередніх сезонах Гейл Ботікер дав Волту копію книги , яка неодноразово була показана з того часу .	дав	5	Masc
Активістка Ірина Нікітчина зазначила , що призначення цих ділянок – землі житлово - комунальної забудови .	зазначила	3	Fem
У кабінеті цього вчителя на кожній парті лежала підбірка основних словників , він вимагав , щоби кожен навчився писати друкованими літерами і мав записник з виписаними латинськими висловами .	лежала	7	Fem
Після тренувань у басейні ми були дуже голодні , а грошей ніколи не вистачало на рогалики для всіх .	вистачало	13	Neut
Вода у кирниці не встигала профільтруватися і пахла розмоченою травою .	встигала	4	Fem
Мр . Фред Кетлінг прочитав програму від дошки до дошки , потім добув годинник , що вказував чверть на сему , і сказав коротко :	вказував	16	Masc
А це було абсурдно , адже написання цих конкретних слів було не небезпечніше ніж власне починати ведення щоденника , але на мить він відчув спокусу разом вирвати ці пописані сторінки та повністю відмовитися від цього задуму .	відчув	23	Masc
Розплавився навіть давній латунний гуцульський мосяжний хрест , прибитий над входом .	Розплавився	0	Masc
Та Ісус добре знався на економіці .	знався	3	Masc
Батько ще трохи поговорив з дідом та й каже дочці :	поговорив	3	Masc
Але от халепа : їхній корабель раптово вибухнув , друзі та колеги загинули , у них зі собою є лише скафандри і спортивні костюми , а попереду їх чекає щонайменше 14 років виживання в очікуванні рятувальників .	вибухнув	7	Masc
Загалом десь 100 романів написав і не тільки про індіанців ( яких він не дуже то і бачив ) , а про далекі краї , де він ніколи не був .	написав	4	Masc
Прочитала на Вашому сайті про книгу " Сіроманець " Миколи Вінграновського .	Прочитала	0	Fem
І він створив думкою своєю дивну постать .	створив	2	Masc
А колись же він царював на мітинґах , і ця скудовчена борідка , ці пасмочки на потилиці викликали повагу .	царював	4	Masc
Ізв’язав і закинув у воду .	закинув	2	Masc
Один близький товариш позичив у мене дуже багато грошей і втік до Америки .	позичив	3	Masc
Тато знімав тоді восьмиміліметровою камерою .	знімав	1	Masc
Охоронці пропускали мене , коли я йшов з вечірнього потяга з Франківська , несучи двох малих дітей , котрі вже спали .	йшов	6	Masc
Будете жити під російськими прізвищами й не будете брати участі в житті української еміграції у Харбіні » , — заявив оунівцям полковник Акікуза , який спершу опікувався націоналістами .	опікувався	26	Masc
Тому я сиділа на підвіконні кав’ярні , пила міцний чорний чай з м’ятою і малювала вже внутрішній Казімеж .	малювала	14	Fem
Юрко звідкись дістав цілий мішок промоційних пачок чудових сиґарет бенсон і ґеджес , у кожній пачечці вміщалося три сиґарети .	вміщалося	16	Neut
Жінка за 50 солила на стежці слимака .	солила	3	Fem
Незабаром наїхало в село чиновного панства .	наїхало	1	Neut
Через кілька хвилин до лазнички ввійшла покоївка з чайником .	ввійшла	5	Fem
Але терпіла , робила усмішки , танцювала на музиках , верталася поночі додому .	терпіла	1	Fem
Вранці виявлялись позасипаними двері , щоби їх відчинити , вилізалося з лопатою через вікно і розкидувалося замети .	розкидувалося	15	Neut
І ще подумалося , що екранізації ніколи не дадуть того ефекту , що книжки , бо вони все окреслюють , всьому дають форму , чіткий вигляд і звужують простір для фантазії та домислів .	подумалося	2	Neut
У п'ятницю , 27 листопада , на екрани Великої Британії виходить стрічка " Керол " , яка вже набула розголосу через свій сюжет – кохання двох жінок , пише газета Telegraph .	набула	18	Fem
Воно прилипало до мокрої бруківки .	прилипало	1	Neut
Я перестав робити домашні завдання у п’ятому класі , коли почав серйозно займатися легкою атлетикою .	перестав	1	Masc
Цей прилад ( який звався телезахист ) можна було приглушити , але не було жодного способу вимкнути його повністю .	звався	4	Masc
В мене мама хрестила в сестри , а потім сестра хрестила в мами .	хрестила	10	Fem
На другий день , після того , як квочка добре викупалась в піску та досхочу наїлася , під неї підпустили курчат .	наїлася	15	Fem
Таке лихо скоїлось перед обідом .	скоїлось	2	Neut
Вони клали великі цвяхи або шматки грубого сталевого дроту на рейки , і поїзд виробляв бездоганні стилети .	виробляв	14	Masc
Як зачули люди , то за малим не все село вибігло з хати , мов на ведмедя , дивитись .	вибігло	10	Neut
Мокрий , він поліз під матір , але не міг там довго висидіти виглядав то з-під крила , то спереду , вилазив на спину або біг геть і націлявся на стіні на поважну чорну муху .	поліз	3	Masc
Щербачов організував більше 30-ти гімалайських експедицій , про які відзняв 26 репортажів .	організував	1	Masc
Дідок атестував , а в Андрія помалу опускалися руки , відлипала спина від дверей і очі дерлися на лоба .	відлипала	10	Fem
І повертався у свій рай , де його вперше у житті усі чекали .	повертався	1	Masc
Тета Міра привчила нас з братом до ґрейпфрутів .	привчила	2	Fem
1922 року заснував у Києві мистецьке об’єднання ” Березіль ” .	заснував	2	Masc
У рамцях фонології це можна зробити , встановивши першу фонетичну зміну , що поширилася серед слов’янських мовців на пізнішій українській території , але оминула сусідні слов’янські племінні групи .	оминула	23	Fem
Шевченко каже : Думав доля зустрінеться , спіткалося горе .	Думав	3	Masc
Вночі тато попросив сиґарету , спробував курити й усвідомив , що більше не зможе цього робити .	спробував	5	Masc
Телезахист приймав та транслював одночасно .	транслював	3	Masc
Тоді побачите , що чоловіча природа відтоді аніскілечки не помінялась і що у давніх смішних рекомендаціях міститься чимало правди .	помінялась	9	Fem
В Лісабоні перейшовся туди - сюди - маєш квадріцепс мрії , невтамовний апетит і двадцять компліментів .	перейшовся	2	Masc
Гинула худоба , конали люди , крик страшний котився по горах : смерть , смерть !..	Гинула	0	Fem
Коло півночі вже й сили не має іти , але боїться лягти відпочити , щоб звір його не розірвав .	розірвав	18	Masc
Потім , стрепенувшись , підкидає їх угору , перебиваючи їхню дерев’яну говірку так , щоб у прорив шелепаво дзвякали мідні тарілки , дзенькав трикутник і наддавала в ритм свою мелодію струнна армія рояля .	дзенькав	22	Masc
— Аби якісно обскублось , потрібно відрізати голову , ногу , — завершує інструктаж .	обскублось	3	Neut
Вінстон наповнив майже повну чайну чашку що стояла поблизу , нервуючи від потрясіння , і жадібно ковтнув його одним великим ковтком неначе ліки .	стояла	7	Fem
Орел його поніс аж у хмару , а потім і пустив його додолу .	поніс	2	Masc
Міністерство Любові що підтримувало закон та порядок .	підтримувало	3	Neut
З-під язика він вийняв половинку жилетки і , ще тримаючи руку біля губ , зробив пальцями той рух , який примусив невагомий шматок сталі пролетіти кілька метрів і заглибитися у дощану стіну якраз біля голови пахана .	примусив	20	Masc
Всередині квартири солодкий та принадний голос диктував перелік цифр , що якось стосувалися виробництва чушкового чавуну .	диктував	6	Masc
Минуло сто літ .	Минуло	0	Neut
Завжди знаходилися нові дурні , що чекали на те щоб він спокусив їх .	спокусив	11	Masc
Двері вона завжди замикала на ключ .	замикала	3	Fem
Воно було схоже на овече , і голос також лунав мов овече блеяння .	лунав	9	Masc
Дзядзьо зумів витягнути тата з вуличної банди , і тато його визнав .	зумів	1	Masc
Воно летючою зорею падало в серце , і серце починало горіти .	починало	9	Neut
Вона засотувала мене і я западав у довгі , хвилясті години півсну , пів'яву .	засотувала	1	Fem
Значить , і досі існує він масово , не перевівся цілковито , оскільки його образ і дотепер страшить в нашім письменстві .	перевівся	9	Masc
Найжахливішою річчю що крилася у цих Двох Хвилинах Ненависті було те , що нікого не примушували грати свою роль , навпаки , було не можливо уникнути цього та не приєднатися до них .	крилася	3	Fem
А Сара не безчестила фараона , вона більше того , зробила йому честь , ставши під його владу .	зробила	10	Fem
Вона одчинила .	одчинила	1	Fem
Щоразу , коли вертоліт знижувався і заходив на близьке коло , ми маскувалися серед ялівців , потім перебігали схилом далі і знову мусили ховатися .	знижувався	4	Masc
Вже через місяць я опинився в армії , і на дверях казарми було написано , що заради радіологічної безпеки слід кожних півгодини змочувати шмату на порозі казарми , а провітрювати приміщення лише уночі впродовж п’яти хвилин .	опинився	4	Masc
Знаю ще таке : коли дитину вперше купають то воду після купелі слід виливати коли не стемніло і обов"язково під родюче дерево ( щоб продовжувався рід ) .	продовжувався	24	Masc
— Щоб ти цю ніч уловив золотого зайця і раненько щоб приніс мені в хату .	уловив	5	Masc
З четвертого знову хотілося напитися .	хотілося	3	Neut
Гра називалася « на кого Бог пошле » .	називалася	1	Fem
Все , що стосується бюджету , виплат зарплат , закупівель МАУ , нафтопереробки , ГОКів , феросплавних заводів , здійснювалося через банк .	здійснювалося	19	Neut
Маленький смугастий звірок , що сидів собі навпочіпки на поваленій кедрині проти сонечка і пильно , з виглядом ученого дослідника , розглядав торішній грибок , тримаючи його передніми лапками , раптом нашорошився .	нашорошився	31	Masc
Дорогою їх спинив офіцер і попросився третім у кабіну вантажівки .	спинив	2	Masc
Нарешті це обридло .	обридло	2	Neut
— Давав ти веприкові їсти ?	Давав	1	Masc
Зимовими ранками він приносив нам з бабцею по келішку смереківки натще .	приносив	3	Masc
Він їй розказав те все , що йому змія загадала .	розказав	2	Masc
На підлогу пляжної кабінки хтось вилив не менше відра води , поклав мішок і жмут жіночого волосся .	вилив	5	Masc
На його городчику росла верба , привезена з Канева , стояв бюст Аполлона .	росла	3	Fem
Пішов дід , найшов ту хатку , де кинув бабину дочку .	кинув	8	Masc
Він взяв її на свої дужі крила і полетів з нею геть високо понад землею .	взяв	1	Masc
Оришка болісно піднімала її і тяжко стогнала ...	піднімала	2	Fem
Тета Міра мала складний розлад ковтання і тому варила собі переважно різні соуси .	варила	8	Fem
... Голубан затулив Зеленського , Дорн затулив Голубана , кулічі й паски затулили Дорна , сніг затулив кулічі й паски ...	затулив	16	Masc
Він же Петю і життя позбавив ) .	позбавив	5	Masc
Височенна , чотириярусна тайга , буйна й непролазна , як африканський праліс , стояла навколо зачарована .	стояла	13	Fem
Маленький і легенький Пуня вибіг на лід .	вибіг	4	Masc
Її учителем української мови був Василь Щурат , біологію викладав Мельник , а географію викладала Олена Степанів .	викладав	9	Masc
Вінстон різко отямив себе та сів пряміше .	отямив	2	Masc
На кожному поверсі , навпроти ліфтової шахти , зі стіни пильно дивився плакат з величезним обличчям .	дивився	11	Masc
Тої самої ночі , коли на моїм відтинку йшла завзятуща борня , сусідний курінь 88-го полку , зложений зі самих чехів , перейшов добровільно до москалів .	перейшов	22	Masc
Тоді авторці довелося приховувати своє ім'я через скандальну на той час історію стосунків продавчині з відділу іграшок в універмазі і старшої за неї заможної жінки , яка у цей час розлучалася з чоловіком .	розлучалася	30	Fem
Несподіваний різкий поштовх виривав тебе зі сну , жорстка долоня трусила тебе за плече , сліпуче світло різало твої очі , коло з жорстких облич стояло навколо ліжка .	стояло	25	Neut
Вийшов і вп'ять прив'язав до вугла колодочку , а сам потяг додому .	потяг	10	Masc
Саме він помагав нам з Юрком так - сяк перебувати заняття у музичній школі .	помагав	2	Masc
Вони здавались особливо смашними , і то один , то другий голосно шльопався на землю , коли сусіда занадто сильно сіпав його за палець .	шльопався	12	Masc
Анжела просто хотіла , щоби АПП ( так ми називали історичку ) пояснила текст листівки .	хотіла	2	Fem
— Мамо , — питаю після того , як куці студентські новини розказано ( сесію здав , костюм ось купив ) , — а чого тітка Марфа Яркова на мене так дивиться ?	купив	19	Masc
І Міністерство Достатку що відповідало за економічні справи .	відповідало	4	Neut
Моїх дітей він здивував тим , що страшенно спритно ловив комарів і живцем їх з’їдав .	здивував	3	Masc
Мотря утерла рукавом сльози й простогнала ...	простогнала	5	Fem
Вінстон встромив кінчик пера у ручку для пера та облизав його щоб позбутися масткого бруду .	облизав	9	Masc
Погородив він загороди великі , розбив те яйце , випустив скот і забагатів .	Погородив	0	Masc
Знала , що від’їхав Корній , і не ходила більше тратити по гаях болючих ночей .	ходила	8	Fem
Вона погостювала трохи , дала батькові грошей та й поїхала в город , купила там собі будинок і зажила панію .	погостювала	1	Fem
… Вона не впала , навіть не спіткнулася , бо це ж була людина - курган : завучка пережила в школі понад сто перевірок усіх рівнів , дві держави , чотирьох директорів .	спіткнулася	7	Fem
Під час показу у США , що розпочався 18 вересня 2015 року , протягом першого тижня фільм був показаний у 545 кінотеатрах і зібрав 7_222_035 $ , що на той час дозволило йому зайняти 5 місце серед усіх прем'єр .	зібрав	23	Masc
Ванна була повна прохолодної води , і Софі , швидко роздягнувшись , лягла у неї .	лягла	12	Fem
Татарські оселі за XV ст . були також в сучасній Бесарабії на межі або навіть за межею лісостепу — від татарського „ кишла нового “ пішла назва суч . Кишинева .	пішла	25	Fem
Вуйко Осип , який був начальником медичного поїзда УГА , а тому мав шанс закінчити медичні студії лише у Празі , добре розумів становище військових еміґрантів і скуповував картини без огляду на якість .	розумів	22	Masc
Пастух покинув сопілку і вхопився за серце .	вхопився	4	Masc
Як увійшов дід , вона зараз розказала йому все , що було , дала йому грошей :	розказала	6	Fem
Він сказав це тільки на те , щоб дочка не плакала .	плакала	10	Fem
— Оце , — каже , — дідусю , за те , що ти прийняв мене , нещасну сироту .	прийняв	14	Masc
Давно хотіла придбати " Алісу " , а тепер , коли з`явилася можливість , " товар відсутній " у київському інтернет - магазині .	хотіла	1	Fem
Я ночував у лікарні коло тата .	ночував	1	Masc
Юра звучить по-нашому , тому це ім’я підійшло братові .	підійшло	7	Neut
Той вдався не дуже добре .	вдався	1	Masc
Вона вже приземлилася обома ногами на пів’ют корабля .	приземлилася	2	Fem
І завела звичку складати графік дня , спілкуватися з людьми в рамках графіку , а потім вимикати телефон і не хвилюватися , що хтось образиться .	завела	1	Fem
А очима дивився на всіх усміхнено й вивчав кожного .	дивився	2	Masc
Усіма військовими справами ЗУНР відав ДСВС , що діяв до 9 червня 1919 року та поділявся на Військову канцелярію ДСВС і 16 відділів .	поділявся	15	Masc
( І це вперше цьогоріч я виспалася , бо спала до 1 юху )	виспалася	6	Fem
Ліжко легко вібрувало від трамваїв , і час від часу блискали сині спалахи , затиснені ущелиною вулиці .	вібрувало	2	Neut
Політрук Маркідонов дозволив мені не конспектувати лекцій політзанять , бо я міг без помилки показати на політичній мапі світу столиці всіх країн — учасниць Варшавського блоку .	дозволив	2	Masc
трохи підофігів , коли побачив , що в угорськ паспорті графа " національність " виділена жирним і більша за решту тексту О_о	підофігів	1	Masc
Мотря утерла рукавом сльози й простогнала ...	утерла	1	Fem
Мабуть , найбільш іронічним і потенційно небезпечнішим прикладом зв'язку між юнгізмом та неоязичництвом виявилася та видатна роль , яку юнгівські твори зіграли у відродженні « Релігії германців » або нордичного язичництва в Європі , Англії та Північній Америці .	виявилася	13	Fem
Поїхав , - каже Юрій Васильович , - я й зо мною Платон Кречет , Галушка й дзвонар Квазимодський із собору Паризької богоматері .	Поїхав	0	Masc
А за Пунею , який прогулював математику в парку , активісти добровільної молодіжної організації « Юні дзержинці » гналися аж до озера .	прогулював	5	Masc
Часом треба було ховатися від патруля , який обходив огорожу .	обходив	8	Masc
Андрій почервонів ( Господи , який же він дурень ! ) , а водночас зрадів , це чудесно , що він має таке знамените товариство !	почервонів	1	Masc
При повному зведенні клітора стане видно його голівку , що висунулася зі складок крайньої плоті .	висунулася	10	Fem
Але татарська людність при тому залишилася ; відомі були рештки її в румунському гінтерлянді за управою своїх султанів ( soldani ) , при цьому спостерігалося засвоювання христіянських імен — аналогічне явище треба зазначити і щодо володарів колишнього подільського улуса .	залишилася	5	Fem
Вона виривалася , і на наших руках ніколи не зникали тонкі візерунки глибоких подряпин .	виривалася	1	Fem
Один близький товариш позичив у мене дуже багато грошей і втік до Америки .	втік	10	Masc
Іноді приходив Лаціс , латиш , котрий сформував у заповіднику експериментальний загін швидкого реаґування у боротьбі з браконьєрами .	приходив	1	Masc
Але бути радянським журналістом вважалося неприпустимим , і я став ботаніком .	вважалося	4	Neut
Сільський культурник , що з марксівської науки твердо засвоїв конечність економічних передумов , прокинувся в ньому цілком .	прокинувся	13	Masc
Додавалися туфельки на шнуруванні та на голову одягався очіпок або солом'яний капелюшок .	одягався	7	Masc
Хоча за звичкою не переставав носити кастет .	переставав	4	Masc
Вона була блискуча , як рання зоря , і міняла свій вид щохвилини , як вогонь .	міняла	9	Fem
Праворуч мр . Кетлінга , себто на 849-м кріслі , сидів уже бородатий добродій , що від нього на цілу англійську милю пахло чистокровним ірландцем .	сидів	10	Masc
Одного разу він забрав у мене на вулиці рештки морозива .	забрав	3	Masc
Довжина панталон вкоротилася до половини литки .	вкоротилася	2	Fem
От хазяїн його взяв та й вивіз у ліс , думає : « Нащо він мені здався , тільки дурно буду годувати , — нехай лучче в лісі ходить » .	здався	16	Masc
Сьогодні зранку - зранечку , зранечку - зісвітаночку Славік залетів у школу й на коридорі , наче велосипедист у коня ( Equus ) , врізався в завучку Надію Петрівну Проскурню .	залетів	9	Masc
В травні вісімдесят шостого ми не могли зрозуміти , чому не можна їсти зелену цибульку , на якій навіть не з’явилося жодних плям .	з’явилося	20	Neut
І пір'я не все повилазило , і взагалі тушка якась покоцана .	повилазило	4	Neut
Потім довго нюхав свої пальці , ледь стримуючись від спокуси спробувати їх полизати .	нюхав	2	Masc
Та вона може заперечувати , брехати , замовчувати , що перетворилась на звьозд штучних , яких багато , повелась на таке .	перетворилась	10	Fem
Чорт перелякався і почав просити чоловіка :	перелякався	1	Masc
Коли я стояв на варті в автопарку із законсервованими тягачами , на пост прилетів зранений бузьок .	прилетів	13	Masc
Киця ходила у пуделко з піском , постійно щось там загрібала , а дзядзьо надто сильно відчував уночі запах її непомитих лап .	загрібала	10	Fem
Йому все зробили , і він призначив зустріч для передачі конверта за годину по тому , як відлетів його літак .	відлетів	17	Masc
Це пояснювалося вологим кліматом .	пояснювалося	1	Neut
Крім світлин , я крав рогалики у хлібній крамниці .	крав	4	Masc
Це була жахливо величезна пірамідальна будівля з блискучого білого бетону , що здіймалася , тераса за терасою , на триста метрів угору .	здіймалася	12	Fem
Пішла вона , набрала борошна , замісила , затопила в печі й почала варити вечерю .	Пішла	0	Fem
Кращі , ніж на сході , фізично - географічні умови сприяли концентрації степовиків саме в районі Дністрянсько - Дунайському , як це спостерігалося за часів Ногая .	спостерігалося	22	Neut
Яґіч підсумовував уже 1884 р . : " Як не припускати для XI століття повного розвитку руських наріч , коли вже різні дрібниці їхні ясно прозирають із пам’яток .	підсумовував	1	Masc
Дзядзьо тим часом стукав якимось патиком у стелю , бо думав , що тамтешні діти їздять серед ночі на ровері , а мама питалася у брата , нащо він трясе ліжком .	стукав	3	Masc
Маленька рудувата жіночка , що працювала у наступній до Вінстонової кубікулі , сіла поміж ними .	сіла	12	Fem
Мокрий , він поліз під матір , але не міг там довго висидіти виглядав то з-під крила , то спереду , вилазив на спину або біг геть і націлявся на стіні на поважну чорну муху .	виглядав	13	Masc
На дельтаплані була відеокамера , що подавала зображення на наземний монітор , який розрізняв шістдесят відтінків кольорів .	розрізняв	13	Masc
Я дуже любив молоко .	любив	2	Masc
Він дуже струнко сидів на стільці , його могутня грудна клітина роздувалася та тремтіла так ніби у ній вирував штормовий океан .	тремтіла	13	Fem
Там хтось кохався .	кохався	2	Masc
Якраз почалася епоха невиплат заробленого .	почалася	1	Fem
На одного воно глянуло коханими очима , іншому заблищало золотом , іншому засіяло світлом слави .	засіяло	12	Neut
От і в суботу довелось викликати наряд .	довелось	4	Neut
А він говорив тим своїм усміхненим поглядом : « Не кваптесь , друзі мої !	говорив	2	Masc
Жахаючись тої страшної хуртовини , яка тоді часто й густо підіймалася , материне серце боялося , щоб Івась у іграшках , бува , не привчився до неї .	боялося	14	Neut
Поплював у руки , взяв сокиру та коли гупнув обухом по бабиному залізному носі , той переломився .	взяв	4	Masc
Жінка нахилила горня , аби вилити чай у вазон , але в останній момент зупинилася .	нахилила	1	Fem
Внизу , під кедриною , виходячи десь з бур’янів і вітролому і зникаючи знов у бур’янах та каміннім розсипу , вилась вузенька стежечка , звірина доріжка , утоптана за тисячоліття .	вилась	20	Fem
Цього ґатунку ніхто не знав , інфляція знецінила їх до вартості сірників , і я курив найкращі французькі сиґарети кілька місяців , коли був безробітним .	знецінила	7	Fem
— У чоловіка навчилася ?..	навчилася	3	Fem
Москалі значною силою відкинули мадярську частину , що кинулася у паніці до втечі .	кинулася	8	Fem
Спустилася ніч ; викликала собі на втіху зорі ; викотився з-за гаю місяць — і став оглядати околицю ...	Спустилася	0	Fem
От вона вийшла та й гукає :	вийшла	2	Fem
Раптом далеко перед ним щось блиснуло .	блиснуло	5	Neut
Дзядзьо не надто знався на суспільних і державних системах , але вірив у сталість людської природи .	знався	3	Masc
Традиційно кажу спасибі всім , хто дочитав моє полотно .	дочитав	6	Masc
Змія встає та й дивиться , що все так ізроблено , як вона йому загадала .	загадала	14	Fem
Я підрахував , що витрачаю в середньому до 10 € в день .	підрахував	1	Masc
Тета Міра купувала в « Дружбі » неймовірну кількість книжок .	купувала	2	Fem
Запріг він коня , приїхав додому та й каже :	приїхав	4	Masc
Там спустився злий дух , — і збіжжя вигоріло , мов від огню , овоч на деревах почорнів , трави пожовкли , квітки посохли , стала пустиня .	почорнів	17	Masc
Для початку , він зовсім не розумів з якою саме метою написав саме 1984 .	розумів	6	Masc
Щось у його обличчі казало про це неспростовно .	казало	4	Neut
Нове покоління хотіло непорівнянно ширших горизонтів , повноправного представлення своєї творчості перед « світовим ареопагом » .	хотіло	2	Neut
Я та й то плюнув на них у своїй « Камені » в примітках до латинських перекладів .	плюнув	4	Masc
Олександра після цього довго соромилась глянути учителеві в вічі .	соромилась	4	Fem
Здійнявся з лона землі сивим туманом і холодною хмарою полинув над землею .	полинув	9	Masc
... Голубан затулив Зеленського , Дорн затулив Голубана , кулічі й паски затулили Дорна , сніг затулив кулічі й паски ...	затулив	2	Masc
Коли подзвонила , не відповіли , написала на пошту те ж саме .	подзвонила	1	Fem
Дівчинка навчилась вирізати ножицями гнійні рани , заки три дні чекала на Каракєджбу , якого посадили на губу за те , що зачинив кількох нестаранних солдатів у пивниці з відкритими бочками лізолу .	навчилась	1	Fem
Довкола були яблуневі сади , і начальник медчастини прапорщик Бек вливав кожному , хто надкусив яблуко , десять літрів води з марганцівкою .	вливав	10	Masc
Нарешті офіцер оголосив тост за успіх угорської кампанії .	оголосив	2	Masc
Хотів відігнати , а вона тої ж хвилини щезла .	щезла	8	Fem
Коли його й не преміювала французька академія , то знайшла щось похвалити закостеніла тепер Гонкурівська .	преміювала	4	Fem
Надавав рибиною по мордасах .	Надавав	0	Masc
Тому людина і перейнялася .	перейнялася	3	Fem
Хірург погодився працювати в парі , і ми разом , тримаючи сина і голку , вдало наклали кілька швів .	погодився	1	Masc
З вагона потяга Львів — Адлер я дивився на Східну Україну .	дивився	7	Masc
Отець доктор Лаба у двадцятих був духівником у гімназії сестер василіянок , де вчилася тета Міра , а в сорокових був духівником — у дивізії « Галичина » , де служив дзядзьо Михась .	служив	30	Masc
Я промивав його рану і заразився тим ґатунком гепатиту , який подібно до сніду передається лише статево або через кров .	заразився	5	Masc
Пішов до праці і зовсім забув за веприка і грис .	забув	5	Masc
Про коломийську гімназію я знав від п . Мелетія Кічури , з яким часто і приязно зустрічаюся тут , у Києві .	знав	4	Masc
Ото побув півроку та задумав жениться .	побув	1	Masc
Якщо хресним \ ою стала людина яка насправді не була охрещеною і сама являється противником християнства , то наскільки прикольним є цей випадок ?	стала	4	Fem
Пан Коцький злякався кабана , скочив на дерево та й подерся туди , де ведмідь сидів .	подерся	10	Masc
— Заждіть ! — волосся їй розкошлалось ; виглядала як безумна .	розкошлалось	6	Neut
Уже значно пізніше у тому басейні працювала тренеркою молода жінка , яка закохалася в мого знайомого .	працювала	6	Fem
Тут слово « тітка » позначало японців , « Оля » позначало — провідника націоналістичної групи .	позначало	11	Neut
І відкіля це лихо взялося ? і чого воно до них вчепилося ? чим була Мотря Остапові ?.. чим вона тепер осталася ?..	взялося	4	Neut
Ще перед відкриттям біля каварень утворювалася черга .	утворювалася	5	Fem
Тепер же він побачив яка Дені чудова і хороша , все-таки вона заради нього ризикнула життям , драконами , і одного втратила .	ризикнула	14	Fem
Востаннє тато закурив у передостанній лікарні , просто у палаті , якось так пускаючи дим стіною , що він збирався під самою стелею , не поширюючи жодного запаху .	закурив	2	Masc
Якраз у листопаді п’ятдесят шостого загинув дідо Мар’яни .	загинув	5	Masc
На стройовій підготовці він любив дати команду тримати п’ятнадцять хвилин піднятою одну ногу .	любив	4	Masc
Сьогодні зранку - зранечку , зранечку - зісвітаночку Славік залетів у школу й на коридорі , наче велосипедист у коня ( Equus ) , врізався в завучку Надію Петрівну Проскурню .	врізався	24	Masc
Артистка , яка читала тексти , теж не бачила , тому на цьому місці запнулась .	бачила	8	Fem
Регіт стих ; усі похнюпили очі у землю ; одна тільки Галя гостро дивилася на всіх гультяїв — і червона краска грала на її щоках , тоді як серце підкидалося в грудях , а груди поривчато дихали .	дивилася	13	Fem
І просить батько того діда , щоб прийняв його дочку .	прийняв	7	Masc
Тепер же він побачив яка Дені чудова і хороша , все-таки вона заради нього ризикнула життям , драконами , і одного втратила .	втратила	21	Fem
Небіжка часто приходила до нас , вони з дзядзем сиділи вечорами на лавці під сливками .	приходила	2	Fem
Він , за рекомендацією авторитетної особи , домовився з ними , що заплатить великі гроші за свою візу .	домовився	7	Masc
Напрацювалася й натягнулася .	Напрацювалася	0	Fem
Вона глянула ще раз на Мотрю , поступилася назад , простогнала , сіла мовчки на піл , узявшись холодними руками за крайню дошку , щоб не впасти .	глянула	1	Fem
Далі у такий же спосіб мішками з глиною « підмуровував » невеличку основу .	підмуровував	9	Masc
Закриймо очі на те , що поломку “ Заповіта ” списали на безглузду причину типу “ на мою машину посвітило вранішнє сонце , тому в мене пом’явся кузов і фари розбились ” .	пом’явся	26	Masc
У місті Бучачі якийсь час діяли водночас 2 ГЕС : одна називалася міською ( вважалася комунальною ) , інша називалася — « на Топольках » , яка після відновлення діє й нині .	називалася	11	Fem
При цьому безперервно курив .	курив	3	Masc
Моїх дітей він здивував тим , що страшенно спритно ловив комарів і живцем їх з’їдав .	з’їдав	14	Masc
Хто раз бачив його , той не забував його до смерті .	забував	7	Masc
Їхня чорна баня стояла просто над Пслухом .	стояла	3	Fem
Виявилося , що Новаківський дуже боїться за свої роботи .	Виявилося	0	Neut
Вона впала на високу гору , і на горі спалахнуло світло , горіло і вабило серце .	спалахнуло	9	Neut
Він зовсім забув , що тільки тиждень минув , як покинув село .	покинув	10	Masc
Внизу , по землі , слався мох , пообростав усе , що тільки можна .	слався	5	Masc
Але він уже не слухав — перед ним підносилася велетенська темна стіна , більша за все , що він здолав досі , й він сказав тій , що не пускала його туди , втримуючи при життю :	сказав	24	Masc
Варто зазначити , що Валентин Щербачов — володар відзнаки « Всенародне визнання » Спілки журналістів України , у 1992 - 1999 роках очолював Федерацію спортивних журналістів України .	очолював	22	Masc
Перед тим , як повіситися , пані Ірця принесла до нас свою колекцію срібного начиння і попросила , щоби ми віддали його урядові незалежної України .	принесла	8	Fem
Він постукує пальцями по столу , розмова зайшла в глухий кут .	зайшла	7	Fem
хотіла натиснути реплай , а видалила комент )	хотіла	0	Fem
Він , рижий , з маленькими гострими очима , упиром упився в її соковите дівоцтво і висмоктав з нього перші найсолодші соки .	висмоктав	16	Masc
Ісус ловив рибу .	ловив	1	Masc
Вийшла , обійшла кругом хати — нема батька .	Вийшла	0	Fem
Він влаштовував банкети і скандальні сцени ревності .	влаштовував	1	Masc
В мене мама хрестила в сестри , а потім сестра хрестила в мами .	хрестила	3	Fem
Офіцер пояснював , що , почувши розмову угорською , зрозумів , що його хочуть убити , тож він захищався .	захищався	18	Masc
Ця рухливість дна вказує , що воно ще доліплювалось до стін посудин додатково .	доліплювалось	8	Neut
Розвиднялося у мене на душі .	Розвиднялося	0	Neut
— От так ! — прошепотів хтось до когось за спинами товаришів .	прошепотів	5	Masc
З перегляду іншого посуду — з рівним дном , виразно означеним випливало , що взагалі цей посуд спочатку не мав дна , яке додатково вліплювалося .	вліплювалося	24	Neut
Кримінальна поліція Мукачева провела ряд оперативних заходів та встановила , що цю крадіжку скоїв 33-річний непрацюючий мукачівець .	скоїв	13	Masc
Натерпілася страху Мотря од тих хитрих спросів та переспросів ; набралася горя Оришка , глядя на свою дитину .	набралася	10	Fem
Це трапилося того ранку у Міністерстві , якщо про щось таке нечітке та туманне можна сказати що воно трапилося .	трапилося	1	Neut
Пожовкло в Мотрі у віччю , заколихався світ , пішло все ходором ...	заколихався	6	Masc
Той чоловік і випустив його з хати .	випустив	3	Masc
Може , коня убив ?	убив	3	Masc
Швидко він зживався з новим своїм місцем на старій землі — і підвертав її під себе : вона йому плодила , родила — ставало на пожиття його !	плодила	19	Fem
Ще видав нотну збірку « Напівник церковний » .	видав	1	Masc
Мотря повернулася , вийшла .	вийшла	3	Fem
Маленька рудувата жіночка перетворилася на яскраво рожеву , її рот відкривався та закривався неначе у риби що потрапила на суходіл .	потрапила	17	Fem
Не раз заявляв про наміри зайти на наш ринок ірландський Ryanair .	заявляв	2	Masc
Дівчинка навчилась вирізати ножицями гнійні рани , заки три дні чекала на Каракєджбу , якого посадили на губу за те , що зачинив кількох нестаранних солдатів у пивниці з відкритими бочками лізолу .	чекала	10	Fem
Як розповів іноземець , він повертався додому з Російської Федерації , і в автобусі познайомився з чоловіком , з яким вони дорогою вживали амфетамін .	познайомився	14	Masc
Терра Маріана проіснувала до 1561-го , коли її поділили між собою Швеція і Велике князівство Литовське	проіснувала	2	Fem
Та чорт таки вирвався .	вирвався	3	Masc
Примітно , що саме The Economist першим заговорив про можливість як перевищення ціною за барель 100-доларової позначки , так і наближення до 200-доларової .	заговорив	7	Masc
Ухватила її , полізла на піч , забралась аж у самий куточок та й з'їла її , а кісточки забрала в торбинку й повісила на жердочці .	полізла	3	Fem
Дзядзьо переконував його , що жолудь набагато кращий , бо ним не можна нікого покалічити .	переконував	1	Masc
Вона погостювала трохи , дала батькові грошей та й поїхала в город , купила там собі будинок і зажила панію .	поїхала	9	Fem
— Ми всі тут голі , як святі , бо душно й пітно від тісноти , та й попріло все у нас .	попріло	18	Neut
Возикові тільки замітувався зад то в один , то в другий бік .	замітувався	2	Masc
Так само без слів офіцер вийняв пістолет і застрелив Мар’яниного діда .	вийняв	5	Masc
Тріснула гілка .	Тріснула	0	Fem
Прийшов кінець і соняшному квітневому дню , і все товариство опинилося під піччю .	Прийшов	0	Masc
У тому барі при довгій стійці постійно сиділо кілька відвідувачів .	сиділо	7	Neut
— Та кажи !.. чого ти плачеш ? — аж скрикнула вона .	скрикнула	10	Fem
Але татарська людність при тому залишилася ; відомі були рештки її в румунському гінтерлянді за управою своїх султанів ( soldani ) , при цьому спостерігалося засвоювання христіянських імен — аналогічне явище треба зазначити і щодо володарів колишнього подільського улуса .	спостерігалося	24	Neut
Чи вона пізнала своїх дітей ?	пізнала	2	Fem
Та зараз йому й загадала :	загадала	4	Fem
Міністерство Правди містило , як казали плітки , три тисячі кімнат від першого до останнього поверху , та відповідну за розмірами розгалужену підземну систему .	містило	2	Neut
А наш дах у Делятині попросту протікав .	протікав	6	Masc
" Курбас блискуче провів свій дебют і був нагороджений оплесками глядачів , – згадує актриса Ганна Юрчакова виступ театру " Руська бесіда " у Самборі 1912 року .	провів	3	Masc
Тих , що залишалося , все ж набралося кілька тисяч .	залишалося	3	Neut
Португальці вимагали , щоб напасники залишили острів ; але їх ніхто не слухав .	слухав	12	Masc
Тоді дзядзьо вискочив на переповнений стіл , пробіг ним , не зачепивши жодного тареля , жодного келішка , жодної фляшки , перескочив через ще якихось людей і пішов додому .	перескочив	21	Masc
Дещо пізніше почав використовуватися довгий полотняний халат , що стягався біля шиї , або перев'язні поясом на талії туніки .	стягався	9	Masc
Чумарка могла бути довжиною до коліна або інколи довжиною до середини стегна .	могла	1	Fem
Київська ОДА виявилася чи не першою , яка намагалася вплинути на перевізників .	намагалася	8	Fem
Йому нарадили одну гарну дівку , щоб він її брав ; він за ту й забув , що його врятувала від змії , з іншою заручився .	врятувала	19	Fem
Пожовкло в Мотрі у віччю , заколихався світ , пішло все ходором ...	Пожовкло	0	Neut
Андрій помовчав , подивився пильно на того , що питав , посміхнувся й раптом викарбував :	питав	9	Masc
Пістрота кидалась в вічі .	кидалась	1	Fem
У середньовічній Європі , де панувала християнська мораль , купання довгий час не дозволялося взагалі , бо це суперечило християнським поглядам на тіло та гігієну .	дозволялося	13	Neut
Вона й його добре держала в руках , і він її боявся , як той боїться ладану .	держала	4	Fem
У свою чергу речник Манафорта Джейсон Малоні відмовився коментувати дані повідомлення .	відмовився	7	Masc
Як завжди , обличчя Еммануеля Гольдштейна , Ворога Народу , спалахнуло на екрані .	спалахнуло	10	Neut
Після вистави ми з Юрком мусили роздавати акторам стоси височенних ромашок , які вчитель попередньо приносив у відрі з водою зі свого городу .	приносив	15	Masc
« Я б і начхав , але друзі - юристи радять подавати позов , випробовуючи судову систему на захисті прав людини .	начхав	4	Masc
Усе , що не відповідало радянським уявленням про корисність ( інші функції мистецтва майже не бралися до уваги , воно мало лише виховувати лояльних до влади громадян ) , цензурувалося , замовчувалося .	цензурувалося	29	Neut
Та як буде питаться тебе , чи не бачив парубка й дівки , чи не йшли сюди , то ти скажеш , що тоді , як ця пшениця сіялась .	сіялась	28	Fem
Приїхали туди , чоловік той випряг коня , пустив його пастись , а сам зрубав дуба товстого - претовстого , розколов його до половини та й каже до злиднів :	випряг	5	Masc
Ці фрагменти — вочевидь , усе , що залишилось нам від “ Прометея 2 ” — надто вже виділяються на тлі океану кретинізму , що панує в “ Заповіті ” .	залишилось	8	Neut
Вашого листа одержав і щиро Вам за нього вдячний .	одержав	2	Masc
Особливо тоді , коли один політичний потрапляв у цілий вагон кримінальних .	потрапляв	6	Masc
І дійшло до того , що Марія часом не приходила на ніч додому .	дійшло	1	Neut
Вийшов із землянки , взяв колодочку , прив'язав до вугла , а сам потяг додому .	прив'язав	7	Masc
спочатку розчепірила ноги , потім щось в кущах робила , потім дитятко дельфіна .... ???	розчепірила	1	Fem
Вийшла , стала на порозі та й гукає :	Вийшла	0	Fem
І відкіля це лихо взялося ? і чого воно до них вчепилося ? чим була Мотря Остапові ?.. чим вона тепер осталася ?..	вчепилося	11	Neut
До 1999 р . діяла гідрошахта Шахта « Піонер » .	діяла	4	Fem
Дзядзьо наливав його в екзотичні фляшки — кілька з них мали витиснений на склі імперський герб — відзнаку постачальника цісарсько - королівського двору — і складав лежма на полиці у найбільшій пивниці .	наливав	1	Masc
Як наслідок , процеси звукозмін висмикувалися з відповідного фонологічного контексту ; їхнє реалістичне історичне витлумачення робилося неможливим , а цілій концепції історичної фонології загрожувала небезпека перекручень .	загрожувала	23	Fem
Дзядзьо тим часом стукав якимось патиком у стелю , бо думав , що тамтешні діти їздять серед ночі на ровері , а мама питалася у брата , нащо він трясе ліжком .	питалася	23	Fem
Тому , якщо вона там робила щось , то явно це пішло її на користь .	пішло	11	Neut
Він їй розказав те все , що йому змія загадала .	загадала	9	Fem
Той , хто йшов позаду , теж брав один рогалик у руку , а ще кілька закладав у каптур першого .	йшов	3	Masc
Яскрава , прекрасна та жвава галюцинація спалахнула у його свідомості .	спалахнула	6	Fem
Після операції доктор почастував мене спиртом , вітаючи з ініціацією , і дав п’ятдесят тисяч на таксі , бо швидка вже давно поїхала на свіжі виклики .	почастував	3	Masc
На дельтаплані була відеокамера , що подавала зображення на наземний монітор , який розрізняв шістдесят відтінків кольорів .	подавала	6	Fem
Відворот сумежних частин потягнув за собою і мою частину .	потягнув	3	Masc
Натомість Зілинський , прекрасний діалектолог , де-не-де у своїх діалектних дослідженнях наважувався робити висновки історичного ґатунку , що ніяк не підтверджувалися пам’ятками й залишалися чистісінькими спекуляціями ( які він сам пізніше мусив спростовувати ) .	мусив	31	Masc
Йому все зробили , і він призначив зустріч для передачі конверта за годину по тому , як відлетів його літак .	призначив	6	Masc
Тоді організація втратила загиблими і страченими чотирьох бойовиків .	втратила	2	Fem
" Наша нарада в Криму знову підтвердила спільну рішучість зберегти й посилити в майбутній мирний період ту єдність мети і дій , що зробила в сучасній війні перемогу можливою і безперечною для Об'єднаних Націй .	зробила	23	Fem
У якомусь місці всі пасажири — хоч ще хвилину тому здавалося , що неможливо навіть ворухнутися — стали на коліна і почали молитися , закриваючи руками лице .	здавалося	10	Neut
Сільський культурник , що з марксівської науки твердо засвоїв конечність економічних передумов , прокинувся в ньому цілком .	засвоїв	8	Masc
Тому я сиділа на підвіконні кав’ярні , пила міцний чорний чай з м’ятою і малювала вже внутрішній Казімеж .	пила	7	Fem
А Сара не безчестила фараона , вона більше того , зробила йому честь , ставши під його владу .	безчестила	3	Fem
Мокрий , він поліз під матір , але не міг там довго висидіти виглядав то з-під крила , то спереду , вилазив на спину або біг геть і націлявся на стіні на поважну чорну муху .	біг	25	Masc
Щоранку я пив воду з одного , лице мив у другому , зуби чистив у третьому .	чистив	13	Masc
З неба покотилася велика блискуча зоря .	покотилася	2	Fem
Той , хто йшов позаду , теж брав один рогалик у руку , а ще кілька закладав у каптур першого .	закладав	16	Masc
У більшості випадків дослідник повинен насамперед з’ясувати , якої мовної та правописної системи дотримувався автор або переписувач , а відтак розглянути відхилення від цієї системи .	дотримувався	13	Masc
Несподіваний різкий поштовх виривав тебе зі сну , жорстка долоня трусила тебе за плече , сліпуче світло різало твої очі , коло з жорстких облич стояло навколо ліжка .	виривав	3	Masc
– Уважайте на нього , щоб не покинув університету і не вступив до театру , – звертається колишня актриса театру " Руська бесіда " у Львові Ванда Янович до Хоми Водяного .	вступив	11	Masc
Я промивав його рану і заразився тим ґатунком гепатиту , який подібно до сніду передається лише статево або через кров .	промивав	1	Masc
Цей підрозділ формувався на основі добровольців від політичної партії " Братство " Дмитра Корчинського .	формувався	2	Masc
Amazon подав заявку на патент цього способу доставки 14 лютого .	подав	1	Masc
Її там не впізнали , і як уже вона розказала все , то мачуха аж об поли вдарилась , що , бач , вона думала її з світу зігнати , а тут зовсім не так вийшло ...	вийшло	35	Neut
Огидний екстатичний транс зі страху та мстивості , бажання вбивати , катувати , трощити пики кувалдою , здавалося кружляв поміж усією цією групою людей неначе електричний струм , перетворюючи всіх і кожного на кривляючогося , верескливого божевільного лунатика .	здавалося	17	Neut
Знала , що від’їхав Корній , і не ходила більше тратити по гаях болючих ночей .	Знала	0	Fem
Саме в такій редакції ( просто підтримати , без подальших наслідків та дій ) радив поставити на голосування питання член земельної комісії Вадим Андрієвський .	радив	14	Masc
Але навіть це було пам’ятною подією серед суцільної самотності у якій він мусив жити .	мусив	12	Masc
Міський голова поставив на голосування пропозицію депутата Андрія Саука підтримати петицію і доручити юридичному відділу міськради звернутися до прокуратури та з позовом до суду .	поставив	2	Masc
Чув і знав .	знав	2	Masc
А здається у 97-му Кохана розбилася під час шторму , коли стояла пришвартована ...	стояла	11	Fem
Воно випромінювало хворобливий , нудотний та маслянистий запах наче китайська рисова горілка .	випромінювало	1	Neut
Господи , — майже крикнула , — та чи ж ви не розумієте , що його ви не вб’єте ?	крикнула	4	Fem
Ідея документа під назвою « Декрет № 3 « Про запобігання соціальному утриманству » з’явилася 2014 року , а реалізовувалася 2015-го , коли він був підписаний .	з’явилася	14	Fem
Я не малюватиму вам щастя матері , коли тріснула перша шкарлупина і звідти почулось жалібне хлипання немовляти .	почулось	13	Neut
2007-го здобув ступінь магістра політичних наук того самого вишу .	здобув	1	Masc
Будь ласка відгукніться ті , хто переходив в Могилянку з Острозької академії або хоча б підкажіть , де таких можна знайти ?	переходив	6	Masc
Тоді гарячий солодкий чай діяв як наркотик .	діяв	4	Masc
Потім принесла міхи й повела чоловіка до підземної комори .	принесла	1	Fem
Поблагословила дочку :	Поблагословила	0	Fem
Автомат називався АКСУ .	називався	1	Masc
На все витратив 500 гривень .	витратив	2	Masc
З раннього віку я не любив праці .	любив	5	Masc
смачнішої піци я не їв - смак хліба , ніби колись у бабці .	їв	4	Masc
Тету Міру це нервувало .	нервувало	3	Neut
— Зробити таку машину прикортіло весною , — тим часом розказує Володя .	прикортіло	4	Neut
Ціле дитинство я ще й записував на внутрішньому боці паска назви усіх міст і місць , в яких бував .	записував	5	Masc
Я фреш , але вже прочитав , що за одну " двійку " виганяють .	прочитав	5	Masc
Сніги були тими роками такі , що доводилося лопату до снігу брати на ніч до хати .	доводилося	7	Neut
Легесенько надушуємо волосся на потилиці та за вухами , щоб , коли притуляємося та зближуємо голови , випромінювався запах .	випромінювався	17	Masc
Він пропонував одружитися , але тета Міра навіть думати про таке не збиралася , бо Галан постійно шпортався і падав на усіх гірських стежках .	пропонував	1	Masc
Камінь цюкнув павука по голові — й той , знепритомнівши , звалився з дерева й гепнувся на землю , задерши лапи .	звалився	11	Masc
Увійшов — нема нікого .	Увійшов	0	Masc
Тоді Мікі варив справжній чифір .	варив	2	Masc
Він довго не міг заспокоїтись після цієї пригоди , але це не пошкодило йому за хвилину вскочити по пояс у миску з водою , яку всі тепер учились пити .	пошкодило	12	Neut
Їй подобалось лишатися незворушеною , коли юнаки одверто виявляли схвильовану змисловість і молоде збудження .	подобалось	1	Neut
Щоби якось компенсувати втрату , його мама влаштувала мене нічним сторожем і двірником у дитячий садочок .	влаштувала	7	Fem
Коли вона хворіла , я залишався там на ніч .	хворіла	2	Fem
Праця нищить митця , вважав я , і намагався їй якнайменше приносити в жертву свій час , бо найголовніше – творчість .	вважав	4	Masc
Пожовкло в Мотрі у віччю , заколихався світ , пішло все ходором ...	пішло	9	Neut
Час від часу Джон їздив автостопом до Ноттінгему по пенсію .	їздив	4	Masc
Інше вікно виходило на внутрішнє подвір’я нечинного костелу Миколая .	виходило	2	Neut
Ще дзядзьо вигадав таку систему , що драбина на стрих піднімалася й опускалася прихованим тросиком .	піднімалася	10	Fem
Ізв’язав і закинув у воду .	Ізв’язав	0	Masc
Навіть жорстке обличчя О’Браєна щільно почервоніло .	почервоніло	5	Neut
По мовчанці мр . Віллі Морріс запримітив мимоходом , що з нагоди неділі здалося б у відповідний спосіб перебути сьогоднішній вечір .	здалося	13	Neut
Баба перебила їй і другу ногу .	перебила	1	Fem
Витягав мене з ліфтової шахти за шиворот .	Витягав	0	Masc
Офіційно наш батальйон називався МУ і Пр .	називався	3	Masc
Мотря не переставала плакати .	переставала	2	Fem
Ліків на той час майже не було , і доктор наказував нам їсти багато кавунів .	наказував	10	Masc
Вчора отримав восьму частину Гаррі Поттера і щойно її дочитав .	дочитав	9	Masc
Треба зазначити , що питання петиції розглядала земельна комісія , яка рекомендувала її підтримати .	розглядала	6	Fem
Вся камера пирснула , скинулась від несподіванки й обернулася до того , що ставив запитання .	обернулася	8	Fem
Я нічого не сказав про ростовських , він оглянув мої вени і припустив зараження під час прийому в стоматолога .	припустив	12	Masc
І своє тодішнє листування з амер . редакторами я теж зберегла - колись непоганий іст . документ буде .	зберегла	10	Fem
Ми не в змозі встановити , в який саме точний момент часу накопичення змін спричинило якісний стрибок чи коли саме виник суб’єктивний первень , а отже й коли саме закінчився інкубаційний період і виформувалася самостійна українська мова .	закінчився	29	Masc
Так само без слів офіцер вийняв пістолет і застрелив Мар’яниного діда .	застрелив	8	Masc
Один із них злегка нагнувся і при допомозі другого насадив на свої плечі скоростріл .	нагнувся	4	Masc
Він завжди просив усіх якнайбільше розповідати про мотоцикли і про відчуття жіночого тіла .	просив	2	Masc
І не розходилась та пісня по світу , не окликалася луною в лузі , як соловейкова , а , як важкий камінь , налягала на душу , морочила голову цілим роєм темних гадок , пекла серце нерозважною тугою ...	морочила	27	Fem
Він пролітав над горами - полонинами , де паслися отари великі , де розкинулись табори людські , там він з’явився густим мороком , лихою заразою .	пролітав	1	Masc
Ми не в змозі встановити , в який саме точний момент часу накопичення змін спричинило якісний стрибок чи коли саме виник суб’єктивний первень , а отже й коли саме закінчився інкубаційний період і виформувалася самостійна українська мова .	виформувалася	33	Fem
Я сказав : « Тоді мені нікуди йти » .	сказав	1	Masc
Злий дух вернувся у підземну країну і ждав .	ждав	7	Masc
Наша команда сиділа внизу на лавці , і в кадр потрапили лише різнокольорові коліна , юнайтет колор .	сиділа	2	Fem
Люди стрибали на своїх місцях униз та вгору та горлали на всю горляку намагаючись заглушити зводячий з розуму , блеючий голос , що лунав з екрану .	лунав	23	Masc
Тоді тета Міра ледве вижила .	вижила	4	Fem
Погородив він загороди великі , розбив те яйце , випустив скот і забагатів .	розбив	5	Masc
Виявилося , що то були два долари .	Виявилося	0	Neut
Повів бідний його у ліс на те саме місце , де він злиднів покинув .	Повів	0	Masc
Зелена кава залишала особливі плями на тарілочках .	залишала	2	Fem
Каракєджба придумував спеціальні вправи — висіти на перекладині вниз головою , бігати смугою перешкод із зав’язаними очима .	придумував	1	Masc
Дзядзьо натомість не любив романів .	любив	3	Masc
Ми вже два роки б'ємося з такою халтурою і вживаємо всіх сил , щоб дати для цього путящу книжку , де б не пахло ладаном , ні словоблудієм і де б ти міг знайти багато цікавих для себе речей .	пахло	23	Neut
Мотря не озивалася ; плакала мовчки .	плакала	4	Fem
Брала зернятка каши і знов випускала їх з рота , боячись , щоб не проковтнути ненароком коштовної страви .	Брала	0	Fem
Ухватила її , полізла на піч , забралась аж у самий куточок та й з'їла її , а кісточки забрала в торбинку й повісила на жердочці .	повісила	23	Fem
У нас у Керелівці всі свято впевнені , що Тарас народився таки в нашому селі , а не в Моринцях .	народився	10	Masc
Там не було електрики , і вона щовечора декламувала Цвєтаєву при нафтовій лампі .	декламувала	8	Fem
Крім того , читаючи цю статтю , О . Кандиба додав усно цілий ряд приміток і пояснень .	додав	10	Masc
Звідти йшов до кавової .	йшов	1	Masc
Шевченко каже : Думав доля зустрінеться , спіткалося горе .	спіткалося	7	Neut
Одна з версій - вирвалась і втекла .	вирвалась	4	Fem
Ждала вона , ждала , далі дума : « Піду подивлюсь , де він » .	ждала	3	Fem
Натомість забудовник зобов’язався передати 10 % збудованих площ Обухівській міськраді і ДП “ Київлісгосп ” .	зобов’язався	2	Masc
Чумарка прилягала до стану і знизу поширювалася зборами .	поширювалася	6	Fem
1968 року було запущено OAO - 2 , яка здійснювала спостереження ультрафіолетового випромінювання зірок і галактик аж до 1972 року , значно перевищивши розрахунковий термін експлуатації в 1 рік .	здійснювала	9	Fem
Вона набрала собі всякого добра і вилізла в ліве вухо .	вилізла	6	Fem
Твоє ім’я видаляли з усіх реєстрів , кожен запис про те що ти коли-небудь робив начисто стирався , в одну єдину мить саме твоє існування повністю заперечувалося , а згодом і забувалося повністю .	забувалося	31	Neut
Деґрадація сягнула такого рівня , що багато наших місцевих сімей влаштовувало домашні гостини першого травня і сьомого листопада .	сягнула	1	Fem
Пів на третю ночі я дописала статтю і через помилку Віндоус жодного слова не збереглося .	дописала	5	Fem
Вночі після снігопаду , коли птахи не спали , бо розпачали над гніздами з яйцями , засипаними снігом , « Свобода » без жодних перешкод повідомила про жахливу ядерну катастрофу на Західній Україні .	повідомила	25	Fem
Вінстон різко обернувся .	обернувся	2	Masc
Ця заввага літературознавця погано корелює зі свідченням самої поетеси у листі до Ольги Кобилянської : « … вчилась тільки того , що мені подобалось , а читала все , що запорву , без жадної заборони .	вчилась	17	Fem
Мене засмикала ліквідація триместра .	засмикала	1	Fem
Після цього наступала сварня .	наступала	2	Fem
Господи ! і за що ти мене отак караєш на сім світі ? — скрикнула Мотря і знову залилась сльозами .	залилась	18	Fem
Це завжди траплялося вночі — арешти постійно проводилися уночі .	траплялося	2	Neut
— А тобі куди летіти так негайно приспічило , га !?	приспічило	7	Neut
Він дуже струнко сидів на стільці , його могутня грудна клітина роздувалася та тремтіла так ніби у ній вирував штормовий океан .	роздувалася	11	Fem
Всі домашні зосереджувалися в одній із кімнат , там , де можна було найсильніше напалити у печі , там , де найменше тепла видував вітер .	видував	23	Masc
Була дивна зима .	Була	0	Fem
Мати порається у хаті , але двері відчинені , - почула .	почула	10	Fem
Зрозуміло , що дзядзьо не любив поліцаїв і міліціянтів .	любив	5	Masc
Чумарка прилягала до стану і знизу поширювалася зборами .	прилягала	1	Fem
— не бачив , коли з’явилася , не бачив , куди й зникла .	зникла	12	Fem
Чорновусе обличчя пильно спостерігало домінуючи на кожному закутку .	спостерігало	3	Neut
Старе тіло тремтіло , колихалося , стара голова не здержувалась на в'язах — хилилася на груди .	колихалося	4	Neut
Наша гора ставала недоступною , вода заповнювала всі підходи .	ставала	2	Fem
Чоловік заглянув у вікно : лампа світить і вогонь горить , аж іскри розлітаються , начеб якась невидима сила гребла грань у пічці .	заглянув	1	Masc
Але що на лінії стрілу терен легко підносився , а добігти до вигіднішого місця було неможливо , то стрільці без хвилі вагання спорудили інструмент , що аж здивував мене своєю дотепністю .	підносився	7	Masc
Він обіцяв , що у мене буде багато грошей , баб і закордонних поїздок .	обіцяв	1	Masc
Присідав і дивився вниз .	дивився	2	Masc
Нагуляла то виховуй сама одна з другою !	Нагуляла	0	Fem
Пуні попався справжній професіонал — після першого ж ходу суперник вийняв блокнот і записав Пунин хід пішаком .	попався	1	Masc
Пан Коцький злякався кабана , скочив на дерево та й подерся туди , де ведмідь сидів .	сидів	15	Masc
Увійшов дід у хату .	Увійшов	0	Masc
Пішов до праці і зовсім забув за веприка і грис .	Пішов	0	Masc
Спочатку я наївно думала , що , якщо побачила назву вулиці , яку знаю , то точно її знайду .	думала	3	Fem
Він надав своєму обличчю виразу спокійного оптимізму , що доцільно було робити стаючи обличчям до телезахисту .	надав	1	Masc
Благо , до цього не дійшло , бо навіть за таких несприятливих обставин її напарник - геолог надто вже хотів жити і , завдяки професійним знанням та ерудиції , зумів облаштувати цілком адекватний побут на наступні роки .	зумів	29	Masc
Здичавілі пси щось винюхали , і через кілька хвилин вулицею розбігалося ціле стадо з пенісами у зубах .	розбігалося	10	Neut
Хотіла написати , що погоджуюся )	Хотіла	0	Fem
Він її і пустив .	пустив	3	Masc
Предивний птах з закрученим хвостом перестав для вас існувати .	перестав	5	Masc
Особливо заперло про то шо як тримати немовля в лівій руці то воно буде лівшею .	заперло	1	Neut
Тих , що залишалося , все ж набралося кілька тисяч .	набралося	7	Neut
Тета Міра ціле життя пила дуже багато води , і ця заборона і страждання сестри призвели до цілковитої неможливості ковтання .	пила	4	Fem
Попри невдалий початок роботи ( телескоп було запущено на орбіту із дефектом головного дзеркала ) зусиллями космічної експедиції дефект вдалося майже повністю компенсувати , що надало змогу наблизитися до розрахункових характеристик .	надало	25	Neut
Пуня знав , що до чого і тим часом утопив у якійсь шпарі свій щоденник і зошит , щоби залишитися анонімним .	утопив	9	Masc
Оскільки вони ідіоти , то Чужий не викликає аж такого жаху ; це раніше потвора хитромудро полювала за людиськами і щоразу більше лякала своєю кмітливістю , а тут Чужому вистачає просто відкрити рота і космонавти самі йому туди застрибнуть .	лякала	22	Fem
Ціла армія помчала далі , не звертаючи уваги на втрати .	помчала	2	Fem
На той час один коштував 2 гривні .	коштував	4	Masc
Вдосвіта замітав листя .	замітав	1	Masc
Я виходжу з-за клуба , в новенькому дешевому костюмі ( три вагони цегли розвантажив з хлопцями - однокурсниками , то й купив ) і з чемоданчиком у руці .	купив	21	Masc
Але він уже не слухав — перед ним підносилася велетенська темна стіна , більша за все , що він здолав досі , й він сказав тій , що не пускала його туди , втримуючи при життю :	підносилася	8	Fem
Поверхня посудини тоді вигладжувалась зглядно потім ще примазувалась .	вигладжувалась	3	Fem
Як правило , письмо в Україні ґрунтувалося на взірцях , узятих з інших слов’янських мов ; літописці й переписувачі аж ніяк не прагнули до відтворення реальної фонетики мови щоденного вжитку .	ґрунтувалося	6	Neut
Навіть святий Миколай залишав свої мандаринки для тети Міри у торбинці , прив’язаній до клямки її покою .	залишав	3	Masc
Пізніше почав грати свою найкращу роль – Михайла Гурмана в " Украденому щасті " .	почав	1	Masc
Скінчилося тим , що ми захотіли подивитися на нічне місто .	Скінчилося	0	Neut
На другому місці за популярністю запитів розташувалася наукова фантастика " Прибуття " , а на третьому місці розташувалася – режисерська робота Мела Гібсона , військова драма " З міркувань совісті " .	розташувалася	17	Fem
До того ж передала запрошення від королеви : новообраний президент може зупинитися в Букінгемському палаці під час офіційного візиту .	передала	3	Fem
Назовні , навіть крізь скло закритих вікон , світ виглядав замерзлим .	виглядав	9	Masc
У місті Бучачі якийсь час діяли водночас 2 ГЕС : одна називалася міською ( вважалася комунальною ) , інша називалася — « на Топольках » , яка після відновлення діє й нині .	називалася	19	Fem
От хазяїн його взяв та й вивіз у ліс , думає : « Нащо він мені здався , тільки дурно буду годувати , — нехай лучче в лісі ходить » .	вивіз	6	Masc
А громи так почали бити , що душа із чоловіка мало не вискочила вон .	вискочила	12	Fem
Мотря не озивалася ; плакала мовчки .	озивалася	2	Fem
" Правоохоронці з’ясували , що невідомий зробив потерпілому зауваження через те , що він палив у недозволеному місці та лаявся на перехожих .	палив	14	Masc
Адже і в курінях на покуті сиділо виборне отамання та чесне товариство , а не якісь заволоки - потурнаки » .	сиділо	6	Neut
Маю зізнатися , що коли я почула цю фразу вперше ( років в 15 ) , я надавала їй зовсім іншого значення .	почула	6	Fem
Давав їй місце на постелі й уважно віддалік слухав , коли засипала вона , як дихала .	засипала	11	Fem
Нижче по вулиці висів ще один плакат , обідраний з краю , що гарячково тріпотів на вітру , почергово показуючи та ховаючи одне єдине слово ІНГСОЦ .	тріпотів	14	Masc
Нам дзядзьо подарував кількадесят блискучих патронів .	подарував	2	Masc
СТАРШИЙ БРАТ НАГЛЯДАЄ ЗА ТОБОЮ , промовляв напис під зображенням .	промовляв	6	Masc
Уявляю , якби я був шпигун , та попався з таким папірцем контррозвідці ...	попався	8	Masc
Знову навіть не розглядалось .	розглядалось	3	Neut
По дорозі з Делятина я наполовину висувався з вікна і на повній швидкості стріляв з пістолета по заданих татом цілях , переважно у дорожні знаки .	висувався	6	Masc
Громадськість так і не довідалася , про що говорили за зачиненими дверима , але вже за кілька днів виявилося , що з адміністративного тиску вийшов величезний пшик .	вийшов	24	Masc
Мотря нічого не одказала , — тільки жалібно дивилася .	одказала	3	Fem
Одно дерево упало на віз і розтрощило його на шматочки , друге вбило коня ; насилу той чоловік вискочив з лісу .	упало	2	Neut
Я подивився через вікно на вікно давнього помешкання .	подивився	1	Masc
Усе , що не відповідало радянським уявленням про корисність ( інші функції мистецтва майже не бралися до уваги , воно мало лише виховувати лояльних до влади громадян ) , цензурувалося , замовчувалося .	відповідало	4	Neut
Айбо коли чоловік гримнув по її носі , той так загудів , що почули в пеклі :	загудів	10	Masc
Її там не впізнали , і як уже вона розказала все , то мачуха аж об поли вдарилась , що , бач , вона думала її з світу зігнати , а тут зовсім не так вийшло ...	розказала	9	Fem
Роздіймав він їм руки , роздіймав , нічого не вдіє .	роздіймав	5	Masc
І просто на підвіконні біля порепаної бегонії плямистої ( Begonia maculata ) Марія Василівна помішала майже вистиглий кминовий ( Carum carvi ) чайок у гарній блакитній чашечці з позолоченою окантовкою у формі листочків .	помішала	14	Fem
Гаразд , вона втратила коханого , ось на пам’ять про нього навішує цвяшок …	втратила	3	Fem
Уже й вечеря постигла , а батько не йде в хату .	постигла	3	Fem
Цей чистий випадок психологічного переносу мене так зачарував , що думала всю прогулянку .	зачарував	7	Masc
Цикнув і завмер , виглядаючи з-за стовбура .	завмер	2	Masc
Камінь цюкнув павука по голові — й той , знепритомнівши , звалився з дерева й гепнувся на землю , задерши лапи .	цюкнув	1	Masc
Вона містилася не у броньовику , а в просторому теплому автомобільному кунзі .	містилася	1	Fem
Під час таких нічних розмов , де узгоджувалися погляди на найважливіші речі , мене найбільше нервувало те , що тато безперервно курив , а я не міг собі того ніяк дозволити у його присутності .	курив	21	Masc
Від початку вісімдесятих у Франківську діяло нетипове кафе « Золотий початок » , де кукурудзу варили цілорічно .	діяло	5	Neut
Дзядзьо любив свого фльоберта , але розумів , що настав час , коли рушниця , навіть зовсім чиста й унікального калібру , повинна бути зліквідована , щоби не бути знайденою міліцією у хаті .	настав	9	Masc
І зараз лють яку відчував кожен стала абстрактною , не адресованою емоцією яку можна було передавати та спрямовувати з одного об’єкта на інший неначе вогонь у паяльній лампі .	відчував	4	Masc
Орел його поніс аж у хмару , а потім і пустив його додолу .	пустив	10	Masc
Модерністське розмежування політики і мистецтва не означало для Лесі Українки зречення громадянського служіння .	означало	6	Neut
Ідея документа під назвою « Декрет № 3 « Про запобігання соціальному утриманству » з’явилася 2014 року , а реалізовувалася 2015-го , коли він був підписаний .	реалізовувалася	19	Fem
У неї в думці пробігла смерть Остапова .	пробігла	4	Fem
— Ма , твій манник лайкнуло вісімдесят людей .	лайкнуло	5	Neut
Швидко він зживався з новим своїм місцем на старій землі — і підвертав її під себе : вона йому плодила , родила — ставало на пожиття його !	родила	21	Fem
Ударив він об поли руками :	Ударив	0	Masc
Якось у діда злетів снігоступ .	злетів	3	Masc
— Просили вовк , ведмідь , дикий кабан , і я прошу , щоб ти прийшла зі своїм паном Коцьким на обід .	прийшла	15	Fem
Потім принесла міхи й повела чоловіка до підземної комори .	повела	4	Fem
Донька Манафорта Джесіка подала на розлучення з Йохаєм у березні .	подала	3	Fem
Не бійся , не перервався б .	перервався	4	Masc
Проаілурус ймовірно був предком Псевдолурусу , який жив 10 - 20 мільйонів років назад , і напевно призвів до головної лінії котячих , включаючи вимерлих махайродових та існуючих сьогодні малих кішок та пантерових .	призвів	17	Masc
— Англійський король приняв на авдієнції новоіменованого мін . Стеффорда Кріппса і тим наче підкреслив його значення .	підкреслив	14	Masc
Шелеснула суха бирка .	Шелеснула	0	Fem
Особливо це відчувалося вночі , ліжко вібрувало , як при середньому землетрусі .	відчувалося	2	Neut
Барабан пристосував зі старої пральної машини « Ардо » .	пристосував	1	Masc
Садочок розташувався у старому палацику .	розташувався	1	Masc
Сказала і відійшла .	відійшла	2	Fem
Несподіваний різкий поштовх виривав тебе зі сну , жорстка долоня трусила тебе за плече , сліпуче світло різало твої очі , коло з жорстких облич стояло навколо ліжка .	трусила	10	Fem
Але поступово мені б хотілося викристалізувати свою особисту лінію .	хотілося	4	Neut
І мені чомусь прийшло у голову : « Йомайо .	прийшло	3	Neut
Вона повезла з собою його привітання селу , кілька доручень і листа до одного з товаришів по роботі .	повезла	1	Fem
Мотря повернулася , вийшла .	повернулася	1	Fem
У міських школах діяло правило двадцяти п’яти градусів — при такому морозі можна було залишатися вдома .	діяло	3	Neut
Книжку оплатила зразу , а від книгарні відповіді немає .	оплатила	1	Fem
Давав їй місце на постелі й уважно віддалік слухав , коли засипала вона , як дихала .	дихала	15	Fem
Вуйко Влодко відбував термін у Хабаровську , ще далі , ніж Чита і Чита - три .	відбував	2	Masc
Один мужик щось сказав , що їм не сподобалося — « ЛНРівці » виштовхали з машини , прострелили обидві ноги — « провчили » ...	сказав	3	Masc
Пустиня давно обернулася знову в розкішну країну , знову хвилювало золоте збіжжя , рясні дерева знов клонили додолу важкі віти .	хвилювало	9	Neut
Вона принесла її до школи , вчительці історії , яка була найліберальнішою і гралася у справжню дружбу учнів і вчительки .	принесла	1	Fem
Коли подзвонила , не відповіли , написала на пошту те ж саме .	написала	6	Fem
Врешті убивць вичислили на якихось підміських городах , і піхота зробила справжню облаву , загнавши їх у безвихідь .	зробила	10	Fem
Не знаю , чи цільно стріляв той прилад , але признаюся , що тоді вперше доводилось бачити таке дивовижжа та подивляти стрілецьку вигадливість .	доводилось	15	Neut
Найцікавіші і найважливіші думки із цієї дискусії зібрала " Українська правда " .	зібрала	7	Fem
Тато і мене назвав Тарасом передовсім тому , щоби не утворювалася здрібніла російська форма з жіночим закінченням .	назвав	3	Masc
Втім , Євгенові Чикаленку звірявся , що зробити це нелегко : « Трудно , Євгене Харлампійовичу , бути українським літератором .	звірявся	4	Masc
Ось такий результат всіх цих років на сцені – мені захотілося бути домашньою .	захотілося	10	Neut
( Зрозуміло , що крамольну згадку про « Ще не вмерла … » вилучили , а цензуроване речення сприймалося якимось надміру екзальтованим . )	вмерла	10	Fem
Злий дух вийшов чорним димом з лона землі і огненною хмарою полинув понад землею .	полинув	11	Masc
Я заказала книжку " Гаррі Поттер і прокляте дитя " 1 жовтня .	заказала	1	Fem
Цвіла божа мрія , розкішна й лагідна .	Цвіла	0	Fem
Квартира знаходилася на сьомому поверсі , і Вінстон , який мав тридцять дев’ять років та варикозну виразку на правій щиколотці , йшов дуже повільно , відпочиваючи по декілька разів під час сходження .	йшов	21	Masc
Така , як вишивають дівчата своїм нареченим , — і трьом мужчинам од того видива на мить заперло дух : сорочка світилася в тьмі як жива , вона хотіла бути вбраною не на смерть , а до шлюбу .	заперло	17	Neut
хотіла натиснути реплай , а видалила комент )	видалила	5	Fem
Був вісімдесят третій рік , і почалися андроповські репресії .	Був	0	Masc
Востаннє тато закурив у передостанній лікарні , просто у палаті , якось так пускаючи дим стіною , що він збирався під самою стелею , не поширюючи жодного запаху .	збирався	19	Masc
... Голубан затулив Зеленського , Дорн затулив Голубана , кулічі й паски затулили Дорна , сніг затулив кулічі й паски ...	затулив	6	Masc
Скінчилося тим , що вони побили нашого товариша .	Скінчилося	0	Neut
Крій чумарки нагадував крій жіночої кирсетки ( юпки ) з рукавами .	нагадував	2	Masc
Дорогою не втримався і вдягнув його на руку , не виймаючи з кишені .	втримався	2	Masc
Вода у кирниці не встигала профільтруватися і пахла розмоченою травою .	пахла	7	Fem
Вуйко Влодко телефонував до Франківська татові , щоби він переконав мене не відмовлятися від військової підготовки .	телефонував	2	Masc
З нічної зміни я приходив за кілька хвилин перед тим , як будилися діти .	приходив	4	Masc
Про скандал у пісочниці : як Гройсман відібрав в Омеляна паровозики , а також про Тіну Кароль та двері в Нарнію у шафі поліцейського — у новій серії « #@)₴?$0 з Майклом Щуром »	відібрав	7	Masc
Я ночував у їхньому спальному мішку , підбитому лисячим хутром .	ночував	1	Masc
Дзядзьо любив свого фльоберта , але розумів , що настав час , коли рушниця , навіть зовсім чиста й унікального калібру , повинна бути зліквідована , щоби не бути знайденою міліцією у хаті .	любив	1	Masc
Маленька рудувата жіночка , що працювала у наступній до Вінстонової кубікулі , сіла поміж ними .	працювала	5	Fem
А ще , як йому скажу , що ти його полуденок з’їв , йо - йой , неборе !..	з’їв	11	Masc
Дзядзеві бракувало повітря .	бракувало	1	Neut
Він пролітав над долинами , де хвилювало золоте збіжжя , де рясні дерева клонили додолу важкі віти .	пролітав	1	Masc
Цей голос лунав з видовженої металевої тарелі , що нагадувала поблякле дзеркало , та була вмонтована в поверхню стіни праворуч .	лунав	2	Masc
Злий дух спав у підземній країні .	спав	2	Masc
Закриймо очі на те , що поломку “ Заповіта ” списали на безглузду причину типу “ на мою машину посвітило вранішнє сонце , тому в мене пом’явся кузов і фари розбились ” .	посвітило	19	Neut
Я старанно відхиляв поли , намагаючись не зачепити нікого чимось важким , що мотулялося на рівні колін .	мотулялося	13	Neut
Особливо вбилась мені в тямку одна сценка , що застановила мене зовсім іншими очима глядіти на Український Легіон .	застановила	9	Fem
Жінка нахилила горня , аби вилити чай у вазон , але в останній момент зупинилася .	зупинилася	14	Fem
Виймаючи пачку , я мусив встигнути прорвати кишеню і вкинути кастет під підкладку плаща .	мусив	4	Masc
Через кілька місяців після дембеля Раїль розбився на мотоциклі , їдучи до дівчини , з якою про все домовився .	розбився	6	Masc
Молодший син випав з ліжечка і розбив собі чоло .	випав	2	Masc
Попросив , щоби вони самі вибрали мені якусь рибину , бо я не з-над моря .	Попросив	0	Masc
Зате під впливом спогадів , що охопили його , він докладно цікавився становищем сільбуду , тими лекціями , що програму їх ще сам склав , одвідуванням кіно , новими виставами .	склав	23	Masc
— Ну , от бачте , нічого я йому і не зробила …	зробила	11	Fem
Шоб не муляло у флуді , і шоб не викинуте було ( флуд же чиститься ) , переніс сюди .	муляло	2	Neut
Вгадайте чи спромігся Кабмін затвердити Положення про Національну раду з питань науки та технологій ?	спромігся	2	Masc
Коли хтось застрелив жінку , яка жила ще ближче від лісу , ніж ми , дзядзьо вирішив знищити свій фльоберт , який зберігався у таємній пивничці під хатою ще з тридцятих років .	зберігався	22	Masc
А здається у 97-му Кохана розбилася під час шторму , коли стояла пришвартована ...	розбилася	5	Fem
Проте недарма показали момент , де йшла мова ніби Рейгар таємно обвінчався з Ліанною , отже Джон Сноу законний і легітимний спадкоємець залізного трону .	обвінчався	11	Masc
Дзядзьо зумів витягнути тата з вуличної банди , і тато його визнав .	визнав	11	Masc
Нарешті я отримала свою довгоочікувану книгу , з таким нетерпінням летіла на пошту в дощ , як не знаю що ...	летіла	10	Fem
Убиралася в барвисті спідниці , голову накривала по-дівочому , заплела розплетену дружками косу .	заплела	9	Fem
Він вдарився , з глухим звуком , об ніс Гольдштейна та відскочив ; його голос лунав невблаганно .	відскочив	11	Masc
— Як же мені не плакати , коли змія загадала таке , що я ніколи його не зроблю , а вона сказала , щоб за одну ніч зробив .	загадала	9	Fem
За якусь хвилину привела віслюка .	привела	3	Fem
Тоді походив сам і теж зробив запис .	походив	1	Masc
Був вересень , п’ятдесятиріччя приєднання Західної України до УРСР .	Був	0	Masc
Чумарка спереду прилягала також до стану і була завжди однобортна .	прилягала	2	Fem
Як уродила їм та пшениця — давай вони зерном ділитися .	уродила	1	Fem
Довкола були яблуневі сади , і начальник медчастини прапорщик Бек вливав кожному , хто надкусив яблуко , десять літрів води з марганцівкою .	надкусив	14	Masc
Давно хотіла придбати " Алісу " , а тепер , коли з`явилася можливість , " товар відсутній " у київському інтернет - магазині .	з`явилася	11	Fem
Я саме йшов на пошту , щоб послати Вам усі важливіші інформації про те , як стоїть справа з друкуванням Вашої книжки .	йшов	2	Masc
Таким же чином « забув » у власному гаманці пакет з амфетаміном і 37-річний громадянин Молдови .	забув	4	Masc
Коли я давав їм по скибочці чорного хліба у вагоні , то на нас усі дивилися як на святу родину .	давав	2	Masc
Але що на лінії стрілу терен легко підносився , а добігти до вигіднішого місця було неможливо , то стрільці без хвилі вагання спорудили інструмент , що аж здивував мене своєю дотепністю .	здивував	27	Masc
З моменту відкриття в 1949 р . на нашій території перших алмазів у долині р . Базавлук цей мінерал потім траплявся у понад сотні місць .	траплявся	20	Masc
Побачивши щось таке , наша мила учителька змінилася на лиці і запровадила Анжелу саме до тієї завучки , про яку ми думали .	запровадила	11	Fem
Я й лизнула — пів’язика й залишилось на замку .	залишилось	6	Neut
Після операції доктор почастував мене спиртом , вітаючи з ініціацією , і дав п’ятдесят тисяч на таксі , бо швидка вже давно поїхала на свіжі виклики .	дав	12	Masc
Старе тіло тремтіло , колихалося , стара голова не здержувалась на в'язах — хилилася на груди .	тремтіло	2	Neut
Нараз позирає , а поряд на лавці сидить паскудна чорна кішка , і на нього очі витріщила .	витріщила	16	Fem
Годують такою смачною юшкою , що навіть Карпо Ярковий п’ятнадцять мисок умолотив би , ще й добавки попросив !	попросив	17	Masc
Суперник довго оглядав поле , уважно вивчив свої нотатки і відмовився .	оглядав	2	Masc
На всіх виїздах стояли наші бетеери , і чергова машина розвозила екіпажам сніданки , обіди і вечері .	розвозила	10	Fem
Доки Більбо підбирав камінці , павук дістався до Бомбура — і незабаром ґномові прийшов би кінець .	підбирав	2	Masc
Вона розпочалася 4 лютого 1945 року .	розпочалася	1	Fem
Той , хто програв , мусив заколоти випадкового глядача , що опинився у цей час у цьому місці .	опинився	11	Masc
Огидний екстатичний транс зі страху та мстивості , бажання вбивати , катувати , трощити пики кувалдою , здавалося кружляв поміж усією цією групою людей неначе електричний струм , перетворюючи всіх і кожного на кривляючогося , верескливого божевільного лунатика .	кружляв	18	Masc
Другого дня , коли зійшлися до театру й почали розповідати одне одному , як кожний влаштувався , виявилося , що всі хазяї годують нас безкоштовно і вважають актора своїм дорогим гостем " .	виявилося	17	Neut
Дідо Богдан вираховував максимальні довжини електричних проводів між двома опорами .	вираховував	2	Masc
Було темно , душно і не лишалося нічого іншого , як забитися в мамине пір'я і віддати себе на поталу тривожним снам .	лишалося	6	Neut
Від самого початку влада зіткнулася з великою проблемою : кого вважати таким , що працює неналежний термін ?	зіткнулася	4	Fem
З перегляду іншого посуду — з рівним дном , виразно означеним випливало , що взагалі цей посуд спочатку не мав дна , яке додатково вліплювалося .	випливало	11	Neut
ВВП на душу населення Тайваню ( $ 145 ) тоді мало відрізнявся від Ефіопії або Сомалі .	відрізнявся	11	Masc
Так от , вони там робили горбик , а я взяв в Тішки біговел , і давай ганяти по тим горбикам .	взяв	10	Masc
Марія Василівна , як актриса після важкої ролі , інколи виходила з образу “ вчительки з великої літери ” й ставала тією , кого треба покарати .	виходила	10	Fem
Ждала вона , ждала , далі дума : « Піду подивлюсь , де він » .	Ждала	0	Fem
У травні гурт виступив на сцені міжнародного фестивалю татуювань « TattoCollection 2015 » та разом з гуртом YouCrane влаштував міні - тур містами Західної України з завершальним концертом у Києві .	влаштував	18	Masc
Коли долар був по 8 гривень , стоїла ця техніка 4 , 5 тисячі гривень .	стоїла	7	Fem
Тричі на день я натирав його гадючою отрутою .	натирав	4	Masc
Але тієї миті Більбо метнув .	метнув	4	Masc
На червону доріжку 37-річна " дівчина Бонда " вийшла в розшитому пайєтками чорному комбінезоні від " Armani " , виставивши на огляд чималу частину своїх грудей , але цнотливо закривши соски бретелями .	вийшла	8	Fem
Машиніст загальмував , вискочив зі своєї кабіни і скотився в яр .	вискочив	3	Masc
Хотілось би зпитати , ви плануєте друкувати книгу Коннора Франти " Робота в процесі " ?	Хотілось	0	Neut
Вольфрам збільшив обсяг тексту , довів до кінця фабульні зв'язки та вніс деякі зміни в основний сюжет , розроблений Кретьєном , але в цілому дотримувався задуму останнього .	збільшив	1	Masc
Подарований тоді ж пояс перетерся аж в університеті .	перетерся	4	Masc
На моє запитання пояснила , що " - ті слимаки , то така зараза , з'їдають на городі чисто все !	пояснила	3	Fem
Наприклад , вивіз меду в січні — червні 2017-го порівняно з першим півріччям 2016-го зріс майже удвічі — до 30 млн кг .	зріс	14	Masc
Забрала вона ті харчі , заплакала та й пішла з батьком .	пішла	8	Fem
За два дні перед початком школи він подарував мені простенький однолезовий розкладний ножик , просвердлив у колодці дірку і засилив шнурок .	подарував	7	Masc
А він час від часу привозив від своїх друзів з інституту космічних досліджень якісь фраґменти супутникової техніки і врешті склав такий дельтаплан з двигуном , котрий за радіокомандами підлітав , кружляв і приземлявся .	привозив	5	Masc
І хочу також подякувати вам за чудову трилогію про джур : мій 10-річний син з минулої осені перечитав її тричі та називає Рутківського своїм улюбленим письменником :)	перечитав	17	Masc
З-під язика він вийняв половинку жилетки і , ще тримаючи руку біля губ , зробив пальцями той рух , який примусив невагомий шматок сталі пролетіти кілька метрів і заглибитися у дощану стіну якраз біля голови пахана .	вийняв	3	Masc
— Як же мені не плакати , коли змія загадала таке , що я ніколи його не зроблю , а вона сказала , щоб за одну ніч зробив .	сказала	21	Fem
Була темна ніч , табори спали , тільки молоді пастухи сиділи навколо багаття — пастухи не спали вночі , — вони співали .	Була	0	Fem
Ой , пропала ж моя голівонька бідная !!. "	пропала	2	Fem
Ще дзядзьо вигадав таку систему , що драбина на стрих піднімалася й опускалася прихованим тросиком .	опускалася	12	Fem
Горе без страви нагодувало обох .	нагодувало	3	Neut
Він прив’язував її оголену до стовпа та пронизував безліччю стріл неначе Святого Себастіана .	прив’язував	1	Masc
Щойно я відкрила посилку для мого брата , де був маленький подарунок для мене .	відкрила	2	Fem
Тато працював у лісовій промисловості , тому нам перед Новим роком привозили пишну ялинку .	працював	1	Masc
Одначе змирився з видавницькою твердолобістю - просто перестав купувати їхній продукт .	перестав	7	Masc
Все пропало , відмовляйтеся від книжок ...	пропало	1	Neut
Народився 1981 року в Бельгії .	Народився	0	Masc
Прийшли додому пізно ввечір і дізналися , що вертоліт дійсно шукав нас — перелякані рідні звернулися до військових , що діти не вертаються з лісу .	шукав	10	Masc
Але місто велике , а Зайчик — дуже маленький , і він заблукав ...	заблукав	12	Masc
Джон шалено танцював на міських святах і на дискотеці , де один з нас пускав музику , а інший стояв на вході .	танцював	2	Masc
Навіть якщо ця шуба колись зводила з розуму пів - Хрещатика ...	зводила	5	Fem
І Марина падала навколюшки , молила матір божу , щоб велика заступниця наслала мир на її рідну сторону і захистила від напасті !	падала	2	Fem
А чоловік завів у двір віслюка із возиком .	завів	2	Masc
… Вона не впала , навіть не спіткнулася , бо це ж була людина - курган : завучка пережила в школі понад сто перевірок усіх рівнів , дві держави , чотирьох директорів .	впала	3	Fem
Вольфрам збільшив обсяг тексту , довів до кінця фабульні зв'язки та вніс деякі зміни в основний сюжет , розроблений Кретьєном , але в цілому дотримувався задуму останнього .	довів	5	Masc
Та тому , що минулого року в Харкові наша бригада виборола переможне місце і таким чином ми це право заслужили , – зазначив Сергій Бутенко .	виборола	10	Fem
Погрюкав удруге .	Погрюкав	0	Masc
Чумарка ( чемерка , чамарка ) — приталений в стані , однобортний верхній чоловічий одяг , який поширювався від стану зборами .	поширювався	17	Masc
Дівчина з темним волоссям всілася безпосередньо за ним .	всілася	4	Fem
І Марина падала навколюшки , молила матір божу , щоб велика заступниця наслала мир на її рідну сторону і захистила від напасті !	молила	5	Fem
Таке саме діялося із молоком .	діялося	2	Neut
Він підійшов до вікна : маленька , квола фігурка , його худорлявого тіла лише підкреслювалась блакитним спецодягом , що був уніформою його партії .	підкреслювалась	14	Fem
Злий дух сидів у підземній країні і думав .	думав	7	Masc
Йшлося ще й через горіхові ліси , де під ногами горіхи укладалися у багаторічні шари .	Йшлося	0	Neut
Ось Карачапов : він здатний схопити людину , що попала в скрутне становище , взяти її за горло й душити доти , поки ні копійки не лишиться в неї .	попала	9	Fem
З них випливає , що хрестив Тараса піп Олексій Базаринський ( Кониський пише - Іван Базаринський ) .	хрестив	5	Masc
Більшість деревець , які не мали жодних шансів на дорозі , виросла .	виросла	11	Fem
Не записуючи нічого на папірчику , я відразу називав цифру в кількасот тисяч або кілька мільйонів , і деякі відвідувачі підозрювали , що це такий барменський прийом , щоби обдурити їх на кілька тисяч .	називав	8	Masc
Зате мати не дуже втішалася тими страшними іграшками .	втішалася	4	Fem
" Наша нарада в Криму знову підтвердила спільну рішучість зберегти й посилити в майбутній мирний період ту єдність мети і дій , що зробила в сучасній війні перемогу можливою і безперечною для Об'єднаних Націй .	підтвердила	6	Fem
Читав , що ще в позаминулому столітті були спроби .	Читав	0	Masc
Анжела просто хотіла , щоби АПП ( так ми називали історичку ) пояснила текст листівки .	пояснила	12	Fem
Він крикнув уголос : « Дивіться , дивіться ! » — і всі дивились туди , куди показувала його рука , — там упала зоря .	упала	23	Fem
Перші зв’язки з японцями ОУН налагодить уже на початку 1930-х — у той час доволі гучною акцією , яку розглядала Ліга Націй , була пацифікація , котру поляки проводили на Галичині .	розглядала	19	Fem
Мені стало ясно , чому , коли я напередодні нашого бою випадково проходив повз чеський курінь , між ним і противником стояла дивна тиша .	проходив	12	Masc
У листах авторка « Боярині » висловлюється навпростець : « … нам , українцям , не щастила доля ніколи в тій Московщині » .	щастила	16	Fem
Усіма військовими справами ЗУНР відав ДСВС , що діяв до 9 червня 1919 року та поділявся на Військову канцелярію ДСВС і 16 відділів .	відав	4	Masc
Прем’єр - міністр Великої Британії Тереза Мей першою серед іноземних лідерів зголосилася зустрітися з президентом Трампом після його інавгурації .	зголосилася	11	Fem
Коли б , макогін проклятий , хоч слівце промовив .	промовив	8	Masc
Софі запиталася у покоївки , де можна знайти воду , і та показала на лазничку в кінці коридору .	запиталася	1	Fem
Вона воліла вибирати сама .	воліла	1	Fem
Він прив’язував її оголену до стовпа та пронизував безліччю стріл неначе Святого Себастіана .	пронизував	7	Masc
Брала зернятка каши і знов випускала їх з рота , боячись , щоб не проковтнути ненароком коштовної страви .	випускала	5	Fem
Денного запасу вистачало на перших півгодини .	вистачало	2	Neut
Тут мені на думку сплив уривок з фільму Мориса Шевальє під назвою “ Любов опівдні ” , в якому тато - детектив відгадав , що його донька закохалася , бо що не день стала мити голову .	сплив	4	Masc
Бачу по тобі , що не давав !	давав	6	Masc
Це стало зрозуміло під час нашої розмови , на яку співачка прийшла без макіяжу , в темному м’якому спортивному костюмі , без звичних сценічних атрибутів і аксесуарів .	прийшла	11	Fem
Я думала , що всі яхти стають перше в ряд , а потім переганяються наввипередки , тим часом вони всі роблять круги по морю навколо різних значків , і котра більше кругів зробить в призначений час , та виграє .	думала	1	Fem
Наша лабораторія вивчала природне лісовідновлення .	вивчала	2	Fem
Я могла б тобі допомогти , айбо і так не допоможу !	могла	1	Fem
Він пропонував одружитися , але тета Міра навіть думати про таке не збиралася , бо Галан постійно шпортався і падав на усіх гірських стежках .	збиралася	12	Fem
Коли приїхав Антоні Міро з Іспанії , ми з Ігорем повели його саме туди , бо на міську каву Міро запізнився .	запізнився	20	Masc
Доводилося вичерпувати воду руками .	Доводилося	0	Neut
Пуня підірвав себе у війську .	підірвав	1	Masc
До трибуни у цілого класу залишилося лише кілька синіх і жовтих непробитих кульок .	залишилося	5	Neut
Він навів на нас автомат і наказав негайно покинути міст .	навів	1	Masc
Вийшла , обійшла кругом хати — нема батька .	обійшла	2	Fem
Коли вона хворіла , я залишався там на ніч .	залишався	5	Masc
( Зрозуміло , що крамольну згадку про « Ще не вмерла … » вилучили , а цензуроване речення сприймалося якимось надміру екзальтованим . )	сприймалося	18	Neut
Цар на це діло згодився .	згодився	4	Masc
І нікого не зустрічав на дорозі ?	зустрічав	3	Masc
Світанкове місто було темне , півсонне й порожнє , проте на головній площі пінився яскраво освітлений фонтан із позолоченими фігурами тварин і чекали на клієнтів пункти обміну валют .	пінився	13	Masc
Привертають увагу « шафка » з глини , чавунні казанки , які розшукав у старших людей по району .	розшукав	12	Masc
Чоловік подумав : « Ой , то би добре зігрітися й просушитися » .	подумав	1	Masc
Завжди було легко працювати на різних роботах , бо знав , що у будь-яку хвилю можна вернутися до свого фаху .	знав	9	Masc
Вона поквапно вилізла з окопів , щоби погрозити москалям зап'ятками .	вилізла	2	Fem
Відбій — роздягання , складання одежі і вискакування на другий ярус тривав стільки , скільки горів сірник .	горів	15	Masc
Він був дуже тяжкий , і я помагав черговим сестрам перекладати померлого на візок , відвозити його довжелезними коридорами і пивницями до лікарняного морґу , переносити тіло на спеціальний стіл .	помагав	7	Masc
Одно руденьке з двома блакитними латочками на спинці курча зацікавилося маминою бородою , підскочило і повисло на ній .	повисло	15	Neut
Якщо вас турбує доля слимака , я його відмила в калюжі .	відмила	8	Fem
Вдома тато курив у піч , сидячи на фотелі .	курив	2	Masc
Про це повідомив журналіст Юрій Бутусов .	повідомив	2	Masc
Він обпарив руку , коли ніс котел з окропом , і послизнувся на жирній бетонній підлозі у кухні .	послизнувся	11	Masc
В одній з авдиторій стояло антикварне піаніно « Вайнбах » без половини необхідних струн , і ми з Фациком і Мациком грали в шість рук пісні « Бітлз » із самвидавівських фотокопій нот .	стояло	4	Neut
Пішов дід , найшов ту хатку , де кинув бабину дочку .	Пішов	0	Masc
Космічна астрономія стала розвиватися після закінчення Другої Світової війни .	стала	2	Fem
Початки підготовки полягали у вивченні досвіду спецслужб усього світу — всього , що могло бути доступним в СРСР .	могло	13	Neut
Ніхто з попередників Дональда Трампа не відвідував Велику Британію так скоро після вступу на посаду .	відвідував	6	Masc
Ми повинні сьогодні визнати , що держава надто довго жила не відповідно до своїх достатків .	жила	9	Fem
Швидко він зживався з новим своїм місцем на старій землі — і підвертав її під себе : вона йому плодила , родила — ставало на пожиття його !	зживався	2	Masc
А ясна , дивна постать все далі ставала , все більше мінилась і зникла в тумані .	зникла	13	Fem
Але сидів під стіною , затиснений іншими гостями , ті його не випускали .	сидів	1	Masc
А вишенькою на торті був картограф , який заблукав у ним же промаркованій печері .	заблукав	8	Masc
Пуня зробив ще один хід і сказав , що дружня нічия влаштувала б усіх .	влаштувала	11	Fem
Я надіявся , що буде значно краще .	надіявся	1	Masc
Просто був хтось моринський , хто захотів прославити рідне село і підробив документи .	підробив	11	Masc
Виявилося , що дочка одного із селян – художниця , і все зробила власними руками .	зробила	12	Fem
Чіпка дивився на неї та дивувався , що з нею сталося ...	сталося	10	Neut
Скочив на воза й ломакою гатить віслюка .	Скочив	0	Masc
Тоді дружніми зусиллями зайняли безпечне місце біля величезної галі автомобілевої фірми й тут , опершись об мосяжне поруччя , з безмежною нудьгою на видовжених обличчях приглядалися морю життя , що заливало Четверту авеню .	заливало	30	Neut
Він навів на нас автомат і наказав негайно покинути міст .	наказав	6	Masc
– А чим він снідав ?	снідав	4	Masc
Вона казала , що у заповіднику все має бути по-заповідному , боронила чоловікові навіть заготовляти сіно коням на зиму .	боронила	11	Fem
Мацик любив футбол , морозиво і фільми із Софі Марсо .	любив	1	Masc
То Ліна , сестра , просила вам передати , я берегла до Різдва …	берегла	10	Fem
Регіт стих ; усі похнюпили очі у землю ; одна тільки Галя гостро дивилася на всіх гультяїв — і червона краска грала на її щоках , тоді як серце підкидалося в грудях , а груди поривчато дихали .	підкидалося	29	Neut
Я більше ніде не бачила , щоб єврейський квартал крім пласту історії , спогадів , синагоги і кількох меморіальних комплексів мав ще щось цікаве .	бачила	4	Fem
У Львові я часом ночував по вулиці Руській .	ночував	4	Masc
Також вона згадала , що зелені насадження виконують захисну функцію від автошляху , а знищення дерев та будівництво АЗС чи автомийки ще більше псує екологічний стан міста .	згадала	2	Fem
Гнат і не думав спитати , куди відійшла .	думав	3	Masc
Жахаючись тої страшної хуртовини , яка тоді часто й густо підіймалася , материне серце боялося , щоб Івась у іграшках , бува , не привчився до неї .	підіймалася	10	Fem
То Ліна , сестра , просила вам передати , я берегла до Різдва …	просила	5	Fem
На одного воно глянуло коханими очима , іншому заблищало золотом , іншому засіяло світлом слави .	глянуло	3	Neut
Він вирізав з дошки профілі кінської голови , прикріпив їх до палиць , і це були наші коні .	прикріпив	8	Masc
А менш ніж за рік позбулася " вагітних " кіло та позувала у купальнику .	позбулася	5	Fem
Виявилося , що дочка одного із селян – художниця , і все зробила власними руками .	Виявилося	0	Neut
— Щоб ти оту гору розкопав , і щоб туди Дніпро йшов , а коло того Дніпра побудуй комори : щоб байдаки туди приставали , й щоб ти ту пшеницю продав на байдаки .	йшов	11	Masc
А очима дивився на всіх усміхнено й вивчав кожного .	вивчав	7	Masc
На той час було зрозуміло – Німеччина , яка восени 1939-го розпочала Другу світову війну , незабаром капітулює .	розпочала	11	Fem
Міжнародна авіакосмічна виставка AeroIndia проводиться в Індії вже в одинадцяте і за цей час стала центром з розвитку співпраці оборонних підприємств авіаційної галузі в усій Азії .	стала	14	Fem
Ненависть розпочалася .	розпочалася	1	Fem
Ненависть сягнула свого апогею .	сягнула	1	Fem
Мотря нічого не одказала , — тільки жалібно дивилася .	дивилася	8	Fem
При докладному розгляді ніжок ( спеціяльно розбитих ) , який я перевів на сотнях примірників , показалося ясно , що посудину виготовлялось наступним способом .	показалося	16	Neut
Одно руденьке з двома блакитними латочками на спинці курча зацікавилося маминою бородою , підскочило і повисло на ній .	зацікавилося	9	Neut
Дідо зв’язався з будапештськими архівами , і йому надіслали поштою всі відомі фотопортрети Земельвайса .	зв’язався	1	Masc
Через привидів я запрошував до садочка гостей .	запрошував	3	Masc
Вінстон залишався стояти спиною до телезахисту .	залишався	1	Masc
Заходив вечір , і хлопець , поблукавши трохи по Шевченківському бульвару , вирішив таки навідати Надійку , що спинилась у подруг недалеко критого ринку .	Заходив	0	Masc
Вони все йшли , кололи ноги на колюче зілля , шарпали одежу об гострі терни , кров була на слідах їх ; йшли і падали один по одному , бо сила покинула їх .	покинула	31	Fem
У середньовічній Європі , де панувала християнська мораль , купання довгий час не дозволялося взагалі , бо це суперечило християнським поглядам на тіло та гігієну .	суперечило	18	Neut
Він взяв її на свої дужі крила і полетів з нею геть високо понад землею .	полетів	8	Masc
Божа мрія цвіла , як і перше , і на землі був спокій .	цвіла	2	Fem
У результаті між незнайомцями зав’язався словесний конфлікт , під час якого підозрюваний вдарив загиблого в обличчя - і він впав на асфальт " , - йдеться у повідомленні .	вдарив	12	Masc
Дзядзьо любив свого фльоберта , але розумів , що настав час , коли рушниця , навіть зовсім чиста й унікального калібру , повинна бути зліквідована , щоби не бути знайденою міліцією у хаті .	розумів	6	Masc
Натис на двері — вони відчинилися .	Натис	0	Masc
— Не йди , — каже , — чоловіче , якби він тебе хотів у куми взять , то б уже давно за тобою прислав .	прислав	24	Masc
Вернулася , а веприк на ціле горло верещить .	Вернулася	0	Fem
Я й лизнула — пів’язика й залишилось на замку .	лизнула	2	Fem
Вранці виявлялись позасипаними двері , щоби їх відчинити , вилізалося з лопатою через вікно і розкидувалося замети .	вилізалося	9	Neut
Також пошепки розповідали історії про жахливу книгу , першоджерело усіх єресей , автором якої був Гольдштейн і яка таємно поширювалася по всіх усюдах .	поширювалася	19	Fem
Вийшов із землянки , взяв колодочку , прив'язав до вугла , а сам потяг додому .	потяг	13	Masc
Найперш барикада мала би перегородити затишну вітальню косачівського дому , бо , як дізнаємося з академічних пояснень , Ольга Драгоманова - Косач « стояла на ліберально - буржуазних позиціях » , а її донька стояла – на марксистських .	мала	2	Fem
Щоб не розбивати нумерації в словничку , — а це б вимагало нових чисел у російському покажчику , — новий фразеологічний матеріял розміщено не по відповідніх групах , а додано вкінці фразеологічного словника .	вимагало	11	Neut
Відомо , наприклад , що у вересні 1741 він видав їй 2 тисячі золотих .	видав	9	Masc
Внизу , по землі , слався мох , пообростав усе , що тільки можна .	пообростав	8	Masc
Було приємно бачити кріпкі й дужі ноги , вузькі стегна , плаский живіт , м’язисті руки , тверду шию , засмалені жовто - бронзові тіла й несховане бажання , але Вер нехтувала їх .	нехтувала	31	Fem
Умочав мішок у воду і клав один на інший .	клав	5	Masc
У 1949 році , зазнавши поразки від комуністичних збройних формувань Мао Цзедуна , підтримуваних СРСР , на острів Тайвань із материка втік очільник Гоміньдану генералісимус Чан Кайші .	втік	21	Masc
Мокрий , він поліз під матір , але не міг там довго висидіти виглядав то з-під крила , то спереду , вилазив на спину або біг геть і націлявся на стіні на поважну чорну муху .	вилазив	21	Masc
Вона пересадила .	пересадила	1	Fem
Згоріло все причандалля , яким ми прикрасили бар — великі довоєнні знимки Заліщиків , аванґардові плакати з Праги , мій домашній програвач з колекцією платівок , пучки макових головок , вінки часнику і снопики кримської марихуани .	Згоріло	0	Neut
Ми навіть були приготовили склад першого уряду Зеленої України , який складався з найбільш знаних українців на Далекому Сході поза межами СССР » , — згадував Купецький .	згадував	25	Masc
Одходячи на спокій , сонце обдало землю блискучим промінням ; земля на прощання усміхнулася — і потемніла .	обдало	5	Neut
Один чоловік пише про себе : " Отримав біологічну та літературну освіту " .	Отримав	7	Masc
Вийшов із землянки , взяв колодочку , прив'язав до вугла , а сам потяг додому .	Вийшов	0	Masc
Він крикнув уголос : « Дивіться , дивіться ! » — і всі дивились туди , куди показувала його рука , — там упала зоря .	показувала	17	Fem
Хотів подякувати за чудове видання та можливість першими прочитати в перекладі з оригіналу .	Хотів	0	Masc
Він завис у Франківську .	завис	1	Masc
Останнє було сказано з таким задоволенням , ніби вона діжку огірків собі насолила .	насолила	12	Fem
Не бачила і не зустріла його .	бачила	1	Fem
Напередодні в ужгородському нічному клубі " KontraBass " Даша виступила в новому для себе амплуа – діджея .	виступила	9	Fem
Пізніше я довідався , що таке пояснення використовувалося в усіх частинах радянської армії незалежно від географічної зони .	довідався	2	Masc
Ми обоє були Тарасами , і Князь вважав таке звертання чимось таким , як брат .	вважав	7	Masc
Він , рижий , з маленькими гострими очима , упиром упився в її соковите дівоцтво і висмоктав з нього перші найсолодші соки .	упився	10	Masc
Міністр фінансів Олександр Данилюк повідомив , що підписання Меморандуму з Міжнародним валютним фондом - це питання найближчих днів .	повідомив	4	Masc
Вольфрам збільшив обсяг тексту , довів до кінця фабульні зв'язки та вніс деякі зміни в основний сюжет , розроблений Кретьєном , але в цілому дотримувався задуму останнього .	вніс	11	Masc
Недруковані лишилися 1-й аркуш ( бо задержався портрет , перебитий з календаря « Громада » ) та останній з словником гуцульської говірки .	задержався	6	Masc
Прибігаємо в село , помітили в яку хату він ускочив .	ускочив	9	Masc
Наша гора ставала недоступною , вода заповнювала всі підходи .	заповнювала	6	Fem
Але терпіла , робила усмішки , танцювала на музиках , верталася поночі додому .	верталася	10	Fem
я одна не зрозуміла ?!	зрозуміла	3	Fem
Гнат і не думав спитати , куди відійшла .	відійшла	7	Fem
Малеча хапала гливкий жовток , давилася , чмихала .	хапала	1	Fem
Дослідження складових ґрунту спочатку принесло нове розчарування : по всій поверхні « хворих » стулок були виявлені цинкові білила , які в живописі почали використовувати в XIX столітті замість традиційних свинцевих .	принесло	4	Neut
Він визнав , що час від часу вживає марихуану шляхом куріння , а цей пакетик він поклав до кишені , і забув за нього , оскільки не одягав куртку з минулого року .	визнав	1	Masc
До чого дурний , як валянок , до чого малий і страшний ( тато недоробив , мама недоносила ) , до того ж постійно прагне накликати на себе біду .	недоносила	17	Fem
Ми поговорили про це з татом однієї ночі , і тато визнав , що настав час мого покоління і мого вибору .	визнав	11	Masc
Один з них знаходився безпосередньо на стіні будинку навпроти .	знаходився	3	Masc
Він іде до ставка та й зажуривсь .	зажуривсь	6	Masc
Я приходив щодня у молочну чергу , бо діти були малесенькі .	приходив	1	Masc
Поверхня посудини тоді вигладжувалась зглядно потім ще примазувалась .	примазувалась	7	Fem
Найтяжче було згадати , про що саме йшлося , коли хтось починав оповідь з того місця , на якому зупинився кілька днів або тижнів тому .	починав	11	Masc
Начальниця дитячої кімнати Смірнова не пропускала нагоди вдарити когось із затриманих гумовим шланґом з піском .	пропускала	5	Fem
Подібна витівка його попередника Миколи Митлюка коштувала йому життя .	коштувала	6	Fem
Він загинув у перші дні війни у вересні 1939 .	загинув	1	Masc
Замовила нову книжку Роальда Дала - сподіваюсь , вона сподобається моїм малим не менше за " Чарлі та шоколадну фабрику " .	Замовила	0	Fem
Воно й не дивно , що жінка - психолог від такої навали мегастресових подій зірвалася на істерику і навіть спробувала самовбитися .	спробувала	19	Fem
Він мовчки собі сидів , а водії невдовзі почали говорити між собою , перейшовши за звичкою на угорську .	сидів	3	Masc
Доній написав черговий пост про Баригу та зраду .	написав	1	Masc
З купи грубого шутру я вхопив кілька камінців і з усього розмаху тричі вцілив у голову Біди з малої відстані .	вцілив	13	Masc
Пізніше так само допитали й інших осіб з нашого кола , але ніхто не видав мене , а ті , що могли видати , не знали й так , хто автор .	видав	14	Masc
Я сказала , що обійдусь без чека .	сказала	1	Fem
І не розходилась та пісня по світу , не окликалася луною в лузі , як соловейкова , а , як важкий камінь , налягала на душу , морочила голову цілим роєм темних гадок , пекла серце нерозважною тугою ...	пекла	34	Fem
А серед них десь існують й такі , на яких одвіку ще не ступала нога людська .	ступала	13	Fem
Текст Василя Овсієнка - старий , але досі найбільш " підручниково " - інформативний , для тих , хто не застав і не пам'ятає : http://umoloda.kiev.ua/number/163/0/71564	застав	20	Masc
На другому місці за популярністю запитів розташувалася наукова фантастика " Прибуття " , а на третьому місці розташувалася – режисерська робота Мела Гібсона , військова драма " З міркувань совісті " .	розташувалася	6	Fem
Учора дав мені товариш скалку од дзеркальця , я глянув на себе і не впізнав .	глянув	9	Masc
Моїх дітей він здивував тим , що страшенно спритно ловив комарів і живцем їх з’їдав .	ловив	9	Masc
А він час від часу привозив від своїх друзів з інституту космічних досліджень якісь фраґменти супутникової техніки і врешті склав такий дельтаплан з двигуном , котрий за радіокомандами підлітав , кружляв і приземлявся .	кружляв	30	Masc
— Начхав я на твою раду .	Начхав	1	Masc
І , коли батько ті іграшки підхвалював , Марина гримала на батька й на сина , що збив таку кептюгу коло землянки .	збив	17	Masc
Над’їхав вечірній рахівський , з вікон виглядали пасажири .	Над’їхав	0	Masc
Настрій та спосіб вести розмову треба знайти такі , щоб чоловік невдовзі зажурився за минулим теплом .	зажурився	12	Masc
Але терпіла , робила усмішки , танцювала на музиках , верталася поночі додому .	робила	3	Fem
Він обпарив руку , коли ніс котел з окропом , і послизнувся на жирній бетонній підлозі у кухні .	ніс	5	Masc
Лише рябок , засвистівши , пролетів з однієї височенної кедри на іншу і завмер на гілці , мов сучок , нерухомо , опустивши чубату голівку вниз і витягши шию .	пролетів	5	Masc
Політична еліта , представлена більшістю тих , хто проголосував сьогодні проти українського уряду , виявилася неготовою визнати легальну економіку і публічну політику єдиним можливим способом суспільного розвитку .	виявилася	14	Fem
Шахматов , наймолодший з них , сполучав філологічну майстерність із молодограматичною методологією .	сполучав	6	Masc
Великі й швидкі хвилі розгойдали дуба так , що важко було навіть всидіти , вода залила його з усіх боків , лупили блискавки .	залила	15	Fem
Можна виробити формулу , яка б ураховувала всі ці фактори .	ураховувала	6	Fem
Тому ми й вирішили надрукувати цю розвідку О . Кандиби , яка дотепер лишилася в рукопису .	лишилася	13	Fem
Саме так , солила , спеціально принесеною з дому сільничкою .	солила	3	Fem
Марія швидко наливалася соками і округлювалася .	наливалася	2	Fem
Утворена в травні 1919 Команда запілля , що перебрала тимчасово функції ДСВС , увійшла в червні до Етапної Команди УГА .	перебрала	8	Fem
Новостворений світ сіяв чудовою красою , скрізь була гармонія , ясне , повне життя .	сіяв	2	Masc
Байдужим поглядом вона пробігала по юнаках і одверталася .	одверталася	7	Fem
Почалась " темна доба " " щербиччини " - на цілих 17 рр .	Почалась	0	Fem
Вони йшли все далі , і світло далі ставало .	ставало	8	Neut
Цілком пожовтівши , я востаннє випив тьмяного старопраменського , келішок фальшивого коньяку порто-марія і здався в інфекційні бараки .	здався	14	Masc
Виявилося , що вся ця вода була призначена на цілу добу для чаїв , миття рук , поливання квітів усього готельного поверху .	Виявилося	0	Neut
Щоб він узяв за жінку стару бабу із залізним носом ?!	узяв	2	Masc
Зустріла на прогулянці в парку ситуацію , еталонну для істерії навколо київпрайд .	Зустріла	0	Fem
Цей голос лунав з видовженої металевої тарелі , що нагадувала поблякле дзеркало , та була вмонтована в поверхню стіни праворуч .	нагадувала	9	Fem
Тоді ми кажемо : хіба тобі невідомо , що Вапліте завжди чесно і акуратно виплачувало свої векселі ?	виплачувало	14	Neut
Читання випало дуже щасливе : гостей прийшло чоловік 120 — 150 .	випало	1	Neut
Доповідь Feeding America засвідчила , що 66 % домогосподарств мусили обирати між тим , витратити гроші на їжу чи на медичне обслуговування .	засвідчила	3	Fem
І отримала гармонію .	отримала	1	Fem
Вона закінчила акторські студії в Ленінграді , він — двічі доктор фізики і математики .	закінчила	1	Fem
— Є також чутка , що до уряду втягають старого віком Льойда Джорджа , який , до речі , у своїх спогадах гостро висмівав Черчіля , як недотепу .	висмівав	23	Masc
За повідомленням , у перебігу рейду , здійсненого раніше в неділю , також загинув один американський спецпризначенець і троє були поранені .	загинув	13	Masc
Забрала вона ті харчі , заплакала та й пішла з батьком .	заплакала	5	Fem
Була рання весна .	Була	0	Fem
Нагодував дітей , чим було , взяв на плече сокиру і пішов широким світом .	взяв	6	Masc
Робилося шкода затраченого дівоцтва .	Робилося	0	Neut
" Правоохоронці з’ясували , що невідомий зробив потерпілому зауваження через те , що він палив у недозволеному місці та лаявся на перехожих .	лаявся	19	Masc
І стояла в темноті тій ще темніша доля їх — чорна , темна , страшна , з худим , з'їденим нуждою лицем , з злими од голоду очима ...	стояла	1	Fem
Несподіваний різкий поштовх виривав тебе зі сну , жорстка долоня трусила тебе за плече , сліпуче світло різало твої очі , коло з жорстких облич стояло навколо ліжка .	різало	17	Neut
Посол Нолькен повідомив у Стокгольм , що Російська імперія на межі державного перевороту і що війська не будуть битися за Анну Леопольдівну .	повідомив	2	Masc
А на зароблені гроші видав брошуру на підтримку капіталізму та християнських цінностей .	видав	4	Masc
Моя подруга отримала біометричний паспорт і вже їздила з ним до Франції .	їздила	7	Fem
Так сприймала свій національний гімн ґенерація , яка й спромоглася відродити державу , це якраз із цього кола вийшло чимало провідних діячів Української Народної Республіки .	сприймала	1	Fem
Серце почуло якесь лихо ; перед очима вже стояла біда ...	почуло	1	Neut
Регіт стих ; усі похнюпили очі у землю ; одна тільки Галя гостро дивилася на всіх гультяїв — і червона краска грала на її щоках , тоді як серце підкидалося в грудях , а груди поривчато дихали .	грала	21	Fem
Та вона може заперечувати , брехати , замовчувати , що перетворилась на звьозд штучних , яких багато , повелась на таке .	повелась	18	Fem
Злий дух сидів у підземній країні і думав .	сидів	2	Masc
Попри те що більшість британців не приймають поглядів і політики нового президента США , Мей звернулася до колеги з теплими словами .	звернулася	15	Fem
Зміїна дочка зробилась ізнов людиною , а той дід зробився парубком , та давай утікати .	зробилась	2	Fem
Джин повставав у його шлунку .	повставав	1	Masc
Тільки прийшла та збудила його , щоб він пшеницю видав купцям на байдаки з тих комор .	прийшла	1	Fem
Дзядзьо не хотів за таке пити і спробував вийти з-за столу .	спробував	7	Masc
Вхопив свою матір і скочив просто в пекло .	Вхопив	0	Masc
Сьогодні , припустивши мерзенну й безсовісну думку про смерть Марії Василівни , члени педколективу , що делегували завучку з вінком , добряче зіпсували свою оцінку , яку Марія Василівна виставляла кожній особі на цій землі ( професійний рефлекс ) .	виставляла	29	Fem
А вже наступної ж миті він був єдиним цілим з усіма тими людьми що були поруч та все що вони казали про Гольдштейна здавалося правдою йому .	здавалося	23	Neut
Такого приниження я не зазнавав ще ніколи .	зазнавав	4	Masc
Яйця були якраз в міру теплі , й , перевертаючи їх ніжно дзьобом з одного боку на другий , вона всією своєю істотою відчувала в кожному маленьке скорчене тільце і величну силу життя , що його наповняла .	наповняла	36	Fem
Потім звеліла запрягти карету і поїхала до свого батька .	звеліла	1	Fem
Засунув вудку почварі в горлянку .	Засунув	0	Masc
З кожним пацієнтом , у кого виявляли гепатит типу Б , наступного дня розмовляв офіцер відділу боротьби з наркотиками .	розмовляв	13	Masc
І ждала .	ждала	1	Fem
Було тут « утро » , що врядили приїжджі росіяни з Ніцци , але таке погане , що не тільки акторам , а навіть публіці було сором і ніяково дивитись одним на других …	Було	0	Neut
Той , хто програв , мусив заколоти випадкового глядача , що опинився у цей час у цьому місці .	програв	3	Masc
Він з нами спав , їв , пив , ходив містом , попросту жив .	спав	3	Masc
Вона впала на високу гору , і на горі спалахнуло світло , горіло і вабило серце .	горіло	12	Neut
Лише рябок , засвистівши , пролетів з однієї височенної кедри на іншу і завмер на гілці , мов сучок , нерухомо , опустивши чубату голівку вниз і витягши шию .	завмер	13	Masc
І , коли батько ті іграшки підхвалював , Марина гримала на батька й на сина , що збив таку кептюгу коло землянки .	гримала	9	Fem
Саме тому цей сік І . П . Павлов називав апетитним соком .	називав	9	Masc
Може вона і жалілась , скажімо , на чоловіка - мамі , священику , подругам , - і почула " що поробиш , терпи , то треба терпіти " .	почула	18	Fem
Там по них ходило сонце і пливли над ними білі хмари .	ходило	3	Neut
Мені було три роки , коли дзядзьо навчив мене і мого делятинського кузена кількох козацьких пісень .	навчив	7	Masc
А потім набив піпу , запалив та й курить , як із комина ...	запалив	5	Masc
Хотілося мститись на комусь , а що під рукою Гнат , то на нього все .	Хотілося	0	Neut
А він час від часу привозив від своїх друзів з інституту космічних досліджень якісь фраґменти супутникової техніки і врешті склав такий дельтаплан з двигуном , котрий за радіокомандами підлітав , кружляв і приземлявся .	підлітав	28	Masc
їв і пив доти , доки в нього лізло .	лізло	8	Neut
Читання випало дуже щасливе : гостей прийшло чоловік 120 — 150 .	прийшло	6	Neut
Закликав мене на допомогу , ми виміняли у здивованих робітників м’ясокомбінату за ящик горілки кілька мішків пенісів .	Закликав	0	Masc
Убиралася в барвисті спідниці , голову накривала по-дівочому , заплела розплетену дружками косу .	Убиралася	0	Fem
Коли дивився на дітей , то серце йому розривалося : бліді , голодні й такі слабенькі , що падуть од вітру .	розривалося	8	Neut
Це трапилося того ранку у Міністерстві , якщо про щось таке нечітке та туманне можна сказати що воно трапилося .	трапилося	18	Neut
Із Батумі приїхала десятикласниця , котра вже понад рік терпіла без Каракєджби .	терпіла	9	Fem
Її там не впізнали , і як уже вона розказала все , то мачуха аж об поли вдарилась , що , бач , вона думала її з світу зігнати , а тут зовсім не так вийшло ...	думала	24	Fem
На початку за взірець правила церковнослов’янська мова , і пам’яток , писаних саме цією мовою ( в різних її редакціях ) , є сила - силенна впродовж усієї історії української мови від XI до XVIII ст .	правила	4	Fem
Він бачив зорю , і вона йому серце вразила .	вразила	8	Fem
Також , 24 травня Печерський райсуд Києва відпустив під заставу в розмірі 15 млн гривень колишнього начальника Державної податкової служби в Луганській області Олександра Антипова .	відпустив	7	Masc
Запріг він коня , приїхав додому та й каже :	Запріг	0	Masc
Андрій помовчав , подивився пильно на того , що питав , посміхнувся й раптом викарбував :	помовчав	1	Masc
Камінь цюкнув павука по голові — й той , знепритомнівши , звалився з дерева й гепнувся на землю , задерши лапи .	гепнувся	15	Masc
— Отой волоцюга , блудяга ... покинув на Дону жінку з дітьми ... приплівся сюди на мою голову ...	приплівся	13	Masc
Тим часом матір нового президента США була шотландкою ; він не раз висловлював захоплення королевою і , як відомо , з нетерпінням чекає на гостини в Єлизавети II .	висловлював	12	Masc
Він просто про принцип Маха чув , але не зрозумів .	чув	5	Masc
У Стокгольмі дійшли висновку , що достатньо одного тільки виду шведських військ , щоб влада Анни Леопольдівни і німців зруйнувалася , а нова імператриця в подяку за допомогу щедро наділить шведського короля російськими землями .	зруйнувалася	19	Fem
Без цих слів я « Живем комуною » не згодився б друкувати .	згодився	9	Masc
Вона стоїть без хустки , сива , пишноволоса — колись її волосся сяяло проти сонця золотим , тепер не сяє .	сяяло	12	Neut
Вийде перший , під білим прапором — під оцим - о , — взяв сорочку до рук , але вона не пахла : він перестав чути запахи , чув лиш паленизну .	перестав	24	Masc
Машиніст загальмував , вискочив зі своєї кабіни і скотився в яр .	загальмував	1	Masc
— Нема , — одказував Левко , блукаючи очима поверх золотого Марфиного волосся , що вибилося з-під чорної хустки .	вибилося	15	Neut
Зміст Вашої книжки переглянув .	переглянув	3	Masc
Про рік 1874-й я знав від С . О . Єфремова , який знайшов ще листи , писані Вами з Відня до видавництва « Вік » .	знайшов	13	Masc
Квочка несамохіть тріпнула головою , і мале покотилося по землі .	тріпнула	2	Fem
Щоби мама не знала , що він курить , товариш тримав сиґарету не пальцями , а затиснувши її у гребінь з довгим руків’ям .	тримав	10	Masc
Як тільки випогоджувалося , ми лізли на дах і смолили шпари .	випогоджувалося	2	Neut
Мар'яно , " Граф Монте-Крісто " виходив українською ще далекого 1924 року , три з чотирьох томів оцифровані , можна завантажити тут : http://toloka.to/t73252	виходив	6	Masc
При докладному розгляді ніжок ( спеціяльно розбитих ) , який я перевів на сотнях примірників , показалося ясно , що посудину виготовлялось наступним способом .	перевів	11	Masc
І не розходилась та пісня по світу , не окликалася луною в лузі , як соловейкова , а , як важкий камінь , налягала на душу , морочила голову цілим роєм темних гадок , пекла серце нерозважною тугою ...	окликалася	9	Fem
— Чик — і вилущив стукача , га !..	вилущив	4	Masc
Плов приготував біженець із Узбекистану .	приготував	1	Masc
— Англійський король приняв на авдієнції новоіменованого мін . Стеффорда Кріппса і тим наче підкреслив його значення .	приняв	3	Masc
Цитую : « Я вже давно звик до вибриків різних телерадіочинуш , котрі , прогинаючись перед можновладцями , забороняли мені працювати в ефірі , бо я ж — « ображав критикою небожителів » .	ображав	29	Masc
Купила товар , а потім вже на роботі подивилась в неті , що сьогодні , у чорну п'ятницю ( як виявляється сьогодні такий день був ) , на мій товар була знижка .	подивилась	8	Fem
Міністерство Миру яке піклувалося про війну .	піклувалося	3	Neut
І відкіля це лихо взялося ? і чого воно до них вчепилося ? чим була Мотря Остапові ?.. чим вона тепер осталася ?..	осталася	21	Fem
Він зовсім забув , що тільки тиждень минув , як покинув село .	минув	7	Masc
Він обпарив руку , коли ніс котел з окропом , і послизнувся на жирній бетонній підлозі у кухні .	обпарив	1	Masc
Маленька рудувата жіночка перетворилася на яскраво рожеву , її рот відкривався та закривався неначе у риби що потрапила на суходіл .	перетворилася	3	Fem
По дорозі з Делятина я наполовину висувався з вікна і на повній швидкості стріляв з пістолета по заданих татом цілях , переважно у дорожні знаки .	стріляв	13	Masc
Вернулась у хату — не хочеться самій вечеряти .	Вернулась	0	Fem
Вона пішла за мого тата « на дитину » , як мені було дев'ять років , і прожила з ним до війни рівно місяць , а зі мною оце вже шостий рік мучиться .	пішла	1	Fem
І зразу вискочив із пекла .	вискочив	2	Masc
Хтось ішов попереду , тримаючи в руці булку і копійки .	ішов	1	Masc
З їх домових вогнищ вийшла молода ґенерація , повна самопосвяти .	вийшла	4	Fem
Всіх зчарувало воно навіки , і чари його були отрута .	зчарувало	1	Neut
Квочка несамохіть тріпнула головою , і мале покотилося по землі .	покотилося	7	Neut
Одначе змирився з видавницькою твердолобістю - просто перестав купувати їхній продукт .	змирився	1	Masc
Людське життя плило тихими хвилями і зливалося з тією мрією в одне осяйне , спокійне море .	плило	2	Neut
Андрій окинув камеру оком , подумав хвилинку , позіхнув і відповів :	окинув	1	Masc
У його створенні нас традиційно надихнула Італія , де особливо цінують домашній затишок і не задовольняються звичайними вузькими та більш жорсткими диванами .	надихнула	5	Fem
На mi-carême ( середина посту ) санремосці сподівались знов карнавальних розривок , але їх перенесли в Бордігеру ( се маленьке місто коло Сан-Ремо , тепер воно вже так як передмістя , бо злилось віллами і садами з Сан-Ремо ) .	злилось	32	Neut
Ніхто з них не кидався до печі .	кидався	4	Masc
Прийшла господиня і , вийнявши , щоб не подушилися між яйцями , тих , що вже обсохли , поклала в решето та поставила на піч .	поставила	22	Fem
Всі прагнули щастя , а ніхто не знав його , всі хотіли бачити його , мати його на хвилинку і вмерти потім , бо воно стало їм миле над життя .	знав	7	Masc
Ми йшли на багатогодинні прогулянки , і я часом на хвильку засинав , веслуючи на човні посеред озера .	засинав	11	Masc
Від різних людей , Ваших земляків , я ще дізнався , що Ви великий аматор книжки української .	дізнався	9	Masc
Почав думати , як самому таку зробить .	Почав	0	Masc
Капітан Єлізаров видавав нам лише десяту частину спиртової норми , а решту тримав у слоїках , зачинених у сейфі .	тримав	12	Masc
— Щоб ти оту гору розкопав , і щоб туди Дніпро йшов , а коло того Дніпра побудуй комори : щоб байдаки туди приставали , й щоб ти ту пшеницю продав на байдаки .	розкопав	5	Masc
Вона пішла за мого тата « на дитину » , як мені було дев'ять років , і прожила з ним до війни рівно місяць , а зі мною оце вже шостий рік мучиться .	прожила	17	Fem
Вуйко Влодко телефонував до Франківська татові , щоби він переконав мене не відмовлятися від військової підготовки .	переконав	9	Masc
При докладному розгляді ніжок ( спеціяльно розбитих ) , який я перевів на сотнях примірників , показалося ясно , що посудину виготовлялось наступним способом .	виготовлялось	21	Neut
Тремтіння пройняло усі його нутрощі .	пройняло	1	Neut
А як з другого боку гримнув якийсь постріл , роздягнутий сердито кричав :	кричав	11	Masc
Прибігла змія та й каже до тієї річки :	Прибігла	0	Fem
— Добре , — погодився .	погодився	4	Masc
І Марина падала навколюшки , молила матір божу , щоб велика заступниця наслала мир на її рідну сторону і захистила від напасті !	захистила	19	Fem
— Іди собі ! — гукнув голова , бачачи , що в неї й річ відтяло .	відтяло	15	Neut
Половців розвіяла татарська навала 1234 - 1240 рр . , що її наслідком було загарбання всієї України мало не на ціле століття .	розвіяла	1	Fem
Про рік 1874-й я знав від С . О . Єфремова , який знайшов ще листи , писані Вами з Відня до видавництва « Вік » .	знав	4	Masc
Дуже задоволена була зі свого партнера Катерина Рубчакова , яка грала Анну .	грала	10	Fem
Поплював у руки , взяв сокиру та коли гупнув обухом по бабиному залізному носі , той переломився .	Поплював	0	Masc
Казала , що ночувала в Домахи , але злі язики говорили , що вона деінде проводила свої ночі .	ночувала	3	Fem
Раз лиш заблудив у глибокий ліс .	заблудив	2	Masc
Регіт стих ; усі похнюпили очі у землю ; одна тільки Галя гостро дивилася на всіх гультяїв — і червона краска грала на її щоках , тоді як серце підкидалося в грудях , а груди поривчато дихали .	стих	1	Masc
Потім він зацікавився Земельвайсом , угорським акушером , який вперше почав застосовувати антисептики , від чого смертність новородків і породіль відразу зменшилася у десятки разів .	зменшилася	21	Fem
Дзядзьо не надто знався на суспільних і державних системах , але вірив у сталість людської природи .	вірив	11	Masc
Рафаель брав у мене пару кубів спирту для промивання шифрувальної апаратури і вводив його собі внутрівенно .	вводив	12	Masc
Я , як громадянин , переконаний у тому , що демократія в Україні зазнала серйозної поразки .	зазнала	13	Fem
Що свого часу й практикувалося .	практикувалося	4	Neut
" До Умані завітав представник села Дзензелівка і попросив нас приїхати до них на тиждень з виставами , – пише актор Василь Василько .	попросив	8	Masc
Ми нещодавно подібний у смарт - шоп батькам брали , фірми Assistent , коштував близько 1600 гривень .	коштував	13	Masc
Він тихо гладив їй волосся , сам погноблений чуттям , що лишає по собі пустиню .	гладив	2	Masc
Маленький смугастий звірок , що сидів собі навпочіпки на поваленій кедрині проти сонечка і пильно , з виглядом ученого дослідника , розглядав торішній грибок , тримаючи його передніми лапками , раптом нашорошився .	розглядав	21	Masc
Капітан Єлізаров видавав нам лише десяту частину спиртової норми , а решту тримав у слоїках , зачинених у сейфі .	видавав	2	Masc
Однак , пара свій роман офіційно досі не підтверджувала .	підтверджувала	8	Fem
А що був красивий , то в процесі переховування кохав усіх зустрічних жінок , тому " кохання " в назві - у множині .	кохав	9	Masc
— Візьми та гляди , — каже , — небагато накладай на віз , щоб ти мені коня не спортив .	спортив	19	Masc
В інституті ми попрацювали рік , добре поїздивши карпатськими містечками і лісами , в яких ніколи більше не довелося побувати , вивчивши паралельний світ цілої мережі лісництв і запам’ятавши основи лісівництва .	довелося	18	Neut
У травні гурт виступив на сцені міжнародного фестивалю татуювань « TattoCollection 2015 » та разом з гуртом YouCrane влаштував міні - тур містами Західної України з завершальним концертом у Києві .	виступив	3	Masc
Зустріч дозволила актуалізувати значну кількість проектів , в найшвидшій реалізації яких зацікавлені обидві сторони .	дозволила	1	Fem
Вона перебирала й інші влучні слова - означення для своїх колег , слова нібито неприйнятні в мовленні вчителя .	перебирала	1	Fem
Азовське море утворилося на місці давнього морського басейну .	утворилося	2	Neut
Він спав довгі віки , і сон його був лихий .	спав	1	Masc
Бібліотека , його рідна дитина , складена з уламків поміщицьких книгозбірень , розкладок з повітполітосвіти та дрібних купівель і пожертв , нараховувала 2178 томів , що він їх сам переписав , перенумерував і порозставляв , розбивши на відділи .	нараховувала	21	Fem
Щодо ремонтів і " облагородження " зйомної квартири , то поміняла їх кілька , але тільки в першій і в цій , що живем зараз робили " облагородження " .	поміняла	10	Fem
На фініші командир полку виставляв чергову машину з термосами чаю .	виставляв	4	Masc
В Оришки затіпались челюсті , забігала по виду мишка .	забігала	5	Fem
Він міг бути почутий , звісно , але допоки він знаходився у своїй теперішній позиції його не можна було побачити .	знаходився	10	Masc
Коли назбирувалося більше талонів , я запрошував своїх приятелів у дієтичну їдальню , і ми влаштовували собі бенкет з бабки , политої киселем .	назбирувалося	1	Neut
Як зазначає Б . Вербер : « Сінгапур – держава демократична , але для того , щоб громадяни не голосували як попало , на виборчому бюлетені пишеться номер картки виборця » .	попало	21	Neut
Перед тим , як повіситися , пані Ірця принесла до нас свою колекцію срібного начиння і попросила , щоби ми віддали його урядові незалежної України .	попросила	16	Fem
Малеча хапала гливкий жовток , давилася , чмихала .	давилася	5	Fem
Пішла вона , набрала борошна , замісила , затопила в печі й почала варити вечерю .	замісила	6	Fem
У дельфінарії в різні роки утримувалося від 4 до 6 дельфінів походженням з Чорного моря та Тихого океану , морські леви та морські котики .	утримувалося	5	Neut
Я виходжу з-за клуба , в новенькому дешевому костюмі ( три вагони цегли розвантажив з хлопцями - однокурсниками , то й купив ) і з чемоданчиком у руці .	розвантажив	13	Masc
Заглянула на піч — нікого .	Заглянула	0	Fem
Маленький смугастий звірок , що сидів собі навпочіпки на поваленій кедрині проти сонечка і пильно , з виглядом ученого дослідника , розглядав торішній грибок , тримаючи його передніми лапками , раптом нашорошився .	сидів	5	Masc
1193-го Папа Римський Целестин III ініціював хрестовий похід на прибалтійських язичників .	ініціював	5	Masc
Пішла вона , набрала борошна , замісила , затопила в печі й почала варити вечерю .	затопила	8	Fem
( Щербицьким Москва замінила Шелеста пізніше , в червні 1972-го , коли каток репресій уже був розкручений на повну . )	замінила	3	Fem
Він дуже струнко сидів на стільці , його могутня грудна клітина роздувалася та тремтіла так ніби у ній вирував штормовий океан .	вирував	18	Masc
Ухватила її , полізла на піч , забралась аж у самий куточок та й з'їла її , а кісточки забрала в торбинку й повісила на жердочці .	з'їла	14	Fem
Один із них злегка нагнувся і при допомозі другого насадив на свої плечі скоростріл .	насадив	9	Masc
Пан Коцький злякався кабана , скочив на дерево та й подерся туди , де ведмідь сидів .	злякався	2	Masc
Напрацювалася й натягнулася .	натягнулася	2	Fem
Заходив вечір , і хлопець , поблукавши трохи по Шевченківському бульвару , вирішив таки навідати Надійку , що спинилась у подруг недалеко критого ринку .	спинилась	18	Fem
Нема на світі людини , якій би це не подобалось , звісно , коли дивуються нею .	подобалось	9	Neut
Чувак побачив , що патрульні заходять у під'їзд , хутко чкурнув у квартиру і причаївся .	чкурнув	10	Masc
Свого часу пів - Ірландії виїхало в штати , і чи згубило це Ірландію ?	виїхало	5	Neut
До Красної Поляни їхалося перевантаженим пазом справжнім серпантином .	їхалося	3	Neut
Міністерство Правди яке займалося виробництвом новин , освіти , розваг та образотворчого мистецтва .	займалося	3	Neut
Смугастий звірок - бурундук почав бавитися з ними , задравши хвостика , як той драгун султана , перестрибував через них .	перестрибував	17	Masc
Квітневе сонце таки добре припікало !	припікало	4	Neut
Засмалених юнаків у синіх і червоних штанцях вона дразнила своїми духовитими десу , червоними підв’язками — Вер була брюнетка — і прозорістю довгих чорних панчіх .	дразнила	8	Fem
Вінстон різко отямив себе та сів пряміше .	сів	5	Masc
Натомість Зілинський , прекрасний діалектолог , де-не-де у своїх діалектних дослідженнях наважувався робити висновки історичного ґатунку , що ніяк не підтверджувалися пам’ятками й залишалися чистісінькими спекуляціями ( які він сам пізніше мусив спростовувати ) .	наважувався	11	Masc
Божа мрія цвіла , як і перше , і спокій був на землі .	цвіла	2	Fem
І від того дня так забагатів , що не було такого багача в цілій околиці .	забагатів	5	Masc
Фільм зняли за романом Патрісії Хайсміт " Ціна солі " , який вийшов друком ще у 1951 році .	вийшов	12	Masc
Вночі тато попросив сиґарету , спробував курити й усвідомив , що більше не зможе цього робити .	попросив	2	Masc
" Змичка міста й села — це міцна запорука майбутніх міст - садів " , — кінчив він і здав працю на годину раніше , ніж мав би право зробити це за терміном .	кінчив	16	Masc
Маю зізнатися , що коли я почула цю фразу вперше ( років в 15 ) , я надавала їй зовсім іншого значення .	надавала	17	Fem
Політична еліта , представлена більшістю тих , хто проголосував сьогодні проти українського уряду , виявилася неготовою визнати легальну економіку і публічну політику єдиним можливим способом суспільного розвитку .	проголосував	8	Masc
В Ужгороді його застрелив совєтський офіцер .	застрелив	3	Masc
– Уважайте на нього , щоб не покинув університету і не вступив до театру , – звертається колишня актриса театру " Руська бесіда " у Львові Ванда Янович до Хоми Водяного .	покинув	7	Masc
Писав сонети про війну , як було вже казано , і про « святий ідеал » .	Писав	0	Masc
От хазяїн його взяв та й вивіз у ліс , думає : « Нащо він мені здався , тільки дурно буду годувати , — нехай лучче в лісі ходить » .	взяв	3	Masc
Вона глянула ще раз на Мотрю , поступилася назад , простогнала , сіла мовчки на піл , узявшись холодними руками за крайню дошку , щоб не впасти .	простогнала	10	Fem
Випробування технології проводилось протягом грудня у Кембриджі ( Великобританія ) , і , як показали результати , доставка може тривати близько 30 хвилин , що значно швидше та ефективніше , ніж доставка багатьма іншими методами .	проводилось	2	Neut
Миттєво його обличчя стало яскраво - червоним і вода потекла з його очей .	потекла	9	Fem
Вхопив свою матір і скочив просто в пекло .	скочив	4	Masc
Обидві братові змагалися голосами , і , розуміється , побила рекорд Марія .	побила	9	Fem
На висланні він мріяв стати оперним співаком .	мріяв	3	Masc
“ Я не любився ні з ким ще зроду , – щиро зізнається він Мавці .	любився	3	Masc
Її там не впізнали , і як уже вона розказала все , то мачуха аж об поли вдарилась , що , бач , вона думала її з світу зігнати , а тут зовсім не так вийшло ...	вдарилась	17	Fem
Прийшла господиня і , вийнявши , щоб не подушилися між яйцями , тих , що вже обсохли , поклала в решето та поставила на піч .	Прийшла	0	Fem
Там принаймні відлунювало піаніно .	відлунювало	2	Neut
Що так обурило білорусів ?	обурило	2	Neut
Мр . Фред Кетлінг прочитав програму від дошки до дошки , потім добув годинник , що вказував чверть на сему , і сказав коротко :	добув	12	Masc
Мені стало ясно , чому , коли я напередодні нашого бою випадково проходив повз чеський курінь , між ним і противником стояла дивна тиша .	стояла	21	Fem
Дякую всім , хто підтримував уряд і мене у ці півтора року .	підтримував	4	Masc
Від такої точної відповіді він втягнув голову в плечі й боязко заморгав білявими віями .	заморгав	11	Masc
Але склалося так , що пізніше нас несподівано зводило ще і ще у зовсім інших сферах — виробництві і продажу шипучих вин , представництві найпопулярнішого тижневика , створенні модного журналу , ловленні форелі .	склалося	1	Neut
Одно дерево упало на віз і розтрощило його на шматочки , друге вбило коня ; насилу той чоловік вискочив з лісу .	розтрощило	6	Neut
В одній з кімнат стояла велика фізгармонія , правдоподібно , лишилася з часів дяківки .	лишилася	10	Fem
Молдавські володарі , що , здавалося би , міцно сиділи в Білгороді на Дністрі , терпіли тут наявність „ татарського царевича “ ще до нової татарської хвилі часів Менглі - Герая .	здавалося	5	Neut
І « Стодолю » з ними , подумав він , лиш уголос цього не сказав .	подумав	7	Masc
Вона зсадила .	зсадила	1	Fem
Лише на його уроках українська література виглядала симпатичною .	виглядала	6	Fem
— Він врятується , — сказала вона ; в голосі їй дзвеніли істеричні нотки : — Він вислизне , він хитрий .	сказала	5	Fem
Але все було добре , поки раптово не звіявся вітер і почалася злива .	звіявся	8	Masc
Приїхали на Димну суміш , а найбільше мені сподобалося лежати під зірками о другій ночі .	сподобалося	8	Neut
Казала , що ночувала в Домахи , але злі язики говорили , що вона деінде проводила свої ночі .	проводила	15	Fem
Ти якось неуважно дивилась серіал .	дивилась	3	Fem
Чув він , коли вертається його дружинонька , як роздягається в темноті , розщіпає натягнену корсетку , думає про останній прощальний крадений поцілунок і всміхається до темноти ?	Чув	0	Masc
Вони здавались особливо смашними , і то один , то другий голосно шльопався на землю , коли сусіда занадто сильно сіпав його за палець .	сіпав	20	Masc
Усі , кому я радила , не пожалкували .	радила	4	Fem
Лише в південно - західному наріччі принаймні декотрі говірки ( а точніше їх носії ) називаються так , як визначив сам народ ( зазвичай це слова на позначення сусідів ) , а не штучними науковими окресленнями .	визначив	19	Masc
ні розвиненої промисловості , ні доброї освіти на острові не існувало .	існувало	10	Neut
Аж тут з’явилась почвара ( то Диявол був ) .	з’явилась	2	Fem
Вуйко Осип , який був начальником медичного поїзда УГА , а тому мав шанс закінчити медичні студії лише у Празі , добре розумів становище військових еміґрантів і скуповував картини без огляду на якість .	скуповував	27	Masc
І темніли вони для дочки й для матері ; здавалась темною хата , й світ що вривався у вікна , чорнів у віччю в них ...	вривався	16	Masc
Йому нарадили одну гарну дівку , щоб він її брав ; він за ту й забув , що його врятувала від змії , з іншою заручився .	брав	9	Masc
Той і сів .	сів	2	Masc
Він жорстко ґвалтував її та перерізав їй горлянку у мить оргазму .	ґвалтував	2	Masc
аж смішно , коли пишуть " нічого не робила " , очевидно же , що груди і губи зроблені , тільки дурний не побаче .	робила	8	Fem
Утворена в травні 1919 Команда запілля , що перебрала тимчасово функції ДСВС , увійшла в червні до Етапної Команди УГА .	увійшла	13	Fem
— Ще тому кілька днів спротивився прем'єр Великої Британії , Черчіль всяким змінам у свому кабінеті , а сьогодні вже є вістка , що в уряді Черчіля проведені зміни .	спротивився	5	Masc
На листопадових канікулах я відмовлявся записуватися у почесну варту біля пам’ятника чекістам , бо треба було хоч кілька днів побути в осінньому Делятині .	відмовлявся	4	Masc
Нам подобалося слухати Брежнєвське цмокання на збільшеній швидкості .	подобалося	1	Neut
( ні в Києві , ні у Львові , ні в Дніпрі - в жодному іншому місті , де я досі читала на презентаціях цей текст , подібної реакції не було ) .	читала	21	Fem
Спочатку вироблялися стінки її від вінця аж до ноги , а тоді виготовлялося додатково ніжку , вмащуючи глину з двох боків так , щоб постало дно та частинне або повне виповнення ніжки .	постало	24	Neut
В цю ж купу йде й сонетист Жак Шаню , якого преміювала навіть французька академія ( тільки цих своїх , релігійних , патріотичних і т . інш . вона й преміює ! ) .	преміювала	11	Fem
Найперш барикада мала би перегородити затишну вітальню косачівського дому , бо , як дізнаємося з академічних пояснень , Ольга Драгоманова - Косач « стояла на ліберально - буржуазних позиціях » , а її донька стояла – на марксистських .	стояла	23	Fem
Поплював у руки , взяв сокиру та коли гупнув обухом по бабиному залізному носі , той переломився .	переломився	16	Masc
Саме цей феномен спостерігався в розділених родинах , частина яких живе в Україні , а частина живе – в Росії .	спостерігався	3	Masc
Пляшки стояли на низенькому стовпчикові , з котрого світила синя лампа .	світила	8	Fem
Його справа вважалася політичною , бо брата затримали каґебісти .	вважалася	2	Fem
Він оповив їй рукою стан , і вона , припавши головою до плеча , тремтіла від далекої вільгості води й теплої вогкості очей .	тремтіла	14	Fem
Дід довго одказувався : жаль було йому дочки , — та що ти зробиш з бабою ?..	одказувався	2	Masc
Така , як вишивають дівчата своїм нареченим , — і трьом мужчинам од того видива на мить заперло дух : сорочка світилася в тьмі як жива , вона хотіла бути вбраною не на смерть , а до шлюбу .	світилася	21	Fem
А вона не спускала очей з вікна .	спускала	3	Fem
Дівчина мордувала кошеня ( дали 2 роки умовно ) - народ злиться бо мало ; Коломойський наєбав країну на 150 млрд - народ мовчить .	наєбав	16	Masc
Тато і мене назвав Тарасом передовсім тому , щоби не утворювалася здрібніла російська форма з жіночим закінченням .	утворювалася	10	Fem
Північноазовський прогин — це тектонічна структура , що утворилася на межі двох платформ .	утворилася	8	Fem
остання нам просто далась за дешевою ціною , тому й погодились на дещо закинуту квартиру .	далась	3	Fem
Особливо ж вразило те , що портал театру , завіса й декорації були мальовані в імпресіоністичній манері !	вразило	2	Neut
А щастя літало по світі зорею , блискавицею , вогником бродячим і ніде не спинялось надовго , і ніхто не мав його ціле в руках .	літало	2	Neut
Ввечері 2 березня , якраз напередодні дня народження Насірова , у Феофанії відбулось чергове дійство , головними дійовими особами якого були слідчі і " напівпритомний , ледь живий " український чиновник .	відбулось	12	Neut
Жінка стояла непохитною перед усіма ударами долі , а ще вона важила ( нетто ) , як три з половиною Славіки ( брутто ) .	стояла	1	Fem
— Заждіть ! — волосся їй розкошлалось ; виглядала як безумна .	виглядала	8	Fem
Чоловік заглянув у вікно : лампа світить і вогонь горить , аж іскри розлітаються , начеб якась невидима сила гребла грань у пічці .	гребла	19	Fem
Я нічого не сказав про ростовських , він оглянув мої вени і припустив зараження під час прийому в стоматолога .	оглянув	8	Masc
Біля музичного училища стояла старезна одноповерхова велика хата , в якій колись жив мій прадід Гнат .	стояла	3	Fem
Останній мешкав і працював у Варшаві , перебуваючи в тісному контакті з польським політикумом .	мешкав	1	Masc
Для статево нерозбудженої жінки , такої , що ніколи раніше не пробувала онанізму , це найкращий шлях якнайповніше розвинути її еротичну вразливість .	пробувала	11	Fem
На другий день , після того , як квочка добре викупалась в піску та досхочу наїлася , під неї підпустили курчат .	викупалась	10	Fem
Першим я побачила парк " Сосновий Бір " на території міста , який має 250 га площі .	побачила	2	Fem
Айбо коли чоловік гримнув по її носі , той так загудів , що почули в пеклі :	гримнув	3	Masc
Змія прокинулася , вийшла в двір та й дивиться на той луг , тільки сама стерня та скирти стоять .	прокинулася	1	Fem
Перед від’їздом вона подарувала моєму знайомому унцію чистого срібла .	подарувала	3	Fem
НТКУ анулювало договір із журналістом без будь-яких пояснень і попередження .	анулювало	1	Neut
Усе , було , лає її , сердешну , та знущається над нею , та ще , було , й діда підцьковує , щоб згриз голову своїй дочці .	згриз	24	Masc
Найперш барикада мала би перегородити затишну вітальню косачівського дому , бо , як дізнаємося з академічних пояснень , Ольга Драгоманова - Косач « стояла на ліберально - буржуазних позиціях » , а її донька стояла – на марксистських .	стояла	34	Fem
Один мужик щось сказав , що їм не сподобалося — « ЛНРівці » виштовхали з машини , прострелили обидві ноги — « провчили » ...	сподобалося	8	Neut
Як розповів 29-річний одесит , який їхав до сусідньої країни на заробітки , він й справді періодично вживає наркотики , тож , вирушаючи в дорогу , взяв дурман - зілля з собою про « запас » .	взяв	26	Masc
Текст « Живем комуною » , як він видрукуваний у « Шляхах мистецтва » , — це таке свідчення про бідність естетичну , що я й не знаю , як редакція погодилась його собі самій видати .	погодилась	31	Fem
Після третього ходу Пуня оголосив , що визнає себе переможеним і привітав чемпіона .	привітав	11	Masc
Пояс порвався на Кавказі , в горах Абхазії , на кордоні Пслух .	порвався	1	Masc
Мр . Фред Кетлінг поміркував , а потім нерадо запропонував від себе одно веселе місце на Бродвею з джез - бендом , неграми і зовсім голісінькими леді .	поміркував	4	Masc
— Ну , справивсь !	справивсь	3	Masc
Це , думав він з неоднозначною огидою — це був Лондон , головне місто Злітно - посадкової Смуги Один , третя з найбільш населених провінцій Океанії .	думав	2	Masc
Знаю ще таке : коли дитину вперше купають то воду після купелі слід виливати коли не стемніло і обов"язково під родюче дерево ( щоб продовжувався рід ) .	стемніло	16	Neut
8 - 10 лютого у Запоріжжі , в рамках соціальної програми дружини Президента України Марини Порошенко , проходив третій етап спеціалізованих тренінгів « Інклюзивна освіта – рівень свідомості нації .	проходив	17	Masc
Ненавиділа подарунків на уродини .	Ненавиділа	0	Fem
Жінка стояла непохитною перед усіма ударами долі , а ще вона важила ( нетто ) , як три з половиною Славіки ( брутто ) .	важила	11	Fem
Марія швидко наливалася соками і округлювалася .	округлювалася	5	Fem
Дівчатам навіть пропонувалося вибрати те , що їм більше подобається , — тонкий і довгий чи грубий , але короткий .	пропонувалося	2	Neut
Чіпка бачив , як вона поблідла , як заблищали в неї очі , як дві гарячі сльози скотилося по личку ... додолу .	поблідла	5	Fem
Знайшов у кишені давно не вдяганої куртки клаптик паперу , помережаний рядками цифр .	Знайшов	0	Masc
У Франківську вона коштувала щодня інакше , у межах двох копійок .	коштувала	3	Fem
Ця конструкція погано трималася .	трималася	3	Fem
Він і згодився .	згодився	2	Masc
Анжела побувала безпосередньо у головній конторі по вулиці Чекістів .	побувала	1	Fem
Шерлок Голмс розпалив у ньому інтерес до знань .	розпалив	2	Masc
Оскільки вони ідіоти , то Чужий не викликає аж такого жаху ; це раніше потвора хитромудро полювала за людиськами і щоразу більше лякала своєю кмітливістю , а тут Чужому вистачає просто відкрити рота і космонавти самі йому туди застрибнуть .	полювала	16	Fem
Він дивився на все це , а серце його неначе хто давив у лещатах — так йому було боляче та трудно ...	дивився	1	Masc
У перші місяці в армії я засинав так швидко , що не відчував від того жодної радості .	засинав	6	Masc
Це науковий факт , сказала вона .	сказала	4	Fem
І дійшло до того , що Марія часом не приходила на ніч додому .	приходила	9	Fem
У Читі він зійшовся з урками .	зійшовся	3	Masc
Ще за якийсь час ви шпурляли в нього тоді , як виводив свою голосну пісню , грудками , і нарешті він став для вас зовсім байдужим .	виводив	11	Masc
Цього ґатунку ніхто не знав , інфляція знецінила їх до вартості сірників , і я курив найкращі французькі сиґарети кілька місяців , коли був безробітним .	курив	15	Masc
Не переймайтеся , сценаристів це не цікавило .	цікавило	6	Neut
Заєць розказав за пана Коцького вовкові , ведмедеві , дикому кабанові .	розказав	1	Masc
З . : Разом із онлайн - замовленням із магазину Microsoft я отримав ( - ла ) ключ продукту .	ла	15	Fem
Виявилося , що попити спокійно тут дуже важко .	Виявилося	0	Neut
Вогонь знищив побиту дошку , прикриту Заліщиками , в яку ми дозволяли відвідувачам кидати ножі для полегшення .	знищив	1	Masc
Коли хтось застрелив жінку , яка жила ще ближче від лісу , ніж ми , дзядзьо вирішив знищити свій фльоберт , який зберігався у таємній пивничці під хатою ще з тридцятих років .	жила	6	Fem
Отець доктор Лаба у двадцятих був духівником у гімназії сестер василіянок , де вчилася тета Міра , а в сорокових був духівником — у дивізії « Галичина » , де служив дзядзьо Михась .	вчилася	13	Fem
Коли хтось застрелив жінку , яка жила ще ближче від лісу , ніж ми , дзядзьо вирішив знищити свій фльоберт , який зберігався у таємній пивничці під хатою ще з тридцятих років .	застрелив	2	Masc
Воно летючою зорею падало в серце , і серце починало горіти .	падало	3	Neut
Салтиков посилав його у недоступні місця і дивився , чим займаються різні звірі .	посилав	1	Masc
Вінстон встромив кінчик пера у ручку для пера та облизав його щоб позбутися масткого бруду .	встромив	1	Masc
Розсердилась баба і вбила сучечку .	вбила	3	Fem
П’янів і забувався .	забувався	2	Masc
Раптом з усіх боків надбігло багато міліціянтів .	надбігло	4	Neut
Прийшла господиня і , вийнявши , щоб не подушилися між яйцями , тих , що вже обсохли , поклала в решето та поставила на піч .	поклала	18	Fem
Скільки їй видав Шетарді — точно не встановлено .	видав	2	Masc
Біда не зважав на школи .	зважав	2	Masc
За два дні перед початком школи він подарував мені простенький однолезовий розкладний ножик , просвердлив у колодці дірку і засилив шнурок .	засилив	19	Masc
Давав їй місце на постелі й уважно віддалік слухав , коли засипала вона , як дихала .	Давав	0	Masc
Про це свідчила будова глини в місці стику стінок з дном — ( різний напрям глиняних пласточків ) , тріщини і таке інше .	свідчила	2	Fem
Потім я викинув його у ріку .	викинув	2	Masc
Юрко почав вивчати історію мистецтв , архітектуру , країнознавство , криміналістику , логіку , геральдику , допоміжні історичні дисципліни , дипломатичний етикет і протокол , термінологію найрізноманітніших галузей знань .	почав	1	Masc
Виявилося , що ця тема застаріла і вже нікого не цікавить .	застаріла	5	Fem
Чіпка дивився на неї та дивувався , що з нею сталося ...	дивився	1	Masc
Здійнявся з лона землі сивим туманом і холодною хмарою полинув над землею .	Здійнявся	0	Masc
Коли справді стався землетрус десь у вісімдесят першому , наша сім’я була єдиною з кількаповерхової камениці у Франківську , котра ніяк не зреаґувала на трясення .	зреаґувала	22	Fem
Не минало і дня , щоб Поліція Думок не викривала шпигунства та саботажу здійснених під його орудою .	викривала	9	Fem
Художник Джим Кей взяв перерву на 1 рік .	взяв	3	Masc
Спочатку я наївно думала , що , якщо побачила назву вулиці , яку знаю , то точно її знайду .	побачила	8	Fem
Знала , що від’їхав Корній , і не ходила більше тратити по гаях болючих ночей .	від’їхав	3	Masc
У місті Бучачі якийсь час діяли водночас 2 ГЕС : одна називалася міською ( вважалася комунальною ) , інша називалася — « на Топольках » , яка після відновлення діє й нині .	вважалася	14	Fem
Він дуже струнко сидів на стільці , його могутня грудна клітина роздувалася та тремтіла так ніби у ній вирував штормовий океан .	сидів	3	Masc
Від початку XVIII ст . мовну практику в Україні почала заполоняти російська мова , аж нарешті український складник звівся до поодиноких українізмів .	звівся	18	Masc
Він дивився на все це , а серце його неначе хто давив у лещатах — так йому було боляче та трудно ...	давив	11	Masc
Водночас кількість дітей і підлітків ( 0 – 14 років ) з 23 % у 1991 р . знизилася у 2014 р . до 15 , 1 % .	знизилася	18	Fem
Розсердилась баба і вбила сучечку .	Розсердилась	0	Fem
Щось важко , помалу йшло крутою стежкою на « становик » .	йшло	4	Neut
А він час від часу привозив від своїх друзів з інституту космічних досліджень якісь фраґменти супутникової техніки і врешті склав такий дельтаплан з двигуном , котрий за радіокомандами підлітав , кружляв і приземлявся .	приземлявся	32	Masc
Пізніше стався якийсь шал з Продовольчою програмою КПРС , і ми вивчали різні її аспекти на географії , біології , історії , хімії і фізиці .	стався	1	Masc
Голова комітету Верховної Ради у закордонних справах Ганна Гопко приєдналася до флешмобу # 22PushUpChallenge , який запустили на підтримку ветеранів АТО .	приєдналася	9	Fem
побачила в стрічці .	побачила	0	Fem
Стрілець ще наміривсь стріляти , утретє .	наміривсь	2	Masc
Він мешкав по черзі у нас і в наших друзів .	мешкав	1	Masc
І ось серед величної тиші , що залягала світлу мистецьку святиню метрополії світу , загомоніли великою тугою , затремтіли лункими радощами й ударили глибоким болем серця всього народу колядки Леонтовича .	залягала	7	Fem
Цикнув і завмер , виглядаючи з-за стовбура .	Цикнув	0	Masc
Щоби здержати навалу москалів , що лявіною котилася на наші окопи , двоє стрільців схопили скоростріл і вискочили з окопу , щоби бічним вогнем перетяти ворогові дорогу .	котилася	7	Fem
Але кілька вихідних я все ж потратила на малювання вікон - дверей і дрібного ремонту ...	потратила	6	Fem
Те , що ми з колегами бекали - мекали то сям то там , то се то те , людина взяла й сформулювала стисло , чітко й по суті .	сформулювала	22	Fem
Посеред денного сеансу в дитячому кінотеатрі , де ми прогулювали уроки , вмикалося світло , і функціонери міськкому комсомолу відпроваджували прогульників до дитячої кімнати міліції .	вмикалося	12	Neut
Економічне джерело боргів — це надто високий бюджетний дефіцит , що склався в перші роки Незалежності .	склався	11	Masc
Ідея полягала не так у тому , щоб поповнити бюджет із кишень « дармоїдів » , як у стимулюванні роботодавців і працівників , які виплачують та отримують зарплати в конвертах , вийти з тіні .	полягала	1	Fem
За роботу зовсім забула .	забула	3	Fem
Стояла ясна та прохолодна квітнева днина , на годинниках пробило тринадцяту годину .	пробило	9	Neut
Думав , думав чоловік , як зарадити біді , але ніяк не годен був щось надумати .	думав	2	Masc
Баба закричала , а далі простерлася , як пес простирається на паздір’ї , раз - двічі тріпнулася й померла .	тріпнулася	16	Fem
Така , як вишивають дівчата своїм нареченим , — і трьом мужчинам од того видива на мить заперло дух : сорочка світилася в тьмі як жива , вона хотіла бути вбраною не на смерть , а до шлюбу .	хотіла	28	Fem
Багато років я носив його на грудях .	носив	3	Masc
Ти мав жити і ти жив , за звичкою що перетворилась на інстинкт — що кожен звук який ти видаси буде записано та , за виключенням коли ти у пітьмі , кожен твій рух буде ретельно розглянуто .	перетворилась	10	Fem
Тому весь сенс мого існування полягав у тому , аби нізащо не стати серйозним членом суспільства , не бути відмінником , не отримати червоного диплома і не опинитися на дошці пошани : « Ними пишається наше місто » .	полягав	5	Masc
Особливо це відчувалося вночі , ліжко вібрувало , як при середньому землетрусі .	вібрувало	6	Neut
Зазначається , що Йохай надав федеральним слідчим інформацію та документи понад 2 місяці тому .	надав	4	Masc
Слоїки побилися , і весь спирт стік у приготовлену залізну миску .	стік	6	Masc
Як сказав він « не хочу » , так усі злидні і кинулись йому на шию .	сказав	1	Masc
Мій брат побував у дитячій кімнаті з іншої причини .	побував	2	Masc
Як розповів іноземець , він повертався додому з Російської Федерації , і в автобусі познайомився з чоловіком , з яким вони дорогою вживали амфетамін .	повертався	5	Masc
Грушами я її декорувала , бо лежали поруч на столі ))	декорувала	3	Fem
Один із найпопулярніших культурних заходів світового рівня відбувся на арт - заводі « Платформа » 13 - 14 травня , вже вдруге у 2017 році .	відбувся	7	Masc
Оришка болісно піднімала її і тяжко стогнала ...	стогнала	6	Fem
Погроза Володимира Винниченка перейти в сусідню літературу , писати для російського читача , краще здатного оцінити талановитого автора , спричинила серйозний конфлікт .	спричинила	19	Fem
Цей чистий випадок психологічного переносу мене так зачарував , що думала всю прогулянку .	думала	10	Fem
Дерев'яна частина влучила йому в голову .	влучила	2	Fem
Малеча хапала гливкий жовток , давилася , чмихала .	чмихала	7	Fem
І дівчинка в матроському костюмчику , що , сама того не відаючи , вишила йому останню зброю , теж була тут і дивилась на нього з любов’ю .	вишила	13	Fem
Як наслідок , процеси звукозмін висмикувалися з відповідного фонологічного контексту ; їхнє реалістичне історичне витлумачення робилося неможливим , а цілій концепції історичної фонології загрожувала небезпека перекручень .	робилося	15	Neut
Взимку , коли підвіконня , дахи , дерева й електричні дроти облипали снігом , гарно було розслонити вікна і дивитися на особливе рожеве сяйво — ілюмінація якось розчинялася у фактурі снігу .	розчинялася	27	Fem
Відразу за мостом існувала — зупинка підміського поїзду .	існувала	3	Fem
« Що ж до мене , – звірялася Михайлові Драгоманову , – то я тільки генієві можу простить кепсько збудований вірш , та й то не завжди .	звірялася	7	Fem
Незабаром націоналістична група отримала нове завдання — працювати з радянськими утікачами - українцями , яких утримували в концтаборі неподалік Харбіна .	отримала	3	Fem
Виявилося , що ця тема застаріла і вже нікого не цікавить .	Виявилося	0	Neut
Пуні попався справжній професіонал — після першого ж ходу суперник вийняв блокнот і записав Пунин хід пішаком .	вийняв	10	Masc
Баба закричала , а далі простерлася , як пес простирається на паздір’ї , раз - двічі тріпнулася й померла .	закричала	1	Fem
Громадськість так і не довідалася , про що говорили за зачиненими дверима , але вже за кілька днів виявилося , що з адміністративного тиску вийшов величезний пшик .	довідалася	4	Fem
Арештований майстер належав їм .	належав	2	Masc
Стояла ясна та прохолодна квітнева днина , на годинниках пробило тринадцяту годину .	Стояла	0	Fem
За виключенням дуже коротеньких нотаток , він зазвичай диктував усе що потрібно до мовоноту , який ясна річ був непридатний щодо його теперішньої мети .	диктував	8	Masc
А Андрій дивився усміхненими очима на всіх присутніх :	дивився	2	Masc
У місті Карачі станом на 24 червня 2015 року загинуло близько 830 осіб .	загинуло	9	Neut
Спустилася ніч ; викликала собі на втіху зорі ; викотився з-за гаю місяць — і став оглядати околицю ...	викликала	3	Fem
Процес писання зовсім захопив його ; перечитуючи свої речення , він мимоволі забував , що пише їх для іспиту .	забував	12	Masc
Він — усе , що залишилося від тематики “ Прометея ” .	залишилося	5	Neut
Київстар при зміні тарифного плану без попередження повісив мені замість гудків ... Океан Ельзи .	повісив	7	Masc
Спочатку гори було видно навіть з вікна нашого помешкання на третьому поверсі у центрі Франківська , але потім десь на околицях побудували високі будинки , і панорама зникла .	зникла	27	Fem
Зокрема , депутат від " Народного фронту " Анатолій Дирів кнопкодавив під час голосування за законопроект № 5247 про призначення позачергових виборів Сєвєродонецької міської ради Луганської області .	кнопкодавив	10	Masc
Якусь молдавську родину , в якої запідозрили холеру , насильно шпиталізували у тій самій лікарні , і біля дверей палати цілодобово сидів озброєний міліціянт .	сидів	21	Masc
По мовчанці мр . Віллі Морріс запримітив мимоходом , що з нагоди неділі здалося б у відповідний спосіб перебути сьогоднішній вечір .	запримітив	6	Masc
І не була повією і не стала .	стала	6	Fem
Коли розвиднялося , вже були на краю лісу .	розвиднялося	1	Neut
Учора вперше в житті застрягла в ліфті .	застрягла	4	Fem
Вранці Степан вийшов до неї на пристань і довго махав кашкетом її хустині .	вийшов	2	Masc
Пізніше я довідався , що таке пояснення використовувалося в усіх частинах радянської армії незалежно від географічної зони .	використовувалося	7	Neut
Потім він зацікавився Земельвайсом , угорським акушером , який вперше почав застосовувати антисептики , від чого смертність новородків і породіль відразу зменшилася у десятки разів .	зацікавився	2	Masc
Праворуч мр . Кетлінга , себто на 849-м кріслі , сидів уже бородатий добродій , що від нього на цілу англійську милю пахло чистокровним ірландцем .	пахло	22	Neut
Тут мені на думку сплив уривок з фільму Мориса Шевальє під назвою “ Любов опівдні ” , в якому тато - детектив відгадав , що його донька закохалася , бо що не день стала мити голову .	відгадав	22	Masc
Молода мати зовсім розгубилася .	розгубилася	3	Fem
Купила товар , а потім вже на роботі подивилась в неті , що сьогодні , у чорну п'ятницю ( як виявляється сьогодні такий день був ) , на мій товар була знижка .	Купила	0	Fem
Її предложено японцям , і представник ОУН відбув з послом Японії в Варшаві ґрунтовну розмову .	відбув	7	Masc
Якраз тоді він подарував мені блок справжнього мальборо , переданого з Америки .	подарував	3	Masc
Приїхали туди , чоловік той випряг коня , пустив його пастись , а сам зрубав дуба товстого - претовстого , розколов його до половини та й каже до злиднів :	пустив	8	Masc
Яйця були якраз в міру теплі , й , перевертаючи їх ніжно дзьобом з одного боку на другий , вона всією своєю істотою відчувала в кожному маленьке скорчене тільце і величну силу життя , що його наповняла .	відчувала	23	Fem
А потім набив піпу , запалив та й курить , як із комина ...	набив	2	Masc
Не менше значіння мав він як маляр і скульптор , та в цій ділянці залишив по собі чимало цінних речей .	залишив	14	Masc
Озирнувся і побачив возика — за ним !	Озирнувся	0	Masc
І Марина падала навколюшки , молила матір божу , щоб велика заступниця наслала мир на її рідну сторону і захистила від напасті !	наслала	12	Fem
І не розходилась та пісня по світу , не окликалася луною в лузі , як соловейкова , а , як важкий камінь , налягала на душу , морочила голову цілим роєм темних гадок , пекла серце нерозважною тугою ...	налягала	23	Fem
Вона глянула ще раз на Мотрю , поступилася назад , простогнала , сіла мовчки на піл , узявшись холодними руками за крайню дошку , щоб не впасти .	сіла	12	Fem
Врешті , там - таки « опинилося » чимало адресатів Українчиних дружніх листів .	опинилося	6	Neut
Часто тета Міра купувала ціле колесо сиру , і ми з братом вирізали у брилі замки і печери , виїдаючи все зайве .	купувала	3	Fem
Щоб той запах був тендітний і випромінювався лише у хвилини піднесення , треба , помивши голову , побризкати мокре волосся духами або одеколоном , а потім старанно витерти і висушити .	випромінювався	6	Masc
Програми Двох Хвилин Ненависті різнилися кожного дня , але не було жодної де б Гольдштейн не виконував головну роль .	виконував	16	Masc
Тета Міра виписувала в окремі зошити українські прізвища , систематизуючи їх за певними ознаками .	виписувала	2	Fem
АПП , зауваживши , що Пуня кусає під партою канапку , дозволила йому їсти відкрито на її уроках .	дозволила	11	Fem
На внутрішньому боці ремінця я записував формули щастя .	записував	5	Masc
Toyota в рамках програми знайомства української аудиторії з гібридними технологіями представила креативну експозицію на Фестивалі вуличної їжі , який проходить у Києві .	представила	10	Fem
Бо падав дощ , і плаття подорожнього геть чисто промокло .	промокло	9	Neut
Отець Головацький не знав , що через кілька років вони стануть родичами , що у Читі дзядзьо одружиться із сестрою жінки його брата .	знав	3	Masc
Свою передмову до книжки я , доповнивши різним матеріалом ілюстрованим , прочитав у історично - літературному товаристві при Академії .	прочитав	11	Masc
Старе тіло тремтіло , колихалося , стара голова не здержувалась на в'язах — хилилася на груди .	хилилася	13	Fem
Все своє свідоме життя я рівнявся на неї , попри те , що вона молодша від мене ” , — сказав Дрейк .	рівнявся	5	Masc
Вольфрам збільшив обсяг тексту , довів до кінця фабульні зв'язки та вніс деякі зміни в основний сюжет , розроблений Кретьєном , але в цілому дотримувався задуму останнього .	дотримувався	24	Masc
Залишаючи Міністерство о цій порі дня він пожертвував своїм ланчем у буфеті та усвідомлював що на кухні з їжі є лише скибка чорного хліба яка не дотягне до завтрашнього сніданку .	пожертвував	7	Masc
Тому я сиділа на підвіконні кав’ярні , пила міцний чорний чай з м’ятою і малювала вже внутрішній Казімеж .	сиділа	2	Fem
Її майже голі від сидіння груди горіли останнім огнем , який могла видушити матерня любов з виснаженого тіла .	могла	11	Fem
Сів до столу й почав уплітати .	Сів	0	Masc
Та й відразу вибігла , як молодиця .	вибігла	3	Fem
А ясна , дивна постать все далі ставала , все більше мінилась і зникла в тумані .	ставала	7	Fem
І темніли вони для дочки й для матері ; здавалась темною хата , й світ що вривався у вікна , чорнів у віччю в них ...	здавалась	9	Fem
Вся камера пирснула , скинулась від несподіванки й обернулася до того , що ставив запитання .	пирснула	2	Fem
Мусив вийти з черги в останню мить .	Мусив	0	Masc
Я ж нічого йому не зробила …	зробила	5	Fem
( Щодо марксизму , захоплення яким нібито знівелювало « згубний » вплив Драгоманова , то коментаторам зоставалося тільки сподіватися , ніби читачі обмежаться лише їхніми примітками .	зоставалося	16	Neut
– Раніше зими були такі , що снігу випадало по півметра , а то й більше , – розповідає директор Колочавського музею в Міжгірському районі на Закарпатті Василь Дербак , 73 роки .	випадало	8	Neut
Софі виросла на кінному заводі .	виросла	1	Fem
Орбітальний телескоп для досліджень Сонця було запущено Великобританією 1962 року в рамках програми « Аріель » , а 1966 року NASA запустила в космос першу орбітальну обсерваторію OAO - 1 ( англ . Orbiting Astronomical Observatory ) .	запустила	21	Fem
За цим фактом поліція розпочала кримінальне провадження за ч . 1 ст . 185 Кримінального кодексу України ( Крадіжка ) , - повідомляє Головне управління Національної поліції у Закарпатській області .	розпочала	4	Fem
Ухватила її , полізла на піч , забралась аж у самий куточок та й з'їла її , а кісточки забрала в торбинку й повісила на жердочці .	Ухватила	0	Fem
якщо хтось де проводить ритуальні танці для закликання весни , то я б радо приєдналась .	приєдналась	14	Fem
У середньовічній Європі , де панувала християнська мораль , купання довгий час не дозволялося взагалі , бо це суперечило християнським поглядам на тіло та гігієну .	панувала	5	Fem
Ухватила її , полізла на піч , забралась аж у самий куточок та й з'їла її , а кісточки забрала в торбинку й повісила на жердочці .	забралась	7	Fem
Посеред ночі від холодного відчаю ми вискакували на сніг , і мороз під зоряним небом видавався полегшенням .	видавався	15	Masc
Коли дивився на дітей , то серце йому розривалося : бліді , голодні й такі слабенькі , що падуть од вітру .	дивився	1	Masc
Зразу подумав : може , то іній ( це надворі було ) , тернув долонею — ні , не іній …	тернув	13	Masc
Пастух покинув сопілку і вхопився за серце .	покинув	1	Masc
А ясна , дивна постать все далі ставала , все більше мінилась і зникла в тумані .	мінилась	11	Fem
— Зараз ніколи ! — крикнув стерновий .	крикнув	5	Masc
— Моїй мамі хтось ніс переломив ...	переломив	5	Masc
Якось так склалось , що живу за принципом " де моя сім"я , там мій дім " .	склалось	2	Neut
Маленька рудувата жіночка перетворилася на яскраво рожеву , її рот відкривався та закривався неначе у риби що потрапила на суходіл .	відкривався	10	Masc
Його волосся було яскраво світлим , його обличчя було природньо рум’яним та життєрадісним , його шкіра була огрубілою від господарчого мила та тупого леза бритви , та вкритою крижаною маскою зими яка щойно скінчилася .	скінчилася	33	Fem
Наталья плакала , бо це було втручанням у біоценоз .	плакала	1	Fem
Глухий та монотонний ритм важкої ходи солдатських чобіт формував тло для блеючого голосу Гольдштейна .	формував	8	Masc
– Були такі зими , що моя баба намотувала на ногу цілу простинь – аж вище колін поверх штанів , майже до самих пахов .	намотувала	8	Fem
Другий як стій наложив ленту — і як затріскотить першому над головою !	наложив	3	Masc
Щоб це видалось дуже новим після доби Ґетевського « Східного дивану » та екзотики часу розквіту романтизму , ми цього б не сказали .	видалось	2	Neut
На останньому поверсі старезної камениці , тої , що прилягає до Успенської церкви , жила наша старенька тітка , вдова першого ректора українського таємного університету .	жила	14	Fem
А за вузькою Тайванською протокою лежав колосальний маоїстський Китай – багатолюдний , агресивний і невблаганний .	лежав	5	Masc
Так сприймала свій національний гімн ґенерація , яка й спромоглася відродити державу , це якраз із цього кола вийшло чимало провідних діячів Української Народної Республіки .	вийшло	18	Neut
Про себе написав тільки , що склав іспита , надіється на стипендію і живе тим часом у знайомих .	склав	6	Masc
Швидко він зживався з новим своїм місцем на старій землі — і підвертав її під себе : вона йому плодила , родила — ставало на пожиття його !	підвертав	12	Masc
Думав , думав чоловік , як зарадити біді , але ніяк не годен був щось надумати .	Думав	0	Masc
Мама працювала в обласній дитячій лікарні і знала , що діти із зони поступають з адреси Івано-Франківськ , 17 , вулиця Авіаційна .	працювала	1	Fem
— Нема , — одказував Левко , блукаючи очима поверх золотого Марфиного волосся , що вибилося з-під чорної хустки .	одказував	4	Masc
Воно й не дивно , що жінка - психолог від такої навали мегастресових подій зірвалася на істерику і навіть спробувала самовбитися .	зірвалася	14	Fem
Зустріч відбулась в рамках участі Концерну в спеціалізованій авіакосмічній виставці AeroIndia - 2017 .	відбулась	1	Fem
Жаль , це могла бути дуже гарна річ , але від перегляду виникає відчуття когнітивного дисонансу .	могла	3	Fem
Ми не в змозі встановити , в який саме точний момент часу накопичення змін спричинило якісний стрибок чи коли саме виник суб’єктивний первень , а отже й коли саме закінчився інкубаційний період і виформувалася самостійна українська мова .	спричинило	14	Neut
Оксана в « Боярині » на власному трагічному досвіді переконалася , що Росія та Україна – це антагоністичні світи , різні культурні традиції .	переконалася	9	Fem
Не минало і дня , щоб Поліція Думок не викривала шпигунства та саботажу здійснених під його орудою .	минало	1	Neut
Нове покоління людське розказувало казки про колишній голод , але ті казки почали забуватись .	розказувало	3	Neut
Рафаель брав у мене пару кубів спирту для промивання шифрувальної апаратури і вводив його собі внутрівенно .	брав	1	Masc
А щастя літало по світі зорею , блискавицею , вогником бродячим і ніде не спинялось надовго , і ніхто не мав його ціле в руках .	спинялось	14	Neut
І вони виходили з хати зі спеченими обличчями , які сонце довгі роки пражило ; воно й тепер зараз увіссалося в них , та й вони його несли до своїх домів .	пражило	13	Neut
Київська ОДА виявилася чи не першою , яка намагалася вплинути на перевізників .	виявилася	2	Fem
Артистка , яка читала тексти , теж не бачила , тому на цьому місці запнулась .	запнулась	14	Fem
У рамцях фонології це можна зробити , встановивши першу фонетичну зміну , що поширилася серед слов’янських мовців на пізнішій українській території , але оминула сусідні слов’янські племінні групи .	поширилася	13	Fem
І хоча це нібито суперечить зацитованій вище поставі Потебні ( 1876 р . ) , насправді він сам учинив точнісінько так само , і , здається , нічого іншого мовознавцеві , власне , й не зостається .	учинив	18	Masc
Згодом я довідався і прізвища , і домашні адреси Пуниних мучителів .	довідався	2	Masc
Дівчина мордувала кошеня ( дали 2 роки умовно ) - народ злиться бо мало ; Коломойський наєбав країну на 150 млрд - народ мовчить .	мордувала	1	Fem
Путя взагалі чималий страхополох , певне , через те , що виросла без товаришів та під крилом у гувернанток .	виросла	11	Fem
Армійський особіст багато разів викликав мене вночі на співбесіду , пропонуючи вступати у вище училище КҐБ на факультет урядового зв’язку .	викликав	4	Masc
Залишаючи Міністерство о цій порі дня він пожертвував своїм ланчем у буфеті та усвідомлював що на кухні з їжі є лише скибка чорного хліба яка не дотягне до завтрашнього сніданку .	усвідомлював	13	Masc
Серце почуло якесь лихо ; перед очима вже стояла біда ...	стояла	8	Fem
Він серед них виглядів дійсно , як людина з волі — засмалений сонцем , аж бронзовий , повнокровний , свіжий .	виглядів	3	Masc
Усе , що не відповідало радянським уявленням про корисність ( інші функції мистецтва майже не бралися до уваги , воно мало лише виховувати лояльних до влади громадян ) , цензурувалося , замовчувалося .	замовчувалося	31	Neut
Взимку в панцернику було так холодно , що на стінах зсередини наростав кількасантиметровий шар інею .	наростав	11	Masc
Далай - лама , що здійснював 10-денну поїздку в Австралію і Нову Зеландію , закликав пам'ятати про проблему глобальної зміни клімату .	здійснював	5	Masc
Одначе розгляд фрагментів цього посуду дозволяє думати , що тут маємо аналогічну техніку , бо не трапляється , щоб ніжка відбивалась від дна посудини в площі здогадного перетину , натомість посудина розбивається все спільно з ніжкою .	відбивалась	20	Fem
Баба закричала , а далі простерлася , як пес простирається на паздір’ї , раз - двічі тріпнулася й померла .	простерлася	5	Fem
До окремого комітету , створеного в цій справі , входив і японський представник .	входив	9	Masc
— Ти , Михайле , кажу , хоч би разочок на неї глянув .	глянув	12	Masc
Він занурив ручку з пером у чорнило та на декілька секунд завагався .	завагався	11	Masc
Напарник ледве встиг вискочити з машини і забігти в якісь кущі .	встиг	2	Masc
Цитую : « Я вже давно звик до вибриків різних телерадіочинуш , котрі , прогинаючись перед можновладцями , забороняли мені працювати в ефірі , бо я ж — « ображав критикою небожителів » .	звик	6	Masc
Оскільки жінка типу матері Ґракхів , або Жанни д'Арк робить , як казав Б . Шов — з овець мужчин , то тип Андромахи навпаки , робить з мужчин те , що робила з ними Цирцея ...	робила	32	Fem
Тепер ніхто й не згадав про неї .	згадав	4	Masc
І от я наткнувся на , власне , самі документи .	наткнувся	3	Masc
Швидко він зживався з новим своїм місцем на старій землі — і підвертав її під себе : вона йому плодила , родила — ставало на пожиття його !	ставало	23	Neut
Чумарка мала невеликий стоячий комір .	мала	1	Fem
Все ж таки саме в дослідженні техніки скрупулятна метода дослідника лишила триваліший слід , ніж у його підсумкових статтях .	лишила	10	Fem
Забрала вона ті харчі , заплакала та й пішла з батьком .	Забрала	0	Fem
Виявилося , що на кілька років .	Виявилося	0	Neut
Натомість арифметичні дії я виконував блискуче .	виконував	4	Masc
Доступність пляжів зробила їх модними для масового відпочинку .	зробила	2	Fem
Мусив багато працювати .	Мусив	0	Masc
Мр . Віллі Морріс добув з горішньої кишені камізельки зложений у восьмеро папір .	добув	4	Masc
Може вона і жалілась , скажімо , на чоловіка - мамі , священику , подругам , - і почула " що поробиш , терпи , то треба терпіти " .	жалілась	3	Fem
Наступної миті огидна , потворна , скрегочуча промова , яка була схожа на гомін велетенської механічної машини що працювала без належної змазки , вибухнула з великого телезахисту у кінці кімнати .	працювала	18	Fem
Каракєджбі і цього було замало , він визнав мене після спеціальної перевірки — за п’ятнадцять секунд треба було знайти острів Робінзона Крузо .	визнав	7	Masc
Але , очевидно , таки не зміг , не знайшов у собі тієї страшно важливої сили — стриматися .	знайшов	9	Masc
Він пам’ятав сотні марок вина .	пам’ятав	1	Masc
Я - бо ніколи й разу не назвав її матір'ю , якось язик не повертається .	назвав	7	Masc
Іноді їм ставало зле , і ми відтягували їх у підсобку .	ставало	2	Neut
Решту дурман - зілля після того він поклав до гаманця й забув .	поклав	7	Masc
Салтиков посилав його у недоступні місця і дивився , чим займаються різні звірі .	дивився	7	Masc
І не розходилась та пісня по світу , не окликалася луною в лузі , як соловейкова , а , як важкий камінь , налягала на душу , морочила голову цілим роєм темних гадок , пекла серце нерозважною тугою ...	розходилась	2	Fem
