Powybijają ci zęby .	Powybijają	0	Fut
Skrzykują te , które wzbiły się za wysoko na wschodzący księżyc .	Skrzykują	0	Pres
Zawrzały dusze , serca i umysły .	Zawrzały	0	Past
Podstawowym problemem jest to , że na tym terenie mieszkają 2 rodziny .	mieszkają	9	Pres
Nie wyśpi się .	wyśpi	1	Fut
Zgodnie z oczekiwaniami po złoto sięgnęły ekipy gospodarzy .	sięgnęły	5	Past
Mnie nie przekona , nie dotknę kolczyków .	przekona	2	Fut
- Skończy Pan niebawem 25 lat .	Skończy	1	Fut
Zastawił się przed cięciem w prawy bok .	Zastawił	0	Past
Słabszym doradza się wczołgiwanie .	doradza	1	Pres
Wiadomo , że ostatecznie zawiedzie się na tej idei Stagiryta .	zawiedzie	4	Pres
Na morskiej jednostce mogą być zatrudnione tylko te osoby , które posiadają aktualne świadectwo zdrowia .	posiadają	11	Pres
Chodź , wyskoczymy na chwilę .	wyskoczymy	2	Fut
Zadzwonimy do Patrycji . . .	Zadzwonimy	0	Fut
Postaramy się spełnić jej życzenie .	Postaramy	0	Fut
- Przymierzymy jeszcze !	Przymierzymy	1	Fut
Biedny Wojtek wysługuje się .	wysługuje	2	Pres
Ostre cięcia grożą też prezesom państwowych spółek .	grożą	2	Pres
Na jego opinię powołuje się amerykański dziennik .	powołuje	3	Pres
Z głośników popłyną rytmy soul i disco .	popłyną	2	Fut
Dzięki nim zmniejsza się u chorego zaleganie afektu , rozładowują się utrwalone stereotypy uczuciowe , obiektywniej widzi swoją sytuację .	zmniejsza	2	Pres
Rzadko je to uszczęśliwia , często się buntują i wtedy cała rodzina ma problemy .	uszczęśliwia	3	Pres
Będą tak krążyć , dopóki się nie poprzewracają .	poprzewracają	7	Fut
Nie zgadzam się z opinią , że wszystko załatwi podwórko .	załatwi	8	Fut
W odpowiednim sklepie za 350 zł sprzedadzą każdemu .	sprzedadzą	6	Fut
Rodziny , które zdecydują się kupić na kredyt własne M , mogą liczyć na pomoc finansową .	zdecydują	3	Pres
Blady strach na wieś padał , kiedy Hanke pojawiał się z tym aparatem .	pojawiał	8	Past
Chmury rozsunęły się na moment , odsłaniając wytarty miedziak słońca .	rozsunęły	1	Past
U mnie miała by ś więcej .	miała	2	Past
A ja oddaję za sześćdziesiąt pięć .	oddaję	2	Pres
Zwycięski zespół uzyska awans .	uzyska	2	Fut
- Rozprawa odbyła się w piątek .	odbyła	2	Past
Nicholas zrobił to wszystko , bez efektu .	zrobił	1	Past
Okrzyczą go zdrajcą .	Okrzyczą	0	Fut
Zgłosili się panie i panowie posłowie do zadania pytań .	Zgłosili	0	Past
Zatrzymały się w odległości kilkudziesięciu metrów od miejsca narodzin Chrystusa .	Zatrzymały	0	Past
O wywiad z prezydentem zabiegam od 3 miesięcy .	zabiegam	4	Pres
Czasami przypali zupę , czasami stłucze talerz z pomidorówką .	stłucze	5	Fut
Strajk zawieszono .	zawieszono	1	Past
Zaraz pójdę sprawdzić .	pójdę	1	Fut
Tego nie zastąpi żaden artykuł w gazecie czy debata w telewizji .	zastąpi	2	Fut
W Boskiej Rzeczywistości problemy nie istnieją .	istnieją	5	Pres
Nikt już po nim nie popełni takiego błędu .	popełni	5	Fut
Czy ja powiedziała m , że nie ufam Jezusowi ?	ufam	7	Pres
Zaproponowali , że przeproszą , i obiecali poprawę .	przeproszą	3	Fut
Zjawi się , jeżeli będzie potrzebna .	Zjawi	0	Fut
Sporządzono także portrety pamięciowe napastników .	Sporządzono	0	Past
Prowadzi teraz inną , w Wesołej , i jest w jej zarządzie .	Prowadzi	0	Pres
Owoc dojrzały nie wyda nasion , kiść uschnie .	uschnie	7	Fut
Trwała dalej w bezruchu .	Trwała	0	Past
Możecie iść do domu .	Możecie	0	Pres
- Posiada osobowość prawną .	Posiada	1	Pres
Nie odpowiem pani raczej na to pytanie .	odpowiem	1	Fut
Tak wielka ilość pokryje z nadwyżką chłonność rynku .	pokryje	3	Fut
Za to , że wrócił bez pieniędzy , gość zapłaci życiem .	zapłaci	9	Fut
Kolejny pijany policjant straci pracę .	straci	3	Pres
Opiszę ci wszystko !	Opiszę	0	Fut
- Ale w tej chwili karmi miesięczne dziecko .	karmi	5	Pres
– Policzysz , jak zechcesz .	Policzysz	1	Fut
- Zaśniesz sam .	Zaśniesz	1	Fut
Piszę o tym za zgodą kapitana Domejki .	Piszę	0	Pres
Głosowało 397 posłów .	Głosowało	0	Past
Zdaje się , że wpatrywała się we mnie od dłuższego czasu .	Zdaje	0	Pres
Uśmiechnęła się do Hehego .	Uśmiechnęła	0	Past
Jeszcze taz polecam .	polecam	2	Pres
Bandyci pobili Rosjanina i wyrzucili z samochodu na Pradze .	wyrzucili	4	Past
A w wakacje niech pojedzie na kolonie lub się szkoli , żeby awansować .	pojedzie	4	Fut
Poszła m zdawać na filozofię .	Poszła	0	Past
Wtedy Bóg złapie to całe towarzystwo łącznie ze mną i wrzuci w ogień piekielny , a będzie tam płacz i zgrzytanie zębów .	wrzuci	10	Pres
- Dali śmy Kwaśniewskiemu szansę , bo mówił dużo o prostych ludziach .	Dali	1	Past
Powrót odbywa się w tempie przyspieszonym .	odbywa	1	Pres
Oni będą zarabiać więcej , a prąd podrożeje .	podrożeje	7	Fut
Wszystkie grupy otrzymały radiomagnetofon i toster .	otrzymały	2	Past
Wsparł go Wierchowicz .	Wsparł	0	Past
Może się pomylił eś ? ? ?	pomylił	2	Past
Mijała minuta za minutą , czas wlókł się w nieskończoność , a nie pojawiał się nikt .	pojawiał	13	Past
Nim Marcin odejdzie , dzieje się coś dziwnego .	odejdzie	2	Pres
Zabieram ze skarbca tylko wczorajszy obrót .	Zabieram	0	Pres
– podasz mi ogień ?	podasz	1	Fut
Omawiana książka jeszcze raz to potwierdza .	potwierdza	5	Pres
Może Ci się przyda .	przyda	3	Fut
Na torze pod Kielcami odbyty się pierwsze wyścigi samochodowe .	odbyty	4	Past
W USA rozpyla się na przykład streptomycynę i tetracyklinę na drzewa owocowe i pola ziemniaków .	rozpyla	2	Pres
Odjadę wkrótce .	Odjadę	0	Fut
Witały ich entuzjastyczne oklaski .	Witały	0	Past
Dziękujemy panu , panie komisarzu .	Dziękujemy	0	Pres
Gdyby wybory ukraińskie odbywały się w Polsce , zdecydowanie wygrałby Juszczenko .	odbywały	3	Past
Niespodziewanie triumfowali Niemcy , którzy mieli doskonale przygotowany sprzęt .	triumfowali	1	Past
Bo same warunki nie wystarczą .	wystarczą	4	Fut
Nad bezpieczeństwem w Zachodniopomorskiem czuwało 2500 policjantów , w tym 500 z drogówki .	czuwało	4	Past
Dotknął wilgotnego ręcznika w łazience , pogładził mięsistą połę szlafroka , powąchał mydło w cedrowej kasetce .	powąchał	11	Past
Ukonstytuowały się już wszystkie komisje działające przy Radzie Gminy i od razu zabrały się do roboty nad sporządzeniem planu działania na rok 1999 .	Ukonstytuowały	0	Past
Jadzia wolała by , żeby za bardzo nie oddalały się od siebie i żeby Dominika tak nie latała .	latała	17	Past
Milion konsumentów nieprzestrzegających zasad koszerności dokonało przełomu na rynku spożywczym .	dokonało	5	Past
Staję koło stołu i czekam .	Staję	0	Pres
- Ale jak rozwijać produkcję , skoro nie warto brać kredytów , bo się ich nie spłaci ?	spłaci	16	Fut
Zapewne już nie wrócę do Ameryki , już nie wrócę do amerykańskich tematów .	wrócę	3	Fut
Odbył jedynie krótką telefoniczną pogawędkę z prezydentem ZSRR Gromowem .	Odbył	0	Past
Na tej robocie się znają .	znają	4	Pres
Faktem jest , że nawet Hitler nie oczekiwał aż takiej reakcji Stalina .	oczekiwał	7	Past
Narzucają na mnie jeszcze jeden pled .	Narzucają	0	Pres
Może nad ranem wróci do hali i spróbuje wydostać się przez okno .	spróbuje	7	Fut
Uwolniono też polskiego ambasadora w Jemenie .	Uwolniono	0	Past
Wychowali ją .	Wychowali	0	Past
Bywa , że w ciągu godziny kawałek drewna zamienia się w rzeźbę , a innym razem potrzebuje kilku dni , by coś stworzyć .	potrzebuje	16	Pres
Tańczą na środku pokoju .	Tańczą	0	Pres
– tamta babcia niech jej kupi . .	kupi	5	Fut
Tworzymy silny zespół i to jest nasz największy atut .	Tworzymy	0	Pres
W piątek od rana w naszym mieście spotka się na plenarnym posiedzeniu Episkopat Polski .	spotka	7	Fut
Podobały jej się ogrody otaczające stare wille .	Podobały	0	Past
Taka ustawa obowiązuje już od ubiegłego roku , ale dopiero wczoraj szef MSW podpisał odpowiednie rozporządzenie .	obowiązuje	2	Pres
Całej imprezie groziła katastrofa , mimo że istniała możliwość otrzymania odszkodowania z towarzystwa ubezpieczeniowego .	groziła	2	Past
Po letniej przerwie w najbliższą niedzielę wznowią rozgrywki pięściarze pierwszej i drugiej ligi bokserskiej .	wznowią	6	Fut
Oznacza ona , że ten Sejm nie zdąży przyjąć ustawy budżetowej .	zdąży	7	Fut
Dlatego umówił em się z nim w restauracji i zawiadomił em policję .	umówił	1	Past
Oczywiście do tych protokołów komisja sięgnie .	sięgnie	5	Fut
Nakazuje je Konstytucja RP oraz przewidywany harmonogram reform ustrojowych .	Nakazuje	0	Pres
Po obu stronach muszą kisnąć jakieś mokradła , co oddychają mgłami .	oddychają	9	Pres
Za chwilę w ciemnościach rozlega się łoskot zasuwającego się opornie betonu .	rozlega	4	Pres
Dzieci wiedzą , że te samoloty niosą wolność , ale dzieci nie mogą spać na nagich , gołych pryczach .	wiedzą	1	Pres
Jestem posłuszny i staram się nie sprzeciwiać .	staram	3	Pres
- Przyrzeknę . . . ?	Przyrzeknę	1	Fut
Wchodzimy w wiraż , coraz bardziej zbliżając się do sklepienia kanału , które naraz przybiera jaskrawoniebieski kolor z domieszką fosforyzującego fioletu .	zbliżając	6	Pres
Twoje słowa trafiły na podatny grunt .	trafiły	2	Past
W Ciechanowie bywam regularnie od 26 lat .	bywam	2	Pres
Czerń , ulubiona barwa , ostro podkreślała niezwykłą , niemal ascetyczną bladość oblicza emira .	podkreślała	6	Past
Czy dożyje podobnej chwili ?	dożyje	1	Fut
Czy Milon zdecyduje się na powrót ?	zdecyduje	2	Fut
Wiem tylko , że jego żona jeszcze w Nowym Jorku zdecydowała się wrócić z synem do kraju .	zdecydowała	10	Past
Bawi mnie to w jakiś ponury sposób .	Bawi	0	Pres
Kup ją , a przekonasz się , że odmieni także twoje .	przekonasz	4	Fut
Zawiesił słuchawkę .	Zawiesił	0	Past
- Chyba nie sięgną .	sięgną	3	Fut
Głosowało 419 posłów .	Głosowało	0	Past
Następnym razem przyprowadzą kolegów i pomalutku piękny sport narciarski zainteresuje bardziej młodzież naszego miasta .	zainteresuje	9	Fut
Niech pan zostawi nas jeszcze przez chwilę , dobrze ?	zostawi	2	Fut
Wessie je mózg , wątroba , rurką pępowiny popłyną do Poli .	popłyną	8	Fut
Mógł by zmienić zdanie , gdyby AWS i UW razem zaproponowały mu , by reprezentował je w wyborach .	zaproponowały	10	Past
Bezmyślnie zdeptał eś po drodze wszystko i wszystkich .	zdeptał	1	Past
Kiedy RS AWS się wzmocni , ja też zrezygnuję z pewnych funkcji .	zrezygnuję	8	Fut
Sam się pan przekona .	przekona	3	Fut
Le Pen straszy zjednoczoną Europą .	straszy	2	Pres
Postanowił , że jej nie odpuści .	odpuści	5	Fut
- Nie zorganizowano zawodów na odpowiednim poziomie , na przykład w skokach do wody czy siatkówce , bo Zimbabwe nie spodziewa się w tych dyscyplinach osiągnięć .	zorganizowano	2	Past
Pociski te przebijają najgrubsze pancerze .	przebijają	2	Pres
Weszli śmy do środka .	Weszli	0	Past
Nie wiadomo też , kto nam odda pieniądze , jeśli obiecanej nagrody nigdy nie zobaczymy .	odda	6	Fut
Przyniosła m mu dodatkowy klucz .	Przyniosła	0	Past
Ale w Niemczech wrze .	wrze	3	Pres
Dopiero za trzy tygodnie ludowcy zdecydują , kogo wystawią do prezydenckiego wyścigu .	wystawią	8	Fut
Klienci bardzo chętnie gwałcą i matkę , i syna .	gwałcą	3	Pres
Po trzech latach wyrośnie górka i dzieci będą miały skąd zbiegać .	wyrośnie	3	Fut
– Pani nadal go kocha ?	kocha	4	Pres
Czterech ludzi nie żyło prawie na pewno .	żyło	3	Past
Potem szli na romantyczny spacer , przytulali się i całowali .	przytulali	6	Past
Szanuję to .	Szanuję	0	Pres
Po decyzji parlamentu zawiesiły działalność polityczną Batasuny .	zawiesiły	3	Past
Cały Boguszów trzęsie się z oburzenia .	trzęsie	2	Pres
Prawdopodobnie wkrótce straci immunitet .	straci	2	Fut
Zaproponowano więc Krystynie , która skwapliwie skorzystała .	skorzystała	6	Past
Poślij po niego , niech przyjdzie i zaświadczy .	zaświadczy	7	Fut
Ale możemy przecież za nią podziękować .	możemy	1	Pres
- Może zresztą sam zostaniesz ambasadorem ?	zostaniesz	4	Fut
Dramatyczny przebieg mistrzostw zakończył się dla Szymona XIV miejscem w światowej klasyfikacji .	zakończył	3	Past
Należało spróbować nawiązać łączność .	Należało	0	Past
Patrzał na nią z uznaniem .	Patrzał	0	Past
- Zobaczymy , czy RS AWS będzie już mógł samodzielnie działać .	Zobaczymy	1	Fut
I nagle zrozumiała m !	zrozumiała	2	Past
Padają pierwsi zabici .	Padają	0	Pres
Ale zdecydowanie nie pozwalam , abyś nazywał mnie głupią albo pozbawioną rozumu .	nazywał	6	Past
I niech mnie ekskomunikują .	ekskomunikują	3	Fut
Zaczyna się zjadanie domu , niszczenie domu , nim się dom rozpadnie .	rozpadnie	11	Pres
Weźmiemy się za to , ale trzeba zacząć od niego . . .	Weźmiemy	0	Fut
Pod pachą trzymała jakąś paczkę zawiniętą w gazetę .	trzymała	2	Past
W najbliższym czasie rynek prawdopodobnie ochłonie i dojdzie do korekty .	dojdzie	7	Fut
– ja sobie to wyobraziła m inaczej .	wyobraziła	4	Past
Najlepiej będzie , jeśli zajmę się tym zaraz .	zajmę	4	Fut
- Spodziewał em się , że tak odpowiesz , Sarai !	Spodziewał	1	Past
I na moment zatkało mnie .	zatkało	3	Past
Zerknęła w lustro , obciągnęła na sobie sweter w czerwone skrzydła . . .	obciągnęła	4	Past
W Burkina Faso dominują muzułmanie .	dominują	3	Pres
Mało nie sfiksuję .	sfiksuję	2	Fut
Była typową polską postępową inteligentką czyli agnostyczką , i wzmianek o chodzeniu do kościoła u niej nie upatrzysz .	upatrzysz	17	Fut
Nawet go to nie poruszyło .	poruszyło	4	Past
Wystarczy , że celnik na niego spojrzy .	spojrzy	6	Fut
Potajemnie przygotowują prezenty .	przygotowują	1	Pres
Mocne łuki brwi jakby nastroszyły się .	nastroszyły	4	Past
I o to się rozchodzi !	rozchodzi	4	Pres
Przekupnie w bazarowych zaułkach opowiadali , że upadek rządu jest bliski i nieuchronny , a ministrowie i generałowie knują spiski albo pakują walizy i szykują się do ucieczki za granicę .	pakują	21	Pres
Dzięki afirmowaniu niewinności pozostajesz w niewinności .	pozostajesz	3	Pres
- A ja myślał em , że niosę jej pocieszenie . . .	niosę	7	Pres
Jeśli pogoda dopisze , będziemy wykonywać te prace bez przerwy .	dopisze	2	Fut
zobaczy pani .	zobaczy	0	Fut
– weźmiesz wódkę i przyjdziesz ?	weźmiesz	1	Fut
Lecz co się stało , nie odstanie !	odstanie	6	Fut
A gdzież to panowie tak podróżują ?	podróżują	5	Pres
- Już dawno umarł .	umarł	3	Past
sprawdzę pana .	sprawdzę	0	Fut
Gotujemy na małym ogniu 15 minut .	Gotujemy	0	Pres
– tak to się układa .	układa	4	Pres
Prezes SSN deklaruje , że w kolejnych etapach zatrudni niemal wszystkich pracowników produkcyjnych .	zatrudni	8	Fut
Nic nie zmieniamy .	zmieniamy	2	Pres
Zacznę od dziś nazywać Lewickiego Anakondą .	Zacznę	0	Fut
Polski lud w nic nie wierzy .	wierzy	5	Pres
Ustrzegła się tego .	Ustrzegła	0	Past
W Zborowie powstał obiekt o powierzchni użytkowej 3364 metrów kwadratowych , w którym zamieszka 50 osób .	powstał	2	Past
Odpalił to makro , nawet nie wychodząc z trybu edycji .	wychodząc	6	Pres
Ale na pewno powiększy się opóźnienie w jego urzeczywistnianiu .	powiększy	3	Fut
- Słyszę silny szum i tętnienie .	Słyszę	1	Pres
Patrol saperski całą dobę dyżuruje w Kazuniu .	dyżuruje	4	Pres
Powiedziała , że komórki zamówił u niej Bogusław Linda .	Powiedziała	0	Past
Czy sądzisz , że teraz , po tych wszystkich latach , rzucę dom , dzieci i pójdę za tobą ?	rzucę	11	Fut
Godzinami , chmurni , łazili po mieście , ciągała go po galeriach , muzeach , teatrach .	ciągała	8	Past
Tylko woda bluznęła .	bluznęła	2	Past
Przystupa odstawiła szklankę po whisky i skuliła się w fotelu , pan Cox wyglądał , jakby się właśnie obudził .	odstawiła	1	Past
Sprawdzę na naszej taśmie .	Sprawdzę	0	Fut
- Nie idę dalej .	idę	2	Pres
Poniedziałkowa prasa londyńska pisze o odsłonięciu pomnika oświęcimskiego .	pisze	3	Pres
Nie wiedzą , że brak jednej maszyny ?	wiedzą	1	Pres
Potem zapomniała o kawie .	zapomniała	1	Past
Poprawimy się !	Poprawimy	0	Fut
Przyjadą goście z miasta .	Przyjadą	0	Fut
Zdziwisz się , ale wielu głosowało za Bośnią .	Zdziwisz	0	Fut
Musi dbać o swoją kobietę .	Musi	0	Pres
Ale trzej bracia nie zważali na przeszkody .	zważali	4	Past
Na trotyl natrafiono w miejscu , które wskazał radiesteta , zatrudniony przez rodzinę zaginionego .	wskazał	7	Past
- Nikt się nie rozłazi , panie kapralu !	rozłazi	4	Pres
Róża pamiętała dobrze ten dzień .	pamiętała	1	Past
Urzędniczka przysunęła mi telefon mimo tych niedołężnych wyjaśnień .	przysunęła	1	Past
Uczyniło się raptem cicho .	Uczyniło	0	Past
Skontaktuję się z mamą trojaczków w najbliższych dniach .	Skontaktuję	0	Fut
Chart nie raczył nawet mnie obwąchać .	raczył	2	Past
Odrzutowiec z hukiem przekraczał barierę dźwięku , patrzyłem , jak rozpruwa niebo .	rozpruwa	10	Pres
Przy bardzo silnych wiatrach zawodnicy zakładają na płozy specjalne obciążenia .	zakładają	5	Pres
Co zrobili śmy ?	zrobili	1	Past
Punkom skóra się spodobała , bo jest praktyczna .	spodobała	3	Past
Obecnie we Francji wykłada na uniwersytecie w Awinionie .	wykłada	3	Pres
- Sojusz zapowiadał , że poprze reformę samorządową .	poprze	5	Fut
Partyjni stratedzy planują więc przedsięwzięcia z myślą o wyborach dalszych , tych pojutrze .	planują	2	Pres
- Co zechcesz .	zechcesz	2	Fut
Płacą pani nie zachęci .	zachęci	3	Fut
Należało spróbować nawiązać łączność .	Należało	0	Past
Po jednemu wsiąkały w próżnię . . .	wsiąkały	2	Past
I dotrzymam .	dotrzymam	1	Fut
Przecież nie umarła , kiedy my żyjemy .	umarła	2	Past
Zmarł w klinice onkologicznej w Warszawie .	Zmarł	0	Past
IZABELLE ADJANl , gwiazda filmu francuskiego , wygrała precedensowy proces .	wygrała	7	Past
Nie dostawał przepustek .	dostawał	1	Past
– Sąsiedzi opowiedzieli coś ciekawego ?	opowiedzieli	2	Past
( dzia ? ! ? )	dzia	1	Pres
Do sali zjechali śmy godnie , windę znarowioną już naprawili .	naprawili	9	Past
Wjeżdżamy między niechlujne zabudowania Płaszowa .	Wjeżdżamy	0	Pres
Naprawdę rzadko się zdarza w województwie , że w jakiejś dziedzinie sięgamy po pierwsze miejsca .	sięgamy	11	Pres
- A ja wam mówię , że jesteście na bańce .	jesteście	7	Pres
Jak się wywiążą ?	wywiążą	2	Fut
Ben Menasse porwał straszydło za ramię , ale przybysz nie zdawał się zważać na ponaglanie .	zdawał	10	Past
Wielu radnych pobiera wysokie diety .	pobiera	2	Pres
Odbywają się one w 100 fabrykach i PGR-ach .	Odbywają	0	Pres
Taka sytuacja łatwo popycha do kroków desperackich .	popycha	3	Pres
Widać , że prawda w oczy kole .	kole	6	Pres
Dawaj , bo zarzygasz .	zarzygasz	3	Fut
Teraz odejdę .	odejdę	1	Fut
Niech śnią spokojnie .	śnią	1	Pres
Zwykle w zimę odżywiamy się nieźle .	odżywiamy	3	Pres
Odrobina zazdrości utrzyma miłość w dobrej formie .	utrzyma	2	Fut
Stojąc , mógł się od biedy bronić .	Stojąc	0	Pres
Kelner ucieszył się .	ucieszył	1	Past
Malował wówczas synagogę w Opatowie .	Malował	0	Past
Pogładził łaskawą pieszczotą wyślizgane drewienka .	Pogładził	0	Past
Wolała puszczać w kinach filmy kung-fu licząc , że dzięki temu ludzie przestaną myśleć o polityce .	licząc	6	Pres
Sprawca ten okazał się nie tylko złodziejem , ale i sadystą .	okazał	2	Past
- Uśmiechnął się .	Uśmiechnął	1	Past
- A jak głosowali inni sarajewscy Serbowie ?	głosowali	3	Past
Na pewno pan nie wróci do Zakopanego ?	wróci	4	Fut
Czy jeszcze kiedyś spotkam Anię ?	spotkam	3	Fut
Cieszy fakt , że Royal Canin tak bardzo dba o koty i chce dzielić się swą wiedzą i doświadczeniem z ich miłośnikami .	dba	8	Pres
W świetlicy Sobczuk wycinał litery .	wycinał	3	Past
Oparł się o ścianę i stał , dysząc ciężko .	dysząc	7	Pres
Czy to znaczy , że Odessa podda się zukrainizowaniu ?	podda	6	Fut
Trudniej było się zdecydować , na co pójdę .	pójdę	7	Fut
Polacy zdobywali to wzgórze .	zdobywali	1	Past
Grób Pikusia i Miśka rozświetlają znicze .	rozświetlają	4	Pres
Jewhen drzemał na krześle przy drzwiach .	drzemał	1	Past
W jego armii służyli teraz synowie śmiałków , którymi dowodził przed laty .	służyli	3	Past
- Jeszcze będziecie mieli rozrywkę , zobaczycie .	zobaczycie	6	Fut
Zaraz skonam z głodu .	skonam	1	Fut
Może zostaniesz kiedyś kierowcą rajdowym .	zostaniesz	1	Fut
Pocałuj ją , a zobaczysz , że tylko krok dzieli cię od najważniejszego .	zobaczysz	4	Fut
Wraz z kadrą wyjadą Daria Kasperska , Paulina Rytwińska i Agnieszka Karcz .	wyjadą	3	Fut
Znalazła m z trudem jakieś zdjęcia .	Znalazła	0	Past
Ja wszystko zanotuję , a żona podpisze .	podpisze	6	Fut
Wilk odprowadzał go wzrokiem , aż ciemna sylwetka rozpłynęła się w mroku korytarza .	rozpłynęła	8	Past
Wykąpiemy się na golasa .	Wykąpiemy	0	Fut
- Wyzyskiwała m .	Wyzyskiwała	1	Past
Znam go .	Znam	0	Pres
Dopiero go zbadają .	zbadają	2	Fut
Zasypiam , ssąc chrupką skórkę przy migoczącym w telewizji Człowieku z żelaza .	ssąc	2	Pres
Chcemy odwiedzić kolegów .	Chcemy	0	Pres
Lubi Polaków .	Lubi	0	Pres
W ciemnym miejscu chodnika do samotnie idącej dziewczyny podbiegł mężczyzna i zgwałcił ją .	zgwałcił	11	Past
Przymknął oczy i trwał w zadumie nie słysząc nawet roztrzepanej gadaniny niezliczonych wróbli .	słysząc	7	Pres
Ponadto prezes powiadomił o przestępstwie tutejszą prokuraturę .	powiadomił	2	Past
Ćwiczyli wojacy z 25 krajów .	Ćwiczyli	0	Past
– Może coś rozpozna .	rozpozna	3	Fut
Wstaję , wyglądam przez okno .	wyglądam	2	Pres
- Jeżeli ćwiczący źle dobiorą rakiety , piloci nie zniszczą przeciwnika .	zniszczą	9	Fut
Na pewno marzł w zimie .	marzł	2	Past
Uśmiechnęła się tylko do siebie .	Uśmiechnęła	0	Past
- Jak pan sądzi , zobaczycie się z Bagsikiem w tym tysiącleciu ?	zobaczycie	5	Fut
Padają Zakłady Cegielskiego w Poznaniu , a dialog przenosi się na ulice .	przenosi	8	Pres
Nigdy nie budował fantastycznych hipotez .	budował	2	Past
Nigdy by m nie pomyślał , że spotkam tu kiedyś pana .	spotkam	7	Fut
Burmistrz Tadeusz Kowalski dogląda realizacji zadania .	dogląda	3	Pres
Wszedł do wagonu , w przejściu natknął się na konduktora - służbistę , który zrobił mu wykład o niebezpieczeństwie związanym ze wskakiwaniem do pociągu w biegu .	natknął	6	Past
Miał napady agresji , wpadał w histerię .	wpadał	4	Past
Decyzja zapadnie dzisiaj rano .	zapadnie	1	Fut
Proboszcz parafii wyjaśniał podczas świątecznych kazań , że w tym roku parafię czekają dwie duże uroczystości .	czekają	12	Pres
- Po ostatnich ulewach owoce gniją błyskawicznie .	gniją	5	Pres
Dwa tygodnie temu prezydent podpisał znowelizowaną ustawę .	podpisał	4	Past
Stanęły wreszcie przed jakimiś drzwiami .	Stanęły	0	Past
Powołujesz się na intelektualnego i emocjonalneog kastrata , ale czego innego mogł em się po Tobie spodziewać ?	Powołujesz	0	Pres
- Polecisz .	Polecisz	1	Fut
- Obiecał em mojemu młodszemu , że przyniosę mu dzisiaj dwie kulki . . .	przyniosę	7	Fut
– Policzysz , jak zechcesz .	zechcesz	4	Fut
Bywa też tak , że dzieci nie wiedzą , czego chcą , i to też nas rozczarowuje .	wiedzą	7	Pres
„ Sztafeta cztery razy po sto ostro ruszyła z miejsca ” .	ruszyła	7	Past
Zaczną czerpać wodę .	Zaczną	0	Fut
- Przeprosiny nie wystarczą .	wystarczą	3	Fut
Rada Nadzorcza PZU zebrała się wczoraj rano .	zebrała	3	Past
Z pomocy skorzysta ok. 300 rodzin .	skorzysta	2	Fut
Uświadamiają sobie , że aborcja to zabijanie .	Uświadamiają	0	Pres
Jestem za ujawnieniem dokumentów IPN-u , niech każdy je oceni .	oceni	9	Fut
Przyjęcie odbywało się w starym pałacu cesarza .	odbywało	1	Past
Nie wiadomo nawet , kiedy do niego w Sejmie dojdzie .	dojdzie	9	Pres
Dwoisz się i troisz , aby rozwiązać kilkadziesiąt praktycznych problemów równocześnie .	Dwoisz	0	Pres
– Uderzyli cię w głowę ?	Uderzyli	1	Past
Nie zajedziesz nigdy , nie odwiedzisz .	zajedziesz	1	Fut
Choinka mieni się różnobarwnie , z bożonarodzeniowego bierwiona w kominku bije przytulne ciepło .	mieni	1	Pres
Agent Pawłow nieustannie wodził wzrokiem za kapitanem , pilnie nadstawiał ucha .	wodził	3	Past
- Spróbuję .	Spróbuję	1	Fut
Jeżeli się uprę , będzie płakać .	uprę	2	Fut
Niezależnie od przedstawionych wyników , kontrolę przeprowadzą jeszcze policjanci z Komendy Wojewódzkiej Policji w Katowicach .	przeprowadzą	6	Fut
Wiedźmin biegł za nim , licząc , że potwory rozciągną się w pościgu .	licząc	5	Pres
We wrocławskim zoo trzymamy je w kilku grupach .	trzymamy	3	Pres
Papiery , odznaczenia podarł em tam , w knajpie , wszyscy widzieli .	widzieli	11	Past
Przygryzając wargi z bezsilnej złości , Chmura wołał Adasia .	Przygryzając	0	Pres
– Ten komplet narzędzi służył do ćwiartowania korpusów .	służył	4	Past
- Teraz pojedziemy na szóste .	pojedziemy	2	Fut
Szczep nie zazieleni się więcej .	zazieleni	2	Fut
Ja widział em ich niewiele , ale wciąż i wciąż mnie przed nimi ostrzegano .	ostrzegano	13	Past
Właściwie tylko Białostockie Przedsiębiorstwo Budownictwa Przemysłowego posiada laboratorium z prawdziwego zdarzenia .	posiada	6	Pres
Po decyzji parlamentu zawiesiły działalność polityczną Batasuny .	zawiesiły	3	Past
Jędrusia przysiadła na brzegu .	przysiadła	1	Past
Dzięki poradnikowi dowiadujemy się , że roczną deklarację oznaczają cyfry 01 .	dowiadujemy	2	Pres
Sprawdzamy wyrostki kolczyste i łuki kręgów .	Sprawdzamy	0	Pres
Dewotka nawet sznurowadło oskarży o rozwiązłość .	oskarży	3	Fut
Cztery kowane wozy pojechały za siostrami .	pojechały	3	Past
Zaznaczam , że pytanie nie jest wyłącznie retoryczne .	Zaznaczam	0	Pres
Bartoch zapalał się coraz bardziej i zdawało się , że o Franoszkach zapomniał .	zdawało	6	Past
Strażacy brnąc niemal po kolanach w wodzie wynoszą w drewnianych klatkach świnie .	brnąc	1	Pres
Kocham was wszystkich .	Kocham	0	Pres
Niedawno zapytał darłowskie dzieci , kim był król Eryk .	zapytał	1	Past
Przypomina tego twojego pedała ze Służewa .	Przypomina	0	Pres
Pili śmy koniak , on wyczuje !	wyczuje	5	Fut
Policja z uwagi na prowadzone wciąż czynności operacyjne nie ujawnia szczegółów dotyczących tej sprawy .	ujawnia	9	Pres
Musiały jej powiedzieć , teraz .	Musiały	0	Past
Niepostrzeżenie wracamy do domu i nad ranem obwieszczamy światu odkrycie niecodziennego zjawiska .	wracamy	1	Pres
Zatrzymali śmy się także na jeden dzień w Bourges , a stamtąd pojechali śmy już do Niemiec .	Zatrzymali	0	Past
Po śląskich miastach grasuje zboczeniec , który atakuje młode dziewczyny !	grasuje	3	Pres
Podporządkowywał em się tu .	Podporządkowywał	0	Past
Nie zajedziesz nigdy , nie odwiedzisz .	odwiedzisz	5	Fut
- Wstyd , wstyd !	Wstyd	1	Pres
Nie narażę cię na niebezpieczeństwo .	narażę	1	Fut
Rozumisz , Dziunia ?	Rozumisz	0	Pres
Nie wolno naruszać czyichś praw autorskich .	wolno	1	Pres
Jak Pan to zrobi ?	zrobi	3	Fut
Klasztor na Jasnej Górze przeżywa prawdziwe oblężenie .	przeżywa	4	Pres
Dotarli śmy wreszcie pod szczyt Mnicha .	Dotarli	0	Past
Najciekawsze opinie wydrukujemy .	wydrukujemy	2	Fut
- Izrael zginie !	zginie	2	Fut
Jeszcze inni bezradnie rozkładają ręce oznajmiając , że nie są w stanie czegokolwiek zapłacić .	oznajmiając	5	Pres
Kontraścikiem buchnie !	buchnie	1	Fut
Ktoś położył mu na ramiona prześcieradło .	położył	1	Past
Wiatr zmęczył się także .	zmęczył	1	Past
Saudyjski ambasador w Londynie już zapowiedział , że jego rząd nie ugnie się pod presją i nie złagodzi kar .	złagodzi	17	Fut
- Wstało by twoje matczysko .	Wstało	1	Past
- Pomodlimy się . . .	Pomodlimy	1	Fut
Zresztą zaraz przyjdzie tu po mnie .	przyjdzie	2	Fut
Co dzień , wychodząc ze szkoły , oglądał się jeszcze , jakby już jutro nie miał jej zobaczyć .	wychodząc	3	Pres
Teraz wybiorą go spośród swego grona członkowie Rady .	wybiorą	1	Fut
Ja wszystko zanotuję , a żona podpisze .	zanotuję	2	Fut
Tutaj jedynie pokrótce opiszemy ten standard i nieco uzupełnimy zaprezentowane w wymienionych artykułach informacje .	uzupełnimy	8	Fut
– jedziemy . .	jedziemy	1	Pres
„ Bawi się ze mną .	Bawi	1	Pres
- Spała ś ?	Spała	1	Past
tak się kroi go i tak się macza w tym sosie .	macza	7	Pres
Powiedział em , że uczą , uśmiechnął em się do Rogera i wychylił em kieliszek .	Powiedział	0	Past
Może list ten obudzi odpowiedzialnych , a wtedy mieszkańcy na pewno ochoczo zabiorą się do upiększania swego osiedla .	obudzi	3	Fut
Wezwali Marcina .	Wezwali	0	Past
Mówimy o wyborach .	Mówimy	0	Pres
Pierwszy numer wyjdzie przed świętami .	wyjdzie	2	Fut
Słońce świeci prosto we mnie .	świeci	1	Pres
Niektórzy okażą się rzeczywiście sprawni i fachowi .	okażą	1	Pres
Steve zaklina się , że po każdym dyżurze szykuje ekstra posiłek czworonożnemu ratownikowi .	szykuje	8	Pres
Albo zesłać mu śmierć , zanim się zestarzeje .	zestarzeje	7	Fut
Jeśli jest , jak przypuszczam , Niemcy mocno się rozczarują .	rozczarują	9	Fut
Tutaj nie odnajdą go ani Doppler , ani Georg .	odnajdą	2	Fut
- Sam pan oceni .	oceni	3	Fut
Urządzimy też prywatny gabinet .	Urządzimy	0	Fut
Śnieg przykrył wiatrołomy grubą powłoką i trzeba je odkopywać .	przykrył	1	Past
Kardynał padrone szedł już na spotkanie .	szedł	2	Past
- Kocham cię w słońcu .	Kocham	1	Pres
Nie omieszkam tego tematu poruszyć .	omieszkam	1	Fut
Za linią lasu błysnęła w słońcu blacha na wieży kościoła .	błysnęła	3	Past
Może nauczysz się wreszcie , jak się takie rzeczy załatwia .	nauczysz	1	Fut
Wchodzimy do starej kamienicy .	Wchodzimy	0	Pres
Nieoczekiwanie i bardzo mocno uderzył w piersi łysego , wąsatego mężczyznę .	uderzył	4	Past
Sam nie dam rady .	dam	2	Fut
Osiągniesz korzyść prestiżową i finansową .	Osiągniesz	0	Fut
Potem zatopił w miąższu czarne palce .	zatopił	1	Past
Przenosi obojętne spojrzenie na stronę z nekrologami , którą Gabriela przygważdża do stołu kościstym palcem .	Przenosi	0	Pres
Trzecie miejsce przypadło Zakładowi Poprawczemu z Kcyni .	przypadło	2	Past
Poproszę o jakieś fajne stanowisko .	Poproszę	0	Fut
Recepcjonistce oczy rozszerzyły się ze zdumienia .	rozszerzyły	2	Past
Raz w roku do miasteczka ściągają turyści z całego kraju i z zagranicy .	ściągają	5	Pres
Obejdzie się .	Obejdzie	0	Fut
Czy jednak to przejdzie ?	przejdzie	3	Fut
Razem medytowali , jedli to samo , oglądali to samo .	jedli	3	Past
Opodal trenowali skoki chłopcy na deskorolkach .	trenowali	1	Past
Bandzior wynajmował posła do niszczenia konkurencji .	wynajmował	1	Past
Podziwiali i doceniali ją też uczniowie .	doceniali	2	Past
- Czytał em , choć czuł em się coraz mocniej poniżony .	Czytał	1	Past
Posiada ok. 150 ciekawych i zróżnicowanych egzemplarzy .	Posiada	0	Pres
- Pani minister , pani reprezentuje rząd i też pewien ład prawny . . .	reprezentuje	5	Pres
Twoje inicjatywy , konkretne , praktyczne i pożyteczne , zyskają uznanie i poparcie .	zyskają	9	Pres
Nowego najęli .	najęli	1	Past
Dla tej ojczyzny nawet lepiej było , kiedy owi emigranci nie odwracali się za siebie , nie próbowali powrotu .	próbowali	17	Past
Bawi się Pan w kolejnego kundelka UPR-u ?	Bawi	0	Pres
- Prześlę .	Prześlę	1	Fut
– ojej się spiję . .	spiję	3	Fut
– jakie śmieci pijesz ?	pijesz	3	Pres
Jął przeciskać się przez zaporę , czołgał się przez rumowisko , zmiażdżone wózki .	czołgał	6	Past
Twoja dusza ufa mu teraz bezgranicznie .	ufa	2	Pres
Obstawimy łoże tabliczkami . . .	Obstawimy	0	Fut
Sięgnął po słuchawkę , wybrał numer wewnętrzny sekretariatu , ale odezwała się tylko sprzątaczka .	Sięgnął	0	Past
Kiedy zaczniemy wreszcie kontrolować budynki mieszkalne i ich stan techniczny ?	zaczniemy	1	Fut
Ja nie mam takich uprawnień i nie uczestniczę w przesłuchaniach .	uczestniczę	7	Pres
- Nie zrobisz tego .	zrobisz	2	Fut
Rolnik , szukając schronienia , błyskawicznie wskoczył na dwukółkę .	szukając	2	Pres
Podpisuje się pani pod tym zdaniem ?	Podpisuje	0	Pres
Na ostatnich dziesięć lat osiem obfitowało w opady śnieżne w kwietniu i maju .	obfitowało	5	Past
Ale może wrócę .	wrócę	2	Fut
Do Kamienia nie pójdzie .	pójdzie	3	Fut
Przed dom nad rzeczką zajeżdża samochód .	zajeżdża	4	Pres
Zażerała się orzechami w czekoladzie i kasztanami mrożonymi , oblizując swoim obyczajem czubki palców .	Zażerała	0	Past
- Ministerstwo Edukacji Narodowej dokonało w 1995 r . przeglądu rodzin zastępczych .	dokonało	4	Past
Teraz wiedział em , że fama mej powieści obiegnie całe wydawnictwo .	obiegnie	8	Fut
Prowadzone obecnie postępowanie rozstrzygnie , kto zawinił .	rozstrzygnie	3	Fut
Angelika przystąpi do komunii w kościele w Dytmarowie .	przystąpi	1	Fut
Wspinając się , potrącił nogą ów kształt , który stoczył się ze stopni . . .	Wspinając	0	Pres
Czas okrutnie ścieśnił tę rodzinę .	ścieśnił	2	Past
Pan Janek zachodził do Ireny Rosy na kawę .	zachodził	2	Past
W wspomnianych zestawach nie figurują te nazwiska .	figurują	4	Pres
Prawdopodobnie wkrótce straci immunitet .	straci	2	Fut
Świadkowie twierdzą , że przy nazwisku figuruje jego stopień .	figuruje	6	Pres
Ale kiedy wymagało by to przekroczenia granic prawa , Bill powstrzymał się z pomocą .	powstrzymał	10	Past
Czy to wpłynie na treść raportu ?	wpłynie	2	Fut
A w Warszawie powstanie pierwszy pomnik lokalnej koalicji radnych PO i PiS .	powstanie	3	Pres
Jeżeli zabawka się zepsuje , wyrzucimy ją .	wyrzucimy	5	Fut
Pomodlę się za Polskę .	Pomodlę	0	Fut
Obudzimy Anamarię o dwunastej .	Obudzimy	0	Fut
Biadoli , że Trzęsionka doniesie im o naszym pijaństwie .	Biadoli	0	Pres
Dodaje , że nie rzucił obrazem o podłogę .	rzucił	4	Past
Zmuś ziemię , by wykarmiła swoje nędzne dzieci .	wykarmiła	4	Past
- To rekin , a ty się boisz , że przy pierwszej okazji wytarmoszę go za płetwy .	wytarmoszę	13	Pres
Podawali sobie z rąk do rąk legitymację podporucznika rezerwy .	Podawali	0	Past
przyda się .	przyda	0	Fut
- Sam go sobie stworzysz .	stworzysz	4	Pres
Niepodzielnie królowały wszędzie radość i uśmiech .	królowały	1	Past
Nakładamy rękawice ochronne , zapinamy swetry i wychodzimy na pokład .	Nakładamy	0	Pres
Inżynier nie kupi ?	kupi	2	Fut
W jakich godzinach urzęduję , kto mnie odwiedza .	urzęduję	3	Pres
Wszystkiego dowiem się we właściwym czasie .	dowiem	1	Fut
Wędrował po Tatrach od 1914 r. , wspinał się od 1924 .	wspinał	7	Past
Zimą , przylatując na popas do Polski , zadowala się pozostałymi na krzakach jagodami .	zadowala	8	Pres
Chodź , poszukamy czegoś na Trzynachę .	poszukamy	2	Fut
otworzę kanały elektryczne i niech wlezie tam . .	otworzę	0	Fut
Indie stanowczo zaprzeczają .	zaprzeczają	2	Pres
Dopomogą w twojej biedzie . "	Dopomogą	0	Fut
Zupełnie nisko nad głowami unosi się helikopter .	unosi	4	Pres
Sądził em , że szarość nie powinna być niema .	Sądził	0	Past
Fałszywego księdza przewieziono do więzienia w Rawiczu .	przewieziono	2	Past
Później zauważył , że lewe oko krwawi .	krwawi	6	Pres
Niech się kto inny pierwszy wypowie . . .	wypowie	5	Fut
Stłuces głobe !	Stłuces	0	Pres
Ciotka tymczasem już krzątała się w kuchni .	krzątała	3	Past
Państwu to się opłaci .	opłaci	3	Fut
Kupicie dom ?	Kupicie	0	Fut
Dziesięciu jeźdźców pokonuje trasę z Torunia do Pucka .	pokonuje	2	Pres
Do godziny drugiej po południu wszystko toczyło się normalnie .	toczyło	6	Past
Ja nie mam takich uprawnień i nie uczestniczę w przesłuchaniach .	uczestniczę	7	Pres
- Sama zatelefonuję .	zatelefonuję	2	Fut
NIK skontrolowała także 21 inwestycji służby zdrowia .	skontrolowała	1	Past
W nocy obudził się po godzince i opadła go bezsilność .	obudził	2	Past
Rysiek dziękował Bogu , że nie wręczył prezesowi dolara w parku , bo by wtedy nie miał czego szukać .	dziękował	1	Past
Jednocześnie policja poinformowała , że w różnych częściach stolicy Iraku odnaleziono 10 ciał mężczyzn .	poinformowała	2	Past
Niebo zasnuło się ołowianymi chmurami .	zasnuło	1	Past
- Przesadzasz ?	Przesadzasz	1	Pres
Biadoli , że Trzęsionka doniesie im o naszym pijaństwie .	doniesie	4	Fut
Nie zatamujesz krwi fałszywym bandażem .	zatamujesz	1	Fut
- Uważasz , że tylko dlatego jestem artystką , że mi się dobrze płaci ?	płaci	13	Pres
Nie przyznam się , o czym myślał em .	przyznam	1	Fut
Kto słyszy ?	słyszy	1	Pres
Dzieli wizja kierowania partią .	Dzieli	0	Pres
— Odpocznie od tego nieszczęścia .	Odpocznie	1	Fut
– Próbował em teraz w lecie na jachcie .	Próbował	1	Past
Hari nie gościł u niego od dziesięciu lat .	gościł	2	Past
Wiem , co zrobię !	zrobię	3	Fut
Dopiero oni wciągnęli kobietę do łodzi .	wciągnęli	2	Past
Dostrzegają je twoje oczy , słyszą je twoje uszy .	słyszą	5	Pres
W obecnej sytuacji odpowiadała mu każda forma rozgłosu .	odpowiadała	3	Past
Warszawski Indeks Giełdowy zyskał 5 procent , a WIG20 , indeks największych spółek na parkiecie , wzrósł o 6,1 procent .	wzrósł	16	Past
Państwo nie zarobi .	zarobi	2	Fut
- Polecę .	Polecę	1	Fut
Kiwek , spluwając w palce , uważnie odliczał złotówki .	odliczał	7	Past
Jak sądzisz ?	sądzisz	1	Pres
Rodzice dziecka zastrzegli sobie anonimowość i nie chcieli rozmawiać z prasą .	zastrzegli	2	Past
Rozpalą nimi pierwszą watrę przy szałasie .	Rozpalą	0	Fut
W zakładzie wszyscy współczują dyrektorowi Szwonderowi .	współczują	3	Pres
Zadręczy nas .	Zadręczy	0	Fut
Odsapnąć nie pozwalają .	pozwalają	2	Pres
W takich warunkach niczego dobrego nie napiszę .	napiszę	6	Fut
Po końcowym gwizdku arbitra w ekipie gości zapanowała zrozumiała euforia .	zapanowała	7	Past
Na koniec kokieteryjnie usprawiedliwiła się , że mówi bez ładu i składu , bo jest już w zaawansowanym wieku .	usprawiedliwiła	3	Past
- Trzymali nas w chlewiku . . .	Trzymali	1	Past
Otaczają one miasto od południa i zachodu .	Otaczają	0	Pres
Ale głową muru nie przebijesz . . .	przebijesz	4	Fut
Czego się napijesz ?	napijesz	2	Fut
Zarzucił mu Pan , że utrwala sejmokrację .	Zarzucił	0	Past
Że coś wymyśli i zorganizuje .	wymyśli	2	Fut
Gram i walczę dla niej , nie dla siebie .	walczę	2	Pres
Pisze przemówienia , opracowania , ekspertyzy .	Pisze	0	Pres
Ale rozumiem , że do ślubu , prędzej czy później , dojdzie ?	dojdzie	11	Fut
Z Jackiem Kuroniem współpracowali śmy i nadal współpracujemy .	współpracujemy	7	Pres
Pewną aktywność przejawiają tylko mieszkańcy domów sąsiadujących ze świątynią .	przejawiają	2	Pres
Dostał eś ostatnio piątkę z algebry ?	Dostał	0	Past
- Słyszysz ?	Słyszysz	1	Pres
Malarz uspokoił się .	uspokoił	1	Past
- Wiem , że Pan nas osłoni .	osłoni	6	Fut
Następuje ciąg dalszy Mszy świętej .	Następuje	0	Pres
O tej rozmowie zapominamy .	zapominamy	3	Pres
Wiedział em , że tej krzywdy mi nie wybaczy .	wybaczy	8	Fut
Piłkarze krakowskiej Wisły sprawili wspaniały prezent wszystkim sympatykom futbolu w Polsce .	sprawili	3	Past
I podobno wcale ich nie dogonili .	dogonili	5	Past
Na tej podstawie otrzymają diety , od 1500 do 2000 złotych .	otrzymają	3	Pres
Świat jest chaotyczny , procesy rozwojowe nie układają się w logiczne ciągi i trzeba się z tym pogodzić .	układają	7	Pres
Wcześniej Gracen stanowczo zaprzeczała , że utrzymywała intymne kontakty z prezydentem .	utrzymywała	6	Past
Michał naciągnął mi na oczy kaptur , omotał szalikiem i kazał wracać do domu .	omotał	7	Past
Jeśli jeden zgubi czapkę , możemy leżeć spokojnie .	zgubi	2	Fut
Kto wiatr sieje , ten burzę zbiera .	zbiera	6	Pres
Zaraz spróbuję lepiej wyjaśnić , co mam na myśli .	spróbuję	1	Fut
Odkładam książki , gaszę komputer .	Odkładam	0	Pres
Mieszka pod Warszawą , a w swoim pięciohektarowym gospodarstwie , oprócz dwudziestu psów , hoduje także konie i kozy .	hoduje	14	Pres
Stłuces głobe !	Stłuces	0	Fut
Stary wiadukt przy ulicy Oświęcimskiej stanowił ogromną uciążliwość dla kierowców .	stanowił	5	Past
Antena powinna być skierowana na południowy wschód .	powinna	1	Pres
Bardzo zachęcam do wizyty w ICM i stałego korzystania z jej usług .	zachęcam	1	Pres
Wydało mi się , że to mi przywróci równowagę .	przywróci	7	Fut
Konstanty dodał jeszcze , że jej pomoże .	pomoże	6	Fut
Jeżeli Golędzinów nadjedzie , wygra wielką stawkę .	nadjedzie	2	Fut
Na parterze pozostanie Księgarnia Literacka .	pozostanie	2	Fut
- Zatrzymaj się , bo strzelę !	strzelę	5	Pres
Bez tabletki nie zasnę .	zasnę	3	Fut
- Ewa , posłuchaj , to na pewno minie . . .	minie	8	Fut
W najbliższych dniach Warszawy nie zasypią śmieci .	zasypią	5	Fut
Z początkiem wojny przenosi się do dworku w Krzykawce .	przenosi	3	Fut
Firma skontaktowała się ze mną , przedstawiając opinię rzeczoznawcy .	przedstawiając	6	Pres
— W sprawie wywiadu moja sekretarka skontaktuje się z pańską sekretarką .	skontaktuje	6	Fut
Tłumaczę mu to , ale nie może pojąć , o co chodzi .	Tłumaczę	0	Pres
Prosi się też zakłady pracy , które dysponują autobusami , by wspomogły komunikację zastępczą .	Prosi	0	Pres
Nie kieruję się przy tym ideologią wegetariańską , choć z nią sympatyzuję .	sympatyzuję	11	Pres
Kiedy wreszcie natrafił na schody i znalazł się na ulicy , kolegów przed pałacem już nie było ; najwidoczniej nie mogąc się go doczekać udali się bez niego na miasto .	mogąc	20	Pres
Występuje stałe obniżanie się poziomów wód w rzekach i potokach .	Występuje	0	Pres
Wciąż nawiązywał em nowe znajomości .	nawiązywał	1	Past
Powołano specjalny zespół mający wyjaśnić przyczyny i okoliczności tragedii .	Powołano	0	Past
Całujemy twoje lodowe stopy .	Całujemy	0	Pres
Nie okpisz jej .	okpisz	1	Fut
W pięć minut później przypomniał sobie , że należało wpierw wytrzeć gumką uwagi na marginesach .	przypomniał	4	Past
- Sąd obawiał się , że nie zdąży przesłuchać pana ministra .	zdąży	7	Fut
Spojrzała , czarne oczka złośliwie mignęły , znikła .	mignęły	5	Past
Wyjeżdża do Kocic , gdzie będzie odnawiał polichromię .	Wyjeżdża	0	Pres
Zbliżają się ferie , już niedługo pociągi z Warszawy do Zakopanego zapełnią się młodzieżą .	zapełnią	11	Fut
Zdaje się , że uczył w szkołach .	uczył	4	Past
Otrzymasz zasiłek i ubezpieczenie zdrowotne .	Otrzymasz	0	Fut
Policjanci śmieją się , odreagowując stres .	śmieją	1	Pres
Lech Kaczyński nie żałuje , że jego filmowa kariera się nie rozwinęła , a do swojego aktorskiego talentu podchodzi z rezerwą .	rozwinęła	11	Past
Samolot kołuje w smugach burego śniegu z deszczem .	kołuje	1	Pres
- Myśleli śmy , że się nie uda .	uda	7	Fut
Przeciętne świadczenie emeryta , rencisty wzrośnie o 33 zł .	wzrośnie	5	Fut
Skrzypnęły drzwi i Liść wszedł do środka .	Skrzypnęły	0	Past
Czy na to go dzisiaj plecy swędziały ?	swędziały	6	Past
Muszę się wytężyć maluczko . . .	Muszę	0	Pres
Mogę się tylko domyślać , że mechanicy zabiją barana , który od rana obgryza skraj plastikowego worka , i przyniosą mi moją część .	przyniosą	19	Pres
Strażacy oflagowali samochody i wywiesili transparenty .	wywiesili	4	Past
Fenometys wciąż kręcił głową , światło lamp odbijało się na bezwłosej skórze idealnymi refleksami .	odbijało	7	Past
Pozwolisz , że pójdę na balkon ?	pójdę	3	Fut
Uczniowie od dawna wiedzą o agencji .	wiedzą	3	Pres
– zbija kasę . .	zbija	1	Pres
Ślizgawki w Dąbrowie Górniczej odbywają się już od 4 lat .	odbywają	4	Pres
Jestem przekonany , że już niedługo zawita do nas prawdziwie złota polska jesień .	zawita	6	Fut
I zawsze dziwię się , że była m taka .	dziwię	2	Pres
A ja wciąż pamiętam jej stopy .	pamiętam	3	Pres
Ciała te noszą ślady tortur .	noszą	2	Pres
Psy od razu wyczuły papierosy .	wyczuły	3	Past
Józinek ochłonie , sprzątnie , przeprosimy się .	przeprosimy	5	Fut
Weźmiemy to pod uwagę , przygotowując zmiany .	Weźmiemy	0	Fut
- Niech pani się przyjrzy tekstowi mojego wystąpienia .	przyjrzy	4	Fut
Niedługo w sprawie umocujemy dodatkowego prokuratora , aby przyspieszyć prace .	umocujemy	3	Fut
Uspokoiły się natychmiast , tylko jakieś drżenie czasem przebiega po nich .	przebiega	8	Pres
Ale oni szybko domyślają się prawdy .	domyślają	3	Pres
Ciotka odpycha go łokciem .	odpycha	1	Pres
Teraz umocnią się na rynku .	umocnią	1	Fut
Kaczka bez brata nikogo nie ugryzie w łydkę .	ugryzie	5	Fut
Napijecie się kawy ?	Napijecie	0	Fut
Oddaję się niecnym praktykom .	Oddaję	0	Pres
Ale ty wrócisz .	wrócisz	2	Fut
Teraz chodzi o to , by nie sprawiła zawodu .	sprawiła	7	Past
Jak długo Szczuka zabawi w Ostrowcu ?	zabawi	3	Fut
Stowarzyszenie na Rzecz Praw i Wolności liczy ok . tysiąca członków .	liczy	6	Pres
Losem tej matki i jej dziecka zainteresowały się nawet władze USA .	zainteresowały	6	Past
Zostawisz chwaścik , a jutro , pojutrze wyrośnie ożóg .	Zostawisz	0	Fut
ja też się w to pobawię kiedyś . .	pobawię	5	Fut
Jej nikt nie podskoczy , nawet w Babilonie .	podskoczy	3	Fut
Apostołowie tego nie praktykowali .	praktykowali	3	Past
W Tczewie w Radzie Miejskiej zasiada 23 radnych .	zasiada	5	Pres
Tenisiści stołowi Energetyka Opoki Trzebinia znają już terminy spotkań barażowych o I ligę , w których ich rywalem będzie zwycięzca II ligi łódzko - świętokrzyskiej Start Brzezina .	znają	5	Pres
Może wytrzymam . . .	wytrzymam	1	Fut
- Przyjechał em przed wojną , pracował em i pracuję u Francuzów . . .	Przyjechał	1	Past
- Podpisał em !	Podpisał	1	Past
Przeszkadza ci .	Przeszkadza	0	Pres
Magdzie zrobiono cewnikowanie .	zrobiono	1	Past
Nakręcił 60 filmów dokumentalnych i stworzył ponad 300 programów telewizyjnych .	Nakręcił	0	Past
Trochę mu się skrzydełka pomięły , ale właził już prawie cały do środka .	pomięły	4	Past
Stanowi klasę sam dla siebie .	Stanowi	0	Pres
W ostatniej minucie klęskę kolończyków przypieczętował Marcel Witeczek .	przypieczętował	5	Past
Pan zanotuje sobie prywatny numer posła . . .	zanotuje	1	Fut
Zamierzam odwiedzić te miejsca w przyszłości .	Zamierzam	0	Pres
Nie odwrócą się .	odwrócą	1	Fut
Otulił zestarzałe ciało w kiereję futrzaną .	Otulił	0	Past
I od początku szedł numer , potem znowu ktoś trącił . . .	szedł	3	Past
Marta dyskretnie przyglądała się trójce młodych ludzi , którzy teraz opiekują się Polą .	opiekują	10	Pres
Z czego mam się cieszyć , że kości rozsiejemy po świecie ?	rozsiejemy	8	Fut
Nakielska straż miejska odbiera sporo podobnych zgłoszeń .	odbiera	3	Pres
Wiadomo , że ostatecznie zawiedzie się na tej idei Stagiryta .	zawiedzie	4	Fut
Komendant się roześmiał odstawiając szklankę .	odstawiając	3	Pres
Arcybiskup Ochrydy przypisuje Borysowi także i inne cechy , które wzbogacają jego wizerunek .	przypisuje	2	Pres
Jak to skończysz , spróbuj Stendhala i Buddenbrooków Tomasza Manna . . .	skończysz	2	Fut
A ten głupi Rzymianin powiedział , że go tam odeśle . . .	odeśle	9	Fut
Niedługo kasa popłynie jeszcze większym strumieniem .	popłynie	2	Fut
Ale ramy , instytucje i aspiracje Cesarstwa narzuciły się apostołom , biskupom , kapłanom i wiernym jako odniesienie oczywiste i nieuniknione .	narzuciły	7	Past
Liście kołysały się na wietrze , gałęzie drzew szumiały jak morze w snach .	szumiały	8	Past
Małe oczki króla zamigotały złowrogo .	zamigotały	3	Past
Kiedy RS AWS się wzmocni , ja też zrezygnuję z pewnych funkcji .	wzmocni	4	Fut
znajomych trochę poodwiedzam .	poodwiedzam	2	Fut
znowu się tutaj odwołam do faktów .	odwołam	3	Fut
- Nie boję się .	boję	2	Pres
W pierwszej kolumnie kroczą woje Chrobrego .	kroczą	3	Pres
Muzeum homoseksualizmu otwierał nadburmistrz Berlina Klaus Wowereit .	otwierał	2	Past
Miasto Detroit do tej pory płonie , a wyjątkowo upalna pogoda sprzyja rozszerzaniu się pożarów .	płonie	5	Pres
- To już ustalili śmy .	ustalili	3	Past
Światło zgasło jednak po dwóch minutach .	zgasło	1	Past
- Ja im się poddam .	poddam	4	Fut
Tym razem atrakcyjność potyczki podniesie fakt , że Hoop i Zepter reprezentują mocno zmienione oblicza .	podniesie	4	Pres
Wniesienie skargi o wznowienie nie tamuje wykonania zaskarżonego wyroku .	tamuje	5	Pres
Że coś wymyśli i zorganizuje .	zorganizuje	4	Fut
- Ja ich nie obgaduję .	obgaduję	4	Pres
Ani my ciebie nie pobudzamy , ani ty się nie dzielisz .	dzielisz	10	Pres
Inne dzieci nie przychodziły do mnie zbyt często .	przychodziły	3	Past
Trzeci zapatrzy się gdzieś w przestrzeń .	zapatrzy	1	Fut
– Nie dokuczam , mamo !	dokuczam	2	Pres
Wśród tradycjonalistów muzułmańskich z państw Półwyspu Arabskiego wywołało ono szok .	wywołało	7	Past
– Mock zapalił i rozsiadł się w fotelu .	rozsiadł	4	Past
Wychodził do pracy świtem , wracał w ciemności .	wracał	5	Past
Barszczucha rozwinęła kabel i włączyła do kontaktu .	włączyła	4	Past
– Ja się tym zajmę .	zajmę	4	Fut
- Oparł się nonszalancko o bufet .	Oparł	1	Past
Wyrównują one nierówności , jednocześnie przyklejając płytki .	przyklejając	5	Pres
Pozwolą Państwo , że coś przypomnę .	Pozwolą	0	Fut
Zbliżała się godzina bankietu , trzeba było zejść na dół .	Zbliżała	0	Past
Koty przerwały brutalnie moje panowanie nad światem .	przerwały	1	Past
Już niedługo się przekonamy .	przekonamy	3	Fut
– jak wyszły ?	wyszły	2	Past
Oczywiście zwilgotniały .	zwilgotniały	1	Past
- Ty nie śpisz , Arielu .	śpisz	3	Pres
Fluor uszkadza nerki , zmniejsza odporność na infekcje i sprzyja rozwojowi alergii .	sprzyja	9	Pres
Nie będzie postulowanego przez PiS samorozwiązania Sejmu , bo nie godzi się na nie Platforma Obywatelska .	godzi	10	Pres
Wolała puszczać w kinach filmy kung-fu licząc , że dzięki temu ludzie przestaną myśleć o polityce .	przestaną	12	Fut
Pierwsza uczestniczka zaśpiewa o miłości przyprawianej różnymi smakami .	zaśpiewa	2	Fut
Ale konia i wóz oddasz ?	oddasz	4	Fut
Może narażę się na krytykę ze strony pana premiera Pawlaka , ale wciąż zbyt wielkie znaczenie przywiązujemy do umów międzyrządowych .	narażę	1	Pres
- Wejdziesz ze mną ?	Wejdziesz	1	Fut
Modna kobieta pozostawi w swojej szafie spodenki do kolan oraz rybaczki .	pozostawi	2	Fut
Od niego dowiem się najlepiej .	dowiem	2	Fut
Statystyki są zastanawiające , ale co się w rzeczywistości za nimi kryje ?	kryje	11	Pres
Zrobił się jakby lekko zadarty . . .	Zrobił	0	Past
- Oddaję ci , bracie Nachorze , terafim ojca naszego .	Oddaję	1	Pres
Gdy dorośnie , zbuduje swoją katedrę , tworząc powieściowy świat W poszukiwaniu straconego czasu .	zbuduje	3	Pres
Jakiego czasu tam pani doświadczyła ?	doświadczyła	4	Past
Że się pełznie .	pełznie	2	Pres
- Znowu sięgnę do wspomnień z okresu , kiedy mieszkał em w Krakowie .	sięgnę	2	Fut
Ofiarę udusili paskiem i dobili kamieniami .	udusili	1	Past
Nie dowie się .	dowie	1	Fut
Ktoś inny w złości kopie ławkę i rzuca głośno soczyste przekleństwa .	rzuca	7	Pres
My takiej nie prowadzimy , nie wykonujemy zadań publicznych dla zysku , ale dla dobra mieszkańców .	wykonujemy	6	Pres
Wracał em do Bud już po północy .	Wracał	0	Past
Federaliści przegrali wybory .	przegrali	1	Past
- I nikt nie zginie ?	zginie	4	Fut
" Zrobimy " !	Zrobimy	1	Fut
Jasieńczyk o nią zapytał .	zapytał	3	Past
Ściany skalne zbliżają się w tym miejscu i dalsza droga prowadzi w ciasnym wąwozie .	zbliżają	2	Pres
Jest to przydatne , gdy na jednej stronie umieszczamy kilka formularzy .	umieszczamy	8	Pres
Pierwej im się te chabazie świeżym kwieciem pokryją .	pokryją	7	Fut
Zagroda zaraz by cię wsadził za kratki .	wsadził	4	Past
- Sam go sobie stworzysz .	stworzysz	4	Fut
W zaborze rosyjskim po śmierci Aleksandra II , który zginął w zamachu terrorystycznym , nastąpiło gwałtowne zaostrzenie polityki represyjnej we wszystkich dziedzinach życia publicznego .	zginął	9	Past
Dziękuję za uwagę .	Dziękuję	0	Pres
Uczą się i pomagają innym .	Uczą	0	Pres
Buduję , mając zaufanie w Bogu i mając miłość do ludzi .	mając	7	Pres
Może pan jeszcze jakieś wymieni ?	wymieni	4	Fut
Niektórzy didżeje wpisują sobie występ w Pieksie do CV .	wpisują	2	Pres
- Niech Pan ześle anioła , by prowadził was w drodze .	ześle	3	Fut
Na skrzyżowaniach wyrastają rośli policjanci , gazeciarze wciskają przechodniom papierowe płachty i przekrzykują się nowościami z wczorajszego dnia i nocy , która właśnie minęła .	wyrastają	2	Pres
Rodzina i przyjaciele powitali w sobotę uwolnione przez rosyjskie służby specjalne Polki .	powitali	3	Past
Robiły śmy kanapki , stroiły śmy półmiski .	stroiły	4	Past
Ułatwi ona włączenie się do ruchu jadącym z Koziegłów do Poznania .	Ułatwi	0	Fut
- Nie trza , damy se sami radę !	trza	2	Pres
Rycerzy głodno nie puszczą .	puszczą	3	Fut
Za Wankiewiczem ja sam głosował em .	głosował	4	Past
Długo szukał po kieszeniach , lecz wyjął z nich tylko zapałki .	szukał	1	Past
Mgła pękała .	pękała	1	Past
Przychodzimy jako spadkobiercy Krzywoustego drużyny .	Przychodzimy	0	Pres
Zresztą nazwa ta nigdy nie funkcjonowała na terenach górskich .	funkcjonowała	5	Past
Panuję nad negatywnymi nastrojami .	Panuję	0	Pres
Andrzej Kowerski pozostawał w jej cieniu i nie wiadomo , jak to znosił .	pozostawał	2	Past
moja mama strasznie chlała i paliła marihuanę .	chlała	3	Past
są takie takie pinezki tylko nie nakłuje ściany .	nakłuje	6	Fut
Jeżeli zostawi się puste wiaderko , też może je zająć któryś kot .	zostawi	1	Fut
Popierają regionalne środowiska twórcze .	Popierają	0	Pres
Kurs zakończył się egzaminem .	zakończył	1	Past
Krew spryskała bok mierzynka .	spryskała	1	Past
Spluwę włożę do buzi , nacisnę spust .	włożę	1	Fut
Przez tydzień włóczył się bez celu po Melbourne , wyczekiwał na rozkazy .	włóczył	2	Past
Przyjdziesz dziś po obiedzie ?	Przyjdziesz	0	Fut
Starczy tego rzępolenia , łajzy !	Starczy	0	Pres
Kaczmarek teraz równie stanowczo zaprzecza , by Ungier go ostrzegał .	zaprzecza	4	Pres
Wtacza się pociąg .	Wtacza	0	Pres
Sport nie zasługuje na to , żeby mówić o nim oddzielnie .	zasługuje	2	Pres
I posadzą .	posadzą	1	Fut
Władze hiszpańskie działały niezwykle szybko .	działały	2	Past
W Boskiej Rzeczywistości problemy nie istnieją .	istnieją	5	Pres
– Wycelowała kluczami w koronkową bieliznę .	Wycelowała	1	Past
Gdzie się podzieje ?	podzieje	2	Fut
Najwięcej pochłoną inwestycje w oświacie , drogowe , wodociągowe i proekologiczne .	pochłoną	1	Fut
Andrzej Kowerski pozostawał w jej cieniu i nie wiadomo , jak to znosił .	znosił	12	Past
Nie znaczy to , że rezygnuję ze sportu .	rezygnuję	5	Pres
- Gramy !	Gramy	1	Pres
Maksymalizację wydajności skrawania osiąga się dzięki maksymalizacji przekroju warstwy skrawanej i prędkości skrawania .	osiąga	3	Pres
Zapowiedział , że SLD zagłosuje w Sejmie przeciw rządowej propozycji .	zagłosuje	4	Fut
Jean Paul nie odzywał się .	odzywał	3	Past
Tu jest strefa przygraniczna , sami rozumiecie .	rozumiecie	6	Pres
Niech spełnią się wszystkie jej marzenia !	spełnią	1	Fut
Co tracisz , co zyskujesz ?	tracisz	1	Pres
- Nie trza , damy se sami radę !	damy	4	Fut
Karolowi głowa pęka z bólu , całe ciało płonie .	płonie	8	Pres
Żadna straż nie upora się z lepiankami .	upora	3	Fut
Ta matka dba o nią , jak umie .	dba	2	Pres
– Wyjdziesz już ?	Wyjdziesz	1	Fut
- Nie wiem , czy mnie puszczą , może będą się bali .	puszczą	6	Fut
Już mnie tu nie zastaną i będą bardzo zdziwieni .	zastaną	4	Fut
Dzielili się obaj z księdzem zgodnie .	Dzielili	0	Past
Społeczeństwo wychowywano w ślepym posłuszeństwie wobec Cesarstwa .	wychowywano	1	Past
Ażeby takim przykrym kolizyom zaradzić , puszczamy w świat ten oto podręcznik .	puszczamy	6	Pres
Ale zdążymy się jeszcze spotkać wieczorem .	zdążymy	1	Fut
Musi , niczego nie dostrzegając , dalej spokojnie obierać włoszczyznę .	Musi	0	Pres
Niedługo w sprawie umocujemy dodatkowego prokuratora , aby przyspieszyć prace .	umocujemy	3	Pres
Wśród podhalańskich Cyganów z bezwzględności słynie jego współpracownik , współoskarżony w Oświęcimiu , Stanisław Kamiński z Czarnej Góry .	słynie	5	Pres
Odpowie za znęcanie się nad psem .	Odpowie	0	Fut
A może i my się zabawimy ?	zabawimy	5	Fut
- Jeszcze nie zdążyła m .	zdążyła	3	Past
- Agatka jest teraz u swoich chrzestnych i nie chcę , by wracała do domu .	wracała	12	Past
Chyba mnie jeszcze zaprosisz , bo mi leczo bardzo smakowało ?	zaprosisz	3	Fut
Wózek zwolnił biegu i przystanął .	przystanął	4	Past
- Wracał ten , który poszedł do kierowcy .	poszedł	5	Past
- No , nie mówiła m , że wykipi ?	wykipi	8	Fut
Poproszę o urlop , paszport leży w domu .	Poproszę	0	Fut
- Wyniesiesz mnie ?	Wyniesiesz	1	Fut
Wznowią je w styczniu przyszłego roku .	Wznowią	0	Fut
Jeden z mężczyzn przystąpił do majstrowania przy kablach telefonicznych .	przystąpił	3	Past
Szły dzieci przez pole minowe i wesoło machały rączkami .	machały	7	Past
Ziewnął , przeciągnął się , mocno napinając mięśnie .	Ziewnął	0	Past
- A ja mówię panu profesorowi , że nie pójdę .	pójdę	9	Fut
To państwo Kaczyńscy wiedzą i rządu do dymisji nie podadzą .	wiedzą	3	Pres
Ale pięć lat temu tryumfował Aleksander Kwaśniewski .	tryumfował	4	Past
Małe szare oczka wpatrywały się we mnie drwiąco , wyraźnie triumfowała .	wpatrywały	3	Past
W Polsce nikt nie wie .	wie	4	Pres
– Bywa , że rolnicy jeszcze przynoszą pisma .	Bywa	1	Pres
W całym województwie odbywają się liczne imprezy artystyczne i sportowe .	odbywają	3	Pres
Roosevelt po dwóch kadencjach wybrał się polować do Afryki , ale już nie mógł żyć bez polityki .	wybrał	4	Past
Przebiegające pod miastem chodniki kopalni zalano wodą , a wzgórze zgniło i zapadło się w ziemię jak przydeptane .	zalano	5	Past
Wygrzebuję z kieszeni monetę dwudziestocentimową i podchodzę do automatu .	podchodzę	6	Pres
Konferencja ideologiczna omówiła wiele interesujących spraw .	omówiła	2	Past
Kazimierz Laudański i jego bracia to znani w okolicy pszczelarze , klienci przyjeżdżają aż z Niemiec po miód .	przyjeżdżają	12	Pres
Należało by wcześniej umyć okna .	Należało	0	Past
- Na razie nie planujemy kolejnych dzieci .	planujemy	4	Pres
Uważano więc w partii , że Gierek , po antrakcie Ochaba , powrócił do praktyki niszczenia poprzedników przez następców .	powrócił	12	Past
Trzeba się spieszyć , bo lada moment pojawią się posłowie IV kadencji .	pojawią	7	Fut
Witała m siostrzeńca i przepraszała m go za kłamstwo moich przełożonych .	przepraszała	4	Past
Tadzio patrzył na mnie i widział em , że mu było żal .	żal	11	Pres
Bardzo prosimy , Pani Minister .	prosimy	1	Pres
Uważam , że pomógł .	pomógł	3	Past
W poczekalni uścisnęli sobie ręce , Henryk dźwignął walizę .	uścisnęli	2	Past
– Policzysz , jak zechcesz .	Policzysz	1	Pres
Nie znoszę łez .	znoszę	1	Pres
Izrael zagroził wczoraj , że wkroczy zbrojnie na tereny Autonomii , jeśli Arafat nie zapanuje nad terrorem .	zagroził	1	Past
Policjanci z pobliskiego komisariatu przyznają , że docierają do nich sygnały o rozbojach .	przyznają	4	Pres
Nie zatrzymuję cię .	zatrzymuję	1	Pres
W 10 sklepach sprzedawcy odmówili , żądając okazania dokumentów , w jednym przypadku alkohol sprzedano .	sprzedano	14	Past
Głosowało 419 posłów .	Głosowało	0	Past
Spluwę włożę do buzi , nacisnę spust .	nacisnę	5	Fut
Projekt nie wykracza poza gminy .	wykracza	2	Pres
Nie skorzystało z tej szansy .	skorzystało	1	Past
Decyzje w tej sprawie podjęły Mostostal Warszawa , Elektrim , Polifarb i Okocim .	podjęły	4	Past
Braków wtenczas nawet poeci nie wypuszczali .	wypuszczali	5	Past
Rodzice ze wzruszeniem prezentowali dziennikarzom swoje maleństwa i dziękowali za pomoc .	dziękowali	8	Past
Po piętnastu zawiadamiamy Kowala , że coś ci się stało .	zawiadamiamy	2	Pres
Frajer odjedzie .	odjedzie	1	Pres
czyżby prawda aż tak bolała ?	bolała	4	Past
Fascynują mnie także ludzie , z którymi współpracuję .	Fascynują	0	Pres
Wirują mu musztardowe księżyce i słońca , a na samym dole żagla zjawia się łeb wieloryba o mikroskopijnych , czerwonych oczach .	Wirują	0	Pres
Sygnał dźwięku wielokanałowego możemy wyprowadzić tylko przez cyfrowe złącze optyczne , ale kabla , niestety , nie znajdziemy w pudełku .	znajdziemy	17	Fut
Wczoraj kamieniarze szykowali się do swojej części prac .	szykowali	2	Past
Na Suwalszczyźnie złamało się 6 słupów , nie pracuje 50 stacji transformatorowych .	złamało	2	Past
Do podlewania sadzonek wyśmienicie nadają się filtrowane ścieki .	nadają	4	Pres
Zwycięzcy gratulujemy !	gratulujemy	1	Pres
Ekolodzy zaopatrzyli młodszych kolegów w worki na śmieci i rękawiczki .	zaopatrzyli	1	Past
Nim przekroczy granice raju , musi wyrazić skruchę .	przekroczy	1	Pres
Już dziś boją się , że znaczna część zbiorów zgnije w kopcach .	zgnije	9	Pres
Przychodzą kibice .	Przychodzą	0	Pres
Okupując wejście , czekały , co się wydarzy .	wydarzy	7	Fut
Starczy mi sił .	Starczy	0	Fut
Polska powoli suszyła się po wielkiej powodzi , a uwaga Czytelników kierowała się na politykę .	kierowała	11	Past
Słuchaj , Piotr był zalany , spadał ze schodów , wyskakiwał z okna .	wyskakiwał	10	Past
Pracownik zwalnia się często podczas pracy dla załatwienia spraw osobistych .	zwalnia	1	Pres
Józinek ochłonie , sprzątnie , przeprosimy się .	sprzątnie	3	Fut
Studiują tutaj Łukasz Kruczek , Grzegorz Śliwka , Krystian Długopolski , teraz obok mnie studentem został Tomek Pochwała .	Studiują	0	Pres
Milcząc , spuściła wzrok .	Milcząc	0	Pres
Ze stara wyciekał olej i płyn chłodzący , a przyczepa miała zdemontowany hamulec awaryjny .	wyciekał	2	Past
W piątek i sobotę tylko w Chicago zmarło na skutek gorąca dalszych 26 osób .	zmarło	7	Past
Ledwo widać drogę , u Gontarczyków całe okno zawiało .	zawiało	8	Past
Usiedli śmy na pniu .	Usiedli	0	Past
Poznali się na weselu brata Edyty .	Poznali	0	Past
Z Lipusza trasa powiedzie ich dalej do Sulęczyna , Sierakowic , Mirachowa i Otomina .	powiedzie	3	Fut
Ceną za to opóźnienie okazał się udział w rynku francuskim .	okazał	4	Past
Człowiek wpakuje się w jakąś historię .	wpakuje	1	Fut
Atak nastąpił z bliska , w wąskiej uliczce .	nastąpił	1	Past
Dzięki temu wyszło szydło z worka , ale czy ktoś za to odpowie głową ? ? ?	odpowie	12	Fut
Postawicie nam ćwiartkę , a my już damy facetowi radę .	Postawicie	0	Fut
Dla zachęty wspomniała by m , że dostanie czekoladę .	dostanie	7	Fut
– Nowak zirytował się .	zirytował	2	Past
Następnie rozłożyła wysoki statyw , zawiesiła na nim pudełko , przeprowadziła od niego przezroczysty przewód do igły , którą wcześniej automatyczny iniektor umieścił w żyle na przedramieniu Irka .	przeprowadziła	10	Past
Panie Prezesie , w ten sposób nie pomoże Pan ani Pana ugrupowaniu , ani działkowcom .	pomoże	7	Fut
Dziś posłowie zadecydują o powstaniu biura .	zadecydują	2	Fut
Podczas ostatnich wyborów wygrała tutaj socjaldemokracja .	wygrała	3	Past
Idę coś zjeść .	Idę	0	Pres
Jeśli w młodości nie przyzwyczaimy organizmu do tego życiodajnego płynu , organizm przestanie wytwarzać laktozę , enzym niezbędny do trawienia cukru mlecznego .	przyzwyczaimy	4	Pres
Często karani kielczanie raz za razem grali w osłabieniu .	grali	6	Past
– niech jej babcia kupi . .	kupi	4	Fut
No teraz często płaci .	płaci	3	Pres
Trafi do szpitala psychiatrycznego .	Trafi	0	Fut
Ty coś ćwiczysz ?	ćwiczysz	2	Pres
Mieszkańcy grożą , że zablokują ulice .	zablokują	4	Fut
Przygotowuje się nowy transport do Niemiec .	Przygotowuje	0	Pres
Dyrektor wymienia imprezy , które zorganizował .	zorganizował	5	Past
W trakcie remontu zauważył go nowy właściciel mieszkania , bo z piasku wystawała ręka .	wystawała	12	Past
Umrą ulgi . . .	Umrą	0	Fut
Ja szczepiła m tylko na odrę .	szczepiła	1	Past
Stopniowo dół się sam zasypie śmieciami .	zasypie	4	Fut
Zapytali , czy rozpoznaje chłopaka na zdjęciu .	rozpoznaje	3	Pres
Następnym razem przyprowadzą kolegów i pomalutku piękny sport narciarski zainteresuje bardziej młodzież naszego miasta .	przyprowadzą	2	Fut
Ponadto bardzo pragniesz się podobać .	pragniesz	2	Pres
Dzięki temu po wyjęciu dwóch foteli uzyskamy dodatkową powierzchnię bagażową .	uzyskamy	6	Fut
Wczoraj , po zamknięciu lokali wyborczych , niemieckie media zapowiedziały , że pani minister ustąpi ze stanowiska .	ustąpi	14	Fut
– no zapaliła m wczoraj bez problemu !	zapaliła	2	Past
- Jeszcze pan zdąży ! "	zdąży	3	Fut
Machała m mu fartuchem , żeby lądował na łące pod lasem , ale ten chłopak chyba się przestraszył , że zawadzi o druty .	przestraszył	17	Past
Sporadycznie tylko osiągają ceny powyżej 10000 zł .	osiągają	2	Pres
Usiadła na fotelu , zakładając nogę na nogę , miała spódniczkę przed kolana .	zakładając	4	Pres
Niech pan mu się jeszcze raz przyjrzy !	przyjrzy	6	Fut
I umie przewidzieć ceny ?	umie	1	Pres
Prawda zwycięży .	zwycięży	1	Fut
Po zranieniu żony , napastnik zbiegł .	zbiegł	5	Past
- To wypracowuje się na codziennych , mozolnych próbach .	wypracowuje	2	Pres
- I tobie niech zawsze zdrowie służy .	służy	6	Pres
Spojrzała w niebo , oceniając , kiedy znów zacznie padać .	zacznie	8	Fut
Sprawdzamy wyrostki kolczyste i łuki kręgów .	Sprawdzamy	0	Pres
Kiermasze te zapowiadały Wielki Tydzień , który charakteryzował się postem i wyrzeczeniami .	charakteryzował	7	Past
Kiedy go wciśniemy , wycisza wszystkie dźwięki .	wciśniemy	2	Fut
Ojciec zajrzał przez drzwi .	zajrzał	1	Past
Decyzja zapadła , mimo że szefowie tajnych służb ostrzegli , iż Palestyńczycy wyjdą na ulice .	wyjdą	12	Fut
Przeszła ona jego najśmielsze oczekiwania .	Przeszła	0	Past
Większość utrzyma pracę .	utrzyma	1	Fut
Rzecznik Praw Obywatelskich wystąpił w obronie inwalidów wojennych i wojskowych , którym wprowadzono obowiązek płacenia za pobyt w sanatoriach uzdrowiskowych .	wystąpił	3	Past
Na północy i wschodzie strzelano .	strzelano	4	Past
Z radością witali również państwa Paleniów sąsiedzi , którzy na tę okazję upiekli specjalny tort .	upiekli	12	Past
Przez zwały gruzów ulicami miasta przebija się z trudem wojskowy Willys .	przebija	5	Pres
- Oto głoszę Twoje Królestwo .	głoszę	2	Pres
Wylegitymował się pan ?	Wylegitymował	0	Past
Wprowadza czytelników w błąd .	Wprowadza	0	Pres
Osiągnęła sukces .	Osiągnęła	0	Past
Lamentują , jakby śpiewali .	Lamentują	0	Pres
Pokażemy mu .	Pokażemy	0	Fut
- Nie tęskni Pan za niespełnionym marzeniem ?	tęskni	2	Pres
Bił tak mocno , że złamał kij bejsbolowy .	Bił	0	Past
Nieruchomo stojąc w powietrzu nad kwiatami lecimy .	lecimy	6	Pres
Wanilii brak , ale cukry waniliowe znakomicie ją zastąpią .	zastąpią	8	Fut
Niektóre rzeki nie zamarzają w ogóle .	zamarzają	3	Pres
lubisz jogurty ?	lubisz	0	Pres
- Ale ginu pan się napije ?	napije	5	Fut
A może boi się , że ją wydam ?	wydam	7	Fut
– jak my to odpakujemy ?	odpakujemy	4	Fut
Nieżyczliwi twierdzą , że wojewoda chorował inaczej .	chorował	5	Past
Zaręczam wam , że ubrań nie znajdziecie .	znajdziecie	6	Fut
Nasz system polityczny ewoluuje w kierunku dwóch wielkich bloków .	ewoluuje	3	Pres
Chłopak zerwał się z miejsca , złapał posążek i ścisnął mocno w dłoni .	ścisnął	9	Past
Począł myśleć gorączkowo .	Począł	0	Past
W ostatnich latach upomnieli się lekarze i pielęgniarki o swoje płace .	upomnieli	3	Past
Postawicie nam ćwiartkę , a my już damy facetowi radę .	damy	7	Fut
Cała opera huczy od sprzecznych komentarzy .	huczy	2	Pres
W wyniku nieadiabatycznego ochładzania najniższych warstw troposfery powstają , ogólnie biorąc , najniższe chmury warstwowe .	powstają	7	Pres
Bywa też tak , że dzieci nie wiedzą , czego chcą , i to też nas rozczarowuje .	rozczarowuje	16	Pres
„ Pogadam ze Stanleyem .	Pogadam	1	Fut
Natomiast Gorczyca pominął w ogóle sprawę milczeniem .	pominął	2	Past
Po spłukaniu ulega biodegradacji .	ulega	2	Pres
Nie pamięta , kiedy ostatnio badał ją lekarz .	badał	5	Past
– mi już starczy tych zdjęć .	starczy	3	Fut
Byli chłopi zwiezieni autobusami .	Byli	0	Past
Zwycięzca już na samym początku narzucił ogromne tempo .	narzucił	5	Past
Splotła silne dłonie .	Splotła	0	Past
- Pływał em tam w ubraniu ?	Pływał	1	Past
Wokół murów wyrosną piękne ogrody .	wyrosną	2	Fut
Należało to robić dokładnie , inaczej paczki spadały przy wjeżdżaniu do windy .	Należało	0	Past
Przeziębicie się !	Przeziębicie	0	Fut
Masz mieszkanie komunalne ?	Masz	0	Pres
Może nawet płakała już przedtem , ale spostrzegł em to dopiero teraz .	spostrzegł	7	Past
- Czy ktoś z pań posłanek i panów posłów pragnie zabrać głos w sprawie przedstawionych propozycji ?	pragnie	9	Pres
- Może pójdę do Zosi ?	pójdę	2	Fut
Spytała m o niego mężczyznę siedzącego obok .	Spytała	0	Past
Jakie aspekty wybijają się na pierwszy plan ?	wybijają	2	Pres
Tu latają cyklony , podejdą wyżej , będzie wiało od wyżu .	wiało	8	Past
Myśli rwały mi się przy każdym kroku .	rwały	1	Past
- Poseł Janusz Wójcik sam zrzeknie się immunitetu .	zrzeknie	5	Fut
Klaskał mu prezydent Kwaśniewski oraz zgodnie prawa i lewa strona .	Klaskał	0	Past
Oprócz okradania opolan eseldziaki kantowały również kumpli w interesach .	kantowały	4	Past
Staram się strzec przed uogólnianiem .	Staram	0	Pres
Lucynka spojżała w okno i zobaczyła wielkiego , kudłatego zwierzaka .	spojżała	1	Past
Rozmawiając , zboczyli na polną drogę .	Rozmawiając	0	Pres
- Co polski Kościół wniesie do Europy narodów ?	wniesie	4	Fut
W dniu tym wystartują również bobsleiści .	wystartują	3	Fut
Piotr A . bije go pięścią , a jego kompan Piotr G . kopie w tył głowy .	kopie	13	Pres
Dzieje się to zazwyczaj w pionowo rozbudowanych , konwekcyjnych chmurach kłębiastych .	Dzieje	0	Pres
Podzielam ten pogląd .	Podzielam	0	Pres
Wyjaśnił w niej , że został wychowany w bardzo purytańskim domu , w którym wpojono mu szacunek dla takich cnót jak skromność i oszczędność .	Wyjaśnił	0	Past
Dwukrotnie występował na mistrzostwach świata .	występował	1	Past
Nie będziesz żałował .	żałował	2	Past
Mężczyzna dotykał ciała dziewczynki w miejscach intymnych .	dotykał	1	Past
Pokiwał em głową .	Pokiwał	0	Past
Jeśli nie zatrąbisz , ośmieszysz nas .	zatrąbisz	2	Fut
Wasielewski wyprowadził wóz z parkingu i włączył się do ruchu .	wyprowadził	1	Past
- Może mi się uda namówić go , żeby wrócił do kraju .	uda	4	Fut
Dratewkę pani Joasia wyrwała z bestialskich łap pewnego szewca , którego niech piekło pochłonie .	wyrwała	3	Past
Wieś powoli budziła się do życia .	budziła	2	Past
Poniosę cię .	Poniosę	0	Fut
Jechała m raz z moim marynarzem .	Jechała	0	Past
– napijesz się herbatki ?	napijesz	1	Fut
Zjechali i zaczęła się sakramencka mordęga .	Zjechali	0	Past
Regina z ciekawością słuchała czytającego z kartki Bornsteina .	słuchała	3	Past
Jeśli przez dwa miesiące nie uda się dogadać , można rozpocząć procedurę wywłaszczeniową .	uda	5	Fut
Grenlandia nie zniknie .	zniknie	2	Fut
Zatrzymali podejrzanego człowieka w niekompletnym stroju .	Zatrzymali	0	Past
– oj no nie szkodzi no .	szkodzi	4	Pres
- Skąd ty bierzesz takie powiedzonka ?	bierzesz	3	Pres
– weźmiesz wódkę i przyjdziesz ?	przyjdziesz	4	Fut
Moje napięcie rośnie z dnia na dzień .	rośnie	2	Pres
- Prowadzi edukację humanitarną , pomaga uchodźcom , powodzianom .	Prowadzi	1	Pres
Nie podzieliła się .	podzieliła	1	Past
Gdy nikt nie reagował na dzwonek , włączyli syrenę .	włączyli	7	Past
Otworzyła m radio i słuchała m muzyki .	Otworzyła	0	Past
Każdy myślał , że wystarczy włożyć do worka z solą i zanieść na strych .	wystarczy	4	Fut
Wąż w kieszeni go uratował .	uratował	4	Past
Rozdają publiczne pieniądze na rzecz Kościoła katolickiego , modlą się żarliwie przed kamerami , marzą o cenzurze obyczajowej .	marzą	14	Pres
Zdradzisz nam sekrety urody Cosmodziewczyny ?	Zdradzisz	0	Fut
- Powtarzam i wykonuję .	wykonuję	3	Pres
Sam Misztal nie ukrywa , że chce zamknięcia dyskoteki .	ukrywa	3	Pres
Zaraz się tam wybiorą .	wybiorą	3	Fut
Mikroświat wciąż kusił swymi tajemnicami .	kusił	2	Past
Manifestanci próbowali uniemożliwić policji zamykanie biur zdelegalizowanego ugrupowania .	próbowali	1	Past
Celników wspomagały specjalnie szkolone psy oraz sprzęt techniczny .	wspomagały	1	Past
Dankowski objął Bełchatów na początku sezonu , a pierwszej porażki doznał dopiero w siódmej kolejce .	objął	1	Past
Podobne warunki terenowe charakteryzują cmentarzysko w Předmostí .	charakteryzują	3	Pres
Pokora uczyniła go cichym i tylko miłość w nim płonie , dlatego spogląda na wszystkie rzeczy takimi samymi oczami .	spogląda	12	Pres
Jeżeli nieszczęściem zakochasz się we mnie .	zakochasz	2	Fut
Samozwańczy gliniarz posługuje się oryginalną legitymacją .	posługuje	2	Pres
- Polska przez wiele lat korzystała z pomocy Zachodu .	korzystała	5	Past
Zwierzę polubiło piwko i bez kufla nie daje się wydoić .	polubiło	1	Past
Chodorkowski podpadł władzom , bo krytykował prezydenta Putina i nie krył swoich politycznych ambicji .	podpadł	1	Past
Podnoszę słuchawkę .	Podnoszę	0	Pres
Hamurabi puścił wzrok daleko przed siebie .	puścił	1	Past
Nikt tam nie zagląda .	zagląda	3	Pres
- On nigdy nie zjedzie chłopu z drogi , choćby był w próżni .	zjedzie	4	Fut
Przepraszam , ale pan wygłasza za długie przemówienie .	Przepraszam	0	Pres
Niewielka szansa , prawdopodobnie obaj żołnierze strzelą i któryś z nich musi trafić .	strzelą	6	Fut
- Wóz się chybnie i zlecą .	chybnie	3	Fut
Czyżby tam zabrnął Barski ?	zabrnął	2	Past
Żyję sama dla siebie i dla siebie umrę .	umrę	7	Fut
II wojna światowa skończyła się ponad pół wieku temu .	skończyła	3	Past
Co odpowie na to dominikanin ?	odpowie	1	Fut
– ja podziękuję .	podziękuję	2	Fut
- Jeśli lud przestanie słuchać naszych nauk , zostanie pożarty przez pogan !	przestanie	3	Fut
Położyli na drabiniastym wozie .	Położyli	0	Past
Ostre cięcia grożą też prezesom państwowych spółek .	grożą	2	Pres
Na seminarium historycznym występowały wszystkie wielkie walory uczonego i nauczyciela .	występowały	3	Past
Ze stadionu zniknie także bieżnia lekkoatletyczna .	zniknie	2	Fut
Poza nielicznymi wyjątkami politycy bagatelizują te informacje .	bagatelizują	4	Pres
W Niemczech płaci sie rolnikom za nieuprawianie ziemi .	płaci	2	Pres
Na ich grobach złożono również wiązanki kwiatów i zapalono znicze .	złożono	3	Past
Kompromitowali nie tylko siebie , ale i Polskę .	Kompromitowali	0	Past
Jeżeli zabawka się zepsuje , wyrzucimy ją .	zepsuje	3	Fut
- Zamykaj buzię , bo ci świecący ptak do niej wleci .	wleci	10	Fut
W ostateczności wyjdę na taras .	wyjdę	2	Fut
Wiedział em , że przyjdziecie .	przyjdziecie	4	Fut
Krzyczy na mnie tylko trochę , kiedy się biję ze starszym bratem .	biję	8	Pres
Według relacji świadków , gdy biały opel frontera zbliżył się do ambasady , wyskoczył z niego człowiek ubrany w panterkę , z granatnikiem w ręku , i próbował odpalić granat w kierunku ambasady .	wyskoczył	13	Past
Nie twierdzę , że prowadzimy wojnę promową .	twierdzę	1	Pres
Ptaki te chętnie korzystają z pokarmu wykładanego dla parkowych łabędzi .	korzystają	3	Pres
Jeszcze w 1576 , jak wspominają akta wizytacyjne , mieszkali tu wolni Prusowie .	wspominają	5	Pres
Tym głównie Stronnictwo będzie się różniło od większości europejskich partii chadeckich , w których liberalizm gospodarczy miesza się z ideami socjaldemokratycznymi i nauką społeczną Kościoła .	różniło	5	Past
Pójdziesz do domu .	Pójdziesz	0	Fut
Jakoś się pogodzimy .	pogodzimy	2	Fut
Czyżby teraz przepuściła okazję , mając tuż obok przystojnego młodego mężczyznę ?	mając	5	Pres
Radni poruszyli problem złych nawierzchni dróg , domagając się ich remontu .	poruszyli	1	Past
Kiedy dostaniesz pieniądze ?	dostaniesz	1	Pres
Powinna m wcześniej na to wpaść .	Powinna	0	Pres
Postawisz mi pizzę ?	Postawisz	0	Fut
Stwierdzono , że stosunkowo wysokie zarobki mają pielęgniarki bloku operacyjnego .	Stwierdzono	0	Past
- A ja się nigdy nie przyzwyczaję do tego barbarzyństwa .	przyzwyczaję	6	Fut
Sześć cebul kupiła na kiermaszu zorganizowanym w pobliskiej szkole .	kupiła	2	Past
Odzyskano ukradzione przedmioty .	Odzyskano	0	Past
Wymykała mu się , a potem znów przyciskała do niego .	przyciskała	7	Past
Pogłaskał ją po dłoni i znowu mimowolnie zastanowił się nad kopertą od Bazarewicza .	Pogłaskał	0	Past
Zresztą umówimy się w budzie .	umówimy	1	Fut
– Policzysz , jak zechcesz .	zechcesz	4	Pres
Że istnieją jej sąsiedzi .	istnieją	1	Pres
- Pogadamy sobie jeszcze i odprowadzę ją do drzwi hotelu .	odprowadzę	5	Fut
– My mieszkamy na samej górze .	mieszkamy	2	Pres
Ale takiej nikt nie złapie !	złapie	4	Fut
Widział em też , że różnią się między sobą .	różnią	5	Pres
Kiedy Krystyna wracała z miasta , zastawała ją na czatach przy drzwiach .	zastawała	6	Past
- Każdy twórca marzy chyba , żeby odnieść wielki sukces .	marzy	3	Pres
Saudyjski ambasador w Londynie już zapowiedział , że jego rząd nie ugnie się pod presją i nie złagodzi kar .	ugnie	11	Fut
- Zrobiono mi tym wielkie świństwo , bo po waszym artykule ludzie się ze mnie śmieją .	Zrobiono	1	Past
Zaprószono ogień i wybuchł poważny pożar na górnych piętrach .	Zaprószono	0	Past
Poruszył em się na łóżku , które odpowiedziało sprężyście .	odpowiedziało	7	Past
Weźmie w nim udział 25 uczniów szkół podstawowych z terenu gminy .	Weźmie	0	Pres
Czy uważa Pan , że dzisiejsi studenci już się nie buntują ?	buntują	10	Pres
Hill startował z pole position , ale już na pierwszych metrach wyprzedził go kolega z zespołu David Coulthard .	startował	1	Past
Nim Marcin odejdzie , dzieje się coś dziwnego .	odejdzie	2	Fut
Natychmiast wyruszymy .	wyruszymy	1	Fut
- Niech pani to skieruje do siebie .	skieruje	4	Fut
Mieszkańcy grożą , że zablokują ulice .	zablokują	4	Pres
Przypuszcza , że uczył się nowych słów .	uczył	3	Past
Odpokutujecie za to !	Odpokutujecie	0	Fut
- Liderzy twierdzą , że jakiś sukces odnieśli .	odnieśli	7	Past
Teraz wylegitymowani na granicy , jeśli nie zapłacą , mogą nawet stracić samochód .	zapłacą	7	Fut
W czasie pobytu u sióstr w klasztorze Krystyna korespondowała z ojcem , niecierpliwie wyczekując jego listów .	korespondowała	8	Past
Pękali śmy z dumy .	Pękali	0	Past
A za trzecim razem wpadnie .	wpadnie	4	Fut
Przyda ci się , idą przymrozki .	Przyda	0	Fut
Chodziło oczywiście o kontakty ściśle naukowe , ale umożliwiły one później wysłanie jezuity , astronoma , do Chin .	umożliwiły	8	Past
czy ty wierzysz w świat radykalnie wegetariański ?	wierzysz	2	Pres
Niektórzy pytają , po co to robię ?	pytają	1	Pres
Błyskotliwy wykładowca - matematyk o mrocznej urodzie zafascynował młodą studentkę .	zafascynował	7	Past
( A odpisze mi koleżanka na priva jeszcze ? )	odpisze	2	Fut
Ktoś się poruszył .	poruszył	2	Past
Wczoraj już od piątej rano kupcy wyprowadzali się .	wyprowadzali	6	Past
I nie zgodzili się .	zgodzili	2	Past
Ranną przetransportowano śmigłowcem do zakopiańskiego szpitala .	przetransportowano	1	Past
Kiedyś musieli za to płacić rodzice , teraz sami finansujemy nasze przyjemności .	finansujemy	9	Pres
Jak się ją trenuje ?	trenuje	3	Pres
Wkrótce zawiniemy do Trondheim .	zawiniemy	1	Fut
Harcerze zbierają niepotrzebne rowery , aby po naprawie przekazać je Domowi Dziecka w Kórniku-Bninie .	zbierają	1	Pres
- Wybaczy pan , Profesorze . . .	Wybaczy	1	Fut
Jeśli weźmiemy pod uwagę sprawność i wydajność akumulatorów wanadowych , projekt wydaje się zupełnie realny .	weźmiemy	1	Pres
Nikt nie zatrzyma rozwoju medycyny .	zatrzyma	2	Fut
Koszmar rozegrał się w nocy .	rozegrał	1	Past
Czy zdążymy przed deszczem pochować pana Sierożę ?	zdążymy	1	Fut
Później strzałami w powietrze sterroryzował kasjerkę i zmusił ją do wydania pieniędzy .	sterroryzował	4	Past
I wróżą dobrą pogodę do inwestowania w akcje .	wróżą	1	Pres
A dziś już siwieje .	siwieje	3	Pres
W klatkach znajdowały się dzikie koty .	znajdowały	2	Past
Wciąż dzwonią do niego jakieś baby .	dzwonią	1	Pres
I montujemy z tego dziewięćdziesięciominutowy program .	montujemy	1	Pres
Trafia się taksówka .	Trafia	0	Pres
Nie robimy z tego tajemnicy .	robimy	1	Pres
W zeszłym roku lekarz stwierdził , że ma świnkę .	stwierdził	4	Past
Robotnicy tylko wtedy poprą reformę , jeśli będą mieli jakieś zabezpieczenie .	poprą	3	Fut
Uczył em .	Uczył	0	Past
Gdy Cahirowi czupryna nieco mocniej przyschnie do czerepu , powędrujemy ku Toussaint .	powędrujemy	9	Fut
- Uciekli ?	Uciekli	1	Past
Ocalałe pielęgniarki wydostają się na brzeg .	wydostają	2	Pres
– chętnie posłucham jeszcze raz . .	posłucham	2	Fut
- Mogło by się tak komuś wydawać .	Mogło	1	Past
Tuż po publikacji rozdzwoniły się telefony z zamówieniami .	rozdzwoniły	3	Past
Nie było to oczywiście zamierzone , wynikło z pośpiechu .	wynikło	6	Past
Cztery kowane wozy pojechały za siostrami .	pojechały	3	Past
Ćwiczyła w hełmofonie .	Ćwiczyła	0	Past
Bohaterki filmu reprezentują różne odmiany kultury śródziemnomorskiej .	reprezentują	2	Pres
Wytargowali lepsze honorarium .	Wytargowali	0	Past
Ich mieszkańcy do dzisiaj pamiętają wojnę z rozwydrzoną młodzieżą , wojnę o prawo do spokojnego snu , którą w końcu wygrały dla nich oddziały gestapowskiej policji .	wygrały	20	Past
Panuję nad negatywnymi nastrojami .	Panuję	0	Pres
Weszła do gabinetu i bezgranicznie puste spojrzenie zawiesiła na fotelu .	zawiesiła	7	Past
Gdy goście opuścili jego dom i pozostał jedynie 63-letni emeryt , doszło między nimi do sprzeczki .	opuścili	2	Past
Zamiera łono ziemi .	Zamiera	0	Pres
Nie jesteś już młodzieńcem i lepszej kariery nie zrobisz .	zrobisz	8	Fut
To jest środowisko , które dzisiaj narzuca ton władzy w Polsce .	narzuca	6	Pres
Pirkka zadrżał pod wpływem przeciągu .	zadrżał	1	Past
Tym razem atrakcyjność potyczki podniesie fakt , że Hoop i Zepter reprezentują mocno zmienione oblicza .	reprezentują	11	Pres
Mój widok bardzo zaskoczył LPR-owskiego działacza .	zaskoczył	3	Past
Kupili jakieś zmiotki w ruskiej hurtowni i zbijają na mnie kasę .	Kupili	0	Past
– że dogorywa tak naprawdę .	dogorywa	2	Pres
Dotarł do zabudowań Ilii .	Dotarł	0	Past
Tematy prac rodzą się nagle .	rodzą	2	Pres
Oprócz Warszawy , gość odwiedzi także Kraków oraz Gdańsk .	odwiedzi	4	Fut
I nie usłyszy , bo inżynier nie powtarza zarzutów .	usłyszy	2	Fut
Oczywiście do zerwania zmówin dochodziło .	dochodziło	4	Past
Nie wstąpi jego stopa junacka w strzemiona ojcowe .	wstąpi	1	Fut
Spróbuję , ale nie będzie to łatwe .	Spróbuję	0	Fut
- Musi odejść .	Musi	1	Pres
- Spróbuję załatwić lekarza .	Spróbuję	1	Fut
Chce uruchomić przewozy w Raciborzu-Markowicach i Nieborowicach .	Chce	0	Pres
Malarz uspokoił się .	uspokoił	1	Past
Czy ty kogokolwiek naprawdę kochał eś ?	kochał	4	Past
- Spróbuję .	Spróbuję	1	Pres
Mnie duchy nie interesują .	interesują	3	Pres
O tym , czy odejdzie , zadecyduje premier .	odejdzie	4	Fut
Dopiero za trzy tygodnie ludowcy zdecydują , kogo wystawią do prezydenckiego wyścigu .	zdecydują	5	Fut
Wprost na podłodze rozpościerał się siennik , a na nim leżał człowiek .	rozpościerał	3	Past
- Tylko mu lodów nie daję .	daję	5	Pres
Hehe wspinał się mozolnie po schodach starej kamienicy przy Poznańskiej .	wspinał	1	Past
– ona czyta samodzielnie gazety ?	czyta	2	Pres
Pracodawca mniej zapłaci za naszą chorobę .	zapłaci	2	Fut
Nie wierzył em .	wierzył	1	Past
Poza tym powinna być bardziej dostępna dla zainteresowanych osób , które zechcą przechować w nim ważne osobiste dokumenty .	zechcą	11	Pres
To by mu rozwaliło żołądek .	rozwaliło	3	Past
Wysiadł więc i piknął pilotem , blokując centralny zamek .	blokując	6	Pres
Teraz Bóg jeden raczy wiedzieć .	raczy	3	Pres
Powiedział em , że uczą , uśmiechnął em się do Rogera i wychylił em kieliszek .	uczą	4	Pres
Nim się nasze drogi rozejdą .	rozejdą	4	Fut
Spotkał się ze stanowczą odmową .	Spotkał	0	Past
Pędzę do pokojówki z tą hiobową wieścią .	Pędzę	0	Pres
Ustalili śmy ze Stachem , że jeszcze trochę pociągnę pismo dla honoru domu i odejdę .	odejdę	14	Fut
- W Gazie wybuchnie wojna domowa .	wybuchnie	3	Fut
- Odpowiem jednym zdaniem .	Odpowiem	1	Fut
Nie pracuje i razem z teściową wychowuje dzieci .	wychowuje	6	Pres
Za parę dni dotrze do Londynu .	dotrze	3	Fut
Tanio wezmę . . .	wezmę	1	Fut
Po zdjęciu serwetki i położeniu jej na kolanach na małym talerzyku spożyjemy przekąskę .	spożyjemy	11	Fut
Do przyczyn nawet nie sięgną !	sięgną	4	Pres
Niech padnę trupem na miejscu .	padnę	1	Fut
Adres niech dobrodziej spisze z dowodu osobistego .	spisze	3	Fut
Analogiczny obraz zróżnicowań społecznych ukazują dane o wieku menarchy dziewcząt .	ukazują	4	Pres
Porosła by gęstym lasem , jak cała okolica , gdyż chudy piasek nie dał by życia .	Porosła	0	Past
Wiem , że tu przyjdziecie .	przyjdziecie	4	Fut
Zmieniamy ludzi , którzy zawiedli .	Zmieniamy	0	Pres
Dlatego publiczność posypała się do teatru , jak na odpust .	posypała	2	Past
A jeszcze wczoraj zdawało mu się , że rozpozna każdą sztachetę w płocie .	rozpozna	8	Fut
Wezmę bilety .	Wezmę	0	Fut
Skoczę i przyniosę .	Skoczę	0	Fut
Błagam , nie chorujcie i żadnych kłopotów nie miejcie !	Błagam	0	Pres
Nie zakłada inwestowania w firmę w upadłości .	zakłada	1	Pres
- Czekam na pana przy wyjściu .	Czekam	1	Pres
Raz na cztery lata wybieramy swoich przedstawicieli do rad gmin .	wybieramy	4	Pres
Osoba przypadkowa zorientuje się , że powinna odejść .	zorientuje	2	Fut
Cena wywoławcza czarnego watermana ze złotą stalówką wynosiła 300 zł .	wynosiła	7	Past
I były dygnitarz wyszedł trzasnąwszy drzwiami .	trzasnąwszy	4	Past
Zatarł ręce i pokiwał głową .	pokiwał	3	Past
Dobył go z ukrytej pod kaftanem pochwy .	Dobył	0	Past
Dlaczego na Niego krzyczę ?	krzyczę	3	Pres
Powinna wierzyć , że jej mąż żyje , a te biedne zwłoki należą do kogoś innego . . .	należą	12	Pres
Nie napisał mi Pan , dlaczego się Pan przenosi do Warszawy .	przenosi	8	Pres
Wzrasta popularność psychologii i psychiatrii .	Wzrasta	0	Pres
Bał em się , że pożar przejdzie też na moją stodołę .	przejdzie	6	Fut
Niech płaszczą się przed groźnym wieprzem !	płaszczą	1	Pres
Ustalili śmy ze Stachem , że jeszcze trochę pociągnę pismo dla honoru domu i odejdę .	pociągnę	8	Fut
I tak za parę dni wracam .	wracam	5	Pres
Potem przyłożył sobie lufę do skroni .	przyłożył	1	Past
– zaczną sobie wyobrażać . .	zaczną	1	Fut
Spaceruję sobie wzrokiem po ścianach , suficie , meblach i przedmiotach .	Spaceruję	0	Pres
Koledzy pozwolą na górę .	pozwolą	1	Pres
– zaśpiewa kolędę . .	zaśpiewa	1	Fut
Ich cierpliwość się wyczerpała .	wyczerpała	3	Past
Na razie przyda ci się więcej wypoczynku .	przyda	2	Pres
Chciałem go wypchnąć z mieszkania , ale naparł na mnie .	naparł	7	Past
A po kebabie wracam do domu .	wracam	3	Pres
Na twarzy tłumacza odmalowało się zdumienie .	odmalowało	3	Past
I ciągle mi się zdaje , że się wyleczę , jakby czas mógł mi w tym pomóc .	wyleczę	8	Fut
A więc teraz szczodrze wynagrodzi mu niedosyt !	wynagrodzi	4	Fut
Stary kładzie ręce w kieszenie i chodzi po pokoju .	kładzie	1	Pres
- Nie przyprowadzimy go , senior .	przyprowadzimy	2	Fut
Gospodarze odpowiedzieli dwoma golami Ralfa Hauptmanna i Austriaka Tony Polstera .	odpowiedzieli	1	Past
One potrzebują równego traktowania .	potrzebują	1	Pres
Bąk uniósł się na łokciach , podparł pięściami brodę .	podparł	6	Past
Mario , też mi się zdaje , że przesadzasz .	zdaje	5	Pres
- Storację zabiorę stąd .	zabiorę	2	Fut
I inni kiwają głową ze zrozumieniem .	kiwają	2	Pres
I zawrócił na rzekę .	zawrócił	1	Past
Uczucia decydują o przyszłości i sekwencji wydarzeń .	decydują	1	Pres
- Langer z grubasami popychał dziennikarską brać do wyjścia .	popychał	4	Past
- Niebawem wyruszymy .	wyruszymy	2	Fut
Po spełnieniu toastu świeżo upieczeni małżonkowie rzucają za siebie kieliszki .	rzucają	6	Pres
Z jednej strony umówił em się z państwem dziennikarzami , że zakończymy o godzinie 17 .	zakończymy	11	Fut
Ale jak zinterpretować pojawienie się kolędników w finałowej scenie , kiedy rozjadą się już Konrad i ksiądz Piotr ?	rozjadą	11	Fut
- Nie wierzył em , że Ance uda się oderwać pana od tropienia przestępców .	uda	7	Fut
Zaczekasz na nas czy pójdziemy razem ?	Zaczekasz	0	Fut
Zapewne dla wielu kobiet słowa Jana Pawła II są ważne i zbawienne , ale słowa nie wystarczą .	wystarczą	16	Pres
Zapytam , jakiej pomocy oczekuje .	Zapytam	0	Fut
Zadzwonił do szpitala w porze wieczornej .	Zadzwonił	0	Past
Zauważyła m , że człowiek ten jest nawet całkiem miły .	Zauważyła	0	Past
A znamy i dawniejsze .	znamy	1	Pres
Liczyli zdobyte łupy , oglądali własne i nieprzyjacielskie straty .	Liczyli	0	Past
Skupia na sobie uwagę ludzi .	Skupia	0	Pres
– może zadzwonimy ?	zadzwonimy	2	Fut
Przypuszczam , że ten człowiek nie należy do SLD .	Przypuszczam	0	Pres
Zapytał mnie w pewnym momencie , czy do niego pójdę .	pójdę	9	Fut
Do głosowania nad projektem dojdzie prawdopodobnie w sobotę .	dojdzie	4	Fut
Przyjadą goście z miasta .	Przyjadą	0	Fut
– Oni się douczą .	douczą	3	Fut
- Nie znali ście mego syna . . .	znali	2	Past
Ja chyba niedługo umrę .	umrę	3	Fut
W piątek wieczorem odwiedziły ją w domu i namówiły na spacer .	odwiedziły	3	Past
On się męczył , darł kartki , wyrzucał , wreszcie znalazł wersję , która wyrażała jego uczucia .	męczył	2	Past
Kiedy lekarz wystrzelił , rozdrażnione zwierzę rzuciło się na niego .	rzuciło	6	Past
Zobaczymy , co zwiozą nam do młodni .	zwiozą	3	Fut
Nad falami sterczał jeszcze tylko wystrzelający pionowo dziób .	sterczał	2	Past
Wiedzą , że zjadła by m ich na kolację .	zjadła	3	Past
Podczas zajęć rękodzielniczych , mimo początkowego wątpienia we własne możliwości , młodzież tworzyła ozdoby wielkanocne .	tworzyła	12	Past
Gdy goście opuścili jego dom i pozostał jedynie 63-letni emeryt , doszło między nimi do sprzeczki .	opuścili	2	Past
Przyznam , że sam był em zdziwiony . . .	Przyznam	0	Fut
– Nie rozumiesz , telefon dołączył em do magnetofonu i nagrywa mi , no .	dołączył	5	Past
Napastnik skuł ofiarę kajdankami i zgwałcił .	zgwałcił	5	Past
- Pójdziesz za to siedzieć , wiesz ?	Pójdziesz	1	Fut
Zostawisz chwaścik , a jutro , pojutrze wyrośnie ożóg .	wyrośnie	7	Fut
Czy czynniki religijne nie ograniczają wolności wyborów politycznych obecnego rządu ?	ograniczają	4	Pres
Chłopak zawahał się .	zawahał	1	Past
Tam dokonał czynów lubieżnych na dziewczynce .	dokonał	1	Past
Jadwiga z niepokojem i współczuciem patrzyła na męża .	patrzyła	5	Past
Zabrała mnie ze sobą , była to dobra okazja , żeby zafundować sobie darmową terapię , pojechać szybko jej passatem do Gdańska .	Zabrała	0	Past
Nie rzekła nic na to .	rzekła	1	Past
Nie zapomniał em o tym zwyczaju .	zapomniał	1	Past
Po paru dniach znał już wszystko i wszystkich i spędzał na górnych piętrach każdą wolną chwilę , wychodząc tylko w porze posiłków i oczywiście snu .	znał	3	Past
Cały teren splantowano , a niedługo zostanie wykonane nowe ogrodzenie .	splantowano	2	Past
Radny Krzysztof Krzeszowski wylicza podobne przypadki także w innych szkołach .	wylicza	3	Pres
Obok colonel Eddie majstruje coś we wspaniałym Kodaku .	majstruje	3	Pres
Gospodarz wyprostował się .	wyprostował	1	Past
Ci strzelali .	strzelali	1	Past
- Trudno będzie , ale spróbujemy .	spróbujemy	5	Fut
Przyszłość nieuchronnie zweryfikuje te hierarchie .	zweryfikuje	2	Fut
Sprawą zainteresował się referat I-szy i przez kontrolę korespondencji może uzyskamy dalsze miejsca zachowanych rzeczy .	uzyskamy	10	Pres
Bo wam sfajczę forsę !	sfajczę	2	Fut
On mnie rozpoznał , zaraz zaświadczy . . .	zaświadczy	5	Fut
Puszczaj , bo zabiję !	zabiję	3	Fut
Rozmawiając , zboczyli na polną drogę .	zboczyli	2	Past
Jeden z uczestników rusza w las , licząc kroki .	rusza	3	Pres
Dziwnej kompanii , ośmielę się zauważyć .	ośmielę	3	Fut
Później połączono go z lądem groblą .	połączono	1	Past
Ksiądz Krzysztof zaproponował , że mi pożyczy .	pożyczy	6	Fut
- Ty tylko udasz , że nic nie widział eś .	udasz	3	Fut
Pożar nie zmoże rzeki .	zmoże	2	Fut
W Warszawie pada śnieg .	pada	2	Pres
Ubrała m się i zeszła m na dół .	Ubrała	0	Past
Pod Wisłą buduje się wielki tunel ciepłowniczy .	buduje	2	Pres
Ostatnio tyle razy wyobrażała m sobie , że się do niego zbliżam .	wyobrażała	3	Past
Uważam , że pomógł .	Uważam	0	Pres
I rzeczywiście , taczając się , po chwili ruszyli przed siebie .	taczając	3	Pres
Przeglądam dziennik swój .	Przeglądam	0	Pres
Na pewno w akcję włączą się również mieszkańcy .	włączą	4	Fut
Przygrywały kapele , występowały zespoły i soliści .	występowały	3	Past
Pochodzi z wielodzietnej rodziny wiejskiej .	Pochodzi	0	Pres
Przyznam się , że nie pamiętam już tak chłodnego początku października .	Przyznam	0	Fut
Zwiększy się również zazdrość i przemoc .	Zwiększy	0	Fut
Aktorstwo bardzo pochłania i to przenosi się na życie prywatne .	przenosi	5	Pres
- Uwierzy !	Uwierzy	1	Fut
Zapewne już nie wrócę do Ameryki , już nie wrócę do amerykańskich tematów .	wrócę	9	Fut
Panie marszałku , jakiego wyniku pan oczekuje ?	oczekuje	6	Pres
- Nauczasz prawdziwie . . .	Nauczasz	1	Pres
- Wytłumaczysz .	Wytłumaczysz	1	Fut
Czy dziennikarze powinni się bać ?	powinni	2	Pres
- Wóz się chybnie i zlecą .	zlecą	5	Fut
Komisja oceniła , że Milczanowski i funkcjonariusze urzędu popełnili przestępstwo .	popełnili	8	Past
Chwycił em teczkę i pobiegł em do sekretariatu .	Chwycił	0	Past
Chodź , Hari , podrzucę cię do domu .	podrzucę	4	Fut
Przed wojną jej osobiście nie znał em .	znał	5	Past
Darmosz wymknął się za nimi .	wymknął	1	Past
- Ja też brał em panią pod uwagę .	brał	3	Past
Myję okna , umyła m trzy .	Myję	0	Pres
Podziwiali i doceniali ją też uczniowie .	Podziwiali	0	Past
Wydawcy kłaniają się w pas .	kłaniają	1	Pres
Proszą też o wszelkie informacje , które mogłyby pomóc w odnalezieniu sprawcy .	Proszą	0	Pres
Ponadto dostali śmy kamizelki , za które żaden z nas nie zapłacił .	zapłacił	11	Past
Rosną tutaj , w okolicy , całe sady jarzębinowe .	Rosną	0	Pres
- Mnie już nic nie zdziwi .	zdziwi	5	Fut
- Tym bardziej nie zechcą wypuścić .	zechcą	4	Fut
Dziewięć lat temu rzucił wódkę .	rzucił	3	Past
Naprawdę tego żałuję .	żałuję	2	Pres
- Kriszan , odwieziesz pana na Stare Delhi .	odwieziesz	3	Fut
Wicemistrzynie Polski z Mielca nie dały pograć w Krakowie Wiśle i opuściły ostatnie miejsce w tabeli właśnie na rzecz podopiecznych Lesława Kędryny .	dały	5	Past
Nie ma lekarza , który wszystkim dogodzi .	dogodzi	6	Fut
Potem zagrzmiało , owiał go płomień i stracił przytomność .	zagrzmiało	1	Past
- Rysiek , dam ci ciężarówkę , ale mi nią przywieziesz Nałkowską z Adamowizny i Gojawiczyńską ze Stawiska !	dam	3	Pres
Rezolucja wypowiada się przeciwko istnieniu narodowych sił nuklearnych , ale nie przeciwko samej broni nuklearnej .	wypowiada	1	Pres
Banał wywoła krwawe powstanie ?	wywoła	1	Fut
Bała m się , że już nic mi w życiu nie wyjdzie .	Bała	0	Past
– jeszcze dziesięć godzin wyjeżdżę i zdaję . .	wyjeżdżę	4	Fut
Z czasem przeprowadzą się na Plewiska .	przeprowadzą	2	Fut
Bardzo dobrze zaprezentował się Tomasz Robaczewski .	zaprezentował	2	Past
W nowej stodole założę elektryczność .	założę	3	Fut
Za jego uwolnienie bandyci zażądali 300 tys . euro .	zażądali	4	Past
Westchnienia Ruskina i Prousta trafiają na podatny grunt .	trafiają	4	Pres
Karteczki te złożymy do klasowego skarbca .	złożymy	2	Fut
O szczegóły poprosimy porucznika Achselringa .	poprosimy	2	Fut
Za nic nie zrobię z siebie pajaca .	zrobię	3	Fut
- Bo się pierdolą .	pierdolą	3	Pres
Ich niski status społeczny sprawia , że poza czasem widowisk obrzędowych nie odgrywają oni istotnej roli w lokalnym życiu publicznym .	odgrywają	12	Pres
Mimo tego nie udał się uniknąć wypadków .	udał	3	Past
Zdaniem Marka Markiewicza , polityczną dojrzałość polityk osiąga dopiero po czterdziestce .	osiąga	7	Pres
Bez trudu odnajdziesz ją też w teatrze , powieści , malarstwie .	odnajdziesz	2	Fut
W gościnnym pokoju u Czapków zasiadają często naukowcy .	zasiadają	5	Pres
- Powiedziała Anna .	Powiedziała	1	Past
- 5 dni obradowała w Warszawie konferencja Stowarzyszenia Prawa Międzynarodowego .	obradowała	3	Past
W najbliższym czasie rynek prawdopodobnie ochłonie i dojdzie do korekty .	ochłonie	5	Fut
Auto szybko rusza .	rusza	2	Pres
O tym , czy odejdzie , zadecyduje premier .	zadecyduje	6	Fut
Cieszą się , ze ktoś zdecydował się wyciągnąć do nich pomocną dłoń .	Cieszą	0	Pres
– wyjedzie . .	wyjedzie	1	Fut
A wieś szaleje z radości .	szaleje	2	Pres
Nagle zauważam , że balkon chwieje się i pęka .	chwieje	5	Pres
Kolejne inwentaryzacje dowodzą , że na półkach biblioteki brakuje kolejnych tytułów .	dowodzą	2	Pres
Po wypadku nie przerwał em pracy .	przerwał	3	Past
- Podał mu coś przez okno .	Podał	1	Past
Tutaj jedynie pokrótce opiszemy ten standard i nieco uzupełnimy zaprezentowane w wymienionych artykułach informacje .	opiszemy	3	Fut
Kto się tobie oprzeć zdoła ?	zdoła	4	Fut
Kiedy nadejdzie cyklon ?	nadejdzie	1	Fut
Uważają nas za moskalofilów , takich zaprzańców antyukraińskich , podczas gdy sami deklarują ukraiński patriotyzm .	Uważają	0	Pres
Wziął em Roszka pod pachę i poszli śmy do nas do domu .	poszli	6	Past
Ale nie chciała chodzić , udawała , że nic nie rozumie .	udawała	5	Past
Co uznają śledczy , pokaże czas .	pokaże	4	Fut
Ćwiczy kilka godzin , przez co nie wyrabia się w pracy .	Ćwiczy	0	Pres
Ograniczenie szybkości obowiązuje tutaj od soboty z powodu rutynowych prac konserwatorskich .	obowiązuje	2	Pres
Za najważniejszych nazistowskich zbrodniarzy powszechnie uznawano Hitlera , Himmlera i Goebbelsa .	uznawano	5	Past
- Wykopię ten dół .	Wykopię	1	Fut
A ona nie doczeka się pochwały i może popadać w kolejne frustracje .	doczeka	3	Fut
Wiedźmin biegł za nim , licząc , że potwory rozciągną się w pościgu .	rozciągną	9	Fut
Lekarze zdecydowali się na operację , ale brakowało dawcy .	brakowało	7	Past
Przyjadą VIP-y . . .	Przyjadą	0	Fut
Witam wszystkich klubowiczów ! ! !	Witam	0	Pres
Zaraz wrócę .	wrócę	1	Fut
Listonosz Perez skinął bez słowa głową .	skinął	2	Past
- Zdarzało się , że uderzyłem butnego Niemca z Wehrwolfu , ale tego nie obejmuje akt oskarżenia .	obejmuje	14	Pres
Wszyscy się tłukli .	tłukli	2	Past
Dostojny gość zwiedzi ponadto stolicę , Kraków oraz Gdańsk .	zwiedzi	2	Fut
- Jeśli czegoś nie lubię , nie zrobię tego za żadne pieniądze .	zrobię	7	Fut
- Górą nie sięgną ?	sięgną	3	Fut
Ja się przebiorę .	przebiorę	2	Fut
- Zakłady i instytucje państwowe działają na podstawie decyzji urzędniczych .	działają	5	Pres
Przerażona dziewczyna pobiegła do ciotki , która mieszka za ścianą , i w sekrecie opowiedziała , co robił jej tata .	pobiegła	2	Past
Panowie w cylindrach i w melonikach tkwili bokiem na przednich ławeczkach .	tkwili	6	Past
Bez sprzeciwu zabiera Izaaka na szczyt góry , przywiązuje do ołtarza , podnosi nóż , jest gotów do ciosu .	przywiązuje	8	Pres
Całuje błękitne oczy i wolno wspina się po schodach .	Całuje	0	Pres
– Na pewno ci powie .	powie	4	Fut
Podszedł do aparatu i nakręcił numer .	Podszedł	0	Past
Tańczono zapamiętale , wykrzykując i piosenką dogryzając sobie wzajemnie .	dogryzając	6	Pres
Sprawę wyjaśnimy .	wyjaśnimy	1	Fut
Bydgoszczanin ogłosił w prasie , że poszukuje panienek do pracy w Niemczech .	ogłosił	1	Past
Przyznał em jej raję .	Przyznał	0	Past
- Zdaje się , że oni zamierzają urządzić komedię sądową .	Zdaje	1	Pres
Prasa francuska opublikowała sporo takich zestawień .	opublikowała	2	Past
- Każdy hałas wywołuje lęk .	wywołuje	3	Pres
Potem nagle umilkł i równie nagle wrzasnął .	wrzasnął	6	Past
Tylko powszechne uwłaszczenie obywateli stwarza dla Polaków ostatnią szansę na uzyskanie realnych praw własności .	stwarza	4	Pres
Czy dowiozą ?	dowiozą	1	Fut
Porucznik nie zamierzał wykładać swoich kart , a przynajmniej nie zamierzał robić tego od razu .	zamierzał	10	Past
- Weźmiesz mu szczyptę , jeżeli usnął .	Weźmiesz	1	Fut
Oszołomiony Jerzy rusza ku wyjściu .	rusza	2	Pres
Przygotuje się pan poseł Roman Andrzejewski .	Przygotuje	0	Fut
- Niech się pan skupi na swoich obowiązkach .	skupi	4	Fut
Podwyżka zmniejszy ponoszone przez spółkę straty .	zmniejszy	1	Fut
Oszukasz mnie .	Oszukasz	0	Fut
Starym kawalerem zostanie i następcy zabraknie , tradycja garncarska w rodzinie Kraszewskich zaginie . . .	zabraknie	5	Fut
Gorące spojrzenia towarzyszyły kandydatkom do korony podczas całego rejsu .	towarzyszyły	2	Past
Jak wielu moich rówieśników inaczej swoje życie planował , a inaczej się potoczyło .	planował	7	Past
zaraz się ruszę . .	ruszę	2	Fut
Ale czasza szamocze się , nie ulega .	szamocze	2	Pres
Służyła pewnie do nadawania sygnałów .	Służyła	0	Past
Wspominają wspólne biesiadowanie .	Wspominają	0	Pres
Mieszkańcy grożą , że zablokują ulice .	grożą	1	Pres
- Zaprowadzę pana do krzesła .	Zaprowadzę	1	Fut
Turska przyznała , że jest przerażona , bo nie wyklucza , że nastolatka mogła zarazić inne osoby .	wyklucza	9	Pres
- Panie przodowniku , jak pragnę wolności , to same równe chłopaki .	pragnę	5	Pres
Czujesz bluesa ?	Czujesz	0	Pres
Kukufat szybko opanował zamieszanie , nawołując zgromadzonych do zachowania spokoju .	nawołując	5	Pres
Burza szalała ponad dwie godziny .	szalała	1	Past
Przewaga któregokolwiek układu skurczowego lub niedowład któregokolwiek układu rozkurczowego powoduje skurcz mięśni gładkich oskrzeli .	powoduje	9	Pres
Potępiamy prezydenta Kaczyńskiego za podłość .	Potępiamy	0	Pres
Przedsiębiorcę z Barda niepokoi , że w obrocie gospodarczym brakuje pieniędzy .	niepokoi	3	Pres
Kontrolerzy nie wzięli pogróżek poważnie , bo wiedzieli z doświadczenia , że w podobnej sytuacji prawie każdy podatnik powołuje się na możnego protektora . . .	powołuje	18	Pres
– Ach , mówisz o pomarańczowej !	mówisz	3	Pres
Odwinęła się z fartucha .	Odwinęła	0	Past
Iskierka zgasła , ustępując miejsca podejrzliwości .	ustępując	3	Pres
- Jakie znaczenie dla śledztwa ma odkrycie dokonane w archiwach w Łomży , o którym niedawno poinformowała prof . Daria Nałęcz ?	poinformowała	16	Past
Mentalnie posłali energię miłości .	posłali	1	Past
Czekam na propozycje " .	Czekam	0	Pres
- Ja im pokażę .	pokażę	3	Fut
- Mam konkretną prośbę .	Mam	1	Pres
W 1935 roku brytyjski informatyk Alan Mathison Turing wymyślił abstrakcyjną maszynę .	wymyślił	8	Past
Już na schodach usłyszała dźwięki dobiegające z komnaty dziadka .	usłyszała	3	Past
Może do nas przyjdą .	przyjdą	3	Fut
Czy my żyjemy w jakimś kompletnie dzikim kraju ?	żyjemy	2	Pres
Nie zdążę odebrać huku .	zdążę	1	Fut
Wyszedł po chwili z tej balowej sali , ustawił nas w rzędzie , według instrumentów , skrzypce , altówka , klarnet , trąbka , puzon , perkusja i ja , saksofon .	ustawił	8	Past
Również państwo bardzo się starało , żeby księża wzięli swoje .	starało	4	Past
Angażowały też prywatnych przewoźników .	Angażowały	0	Past
Przestał em marzyć .	Przestał	0	Past
Wybudujecie nową , za co ?	Wybudujecie	0	Fut
- Z tą Martą też nic dobrego nie wyjdzie .	wyjdzie	8	Fut
Takich samochodów nie udostępniają dziennikarzom .	udostępniają	3	Pres
Komisja Europejska traci cierpliwość .	traci	2	Pres
Odczuwa jednak dotkliwie pustkę , brak sensu życia .	Odczuwa	0	Pres
Może zdam się na panów ?	zdam	1	Fut
Zaczerwieniła się , wzgardliwie odymając usta .	odymając	4	Pres
Winko odstawił em , bo mnie do grobu zaprowadzi .	zaprowadzi	8	Fut
Jakieś światła błyszczą z prawej burty .	błyszczą	2	Pres
- dodaje gen. Biel .	dodaje	1	Pres
Jeżeli unosisz ją , wtedy unoszą się także ramiona .	unoszą	5	Pres
Przedtem włóczyli się po mieście , topniał śnieg , szumiało w rynnach , czuć było powiewy ciepła i zgnilizny , nad dachami tłukły się kłębiaste chmury .	tłukły	22	Past
Sami urządzą sobie rzeź .	urządzą	1	Fut
Kontrolę prywatyzacji jednoosobowych spółek Agencji WRSP Izba przeprowadziła na zlecenie sejmowej Komisji Rolnictwa i Rozwoju Wsi .	przeprowadziła	7	Past
Kochał Dorę , ale nie potrafił odejść od Zofii , swej żony .	Kochał	0	Past
Siedzę dziś cały dzień w domu i obiad jemy w domu .	Siedzę	0	Pres
A ogrzewania wyłączyć nie możemy , bo to zaszkodzi świeżo zakonserwowanym freskom w obu synagogach .	zaszkodzi	8	Fut
Następnie Aleksander Zawadzki dokonał otwarcia muzeum w dziesiątym Pawilonie .	dokonał	3	Past
Wszystko opłacę .	opłacę	1	Fut
Ich przedstawiciele , służąc w Gwardii Szlacheckiej , dodawali splendoru Stolicy Piotrowej , a jednocześnie znajdowali tam niejednokrotnie środki dla wygodnego życia , ponieważ za swą służbę otrzymywali pensje .	służąc	3	Pres
Przymykali śmy oko na jego wybryki , ale zaczął przeginać .	Przymykali	0	Past
- Zrezygnowali ?	Zrezygnowali	1	Past
Ale menażer klubu z Mannheim nalegał , aby do transferu doszło już teraz .	nalegał	5	Past
– Teraz pan tu rozkazuje ?	rozkazuje	4	Pres
Pamiętajmy jednak , że nasza złość i niecierpliwość tylko pogorszą i tak niełatwą sytuację .	pogorszą	9	Fut
Szofer niecierpliwił się przy załadowanej ciężarówce .	niecierpliwił	1	Past
Właśnie zakończył się trzeci , diecezjalny etap konkursu .	zakończył	1	Past
Może list ten obudzi odpowiedzialnych , a wtedy mieszkańcy na pewno ochoczo zabiorą się do upiększania swego osiedla .	zabiorą	12	Fut
– Jednej rzeczy nie pojmuję .	pojmuję	4	Pres
Powołanie Semaka wzburzyło pracowników opolskiej rozgłośni .	wzburzyło	2	Past
I montujemy z tego dziewięćdziesięciominutowy program .	montujemy	1	Pres
Przypomnijmy , że na budowę centrum hurtowego nie zgadzają się mieszkańcy Osowej .	zgadzają	8	Pres
Gagosian nadal milczał , siedząc za biurkiem na swój sztywny sposób .	siedząc	4	Pres
Uroiła sobie , że lekarze chcą ją zabić .	Uroiła	0	Past
Czy nasze indywidualne cele pokrywają się z celem grupy jako całości ?	pokrywają	4	Pres
- Ja ci się pośmieję ! "	pośmieję	4	Fut
Najpierw myślał em , że śnię .	śnię	5	Pres
- Przypuszczam .	Przypuszczam	1	Pres
Na pewno zrobisz to lepiej ode mnie .	zrobisz	2	Fut
Wybili szybę w drzwiach wejściowych sklepu betonowym krawężnikiem .	Wybili	0	Past
Zgadzam sie z Tobą . . .	Zgadzam	0	Pres
CZY MUSZĘ ? ! ! ! ! !	MUSZĘ	1	Pres
Wiem , co zrobię .	zrobię	3	Fut
Kula spustoszy głowę , rozszarpie mózg .	spustoszy	1	Fut
Rozłożył dłonie .	Rozłożył	0	Past
Surowo zwracam panu na to uwagę w tej chwili .	zwracam	1	Pres
Stamtąd widać cały Sybir .	widać	1	Pres
Sławomir często zastanawia się nad nazwiskami .	zastanawia	2	Pres
Popatrzyła z niedowierzaniem na mój kciuk .	Popatrzyła	0	Past
Trafił do Tary , ale zgodnie z umową nadal miano przyjeżdżać po jego krew .	miano	9	Past
Wybrała TVN .	Wybrała	0	Past
Kierowca zbiegł .	zbiegł	1	Past
Wiele projektował em , sporo podróżował em .	projektował	1	Past
Sąd lub organ umorzy postępowanie .	umorzy	3	Fut
Nasze wzruszenie i jej się udzieliło .	udzieliło	5	Past
Później zabroniono podawać podroby .	zabroniono	1	Past
- Jeśli nikt nie zgłupieje , skończy się na strachu .	zgłupieje	4	Fut
- Wygląda na to , że piłka nożna seniorów w Występie przestanie istnieć .	przestanie	11	Fut
Zaprosimy cię na otwarcie , przysięgam .	Zaprosimy	0	Fut
No kto , na przykład , zbudował radziecką bombę atomową ?	zbudował	6	Past
Przewrócił się w hotelowym hallu łamiąc żebra .	łamiąc	5	Pres
Liczył em na to , że przyjdziecie z tym do mnie .	przyjdziecie	6	Fut
Sama je wymyślam .	wymyślam	2	Pres
Woziła m cię w wózku po bazie i myślała m , że oszaleję .	oszaleję	12	Fut
On interpretuje prawo na swój sposób .	interpretuje	1	Pres
Mentalnie posłali energię miłości .	posłali	1	Past
– nic nie zrobisz .	zrobisz	3	Fut
Oczy powlekła biaława szklistość , co wzmogło tajemnicę spojrzenia .	powlekła	1	Past
Zaczekasz na nas czy pójdziemy razem ?	pójdziemy	4	Fut
Sprowadzę cię po schodach .	Sprowadzę	0	Fut
Zahamował i wychylił się .	wychylił	2	Past
Poklepał chłopca po ramieniu .	Poklepał	0	Past
Dalej za płotem ciągnął się sad .	ciągnął	3	Past
Walkom rewolucyjnym towarzyszyły klęski rosyjskie na Dalekim Wschodzie w wojnie z Japonią .	towarzyszyły	2	Past
Potem zagrzmiało , owiał go płomień i stracił przytomność .	owiał	3	Past
Zamki przemycała kobieta handlująca na bazarze Różyckiego w Warszawie .	przemycała	1	Past
- Powtarzam , że jajecznicy pan tam nie dostanie .	dostanie	8	Fut
- Pogodzimy się .	Pogodzimy	1	Fut
Inny facet postanowił , że postawi stację z gazem do samochodów przy ul. Warszawskiej .	postawi	5	Fut
Machała m mu fartuchem , żeby lądował na łące pod lasem , ale ten chłopak chyba się przestraszył , że zawadzi o druty .	zawadzi	20	Fut
- Komu zwracasz uwagę ?	zwracasz	2	Pres
Kto pierwszy wstaje od stołu ?	wstaje	2	Pres
Daję dzieciom wiele swobody w naszym domku pod Warszawą .	Daję	0	Pres
- Może lepiej nam się poszczęści .	poszczęści	5	Fut
Napastnicy grozili nastolatkom , że ich pobiją .	pobiją	6	Fut
Rozmażesz sobie makijaż .	Rozmażesz	0	Fut
Odeszli , choć mogli zapytać o to i owo w samym Betlejem .	mogli	3	Past
– wsunę się ci pod twoje nogi . .	wsunę	1	Fut
Stoją wszędzie na tarasie , w ogrodzie , przy oknach .	Stoją	0	Pres
- Czy różnice interesów w koalicji nie przeszkodzą w kontynuowaniu reform ?	przeszkodzą	7	Fut
– Wyglądasz staro .	Wyglądasz	1	Pres
No , może powtórzysz to jeszcze raz !	powtórzysz	3	Fut
Pakowali się dalej , nie reagując .	reagując	5	Pres
Pewnie nastanie już spokój wokoło .	nastanie	1	Fut
Znajdziemy inny symbol .	Znajdziemy	0	Fut
Skąd wiedział , kiedy przyjedzie ?	przyjedzie	4	Fut
Może jakoś dogada się jeszcze z tym głupim bydlakiem .	dogada	2	Fut
Poszukiwała go policja z Gostynia za kilka innych przestępstw .	Poszukiwała	0	Past
wszystkich pozwalniali . .	pozwalniali	1	Past
Roszczenia , jak się zakłada , były by załatwiane w trybie administracyjnym .	zakłada	4	Pres
Jako nieletni odbył karę w poprawczaku .	odbył	2	Past
- Zabrali nam Młodego .	Zabrali	1	Past
O drugie miejsce zawzięcie walczyły reprezentacja Belgradu oraz Alita Alytus .	walczyły	4	Past
Umyte brokuły dzielimy na cząstki i układamy w naczyniu .	dzielimy	2	Pres
Mój widok bardzo zaskoczył LPR-owskiego działacza .	zaskoczył	3	Past
Ich odrobienie przekraczało siły jednego pokolenia .	przekraczało	2	Past
- Przez 40 lat płaciliśmy składki na służbę zdrowia , a teraz , kiedy jej na-prawdę potrzebujemy , wypinają się na nas .	potrzebujemy	16	Pres
- Liczne przykłady coraz bardziej wyrafinowanych działań terrorystycznych na świecie uświadamiają społeczeństwu potrzebę ochrony przed tego typu zagrożeniami .	uświadamiają	10	Pres
W Unii Europejskiej budżet opracowuje się raz na 7 lat .	opracowuje	4	Pres
Czy sądzisz , że teraz , po tych wszystkich latach , rzucę dom , dzieci i pójdę za tobą ?	pójdę	16	Fut
Nie odzywając się przez cały czas do siebie , dojechali śmy do Wisły .	odzywając	1	Pres
I cała wspólnota modli się za niego .	modli	3	Pres
Stryjna przyjechała i mieszkanie wypełniło się jej obecnością .	wypełniło	4	Past
Zobaczy pan .	Zobaczy	0	Fut
Długo oczekiwana wiosna przyjdzie do nas już jutro !	przyjdzie	3	Fut
Pokażemy w najbliższym czasie .	Pokażemy	0	Fut
Ukończyła tylko drugą klasę podstawówki .	Ukończyła	0	Past
„ Kiedy dojdzie do procesu Reinefahrta ” ?	dojdzie	2	Fut
Nie lubiły tylko pijaków , szczekały , kiedy opierali się o płot .	lubiły	1	Past
Dziadek szybko przeżegnał się .	przeżegnał	2	Past
Nim przekroczy granice raju , musi wyrazić skruchę .	przekroczy	1	Fut
Może chłopiec zasłucha się i zaśnie ? . . .	zaśnie	5	Fut
Odsuwa się daleko .	Odsuwa	0	Pres
Spostrzegł , że opuściła głowę i zaciskała poruszające się nerwowo usta .	opuściła	3	Past
Zeszła z głównej alejki i skręciła w sieć bocznych dróżek .	skręciła	5	Past
Drżeli i bledli , z ust oratorów dobywał się bełkot .	Drżeli	0	Past
W hotelu pozostanie intendent , mały pochylony , skromny człowiek .	pozostanie	2	Fut
Groził , że się podpali .	podpali	4	Fut
Czy pieniędzy zabraknie dla wszystkich potrzebujących ?	zabraknie	2	Fut
Mock podniósł się i nakrył głowę .	nakrył	4	Past
A żona się gniewa , bardzo się gniewa . . .	gniewa	3	Pres
I nagle zrywa się , zachłystując radosnym gwarem .	zachłystując	5	Pres
Gdy rozległ się krzyk , Guilielmo zakryl twarz rękami .	zakryl	6	Past
Bronił eksmitowanych na bruk , naprawiając błędy przyjętej przez koalicję SLD­PSL ustawy , grzmiał na globalistów i świeżych krajowych , drapieżnych kapitalistów .	naprawiając	5	Pres
Niech że mnie wysadzą ! "	wysadzą	3	Fut
W tych pierwszych związkach nastolatki doświadczają smaku ludzkiej miłości , odkrywają siłę fascynacji i wzajemnego przyciągania siebie .	odkrywają	10	Pres
Strefy za parę lat zdechną śmiercią naturalną .	zdechną	4	Fut
Nasze piłkarki w grupie zmierzą się z Niemcami , Szwecją i Szwajcarią .	zmierzą	4	Fut
Ziuta uściskała go i ucałowała w oba policzki .	ucałowała	4	Past
Don Esteban krzyknął .	krzyknął	2	Past
Pytała ś , jak zarabiam ?	Pytała	0	Past
Serena zamruczała coś przez sen i rozłożyła się na mojej połowie .	zamruczała	1	Past
- Słyszę , iż nie śpisz jeszcze .	Słyszę	1	Pres
Po raz kolejny wystąpił pan niezgodnie z regulaminem .	wystąpił	3	Past
Gdy Cahirowi czupryna nieco mocniej przyschnie do czerepu , powędrujemy ku Toussaint .	przyschnie	5	Fut
Winien em je opieczętować .	Winien	0	Pres
Kto zdejmie ?	zdejmie	1	Fut
Niezadługo nadjedzie .	nadjedzie	1	Fut
Dziś zgromadzili śmy się tu , zwabieni staropolską gościnnością twoją , ażeby uczcić dzień twego imienia .	zgromadzili	1	Past
Za pomaganie funkcjonariuszom MO Konstanty odpowie teraz przed sądem .	odpowie	5	Fut
Podniosła głowę .	Podniosła	0	Past
Osobiście poznała m swojego zaciekłego wroga .	poznała	1	Past
Przygotujemy wszystko i wtedy napijemy się maty .	napijemy	4	Fut
– przebierze się za aniołka . .	przebierze	1	Fut
Patrzył na nich nieufnie .	Patrzył	0	Past
w głębi duszy tłumisz pragnienie ucieczki od samej siebie .	tłumisz	3	Pres
Nadszedł normalny , szary dzień po dniu .	Nadszedł	0	Past
Inne stolemy wyniosły się dawno do zamorskich krajów i ludzie przestali się już bać , że padną ofiarą ich psot .	padną	16	Fut
Wierzę panu na słowo .	Wierzę	0	Pres
Zobaczymy , co zwiozą nam do młodni .	Zobaczymy	0	Fut
A jemu nie wierzą .	wierzą	3	Pres
Już teraz wielu rzeczom podołamy .	podołamy	4	Fut
Spróbuję teraz uzasadnić swoje stanowisko .	Spróbuję	0	Fut
Lecz myszy popłynęły za nim , dopadły go na wieży i zagryzły .	popłynęły	2	Past
Inflacja rośnie .	rośnie	1	Pres
Wolała by wszywkę .	Wolała	0	Past
Wtedy nikt nas nie zauważy .	zauważy	4	Fut
" Obywatelu Bukowiński , proponujemy wam repatriację do Polskiej Republiki Ludowej " .	proponujemy	4	Pres
Pozwolisz , że pójdę na balkon ?	Pozwolisz	0	Fut
Wywiozą nas do Polski !	Wywiozą	0	Fut
Kwity wykłada sympatyczny i kulturalny pan po pięćdziesiątce .	wykłada	1	Pres
Kupili jakieś zmiotki w ruskiej hurtowni i zbijają na mnie kasę .	zbijają	7	Pres
Ustawa o radiofonii i telewizji niebawem stanie się obowiązującym prawem .	stanie	6	Fut
I działa biją .	biją	2	Pres
Co odpowie na to dominikanin ?	odpowie	1	Pres
Sasza przystanął .	przystanął	1	Past
Za chwilę kardynałowie i biskupi wyniosą obraz Matki Bożej Jasnogórskiej na ołtarz przed kościołem .	wyniosą	5	Fut
- Będziemy udawali , że śpimy .	śpimy	5	Pres
- Przejdzie , nie warto się przejmować .	Przejdzie	1	Fut
Frajer odjedzie .	odjedzie	1	Fut
Już Pitagorejczycy znali podobno wszystkie najbardziej regularne wielościany nazywane foremnymi .	znali	2	Past
Ponosi się i wyrzuca .	Ponosi	0	Fut
Zamyka oczy , jakoś tak dziwnie sapie .	sapie	6	Pres
Lopez odchrząknął .	odchrząknął	1	Past
Wszyscy klaskali .	klaskali	1	Past
I zrozumieli ludzie , że tu Bóg był , i zburzyli ten sądowy dom , aby w nim nikt już więcej po Panu Jezusie nie sądził , a przed jabłonnymi drzewami postawili krzyż i on do dziś tam stoi .	sądził	25	Past
Większość skradziono w Berlinie , Hamburgu , Kilonii i Bremie .	skradziono	1	Past
Spekulowano nawet , że odejdzie z partii wraz z Jurkiem .	odejdzie	4	Fut
– Odłożył słuchawkę .	Odłożył	1	Past
Czemu kogut głośno pieje ?	pieje	3	Pres
- Jest pytanie , natomiast tu się odbywa demonstracja z tej strony . . .	odbywa	7	Pres
Ułoży się most , star przejedzie , kratownice wrócą na miejsce , zatrzemy ślady i poczekamy .	Ułoży	0	Pres
Może nad ranem wróci do hali i spróbuje wydostać się przez okno .	wróci	3	Fut
- Opublikował em te dokumenty z pełną świadomością .	Opublikował	1	Past
- Dzieci , co mówicie .	mówicie	4	Pres
Nieźle tam zarabia , ale niejednokrotnie chwali się drogimi rzeczami kupionymi za pieniądze , które syn tego pana zostawia na utrzymanie ojca .	chwali	6	Pres
- Wystarczą gumowe .	Wystarczą	1	Fut
Kruk krukowi oka nie wykole .	wykole	4	Fut
Szlocha , jest załamana .	Szlocha	0	Pres
Czasem cisnę spust , a ten diabeł uprze się i nie wystrzeli .	uprze	7	Fut
- Spodziewał em się , że tak odpowiesz , Sarai !	odpowiesz	7	Fut
Siedział ponury na przedzie tramwaju , pod plastykowym dachem .	Siedział	0	Past
Wszystko rozegra się w zaciszu ministerialnych gabinetów .	rozegra	1	Fut
Nie pobudziła m .	pobudziła	1	Past
Daje poczucie wspólnoty , gromadzi ludzi z podobnymi problemami , którzy zaczynają stanowić dla siebie grupę wsparcia .	Daje	0	Pres
Debren udał , że nie zrozumiał .	udał	1	Past
Jak realizowano budżet ?	realizowano	1	Past
- No zobaczysz .	zobaczysz	2	Fut
Jedna osoba zginęła , trzy zostały ranne .	zginęła	2	Past
Kula spustoszy głowę , rozszarpie mózg .	rozszarpie	4	Fut
Płeć piękna zwycięża !	zwycięża	2	Pres
Zakończy się w piątek .	Zakończy	0	Fut
Spostrzegł , że opuściła głowę i zaciskała poruszające się nerwowo usta .	zaciskała	6	Past
Mieszka pod Warszawą , a w swoim pięciohektarowym gospodarstwie , oprócz dwudziestu psów , hoduje także konie i kozy .	hoduje	14	Pres
- Widzę , że pan niezbyt się przejął tą zbrodnią .	przejął	7	Past
A ja nie umiem z tym sobie kompletnie poradzić , dlaczego on mi to robi ?	umiem	3	Pres
Są chętne , jak Lilka .	Są	0	Pres
- Wczoraj się mył em .	mył	3	Past
- Ale już niedługo zniknie .	zniknie	4	Fut
Policjant zaświecił lizakiem .	zaświecił	1	Past
Ale taka większość powstanie .	powstanie	3	Fut
I nie usłyszy , bo inżynier nie powtarza zarzutów .	powtarza	7	Pres
Stefan nieraz nadkładał drogi po pracy , by popatrzyć , jak rośnie ich dom .	rośnie	11	Pres
Robię się czerwony i zeskakuję z okna .	zeskakuję	4	Pres
Siedzimy naprzeciw siebie , pijemy herbatę , jemy piernik domowego wypieku .	Siedzimy	0	Pres
- Może razem jechać , weźmiemy motor ?	weźmiemy	5	Fut
- Pojebało cię ? !	Pojebało	1	Past
Dziś stąd wyruszamy , może jeszcze zdążę ucałować jego stygnącą rękę .	zdążę	6	Fut
Sprzedaż monti i stanowisk nie pokrywała chronicznego deficytu .	pokrywała	5	Past
TWARDZIEL 1 pokazuje legitymację służb specjalnych .	pokazuje	2	Pres
Pokrzepiła mnie tym na duchu .	Pokrzepiła	0	Past
- Popłynę . . .	Popłynę	1	Fut
Kaczka bez brata nikogo nie ugryzie w łydkę .	ugryzie	5	Fut
- Jak często występujecie przed publicznością ?	występujecie	3	Pres
Kolejny pijany policjant straci pracę .	straci	3	Fut
Współczesne trendy cywilizacyjne sprzyjają siłom zła , lecz dobro nie odpuszcza .	odpuszcza	10	Pres
Tym razem postawiono na casting także w mniejszych miastach .	postawiono	2	Past
Ale na wasze żądanie zatrzymam go .	zatrzymam	4	Fut
Mogli by w nich uczestniczyć kandydaci Unii Wolności oraz Wałęsa i Olszewski , jeśli tylko zechcą i będą mieli poparcie 15 parlamentarzystów i 300 radnych .	zechcą	15	Fut
Wojewoda doda jej dla splendoru nieszczupły taborek .	doda	1	Fut
Rozrywka jest kołem zamachowym telefonii komórkowej , a MMS bardzo ją uatrakcyjnią .	uatrakcyjnią	11	Fut
- Podczas tych rozmów tak mi się dłuży , że nieraz trzy razy przysnę .	przysnę	13	Pres
Potem opłukała naczynia i ustawiła na drucianej kratce , by obeschły .	obeschły	10	Past
Wyjaśnia on w przystępny sposób tajniki stosowanych w programie konwencji .	Wyjaśnia	0	Pres
Pokiwał na to głową .	Pokiwał	0	Past
Jeśli nie zatrąbisz , ośmieszysz nas .	ośmieszysz	4	Fut
Rozpaczliwie próbował em coś wyjaśnić , nie licząc na sukces .	licząc	7	Pres
Chyba dam radę .	dam	1	Fut
- Za godzinę zjawi się u państwa moja sekundantka .	zjawi	3	Fut
Kto wiatr sieje , ten burzę zbiera .	sieje	2	Pres
może wpadnę do Gumy po pieróg .	wpadnę	1	Fut
Ja już się załapał em na to pokolenie .	załapał	3	Past
Prawdopodobnie zapuścił się dalej .	zapuścił	1	Past
Zachęcany , aby również w czasie Wielkiego Tygodnia zrezygnować z oglądania telewizji .	Zachęcany	0	Pres
Za punktualność , komfort podróżowania , czy czystość przystanków będzie dbał MZKZG .	dbał	10	Past
Trudne warunki pozwolą co najwyżej wymyśleć cieplejszy korzuch .	pozwolą	2	Fut
– już się nie zastanawiają .	zastanawiają	4	Pres
Apfelbaum szedł przed siebie , nie zwracając na niego uwagi .	zwracając	6	Pres
Przypuszcza , że uczył się nowych słów .	Przypuszcza	0	Pres
Ten futszak wszedł do jej domu .	wszedł	2	Past
- Postaram się .	Postaram	1	Fut
Mamy pomysły , których panu nie zdradzę .	zdradzę	6	Fut
Myślała m , że odkryła m to w tym tygodniu !	Myślała	0	Past
Przyzwoitość każe szanować gości i ja właśnie w ten elegancki sposób uszanuję Jagodowe wakacje .	uszanuję	11	Fut
Ja sama zaniosę .	zaniosę	2	Fut
Nerwy ludziom puszczają , często dochodzi do utarczek słownych .	dochodzi	5	Pres
Mimo że na koncie ma już osiem wyroków , nadal okrada turystów odwiedzających Kraków .	okrada	10	Pres
W niedzielę 7 czerwca o godz . 17 Odra podejmuje Inę , a Mieszko o tej samej godzinie u siebie gra z Dąbrovią .	podejmuje	9	Pres
Zatopieni w pełnym kontakcie , przestali śmy zauważać resztę świata .	przestali	5	Past
Krew ciągle płynęła mu z nosa .	płynęła	2	Past
Niech mama zaraz napisze .	napisze	3	Fut
Czasem cisnę spust , a ten diabeł uprze się i nie wystrzeli .	wystrzeli	11	Fut
Co uznają śledczy , pokaże czas .	uznają	1	Fut
Starczy tego rzępolenia , łajzy !	Starczy	0	Fut
A ja odciągnę ich od ciebie .	odciągnę	2	Fut
Znakomicie lokalizuje miejsca , w których kryją się szkodniki .	lokalizuje	1	Pres
Nakazał też wypłatę wynagrodzenia , które by otrzymywały , gdyby świadczyły pracę w poradni .	otrzymywały	7	Past
Zdarzenie z kamykiem nie wychodziło mu z głowy .	wychodziło	4	Past
To pewnie porwana Angielka , cieszyły się polskie media .	cieszyły	5	Past
- Ja każdemu poradzę .	poradzę	3	Fut
Ma Pan trzy córki , czy podtrzymują one rodzinną tradycję ?	podtrzymują	6	Pres
Może w styczniu zaproszę cię na chrzciny .	zaproszę	3	Fut
Żonę ma w Stanach Zjednoczonych , dorosłym dzieciom powodzi się dobrze .	powodzi	8	Fut
- I nie pokaże się więcej w naszym domu .	pokaże	3	Fut
Demokracja nie gwarantuje sukcesu i nawet nie gwarantuje sama siebie .	gwarantuje	2	Pres
Po zakończeniu kariery Perry rok w rok komentował Wimbledon .	komentował	7	Past
- Pokręciła głową .	Pokręciła	1	Past
Na maszynce syczała woda do zmywania , radio grało .	syczała	2	Past
Na nim konie tańczą .	tańczą	3	Pres
- Do stryja pojadę .	pojadę	3	Fut
Pozostaje Maciej Płażyński .	Pozostaje	0	Pres
I panna Wanda zaledwie rzuciła na nie okiem .	rzuciła	4	Past
Później Dąbrowska podobno się na mnie obraziła , bo porównał em ją gdzieś z Orzeszkową .	obraziła	6	Past
Jeśli resort zaakceptuje programy , będzie je finansować .	zaakceptuje	2	Fut
Wczoraj ciśnienie wynosiło ponad 1000 hektopaskali .	wynosiło	2	Past
Skoro pogrąża się w rozpaczy i gniewie .	pogrąża	1	Pres
Ucieszy się , że ktoś kradnie jej książki .	Ucieszy	0	Fut
Wzrost gospodarczy się utrzymuje .	utrzymuje	3	Pres
Do minionej środy takie pismo do starostwa w Bytowie nie nadeszło .	nadeszło	10	Past
Potem mnie to znudziło .	znudziło	3	Past
Ale ujęli sporo .	ujęli	1	Past
Bardzo tego żałuję .	żałuję	2	Pres
W końcu przyznał się do winy .	przyznał	2	Past
Odpowiedział eś posługując się sztandarowym obok Białorusi argumentem .	posługując	2	Pres
JAK ONE TO ROBIĄ ?	ROBIĄ	3	Pres
Ja otworzę . . . "	otworzę	1	Fut
Czym w końcu różnią się tak naprawdę republikanie od demokratów ?	różnią	3	Pres
Który nie dostarczył zboża na przemiał , będzie odpowiadał .	dostarczył	2	Past
Opublikowano też felieton pułkownika Bosaka .	Opublikowano	0	Past
Zażerała się orzechami w czekoladzie i kasztanami mrożonymi , oblizując swoim obyczajem czubki palców .	oblizując	9	Pres
Wśród trzech pozostałych młodych rysi śledzonych telemetrycznie , które osiedliły się w Puszczy Białowieskiej , były dwie samice .	osiedliły	9	Past
- Może spotkasz swojego starego znajomego , Szmidta .	spotkasz	2	Fut
Nieruchomo stojąc w powietrzu nad kwiatami lecimy .	stojąc	1	Pres
Do przyczyn nawet nie sięgną !	sięgną	4	Fut
Co wolisz ?	wolisz	1	Pres
Commercial Union od 1991 roku działa również na rynku naszych ubezpieczeń życiowych .	działa	5	Pres
Dziękuję , Panie Inspektorze .	Dziękuję	0	Pres
- A gdzie wy garnki trzymacie ?	trzymacie	5	Pres
- Knujecie !	Knujecie	1	Pres
Chaos bezdźwięczny pokrył wreszcie harmonię .	pokrył	2	Past
W Polsce borówka rośnie na 100 hektarach .	rośnie	3	Pres
Dlatego ceni się sumienność , odpowiedzialność , perspektywiczne myślenie .	ceni	1	Pres
Napadła ś na Kucyka , a to jest ich człowiek w terenie i nie dadzą go ruszyć .	dadzą	14	Fut
I szedł em przez te stygnące odchody coraz bardziej markotny , a przygnębienia przybywało mi z każdym krokiem .	przybywało	13	Past
Zgłosiły się trzy panie .	Zgłosiły	0	Past
Dopiero waląc ramieniem o ziemię , poczuł strach .	waląc	1	Pres
Od pierwszej chwili , kiedy Cię ujrzała m w drzwiach , była m już tylko kobietą .	ujrzała	6	Past
- Wcale nie zwariowaliśmy , tylko uważamy , że z taką nogą spacerować nie możesz .	uważamy	6	Pres
W pokoju na górce położyła chłopca w swoim łóżku i zeszła na dół .	zeszła	10	Past
Gdyby śmy wobec tych przeciwności zareagowali negatywnym myśleniem lub działaniem , pomnożymy tylko złe siły , a te zrealizują się w naszym życiu .	pomnożymy	11	Fut
Poproszę pana senatora Józefa Kuczyńskiego .	Poproszę	0	Fut
Umiera w swoim ogrodzie .	Umiera	0	Pres
Po chwili znaleźli się w podziemiach domu .	znaleźli	2	Past
ruszę się .	ruszę	0	Fut
Podwyżka zmniejszy ponoszone przez spółkę straty .	zmniejszy	1	Pres
- Tam napijemy się kawy .	napijemy	2	Fut
Może tego doczekają .	doczekają	2	Fut
Bawiąc się chwastami swojej simlah Manahem mrużył coraz podstępniej oczy .	Bawiąc	0	Pres
We własnym pokoju rzuciła się na łóżko i prędko zasnęła .	rzuciła	3	Past
Przedtem zdam maturę .	zdam	1	Fut
Obrazy cyfrowe składają się z połączonych ze sobą pikseli o różnych barwach lub tonach .	składają	2	Pres
– pójdę do Jędrzeja .	pójdę	1	Fut
NIK podkreśla , że w czasie prywatyzacji AWRSP następowało pogorszenie sytuacji ekonomicznej Polski .	podkreśla	1	Pres
Spod wody wyłaniały się nowe kontynenty .	wyłaniały	2	Past
Zwycięskie drużyny otrzymają nagrody pieniężne .	otrzymają	2	Fut
Myślisz , że ktoś na coś czeka , a on już uciekł . . .	Myślisz	0	Pres
Odsuwa miskę po chwili .	Odsuwa	0	Pres
– za dwadzieścia minut się zbieram . .	zbieram	5	Pres
Zaraz wydam dyspozycje .	wydam	1	Fut
Gdyby śmy wobec tych przeciwności zareagowali negatywnym myśleniem lub działaniem , pomnożymy tylko złe siły , a te zrealizują się w naszym życiu .	zrealizują	18	Fut
- Skaczesz , rozglądasz się i wracasz .	Skaczesz	1	Pres
Urodę stołu znakomicie podniosą antyczne lichtarze ze świecami , kryształy i srebra .	podniosą	3	Fut
Mnie nie przekona , nie dotknę kolczyków .	dotknę	5	Fut
Chętnie nawiążę znajomość z taką osobą .	nawiążę	1	Fut
Wsunąwszy ją w ramy , położył na niej obrazek i zaczął skrupulatnie wbijać ćwieczki .	położył	5	Past
Przez uczony wywód autorki przewijają się dzieła współczesnych filozofów , od Ricoeura po Levinasa .	przewijają	4	Pres
- Ale wybieramy .	wybieramy	2	Pres
Ale góry się nie poddawały .	poddawały	4	Past
- Meneli naszło się z całego osiedla .	naszło	2	Past
Czemu godzę się na tortury pod obojętnym światłem wielkiej lampy ?	godzę	1	Pres
Włączamy telewizor .	Włączamy	0	Pres
Czasami przypali zupę , czasami stłucze talerz z pomidorówką .	przypali	1	Fut
Starem z przyczepą załadowaną piaskiem kierował kursant .	kierował	5	Past
- Jeszcze przyniosą mięso .	przyniosą	2	Fut
Najcudowniejsze cnoty staną się wadami , jeśli w nich zabraknie ufności .	staną	2	Fut
Nosze wysłali śmy grzecznie kożuchem .	wysłali	1	Past
Uroczystość wręczenia nagrody urozmaicił koncert orkiestry Filharmonii Koszalińskiej .	urozmaicił	3	Past
Zobaczył Dunaja .	Zobaczył	0	Past
Zauważył em , że po raz pierwszy powieki nie zakrywały jego źrenić , żółtych i okrągłych .	zakrywały	9	Past
Zresztą francuzica niepotrzebnie wylicza kunsztowne potrawy , bo generał lubi tylko prostą kuchnię .	wylicza	3	Pres
I zjechawszy na kolana gorzko zapłakał zapominając , że patrzą na niego ludzie .	zapłakał	5	Past
Zabijecie je .	Zabijecie	0	Fut
– czterdzieści pięć minut starczy . .	starczy	4	Fut
Umożliwiają one niestosowanie się do niektórych znaków drogowych .	Umożliwiają	0	Pres
Ale Moja Wdowa uważała , że zupy te czynią żołądek gładkim i młodym .	uważała	3	Past
Niech zstąpi Duch Twój !	zstąpi	1	Fut
Solenizantki złożyły życzenia sąsiadującym z nimi w kalendarzu Ernestom i Bożenom .	złożyły	1	Past
Czy zdąży ?	zdąży	1	Fut
Następnie podgrzewamy i przesączamy przez gęste sito .	przesączamy	3	Pres
Radny Krzysztof Krzeszowski wylicza podobne przypadki także w innych szkołach .	wylicza	3	Pres
I kamera pokazuje go w panterce , na froncie w Bośni .	pokazuje	2	Pres
- Tyle nie wytrzymam .	wytrzymam	3	Fut
- Naszym kolegom wciąż się zdaje , że wygrali . . .	zdaje	5	Pres
Czy nikt nie zagrozi złodziejowi .	zagrozi	3	Fut
Dlaczego mrozimy mięso ?	mrozimy	1	Pres
- Bywa , że czuję się w teatrze obco .	Bywa	1	Pres
– to się w niej rozwinie . .	rozwinie	5	Fut
Potem się wywietrzy .	wywietrzy	2	Pres
Na koniec zacieramy ślady .	zacieramy	2	Pres
Niech pani posłucha .	posłucha	2	Fut
Mogł em szczęście dać .	Mogł	0	Past
- Jemu nie sprzedam .	sprzedam	3	Fut
Obie części składamy podszewką do środka , zszywamy po brzegach , obszywamy lamówką .	obszywamy	11	Pres
Od tygodnia wieś huczy od plotek i domysłów .	huczy	3	Pres
Bogu zawierzam i w Bogu pokładam nadzieję .	zawierzam	1	Pres
Nie odzywa się nikt .	odzywa	1	Pres
Przebrzmiała już wiadomość zaczęła powracać , jakby m cofał taśmę magnetofonową i wysłuchiwał fatalnego technicznie nagrania .	wysłuchiwał	12	Past
Wypowiadamy je w różnych sytuacjach i z różnych powodów .	Wypowiadamy	0	Pres
Po zetknięciu z ziemią maszyna wybuchła , a siła eksplozji wyrzuciła dwóch słowackich mechaników i Marka Panasia .	wyrzuciła	10	Past
Czy my wszyscy zasługujemy na życie w państwie rządzonym przez państwa Kaczyńskich ?	zasługujemy	3	Pres
- Zatrzymaj się , bo strzelę !	strzelę	5	Fut
Mniejsze rosły jeszcze w doniczkach .	rosły	1	Past
Miś Holender przysłał mu czerwone anemony i hiacynty na ostatek .	przysłał	2	Past
– Ile pan zarabia ?	zarabia	3	Pres
Sierpcem nie interesuje się zupełnie przemysł terenowy .	interesuje	2	Pres
Nadążacie , Towarzysze ?	Nadążacie	0	Pres
Takiemu psiakowi nie umknie zapewne żaden zapach .	umknie	3	Fut
I poślemy cię do takiego miejsca , z którego się nie wychodzi .	poślemy	1	Pres
Stało się .	Stało	0	Past
Byli w wielu innych związkach , które się jednak rozsypały .	Byli	0	Past
Przygotujemy wszystko i wtedy napijemy się maty .	Przygotujemy	0	Fut
Po piętnastu minutach nadchodzi .	nadchodzi	3	Pres
- Nasi urzędnicy przyjrzą się drodze .	przyjrzą	3	Fut
otworzę kanały elektryczne i niech wlezie tam . .	wlezie	5	Fut
Często śniło się jej , że biegnie za oderwaną ręką i nie może jej dogonić .	śniło	1	Past
Wydawało się , że wojna jednak go przerosła , przeraziła .	przerosła	7	Past
Buduję , mając zaufanie w Bogu i mając miłość do ludzi .	Buduję	0	Pres
Oj , słyszą .	słyszą	2	Pres
- Chcemy odsprzedać te wałachy .	Chcemy	1	Pres
Wtedy wyciąga zawieruszony w pomiętej pościeli telefon komórkowy , by wszystkie je po kolei załatwić .	wyciąga	1	Pres
Izrael zagroził wczoraj , że wkroczy zbrojnie na tereny Autonomii , jeśli Arafat nie zapanuje nad terrorem .	zapanuje	14	Fut
Odeszli , choć mogli zapytać o to i owo w samym Betlejem .	Odeszli	0	Past
Przeżył em już rzeczy znacznie gorsze .	Przeżył	0	Past
Może się okazać , że zbyt surowo oceniasz siebie .	oceniasz	7	Pres
Koło się zamyka .	zamyka	2	Pres
Tu latają cyklony , podejdą wyżej , będzie wiało od wyżu .	podejdą	4	Fut
Ręce mu drżały , gdy podnosił szklankę .	podnosił	5	Past
Macie ten kalendarz przy sobie ?	Macie	0	Pres
Biznesmena Roku wybierano na Pomorzu już po raz szósty .	wybierano	2	Past
- Jeżeli ćwiczący źle dobiorą rakiety , piloci nie zniszczą przeciwnika .	dobiorą	4	Fut
Robią tu pamiątkowe zdjęcia i kupują drobiazgi .	Robią	0	Pres
" Zrobimy " !	Zrobimy	1	Pres
Lecz tu znów wyjaśniło się , że poleci z nimi doktor Pnin .	poleci	7	Fut
Nie zostaniesz tutaj .	zostaniesz	1	Fut
Konsjerżka , jak większość konsjerżek Portugalka , szorowała chodnik i mury ryżową szczotką .	szorowała	7	Past
W domu wspomniała o studniówce przy niedzielnym obiedzie .	wspomniała	2	Past
Czyli płaci się za to , żeby nic nie robili .	płaci	1	Pres
- Daj , podpiszę .	podpiszę	3	Fut
Pograć sobie od czasu do czasu nikomu nie zaszkodzi .	zaszkodzi	8	Fut
Co mu odpowiesz , królowo ?	odpowiesz	2	Fut
- Nie kradnę , nie sprzedaję narkotyków i nie morduję za pieniądze .	morduję	9	Pres
Darowizny przekazane na jej rzecz podlegają odpisowi podatkowemu .	podlegają	5	Pres
Oznacza to , że odbierze każde przychodzące wywołanie .	odbierze	4	Pres
Nie zapomnę tego pierwszego dnia .	zapomnę	1	Fut
Dwa samochody zderzyły się dachami .	zderzyły	2	Past
Sprawą zainteresował się referat I-szy i przez kontrolę korespondencji może uzyskamy dalsze miejsca zachowanych rzeczy .	uzyskamy	10	Fut
Ulice zajmą pojazdy napędzane siłą ludzkich mięśni .	zajmą	1	Fut
Słuchaj , co ci rzeknie herold !	rzeknie	4	Fut
Ona unikała jego spojrzenia .	unikała	1	Past
Kadencja rady potrwa do 2007 r.	potrwa	2	Fut
Co innego zaprzątało jej już główkę .	zaprzątało	2	Past
Popełniasz błąd .	Popełniasz	0	Pres
Tamta urodziła dziecko z wielkim okiem pośrodku czoła .	urodziła	1	Past
A tak nazywały się serwowane tam alkohole .	nazywały	2	Past
- Czy zatrzymają pana strefy ochronne wokół siedzib władzy ?	zatrzymają	2	Fut
Od 1993 r . jest kierownikiem Zakładu Współczesnych Teorii Ekonomicznych , a od 1999 r . pełni funkcję dziekana Wydziału Ekonomiczno - Socjologicznego Uniwersytetu Łódzkiego .	pełni	16	Pres
Rozglądam się i nie wierzę własnym oczom .	Rozglądam	0	Pres
– chłopaki zaśpiewają jakąś ckliwą melodię . .	zaśpiewają	2	Fut
Rada Ludowa próbowała przeciwstawiać się takim krokom .	próbowała	2	Past
Niech to diabli wezmą .	wezmą	3	Fut
Siostra szorowała i myła ręce .	myła	3	Past
Łamią się piersi , trzeszczy kość , próchnieją dłonie , twarze bledną . . .	bledną	11	Pres
Starym kawalerem zostanie i następcy zabraknie , tradycja garncarska w rodzinie Kraszewskich zaginie . . .	zaginie	12	Fut
Okazało się , że obaj już wcześniej usiłowali wyłudzać pieniądze i buty .	usiłowali	7	Past
W roku 1912 Olga w związku z kolejną przygotowującą się pod jej nieobecność wystawą zasięgnęła rady Sainsèrea przy wyborze obrazów .	zasięgnęła	14	Past
Zdecydują o tym rady krajowe SLD i Unii Pracy oraz Rada Naczelna PSL .	Zdecydują	0	Fut
Policjanci pojechali do domu ucznia i odkryli , że granat pochodzi z kolekcji tatusia .	odkryli	6	Past
Na wschodzie majaczą szczyty Tynioka , Ganczerki , a tam dalej , już niewidoczna , bardziej na północ , jest Barania .	majaczą	2	Pres
Myślał em , że mi się bom zerwie z talii !	zerwie	7	Fut
Wozili się trochę po mieście .	Wozili	0	Past
Rodzina jej uważała , że urodzenie nieślubnego dziecka okryje ich hańbą .	okryje	8	Fut
- Ty mnie wcale nie słuchasz !	słuchasz	5	Pres
Izrael zagroził wczoraj , że wkroczy zbrojnie na tereny Autonomii , jeśli Arafat nie zapanuje nad terrorem .	wkroczy	5	Fut
Lech Kaczyński nie żałuje , że jego filmowa kariera się nie rozwinęła , a do swojego aktorskiego talentu podchodzi z rezerwą .	żałuje	3	Pres
Pan konsul obiecał , że poruszy natychmiast tę sprawę z attaché wojskowym , generałem brygady .	obiecał	2	Past
Pracuję w dziale płac .	Pracuję	0	Pres
Resztę dopowiedzą polityczni konkurenci .	dopowiedzą	1	Fut
Jakaś staruszka dreptała z dzbanem po wodę .	dreptała	2	Past
Przekonamy się .	Przekonamy	0	Fut
Ale nie pozbędziemy się problemu .	pozbędziemy	2	Fut
Ale czy się uda ?	uda	3	Fut
Kierowca wrzuca wsteczny i na pełnym gazie taranuje pieszych .	taranuje	7	Pres
Ucierpi niezawisłość sędziowska ?	Ucierpi	0	Fut
– też tak sobie tłumaczę . .	tłumaczę	4	Pres
Obserwuję je drżąc .	Obserwuję	0	Pres
Artyści poprowadzą biesiadę śląsko - bawarską .	poprowadzą	1	Fut
– Po co go tu przysłali ?	przysłali	5	Past
on otwiera oczy i się śmieje .	śmieje	5	Pres
— Ależ on umrze !	umrze	3	Fut
Chyba przyznasz , że przyjemniej obcuje się z osobami myślącymi i sympatycznymi .	przyznasz	1	Fut
Zabrali mi prywatność , nawet moje łóżko stało się własnością państwa .	Zabrali	0	Past
Nie masz czym jechać !	masz	1	Pres
Podczas poprzedniej wojny dowodził własnym batalionem i , jak zapewniał , miał jeńców na tuziny .	zapewniał	9	Past
Jakoś do tej pory obywamy się bez tego .	obywamy	4	Pres
- Nie powtarzaj mi tego , bo jeszcze zmienię zdanie .	zmienię	8	Fut
Serio , taki gówniarz i prymityw przemówił wtedy we mnie .	przemówił	6	Past
Grób Petuli zdobi wrzos .	zdobi	2	Pres
Monopoliści nakręcą inflację .	nakręcą	1	Fut
Przekonamy się wkrótce .	Przekonamy	0	Fut
- Rysiek , dam ci ciężarówkę , ale mi nią przywieziesz Nałkowską z Adamowizny i Gojawiczyńską ze Stawiska !	przywieziesz	10	Pres
Czasem cisnę spust , a ten diabeł uprze się i nie wystrzeli .	cisnę	1	Fut
Pomogę mu .	Pomogę	0	Fut
I cała wspólnota modli się za niego .	modli	3	Pres
Mam nadzieję , że Was zainteresuje .	zainteresuje	5	Pres
Ale niestety wyobraźnia działa i już powoli wyobrażała m sobie siebie z wózkiem za 9 miesięcy . .	działa	3	Pres
- Zrobimy pana landrata na szosie w podgórskim pejzażu .	Zrobimy	1	Fut
Z Bronkiem niedawno rozmawiał przez telefon .	rozmawiał	3	Past
Tej czynności również towarzyszyły modlitwy i obrzędy .	towarzyszyły	3	Past
Raport podkreśla , że w wielu krajach najpoważniejszym problemem jest wysokie bezrobocie .	podkreśla	1	Pres
Nie przeszkadza im to uczestniczyć we mszy świętej .	przeszkadza	1	Pres
Ludzie giną i ludzie zwyciężają .	zwyciężają	4	Pres
Mariusz Walter zadebiutował jako reżyser już w latach 60 . , szybko związał się z telewizją publiczną , w której pracował aż do lat 80 .	zadebiutował	2	Past
Rabi Eleazar ben Cwi nie szemrze .	szemrze	5	Pres
Ogromnie interesowało ich , co z tych zabiegów wyniknie .	wyniknie	8	Fut
ja mu zrobię sweter na niespodziankę . .	zrobię	2	Fut
Trzech sprytnych chłopców szukało nawet syrenki w przedszkolnym akwarium .	szukało	3	Past
Kaczka bez brata nikogo nie ugryzie w łydkę .	ugryzie	5	Fut
- Przyrzekniesz mi coś , Hunt .	Przyrzekniesz	1	Fut
Zrobiono to poza moimi plecami .	Zrobiono	0	Past
Kto pierwszy dotrze do skarbu ? !	dotrze	2	Fut
Nigdy nie wykroczył poza zasady wiary chrześcijańskiej .	wykroczył	2	Past
- Wierzę .	Wierzę	1	Pres
Przypomnę sobie podczas podróży .	Przypomnę	0	Fut
- Zabraniam ci !	Zabraniam	1	Pres
- Będziemy udawali , że śpimy .	udawali	2	Past
Zaproponowali , że przerobią telefon tak , by można było z niego bezpłatnie rozmawiać .	przerobią	3	Fut
Śmiał się wesoło , nacisnął dziewuszce nos , a ona obruszyła się , grożąc palcem .	Śmiał	0	Past
Pragnę nadmienić , że nie wszystkie marzenia i oczekiwania wywołują sny odwrotne .	Pragnę	0	Pres
Niech pan pomyśli , jaką rodzice mieli by niespodziankę , gdyby pan ukończył siedem klas .	pomyśli	2	Fut
- Przyrzekniesz mi .	Przyrzekniesz	1	Fut
Kuba , zbliż no się do mnie , niech cię pocałuję .	pocałuję	10	Fut
W Małej Komorzy z tego powodu zapaliły się sadze .	zapaliły	6	Past
- A trafisz ?	trafisz	2	Fut
Wessie je mózg , wątroba , rurką pępowiny popłyną do Poli .	Wessie	0	Fut
Już bał em się , że Francuzi oddadzą to Japończykom .	oddadzą	7	Fut
Żelezik rzuca mi spłoszone spojrzenie .	rzuca	1	Pres
Przed awanturą natomiast wszyscy Zarządowi patrzyli na ręce , zarzucając mu niekompetencję i prywatę .	patrzyli	5	Past
Ciało znalazło nareszcie dla siebie miejsce .	znalazło	1	Past
Prawdopodobnie dopiero w sobotę zdradzi swoje zamiary .	zdradzi	4	Fut
Rządowy projekt chroni dzieci i młodzież .	chroni	2	Pres
Celnikom wyjaśniła , że muszlę kupiła w Acapulco za 20 dolarów .	kupiła	5	Past
Jeśli jest , jak przypuszczam , Niemcy mocno się rozczarują .	przypuszczam	4	Pres
Mock przytulił się do hrabiny i objął jej kruche ramiona .	objął	6	Past
Odbyło się taksowanie .	Odbyło	0	Past
Zaatakował chłopak .	Zaatakował	0	Past
Gdzież ja tyle zarobię .	zarobię	3	Fut
Naraz przystanęli , bo zdawało się im , że słychać czyjeś kroki .	przystanęli	1	Past
Dzwonią do drzwi niespokojnie , nerwowo .	Dzwonią	0	Pres
- Nie powtarzaj mi tego , bo jeszcze zmienię zdanie .	zmienię	8	Pres
Polska gospodarka od 1994 r . wykazuje wysokie tempo wzrostu .	wykazuje	6	Pres
Z ogromną prędkością przejechały przez nie dwa samochody osobowe .	przejechały	3	Past
- Gdzie przed nocą przybiję .	przybiję	4	Fut
PPP jest głęboko patriotyczna i tego się nie wstydzimy .	wstydzimy	8	Pres
Wielka katastrofa przestawiła ludzki umysł na wyższe obroty .	przestawiła	2	Past
Po chwili wracają .	wracają	2	Pres
Józinek ochłonie , sprzątnie , przeprosimy się .	ochłonie	1	Fut
W tym roku Ministerstwo Zdrowia wykreśliło z nich osiemnaście leków .	wykreśliło	5	Past
Wkrótce będziesz w dużo lepszej kondycji .	będziesz	1	Fut
Dla uczczenia tego zdarzenia przynoszę filiżanki .	przynoszę	4	Pres
Ty nigdy więcej takiego czegoś nie zrobisz .	zrobisz	6	Fut
