Do GROM-u dotarło ośmiu .	dotarło	2	Neut
Sputnik zawirował po raz ostatni , zatrzymał się i zgasł .	zgasł	9	Masc
A więc chroniła i tuliła .	tuliła	4	Fem
Wydawało się , że wojna jednak go przerosła , przeraziła .	przeraziła	9	Fem
– wtedy hamulce zapowietrzyły się . .	zapowietrzyły	3	Masc
Mówił , że jesteś naszym najlepszym klientem .	Mówił	0	Masc
Było już późno i ciemno .	Było	0	Neut
Wówczas koła łowieckie będą dbały , aby populacja nie rozrastała się ponad dopuszczalną .	rozrastała	9	Fem
Chwycił walizkę i pędem dopadł drzwi wyjściowych .	Chwycił	0	Masc
Nie poruszyła m się .	poruszyła	1	Fem
Skóra wokół poczerwieniała , a w kącikach ust pojawił się grymas skrywanego bólu .	pojawił	8	Masc
Woły stąpały ospale , skrzypiały jarzma .	skrzypiały	4	Neut
Mnie ta muzyka nie przeszkadza , już się przyzwyczaiła m .	przyzwyczaiła	8	Fem
Czyżby tam zabrnął Barski ?	zabrnął	2	Masc
U sześciu pozostałych kandydatów dopatrzyła się nieprawidłowości .	dopatrzyła	4	Fem
W różnych krajach Europy Joint zachęcał do tworzenia miejscowych organizacji , zdolnych do samodzielnej pracy z sierotami .	zachęcał	5	Masc
Gdy goście opuścili jego dom i pozostał jedynie 63-letni emeryt , doszło między nimi do sprzeczki .	doszło	11	Neut
Zmuś ziemię , by wykarmiła swoje nędzne dzieci .	wykarmiła	4	Fem
Wszystko wskazywało na to , że jednak tak nie było , ale należało to dokładnie sprawdzić .	należało	12	Neut
Co zrobili śmy komu ? . . .	zrobili	1	Masc
Koło urządziło również podczas wakacji obóz wędrowny po Pomorzu .	urządziło	1	Neut
Znów zapachniało celą .	zapachniało	1	Neut
Tej czynności również towarzyszyły modlitwy i obrzędy .	towarzyszyły	3	Fem
Wilhelm wygrzebywał brud zza paznokci .	wygrzebywał	1	Masc
Za krótka kołdra pokazywała jak nigdzie swoją małpią złośliwość .	pokazywała	3	Fem
Księgowe potwierdziły , że działały w porozumieniu z kilkoma członkami spółdzielni .	potwierdziły	1	Fem
- Nie wiem , co się stało .	stało	6	Neut
Odłożył je z żalem .	Odłożył	0	Masc
Przyjechała na wakacje .	Przyjechała	0	Fem
Wymykała mu się , a potem znów przyciskała do niego .	Wymykała	0	Fem
Wróciła dwucyfrowa inflacja .	Wróciła	0	Fem
W styczniu kredytowy ruch jeszcze się zwiększył .	zwiększył	6	Masc
Dali ście zły przykład , sprowokowali ście do grzechu !	Dali	0	Masc
- Spodziewał em się , że tak odpowiesz , Sarai !	Spodziewał	1	Masc
Wrócił em do domu .	Wrócił	0	Masc
Państwu Kłosom to nowe mieszkanie bardzo się podobało .	podobało	7	Neut
- Mogło ci się wydawać .	Mogło	1	Neut
Na piersi pyszniła się wspaniała biało - amarantowa kokarda .	pyszniła	2	Fem
Sam wiem , że nieraz różnie bywało .	bywało	6	Neut
Podwórko pachniało cytrusami .	pachniało	1	Neut
Piękne dziewczyny zelektryzowały kierowców tirów .	zelektryzowały	2	Fem
Do minionej środy takie pismo do starostwa w Bytowie nie nadeszło .	nadeszło	10	Neut
Janka bez słowa wkładała już białe sandałki , sięgnęła po torebkę .	wkładała	3	Fem
Mocno uścisnął em mu rękę , on przedłużył uścisk .	przedłużył	7	Masc
Miliony ludzi straciło oszczędności całego życia .	straciło	2	Neut
– Wycelowała kluczami w koronkową bieliznę .	Wycelowała	1	Fem
Czyżby oni wszyscy ulegli zbiorowej halucynacji , skoro po powrocie z kina mówią , że im się podobało ?	podobało	17	Neut
Na czas akcji z kamienicy ewakuowano 10 osób , które nad ranem wróciły do swoich mieszkań .	wróciły	12	Fem
Kia sephia , którą kierował 67-letni Henryk M . , nie zatrzymała się przed przejściem i potrąciła staruszkę .	potrąciła	16	Fem
Część z nich wyjechała z nagrodami .	wyjechała	3	Fem
Znalazł się generał !	Znalazł	0	Masc
Starcia zaczęły się koło południa .	zaczęły	1	Neut
Zamiast niego do celi pomaszerował jego brat .	pomaszerował	4	Masc
W Gnieźnie w sylwestrowy wieczór zginęli podczas pożaru trzej chłopcy , a jadący do akcji samochód strażacki wpadł na dwie kobiety .	zginęli	5	Masc
Razem ze mną miał być przyjęty inny kandydat , który jednak w ostatniej chwili zrezygnował .	zrezygnował	14	Masc
- Nie zabrzmiało to ani zachęcająco , ani entuzjastycznie .	zabrzmiało	2	Neut
Pod jej nosem błyszczał pot , musiała biec , widocznie firma pilnująca mieszkania nie zawiadomiła jej o wyłączeniu alarmu .	zawiadomiła	14	Fem
Podniosła m oczy znad talerzyka z malinami , posypanymi cukrem .	Podniosła	0	Fem
Cierpliwie wycisnął numer .	wycisnął	1	Masc
I na moment zatkało mnie .	zatkało	3	Neut
Pocałowała mnie w czoło i wyszła , zanim zdążył em coś powiedzieć .	Pocałowała	0	Fem
Wypełniła ją bez reszty .	Wypełniła	0	Fem
Papieros sparzył mi palce , rzucił em go w śnieg .	sparzył	1	Masc
Prezydent Bush zapewniał w środowym przemówieniu telewizyjnym , że siły koalicji będą maksymalnie oszczędzały ludność cywilną .	oszczędzały	13	Fem
Widziała m , jak cichaczem wrócił eś .	wrócił	5	Masc
- Przez chwilę odpędzała natarczywą złą myśl , ale ta zła myśl wracała .	wracała	12	Fem
Nie miała ochoty wracać do domu .	miała	1	Fem
Pod pismem do władz gminy podpisało się ponad 50 osób .	podpisało	5	Neut
Zastygła m z lekko przechylonym dzbankiem .	Zastygła	0	Fem
Sporo osób po moim kierunku pracowało później w bankach , ministerstwach , również w sejmie .	pracowało	5	Neut
Do tego NBP dał mu jeszcze pamiątkową monetę .	dał	3	Masc
Poza tym tych delikatnych wzorów nie zalewała minia i lakier .	zalewała	6	Fem
Miało to dobre strony , gdyż rodziło rzeczywisty consensus , czyli zgodę .	Miało	0	Neut
Odpalił to makro , nawet nie wychodząc z trybu edycji .	Odpalił	0	Masc
stówę się dawało i był pełny zbiornik .	dawało	2	Neut
Poczuła swą kobiecość i było z tym cudownie .	Poczuła	0	Fem
Około 300 eksponatów reprezentowało osiągnięcia 40 twórców .	reprezentowało	3	Neut
Poznań jest właściwie jedynym większym miastem na terenie naszego kraju , na które spoglądały oczy wielkiego poety .	spoglądały	13	Neut
Znowu tańczyli śmy blisko siebie .	tańczyli	1	Masc
Oglądała niedawno coś takiego na TVP Kultura .	Oglądała	0	Fem
Wchodziło się tam przez francuskie kwatery .	Wchodziło	0	Neut
Czyżby teraz przepuściła okazję , mając tuż obok przystojnego młodego mężczyznę ?	przepuściła	2	Fem
Na Siemiradzkiego wybrzydzali krytycy , ale publiczność uwielbiała jego obrazy .	uwielbiała	7	Fem
Potem opłukała naczynia i ustawiła na drucianej kratce , by obeschły .	ustawiła	4	Fem
Słuchali z zażenowaniem .	Słuchali	0	Masc
Kola parsknął śmiechem .	parsknął	1	Masc
Chyba mnie jeszcze zaprosisz , bo mi leczo bardzo smakowało ?	smakowało	9	Neut
Zaczerwieniła się , wzgardliwie odymając usta .	Zaczerwieniła	0	Fem
Politycy opozycji poinformowali również , że zamierzają złożyć do Trybunału Konstytucyjnego wniosek w sprawie niekonstytucyjności ustawy o ABW i AW .	poinformowali	2	Masc
- To nam pozwoliło przetrwać ostatnią epokę lodową .	pozwoliło	3	Neut
- Było za późno .	Było	1	Neut
Znów się zawahała , ale nie miała przecież nic do ukrycia .	zawahała	2	Fem
Stało się coś ?	Stało	0	Neut
Twoje słowa trafiły na podatny grunt .	trafiły	2	Neut
Powstało z komitetów na rzecz referendum w sprawie karania za aborcję .	Powstało	0	Neut
Z pism Slazskiej Energetiki wynika , że opalana węglem nowa elektrociepłownia w Trzyńcu będzie spełniała wszystkie europejskie normy ekologiczne .	spełniała	14	Fem
Ostatecznie zapłacił em .	zapłacił	1	Masc
- Biegał po domu , obszukiwał szafy .	Biegał	1	Masc
Głos nikł i stawał się coraz cichszy .	nikł	1	Masc
Wówczas koła łowieckie będą dbały , aby populacja nie rozrastała się ponad dopuszczalną .	dbały	4	Neut
Odeszli , choć mogli zapytać o to i owo w samym Betlejem .	mogli	3	Masc
Rozładował ją na brzegu , a ona cisnęła naboje do wody .	cisnęła	7	Fem
W jej twarzy , mokrej od łez rozmazanych i czerwonej , tężały w osłupieniu szkliste , bladoniebieskie oczy .	tężały	11	Neut
Odbyło się taksowanie .	Odbyło	0	Neut
W weekend na zachodnich przejściach granicznych trwały wzmożone kontrole .	trwały	6	Fem
Zmarł w swoim namiocie .	Zmarł	0	Masc
Bała się .	Bała	0	Fem
Potem podniosł em rękę .	podniosł	1	Masc
Jak ta Mirta miała wszystko uporządkowane i przemyślane !	miała	3	Fem
Do zdarzenia doszło o godz . 6 . 30 czasu polskiego .	doszło	2	Neut
Chłopcy zrobili swoje .	zrobili	1	Masc
We wtorek posłowie przyszli po te informacje .	przyszli	3	Masc
Nad placem przeleciały myśliwce naddźwiękowe .	przeleciały	2	Masc
Sprawa już trafiła do sądu .	trafiła	2	Fem
Mieli przymierzać im te drewniane serce .	Mieli	0	Masc
Zrobiło mi się przyjemnie .	Zrobiło	0	Neut
Napisałaby więc z pewnością o Bali , co się stało w Kucie , tuż przy głównym deptaku .	stało	9	Neut
Z jednej strony umówił em się z państwem dziennikarzami , że zakończymy o godzinie 17 .	umówił	3	Masc
Urzędniczka przysunęła mi telefon mimo tych niedołężnych wyjaśnień .	przysunęła	1	Fem
Idiotka Zuzia zapomniała zrobić w banku blokadę i całą forsę zajęli na długi .	zapomniała	2	Fem
Podniosła m się .	Podniosła	0	Fem
- Mogło by się tak komuś wydawać .	Mogło	1	Neut
Popatrzyła z niedowierzaniem na mój kciuk .	Popatrzyła	0	Fem
Małe szare oczka wpatrywały się we mnie drwiąco , wyraźnie triumfowała .	wpatrywały	3	Neut
Udział zgłosiło ponad 200 osób z Polski i zagranicy .	zgłosiło	1	Neut
Echo zadzwoniło we wnętrzu złomobusu .	zadzwoniło	1	Neut
Ocean wtargnął w głąb lądu i nie odpłynął cały , tworząc jeziora rozmiaru mórz , bo głęboka płyta litosferycznego płaszcza Kwinty uległa zgnieceniu , a wody zapełniły powstałe na powierzchni depresje .	zapełniły	26	Fem
Związany z kapistami , wielokrotnie jednak przekraczał wyznaczone przez nich malarskie granice .	przekraczał	6	Masc
Mógł by mnie przecież pocałować , wcale by m się nie broniła .	broniła	11	Fem
Ekspertyza potwierdziła podpalenie .	potwierdziła	1	Fem
Do zdarzenia doszło na dość oblodzonej ulicy .	doszło	2	Neut
Jerzyk szepnął mi .	szepnął	1	Masc
– i teraz podpisywała ś ?	podpisywała	3	Fem
Nie nalegał .	nalegał	1	Masc
Tymczasem nasi reporterzy odnajdują mężczyznę , na którego wezwanie zareagowali nocą policjanci .	zareagowali	9	Masc
Rzecznik australijskiego koncernu Chris Codrington wyraził przekonanie , że przyczyną zatrucia wód Cisy nie był cyjanek .	wyraził	5	Masc
Większość ulic niemal tonęła w wodzie .	tonęła	3	Fem
Stała pusta , niszczała , groziła zawaleniem .	niszczała	3	Fem
Zwierzenia Ani poruszyły mnie do głębi .	poruszyły	2	Neut
Wybzykał , wraca do domu .	Wybzykał	0	Masc
Bóg go wysłuchał , wróciła szczęśliwie .	wróciła	4	Fem
RPO interweniował w sprawie zwolnienia inwalidów z tych opłat już w 1993 r .	interweniował	1	Masc
Wańkowicze wrośli już w tutejszy teren i próbowali się utrzymać .	próbowali	7	Masc
– Mock zapalił i rozsiadł się w fotelu .	rozsiadł	4	Masc
Ogień trzaskał w ciszy , dzieci wybiegły na dwór przestraszone .	wybiegły	6	Neut
Czyżby umarła ? . . .	umarła	1	Fem
Tablica z nazwą ronda też przepadła .	przepadła	5	Fem
W pierwszej kolejności będzie służyła ponad 400 uczniom szkoły podstawowej i gimnazjum .	służyła	4	Fem
Do 1939 miasto leżało po niemieckiej stronie granicy .	leżało	3	Neut
pomogło mi to . .	pomogło	0	Neut
Pięć osób ocalało .	ocalało	2	Neut
W szklarniach pozostało ich jeszcze sporo .	pozostało	2	Neut
Nagle z ciemności wyłoniło się trzech mężczyzn kryjących twarze pod kominiarkami .	wyłoniło	3	Neut
Jak wielu moich rówieśników inaczej swoje życie planował , a inaczej się potoczyło .	potoczyło	12	Neut
Kręciło się tu kilku żołnierzy i dwóch sanitariuszy , nie było lekarza .	Kręciło	0	Neut
Zimą bywało , że nie jadła tygodniami .	bywało	1	Neut
Wolski szybko przeczytał meldunek .	przeczytał	2	Masc
Spojrzała , czarne oczka złośliwie mignęły , znikła .	znikła	7	Fem
Nogi narciarza drżały z wysiłku .	drżały	2	Fem
Wcześniej Gracen stanowczo zaprzeczała , że utrzymywała intymne kontakty z prezydentem .	zaprzeczała	3	Fem
Skąd się wzięło Halloween ?	wzięło	2	Neut
Poszukiwania przy użyciu śmigłowca trwały całą niedzielę .	trwały	4	Neut
Adam wspaniale tańczył , okazywał Edycie dużo zainteresowania .	tańczył	2	Masc
Wczoraj kolegium Instytutu usiłowało wyłonić nowego kandydata na prezesa .	usiłowało	3	Neut
Jego oczy przestraszone , rozbiegane cofnęły się jeszcze bardziej .	cofnęły	5	Neut
Irena odeszła z innym , tak to wyglądało bardzo powierzchownie .	wyglądało	7	Neut
Ożenił się , a jego żona nienawidziła NY .	nienawidziła	6	Fem
Królowa uśmiechnęła się .	uśmiechnęła	1	Fem
Zwierzę polubiło piwko i bez kufla nie daje się wydoić .	polubiło	1	Neut
Poparzeniu uległy także drogi oddechowe .	uległy	1	Fem
I wtedy mnie obskoczyli .	obskoczyli	3	Masc
I wtedy obok stołu coś szurnęło .	szurnęło	5	Neut
Trochę mnie zatkało i zastanowiło , czy on czasami nie jest aktualny obecnie ?	zatkało	2	Neut
Kradli telefony komórkowe , sprzęt komputerowy i inne cenne przedmioty .	Kradli	0	Masc
Ktoś wyrwał sztachetę z płotu .	wyrwał	1	Masc
Ten facet naprawdę oszalał .	oszalał	3	Masc
Upragnioną miłość zanurzył eś w najpodlejszym , cuchnącym bagnie .	zanurzył	2	Masc
Składem do Kołobrzegu pojechało 150 dzieci .	pojechało	3	Neut
- Życie ci obrzydło ? !	obrzydło	3	Neut
Wytoczyła też proces redakcji pisma .	Wytoczyła	0	Fem
Później były aresztowania brzeskie i w listopadzie wybory parlamentarne w atmosferze terroru , które dały BBWR większość w nowym Sejmie .	dały	14	Neut
Mieszkańcy miasta mówią , że od 20 lat rzeka nie miała tak wysokiego poziomu .	miała	10	Fem
Komtur nachylił się niżej i słuchał .	nachylił	1	Masc
Zobaczyła , że ukrył twarz w dłoniach .	Zobaczyła	0	Fem
W przedziale zapadło milczenie .	zapadło	2	Neut
Konsjerżka , jak większość konsjerżek Portugalka , szorowała chodnik i mury ryżową szczotką .	szorowała	7	Fem
– Zwierzęta skinęły głowami .	skinęły	2	Neut
Złoty instrument sprezentowało mu bractwo kurkowe .	sprezentowało	2	Neut
Otworzyła szerzej drzwi wpuszczając wszystkich do środka .	Otworzyła	0	Fem
Jeszcze wam się nie znudziło ?	znudziło	4	Neut
Lekarze zdecydowali się na operację , ale brakowało dawcy .	brakowało	7	Neut
On pisał odę do Matki - Syberii .	pisał	1	Masc
Ciało znalazło nareszcie dla siebie miejsce .	znalazło	1	Neut
Będzie kierował on towarzystwem do 2007 roku .	kierował	1	Masc
Jadzia wolała by , żeby za bardzo nie oddalały się od siebie i żeby Dominika tak nie latała .	latała	17	Fem
Szopka przeniosła się do sądu .	przeniosła	1	Fem
Selekcjoner Jerzy Engel rozdał pamiątkowe monety , wybite z okazji zbliżających się mistrzostw świata .	rozdał	3	Masc
- Chyba ci odbiło . . .	odbiło	3	Neut
Usiadł na łóżku i schował twarz w dłoniach .	Usiadł	0	Masc
Cały Babel na to patrzył !	patrzył	4	Masc
Ledwo widać drogę , u Gontarczyków całe okno zawiało .	zawiało	8	Neut
Spotkanie w urzędzie wywarło na wszystkich jego uczestnikach niesamowite wrażenie .	wywarło	3	Neut
Obie spółki ustaliły identyczne ceny .	ustaliły	2	Fem
Tymczasem słońce podniosło się wyżej .	podniosło	2	Neut
Ogień szedł przed Tobą i pożerał nieprzyjaciół .	pożerał	5	Masc
Zatkało go .	Zatkało	0	Neut
Siedział odchylony za swoim biurkiem z taką miną , jakby dowodził całą policją , Interpolem i FBI na dodatek i delektował się kawą .	delektował	20	Masc
Dokonało tego dwóch młodzieńców .	Dokonało	0	Neut
Wypił go i otarł usta ręką .	otarł	3	Masc
- Uprzedził em cię .	Uprzedził	1	Masc
Czyżby muzyka w nim nie wzbierała , nie domagała się ujścia ?	wzbierała	5	Fem
W 1972 r. wraz z kolegami wpadł podczas rozlepiania ulotek na mieście .	wpadł	6	Masc
Uderzył w ścianę .	Uderzył	0	Masc
Kręciła m wtedy film .	Kręciła	0	Fem
Chodziło o unieszkodliwienie całej bandy .	Chodziło	0	Neut
Było ciemno , płonęły znicze .	płonęły	3	Masc
Po zajęciu miejscowości Krzyżacy zmasakrowali miejscową ludność .	zmasakrowali	4	Masc
- Jajo przywiózł do nas osobiście dyrektor płockiego zoo .	przywiózł	2	Masc
Sądej zdziwił się .	zdziwił	1	Masc
Miała wydatki .	Miała	0	Fem
Śniło mi się , że zapomniała m , jak wyglądasz .	zapomniała	5	Fem
Dobiegł do pierwszych drzew i zniknął w gęstwinie .	Dobiegł	0	Masc
Ich odrobienie przekraczało siły jednego pokolenia .	przekraczało	2	Neut
Przez 26 lat pracował w Komendzie Rejonowej Policji w Jarosławiu .	pracował	3	Masc
Wyłączyła komputer i podeszła do lustra .	Wyłączyła	0	Fem
Połączyły siły .	Połączyły	0	Fem
Pani Jadwiga trzynaście lat temu kupiła w Arciechowie działkę ze starym domostwem .	kupiła	5	Fem
Lufki wysunęły się z większości oczu , ustalając osobę chichotu .	wysunęły	1	Fem
Kobieta , bez uprzedzenia , nie przyszła wczoraj do pracy , a w mieszkaniu świeciło się światło .	świeciło	14	Neut
Funkcjonariusze policji przypuszczają , że ofiara zasnęła .	zasnęła	6	Fem
W jego koszyku znalazło się aż 125 dorodnych prawdziwków .	znalazło	3	Neut
Auto z czterema młodymi mężczyznami wpadło do Wisły .	wpadło	5	Neut
Margit również przykucnęła i wybierała zwierzątka .	wybierała	4	Fem
Nie pomyślał em o tym , że nie był on przytwierdzony do postumentu , zdejmowano go przecież rokrocznie .	pomyślał	1	Masc
Niewytłumaczalna zbrodnia wstrząsnęła Polską .	wstrząsnęła	2	Fem
Prawdopodobnie w toalecie przestępcy zaopatrzyli się w granaty i pistolet .	zaopatrzyli	4	Masc
Głowa zastanowiła się chwilę .	zastanowiła	1	Fem
Na torze pod Kielcami odbyty się pierwsze wyścigi samochodowe .	odbyty	4	Masc
Skupieni operatorzy delikatnie manipulowali skomplikowanymi urządzeniami odbioru przekazywanej informacji .	manipulowali	3	Masc
Co by się stało , gdyby m nie uciekł z Wilna ?	stało	3	Neut
Niosła się w obłoku , zakurzona .	Niosła	0	Fem
– Upokorzył em go .	Upokorzył	1	Masc
Karolcia zaczerwieniła się i nic nie odpowiedziała .	odpowiedziała	6	Fem
Kobieta zaufała oszustowi i podała numery z 28 kart .	zaufała	1	Fem
Wydawało mu się , że od niego coś pękło mu w sercu .	pękło	8	Neut
Po decyzji parlamentu zawiesiły działalność polityczną Batasuny .	zawiesiły	3	Fem
Do tej pory wyjechało już ponad 100 dzieci .	wyjechało	3	Neut
Wasielewski wyprowadził wóz z parkingu i włączył się do ruchu .	wyprowadził	1	Masc
Ale kłamstwa się wydały .	wydały	3	Neut
Wydawało się , że fiskus nie będzie dłużej gnębił Waldemara Gronowskiego , legnickiego piekarza , który przez ponad 10 lat rozdawał pieczywo najuboższym .	rozdawał	20	Masc
Ta osobista tragedia odcisnęła swe piętno na jego usposobieniu .	odcisnęła	3	Fem
Czy macierzyństwo bardzo odmieniło Twoje życie ?	odmieniło	3	Neut
Szumiał wiatr w gołych gałęziach drzew .	Szumiał	0	Masc
Kilkunastu nie wstało .	wstało	2	Neut
Trochę mnie zatkało i zastanowiło , czy on czasami nie jest aktualny obecnie ?	zastanowiło	4	Neut
- Marysette umilkła .	umilkła	2	Fem
Został em Żydem .	Został	0	Masc
Oddychał prędko , dławiła go flegma .	dławiła	3	Fem
Ręką wskazał mi fotel .	wskazał	1	Masc
W zeszłym tygodniu , świadczeniobiorcy otrzymali z ZUS-u zawiadomienie o wysokości waloryzacji .	otrzymali	5	Masc
Policjanci już od dwóch tygodni szukali fałszywek .	szukali	5	Masc
Dlaczego tak go wciągały ?	wciągały	3	Neut
- Nie dało się jej przyszyć .	dało	2	Neut
Urwał em .	Urwał	0	Masc
W pewnej chwili zjawiła się na ulicy Kazia .	zjawiła	3	Fem
Gajowy mu do gardła przystawił dwururkę .	przystawił	4	Masc
Wypytywała rodaków o Warszawę , interesowała się przeżyciami Tomka w czasie wyprawy i nawet namawiała go usilnie , aby pozostał w Australii .	Wypytywała	0	Fem
Znów go zaswędziało .	zaswędziało	2	Neut
- Porywacze uwolnili na naszą prośbę część kobiet oraz akredytowanych w naszym kraju dyplomatów .	uwolnili	2	Masc
Na szczęście w piecu już wygasło .	wygasło	5	Neut
Powiedzieli mi , że ojciec popełnił samobójstwo .	Powiedzieli	0	Masc
Stała tak długą chwilę , silnik głośno pracował , jakby samochód już się bardzo zmęczył .	Stała	0	Fem
Trochę pomogło .	pomogło	1	Neut
Ognista łapa przejechała po głowie Liścia , ledwie zdołał jej umknąć .	przejechała	2	Fem
Ponadto dostali śmy kamizelki , za które żaden z nas nie zapłacił .	dostali	1	Masc
Uczniów to nie przekonało .	przekonało	3	Neut
Panowie nie mieli najmniejszych problemów z dziwnie skleconą reprezentacją Reszty Świata , panie też gładko wygrały z osłabioną ekipą USA .	wygrały	15	Fem
Nawet laik wie , że do 1939 r. nie błyszczeli śmy specjalnie w kinie .	błyszczeli	9	Masc
Co mogło spowodować agresję u ryby ?	mogło	1	Neut
Państwowa komisja wyborcza nadal nie podała wyników .	podała	5	Fem
Wyglądało na to , że jest to ich pierwszy posiłek od rana .	Wyglądało	0	Neut
Powiało ostro naftaliną .	Powiało	0	Neut
Sporo osób po moim kierunku pracowało później w bankach , ministerstwach , również w sejmie .	pracowało	5	Neut
Co zrobić , gdy taka sytuacja się zdarzyła i w wyniku tego ktoś stracił pracę ?	zdarzyła	7	Fem
Po mszy świętej wyruszyła z bazyliki katedralnej i okrążyła Stary Rynek .	okrążyła	8	Fem
Wymusiła ś na mnie .	Wymusiła	0	Fem
Siostra szorowała i myła ręce .	szorowała	1	Fem
Wielokrotnie groził Cyganom zemstą za oskarżenia .	groził	1	Masc
Plama pływała w zakolu , nie spłynęła nurtem .	spłynęła	6	Fem
Prawem opozycji nazwał szef Agencji Bezpieczeństwa Wewnętrznego Andrzej Barcikowski zapowiedź ewentualnego wniosku o odwołanie go z pełnionej funkcji .	nazwał	2	Masc
Wszyscy się roześmieli .	roześmieli	2	Masc
Otwarcie granic nie poprawiło sytuacji plantatorów .	poprawiło	3	Neut
Później strzałami w powietrze sterroryzował kasjerkę i zmusił ją do wydania pieniędzy .	zmusił	7	Masc
Jedli śmy te doskonałe ogórki i zapijali śmy wódką .	Jedli	0	Masc
Jej opowiadał o tobie .	opowiadał	1	Masc
- Ja pana ojcu wręczała m kwiaty !	wręczała	4	Fem
To , niestety , będzie kosztowało .	kosztowało	5	Neut
Dotychczas opłaty zależały od wartości nieruchomości .	zależały	2	Fem
pozwoliła m .	pozwoliła	0	Fem
Bił tak mocno , że złamał kij bejsbolowy .	Bił	0	Masc
Wzdłuż kamiennej podmurówki obszedł dom wokoło .	obszedł	3	Masc
Pozwoliło to załatwić ostatecznie sprawę Czechowicza .	Pozwoliło	0	Neut
I nagle zrozumiała m !	zrozumiała	2	Fem
Spojrzała , czarne oczka złośliwie mignęły , znikła .	mignęły	5	Neut
Skąd to pani przyszło do głowy ?	przyszło	3	Neut
Pewnie to go zmyliło .	zmyliło	3	Neut
Znajdowała m się w jakimś dużym supermarkecie .	Znajdowała	0	Fem
Potem zagrzmiało , owiał go płomień i stracił przytomność .	zagrzmiało	1	Neut
Mentalnie posłali energię miłości .	posłali	1	Masc
Na pogrzeb ojca przyjechał w mundurze .	przyjechał	3	Masc
Specjalnie podesłał eś mi Celińskiego .	podesłał	1	Masc
Ten pośpiech będzie teraz kosztował .	kosztował	4	Masc
Oprócz Polaków odpływali na tę wyprawę także i cudzoziemcy , wszyscy spod znaku republikańskiego .	odpływali	2	Masc
Zapanowało milczenie .	Zapanowało	0	Neut
Owa niezapomniana chwila zawierała nieprawdopodobny ładunek patosu .	zawierała	3	Fem
Oczywiście zwilgotniały .	zwilgotniały	1	Fem
Jak planował , pojechał do Jurka wczesnym popołudniem .	pojechał	3	Masc
- Działania operacyjne ustały , a C . ciągle piął się w górę .	piął	9	Masc
Tak też się stało .	stało	3	Neut
Widownia westchnęła ze współczuciem , a Iwana to uskrzydliło .	uskrzydliło	8	Neut
- Powinna to zrobić dobrowolnie .	Powinna	1	Fem
Wtedy skończyły się zamówienia .	skończyły	1	Neut
Co docierało do ludzi ?	docierało	1	Neut
Na parterze remonty trwały w najlepsze .	trwały	3	Masc
Jak zwykle , kiedy wpadał w falset , uderzał laską o podłogę .	wpadał	4	Masc
Nie mogła się mylić , bo odbite od łez światło dawało wyraźny błysk .	dawało	10	Neut
Liczył em na to , że przyjdziecie z tym do mnie .	Liczył	0	Masc
Pomagało mu w tym dwóch kolegów .	Pomagało	0	Neut
Oddały ster rządów lewicy .	Oddały	0	Neut
Układali śmy stóg .	Układali	0	Masc
Pośliniła palec i zaczęła trzeć .	Pośliniła	0	Fem
Dżabie chrupnęło w kościach .	chrupnęło	1	Neut
Podczas przesłuchania w komisji minister Zbigniew Siemiątkowski zdystansował się wobec pomysłu Cimoszewicza .	zdystansował	7	Masc
Słońce prażyło niemiłosiernie , a na domiar złego wykończyły się zapasy żywności i wody .	prażyło	1	Neut
Na kostce drżało całe ciało zawodników .	drżało	2	Neut
Mimo ciepłego dnia pani domu przyjęła ją otulona w brązowy blezer , spod ciemnej spódnicy wystawały chude łydki .	wystawały	15	Fem
Następnie rozłożyła wysoki statyw , zawiesiła na nim pudełko , przeprowadziła od niego przezroczysty przewód do igły , którą wcześniej automatyczny iniektor umieścił w żyle na przedramieniu Irka .	zawiesiła	5	Fem
Partia Konserwatywna zawiesiła Spencera w obowiązkach posła .	zawiesiła	2	Fem
Wcale się nie ucieszył z naszego spotkania .	ucieszył	3	Masc
– nic nie mówiła . .	mówiła	3	Fem
Wanna nie nasunęła mi żadnych skojarzeń , była normalną wanną .	nasunęła	2	Fem
Trafiła na obserwację do szpitala .	Trafiła	0	Fem
Uciekli z polany i skryli się między drzewami .	skryli	4	Masc
Poparzeniu uległy także drogi oddechowe .	uległy	1	Fem
Na zakończenie uroczystości głos zabrał sam ks . kardynał Sodano , który na początku niemal czystą polszczyzną przywitał przybyłych gości oraz wyraził swoje zadowolenie z pobytu we Wrocławiu .	zabrał	4	Masc
Ostatnio dwie sprawy trafiły do sądu .	trafiły	3	Fem
Jechali śmy dorożką do domu .	Jechali	0	Masc
Pomogł em mu zarzucić worek na plecy .	Pomogł	0	Masc
Wszyscy się obejrzeli , bo kobieta siedziała w ostatnim rzędzie .	obejrzeli	2	Masc
Przyjechała na wakacje .	Przyjechała	0	Fem
Nie rokowało to najlepiej .	rokowało	1	Neut
Dziecko niespodziewanie wsiadło do czekającej na piętrze windy .	wsiadło	2	Neut
Gdy wróciła , usiadła obok niego na tapczanie .	wróciła	1	Fem
Wyszła i zamknęła drzwi .	Wyszła	0	Fem
Jedna z nich trafiła do szpitala na obserwację .	trafiła	3	Fem
Nie wiadomo , kto będzie wówczas rządził .	rządził	6	Masc
Stała oparta o balustradę i patrzyła na wodę .	Stała	0	Fem
Bywało bardzo różnie .	Bywało	0	Neut
Poznał kosmetyczkę i przybory toaletowe .	Poznał	0	Masc
Zdawało się , że dopiero teraz Maria Rosa ją zauważyła .	Zdawało	0	Neut
– Wprowadzały coś ciekawego .	Wprowadzały	1	Fem
Gdy zgasło światło , kamera pokazała , że zabawiali się ze sobą pod kołdrą .	zgasło	1	Neut
Głosowało 397 posłów .	Głosowało	0	Neut
Powstrzymało go pytanie .	Powstrzymało	0	Neut
O wrocławskim spotkaniu prezydentów Kwaśniewskiego i Chiraca oraz kanclerza Schrödera informowały wszystkie media .	informowały	10	Neut
Weronika wytężyła wzrok i ze zdumieniem poznała Krzysztofa .	wytężyła	1	Fem
Stryjna przyjechała i mieszkanie wypełniło się jej obecnością .	wypełniło	4	Neut
Dla siebie zamówiła eskalopki cielęce .	zamówiła	2	Fem
Kobieta poniosła śmierć na miejscu .	poniosła	1	Fem
Podczas obchodu można było się przekonać , że nastąpiły gruntowne zmiany w pomieszczeniach CSiK .	nastąpiły	8	Fem
Lokalne władze AWS wykluczyły prezydenta ze swoich szeregów .	wykluczyły	3	Fem
Bywało , że musiała ich odpędzać policja .	Bywało	0	Neut
Światełko migotało przy zamkniętym kiosku .	migotało	1	Neut
Jadwiga Melnyk przeszła w człuchowskim szpitalu dwa zabiegi .	przeszła	2	Fem
Kasia zrezygnowała .	zrezygnowała	1	Fem
- Zaskoczyli śmy szkopów i zwiewają !	Zaskoczyli	1	Masc
Auto zostało całkowicie zniszczone , a kierowcę strażacy wydobyli za pomocą narzędzi hydraulicznych .	wydobyli	8	Masc
W 1997 roku zachorowało około 11 tys . kobiet , z tego około 6 tys . zmarło .	zachorowało	3	Neut
Wszedł , zabiło go .	zabiło	2	Neut
Szwagier pana Korzeniowskiego toporem rozrąbał świński łeb i wydobył mózg .	wydobył	8	Masc
Wpłynęło 148 projektów .	Wpłynęło	0	Neut
Wszystkie te rzeczy zjadał Józio z Hańdzią , gdyż matka żywiła się raczej kiszoną kapustą .	żywiła	10	Fem
Tomasz nastawił radio .	nastawił	1	Masc
Wtedy wszystko wydawało się jasne .	wydawało	2	Neut
i pokazała się .	pokazała	1	Fem
Łzy płynęły teraz po jej brzydkiej twarzy , a ona wycierała je ręką .	wycierała	10	Fem
Misję tę powierzyła doktorowi Lane matka Oswalda , Marguerite .	powierzyła	2	Fem
- Chciała m ci pokazać coś dziwnego w lesie .	Chciała	1	Fem
Jechało im się dobrze , na szosie po przedpołudniowym deszczu nie było kurzu , ale jezdnia nie była już mokra .	Jechało	0	Neut
Chciało jej się płakać .	Chciało	0	Neut
- Spacerowała m , była m nad rzeką .	Spacerowała	1	Fem
Rzecznik przyznała , ze ministerstwa generalnie krytykują założenia przygotowane przez ministra finansów Jarosława Bauca .	przyznała	1	Fem
Dlaczego tak go wciągały ?	wciągały	3	Neut
- Analfabetyzmowi wydali śmy zdecydowaną walkę , spodziewamy się niebawem zlikwidować go całkowicie .	wydali	2	Masc
Istniała wcześniej i będzie istniała potem .	Istniała	0	Fem
Na seminarium historycznym występowały wszystkie wielkie walory uczonego i nauczyciela .	występowały	3	Masc
Leki na obniżenie temperatury nie działały , a sytuacja , według słów Havlovej , w nocy z poniedziałku na wtorek stała się krytyczna .	działały	5	Masc
Ilu prezesów pani przetrzymała ?	przetrzymała	3	Fem
Żadna się nie odezwała .	odezwała	3	Fem
Berlińczykom spodobała się ta otwartość .	spodobała	1	Fem
– jeszcze nie próbowała ś baby ?	próbowała	3	Fem
I niestety , gdy w pewnej chwili znów się wspiął na palce , nagle zachwiał się .	zachwiał	14	Masc
Co chwila oblizywał sobie pysk .	oblizywał	2	Masc
Paryża pół ze złości się skręcało !	skręcało	5	Neut
Przyglądali śmy się różnym kształtom bakterii , glonów , pierwotniaków .	Przyglądali	0	Masc
Swój szybki rozwój zawdzięczało korzystnemu położeniu na skrzyżowaniu dróg .	zawdzięczało	3	Neut
Ognisko zgasło .	zgasło	1	Neut
Wreszcie coś szczęknęło obiecująco .	szczęknęło	2	Neut
Obaj 23-letni starogardzianie trafili do policyjnego aresztu .	trafili	3	Masc
- Krzyknęła histerycznie matka , a Anna przycupnęła w kącie za szafą .	przycupnęła	7	Fem
Ciepłe było i drżało mi w dłoniach .	drżało	3	Neut
Upiła łyk i sięgnęła po torebkę z bułką .	Upiła	0	Fem
W zamian kuria proboszczem tego kościoła uczyniła jego starszego brata , ks . Zdzisława Struzika .	uczyniła	6	Fem
Wydawało się , że wojna jednak go przerosła , przeraziła .	Wydawało	0	Neut
Krytyka się o tym rozpisywała a on milczał .	rozpisywała	4	Fem
Psy grzebały w śmietniku .	grzebały	1	Masc
Pozwoliło to załatwić ostatecznie sprawę Czechowicza .	Pozwoliło	0	Neut
Nie powie swojej mamie , że jesteście razem , bo to mogło by ją przygnębić .	mogło	11	Neut
Słone przekleństwa dolatywały aż do ostatniego wozu .	dolatywały	2	Neut
Zapłaciła ponad 1300 dolarów , na szczęście za oceanem znalazła pracę .	znalazła	9	Fem
Oddychał prędko , dławiła go flegma .	dławiła	3	Fem
Tomasz nastawił radio .	nastawił	1	Masc
- Działania operacyjne ustały , a C . ciągle piął się w górę .	ustały	3	Neut
Ale w takim razie cóż by to oznaczało ?	oznaczało	7	Neut
Z wersji ucieczki policja wycofała się .	wycofała	4	Fem
- Niedawno napoczął moją melbę .	napoczął	2	Masc
Wczoraj kolegium Instytutu usiłowało wyłonić nowego kandydata na prezesa .	usiłowało	3	Neut
Następnie zbiegł po jakichś schodach ; zbiegał długo .	zbiegał	6	Masc
- Zmarszczka przecięła czoło Tygellina .	przecięła	2	Fem
Mogła sobie w nim utłuc rokokowym samojebem dziecko z krwi , spermy i chromosomów śliny .	Mogła	0	Fem
Wyciągnęli z płomieni mężczyznę .	Wyciągnęli	0	Masc
Trafiła wprost na słup trakcji elektrycznej .	Trafiła	0	Fem
Głowa zastanowiła się chwilę .	zastanowiła	1	Fem
Wydało mi to się szalenie zabawne .	Wydało	0	Neut
Za bardzo poszedł do przodu po wyjściu z progu i miał w powietrzu kłopoty .	poszedł	2	Masc
Potrząsnął głową , odchrząknął .	Potrząsnął	0	Masc
Który milioner żył by w takim syfie ?	żył	2	Masc
Nawet go to nie poruszyło .	poruszyło	4	Neut
W październiku podczas pierwszych tegorocznych mrozów zamarzły cztery osoby .	zamarzły	6	Fem
Pozwolił eś ?	Pozwolił	0	Masc
Do jego grona należała także jedna dziewczyna .	należała	3	Fem
Fenometys wciąż kręcił głową , światło lamp odbijało się na bezwłosej skórze idealnymi refleksami .	odbijało	7	Neut
102 lata obchodziła wczoraj Stanisława Przybyła , rodowita mieszkanka Łaz .	obchodziła	2	Fem
Samo się zaczęło .	zaczęło	2	Neut
Ich oczy się zetknęły .	zetknęły	3	Neut
Przeleciało mi przez myśl i zrobiło mi się nieswojo .	Przeleciało	0	Neut
Niektórym się sprawdziło .	sprawdziło	2	Neut
Geday wymyślił depilator , cudeńko .	wymyślił	1	Masc
I ryczała m do końca .	ryczała	1	Fem
Osunął mu się w rękach .	Osunął	0	Masc
W jej twarzy , mokrej od łez rozmazanych i czerwonej , tężały w osłupieniu szkliste , bladoniebieskie oczy .	tężały	11	Neut
Załamała się tradycja zbiorowych wystąpień i manifestacji .	Załamała	0	Fem
50.000 złotych kosztowała modernizacja ul . Hallera w Lubiewie .	kosztowała	2	Fem
Nawet w tych nerwowych czasach spokojnie się z nim pracowało .	pracowało	9	Neut
Postanowiłam , że nie będę się zmuszała do pracy , ale wzięło mnie i poprawiłam całość .	wzięło	11	Neut
Po chwili odsłonił głowę i uważnie lustrował zaniepokojone twarze .	lustrował	6	Masc
Na dachu paliła się 81-letnia kobieta .	paliła	2	Fem
Działo się to podczas dochodzenia do nabrzeża w Ystad .	Działo	0	Neut
Roboty finansowało w całości uzdrowisko .	finansowało	1	Neut
Kilka dni temu na oddział trafiła prątkująca absolwentka gimnazjum .	trafiła	5	Fem
Czuło się tę wielowiekową bliskość pokrewnych narodów .	Czuło	0	Neut
- Powiedział cicho Stanisław i spojrzał Katarzynie w oczy .	Powiedział	1	Masc
Twoja maska spadła .	spadła	2	Fem
Głosowało 364 posłów .	Głosowało	0	Neut
Udało mu się mnie zaskoczyć .	Udało	0	Neut
Świeczka na stole migotała nikłym płomykiem .	migotała	3	Fem
Wrócił po chwili , wycierał starannie dłonie ręcznikiem .	Wrócił	0	Masc
W Wielkopolsce na nową maturę zdecydowało się 522 abiturientów .	zdecydowało	5	Neut
Przebiegała między najwyższą topolą na brzegu a kominem mleczarni .	Przebiegała	0	Fem
Dziecko utopiło się w żwirowisku w okolicach Wrocławia .	utopiło	1	Neut
Miewał zawsze wielu antagonistów .	Miewał	0	Masc
Udało mu się oszukać już kilka osób .	Udało	0	Neut
Właśnie wyskoczyła .	wyskoczyła	1	Fem
W szerokim pęknięciu fosforycznie świeciło próchno .	świeciło	4	Neut
Gdyby wybory ukraińskie odbywały się w Polsce , zdecydowanie wygrał by Juszczenko .	wygrał	9	Masc
Teraz opanowali Somalię .	opanowali	1	Masc
Policjant zaświecił lizakiem .	zaświecił	1	Masc
Już na kilka dni przed nią obozowisko partyzanckie przedstawiało dziwny widok .	przedstawiało	8	Neut
Od marca Barbara Piwnik zdążyła już jednak wymienić 3 prokuratorów apelacyjnych i 9 okręgowych .	zdążyła	4	Fem
Zabrali mi prywatność , nawet moje łóżko stało się własnością państwa .	stało	7	Neut
Zasępił się .	Zasępił	0	Masc
Wypadła m ze sklepu i pobiegła m na umówione miejsce .	pobiegła	5	Fem
Dopóki nie miała m opiekunki , sypiała m po trzy godziny .	sypiała	6	Fem
Do zadania pytania zapisało się 53 posłów .	zapisało	3	Neut
- Moja kariera sięgnęła szczytu .	sięgnęła	3	Fem
Tam były winnice i gąszcz , wszędzie się roiło od królików .	roiło	8	Neut
Zawiedziona szlachecka fantazja przeglądała mu z niebieskich oczek .	przeglądała	3	Fem
Jeszcze inne sądziły , że to zwykły zabieg .	sądziły	2	Fem
Wszystko się w mojej twarzy zmieniło .	zmieniło	5	Neut
Niedziela Palmowa na Kociewiu różniła się zresztą od obchodów w innych częściach Polski .	różniła	4	Fem
Myśli rwały mi się przy każdym kroku .	rwały	1	Fem
Także miasto Bielsko-Biała włączyło się w finansowanie dokumentacji .	włączyło	3	Neut
Ale nie chciała chodzić , udawała , że nic nie rozumie .	udawała	5	Fem
Przedtem włóczyli się po mieście , topniał śnieg , szumiało w rynnach , czuć było powiewy ciepła i zgnilizny , nad dachami tłukły się kłębiaste chmury .	szumiało	9	Neut
Mikroświat wciąż kusił swymi tajemnicami .	kusił	2	Masc
Tymczasem komandor zatrzaśnięty w samochodzie wydzwaniał z telefonu komórkowego do znajomych .	wydzwaniał	5	Masc
Do konkursu stanęło piętnastu traktorzystów .	stanęło	2	Neut
Książka ukazała się w odpowiednim momencie , w okresie dyskusji nad nowymi programami .	ukazała	1	Fem
Mao urodził się w 1893 roku w zamożnej rodzinie chłopskiej .	urodził	1	Masc
Nasze wzruszenie i jej się udzieliło .	udzieliło	5	Neut
Rozpoczęła się ogólnopolska akcja protestacyjna Państwowej Straży Pożarnej .	Rozpoczęła	0	Fem
Jak do tego doszło ?	doszło	3	Neut
Dziewczyny mówią , że piszczała , płakała , śmiała się , przykucnęła , usiłując uspokoić drżące od wysiłku mięśnie i wtedy rzuciły się na nią . . .	rzuciły	21	Neut
Całe starostwo spiskie od 1591 do 1745 roku należało do Lubomirskich .	należało	8	Neut
Działo się to podczas dochodzenia do nabrzeża w Ystad .	Działo	0	Neut
Dzieci zaczepiali na katowickim dworcu PKP .	zaczepiali	1	Masc
W wydanym wczoraj oświadczeniu Rada podkreśliła , że wstrzymanie wykonania koncesji , gdy jednocześnie toleruje się działalność piratów , niszczy podstawy ładu w eterze .	podkreśliła	5	Fem
- Boże , jak ja się kiedyś bawiła m po balach !	bawiła	7	Fem
Szef Polsatu zapowiedział , że złoży dziś do NSA wniosek o zmianę postanowienia .	zapowiedział	2	Masc
Mało brakowało , a miłość do zajączka Kamil przypłacił by życiem .	brakowało	1	Neut
To by mu rozwaliło żołądek .	rozwaliło	3	Neut
Ta kobieta udzieliła mi kilku ważnych lekcji .	udzieliła	2	Fem
I to najwyraźniej rozwścieczyło sprawców .	rozwścieczyło	3	Neut
Wczoraj trafił do aresztu .	trafił	1	Masc
Dopiero po ich zakończeniu będzie wiadomo , co zabiło ryby .	zabiło	8	Neut
Za dawno przywykł do posłuchu .	przywykł	2	Masc
Ta miała by sie z czego tłumaczyć .	miała	1	Fem
Mechanizm okazał się bardziej trwały od człowieka .	okazał	1	Masc
Wyglądało to kusząco .	Wyglądało	0	Neut
Głosowało 429 posłów .	Głosowało	0	Neut
Zachowała się jego piękna fotografia w powstańczym stroju , wykonana w jednym z krakowskich atelier , a także oryginalne dokumenty , powstańcza prasa i ulotki .	Zachowała	0	Fem
Zaskoczyło mnie to .	Zaskoczyło	0	Neut
Również wysokie pozycje zajęły inne polskie załogi .	zajęły	3	Fem
Kiedy lekarz wystrzelił , rozdrażnione zwierzę rzuciło się na niego .	rzuciło	6	Neut
Nawet go to nie poruszyło .	poruszyło	4	Neut
Naraz przystanęli , bo zdawało się im , że słychać czyjeś kroki .	zdawało	4	Neut
– No zawsze się tam na tej architekturze ktoś zna , bo jeden budował chałupę dla siebie , a drugi gdzieś był i coś widział .	budował	13	Masc
Nie było to oczywiście zamierzone , wynikło z pośpiechu .	wynikło	6	Neut
Nie wypaliło !	wypaliło	1	Neut
Zmiany dokonane w Oplu Fronterze wyszły mu na dobre .	wyszły	5	Fem
W Małej Komorzy z tego powodu zapaliły się sadze .	zapaliły	6	Fem
Ciężko poranili kilkunastu policjantów .	poranili	1	Masc
Badał em ten teren kilka razy .	Badał	0	Masc
I tym razem partia okazała się nieodpowiednia .	okazała	4	Fem
Ale obiecał kupić obraz .	obiecał	1	Masc
Bardzo się wówczas cieszyła z tego kostiumu .	cieszyła	3	Fem
Tu Roman Rudziński przechowywał truciznę i szafka była zwykle zamknięta na klucz .	przechowywał	3	Masc
Poczta zmniejsza swój deficyt i już w 1997 r. powinna zacząć przynosić zyski .	powinna	9	Fem
Wielu z nich używało rosyjskich nazwisk .	używało	3	Neut
Jean Paul nie odzywał się .	odzywał	3	Masc
Legenda Ismaela Khana narodziła się wśród płomieni i śmierci .	narodziła	3	Fem
Wybzykał , wraca do domu .	Wybzykał	0	Masc
Nie zamierzał em zaspokajać ciekawości Mojki .	zamierzał	1	Masc
Starcie między Generałem a MRP przybrało nawet formy drastyczne .	przybrało	5	Neut
- Jakby kładli śnieg z dołu do góry , nic by się nie stało .	stało	13	Neut
Firma ponosiła duże straty .	ponosiła	1	Fem
Ani mu się śniło opowiadać o słonecznej wiośnie .	śniło	3	Neut
W wózku wiozła 13-miesięcznego synka .	wiozła	2	Fem
tam wysoko poleciało .	poleciało	2	Neut
Pseudokibicom ze Stalowej Woli upiekło się , choć nieźle w sobotę nabroili .	upiekło	4	Neut
Wilk odprowadzał go wzrokiem , aż ciemna sylwetka rozpłynęła się w mroku korytarza .	rozpłynęła	8	Fem
Po rozwodzie przyjaźń z transseksualistą zmieniła się w związek .	zmieniła	5	Fem
Ale pani poseł nie dopuściła do niewygodnej debaty na temat tych zarzutów .	dopuściła	4	Fem
Jadąc fordem escortem nie ustąpiła pierwszeństwa karetce pogotowia .	ustąpiła	4	Fem
Zgłosiło się siedmiu kandydatów .	Zgłosiło	0	Neut
Jechali motocyklem .	Jechali	0	Masc
Do dziś w sądownictwie pracują osoby , które rozpoczynały swoją karierę w latach stalinowskich .	rozpoczynały	8	Fem
Sala zabrzmiała oklaskami .	zabrzmiała	1	Fem
Parokrotnie Wajdowie osobiście kwestowali na ulicach Japonii .	kwestowali	3	Masc
Do zdarzenia doszło w sobotę wieczorem .	doszło	2	Neut
Tu latają cyklony , podejdą wyżej , będzie wiało od wyżu .	wiało	8	Neut
- Spała ś ?	Spała	1	Fem
I bardzo piękne się zrobiły .	zrobiły	4	Fem
Downar wyjął papierośnicę i w zamyśleniu począł obracać ją w palcach .	począł	6	Masc
Prezydent Aleksander Kwaśniewski podpisał nową ordynację wyborczą do Sejmu i Senatu .	podpisał	3	Masc
Bawiąc się chwastami swojej simlah Manahem mrużył coraz podstępniej oczy .	mrużył	6	Masc
A co w sercu nosił ten pan możny ? . . .	nosił	4	Masc
To zabrzmiało ostro .	zabrzmiało	1	Neut
48 zakładów mięsnych z całego kraju zgłosiło do konkursu 213 swoich produktów .	zgłosiło	6	Neut
Pogotowie natychmiast odwiozło rannych pasażerów do szpitala w Rybniku .	odwiozło	2	Neut
Malarstwo Rubensa odegrało zasadniczą rolę w historii kultury europejskiej .	odegrało	2	Neut
Ale Moja Wdowa uważała , że zupy te czynią żołądek gładkim i młodym .	uważała	3	Fem
Palce Szczyrbka ściskały coraz mocniej .	ściskały	2	Masc
Przez następne 200 lat Krzyżacy kolonizowali Prusy i budowali swoje państwo .	budowali	8	Masc
Przez wiele lat uchodził za radykalnego antykomunistę .	uchodził	3	Masc
Tak jak upiekło im się po Zatoce i Afganistanie .	upiekło	2	Neut
Coś zachrzęściło na poduszce , ale poruszył się .	zachrzęściło	1	Neut
Konia by powaliło .	powaliło	2	Neut
Mimo że Amerykanie uznali operację za udaną , z rejonu walk zdołało wymknąć się wielu partyzantów .	zdołało	11	Neut
Zwiększyło by to przestępczość w tym rejonie .	Zwiększyło	0	Neut
Zdarzenie z kamykiem nie wychodziło mu z głowy .	wychodziło	4	Neut
Była nietykalna , bo chroniła ją karta nauczyciela .	chroniła	4	Fem
Miało kolor niebieski .	Miało	0	Neut
Na rynku chuda kobieta zaganiała kozę do bramy .	zaganiała	4	Fem
Rodzice ze wzruszeniem prezentowali dziennikarzom swoje maleństwa i dziękowali za pomoc .	dziękowali	8	Masc
I mnie o waszych spotkaniach powiedzieli uczynni sąsiedzi .	powiedzieli	5	Masc
- Przez ostatnie miesiące zasuwała m na pełnych obrotach .	zasuwała	4	Fem
Jego serce ledwie się ruszało .	ruszało	4	Neut
W czwartek do egzaminu ustnego z historii przystąpiło 94 maturzystów , w piątek natomiast 59 miłośników biologii popisywało się wiedzą z tej dziedziny .	przystąpiło	7	Neut
Dziewczęta wybuchnęły śmiechem .	wybuchnęły	1	Neut
Przyznaje , że w jej życiu skończyła się pewna epoka .	skończyła	6	Fem
Niebieskie światełko zgasło .	zgasło	2	Neut
Zdaje się , że wpatrywała się we mnie od dłuższego czasu .	wpatrywała	4	Fem
Cofnęło ich tylko dwa kilometry na południe .	Cofnęło	0	Neut
Do pierwsze kolizji doszło przy ulicy Kolejowej w Szydłowcu .	doszło	3	Neut
Wreszcie zdarzyła się prawdziwa katastrofa .	zdarzyła	1	Fem
Za sobą mieli martwą rzekę , która leżała wśród piasków jak rozbity dzban .	mieli	2	Masc
Poza nimi na ławie siedziało jeszcze pięciu podsądnych .	siedziało	4	Neut
Jego twórczość dotyczyła głównie drugiej wojny światowej .	dotyczyła	2	Fem
Samochód przebił barierkę i spadł na tory .	spadł	4	Masc
On się męczył , darł kartki , wyrzucał , wreszcie znalazł wersję , która wyrażała jego uczucia .	męczył	2	Masc
Chciałem podziękować za inicjatywę , z której zrodziło się pytanie , umożliwiającą mi pokazanie prawdy .	zrodziło	7	Neut
Dawali śmy mu złoto . . .	Dawali	0	Masc
- Mleko już się rozlało .	rozlało	4	Neut
Nikt go tu nie zapraszał !	zapraszał	4	Masc
15 naukowców uczestniczących w sesji otrzymało pamiątkowe medale wybite z okazji jubileuszu .	otrzymało	5	Neut
Za linią lasu błysnęła w słońcu blacha na wieży kościoła .	błysnęła	3	Fem
Jeszcze nie oszacowali strat .	oszacowali	2	Masc
To wystarczyło , żeby przestraszyć pozostałych kierowców trójkołowych pojazdów , którzy też pracowali nielegalnie .	pracowali	12	Masc
Jeszcze nie zakończyło się liczenie głosów , ale można już powiedzieć , że takiej koalicji nie będzie .	zakończyło	2	Neut
Oświadczył też , że idą z polecenia organizacji z bardzo ważnym zadaniem .	Oświadczył	0	Masc
- Nie będę tego komentował .	komentował	4	Masc
Do sześciu głodujących w Poznaniu dołączyło w piątek trzech związkowców ze Śremu .	dołączyło	5	Neut
- Słyszała m , że nie ma spraw bezkarnych .	Słyszała	1	Fem
Machnął ręką i zabrał się do swoich urzędowych papierów .	Machnął	0	Masc
Wielu uczestników tegorocznego Karnawału gościło już wcześniej na deskach Domu Ludowego w Bukowinie Tatrzańskiej .	gościło	4	Neut
Zranił jednego z nich , ale bandyci uciekli .	uciekli	7	Masc
Naraz auto zatrzymało się .	zatrzymało	2	Neut
Do budowy nowego gmina podchodziła kilkakrotnie .	podchodziła	4	Fem
Miało to dobre strony , gdyż rodziło rzeczywisty consensus , czyli zgodę .	rodziło	6	Neut
Wziął em lodowaty prysznic , po śniadaniu wyłączył em telefony i w ciszy gabinetu nastawił em w pamięci taśmę mojego życia .	nastawił	14	Masc
Matka - niematka uważa , że sędzię zaszczuły media .	zaszczuły	7	Neut
Na tej klepce bracia mocno się poślizgnęli .	poślizgnęli	6	Masc
Alona wybierała produkty ze straganów , a pan Jeffrey nosił za nią koszyk .	wybierała	1	Fem
- Czegoś podobnego jeszcze nie przeżył em .	przeżył	5	Masc
W Technikum Mechanicznym wszystkie osoby zaliczyły pierwszy etap .	zaliczyły	5	Fem
Gdyby to się potwierdziło , jest szansa na utrzymanie produkcji .	potwierdziło	3	Neut
- Jak się tę cenną rzecz zdobywało ?	zdobywało	6	Neut
Kto wie , czy najwięcej nie przyczyniła się do mojego wybawienia długotrwała burza .	przyczyniła	6	Fem
– położyła m ci na fotelu .	położyła	1	Fem
Później współpracowali z Szewardnadze , strzegąc jednak zazdrośnie swojej sfery wpływów .	współpracowali	1	Masc
Miała tam miejsce próba zamachu na Ojca Świętego .	Miała	0	Fem
Wtedy wydawało mi się to nadmierną ostrożnością .	wydawało	1	Neut
Ogonowski i Latusek tłumaczyli , że właśnie znaleźli zastrzelone zwierzę .	tłumaczyli	3	Masc
- Będziemy grali , mam taką nadzieję .	grali	2	Masc
Tylko w minioną sobotę w atakach terrorystycznych w Bagdadzie zginęło ponad 40 osób .	zginęło	9	Neut
- Pojebało cię ? !	Pojebało	1	Neut
Braków wtenczas nawet poeci nie wypuszczali .	wypuszczali	5	Masc
I panna Wanda zaledwie rzuciła na nie okiem .	rzuciła	4	Fem
Później policjantom powiedział , że dzwonił na pogotowie .	dzwonił	5	Masc
Choć dziecko złożyło na policji zeznania , sprawców nie zatrzymano .	złożyło	2	Neut
Mecz rozpoczął się dla niej bardzo dobrze , bo już w 2 . minucie Cezary Kucharski zdobył prowadzenie .	rozpoczął	1	Masc
Prasa podwoiła liczbę tytułów .	podwoiła	1	Fem
Na tej klepce bracia mocno się poślizgnęli .	poślizgnęli	6	Masc
W takich warunkach wielu duchownych decydowało się na organizowanie katakumbowego życia religijnego .	decydowało	5	Neut
Pośliniła palec i zaczęła trzeć .	Pośliniła	0	Fem
– Przyzwyczaił em się do jeżdżenia tramwajem .	Przyzwyczaił	1	Masc
Wśród juniorek w obu konkurencjach triumfowała Szczygiełówna .	triumfowała	5	Fem
W Betlejem zupełnie utracili ducha dociekliwości , z punktu widzenia intelektualisty zachowali się nadzwyczaj pokornie .	zachowali	11	Masc
Sejm zaaprobował przekroczenie budżetowe , co przekreśliło sens dalszych działań Trybunału Stanu .	przekreśliło	6	Neut
To poskutkowało .	poskutkowało	1	Neut
Shimada wyznaczył więc ludzi i za chwilę wnętrze góry poczęło błyskać upiornym światłem palników i ożywiło się znów koszmarną krzątaniną .	poczęło	9	Neut
Pestka nigdy dotąd nie pytała o takie rzeczy .	pytała	4	Fem
Wystarczyło zrobić jeszcze krok , może dwa .	Wystarczyło	0	Neut
Armia izraelska odwołała ćwiczenia i manewry .	odwołała	2	Fem
Milion konsumentów nieprzestrzegających zasad koszerności dokonało przełomu na rynku spożywczym .	dokonało	5	Neut
Istotnie , w damskim pokoju aż syczało .	syczało	6	Neut
O dziewictwie już dawno zapomniała .	zapomniała	4	Fem
Trubadur głosił , iż jej dochowanie należało do obowiązków damy , lecz niczego nie gwarantowało niewieście .	należało	6	Neut
Natalia spoważniała .	spoważniała	1	Fem
To mnie ucieszyło .	ucieszyło	2	Neut
Na maszynce syczała woda do zmywania , radio grało .	grało	8	Neut
Tak właśnie zrobili śmy , a tych handlarzy , którzy pracowali półlegalnie , przegonili pogranicznicy .	zrobili	2	Masc
- Za jakiś miesiąc należało by spenetrować wysypisko , najlepiej z psami .	należało	4	Neut
Spojrzałem na kobietę i stwierdziłem , że po raz pierwszy jej twarz zasługiwała na uwagę .	zasługiwała	12	Fem
Wzruszyła ramionami .	Wzruszyła	0	Fem
Wyrok ten uchylił sąd apelacyjny .	uchylił	2	Masc
Ledwo widać drogę , u Gontarczyków całe okno zawiało .	zawiało	8	Neut
Następcy Piotra wybrali na siedzibę Rzym , a nie Jerozolimę .	wybrali	2	Masc
Zbyt was kochał em . . .	kochał	2	Masc
Już bez strachu , z niedowierzaniem i błyskiem w oczach przekładała paczki z ręki do ręki .	przekładała	10	Fem
Nie znali się za życia .	znali	1	Masc
Dziewczynka opuściła już intensywną terapię i razem z rodzicami przeniosła się na zwykły oddział .	opuściła	1	Fem
Aureliusz słuchał kątem ucha , odbierając teczkę z depozytu .	słuchał	1	Masc
Prezydent Bush zapewniał w środowym przemówieniu telewizyjnym , że siły koalicji będą maksymalnie oszczędzały ludność cywilną .	zapewniał	2	Masc
Razem z nimi pojawiła się również amerykańska pielęgniarka , która przez jakiś czas będzie pomagać w opiece nad dziećmi .	pojawiła	3	Fem
Nie ma też dowodów , by Pietruszka był agentem KGB , choć SB ściśle współpracowała z Rosjanami .	współpracowała	14	Fem
Z tych samych środków , które zasiliły konto Hufca ZHP , dofinansowanie zdobyło także Stowarzyszenie Na Rzecz Szkolnictwa Specjalnego .	zdobyło	12	Neut
Pies przekrzywiał głowę , jakby słuchał .	słuchał	5	Masc
Wówczas koła łowieckie będą dbały , aby populacja nie rozrastała się ponad dopuszczalną .	dbały	4	Neut
Rozśpiewały się ptaki , powracające gromadami w mury Zamku .	Rozśpiewały	0	Masc
Panowie w cylindrach i w melonikach tkwili bokiem na przednich ławeczkach .	tkwili	6	Masc
Nie zauważyła ś ?	zauważyła	1	Fem
- O , tu już przesadziła ś !	przesadziła	5	Fem
Dlaczego wpadł ?	wpadł	1	Masc
Przebiegające pod miastem chodniki kopalni zalano wodą , a wzgórze zgniło i zapadło się w ziemię jak przydeptane .	zapadło	12	Neut
Dlatego umówił em się z nim w restauracji i zawiadomił em policję .	umówił	1	Masc
- Pan inżynier rosołku by nie popił ?	popił	6	Masc
Na dodatek pod koniec dekady zaczęło rosnąć bezrobocie , zwłaszcza wśród kobiet i młodzieży .	zaczęło	5	Neut
Wolała puszczać w kinach filmy kung-fu licząc , że dzięki temu ludzie przestaną myśleć o polityce .	Wolała	0	Fem
Co mnie jeszcze śmieszyło ?	śmieszyło	3	Neut
Już trzykrotnie odwoływali się do Samorządowego Kolegium Odwoławczego , by unieważnić decyzję o warunkach zabudowy wydaną przez Wydział Architektury .	odwoływali	2	Masc
Ale stało się .	stało	1	Neut
Ale dała się zabrać .	dała	1	Fem
Czy pamiętała jakiś wiersz ?	pamiętała	1	Fem
Sto godzin temu poszedł by m na taki układ .	poszedł	3	Masc
Wypadła ś z gry ?	Wypadła	0	Fem
Oczywiście SLD mogło by być ugrupowaniem ateistycznym albo umiarkowanie areligijnym .	mogło	2	Neut
Matka - niematka uważa , że sędzię zaszczuły media .	zaszczuły	7	Neut
Tak się przynajmniej wydawało .	wydawało	3	Neut
kanapy się dorobili śmy .	dorobili	2	Masc
Zakończenie pięknej piłkarskiej kariery wcale nie oznaczało końca przygody z piłką nożną .	oznaczało	6	Neut
- Uprzedził pan nasze myśli .	Uprzedził	1	Masc
i to wylało się poza granice naszego kraju .	wylało	2	Neut
Oczy powoli przyzwyczajały się do mroku .	przyzwyczajały	2	Neut
Już w 15 . minucie Stal objęła prowadzenie po strzale Grecha .	objęła	6	Fem
Świadek zeznawał by w procesach pozostałych członków gangu .	zeznawał	1	Masc
Dosiadł się do nich , napełnił talerz zupą pomidorową .	Dosiadł	0	Masc
Komtur nachylił się niżej i słuchał .	słuchał	5	Masc
Za wszelką cenę starał się dogonić swoich , ale nie pomyślał , jak to będzie praktycznie wyglądało .	wyglądało	16	Neut
I zaraz Pan musiał przepraszać , bo środowisko się oburzyło . . .	oburzyło	9	Neut
Gdy zahamowała tuż obok , chłopak otworzył bagażnik .	zahamowała	1	Fem
Dramatyczny przebieg mistrzostw zakończył się dla Szymona XIV miejscem w światowej klasyfikacji .	zakończył	3	Masc
Zdjął i wyniósł do przedpokoju .	Zdjął	0	Masc
Większość pampersów nie przepracowała w telewizorni nawet 12 miesięcy , więc zgodnie z obowiązującym regulaminem nie mogła uczestniczyć w nagrodach z zysku za 1994 rok .	przepracowała	3	Fem
Panie ze Skarszew pełniły rolę obserwatorek .	pełniły	3	Fem
Grali śmy w taką grę , byli policjanci i bandyci .	byli	6	Masc
W rozdrażnieniu Pierre chwycił go silnie zębami .	chwycił	3	Masc
Wzorem większości producentów przeczytał wyłącznie krótkie streszczenie zawarte na pierwszej stronie , ale po jego minie można było wyczytać , że sama koncepcja go urzekła .	urzekła	24	Fem
Usłużnym kierowcą okazał się 34-letni Rob Gatena .	okazał	2	Masc
I skorzystał em .	skorzystał	1	Masc
Przecież nie wyszła na strych .	wyszła	2	Fem
Otworzyła usta .	Otworzyła	0	Fem
Rzadko się odzywał , raczej słuchał , notował , łagodził ostre nieraz spory .	notował	7	Masc
Ta rzuciła słuchawką .	rzuciła	1	Fem
Było ich czterech .	Było	0	Neut
Celnikom wyjaśniła , że muszlę kupiła w Acapulco za 20 dolarów .	kupiła	5	Fem
A potem zaczęło się . . .	zaczęło	2	Neut
Plenum rozpatrzyło także sprawy organizacyjne .	rozpatrzyło	1	Neut
Dziewczyny mówią , że piszczała , płakała , śmiała się , przykucnęła , usiłując uspokoić drżące od wysiłku mięśnie i wtedy rzuciły się na nią . . .	piszczała	4	Fem
Ktoś wskazał pana .	wskazał	1	Masc
Niestety , ja też jestem na wychowawczym i ZUS niczego nie wpłacił .	wpłacił	11	Masc
Nastrój jesiennej majówki zepsuła ta dziewczyna .	zepsuła	3	Fem
500 chuliganów zorganizowało protest przeciw złej sytuacji finansowej klubu .	zorganizowało	2	Neut
Nie znał Ilony .	znał	1	Masc
Wkrótce nadeszło drugie zdjęcie w czarnej obwódce .	nadeszło	1	Neut
W niedzielę o godz . 2 . 14 rozpoczęła się astronomiczna zima .	rozpoczęła	8	Fem
- Możliwość odejścia Leszka Balcerowicza bardzo zaniepokoiła inwestorów .	zaniepokoiła	6	Fem
Wiedziałam , gdzie są fotografie z naszych pogrzebów ; wystarczyło , żeby poszperał trochę w szufladach .	poszperał	12	Masc
Czy to ta niemoc grzybowa zwiastowała ?	zwiastowała	5	Fem
Tak właśnie zrobili śmy , a tych handlarzy , którzy pracowali półlegalnie , przegonili pogranicznicy .	przegonili	13	Masc
Może mu zazdrościł .	zazdrościł	2	Masc
Była przy żonie Andrzeja , dopóki nie urodziło się dziecko .	urodziło	7	Neut
Rada Nadzorcza PZU zebrała się wczoraj rano .	zebrała	3	Fem
- Podpisał em !	Podpisał	1	Masc
Przyjechało pogotowie .	Przyjechało	0	Neut
Stryjna przyjechała i mieszkanie wypełniło się jej obecnością .	wypełniło	4	Neut
Skinęli porozumiewawczo głowami i usiedli .	Skinęli	0	Masc
Niezwyciężony lęk przed dziwem w każdym momencie serca przychodniów przeszywał .	przeszywał	9	Masc
- Dostała m twój list , przyjedź , jeśli chcesz . . .	Dostała	1	Fem
To zabrzmiało ostro .	zabrzmiało	1	Neut
Firma skontaktowała się ze mną , przedstawiając opinię rzeczoznawcy .	skontaktowała	1	Fem
Powołanie Semaka wzburzyło pracowników opolskiej rozgłośni .	wzburzyło	2	Neut
Mock przytulił się do hrabiny i objął jej kruche ramiona .	objął	6	Masc
O sytuacji dzieci poinformowała szpital przypadkowa osoba .	poinformowała	3	Fem
Wielkie firmy już dawno dostrzegły , że rządy muszą zabiegać o ich względy , aby przypisywać sobie sukcesy gospodarcze .	dostrzegły	4	Fem
Odwróciła się i zaczęła szybko iść w moją stronę .	Odwróciła	0	Fem
Uważał , że jego własne zadanie jest zbyt łatwe .	Uważał	0	Masc
Miesiąc spędziła w szpitalu .	spędziła	1	Fem
Właśnie to zagęszczenie chyba spowodowało , że w krótkim czasie koszatniczki w Wiedniu wyginęły .	wyginęły	13	Fem
Coś się tam zepsuło , a części wymiennych nie ma .	zepsuło	3	Neut
Oczywiście nie zabrakło w tym momencie również opiekunki stypendystów pani Karoliny Szybki .	zabrakło	2	Neut
czyli osiągnęła ś sukces .	osiągnęła	1	Fem
Niestety , nie zostawiła adresu .	zostawiła	3	Fem
Coś poruszyło się z tyłu , za ramieniem dziesiętnika .	poruszyło	1	Neut
Przebiegające pod miastem chodniki kopalni zalano wodą , a wzgórze zgniło i zapadło się w ziemię jak przydeptane .	zgniło	10	Neut
Zaroiło się po ścierniskach i bruzdach .	Zaroiło	0	Neut
- Proboszcz pierwszy nadpił .	nadpił	3	Masc
Nasze spółdzielnie produkcyjne powstały dzięki przykładowi kołchozów radzieckich .	powstały	3	Fem
Po czym stanął , zawrócił i wyszedł .	zawrócił	4	Masc
Andrew wolał by , aby Elizabeth pożegnali tylko najbliżsi .	wolał	1	Masc
włożyła ś .	włożyła	0	Fem
– wchodziło się do mieszkania i był jeden wielki smród .	wchodziło	1	Neut
Było przestronnie , panowała spokojna , sympatyczna atmosfera .	panowała	3	Fem
- Nie powinno .	powinno	2	Neut
W Betlejem zupełnie utracili ducha dociekliwości , z punktu widzenia intelektualisty zachowali się nadzwyczaj pokornie .	zachowali	11	Masc
- Mimo stacjonujących w Groznym wojsk i patroli Rosjanie nie będą się tam czuli bezpiecznie .	czuli	13	Masc
Lech Kaczyński nie żałuje , że jego filmowa kariera się nie rozwinęła , a do swojego aktorskiego talentu podchodzi z rezerwą .	rozwinęła	11	Fem
Wiele się zmieniło .	zmieniło	2	Neut
Potem ustosunkował się do tego , co wcześniej przekazali śmy w sprawach gospodarczych .	ustosunkował	1	Masc
Z ulicy dobiegały czyjeś kroki .	dobiegały	2	Masc
Dwa lata temu kilkudziesięciu okolicznych rolników demonstrowało swoje niezadowolenie przed mławską Temidą .	demonstrowało	6	Neut
W gabinecie sadza na fotelu , siada obok i w obecności rodziców streszcza mu , co jej opowiedzieli .	opowiedzieli	17	Masc
14-letni chłopak nie jadł , nie mówił , nie umiał korzystać z toalety .	jadł	3	Masc
Podał em dokument .	Podał	0	Masc
Mimo operacji nie dało się go uratować .	dało	3	Neut
Potem wypełniał ankietę i kładł się na kozetkę .	kładł	4	Masc
Saszce rzeczywiście odeszła chętka do dalszej rozmowy .	odeszła	2	Fem
Psychiatrzy orzekli , że nie był w pełni poczytalny .	orzekli	1	Masc
Najwyższe sięgały nawet 180 cm .	sięgały	1	Masc
Obudziło mnie zimne dotknięcie .	Obudziło	0	Neut
Długi ograniczył się do spojrzenia .	ograniczył	1	Masc
Perkusja robiła straszliwy hałas .	robiła	1	Fem
Agencja poinformowała , że Masud zmarł w Afganistanie .	poinformowała	1	Fem
Wycieczka musiała zmienić trasę marszu i zgubiła się .	zgubiła	6	Fem
Jasieńczyk o nią zapytał .	zapytał	3	Masc
Podobny sprzęt otrzymywały od niego dzieci i w ten sposób kontaktował się z nimi .	kontaktował	10	Masc
Zrozpaczona matka nie może sobie darować , że nie odczytała wezwania na pomoc w słowach dziecka .	odczytała	9	Fem
Na maszynce syczała woda do zmywania , radio grało .	syczała	2	Fem
- Popełnili by śmy ciężki grzech twierdząc , że te obrazy nas nie interesują .	Popełnili	1	Masc
Parowozy zawsze fascynowały i przerażały .	fascynowały	2	Masc
Ogłoszone wczoraj dane Narodowego Banku Polskiego , dotyczące wielkości deficytu na rachunku obrotów bieżących , zaskoczyły ekonomistów .	zaskoczyły	15	Fem
Z początku nie wyglądało to tak źle .	wyglądało	3	Neut
Noc zamazała fantastyczne kolory i wszystkie klomby wyglądały teraz jednakowo .	zamazała	1	Fem
W głowach łóżka na słupku od kwiatów paliła się zdjęta ze ściany gromnica .	paliła	7	Fem
Jakoś się to potem rozwinęło .	rozwinęło	4	Neut
- Musiała m .	Musiała	1	Fem
Rzuca się na podłogę w hipermarkecie , bo nie dostało kolejnej zabawki .	dostało	9	Neut
– Nieraz już leczyła m tak Jarowita .	leczyła	3	Fem
Udało się dopiero wtedy , gdy zorientowałem się , co jest grane .	Udało	0	Neut
Gdyby z takiego nierozsądnego myślenia wyrastało się jak z dziecięcych ubrań , nie było by większego problemu .	wyrastało	5	Neut
Wróciło do łask w 1960 r .	Wróciło	0	Neut
Dopiero dzisiaj w trędowatej kaplicy rozdzielili się na kata i ofiarę .	rozdzielili	5	Masc
– Zajrzała jej w oczy spłowiałym błękitem tęczówek .	Zajrzała	1	Fem
- Ruski przerzucił się na Turcję .	przerzucił	2	Masc
– obraziła ś się .	obraziła	1	Fem
W ziemi ziały ogromne dziury .	ziały	2	Fem
Kudłatemu znowu coś popieprzyło się w obliczeniach finansowych .	popieprzyło	3	Neut
Przed sądem stawiło się tylko 18 świadków .	stawiło	2	Neut
Ale nigdy nie pokazała by m wszystkiego .	pokazała	3	Fem
Stanowczo mi nie szło .	szło	3	Neut
Książęta kijowscy tracili podstawy gospodarcze swej pozycji politycznej .	tracili	2	Masc
Zeszła z głównej alejki i skręciła w sieć bocznych dróżek .	skręciła	5	Fem
Kaneyasu kiwał głową , akceptując pomysł Kiry .	kiwał	1	Masc
Nieboszczyk ojciec zawsze nam to śpiewał i na pedałowej harmonii sobie podgrywał .	śpiewał	5	Masc
Podwórko pachniało cytrusami .	pachniało	1	Neut
Zajmowała się tym głównie Maryla Wacławkówna , wygnana ongiś z przedszkola za klerykalizm .	Zajmowała	0	Fem
Splątała się jawa ze snem .	Splątała	0	Fem
Byli w wielu innych związkach , które się jednak rozsypały .	Byli	0	Masc
Na twarzy tłumacza odmalowało się zdumienie .	odmalowało	3	Neut
Co wam wpadło do głowy ?	wpadło	2	Neut
I puścił go .	puścił	1	Masc
Informację tę potwierdziło rosyjskie dowództwo .	potwierdziło	2	Neut
Sam z przyjemnością przeczytał by m dokumenty na swój temat , sądzę , że istnieją .	przeczytał	3	Masc
W wyniku wyborów Kohl utrzymał przewagę w Bundestagu .	utrzymał	4	Masc
pokłóciły się między sobą .	pokłóciły	0	Fem
Zajmowały się tym już Zofia Korczak - Blatonowa i Aniela Cieszkowska .	Zajmowały	0	Fem
Dozorca strzyknął brunatną śliną .	strzyknął	1	Masc
Ogień trzaskał w ciszy , dzieci wybiegły na dwór przestraszone .	trzaskał	1	Masc
Za naszym domem też tęsknił , pisał , że nie może zapomnieć Wigilii przy kolędach na Wzgórzu .	tęsknił	4	Masc
Andrew wszedł do budynku konsulatu .	wszedł	1	Masc
Po chwili odsłonił głowę i uważnie lustrował zaniepokojone twarze .	odsłonił	2	Masc
Widownia westchnęła ze współczuciem , a Iwana to uskrzydliło .	westchnęła	1	Fem
Przyjechał ze wsi z forsą , chciał kupić motorek .	Przyjechał	0	Masc
Zachrobotało w bramie , zachrzęściło i błysnęła latarka Softa .	zachrzęściło	4	Neut
Arkadiusza J . pogrążyły też zeznania taksówkarza , który zabrał oskarżonych sprzed Stodoły .	zabrał	9	Masc
Prosiła , żeby ucałować ciotkę i podziękować jej za paczkę .	Prosiła	0	Fem
Dogadał się z NATO i Bushem .	Dogadał	0	Masc
Polskich komunistów nie łączyły nigdy żadne specjalne więzy z przywódcami ludowych Chin .	łączyły	3	Neut
Minęło już tyle lat , a ja bardzo często przychodzę na oddział .	Minęło	0	Neut
Również państwo bardzo się starało , żeby księża wzięli swoje .	starało	4	Neut
W styczniu przyszedł front .	przyszedł	2	Masc
Sylwetki mechaników wchłonęło po chwili czarne wnętrze hangaru .	wchłonęło	2	Neut
Stał na środku przedpokoju , hipnotyzując wzrokiem Lidkę , która wpatrywała się w niego z niedowierzaniem i zachwytem .	wpatrywała	10	Fem
Żadna ze stron procesu nie odwoływała się od wyroku .	odwoływała	5	Fem
Władze hiszpańskie działały niezwykle szybko .	działały	2	Fem
Darmosz zgasił papierosa , ruszył za nimi .	ruszył	4	Masc
Jej głos był cichy , łagodny , prosiła o coś .	prosiła	7	Fem
Dodaje , że nie rzucił obrazem o podłogę .	rzucił	4	Masc
Następnie rozłożyła wysoki statyw , zawiesiła na nim pudełko , przeprowadziła od niego przezroczysty przewód do igły , którą wcześniej automatyczny iniektor umieścił w żyle na przedramieniu Irka .	rozłożyła	1	Fem
Pozbył się balastu , nim ten balast odebrała mu zamieć historii .	Pozbył	0	Masc
Ostatnio przebiła się lewa górna 2 !	przebiła	1	Fem
Pozytywne zdanie miała garstka z nich .	miała	2	Fem
Wojskowy Sąd Okręgowy odrzucił wczoraj apelacje obrońców i utrzymał wyrok sądu pierwszej instancji .	utrzymał	8	Masc
Wciąż traktowała mnie z góry .	traktowała	1	Fem
Uczestniczki wysłuchały wykładów doradców zawodowych i prawników , uczestniczyły w zajęciach psychologicznych , poznawały podstawy obsługi komputera i korzystania z Internetu .	wysłuchały	1	Fem
Nad ranem z soboty na niedzielę z pędzącego pociągu wyskoczyła 17-letnia dziewczyna .	wyskoczyła	9	Fem
Milicja ujęła napastników .	ujęła	1	Fem
- Mieszczanie złożyli okup .	złożyli	2	Masc
Udało się !	Udało	0	Neut
– Leżał na rękawicach ochronnych i też był popaprany ziemią .	Leżał	1	Masc
Jednak po dokładnych oględzinach straż pożarna odkryła ofiarę pożaru .	odkryła	6	Fem
Pewnie się nam przyśniło .	przyśniło	3	Neut
Tak właśnie zrobili śmy , a tych handlarzy , którzy pracowali półlegalnie , przegonili pogranicznicy .	pracowali	10	Masc
I szedł em przez te stygnące odchody coraz bardziej markotny , a przygnębienia przybywało mi z każdym krokiem .	przybywało	13	Neut
Z jego przepalonego i odsłaniającego rusztowanie kręgów gardła wydobył się syk .	wydobył	8	Masc
Myślała m , że odkryła m to w tym tygodniu !	Myślała	0	Fem
- Kapliczka przylegała do kościoła katolickiego , Łemkowie z niej od wielu lat nie korzystali .	korzystali	14	Masc
Jak poinformował Cesar Fraga z Uniwersytetu w Buenos Aires , przeprowadzone tam badania wykazały , że czekolada wzmacnia antyutleniacze znajdujące się we krwi , zwiększając odporność na zaburzenia serca i naczyń wieńcowych .	wykazały	13	Neut
Około północy nadciągnął sztorm i śnieżyca .	nadciągnął	2	Masc
I coś ścisnęło mnie w piersiach od tych jego słów .	ścisnęło	2	Neut
Doszło do kraksy .	Doszło	0	Neut
Do zdarzenia doszło na dość oblodzonej ulicy .	doszło	2	Neut
W Kcyni odbyło się spotkanie z kandydatami na kierowników na samodzielny publiczny zakład opieki zdrowotnej w Kcyni i Kowalewku .	odbyło	2	Neut
Znalazła m z trudem jakieś zdjęcia .	Znalazła	0	Fem
Nic nie wiem o tym , by po moim aresztowaniu pan mecenas doradzał Barbarze .	doradzał	12	Masc
Błyskotliwy wykładowca - matematyk o mrocznej urodzie zafascynował młodą studentkę .	zafascynował	7	Masc
Usta głowy drgnęły , po czym popłynął z nich chrapliwy głos .	drgnęły	2	Neut
Dobrze spisała się młodzież w Sterdyni , Ceranowie , Skrzeszynie , Czerwonce i Wężach .	spisała	1	Fem
– Rozpakował rzeczy .	Rozpakował	1	Masc
- Czy świadomie wybrała pani rzeźbę , przecież to taki niekobiecy zawód ?	wybrała	3	Fem
W tym momencie zrozumiała m , że ona się myli .	zrozumiała	3	Fem
Robiły śmy kanapki , stroiły śmy półmiski .	stroiły	4	Fem
Mogła m sprawdzić dokładnie ten link przed napisaniem posta .	Mogła	0	Fem
Czy nie widział domów na mapach ?	widział	2	Masc
Zbigniew Brzeziński , doradca prezydenta Jimmy'ego Cartera do spraw bezpieczeństwa , zaapelował o umiar do robotników , władzy i Kościoła w Polsce .	zaapelował	11	Masc
Mariola odstawiła torebkę na malutki stołeczek .	odstawiła	1	Fem
Barszczucha rozwinęła kabel i włączyła do kontaktu .	rozwinęła	1	Fem
Łódź zakołysała się gwałtownie .	zakołysała	1	Fem
Niebo zasnuło się ołowianymi chmurami .	zasnuło	1	Neut
Po piętnastu zawiadamiamy Kowala , że coś ci się stało .	stało	9	Neut
Mogła by m wszystko ściągnąć spod spodu .	Mogła	0	Fem
Auderska opowiadała plotki .	opowiadała	1	Fem
Całowała go drobnymi , szybkimi pocałunkami .	Całowała	0	Fem
Tymczasem mamusia zaczęła czegoś gwałtownie szukać w torebce .	zaczęła	2	Fem
Jan stanie przed Bogiem i będzie musiał świadomie odpowiedzieć za całe życie , cokolwiek w tym poprzednim się wydarzyło .	wydarzyło	18	Neut
Najder nie godził się na takie załatwienie sprawy .	godził	2	Masc
Przegrali śmy życie .	Przegrali	0	Masc
Ale z drugiej strony nie chciał em , żeby moja przyjaciółka uznała mnie za wariata .	uznała	11	Fem
Nie wiedziała , jak udzielić mu tych rad , czuła , że śmiałby się znowu .	czuła	9	Fem
Jasne , wesołe światło rozlało się po kątach .	rozlało	4	Neut
Zarzuty usłyszały 33 osoby .	usłyszały	1	Fem
Czy na to go dzisiaj plecy swędziały ?	swędziały	6	Neut
A teraz bym opluła .	opluła	3	Fem
To się nazywało teatr , ale to było mieszkanie cioci Lecha Emfazego .	nazywało	2	Neut
Zdziwilibyście się , ile nas łączyło .	łączyło	5	Neut
bo tak zaczęła m robić .	zaczęła	2	Fem
Machała m mu fartuchem , żeby lądował na łące pod lasem , ale ten chłopak chyba się przestraszył , że zawadzi o druty .	Machała	0	Fem
Nie znam przecież obyczajów panujących w jej kraju , nie interesowały mnie .	interesowały	10	Masc
- Oczy bankiera wyrażały życzliwość i zaciekawienie .	wyrażały	3	Neut
Dlaczego dała m sobie wmówić ciemnotę i sobą poniewierać ?	dała	1	Fem
Dziewczyna głośniej zachlipała w progu .	zachlipała	2	Fem
Zdaniem dyrekcji nie można zlokalizować magazynów poza obszarem fabryki , gdyż zwiększyło by to koszty produkcji .	zwiększyło	11	Neut
Po zmierzchu życie towarzyskie wyraźnie się ożywiło .	ożywiło	6	Neut
Inne dzieci nie przychodziły do mnie zbyt często .	przychodziły	3	Neut
Stawiał sobie wielkie problemy i plon jego pracy był wielki .	Stawiał	0	Masc
Począł myśleć gorączkowo .	Począł	0	Masc
Do zdarzenia doszło w niedzielę .	doszło	2	Neut
W tych ramach wspierało także hierarchicznie gorszą pozycję kobiet .	wspierało	3	Neut
Ten okrzyk otrzeźwił go .	otrzeźwił	2	Masc
Było ich trzech .	Było	0	Neut
Wyrok nie zapadł , bo w trakcie procesu sąsiad zmarł .	zmarł	9	Masc
Ogarnęło ją dziwne wzruszenie .	Ogarnęło	0	Neut
Powinno być dożywocie . . .	Powinno	0	Neut
Sprawdzili śmy u dealerów , jakie auta spełniają ZUS-owskie marzenia .	Sprawdzili	0	Masc
Policjanci odwieźli delikwentów do izby wytrzeźwień .	odwieźli	1	Masc
Zakończyły się ligowe rozgrywki drużynowych mistrzostw Polski w zapasach .	Zakończyły	0	Fem
Matka płakała .	płakała	1	Fem
Stało się .	Stało	0	Neut
Interesująco wypadła sala wystawiennicza na poddaszu , chociaż widać , że w budynku jest jeszcze parę rzeczy do robienia .	wypadła	1	Fem
Tak się zdarzyło w Charkowie .	zdarzyło	2	Neut
Wypraszam sobie , żeby ś szydziła ze mnie .	szydziła	5	Fem
Twierdzili , że nie oddali córki do szpitala , bo nie mogli by jej odwiedzać .	Twierdzili	0	Masc
Czy stać jakąś powszedniość , by stała się rzeczą wielką ?	stała	6	Fem
Ruszyły sprawy spadkowe .	Ruszyły	0	Fem
Wszystkie grupy otrzymały radiomagnetofon i toster .	otrzymały	2	Fem
- To bardzo pomogło .	pomogło	3	Neut
Nie odezwała się .	odezwała	1	Fem
Wszystko się zmarnowało .	zmarnowało	2	Neut
W dzielnicy zawrzało .	zawrzało	2	Neut
Powtórzyła i w tym momencie zdrzemnęła się .	Powtórzyła	0	Fem
Rudzki odznaczał się wielkim sceptycyzmem wobec wszelkich spekulacji i niesprawdzalnych hipotez .	odznaczał	1	Masc
Na rozwieszonej chustce do nosa ujrzał em film .	ujrzał	5	Masc
Gospodarz milczał opuściwszy powieki , jakby się lękał zdradzić spojrzeniem .	lękał	7	Masc
– Sprzedał by pan obcemu ziemię ?	Sprzedał	1	Masc
Jakiś gorący dreszcz przeniknął Felusia .	przeniknął	3	Masc
Prawdziwe chwile euforii przeżywała również warszawska giełda .	przeżywała	3	Fem
W czasie pobytu krótko rozmawiał em z Lechem Bądkowskim .	rozmawiał	4	Masc
Wielka Rada zbierała się już ponad dwadzieścia lat , a nigdy nie doszło na niej do głosowania . . .	zbierała	2	Fem
Zjadł sześć ciastek z kremem " .	Zjadł	0	Masc
W poniedziałek dwaj gorzowianie podbili ją do 1.000 zł .	podbili	4	Masc
Na pastwisku w Uniszkach Gumowskich rolnik załadował na dwukółkę krowę .	załadował	6	Masc
śledztwo IPN nie dało żadnych efektów .	dało	3	Neut
Burza toczyła się leniwie , zanim zapadła w zachodnią czeluść nieba .	zapadła	6	Fem
ŻYCIE przedstawiło w sądzie świadków , którzy widzieli Kwaśniewskiego w Cetniewie .	przedstawiło	1	Neut
– nie wskazała by m .	wskazała	2	Fem
Któż pielęgnował by go wtedy z takim oddaniem ? . . .	pielęgnował	1	Masc
W koszuli nocnej , boso podeszła do okna i odsunęła firankę .	odsunęła	9	Fem
Zaczął się wielki exodus .	Zaczął	0	Masc
Mało brakowało , a miłość do zajączka Kamil przypłaciłby życiem .	brakowało	1	Neut
Wzruszyła ramionami .	Wzruszyła	0	Fem
Wysiadła na zakręcie przed Hagen .	Wysiadła	0	Fem
Piosenkę zaśpiewali dobrze i publiczność przyjęła ich serdecznie , a dziennikarze wyróżnili swoją nagrodą .	wyróżnili	11	Masc
Twierdzili , że nie oddali córki do szpitala , bo nie mogliby jej odwiedzać .	Twierdzili	0	Masc
Poruszyły się wskaźniki na podświetlanych zegarach .	Poruszyły	0	Masc
Kiwek , spluwając w palce , uważnie odliczał złotówki .	odliczał	7	Masc
Pożyczyła i zapomniała oddać .	zapomniała	2	Fem
Miała liczne obrażenia głowy .	Miała	0	Fem
Komisja przetargowa miasta i Zarządu Dróg Miejskich wybrała najtańszą ofertę .	wybrała	7	Fem
Akurat wtedy , gdy kadrowicze rozpakowywali w Warszawie swój sprzęt po powrocie ze zgrupowania w Barsinghausen , w kościele w Kazimierzu zebrał się tłum wiernych , który modlił się o powodzenie naszej drużyny w zbliżających się mistrzostwach świata .	modlił	27	Masc
Przybywały tabunami .	Przybywały	0	Neut
Przed rozpoczęciem zdjęć przez dwa tygodnie spotykali śmy się na próbach .	spotykali	6	Masc
Z tym się rozstali .	rozstali	3	Masc
Należało by wcześniej umyć okna .	Należało	0	Neut
Ta zbrodnia wstrząsnęła Polską .	wstrząsnęła	2	Fem
– coś by m chrupnęła . .	chrupnęła	4	Fem
Wrócił em do biura i natychmiast zadzwonił em na policję .	Wrócił	0	Masc
Czy się tam wprowadził ?	wprowadził	3	Masc
Bronił eksmitowanych na bruk , naprawiając błędy przyjętej przez koalicję SLD­PSL ustawy , grzmiał na globalistów i świeżych krajowych , drapieżnych kapitalistów .	grzmiał	13	Masc
Dzieci wpadły w rozpacz .	wpadły	1	Neut
Dzięki archiwum zachowały się kopie .	zachowały	2	Fem
Jak wielu moich rówieśników inaczej swoje życie planował , a inaczej się potoczyło .	planował	7	Masc
Ericsson kończy produkcję telefonów komórkowych , która przynosiła szwedzkiej spółce ogromne straty .	przynosiła	7	Fem
Stare by może uciekły , ale małe dorosły i zostały .	dorosły	7	Fem
Cztery kowane wozy pojechały za siostrami .	pojechały	3	Masc
Zrozumiał em wszystko .	Zrozumiał	0	Masc
Cudem przeżyła 9-letnia dziewczynka .	przeżyła	1	Fem
Lech Kaczyński w czasie kampanii wspiął się na szczyty .	wspiął	5	Masc
Batcherol nie słuchał .	słuchał	2	Masc
– nie oglądał em .	oglądał	2	Masc
Obruszył się Adam .	Obruszył	0	Masc
Szosa zwężała się i wydłużała , drzewa uciekały .	uciekały	7	Neut
Było już południe , kiedy skończyli kręcić .	skończyli	5	Masc
Minęło tyle lat . . .	Minęło	0	Neut
Nie wiem , czy wybory zweryfikowały ten pogląd .	zweryfikowały	5	Neut
Związane ciała poruszyły się słabo .	poruszyły	2	Neut
Stało się !	Stało	0	Neut
Niestety później zatracił już swą skuteczność .	zatracił	2	Masc
Gdy myśleli ście o swoim rodzicielstwie , obiecywali ście sobie nie popełnić ich błędów .	obiecywali	7	Masc
Należało spróbować nawiązać łączność .	Należało	0	Neut
- Miasto wydzierżawiło teren bez problemów .	wydzierżawiło	2	Neut
Co jakiś czas wydawało mi się , że teraz już mogę coś wydrukować albo że już mi wolno wyjechać .	wydawało	3	Neut
- Rozprawa odbyła się w piątek .	odbyła	2	Fem
Dziecko utopiło się w żwirowisku w okolicach Wrocławia .	utopiło	1	Neut
Zanim wiązanki kwiatów przykryły mogiłę , słowa modlitwy prowadzonej przez ks . Pawła Dorucha splatały się z wyrazami bólu i wspomnieniami przyjaciół .	splatały	14	Neut
Elizabeth uśmiechnęła się do kobiet , a one uśmiechnęły się do niej .	uśmiechnęły	8	Fem
Konia by powaliło .	powaliło	2	Neut
Dziecko przejechało w ten sposób aż 6 pięter .	przejechało	1	Neut
Szczekały przez długi czas wśród jasnej od księżyca nocy .	Szczekały	0	Masc
- Nie będzie to nic kosztowało .	kosztowało	5	Neut
Potem odważniej zaatakowali gospodarze .	zaatakowali	2	Masc
Porucznik nie zamierzał wykładać swoich kart , a przynajmniej nie zamierzał robić tego od razu .	zamierzał	10	Masc
Ilość plam pulsujących w jego oczach mnożyła się w zastraszającym tempie .	mnożyła	6	Fem
Widać , że położył się w ubraniu , bo spod kołdry wystają stopy i nieco obszarpane nogawki spodni .	położył	3	Masc
Podnieśliśmy go , położyli na ławce .	położyli	3	Masc
Przygrywały kapele , występowały zespoły i soliści .	Przygrywały	0	Fem
W Etiopii 21 osób zginęło w katastrofie autobusu .	zginęło	4	Neut
Ukończyły wyścig razem , trzymając się za ręce .	Ukończyły	0	Neut
Nie pamiętam szczegółów , ale coś podobnego już zaszło .	zaszło	8	Neut
Adam przyjechał natychmiast .	przyjechał	1	Masc
Wiślana smuga wtopiła się w szarość horyzontu .	wtopiła	2	Fem
Miał napady agresji , wpadał w histerię .	wpadał	4	Masc
Pseudokibicom ze Stalowej Woli upiekło się , choć nieźle w sobotę nabroili .	upiekło	4	Neut
Pokręciła głową .	Pokręciła	0	Fem
21 sierpnia 1944 roku rozegrała się w tym miejscu pierwsza po 1939 roku regularna bitwa pomiędzy oddziałami Armii Krajowej i Armii Czerwonej .	rozegrała	4	Fem
On umarł siedząc przy stole .	umarł	1	Masc
Nos odgryzł syn .	odgryzł	1	Masc
Z lodówki wyjęła niewielki dozownik wypełniony rubinową cieczą i bardzo ostrożnie wcisnęła go do otworu w pudełku .	wyjęła	2	Fem
Tym głównie Stronnictwo będzie się różniło od większości europejskich partii chadeckich , w których liberalizm gospodarczy miesza się z ideami socjaldemokratycznymi i nauką społeczną Kościoła .	różniło	5	Neut
Głosowało 381 posłów .	Głosowało	0	Neut
Nie sądź , a nie będziesz sądzony , uspokoiła się .	uspokoiła	8	Fem
Ulice zamieniły się w nieprzejezdne rozlewiska .	zamieniły	1	Fem
Wypadła m ze sklepu i pobiegła m na umówione miejsce .	Wypadła	0	Fem
Nie chciała i nie miała czasu .	miała	4	Fem
Zachrobotało w bramie , zachrzęściło i błysnęła latarka Softa .	Zachrobotało	0	Neut
Zaprószono ogień i wybuchł poważny pożar na górnych piętrach .	wybuchł	3	Masc
Zarejestrował w urzędzie skarbowym fikcyjną pożyczkę na kwotę 500 tys . zł .	Zarejestrował	0	Masc
Mimo tego nie udał się uniknąć wypadków .	udał	3	Neut
Z jakiego powodu tak zaskoczyło ono paleoantropologów ?	zaskoczyło	4	Neut
Stali wśród namiotów , w których krzątali się nadwołżańscy Niemcy , zruszczeni po wiekach .	Stali	0	Masc
Wczoraj wszystko prysło jak bańka mydlana !	prysło	2	Neut
Policję zaalarmowała pracownica jednego z krakowskich szpitali .	zaalarmowała	1	Fem
Podziękowała m raz jeszcze i zwróciła m futro .	zwróciła	5	Fem
Czy doszła do Pana moja Scena Zazdrości ?	doszła	1	Fem
Oficer wyszedł , rencistka odkręciła gaz .	odkręciła	4	Fem
Słyszała jakieś głosy , wokół niej zrobił się ruch , a potem nagle wszystko ucichło .	Słyszała	0	Fem
Nie wypaliło !	wypaliło	1	Neut
Nie ustąpiła .	ustąpiła	1	Fem
Agent Pawłow nieustannie wodził wzrokiem za kapitanem , pilnie nadstawiał ucha .	wodził	3	Masc
Ich przedstawiciele , służąc w Gwardii Szlacheckiej , dodawali splendoru Stolicy Piotrowej , a jednocześnie znajdowali tam niejednokrotnie środki dla wygodnego życia , ponieważ za swą służbę otrzymywali pensje .	dodawali	8	Masc
Wrześniowe wybory zmieniły polityczny układ parlamentu .	zmieniły	2	Neut
Milcząco przywitał się z teściem i szorstko odprawił syna do odrabiania lekcji .	odprawił	7	Masc
Na początku września opracowali plan , który po tygodniu zrealizowali .	zrealizowali	9	Masc
Zawalili śniegiem całą górę nierówno i musiało strzelić .	musiało	6	Neut
– ale ten system się na początku nie zajmował artystami .	zajmował	8	Masc
Przytrzymał em ją za rękę .	Przytrzymał	0	Masc
Lżejsze podpórki chwytał po dwie i prawie biegnąc rzucał je na platformę .	rzucał	8	Masc
Podczas poprzedniej wojny dowodził własnym batalionem i , jak zapewniał , miał jeńców na tuziny .	zapewniał	9	Masc
Jednak główną rolę w pracy nad brzmieniem płyty odegrały gitarzystka Wendy Melvoin i grająca na instrumentach klawiszowych Lisa Coleman .	odegrały	8	Fem
Rozebrał się , wszedł do rzeki , zanurkował przy urwistym brzegu .	Rozebrał	0	Masc
Było też paru oficerów z polskiej jednostki w Legnicy .	Było	0	Neut
Mariola odstawiła torebkę na malutki stołeczek .	odstawiła	1	Fem
Stało się oczywiste , że porozumienia są możliwe i owocne .	Stało	0	Neut
Potem zagrzmiało , owiał go płomień i stracił przytomność .	zagrzmiało	1	Neut
W zamian będzie pobierał opłaty za miejsce do handlowania .	pobierał	3	Masc
- Będzie biegł od zatoczki autobusowej przy Sandomierskiej do budynku Urzędu Gminy .	biegł	2	Masc
Znał w mieście każdą uliczkę i każdy zaułek .	Znał	0	Masc
Pokręciła głową i usiadła na krześle .	Pokręciła	0	Fem
Mag osunął się bezwładnie .	osunął	1	Masc
Al Gore skoncentrował na jego zdolności dawania odporu tego typu taktyce .	skoncentrował	2	Masc
Ten wiersz Dominika przykleiła sobie nad biurkiem , a Jadzia dziwiła się .	przykleiła	3	Fem
Przygwożdżonemu ich argumentacją Mister O'Gorckowi zawsze pozostawało się wycofać .	pozostawało	6	Neut
Ceną za to opóźnienie okazał się udział w rynku francuskim .	okazał	4	Masc
Zapanowało milczenie .	Zapanowało	0	Neut
Następnie była Droga Krzyżowa , w czasie której występowały dzieci .	występowały	8	Neut
Tę dwuletnią szkołę pomaturalną ukończyło 15 absolwentów .	ukończyło	4	Neut
– Od wiosny całe miasto przygotowywało się na zimę .	przygotowywało	5	Neut
R . pomagał ukryć zwłoki .	pomagał	2	Masc
Zarzucał nas wiadomościami o długiej zimie .	Zarzucał	0	Masc
wszystkich pozwalniali . .	pozwalniali	1	Masc
Krystyna Kofta ogłosiła , że przyjmuje na siebie misję walki o równouprawnienie Bożen z Krystynami i za dwa lata zaprosiła panie do Trójmiasta , by równość tę udowodnić .	zaprosiła	19	Fem
– kto zaryzykował ?	zaryzykował	2	Masc
Zośka lekko się zmieszała .	zmieszała	3	Fem
Nad falami sterczał jeszcze tylko wystrzelający pionowo dziób .	sterczał	2	Masc
Okoliczności ułożyły się idealnie , by m przekroczył próg .	przekroczył	7	Masc
Na obiedzie byli Józewscy .	byli	2	Masc
Coś się we mnie zacięło .	zacięło	4	Neut
Malwina spojrzała na niego z odrazą , Kulesza się zaczerwienił , ale Ewa , o dziwo , parsknęła śmiechem .	parsknęła	17	Fem
Ten biało - czarny kocur zdobył szturmem serca pracowników Downing Street , a z czasem jego sława rozprzestrzeniła się na cały kraj .	rozprzestrzeniła	17	Fem
Oczom Andrew ukazał się nieprawdopodobny widok .	ukazał	2	Masc
Wziął em lodowaty prysznic , po śniadaniu wyłączył em telefony i w ciszy gabinetu nastawił em w pamięci taśmę mojego życia .	wyłączył	7	Masc
Podobało mi się .	Podobało	0	Neut
- Apteka zachowała się niedobrze .	zachowała	2	Fem
- Wyszło , że mam o 0,65 metra większe mieszkanie .	Wyszło	1	Neut
Msza żałobna odbyła się pod gołym niebem .	odbyła	2	Fem
Uroiła sobie , że lekarze chcą ją zabić .	Uroiła	0	Fem
Nad bezpieczeństwem w Zachodniopomorskiem czuwało 2500 policjantów , w tym 500 z drogówki .	czuwało	4	Neut
- Wiedział Jacek .	Wiedział	1	Masc
Zaraz potem zaczęli się spotykać .	zaczęli	2	Masc
Było ich tyle , że trudno by wypatrzyć chociaż skrawek wolnego miejsca .	Było	0	Neut
46-letni Marek Ch . doznał jedynie złamania prawej nogi .	doznał	4	Masc
Posmutniał em i ona to dostrzegła .	Posmutniał	0	Masc
Nie przewidywały , że na własnej piersi wyhodują sobie takiego gada .	przewidywały	1	Fem
Przypomnijmy , że podczas strzelaniny w Warszawie policja i prokuratura uznały , że funkcjonariusz słusznie sięgnął po broń .	uznały	10	Fem
Zwłoki psa trafiły do wrocławskiego schroniska dla zwierząt .	trafiły	2	Neut
Pękali śmy z dumy .	Pękali	0	Masc
Przymknął oczy i trwał w zadumie nie słysząc nawet roztrzepanej gadaniny niezliczonych wróbli .	Przymknął	0	Masc
Gdy na miejscu zjawili się policjanci z komisariatu kolejowego policji , schronisko znajdowało się w opłakanym stanie .	zjawili	3	Masc
Nagle wyskoczył stamtąd ku Maćkowi i uderzył go pięścią w twarz .	wyskoczył	1	Masc
Otworzyła m radio i słuchała m muzyki .	Otworzyła	0	Fem
Sylwetka loki chwiała się w oczach Awaru , głowa stawała się coraz cięższa .	chwiała	2	Fem
Chyba schodziły z niego te ostatnie kreski .	schodziły	1	Fem
Reformy ograniczono do totalnej prywatyzacji , która przyjęła raczej ramy wyprzedaży majątku narodowego .	przyjęła	7	Fem
Trzech sprytnych chłopców szukało nawet syrenki w przedszkolnym akwarium .	szukało	3	Neut
Celowo wyrażał em także inne wątpliwości .	wyrażał	1	Masc
Kłamstwo było przykre i onieśmielało .	onieśmielało	4	Neut
Uniemożliwiła mu to bardzo ofensywna postawa Raftera .	Uniemożliwiła	0	Fem
Krysia pociągnęła nosem i zaśmiała się .	zaśmiała	4	Fem
Stała pusta , niszczała , groziła zawaleniem .	groziła	5	Fem
Myślała ś o mnie .	Myślała	0	Fem
Nie słyszał , o czym mówili .	słyszał	1	Masc
Zdobył też wiele prestiżowych nagród .	Zdobył	0	Masc
Napięta żyłka świsnęła i pękła w przeponie .	pękła	4	Fem
Kilka par tańczyło w przyćmionym świetle , które zdawało się być substancją podobną do mgły z tiulu .	tańczyło	2	Neut
Jego serce ledwie się ruszało .	ruszało	4	Neut
Doceniała to .	Doceniała	0	Fem
Chcemy , by lepiej rozumiały siebie , a one tego nie potrafią .	rozumiały	4	Neut
Powracali tam ci dawno pożegnani .	Powracali	0	Masc
Ministerstwo Rolnictwa , które przed rokiem obłożyło miód importowany opłatami wyrównawczymi , opracowało długofalowy program rozwoju pszczelarstwa .	obłożyło	6	Neut
Zanim wiązanki kwiatów przykryły mogiłę , słowa modlitwy prowadzonej przez ks . Pawła Dorucha splatały się z wyrazami bólu i wspomnieniami przyjaciół .	przykryły	3	Fem
Mieszkała m w Dobrziszu .	Mieszkała	0	Fem
Wszystko się w mojej twarzy zmieniło .	zmieniło	5	Neut
W Chadaju odezwała się podlaska dusza .	odezwała	2	Fem
Zapadł książę w dumanie posępne .	Zapadł	0	Masc
Milcząc , spuściła wzrok .	spuściła	2	Fem
Stało się dokładnie tak , jak zaplanowały .	Stało	0	Neut
Ponieważ na pukanie nikt nie reagował , policjanci wyważyli drzwi .	reagował	5	Masc
Zrobił em szybko dwa przysiady i skierował em się do łazienki .	Zrobił	0	Masc
Czy nie było by lepiej , gdyby on rozwijał naukę , kształcił uczniów , a uczelnią zajmował się specjalista od zarządzania ?	rozwijał	8	Masc
Żadne nie wiedziało .	wiedziało	2	Neut
Cóż znaczyło ośmiu ludzi wobec zbrojnych i groźnych tysięcy ?	znaczyło	1	Neut
Coś poruszyło się z tyłu , za ramieniem dziesiętnika .	poruszyło	1	Neut
Jednak nawet wtedy eksperci zgodnie twierdzili , że boom internetowy kiedyś wróci .	twierdzili	5	Masc
Andrzej Michaluk wybiegł na dach z kocem .	wybiegł	2	Masc
Ponoć nie życzyli sobie ich obecności inni dziennikarze . . .	życzyli	2	Masc
Dotychczas obowiązek donoszenia WKU o studentach , którzy przerwali naukę , spoczywał na uczelniach .	przerwali	8	Masc
Zjechali i zaczęła się sakramencka mordęga .	Zjechali	0	Masc
Niedawno zapytał darłowskie dzieci , kim był król Eryk .	zapytał	1	Masc
Niebacznie stanął pod nawisem , oberwało się i przywaliło .	przywaliło	8	Neut
Wczoraj wszystko prysło jak bańka mydlana !	prysło	2	Neut
Do zdarzenia doszło w środę około godziny 20 .	doszło	2	Neut
Dowiedziała m się , że mój rozmówca z powodu swojego wzrostu pracował na budowie .	Dowiedziała	0	Fem
Obok czterech żołnierzy kopało dół .	kopało	3	Neut
Na weselu bawiło się prawie 150 gości .	bawiło	2	Neut
Pałęczkę przejęła Ciri .	przejęła	1	Fem
Ajataka wzruszyła ramionami i pociągnęła mnie do windy .	pociągnęła	4	Fem
Krysia pociągnęła nosem i zaśmiała się .	pociągnęła	1	Fem
Bała się .	Bała	0	Fem
Bardzo przydało by się nazwisko leśniczego .	przydało	1	Neut
Starą szopę Elżbieta S . zamieniła na fabrykę narkotyków .	zamieniła	5	Fem
Kiedy się ocknął , szarzało .	szarzało	4	Neut
Pozbył się balastu , nim ten balast odebrała mu zamieć historii .	odebrała	7	Fem
przy drodze stały drzewa . .	stały	2	Neut
Przyjęcie odbywało się w starym pałacu cesarza .	odbywało	1	Neut
Głosowało 427 posłów .	Głosowało	0	Neut
Patrzył em , jak zasnuwały horyzont .	zasnuwały	4	Fem
Zresztą nawet bez Twego wyznania dalo się to odczuć .	dalo	5	Neut
Miasto otuliła mgła .	otuliła	1	Fem
Jak dotychczas w Oxfordzie nie doszło do żadnych incydentów .	doszło	5	Neut
Wychodził do pracy świtem , wracał w ciemności .	wracał	5	Masc
Po chwili przyjechał fotograf i wszystko stało się jasne .	stało	6	Neut
Pomogli mu , podnieśli też z trudem kolumnę zaklinowaną w kącie i osadzili na trzonie .	podnieśli	3	Masc
- Nie chcą , bym ich utrzymywał .	utrzymywał	6	Masc
Ale trzej bracia nie zważali na przeszkody .	zważali	4	Masc
Podeszła po pieniądze .	Podeszła	0	Fem
Wydało mi się , że to mi przywróci równowagę .	Wydało	0	Neut
Podziękował i wstał .	Podziękował	0	Masc
U ludów słowiańskich rodzina miała charakter patriarchalny , a przewodził jej ojciec .	przewodził	9	Masc
Ich odrobienie przekraczało siły jednego pokolenia .	przekraczało	2	Neut
Na Siemiradzkiego wybrzydzali krytycy , ale publiczność uwielbiała jego obrazy .	wybrzydzali	2	Masc
Zaczęła zaraz pośpiesznie mówić , choć wiedziała najwyraźniej , że jej nie słucha .	Zaczęła	0	Fem
Zamierzał ją zawieść do inseminatora .	Zamierzał	0	Masc
Po obu stronach rosły drzewa .	rosły	3	Neut
Nikogo nie werbowała m .	werbowała	2	Fem
Woziła m cię w wózku po bazie i myślała m , że oszaleję .	Woziła	0	Fem
Poszła m do drugiej .	Poszła	0	Fem
– ja sobie to wyobraziła m inaczej .	wyobraziła	4	Fem
Do obozu pozostało jeszcze parę kilometrów .	pozostało	2	Neut
Od pól wiało melancholią października .	wiało	2	Neut
Odrzucił płaszcz , czoło miał zroszone potem .	Odrzucił	0	Masc
Prezydent zaprzeczył i wytoczył nam proces .	wytoczył	3	Masc
Uśmiechnęła się do Hehego .	Uśmiechnęła	0	Fem
Jak się dowiedział dziennikarz PAP , zrezygnował z policyjnej eskorty .	dowiedział	2	Masc
Odbył jedynie krótką telefoniczną pogawędkę z prezydentem ZSRR Gromowem .	Odbył	0	Masc
W połowie maja laweciarze zorganizowali protest na przejściach granicznych .	zorganizowali	4	Masc
Tym razem gościła go prywatna Wyższa Szkoła Dziennikarstwa .	gościła	2	Fem
Wszystkie grupy otrzymały radiomagnetofon i toster .	otrzymały	2	Fem
Małe szare oczka wpatrywały się we mnie drwiąco , wyraźnie triumfowała .	triumfowała	10	Fem
- Mógł by ś obrać ?	Mógł	1	Masc
Poranna Łunia świeciła nad miastem Krakowem , gdy wsiadałam do pociągu .	świeciła	2	Fem
Strażacy oflagowali samochody i wywiesili transparenty .	wywiesili	4	Masc
Co innego zaprzątało jej już główkę .	zaprzątało	2	Neut
Z wnioskiem takim wystąpił naczelnik OSP Arkadiusz Pindral .	wystąpił	3	Masc
Najwyraźniej przebiegł przez holo tej reklamy .	przebiegł	1	Masc
Wśród tradycjonalistów muzułmańskich z państw Półwyspu Arabskiego wywołało ono szok .	wywołało	7	Neut
Kaśka jeździła na nartach ?	jeździła	1	Fem
Zwiedzili także Warszawę .	Zwiedzili	0	Masc
Uzywa Pan terminów , których pan nie zdefiniował .	Uzywa	0	Masc
Pierwsze i drugie miejsce zajęły słowackie dziewczęta , ubrane w getry i krótkie falbankowe spódniczki .	zajęły	4	Neut
Lampa przygasła .	przygasła	1	Fem
Wyprostował się .	Wyprostował	0	Masc
U ludów słowiańskich rodzina miała charakter patriarchalny , a przewodził jej ojciec .	przewodził	9	Masc
Opadły mi ręce . . .	Opadły	0	Fem
Poruszyłem się na łóżku , które odpowiedziało sprężyście .	odpowiedziało	6	Neut
Nie uważał siebie nigdy za lepszego od obu tych kolegów .	uważał	1	Masc
Co się z panem działo ?	działo	4	Neut
Dotknęła brudnego bandaża , którym owijała opornik .	Dotknęła	0	Fem
W ubiegłym roku bracia Lunelli osiągnęli kolejny pułap .	osiągnęli	5	Masc
Analiza spektrometryczna wykazała , że jego skład izotopowy jest typowy dla procesów reaktorowych , a nie wybuchu jądrowego .	wykazała	2	Fem
– Zwierzęta skinęły głowami .	skinęły	2	Neut
Zeznał on , iż został pobity przez nieznanego osobnika .	Zeznał	0	Masc
Niektóre sprawy trafiły nawet do kolegium .	trafiły	2	Fem
Towarzyszyło im oko obiektywu .	Towarzyszyło	0	Neut
śledztwo wykazało , że zapłon i pojemnik były produkcji zachodnioniemieckiej .	wykazało	1	Neut
Neandertalczycy żyli w Europie dwieście tysięcy lat .	żyli	1	Masc
Przed wojną jej osobiście nie znał em .	znał	5	Masc
Na kostce drżało całe ciało zawodników .	drżało	2	Neut
Prosze ułożyć mi coś , żeby ludzie zębami zgrzytali , włosy darli , płakali , ale i równocześnie wroga szukali . . .	szukali	19	Masc
– Dziadek mi kazał .	kazał	3	Masc
To się znów bardzo Janikowi podobało .	podobało	5	Neut
Prosze ułożyć mi coś , żeby ludzie zębami zgrzytali , włosy darli , płakali , ale i równocześnie wroga szukali . . .	darli	11	Masc
W chwili kiedy Julia wypowiedziała te słowa , dla Andrew zatrzymał się czas .	wypowiedziała	4	Fem
Na witrynie umieścili też nazwiska ponad 500 znanych ludzi , którzy podpisali się pod protestem przeciwko zakazowi Marszu Równości .	umieścili	2	Masc
Słuchaj , Piotr był zalany , spadał ze schodów , wyskakiwał z okna .	wyskakiwał	10	Masc
W szybkim tempie spijało rosę .	spijało	3	Neut
W Laskach w liturgii uczestniczyło się przez cały dzień i modliło się wszędzie .	uczestniczyło	4	Neut
Nawet duże lustro na staroświeckiej komodzie służyło z pewnością do różnych celów .	służyło	6	Neut
W Olsztynie pod drzwiami szpitalnymi zmarły ostatnio dwie osoby .	zmarły	5	Fem
Kiedy Anna Maria poznała swojego przyszłego męża , niewiele wiedział o Generale .	poznała	3	Fem
Robotnicy tylko wtedy poprą reformę , jeśli będą mieli jakieś zabezpieczenie .	mieli	8	Masc
– i nic się nie działo ?	działo	5	Neut
Procesję prowadził biskup Alojzy Orszulik .	prowadził	1	Masc
Ostatnio tyle razy wyobrażała m sobie , że się do niego zbliżam .	wyobrażała	3	Fem
Płacić również nie zamierzały .	zamierzały	3	Fem
Ukończyła tylko drugą klasę podstawówki .	Ukończyła	0	Fem
Spóźnili śmy się . . .	Spóźnili	0	Masc
Słońce ogrzewało twarz i osuszało stopy .	ogrzewało	1	Neut
Na spotkanie z Jeffreyem przyszła spóźniona , umówili się w kawiarni nieopodal opery .	umówili	7	Masc
Ogromnie interesowało ich , co z tych zabiegów wyniknie .	interesowało	1	Neut
Ciągnęła monolog , w którym celnie uwypukliła nieludzkie cechy jego matki .	Ciągnęła	0	Fem
Potem usiadł na brzegu łóżka i ukrył twarz w dłoniach .	ukrył	6	Masc
Na chwilę twarz zakryła dłońmi , zabłysła złota obrączka .	zakryła	3	Fem
Zawahała się , chwyciła plik , położyła na stoliku i podniosła słuchawkę .	położyła	6	Fem
Wyborcom oświadczono , że będą musieli przyjść nieco później .	musieli	5	Masc
W ataku grali Michalis Konstantinou i Nikos Liberopoulos .	grali	2	Masc
Z pożaru uratowała się czternastoletnia Stefania Nowaczuk .	uratowała	2	Fem
- Meneli naszło się z całego osiedla .	naszło	2	Neut
W czwartek do egzaminu ustnego z historii przystąpiło 94 maturzystów , w piątek natomiast 59 miłośników biologii popisywało się wiedzą z tej dziedziny .	popisywało	17	Neut
Podczas przyjęcia dowiedziała m się , dlaczego tak uczynił .	dowiedziała	2	Fem
Należało spróbować nawiązać łączność .	Należało	0	Neut
Ale później , w latach sześćdziesiątych , wywiązała się intensywna publiczna debata na temat stosunków polsko - niemieckich . . .	wywiązała	7	Fem
Galerii handlowych świadomie nie bojkotowali , bo z nich nadal czerpali kasę .	czerpali	10	Masc
Kochał Dorę , ale nie potrafił odejść od Zofii , swej żony .	Kochał	0	Masc
Rzeczywiście Stopina rozwieszała w ogrodzie bieliznę .	rozwieszała	2	Fem
Jak to wyglądało ?	wyglądało	2	Neut
Zrobił eś wóz ?	Zrobił	0	Masc
Parowozy zawsze fascynowały i przerażały .	przerażały	4	Masc
Zawód odmalował się na twarzy Feliksa .	odmalował	1	Masc
Kusiły , by zajrzeć do środka .	Kusiły	0	Neut
Zimna woda tryskała na głowę , szyję i płonące uszy .	tryskała	2	Fem
Połowa zareagowała na leczenie pozytywnie .	zareagowała	1	Fem
Małgorzatka zbudziła się zlana potem .	zbudziła	1	Fem
Światło zgasło jednak po dwóch minutach .	zgasło	1	Neut
W GROM-ie dostały by 3 .	dostały	2	Fem
Tylko woda bluznęła .	bluznęła	2	Fem
Tutaj przecież ich rodzina mieszkała i tu mama się urodziła .	urodziła	9	Fem
- Wyznał .	Wyznał	1	Masc
Prosi się też zakłady pracy , które dysponują autobusami , by wspomogły komunikację zastępczą .	wspomogły	11	Masc
Na Suwalszczyźnie złamało się 6 słupów , nie pracuje 50 stacji transformatorowych .	złamało	2	Neut
Było przestronnie , panowała spokojna , sympatyczna atmosfera .	Było	0	Neut
Przekazał em informację dyżurnemu , aby to wyjaśnił .	Przekazał	0	Masc
Nasilił się w październiku 2000 roku .	Nasilił	0	Masc
Zawsze wygrywał , bo był najszybszy .	wygrywał	1	Masc
Ani mu się śniło opowiadać o słonecznej wiośnie .	śniło	3	Neut
Uczyniło się raptem cicho .	Uczyniło	0	Neut
Przypuszcza , że uczył się nowych słów .	uczył	3	Masc
U ludów słowiańskich rodzina miała charakter patriarchalny , a przewodził jej ojciec .	miała	4	Fem
Kiedy dziecko nie wróciło do domu , rodzina samodzielnie rozpoczęła poszukiwania .	wróciło	3	Neut
Rozbili śmy na jezdni dwa świeże jaja .	Rozbili	0	Masc
Do tragedii doszło na łuku drogi ; rozpędzony pojazd zjechał do wypełnionego wodą rowu i przycisnął dziecko .	doszło	2	Neut
Mógł by zmienić zdanie , gdyby AWS i UW razem zaproponowały mu , by reprezentował je w wyborach .	zaproponowały	10	Fem
Jego anegdoty traktowały o najrozmaitszych księżach dziwakach , których w okolicy nie brakło , a których przygody tchnęły często humorem z epoki Seweryna Soplicy czy nawet Paska .	brakło	12	Neut
- Namierzyli ciebie , odsłuchają treść rozmowy .	Namierzyli	1	Masc
Henryk informował , że Jenny przespała granicę i nikt jej nawet nie budził .	przespała	5	Fem
Po trzech dniach Śpiąca Królewna wróciła do Warszawy .	wróciła	5	Fem
W końcu lipca przyjechał po mnie Ojciec i pojechali śmy do Kielc .	przyjechał	3	Masc
Przechodził on długą ewolucję , stając się najpopularniejszym tanim zegarkiem .	Przechodził	0	Masc
Dziś to się uciszyło .	uciszyło	3	Neut
- Stało za rogiem .	Stało	1	Neut
Zdaniem obrońców polecenie osadzenia Chodorkowskiego w pojedynczej celi przyszło z samego Kremla , który chce złamać byłego szefa koncernu naftowego .	przyszło	8	Neut
Mijały sekundy .	Mijały	0	Fem
Wyschły źródła .	Wyschły	0	Neut
Towarzystwo oddelegowało kilku rzeczoznawców do pełnienia dyżurów i udzielania porad konsumentom .	oddelegowało	1	Neut
Powołana przez burmistrza komisja dokonała kontroli w Ośrodku .	dokonała	4	Fem
Do kraju powróciły uprowadzone Polki .	powróciły	2	Fem
Decyzje w tej sprawie podjęły Mostostal Warszawa , Elektrim , Polifarb i Okocim .	podjęły	4	Masc
Zwierzenia Ani poruszyły mnie do głębi .	poruszyły	2	Neut
Potem jeszcze kaszkę ryżową dał em .	dał	4	Masc
Nauczyciele wymienili spojrzenia .	wymienili	1	Masc
Francuskie Zgromadzenie Narodowe uchwaliło wczoraj kontrowersyjną ustawę o skróceniu obowiązkowego tygodnia pracy z 39 do 35 godzin .	uchwaliło	3	Neut
Polska powoli suszyła się po wielkiej powodzi , a uwaga Czytelników kierowała się na politykę .	kierowała	11	Fem
W Małej Komorzy z tego powodu zapaliły się sadze .	zapaliły	6	Fem
Myślała m , że odkryła m to w tym tygodniu !	odkryła	4	Fem
- Ale dzieci lubiły się tam bawić .	lubiły	3	Neut
Robiły śmy kanapki , stroiły śmy półmiski .	Robiły	0	Fem
IZABELLE ADJANl , gwiazda filmu francuskiego , wygrała precedensowy proces .	wygrała	7	Fem
- Spotkali śmy się , towarzyszu rektorze . . .	Spotkali	1	Masc
Głosowało 364 posłów .	Głosowało	0	Neut
Musiały jej powiedzieć , teraz .	Musiały	0	Fem
Załadował na wóz wynajętych gazeciarzy i rozwiózł po mieście , każąc rozdawać list przechodniom .	rozwiózł	6	Masc
Dziecko znalazło by się w niebezpieczeństwie , gdyby motłoch je odkrył .	odkrył	10	Masc
Odgłosy tego polskie media zagłuszały białoruską wrzawą .	zagłuszały	4	Neut
Oni myśleli , że byłam nówka i Miszka mnie rozdziewiczył .	rozdziewiczył	9	Masc
Dlaczego wymyśliła to nieślubne dziecko ?	wymyśliła	1	Fem
W końcu przyznał się do winy .	przyznał	2	Masc
Wizytator przeprosił kierownika i udał się z powrotem do klasy szóstej .	przeprosił	1	Masc
W Wielkopolsce na nową maturę zdecydowało się 522 abiturientów .	zdecydowało	5	Neut
W poniedziałek dwaj gorzowianie podbili ją do 1.000 zł .	podbili	4	Masc
Zaczął eś dobrze , wiesz , o kogo chodzi .	Zaczął	0	Masc
Komory zadziałały , ale organizm był już zbyt wycieńczony .	zadziałały	1	Fem
Nazwisko wyleciało z głowy .	wyleciało	1	Neut
Wielka Rada zbierała się już ponad dwadzieścia lat , a nigdy nie doszło na niej do głosowania . . .	doszło	12	Neut
Ale kiedy wymagało by to przekroczenia granic prawa , Bill powstrzymał się z pomocą .	wymagało	2	Neut
Za metą w Wengen potłukł się .	potłukł	4	Masc
Trzech innych wytoczyło księdzu oddzielny proces .	wytoczyło	2	Neut
Wciąż nie rozpoznawał barwy jej oczu .	rozpoznawał	2	Masc
Do programu zgłosiły się cztery powiaty .	zgłosiły	2	Masc
Poprosił em marszałka o wyznaczenie mediatora .	Poprosił	0	Masc
Zrobiła swoje .	Zrobiła	0	Fem
Coś się poruszyło .	poruszyło	2	Neut
Usamodzielniły się Wyry , Bojszowy , Lędziny i Bieruń .	Usamodzielniły	0	Neut
Wyborcy zdecydowali , że powinni zasiąść w Sejmie .	zdecydowali	1	Masc
Lecz spojrzawszy na Polka umilkła .	umilkła	4	Fem
A kiedy tak się stało , powstał problem ze zdobyciem odpowiednich dowodów .	stało	4	Neut
Ciotka nie przysyłała dolarów , ciotka brodatego syna Cybucha rozwijała świadomość .	rozwijała	9	Fem
Nawet bałem się ją tknąć , ale mnie uspokoiła , że jest w porządku . . .	uspokoiła	8	Fem
Te słowa powstały po to , by je ze sobą połączyć .	powstały	2	Neut
– Nie mam już tego kawałeczka skórki , jeśli o to chodzi , ale wszystko tylko na tym się skończyło .	skończyło	19	Neut
Identyfikowała go z komunizmem !	Identyfikowała	0	Fem
W roku 1912 Olga w związku z kolejną przygotowującą się pod jej nieobecność wystawą zasięgnęła rady Sainsèrea przy wyborze obrazów .	zasięgnęła	14	Fem
Owinął em się w koce i zasnął em .	zasnął	6	Masc
Niebacznie stanął pod nawisem , oberwało się i przywaliło .	przywaliło	8	Neut
Skończyła makijaż i zaczęła przeglądać ciuchy .	Skończyła	0	Fem
Wyglądał tak samo jak co dzień w drodze do biura .	Wyglądał	0	Masc
Witała m siostrzeńca i przepraszała m go za kłamstwo moich przełożonych .	przepraszała	4	Fem
Z nowym rokiem weszło w życie nowe prawo dewizowe .	weszło	3	Neut
- Sapnęła , ale pod warstwą chłodu zamajaczyła iskierka rozbawienia .	zamajaczyła	7	Fem
Żona kamienicznika prowadziła sklep z żyrandolami i żarówkami .	prowadziła	2	Fem
Dżabie odbiło się walerianą .	odbiło	1	Neut
Jej mąż nigdzie nie pracował , ale nie mieli materialnych kłopotów .	mieli	8	Masc
- Wczoraj się mył em .	mył	3	Masc
Dlaczego tego nie zrobiła m ?	zrobiła	3	Fem
Nigdy tego nie jadła m !	jadła	3	Fem
O co im poszło ?	poszło	3	Neut
Istotnie , w damskim pokoju aż syczało .	syczało	6	Neut
Z decyzji cieszą się związkowcy , którzy żądali odwołania dyrektora .	żądali	7	Masc
Należało to robić dokładnie , inaczej paczki spadały przy wjeżdżaniu do windy .	spadały	7	Fem
Poszukiwania przy użyciu śmigłowca trwały całą niedzielę .	trwały	4	Neut
Zdziwiła się i nic nie odrzekła .	odrzekła	5	Fem
Leżała na wersalce z nosem wtulonym we włochatą poduszeczkę .	Leżała	0	Fem
PRZEGRAŁ EŚ !	PRZEGRAŁ	0	Masc
- Rozmawiał pan z Filipiakiem ?	Rozmawiał	1	Masc
Wypytywała rodaków o Warszawę , interesowała się przeżyciami Tomka w czasie wyprawy i nawet namawiała go usilnie , aby pozostał w Australii .	namawiała	14	Fem
Wprowadzenie rozwiązań proponowanych przez SLD prowadziło by do wynaradawiania .	prowadziło	5	Neut
Przez następne stulecia przylgnęła do niej raczej sława rozpustnicy i zdrajczyni .	przylgnęła	3	Fem
- Przecież to dziecko bezgranicznie mu ufało .	ufało	6	Neut
Czterech ludzi nie żyło prawie na pewno .	żyło	3	Neut
Klepał Jazończyka po ramieniu , ciągle ze śmiechem , mimo że twarz tamtego wyrażała surową powagę .	wyrażała	13	Fem
- Wymknęło ci się , że przesadą było by zginąć za komunizm .	Wymknęło	1	Neut
Niezdecydowanie obracała papier w rękach .	obracała	1	Fem
Spojrzał Pan na nagłówek ?	Spojrzał	0	Masc
W piątek wieczorem odwiedziły ją w domu i namówiły na spacer .	namówiły	8	Fem
Ale Semena nie znał em .	znał	3	Masc
Mam prawo przypuszczać , że reakcje Polaków w takim wypadku odbiegały by od zachowania Amerykanów .	odbiegały	10	Fem
Klaskał mu prezydent Kwaśniewski oraz zgodnie prawa i lewa strona .	Klaskał	0	Masc
Kilka osób spytało mnie , czy jestem dzięki feminizmowi szczęśliwsza .	spytało	2	Neut
– Ojciec Benedykt służył tutaj ?	służył	3	Masc
Podczas którejś kolacji wyznał , że przez kilkanaście lat uprawiał pięściarstwo .	uprawiał	9	Masc
Przedtem nie mówiło się o nim , bo żył .	mówiło	2	Neut
Papieros sparzył mi palce , rzuciłem go w śnieg .	sparzył	1	Masc
Z początkiem bieżącego roku Ministerstwo Oświaty i Wychowania podwyższyło uczniowskie stypendia .	podwyższyło	8	Neut
Powiedziała Elizabeth , iż jest Polką , a to miasto kiedyś należało do Polski .	należało	11	Neut
Licznie przybyła publiczność zajęła miejsca przy stołach biesiadnych , na obszernym trawniku lub obok sceny .	zajęła	3	Fem
Rozmawiał eś z nim .	Rozmawiał	0	Masc
Wyrósł z tamtego świata .	Wyrósł	0	Masc
Straciła w powstaniu dwóch synów i męża .	Straciła	0	Fem
Słońce wyrwało się z pęt horyzontu i zaczęło uwalniać dusze z martwych ciał żołnierzy .	zaczęło	7	Neut
Recepcjonistce oczy rozszerzyły się ze zdumienia .	rozszerzyły	2	Neut
Konsorcjum umożliwiło by wspólne finansowanie inwestycji .	umożliwiło	1	Neut
O tych wątpliwościach pisała regionalna prasa .	pisała	3	Fem
Wszystko wskazywało na to , że jednak tak nie było , ale należało to dokładnie sprawdzić .	wskazywało	1	Neut
Nie posiadała pani Klaudia urody .	posiadała	1	Fem
Czy zamienił by ś wszystkie swoje osiągnięcia na olimpijski medal ?	zamienił	1	Masc
Ruszył przed siebie .	Ruszył	0	Masc
W Polsce przebywała delegacja parlamentarzystów tureckich .	przebywała	2	Fem
" Jestem inny , ale potrafię więcej , niż mogło by się wydawać .	mogło	9	Neut
Pogłębiły się zmarszczki , sczerniały sińce pod oczami ; był blady i jakby przygarbiony .	Pogłębiły	0	Fem
Ale pani Barbarze to znowu nie dogadzało .	dogadzało	6	Neut
- Urwał , machnął ręką , pochylił się do mnie .	Urwał	1	Masc
Czy ją kiedyś spotkała m ?	spotkała	3	Fem
– Miałem w kieszeni radiotelefon , w którym cały czas odzywały się policyjne komunikaty .	odzywały	10	Masc
Po tym wypadku jakby się otrząsnął .	otrząsnął	5	Masc
Czy to ta niemoc grzybowa zwiastowała ?	zwiastowała	5	Fem
I jeszcze coś szumiało .	szumiało	3	Neut
Wicemistrzynie Polski z Mielca nie dały pograć w Krakowie Wiśle i opuściły ostatnie miejsce w tabeli właśnie na rzecz podopiecznych Lesława Kędryny .	dały	5	Fem
Sześć pięknych dziewcząt rywalizowało w Miejsko - Gminnym Ośrodku Kultury w Małogoszczu o tytuł Miss Regionu Jędrzejowskiego i Włoszczowskiego .	rywalizowało	3	Neut
Wczoraj , po zamknięciu lokali wyborczych , niemieckie media zapowiedziały , że pani minister ustąpi ze stanowiska .	zapowiedziały	9	Neut
Toboła odprowadził Dębskiego na łodziowy .	odprowadził	1	Masc
Skończyło się .	Skończyło	0	Neut
Ponad 1600 osób wzięło wczoraj udział w 24 . maratonie ulicznym we Wrocławiu .	wzięło	3	Neut
Shimada wyznaczył więc ludzi i za chwilę wnętrze góry poczęło błyskać upiornym światłem palników i ożywiło się znów koszmarną krzątaniną .	ożywiło	15	Neut
Co mnie jeszcze śmieszyło ?	śmieszyło	3	Neut
NIK podkreśla , że w czasie prywatyzacji AWRSP następowało pogorszenie sytuacji ekonomicznej Polski .	następowało	8	Neut
I tym razem Gagarin zniósł ją ze stoickim spokojem .	zniósł	4	Masc
Przez całe epoki piwo było napojem do śniadania , piło się piwo z serem .	piło	9	Neut
Ale Saszkę to wzruszyło .	wzruszyło	3	Neut
Kiwnął em na barmana , żeby zapłacić .	Kiwnął	0	Masc
Czy macierzyństwo bardzo odmieniło Twoje życie ?	odmieniło	3	Neut
Angus powtarzał to wszystko , nawet , jeżeli sam w coś nie wierzył .	powtarzał	1	Masc
Sylwester pociągnął się za nos .	pociągnął	1	Masc
Głosowało 398 posłów .	Głosowało	0	Neut
Nie spała całą noc i teraz leży w łóżku .	spała	1	Fem
Powikłania doprowadziły na początku lutego do śmierci .	doprowadziły	1	Neut
Tymczasem w bufecie panna Tola czyściła koszyki do chleba .	czyściła	5	Fem
Tak bardzo pani schudła , że poznać trudno .	schudła	3	Fem
Udało się niestety uratować tylko Marię Fryc , zaś dwudziestotrzyletni jej mąż utonął .	Udało	0	Neut
Kobieta otworzyła drzwi , wpuściła do środka czarnowłosego mężczyznę .	wpuściła	4	Fem
- Starała m się pełnić jak najlepiej swoją funkcję .	Starała	1	Fem
Trubadur głosił , iż jej dochowanie należało do obowiązków damy , lecz niczego nie gwarantowało niewieście .	gwarantowało	14	Neut
Dotyczyło to zresztą wyłącznie ubioru .	Dotyczyło	0	Neut
Austria i carska Rosja niszczyły je dalej systematycznie .	niszczyły	4	Fem
Witały ich entuzjastyczne oklaski .	Witały	0	Neut
- Dowiedziała m się , że pan spotyka się od pewnego czasu z Renią .	Dowiedziała	1	Fem
– nie dała ci ?	dała	2	Fem
W jednej chwili runęło życie Michała .	runęło	3	Neut
Było cicho , spokojnie i sennie .	Było	0	Neut
Zwrócił się do mnie .	Zwrócił	0	Masc
Niosło wonią smoły i wodorostów , woda pluskała cicho o łódki przywiązane do omszałych pali .	Niosło	0	Neut
Niebieskie światełko zgasło .	zgasło	2	Neut
W tym roku o tytuł najlepszej walczyło 160 pism .	walczyło	6	Neut
Często śniło się jej , że biegnie za oderwaną ręką i nie może jej dogonić .	śniło	1	Neut
Małżonka krewnego przezornie schowała się do skrzyni i to ją uratowało .	uratowało	10	Neut
Spotkanie w urzędzie wywarło na wszystkich jego uczestnikach niesamowite wrażenie .	wywarło	3	Neut
Sam przekonał się o tym boleśnie .	przekonał	1	Masc
- Zdjęli śmy sztukę .	Zdjęli	1	Masc
Miało być dziś rano .	Miało	0	Neut
Sąd Wojewódzki dopatrzył się racji w stanowisku pozwanych .	dopatrzył	2	Masc
Dyna nie wydawał się obrażony .	wydawał	2	Masc
Uczniów to nie przekonało .	przekonało	3	Neut
Zauważył em , że po raz pierwszy powieki nie zakrywały jego źrenić , żółtych i okrągłych .	zakrywały	9	Fem
Z lodówki wyjęła niewielki dozownik wypełniony rubinową cieczą i bardzo ostrożnie wcisnęła go do otworu w pudełku .	wcisnęła	11	Fem
Słońce , rozgrzewające żołądek Gregora Smidda , rozgrzało i granat .	rozgrzało	7	Neut
Zbliżali się do niej groźnie .	Zbliżali	0	Masc
Też tam rodzili śmy .	rodzili	2	Masc
Maria Kadłubek odebrała wydany zaocznie wyrok sądu grodzkiego .	odebrała	2	Fem
Całe zamieszanie wywołało orzeczenie Trybunału Konstytucyjnego z maja ubiegłego roku .	wywołało	2	Neut
Ze swadą wyśmiał i wypunktował tę pookrągłostołową zgraję rządzącą Polską z nadania Kiszczaka .	wyśmiał	2	Masc
Zerkała na czarno - biały obraz i pogryzała słone paluszki .	Zerkała	0	Fem
Publiczność przyjęła ją entuzjastycznie , ale krytycy nazwali królową kiczu .	nazwali	7	Masc
– W pewnym momencie jedna , która nagrywała wszystko kamerą , zaczęła machać ręką , byśmy szybko odjechali .	nagrywała	7	Fem
Brakowało jakiegoś rysu dawnego Jeffa .	Brakowało	0	Neut
Nie rzekła nic na to .	rzekła	1	Fem
Byłoby dziwne , gdyby ta większość przekazywała opozycji przewodnictwo najważniejszych komisji .	przekazywała	6	Fem
Niedobrze by było , gdyby to miasto usnęło .	usnęło	7	Neut
Ponadmiesięczna wyprawa zakończyła się sukcesem .	zakończyła	2	Fem
Może wolał przemilczeć tragedię .	wolał	1	Masc
Ponieważ na pukanie nikt nie reagował , policjanci wyważyli drzwi .	wyważyli	8	Masc
Nagle zaczęła jęczeć i płakać .	zaczęła	1	Fem
Spała niespokojnie , często rzucała się na łóżku , zdarzało jej się nawet krzyczeć .	zdarzało	9	Neut
Krewna Krystyny , która wciąż stała obok mnie , zajrzała mi przez ramię .	stała	5	Fem
Nikt o nic nie pytał .	pytał	4	Masc
Milczącemu urodziła się córka .	urodziła	1	Fem
Dlaczego euro przez ostatnie trzy miesiące wbrew prognozom osłabło ?	osłabło	8	Neut
Tam dokonał czynów lubieżnych na dziewczynce .	dokonał	1	Masc
Obudziła się na kanapie , na szczęście , u przyjaciół .	Obudziła	0	Fem
Elizabeth cofnęła się , może lepiej , żeby jej tu nikt nie widział .	cofnęła	1	Fem
Po 6,5-godzinnej burzliwej dyskusji sejmowa komisja kultury przyjęła wczoraj projekt budżetu kultury i budżetu radia i telewizji .	przyjęła	7	Fem
A potem dwupłatowiec wniknął w nasz bombowiec niczym duch .	wniknął	3	Masc
Wilk nie zadawał już pytań , ale ona wcale ich nie potrzebowała .	zadawał	2	Masc
Wspólne działania dały efekty .	dały	2	Neut
Stało się jednak inaczej .	Stało	0	Neut
- Zaliczyli śmy nawet test wypadkowy .	Zaliczyli	1	Masc
Oczy Nony zalśniły .	zalśniły	2	Neut
– W pewnym momencie jedna , która nagrywała wszystko kamerą , zaczęła machać ręką , byśmy szybko odjechali .	odjechali	17	Masc
Gdyby Nina Terentiew ciągle rządziła Dwójką , krzywdy pani zrobić by nie dała ?	dała	12	Fem
Lecz myszy popłynęły za nim , dopadły go na wieży i zagryzły .	zagryzły	11	Fem
Gdy rozległ się krzyk , Guilielmo zakryl twarz rękami .	zakryl	6	Masc
Woziły im posiłki na wózkach .	Woziły	0	Fem
Barszczucha rozwinęła kabel i włączyła do kontaktu .	włączyła	4	Fem
Yennefer opuściła głowę , spojrzała między swoje uda , nad którymi przemykały złote rybki .	przemykały	11	Fem
- Opublikował em te dokumenty z pełną świadomością .	Opublikował	1	Masc
W 1997 roku zachorowało około 11 tys . kobiet , z tego około 6 tys . zmarło .	zmarło	16	Neut
Pięciu marynarzy niszczyciela poniosło śmierć a dwóch odniosło ciężkie rany .	poniosło	3	Neut
Laboratorium badań serologicznych pozostało w gestii leszczyńskiego szpitala .	pozostało	3	Neut
- Nóż niezbyt sprawnie odkrawał ziemniaczane spirale .	odkrawał	4	Masc
Iskierka zgasła , ustępując miejsca podejrzliwości .	zgasła	1	Fem
Dziadek szybko przeżegnał się .	przeżegnał	2	Masc
- Zrezygnowali ?	Zrezygnowali	1	Masc
Wszedł em na plac .	Wszedł	0	Masc
- Zatkało ich .	Zatkało	1	Neut
Grace zerwała się , zgarnęła ręką włosy .	zgarnęła	4	Fem
- Powinno być łatwiej , bo Husajna nie otaczają fanatycy .	Powinno	1	Neut
Strażacy wstępnie określili straty na 15.000 złotych .	określili	2	Masc
Rodzice ze wzruszeniem prezentowali dziennikarzom swoje maleństwa i dziękowali za pomoc .	prezentowali	3	Masc
Zatrzymał się na półpiętrze .	Zatrzymał	0	Masc
" Pewnie mu się przyśniła Francja . . .	przyśniła	4	Fem
Było już południe , kiedy skończyli kręcić .	Było	0	Neut
Skinęli porozumiewawczo głowami i usiedli .	usiedli	4	Masc
Róża pamiętała dobrze ten dzień .	pamiętała	1	Fem
Przed tygodniem rzesze ostrzeszowian odprowadziły go na miejsce wiecznego spoczynku .	odprowadziły	4	Fem
Rodzice Agnieszki nie motywowali jej do nauki .	motywowali	3	Masc
Światło zgasło jednak po dwóch minutach .	zgasło	1	Neut
„ Powiało grozą .	Powiało	1	Neut
- Ale opłaciło się .	opłaciło	2	Neut
Na bezdomne po Powstaniu Warszawskim dwie głośne pisarki czekały w Łodzi zarezerwowane dla nich mieszkania .	czekały	8	Neut
W Laskach w liturgii uczestniczyło się przez cały dzień i modliło się wszędzie .	modliło	10	Neut
Czy na to go dzisiaj plecy swędziały ?	swędziały	6	Neut
Miało płonąć mieszkanie na dziewiątym piętrze jednego z bloków .	Miało	0	Neut
Korespondenci budapesztańskich gazet donoszą , że wielu miejscowych Węgrów wyjechało do krewnych na wieś albo uciekło na Węgry .	wyjechało	9	Neut
Talent dramatopisarski Kisielewskiego wypowiedział się w zasadzie w tych dwóch sztukach młodzieńczych .	wypowiedział	3	Masc
Staads wstał i skierował się do wyjścia , za nim , gęsiego , podążyli jego współpracownicy .	podążyli	13	Masc
Do minionej środy takie pismo do starostwa w Bytowie nie nadeszło .	nadeszło	10	Neut
Zmieniały się tylko nazwiska i wielkość zdeprawowanych pieniędzy .	Zmieniały	0	Neut
Spod czerni i płomieni zaczynały już wyglądać żółtawe żebra trupa .	zaczynały	4	Neut
Ale to się zmieniło .	zmieniło	3	Neut
Podziękowała m raz jeszcze i zwróciła m futro .	Podziękowała	0	Fem
Podejrzewam , że się z nią ożenił dla majątku .	ożenił	6	Masc
Wtedy wracali chłopi , a wraz z nimi albo wkrótce po nich w pandższirskich wioskach pojawiali się mudżahedini .	pojawiali	15	Masc
Wrócił do Polski w październiku 1918 r .	Wrócił	0	Masc
Po jakimś czasie niebo nad puszczą poszarzało .	poszarzało	6	Neut
Silny Sojusz na pewno będzie skrupulatnie punktował potknięcia koalicjantów .	punktował	6	Masc
Skąd to się wzięło ?	wzięło	3	Neut
Szły dzieci przez pole minowe i wesoło machały rączkami .	machały	7	Neut
Z szacunkowych danych wynika , że stopa bezrobocia w kwietniu wyniosła 13,6 proc .	wyniosła	10	Fem
Wystawa w Tel Awiwie przyciągnęła ponad 5 tysięcy zwiedzających , pokazano ją we wszystkich izraelskich telewizjach , pisały o niej wszystkie gazety .	pisały	17	Fem
Nie lubiły tylko pijaków , szczekały , kiedy opierali się o płot .	lubiły	1	Neut
o wzięło by się czyściochę . .	wzięło	1	Neut
Plecy Dobrskiego zdradzały tak wielkie rozgoryczenie .	zdradzały	2	Neut
I wojna światowa strąciła nam z głowy te cudeńka .	strąciła	3	Fem
Mała poskarżyła się , że koza się jej nie słucha .	poskarżyła	1	Fem
To ostatecznie przesądziło o południowym kierunku japońskiej ekspansji .	przesądziło	2	Neut
Tamten obruszył się .	obruszył	1	Masc
Zawód przeżyły grupy protestujących warszawiaków , które licznie przybyły na wczorajszą sesję rady miasta .	przybyły	8	Fem
Dotyczyło to zresztą wyłącznie ubioru .	Dotyczyło	0	Neut
- Z biegiem lat pańska gniewność ustąpiła ?	ustąpiła	6	Fem
Zdaniem senator Grześkowiak , naruszała ona zasadę zaufania obywateli do państwa .	naruszała	4	Fem
Przeprowadziła się tutaj z Krakowa .	Przeprowadziła	0	Fem
Świadkowie twierdzą , że spod siedziby SdRP odjechało w ostatnich kilkunastu miesiącach kilka takich grup .	odjechało	7	Neut
Okno było otwarte , ogród szarzał pod niebem bez barwy .	szarzał	5	Masc
Szef aż podskoczył !	podskoczył	2	Masc
Zenek prosił kolegów , żeby nic nie mówili mamie , gdyby go przysypało .	przysypało	12	Neut
Przebiegające pod miastem chodniki kopalni zalano wodą , a wzgórze zgniło i zapadło się w ziemię jak przydeptane .	zgniło	10	Neut
Mani wciąż nie było i Beata pomyślała , że wyjechała już na wakacje .	wyjechała	9	Fem
Nie lubiły tylko pijaków , szczekały , kiedy opierali się o płot .	szczekały	5	Neut
Zdaniem fachowców urządzenie spisywało się dobrze .	spisywało	3	Neut
Czy mogł em odjechać bez Syrenki ?	mogł	1	Masc
Sołtys Ligoty Stanisław Kuźnik składa serdeczne podziękowanie wszystkim sponsorom , którzy przyczynili się do zorganizowania festynu i dzięki którym dzieci z Ligoty będą mogły pojechać na wycieczkę .	przyczynili	11	Masc
Nie istniał system rzetelnej kontroli odbioru inwestycji .	istniał	1	Masc
Po końcowym gwizdku arbitra w ekipie gości zapanowała zrozumiała euforia .	zapanowała	7	Fem
Wreszcie coś szczęknęło obiecująco .	szczęknęło	2	Neut
Oprócz słuchania Steczkowskiej delegaci zajmowali się dyskusją o strajku generalnym .	zajmowali	4	Masc
Wydawało się , że fiskus nie będzie dłużej gnębił Waldemara Gronowskiego , legnickiego piekarza , który przez ponad 10 lat rozdawał pieczywo najuboższym .	Wydawało	0	Neut
dało by radę ?	dało	0	Neut
Iskierka zgasła , ustępując miejsca podejrzliwości .	zgasła	1	Fem
Około jedenastej śniadania się kończyły , zamawiano czarne kawy , herbaty i kapucyny .	kończyły	4	Neut
Ruszyli w dół .	Ruszyli	0	Masc
Doszło do kraksy .	Doszło	0	Neut
Doznał poważnych obrażeń ciała i przebywa w szpitalu .	Doznał	0	Masc
Świadkowie twierdzą , że spod siedziby SdRP odjechało w ostatnich kilkunastu miesiącach kilka takich grup .	odjechało	7	Neut
Dlaczego się przestraszyła ?	przestraszyła	2	Fem
Jurek milczał .	milczał	1	Masc
Kasia zrezygnowała .	zrezygnowała	1	Fem
Sprawiło to , że się właśnie wytuszowałam i ubrałam .	Sprawiło	0	Neut
Elizabeth nie wiedziała , jak jej powiedzieć , że przywiozła chore dziecko .	przywiozła	9	Fem
Chwycił em teczkę i pobiegł em do sekretariatu .	Chwycił	0	Masc
Wczoraj , po zamknięciu lokali wyborczych , niemieckie media zapowiedziały , że pani minister ustąpi ze stanowiska .	zapowiedziały	9	Neut
- Pokręciła głową .	Pokręciła	1	Fem
Wezwane pogotowie ratunkowe odwiozło go do szpitala .	odwiozło	3	Neut
Zatrzymał się na miejscu i na wszelki wypadek uniósł ręce .	uniósł	8	Masc
Machinalnie zaczęła przepisywać tekst z kartki .	zaczęła	1	Fem
W szybkim tempie spijało rosę .	spijało	3	Neut
Drzwi uchyliły się z lekkim skrzypieniem nie naoliwionych zawiasów .	uchyliły	1	Neut
- A po co to malował eś ?	malował	5	Masc
Na weselu bawiło się prawie 150 gości .	bawiło	2	Neut
Otworzyła m radio i słuchała m muzyki .	słuchała	4	Fem
Było ciemno , płonęły znicze .	Było	0	Neut
Skrzypnęły drzwi .	Skrzypnęły	0	Neut
- Wrócił pan z zagranicy ?	Wrócił	1	Masc
Bardzo się tym wzruszył .	wzruszył	3	Masc
Pomyliła się .	Pomyliła	0	Fem
Jest to szczególnie atrakcyjne dla dzieci , które same proszą rodziców , aby mogły wziąć do rączki te piękne stworzenia .	mogły	13	Neut
Widownia westchnęła ze współczuciem , a Iwana to uskrzydliło .	uskrzydliło	8	Neut
Już sobie wypatrzyła m coś w naturze .	wypatrzyła	2	Fem
Na ścianach wisiały pamiątkowe fotografie i adresy gratulacyjne .	wisiały	2	Fem
Co zrobiła ?	zrobiła	1	Fem
- Myślała m , że ktoś w szkodę wlazł sąsiadowi .	Myślała	1	Fem
Wszedł do kuchni ledwie zapukawszy .	Wszedł	0	Masc
Marta dyskretnie przyglądała się trójce młodych ludzi , którzy teraz opiekują się Polą .	przyglądała	2	Fem
Wyjątek stanowiły niedziele .	stanowiły	1	Fem
Zdziwisz się , ale wielu głosowało za Bośnią .	głosowało	5	Neut
Nie mogł em zasnąć .	mogł	1	Masc
Rozmyślał o tym sennym widzeniu .	Rozmyślał	0	Masc
I zrozumieli ludzie , że tu Bóg był , i zburzyli ten sądowy dom , aby w nim nikt już więcej po Panu Jezusie nie sądził , a przed jabłonnymi drzewami postawili krzyż i on do dziś tam stoi .	sądził	25	Masc
Pokiwał em tylko głową .	Pokiwał	0	Masc
Podlaska Agencja Restrukturyzacji i Modernizacji Rolnictwa opracowała specjalną instrukcję dla parafii .	opracowała	6	Fem
Dwukrotnie SKO przyznało im rację .	przyznało	2	Neut
Zarzucał nas wiadomościami o długiej zimie .	Zarzucał	0	Masc
Ciotka tymczasem już krzątała się w kuchni .	krzątała	3	Fem
W międzyczasie skończyła m też dziennikarstwo .	skończyła	2	Fem
– no zapraszała mnie tam Kalińska .	zapraszała	2	Fem
Auto z czterema młodymi mężczyznami wpadło do Wisły .	wpadło	5	Neut
Marta nie potrafiła odpowiedzieć na pytania córki , gdyż sama do dnia dzisiejszego nie znała odpowiedzi .	znała	14	Fem
W jego moskiewskim salonie bywała śmietanka przedrewolucyjnej Rosji .	bywała	4	Fem
Przewrócił em jakieś puszki , stracił em kamerę , ale świeca płonie .	Przewrócił	0	Masc
Kiwek , spluwając w palce , uważnie odliczał złotówki .	odliczał	7	Masc
A po ocknięciu się z kamienia osiągnął em jeszcze dwie , straszne w swej prostocie , myśli .	osiągnął	6	Masc
Firma świętowała w ten sposób swoje 85-lecie .	świętowała	1	Fem
Zabił się na miejscu .	Zabił	0	Masc
Iluż poważnych obecnie pisarzy czytało swe pierwsze próby literackie w sali przy Krupniczej , siedząc wokół dębowych stołów zsuniętych pośrodku .	czytało	4	Neut
Wilk nie zadawał już pytań , ale ona wcale ich nie potrzebowała .	potrzebowała	11	Fem
Lopez milczał .	milczał	1	Masc
Rozmawiały z nim samym jednym niebiosa .	Rozmawiały	0	Neut
Sześć cebul kupiła na kiermaszu zorganizowanym w pobliskiej szkole .	kupiła	2	Fem
Dodawał też , że korzystał z jawnych źródeł .	Dodawał	0	Masc
Ta sprawa wstrząsnęła całą Polską .	wstrząsnęła	2	Fem
Zaraz potem , bez żadnych ceregieli , skoczyła Filomena .	skoczyła	7	Fem
Wiele szczęścia miała grupa uczniów z Warszawy , która wybrała się w niedzielę na pieszą wycieczkę po Karkonoszach .	wybrała	9	Fem
Musiała m przerwać pisanie , bo obudził się Michał .	Musiała	0	Fem
Pootwierało wiele zamkniętych dotąd drzwi .	Pootwierało	0	Neut
Kontakty towarzyskie utrzymywali jednak przez cały czas .	utrzymywali	2	Masc
Przekazał policjantowi dziewczynę i popłynął do brzegu .	popłynął	4	Masc
Zalało perony na dworcu kolejowym .	Zalało	0	Neut
Nerwy jej niepotrzebnie puściły .	puściły	3	Neut
Kiedy pracowało się pani w TVP najlepiej ?	pracowało	1	Neut
Tam też goście imprezy spotykali się na dyskusjach każdego dnia .	spotykali	4	Masc
Szły dzieci przez pole minowe i wesoło machały rączkami .	Szły	0	Neut
- Jeszcze nie zdążyła m .	zdążyła	3	Fem
Jak czuła się Krystyna , schodząc tu co rano na śniadanie ?	czuła	1	Fem
Choć dziecko złożyło na policji zeznania , sprawców nie zatrzymano .	złożyło	2	Neut
KTO PIERWSZY ZAPALIŁ OGIEŃ NA ROZEWIU ?	ZAPALIŁ	2	Masc
Po mszy świętej wyruszyła z bazyliki katedralnej i okrążyła Stary Rynek .	wyruszyła	3	Fem
Na Siemiradzkiego wybrzydzali krytycy , ale publiczność uwielbiała jego obrazy .	uwielbiała	7	Fem
Wymykała mu się , a potem znów przyciskała do niego .	przyciskała	7	Fem
Zamiast trzystu dwudziestu ośmiu obiektów elektryfikacyjnych , załoga wybudowała trzysta sześćdziesiąt cztery .	wybudowała	8	Fem
Nie patrzyła już na mnie .	patrzyła	1	Fem
Poszła z własnej woli , gdyż dobrze go znała .	znała	8	Fem
Nie nalegał .	nalegał	1	Masc
Zakłada ona , że obywatele polscy będą mogli przebywać w Izraelu bez wizy do trzech miesięcy i że takie samo prawo w odniesieniu do pobytu w Polsce będą mieli obywatele Izraela .	mogli	7	Masc
Trochę mu się skrzydełka pomięły , ale właził już prawie cały do środka .	pomięły	4	Neut
Czemu akurat wtedy szwankowała łączność ?	szwankowała	3	Fem
Nieco częściej czyniły to kobiety .	czyniły	2	Fem
A on tak spał na dworze .	spał	3	Masc
– Musiał by m być szalony , żeby ci powiedzieć .	Musiał	1	Masc
Już był pełen dzieci , mały nauczyciel spędzał je do szkoły .	spędzał	7	Masc
W wysokiej trawie leżały setki stygnących ludzkich ciał .	leżały	3	Fem
Osoba przypadkowa zorientuje się , że powinna odejść .	powinna	6	Fem
Wydawało się , że wojna jednak go przerosła , przeraziła .	przerosła	7	Fem
Sprawą zajęła się policja , która sprawdza wszelkie okoliczności .	zajęła	1	Fem
Przyjechał tu na Milkowszczyznę już jako doktor .	Przyjechał	0	Masc
Władze samorządowe wystąpiły już z pozwem do sądu w Warszawie .	wystąpiły	2	Fem
Jej zdaniem coś złego wydarzyło się w mieszkaniu przy ul . Składowej , w którym wraz z siostrą mieszkała jej koleżanka .	wydarzyło	4	Neut
NBP OBNIŻYŁ o 4 punkty procentowe stopę swoich kredytów .	OBNIŻYŁ	1	Masc
Opadał kurz w uliczce i cuchnęły w upale spaliny pracujących silników .	cuchnęły	5	Neut
Wiedzą , że zjadła by m ich na kolację .	zjadła	3	Fem
Przypuszczam , że chodzi raczej o to , iż wybrał się samowolnie !	wybrał	9	Masc
Agnieszka Strumiłowska opowiedziała mi historię z jej czasów studenckich .	opowiedziała	2	Fem
Stanisław Mróz prawie nigdy nie rozstawał się z dudami .	rozstawał	5	Masc
Odbyło się taksowanie .	Odbyło	0	Neut
- Będzie się Pan opierał na betonie ?	opierał	4	Masc
Moi ludzie odnaleźli tego Pawła .	odnaleźli	2	Masc
Jej mąż stał bezradny w kącie , tulił synka .	tulił	7	Masc
25 lat temu zaginął w Bieszczadach w tajemniczych okolicznościach Witold Gontaszewski .	zaginął	3	Masc
Tamta patrzyła zaskoczona .	patrzyła	1	Fem
Było jej ciężko samej we Francji .	Było	0	Neut
- Wiele złudzeń padło przez te dwa czy trzy lata .	padło	3	Neut
Poszukiwała go policja z Gostynia za kilka innych przestępstw .	Poszukiwała	0	Fem
Nawet duże lustro na staroświeckiej komodzie służyło z pewnością do różnych celów .	służyło	6	Neut
W takie wieczory milkły rozmowy .	milkły	3	Fem
Żeby opłacić dziennikarza , przeciętne warszawskie osiedle musiało by się złożyć po 10 groszy .	musiało	7	Neut
W pobliżu granicy Kosowa z Albanią zginęło w walkach z serbskimi żołnierzami co najmniej ośmiu albańskich separatystów .	zginęło	6	Neut
Można się oczywiście zastanawiać , co młodego Johnsona tak pchało do faszyzmu czy nazizmu .	pchało	9	Neut
Do nowotarskiej tradycji weszły organizowane przez burmistrza spotkania noworoczne .	weszły	3	Neut
Wypowiedział wojnę wielu bardzo różnym środowiskom .	Wypowiedział	0	Masc
Kardynał padrone szedł już na spotkanie .	szedł	2	Masc
Twoje słowa trafiły na podatny grunt .	trafiły	2	Neut
– kiedy ta książka się ukazała ?	ukazała	5	Fem
Orzechowe oczy garncarza wpatrzyły się badawczo w twarz Kaliasa .	wpatrzyły	3	Neut
Niektórzy szukali ich na dalekiej mroźnej północy .	szukali	1	Masc
Niestety , lekarz po przybyciu na miejsce orzekł , że ten już nie żyje .	orzekł	7	Masc
" Dąbrowska odnotowuje , że zarys którejś z nowel Kowalska w pośpiechu rzuciła na papier po francusku " .	rzuciła	12	Fem
Jego karogga zagłębiła się w płomienie , sięgnęła czegoś twardego .	zagłębiła	2	Fem
Zamiast złota , klejnotów i posiadłości składał się on z 200 rycerzy !	składał	6	Masc
Tylko w minioną sobotę w atakach terrorystycznych w Bagdadzie zginęło ponad 40 osób .	zginęło	9	Neut
Piłkarze krakowskiej Wisły sprawili wspaniały prezent wszystkim sympatykom futbolu w Polsce .	sprawili	3	Masc
Wypytywała rodaków o Warszawę , interesowała się przeżyciami Tomka w czasie wyprawy i nawet namawiała go usilnie , aby pozostał w Australii .	interesowała	5	Fem
Wizytator przeprosił kierownika i udał się z powrotem do klasy szóstej .	udał	4	Masc
Siostrzyczki emanowały szlachetnością i pobożnością .	emanowały	1	Fem
Krew spryskała bok mierzynka .	spryskała	1	Fem
Przyjechał em , żeby ratować Gruzję .	Przyjechał	0	Masc
Ale powiem ci , że w dużej mierze poznał em siebie dopiero podczas pisania .	poznał	8	Masc
II wojna światowa skończyła się ponad pół wieku temu .	skończyła	3	Fem
Serena zamruczała coś przez sen i rozłożyła się na mojej połowie .	zamruczała	1	Fem
Nie skorzystało z tej szansy .	skorzystało	1	Neut
Tymczasem kolegium odroczyło swoją decyzję .	odroczyło	2	Neut
Ale teraz noc zakrywała te figury .	zakrywała	3	Fem
Związany z kapistami , wielokrotnie jednak przekraczał wyznaczone przez nich malarskie granice .	przekraczał	6	Masc
Przyjechały 102 osoby .	Przyjechały	0	Fem
Jego matka znała słabo francuski , ale jako tako mogły się porozumieć .	mogły	9	Fem
Kobieta , bez uprzedzenia , nie przyszła wczoraj do pracy , a w mieszkaniu świeciło się światło .	świeciło	14	Neut
Kobieta zaufała oszustowi i podała numery z 28 kart .	podała	4	Fem
Po nagrodę przyszła z synem .	przyszła	2	Fem
Zmieniła się również polityka sądu .	Zmieniła	0	Fem
Trzy strzały trafiły przebywających w wartowni żołnierzy .	trafiły	2	Masc
Sugerowała , że przed egzaminem można było kupić testy .	Sugerowała	0	Fem
Dobrze spisała się młodzież w Sterdyni , Ceranowie , Skrzeszynie , Czerwonce i Wężach .	spisała	1	Fem
Na koniec kokieteryjnie usprawiedliwiła się , że mówi bez ładu i składu , bo jest już w zaawansowanym wieku .	usprawiedliwiła	3	Fem
Trzy osoby podejrzane o korupcję , w tym profesora , który przewodniczył komisji egzaminującej weterynarzy , zatrzymali warmińsko - mazurscy policjanci .	zatrzymali	16	Masc
Płacić również nie zamierzały .	zamierzały	3	Fem
I szczerze mnie zadziwił . . .	zadziwił	3	Masc
W pomieszczeniu tym będzie mogło korzystać z noclegów czterdziestu turystów .	mogło	4	Neut
Bardzo żałuje , że robił dotąd .	robił	4	Masc
Pierwsze krople deszczu zadudniły o trumnę i zmieszały się ze święconą wodą , którą ksiądz rozpryskiwał z kropidła podobnego do królewskiego berła .	zmieszały	7	Fem
Również państwo bardzo się starało , żeby księża wzięli swoje .	starało	4	Neut
Te ostatnie dziewczyny zostawiły , ponieważ były za małe .	zostawiły	3	Fem
Zmierzyła m ciśnienie krwi .	Zmierzyła	0	Fem
W Charkowie 300 osób odkryło ostatnio karaimskie korzenie .	odkryło	4	Neut
Po chwili znaleźli się w podziemiach domu .	znaleźli	2	Masc
Oczy wyszły nieomal z orbit .	wyszły	1	Neut
Na dowód dobrej woli natychmiast odwołało z rady nadzorczej dwóch największych banachożerców , w tym Poczobutta .	odwołało	5	Neut
I co załatwił ?	załatwił	2	Masc
Powstały wówczas Prusy Zakonne .	Powstały	0	Neut
Wilczyński nadal był zdziwiony , ale pokiwał głową .	pokiwał	6	Masc
– zwężał się ku górze odrobinę .	zwężał	1	Masc
- Kilka godzin spędziła m przed lustrem zastanawiając się , co włożyć .	spędziła	3	Fem
Szynkarz kłaniał mu się nisko .	kłaniał	1	Masc
Wśród tradycjonalistów muzułmańskich z państw Półwyspu Arabskiego wywołało ono szok .	wywołało	7	Neut
Losem tej matki i jej dziecka zainteresowały się nawet władze USA .	zainteresowały	6	Fem
Wreszcie na ludzi głodnych przybywających ze wsi czekały rozwijające się gwałtownie w XIX w . miasta .	czekały	7	Neut
Rozumowanie Angusa nie było więc pozbawione podstaw , ale jeszcze zbyt daleko biegło w przyszłość .	biegło	12	Neut
Helena przeżyła swój kryzys w drugiej klasie liceum .	przeżyła	1	Fem
Jeszcze kilka miesięcy temu 15 dyplomatów z tej listy pracowało w Polsce .	pracowało	9	Neut
Jelcyn nie wykorzystał swej władzy dla prawdziwego zreformowania gospodarki .	wykorzystał	2	Masc
Baszmaczkina sam niegdyś postawił em w dzienniku obok kopisty Bartleby z noweli Melville'a .	postawił	3	Masc
Poruszył em się na łóżku , które odpowiedziało sprężyście .	odpowiedziało	7	Neut
Wyprawa , zmuszona do przyjęcia walki , rozbiła się na wiele części .	rozbiła	7	Fem
- Michał nagle stał się natarczywy i to mnie zdziwiło .	zdziwiło	9	Neut
Upiła łyk i sięgnęła po torebkę z bułką .	sięgnęła	3	Fem
Atak nastąpił z bliska , w wąskiej uliczce .	nastąpił	1	Masc
Spłoszyły się nasze oczy .	Spłoszyły	0	Neut
Powstało z komitetów na rzecz referendum w sprawie karania za aborcję .	Powstało	0	Neut
Kaśka , co cię ugryzło ?	ugryzło	4	Neut
Władze bały się tam zaglądać , a jedyne prawo wyznaczał pistolet czy karabin .	bały	1	Fem
Produkcję nadzorował w Krośnie Jerzy .	nadzorował	1	Masc
Przed wojną powodziło mi się zupełnie nieźle .	powodziło	2	Neut
Ale ciągle go gdzieś gnało , stawiał sobie nowe wyzwania .	gnało	4	Neut
– to mnie się skojarzyło z kumplem . .	skojarzyło	4	Neut
– Wycelowała kluczami w koronkową bieliznę .	Wycelowała	1	Fem
Twierdzą , że gazeta naruszyła ich dobre imię .	naruszyła	4	Fem
„ Sztafeta cztery razy po sto ostro ruszyła z miejsca ” .	ruszyła	7	Fem
- Odkąd cię poznała m , chciała m być taka jak ty .	poznała	3	Fem
Margit również przykucnęła i wybierała zwierzątka .	przykucnęła	2	Fem
Te wszystkie domy , ten , ten i ten , powstały z niego .	powstały	10	Masc
Głosowało 379 posłów .	Głosowało	0	Neut
Sprawa już trafiła do sądu .	trafiła	2	Fem
Świat Rydzyka tego wszystkiego nie wydumał .	wydumał	5	Masc
Dostał oklaski od zebranych , ale odpowiedzi oficjalnej nie otrzymał .	Dostał	0	Masc
Spośród trzystu ochotników Polluks wybrał stu najlepiej znających się na morzu .	wybrał	4	Masc
U mnie miała by ś więcej .	miała	2	Fem
Pogotowie natychmiast odwiozło rannych pasażerów do szpitala w Rybniku .	odwiozło	2	Neut
Odbyły się już spotkania .	Odbyły	0	Neut
Wystarczyło paru lat , aby konkret został wyklęty .	Wystarczyło	0	Neut
W katowickim oddziale WBK pierwszy klient wykupił wszystkie akcje .	wykupił	6	Masc
Padały jeszcze pytania o drogi krajowe biegnące przez wsie .	Padały	0	Neut
Zerwanie odbyło się przed rabinem .	odbyło	1	Neut
Często chodzili do pubu , pili piwo , rozmawiali .	chodzili	1	Masc
Do tego NBP dał mu jeszcze pamiątkową monetę .	dał	3	Masc
Zaproponowali , że przeproszą , i obiecali poprawę .	Zaproponowali	0	Masc
Odkręcił korek , oblał się i podpalił .	podpalił	6	Masc
Towarzyszyły mu również podczas pracy w polu .	Towarzyszyły	0	Neut
Dotychczas za kratkami znalazło się sześciu egzaminatorów i pośredników .	znalazło	3	Neut
Działo się to po południu .	Działo	0	Neut
- Pani Salach kazała śledzić każdy jej krok i informować o każdym błędzie .	kazała	3	Fem
W tym roku Ministerstwo Zdrowia wykreśliło z nich osiemnaście leków .	wykreśliło	5	Neut
Brakowało też kapelana .	Brakowało	0	Neut
Biała plama zniknęła , cały glob był opasany siecią wspólnot .	zniknęła	2	Fem
Chłopiec posłusznie ukląkł i mełł pacierz obok żarliwie modlącej się i popłakującej matki .	mełł	4	Masc
- Ministerstwo Edukacji Narodowej dokonało w 1995 r . przeglądu rodzin zastępczych .	dokonało	4	Neut
Najtrudniejsze zadanie stało przed Mercedesem .	stało	2	Neut
Ze sklepów zniknęły wiatraki .	zniknęły	2	Masc
Historia przedstawiona w tej książce zawiera mniej znane fragmenty dziejów zjawiska , które tak straszliwie poraziło ludzkość .	poraziło	15	Neut
Ale wyrażał się niejasno .	wyrażał	1	Masc
– Tyle głów rozłupali śmy przed twoją . . .	rozłupali	3	Masc
Parafowanie umowy nie poprawiło szans wyborczych AWS , ale sprawa ta dalej jest wykorzystywana do celów politycznych .	poprawiło	3	Neut
Czy strony zrozumiały wyrok ?	zrozumiały	2	Fem
Zaczął się wielki exodus .	Zaczął	0	Masc
Spojrzał na Staśka .	Spojrzał	0	Masc
Jakaś staruszka dreptała z dzbanem po wodę .	dreptała	2	Fem
Stąd zawróciła .	zawróciła	1	Fem
Zapowiedział pan , że niebawem młodzież nie będzie zdawać egzaminów na studia , że matura zastąpi dodatkowy dziś egzamin .	Zapowiedział	0	Masc
Jedyny Polak , który po sprincie awansował do biegu na dochodzenie , Tomasz Sikora , nie startował .	startował	16	Masc
Drgnęła na głos Mory .	Drgnęła	0	Fem
Przyjechał tu na Milkowszczyznę już jako doktor .	Przyjechał	0	Masc
Przyjaciele użyczali jej chętnie .	użyczali	1	Masc
Po dwóch tygodniach na jej rozkładające się zwłoki natrafił w lesie rowerzysta .	natrafił	8	Masc
O’Donellowie siedzieli przy ognisku .	siedzieli	1	Masc
Od poniedziałku toczyły się walki o jego odbicie .	toczyły	2	Fem
W święta głodowało już sześciu pracowników MZK , przedwczoraj dwóch z nich odmówiło przyjmowania płynów .	głodowało	2	Neut
Jednak już wkrótce Nizioł i Wapiński ze zdumieniem odkryli , że Łapiński nie dotrzymuje wcześniej danego słowa .	odkryli	8	Masc
Wyraźnie za Basajewem nie przepadał .	przepadał	4	Masc
Jak pani zareagowała ?	zareagowała	2	Fem
Dlaczego to zrobił eś ?	zrobił	2	Masc
Ponadmiesięczna wyprawa zakończyła się sukcesem .	zakończyła	2	Fem
Wnętrze Ejakulatio błyszczało .	błyszczało	2	Neut
Bo on wiedział , kto mu zaszkodził .	zaszkodził	6	Masc
Na tych przejazdach woda była płytka , ale dno piaszczyste nie groziło uszkodzeniem łodzi .	groziło	11	Neut
Nadleśnictwa z terenu powiatu tucholskiego odwołały zakaz wstępu do lasu .	odwołały	5	Neut
– odliczył em klatki . .	odliczył	1	Masc
W tegorocznym VIII turnieju wystartowało 18 drużyn podzielonych na 6 grup .	wystartowało	4	Neut
Było już jasno , ale słońce nie świeciło jeszcze .	świeciło	7	Neut
Strażacy i policjanci wezwani na miejsce wypadku nie mogli wyjść ze zdumienia .	mogli	8	Masc
Malarz chwycił go mocno za ramię .	chwycił	1	Masc
Wróciła dynamika , dawny zapał .	Wróciła	0	Fem
Kiedyś Róża miała kłopoty przez to siorbanie .	miała	2	Fem
Gładkie oblicze strzygonia stężało , alabastrowa skóra napięła się , jakby miała zaraz pęknąć .	stężało	3	Neut
We własnym pokoju rzuciła się na łóżko i prędko zasnęła .	zasnęła	9	Fem
Negocjacje rozpoczęły się dopiero po przyjeździe do szkoły zastępcy wójta gminy .	rozpoczęły	1	Fem
Wraz z kolejnymi minutami potrawa zmieniała się z płynnej w coraz bardziej stałą .	zmieniała	5	Fem
I widziałem , jak docierała do nich prawda o aborcji .	docierała	4	Fem
Zdarzenie z kamykiem nie wychodziło mu z głowy .	wychodziło	4	Neut
Opowiadał niezwykle ciekawie , a tematów mu nie brakło .	brakło	8	Neut
Co znów wyrwało z kręgu tej kultury wielu intelektualistów .	wyrwało	2	Neut
- Może i ty by ś się uczył u Sołowjowa - Tamarina ?	uczył	7	Masc
Nikt w klubie nie ukrywał jednak , że to sytuacja tymczasowa .	ukrywał	4	Masc
Co śmy jeszcze zaniedbali , czymże śmy zgrzeszyli ?	zaniedbali	3	Masc
Często mdlała i padała na podłogę , płacząc histerycznie .	padała	3	Fem
Ostatnia wizyta we Włoszech miała przede wszystkim charakter gospodarczy .	miała	4	Fem
Na scenie bez przerwy prezentowały się zespoły młodzieżowe z Reska , Szczecina , Polic i Wolina .	prezentowały	4	Masc
Było ich niewiele , ponieważ w trakcie kampanii skupiliśmy się na rozdawaniu ulotek .	Było	0	Neut
Na pewno marzł w zimie .	marzł	2	Masc
Podobny sprzęt otrzymywały od niego dzieci i w ten sposób kontaktował się z nimi .	otrzymywały	2	Neut
W grudniu sprzedali mieszkanie i każde z nich poszło w swoją stronę .	sprzedali	2	Masc
- E , zdawało ci się .	zdawało	3	Neut
Trzech sprytnych chłopców szukało nawet syrenki w przedszkolnym akwarium .	szukało	3	Neut
Dymek w tym czasie ekspanderem przymocował otwartą klapę .	przymocował	5	Masc
– no już ciotka wysłała totka .	wysłała	4	Fem
Ciągle nie możemy doczekać się takich czasów , kiedy rządy po prostu nie będą przeszkadzały .	przeszkadzały	14	Masc
Chyba zasnął em i chyba mi się śniła .	śniła	7	Fem
W sezonie letnim w 2005 r . utonęło 325 osób .	utonęło	7	Neut
Wcześniej szefował ZOZ-owi w Piasecznie .	szefował	1	Masc
Eli chwycił wiadra i ruszył za nią kamienistą dróżką .	chwycił	1	Masc
Debren udał , że nie zrozumiał .	udał	1	Masc
Średnio płacąc kartą , wydawali śmy 211 złotych .	wydawali	4	Masc
Wszyscy czuli ulgę .	czuli	1	Masc
Izydor znieruchomiał z kopiowym ołówkiem nad blankietem reklamacyjnym .	znieruchomiał	1	Masc
W ubiegłym roku trzynastki pochłonęły 54.537 złotych .	pochłonęły	4	Fem
Kudłatemu znowu coś popieprzyło się w obliczeniach finansowych .	popieprzyło	3	Neut
Kiedy został em w ciszy , skupił em się raz jeszcze .	został	1	Masc
Urosły ogromnie .	Urosły	0	Fem
Podniósł się , w ręku trzymał pusty słoik .	trzymał	5	Masc
Zażarta walka trwała kilkadziesiąt minut .	trwała	2	Fem
i zmieniono to i się rozpadło wszystko .	rozpadło	5	Neut
Po powrocie do Polski Gronowska wraz z mężem zaczęła walczyć o sprowadzenie syna do kraju .	zaczęła	8	Fem
- Zatłukł mojego męża , a po trzech miesiącach go wypuszczono .	Zatłukł	1	Masc
Ale i to nie pomogło .	pomogło	4	Neut
O piątej przyszli Hauboldowie , zrobili śmy im herbatę i było dość przyjemnie .	zrobili	5	Masc
Ubrała m się i zeszła m na dół .	Ubrała	0	Fem
Większość nie stosowała się do obowiązujących zakazów zatrzymywania i postoju .	stosowała	2	Fem
Stare by może uciekły , ale małe dorosły i zostały .	zostały	9	Fem
Pani Czapkowa zaścieliła stół świeżą ceratą , podała kotlety z dzika , a po obiedzie odbyło się sympozjum .	odbyło	15	Neut
Zgodnie z ustaleniami nie udzielił żadnych wywiadów ani nie wydał żadnego oświadczenia politycznego .	udzielił	4	Masc
Kompromitowali nie tylko siebie , ale i Polskę .	Kompromitowali	0	Masc
Tu biło serce Orkiestry .	biło	1	Neut
Wozili się trochę po mieście .	Wozili	0	Masc
Jął przeciskać się przez zaporę , czołgał się przez rumowisko , zmiażdżone wózki .	Jął	0	Masc
Stary wiadukt przy ulicy Oświęcimskiej stanowił ogromną uciążliwość dla kierowców .	stanowił	5	Masc
Przyjechało wielu ciekawskich , ale też kupujących .	Przyjechało	0	Neut
Podobnie zachowała się burżuazja niemiecka .	zachowała	1	Fem
Zaczął em się obawiać , że wyrządził em mu krzywdę .	Zaczął	0	Masc
Nie broniła się .	broniła	1	Fem
Przed wejściem do pokoju zastukał .	zastukał	4	Masc
Chodziło oczywiście o kontakty ściśle naukowe , ale umożliwiły one później wysłanie jezuity , astronoma , do Chin .	Chodziło	0	Neut
Przez godzinę z boiska wiało nudą , a piłkarze prezentowali futbol plażowy .	wiało	4	Neut
Oni myśleli , że byłam nówka i Miszka mnie rozdziewiczył .	myśleli	1	Masc
Czy dziennikarze powinni się bać ?	powinni	2	Masc
Stracił eś pracę ?	Stracił	0	Masc
Dochodzi 5-ta i zaległa cisza .	zaległa	3	Fem
- Prokuratura stołeczna równolegle z UOP wszczęła śledztwo w sprawie przecieków .	wszczęła	6	Fem
tutaj obcięła m Ewelinę .	obcięła	1	Fem
Do godziny drugiej po południu wszystko toczyło się normalnie .	toczyło	6	Neut
Tysiące zwiedzających oblegało stoiska .	oblegało	2	Neut
Jadący motorem 22-letni mężczyzna na łuku drogi stracił panowanie nad pojazdem i uderzył w betonowe ogrodzenie .	uderzył	12	Masc
I zjechawszy na kolana gorzko zapłakał zapominając , że patrzą na niego ludzie .	zapłakał	5	Masc
Powinno być odwrotnie .	Powinno	0	Neut
Nigdy nie zostanie rusałką ta , która pokalała swój wianek .	pokalała	7	Fem
Niewiele brakowało , by zaproponowała odstrzał niegrzecznych myśliwych polujących na kuropatwy .	brakowało	1	Neut
Jakże by m ja śmiał . . .	śmiał	4	Masc
Nawet u mnie nie byli , bo formalności wizowe trwały zbyt długo .	trwały	9	Fem
Na Irku cały ten wywód nie zrobił żadnego wrażenia .	zrobił	6	Masc
Z pozostałymi członkami dawnego kierownictwa związanymi z Gomułką plenum obeszło się bezceremonialnie , usuwając ich w większości ze składu KC .	obeszło	9	Neut
Gdy goście opuścili jego dom i pozostał jedynie 63-letni emeryt , doszło między nimi do sprzeczki .	doszło	11	Neut
Jak to musiało wyglądać z daleka . . .	musiało	2	Neut
Pierwsze i jedyne auto zatrzymało się przy nich dopiero po kilku kwadransach !	zatrzymało	4	Neut
Mieszkanie na pewno na tym zyskało .	zyskało	5	Neut
Przemkowi już kilka razy nauczycielka zabierała telefon , bo bawił się nim podczas lekcji .	zabierała	5	Fem
Wydaje się , że o decyzji przesądziły trzy czynniki .	przesądziły	6	Masc
Udało się !	Udało	0	Neut
Choroba Ani zaczęła się niewinnie .	zaczęła	2	Fem
Terroryści wyciągnęli broń i strzelali w powietrze .	strzelali	4	Masc
Janos wykonywał stoły , zydle , półeczki dla siebie , rodziny , sąsiadów , płacił nimi za pomoc przy gospodarstwie .	wykonywał	1	Masc
A jaki się ukazywał Annaliese Micheal ?	ukazywał	3	Masc
Słońce Grecji zgasło i nad tragedią Sofoklesa zapadły egipskie ciemności .	zgasło	2	Neut
Z połączonych dłoni zrobili koło .	zrobili	3	Masc
Sanki pomknęły po ubitym śniegu na Pohulankę .	pomknęły	1	Neut
Dwa osobowe samochody zderzyły się dachami .	zderzyły	3	Masc
- Widzę , że pan niezbyt się przejął tą zbrodnią .	przejął	7	Masc
Wyprostowała plecy .	Wyprostowała	0	Fem
Nie znał em go przedtem , bo za moich czasów wileńskich był jeszcze sztubakiem , a potem przebywał za granicą .	przebywał	17	Masc
Witały ich entuzjastyczne oklaski .	Witały	0	Neut
Jesienią zeszłego roku odwołać dyrektora Ziarkowskiego usiłowała Rada Kasy .	usiłowała	6	Fem
Spała niespokojnie , często rzucała się na łóżku , zdarzało jej się nawet krzyczeć .	rzucała	4	Fem
Wiatr szarpał szalik pilota , a szkła lotniczych okularów błyskały purpurą .	błyskały	9	Neut
Zgodnie z oczekiwaniami po złoto sięgnęły ekipy gospodarzy .	sięgnęły	5	Fem
Widziałem , jak wielka epidemia uderzyła w Hongkong .	uderzyła	5	Fem
Unosiła się wokół nich anielska aura .	Unosiła	0	Fem
Przypomniał swą pierwszą sprzed kilku lat wizytę w Ludwinowie w 1860 roku , zabawił kilka dni , zburzył spokój samotniczki .	zburzył	17	Masc
Przeżyła szok , którego nie złagodził nawet środek uspokajający .	Przeżyła	0	Fem
Proszę zobaczyć , ilu posłów AWS nie głosowało .	głosowało	7	Neut
- Wstało by twoje matczysko .	Wstało	1	Neut
CBŚ zarządziło na poniedziałek obławę .	zarządziło	1	Neut
Prowadziła także programy telewizyjne dla mniejszości ukraińskiej i rosyjskiej w Polsce .	Prowadziła	0	Fem
Na skrzyżowaniach wyrastają rośli policjanci , gazeciarze wciskają przechodniom papierowe płachty i przekrzykują się nowościami z wczorajszego dnia i nocy , która właśnie minęła .	minęła	23	Fem
Na chwilę mignęła mi sylwetka dziewczyny z łopatą na ramieniu .	mignęła	2	Fem
Dochodzi 5–ta i zaległa cisza .	zaległa	3	Fem
Poprosił ekspedientkę o dostęp do telefonu , tłumacząc , że musi zadzwonić do swojego wspólnika .	Poprosił	0	Masc
Może nawet płakała już przedtem , ale spostrzegł em to dopiero teraz .	płakała	2	Fem
Rumuński parlament odrzucił rządowy projekt ustawy przewidujący likwidację kar za homoseksualizm .	odrzucił	2	Masc
Powstał chaos .	Powstał	0	Masc
Oczy powlekła biaława szklistość , co wzmogło tajemnicę spojrzenia .	powlekła	1	Fem
Zaproponowano więc Krystynie , która skwapliwie skorzystała .	skorzystała	6	Fem
Przyszła Kryśka i zdziwiła się , że jestem taka blada .	zdziwiła	3	Fem
A więc chroniła i tuliła .	chroniła	2	Fem
W sezonie letnim w 2005 r. utonęło 325 osób .	utonęło	6	Neut
Chce , by powstał na nich ośrodek sportów wodnych .	powstał	3	Masc
Znowu odpowiedziało mu milczenie .	odpowiedziało	1	Neut
Pseudokibicom ze Stalowej Woli upiekło się , choć nieźle w sobotę nabroili .	nabroili	11	Masc
Kilka par tańczyło w przyćmionym świetle , które zdawało się być substancją podobną do mgły z tiulu .	zdawało	8	Neut
Tego dnia nie tylko Żanna miała swoje święto .	miała	5	Fem
- Dosyć się napatrzyła m .	napatrzyła	3	Fem
Dziewczyna podziękowała .	podziękowała	1	Fem
I uśmiechała się do tego chłopaka nawet na ulicy .	uśmiechała	1	Fem
Niestety , wykonane opodal obwałowania niewiele dały .	dały	6	Neut
Na miejscu specjalna ekipa zbadała pozostałości po eksplozji .	zbadała	4	Fem
Zastrzeżenia wojewody dotyczyły tylko Polaków na stanowiskach kierowniczych .	dotyczyły	2	Neut
Dlatego ukrył się i przedostał w środek nieprzyjacielskiego oddziału .	przedostał	4	Masc
Zarysowały się mury kilku budynków .	Zarysowały	0	Masc
Dobrze zbudowana , na starość otyła , poruszała się szybko i zręcznie .	poruszała	7	Fem
Roboty finansowało w całości uzdrowisko .	finansowało	1	Neut
- Nie spodziewał em się tego po tobie , Teresko !	spodziewał	2	Masc
To nie mogło być naprawdę .	mogło	2	Neut
Wciąż drożeją zboża , głównie żyto , a ceny pszenicy ustabilizowały się na wysokim poziomie .	ustabilizowały	10	Fem
W piątek i sobotę tylko w Chicago zmarło na skutek gorąca dalszych 26 osób .	zmarło	7	Neut
Podrożały stanowiska .	Podrożały	0	Neut
Sprzedaż monti i stanowisk nie pokrywała chronicznego deficytu .	pokrywała	5	Fem
To by mu rozwaliło żołądek .	rozwaliło	3	Neut
Obok leżał rower , którym jechała kobieta .	jechała	5	Fem
Pożyczyła i zapomniała oddać .	Pożyczyła	0	Fem
Tego wymagała grzeczność .	wymagała	1	Fem
Jak kłamała .	kłamała	1	Fem
Rozpoczął się kolejny rok akademicki .	Rozpoczął	0	Masc
Uniemożliwiła mu to bardzo ofensywna postawa Raftera .	Uniemożliwiła	0	Fem
Lekarze zdecydowali się na operację , ale brakowało dawcy .	brakowało	7	Neut
Do roli premiera nie dorastał .	dorastał	4	Masc
Wprowadzić mechanizm , by sądy respektowały takie ugody .	respektowały	5	Masc
5,5 tys . osób pozostało bez dachu nad głową .	pozostało	4	Neut
Janka bez słowa wkładała już białe sandałki , sięgnęła po torebkę .	sięgnęła	8	Fem
O ziemię zastukały ciężkie buty .	zastukały	2	Masc
Spod wody wyłaniały się nowe kontynenty .	wyłaniały	2	Masc
Wybiegł em .	Wybiegł	0	Masc
Co sprawiło , że zaangażował się pan w ten ruch i tę ideologię ?	zaangażował	4	Masc
Kompletnie pijany zjechał na lewe pobocze drogi i uderzył w drzewo .	zjechał	2	Masc
Nerwy jej niepotrzebnie puściły .	puściły	3	Neut
