Ramiz girip başını eğerek kapının önünde dikildi .	dikildi	6	3
Böyle bir acı var mı ? Ölüm şekline dua ediyoruz .	ediyoruz	9	1
Yanlışlanabilirlik ilkesi ne yazık ki çoğu zaman yanlış yorumlanmaktadır .	yorumlanmaktadır	8	3
Şirketin patronu olan okul arkadaşım her zaman giydiği birbirinin aynı siyah takım elbiseleri , inanılmaz derecede parlak kravatlarıyla öğlen yemeğine giderken kapıdan kafasını uzatıp Kaç ? diye soruyordu , ona o ana kadar okuyup kaydettiğim cinayetlerin sayısını söylüyordum .	söylüyordum	37	1
Öyle kolay gelmez ki o .	gelmez	2	3
Şimdi düşünüyorum da , galiba o parkın dışında yapamayacağım ben , dedi Kerem .	düşünüyorum	1	1
Sevilme peşinde koşan ve sevmeyi bilemeyen iki genç , yasal ve yasal olmayan uyuşturucuların etkisiyle sevme oyunu oynayacaklar ve minik bağımlı çocuklar dünyaya getirecekler .	oynayacaklar	17	3
Halbuki arada gidip günah çıkardın mı , kendini bir miktar yırtmış hissediyorsun , temizlenmiş hissediyorsun , aynı haltı yiyeceğini bilsen bile bir güvencen var .	hissediyorsun	14	2
Başlığı bulunca rahatladım , krizden kurtuldum ...	rahatladım	2	1
Onların gürültülü neşesi , duyduğum yalnızlık duygularını azaltıyordu , ama neler konuştuklarını da anlamıyordum .	anlamıyordum	13	1
Siz farkında olmadan , sizinle bir anlaşma yaptım ve kendinizi bana teslim ettiniz .	ettiniz	12	2
Beş bin askerinin harekatında pirinç ve ekmek stoku yapmıyor .	yapmıyor	8	3
Buna göre bakanlık soruşturmayı yenileyebilirdi .	yenileyebilirdi	4	3
Onun Protestan fondamantalizmini bir yana bırakıyorum .	bırakıyorum	5	1
Bu dönemde , teori , bilimin çeşitli alanlarında , yeni kavramsal yapılanmalarla bilimi yeni düzlemlere taşımış ; geçmişin kavramsal yapılanmalarında köklü bir kopuşla bilimin önünde yeni ufuklar açmıştır .	taşımış	15	3
Sezonu kapamakta inatçı bir genç sürat motoruyla göremediğim birine fiyakalar yapıyordu daireler çizerek .	kapamakta	1	3
Sahi siz , aradığınız bu Ana'yı gördünüz mü hiç ? dedi .	gördünüz	6	2
Birbirimizi biliriz .	biliriz	1	1
Bodrum evi için bir anlamı ve güzelliği olan gumbillinin ( Bodrum evine özgü çatı parapeti köşelerinde yer alan süs elemanı ) ve beyazın , binlerce tekrardan sonra mide bulandırdığını söylemeliyim .	söylemeliyim	29	1
Kapının orda hafifçe sendeledi .	sendeledi	3	3
Az önce onunla konuşuyordum , dedim .	konuşuyordum	3	1
Şöyle bir dolaşayım evini ...	dolaşayım	2	1
Yurtdışlarına gitti , ekonomi - mekonomi , işletme - mişletme de okudu .	okudu	11	3
Milliyet'i arayan Arınç , " Yanlışlara ortak olmam " haberindeki ifadenin rahatsızlık yarattığını , Erdoğan'ın Danimarka'dan arayarak tepki gösterdiğini belirtti .	olmam	7	1
Güneş batarken ve eylül rüzgarları kuruyan otların üstünde belli belirsiz gezinirken buluşmalıydınız .	buluşmalıydınız	11	2
Dilerim , dedi .	Dilerim	0	1
Biraz daha anlatmalıyım diye düşündüm .	anlatmalıyım	2	1
Elleşme , tamam , dedi .	Elleşme	0	2
Ama söylediği fikir şahsi fikri , aslında genel bir görüşü kapsıyordu .	kapsıyordu	10	3
Nereye dokunsam altın ışıklar saçılıyordu zarif kol hareketlerimden .	dokunsam	1	1
Kamulaştırmalarda , inşaatın kontrolörlüğünü yapacak olan İngiliz BP'nin isteği üzerine ' uluslararası standartlar ' uygulanacak .	uygulanacak	14	3
İzini bulursanız , bu numaraya haber verirsiniz , dedi .	verirsiniz	6	2
Eşi ve kızı öldü ama o bilmiyor .	bilmiyor	6	3
Odaya en büyük yeğen yerleşti , işin beyni o olduğuna göre , münasiptir .	yerleşti	4	3
Havaalanından yaklaşık otuz kişiyi aramış , herkesle şakalaşıp vedalaşmış .	aramış	4	3
Bir süre kepenkleri inmiş dükkanların önünden yürüdüm , gece zamanı karanlık ve sessiz duran şadırvana bir göz attım .	yürüdüm	6	1
Bir de bir laf çıkarmışlar : Senin yaptığını , Çorumlu Çorumluya yapmaz .	çıkarmışlar	4	3
Ama göreve çağrıldı .	çağrıldı	2	3
Yedi saatlik yolculuk boyunca - ki yetmiş kilometre kat edecektik - bir tek eve rastlamanın mümkün olmadığı bir coğrafya .	edecektik	9	1
Sokaklar birbirine karıştı .	karıştı	2	3
Çünkü , sanık sandalyesinde oturan darbecilerden birisi kalkıp dinleyici sıralarına parmağını uzatsa ve sorsa .	uzatsa	11	3
Tayyip Erdoğan'ın yanında , onun yanlışlarına ortak olsaydım kesinlikle bu noktalarda bulunmazdım .	bulunmazdım	11	1
Rekabet neler yaptırıyor .	yaptırıyor	2	3
Belki ahirette başına gelecekler değişmiyor , ama şu dünyada yaşarken daha komplekssiz , daha nazik ve daha hoşgörülü olabiliyorsun .	olabiliyorsun	18	2
Bunu kendisine yapılmış saygısızlık sayıyordu , gurbet ellerde bulduğum işe gitmemi yediremiyordu kendine .	yediremiyordu	11	3
Kendimi , bilincimin daha rahat olacağı bir dalgınlığa bırakmaya çalıştım .	çalıştım	9	1
Hiçbir mitosun ardı sıra sürüklenmiyorum .	sürüklenmiyorum	4	1
Yahu nasıl yaptırırız zorla ?	yaptırırız	2	1
Başkanın verdiği davette cam gibi cilalanmış döşemeler üzerinde kayıp da kırdığım sol bacağım yüzünden her gün hastaneye gidip kadavra üzerindeki çalışmayı gözüm yemiyordu .	yemiyordu	22	3
Nasıl bir viski vereyim sana .	vereyim	3	1
Böyle bir saldırıyla karşılaşan bir geyik çobanı sabah , heyecanla olanları anlatmıştı yola çıkarlarken .	çıkarlarken	13	3
1970'li yılların başında ölen bir yaşlı adamın mezarının etrafında toplanıldı .	toplanıldı	9	3
ikibinbir'de ikiyüzseksenbir milyon kankaları ihracat yapan Arçelik , ikibiniki'de ihracatını yüzde kırkyedi artırarak dörtyüzondört milyon Ataizi yükseltti .	yükseltti	16	3
( Bakınız : " Taşkın Türkler " , " Biraz Profilo .	Bakınız	1	2
- Kaçıncı kata çıkıyorsun .	çıkıyorsun	3	2
Şimdi hiçbir şeye yaramadıklarını düşünsem de , yaşayabilmek için yazmak ! Böylece , o beklemekle , aramakla , bütün bu zaman parçalarını dolduracak olan boşlukla ve sıkıntıyla dolu yaşam çizgimi belirledim sanıyorum .	düşünsem	4	1
Akgündüz'ün fezlekesi , davanın ağır ceza mahkemelerinin kapsamına girmesi nedeniyle , bünyesinde ağır ceza mahkemesi bulunan Bakırköy Adliyesi'ne gönderilecek .	gönderilecek	18	3
Henüz Türkçeye çevrilmemiş .	çevrilmemiş	2	3
Aradığımı Buldum Sandım .	Sandım	2	1
Yerimden fırladım , kapıyı hızla açıp Ömür Uzatma Kıraathanesi'nden dışarıya çıktım .	çıktım	10	1
Dünyanın merkezi bendim ama dünyanın merkezinin bu kadar kalabalık olduğunu bilmiyordum , diyor .	bilmiyordum	10	1
Neyse ki üçüncü kez sorduğunda iyi bir cevap hazırlamıştım : Esinciğim evde tek kız olmasının daha iyi olduğuna karar verdik .	verdik	19	1
Bunları biliyorsunuz .	biliyorsunuz	1	2
O anlamda , tarihin doğrusu ya da yanlışı çok da fark etmiyor .	etmiyor	11	3
Keşke hayata ve aşka dair konuşsaydınız önce ...	konuşsaydınız	5	2
Anne , ne olur , ses çıkartmadan çalayım , içine kazağımı tıkarım , diye yalvardı çocuk .	tıkarım	11	1
Lütfen bana gerçeği söyle .	söyle	3	2
Dolaşıp durma , başım dönüyor .	durma	1	2
Ev , ya da ev yapmak adına , ülkemizdeki gecekondu uygulamalarından öğrenecek epey şeyimiz olduğunu düşünüyorum .	düşünüyorum	15	1
Kapıyı itiyorum , zorluyorum , tam biraz açılır gibi oluyor , gene kapanıyor .	zorluyorum	3	1
Yoğun siste uçak piste doğru gelirken pilota " Yaklaşma hattının solunda kaldın " uyarısı yapıldığı , bunun üzerine pilotun uçağı düzeltmeye çalıştığı , ancak sol dikmenin ( ana iniş takımı solu ) tepeye çarptığı ifade edildi .	gelirken	5	3
Acemi vücutlarının , aldıkları alkolün de etkisiyle , ancak çırpınış düzeyine ulaştırabildiği göbek dansını kesen turistlerin yerlerine oturmaları birkaç dakika bile sürmezdi .	sürmezdi	21	3
Dün gece diskoda unutmuşsun .	unutmuşsun	3	2
Mücadele ... diye mırıldandı adam .	mırıldandı	3	3
Katana deme .	deme	1	2
Kelime Rumca gibi görünse de değil .	görünse	3	3
Diz çök karşısında , okşa saçlarını , özür dile , bağış dile , ne dilersen dile it herif , ağla hatta elinden geliyorsa ...	dilersen	14	2
Kafamın yetmediği fen derslerinde düşünürdüm : Aynı hoca ağabeyime de böyle anlatmış .	anlatmış	11	3
Bir köpeğin bütün kokuları birbirinden ayırdedip insanların duygularını kokularından anlamaları gibi kadınların sesini tanırdım , her tonunu bilirdim , yalnızca kulaklarımla değil bütün vücudumla duyardım onların sesini .	duyardım	24	1
Önce Serpil Biriçim , sonra Fikret Bila Bey'i aradım ..	aradım	8	1
Boş zamanlarımda bazen cinayetlerin işlendiği yerlerde dolaşıp çevreye bakınır , cinayet anını gözümde canlandırmaya uğraşırdım .	uğraşırdım	14	1
Sesler değişse bile duyguların seslere kattığı tonlamalar değişmez , ne kadar saklamak isteseler de bunu beceremezler , bir köpekten kokularını saklayamayacakları gibi benden de seslerini saklayamazlardı .	isteseler	12	3
Neden sonra Katana ağaçtan süzülüp indi .	indi	5	3
Tayyip Erdoğan'ın yanında , onun yanlışlarına ortak olsaydım kesinlikle bu noktalarda bulunmazdım " sözünün Milliyet tarafından farklı yansıtıldığını öne sürdü .	bulunmazdım	11	1
Versem mi acaba ? Yanlış bir şey yapmış olmayalım ? diye sordu .	Versem	0	1
Buyur , Ayşe abla , geç sofraya .	Buyur	0	2
Türkiye'ye Çin'den elli bin turist geleceğini öngörüyorum .	öngörüyorum	6	1
Bugün Ulusal Müzeyi gezdim , sonra da seni düşündüm .	düşündüm	8	1
Kendimi uyuşturucularla adım adım öldürürken bile ölmekten korkuyordum .	korkuyordum	7	1
Kardeşini eleştiriyor gibi geldi bana , neden sokulgan onca ?	eleştiriyor	1	3
Telaşla ayağa fırladı , telefona koşarken kapı vuruldu .	vuruldu	7	3
Görürüz bakalım , yarın o arabayı kim silecek , diye tehditler savurarak uzaklaştı diğer siliciler .	Görürüz	0	1
Beğendin değil mi marifetini .	Beğendin	0	2
Hiçbiri , hiçbirimize sürpriz olmadı ...	olmadı	4	3
Hitler'in Almanya için kimi iyi şeyler yaptığına , Karl Marks'ın dört ayak üstünde çocukları sırtında gezdiren , büyümeyen bir çocuk olarak kaldığına hayretle muttali oluyorsunuz .	oluyorsunuz	24	2
Onlardan intikam alırım .	alırım	2	1
Bu kızgınlığım yüzünden sana normal davranamıyorum .	davranamıyorum	5	1
Sen de fena değilsin .	değilsin	3	2
Giriyorum içeriye , dedim .	Giriyorum	0	1
Bu yüzden mi terk ettin evini .	ettin	4	2
Bilimin bugün içinde bulunduğu konumu daha yakından çözümlemek ve geleceğe ilişkin bazı kestirimlerde bulunabilmek için , burada sözünü ettiğimiz ilişkilerin tarih içinde izlediği gelişme çizgisini ele almak istiyoruz .	istiyoruz	27	1
Versem mi acaba ? Yanlış bir şey yapmış olmayalım ? diye sordu .	olmayalım	8	1
Keskin toplum eleştirisi , esprili ve zeki özeleştiri , bir çeşit kara mizah , bilgi düzeylerinin çok üstünde bir entelektüel performans onlarla tanışanları şaşırtır ve çarpar .	çarpar	25	3
Ayak oyunuyla bir yuvarlayabilsem kanapeye .	yuvarlayabilsem	3	1
O , kendi açlığıyla oğlunu sevgiye boğduğunu bilmiyordu .	bilmiyordu	7	3
Bunu nasıl daha mümkün hale getiririz diye düşünürken Amerikalı şirket aleyhine bir dava açarak belgeleri , savcılığın soruşturma belgelerini Kara Kuvvetleri'nin müşterek kanaat raporuna konu olan belgeleri oraya getirtmek mümkün olur gibi bir fikir geldi aklımıza .	getiririz	5	1
Türkiye , geçmişle ve geçmişin korkularıyla bağlarını kopardı gidiyor .	gidiyor	8	3
Hızla yerimden kalkıp , Taşhan'dan dışarıya çıktım .	çıktım	6	1
Bak işte bu fotoğrafta yan yana duruyorlar .	Bak	0	2
Cebindeki elli bini ne yaptın ? diye sordu oğlana .	yaptın	4	2
Bir süre sessiz yürüdük .	yürüdük	3	1
Yanılıyor muyum yoksa .	Yanılıyor	0	3
Önce hayatlarının çizgileri teğet değdi birbirine ...	değdi	4	3
Annenin veya babanın hemen evleneceğini neden aklına getiriyorsun ?	getiriyorsun	7	2
Kertenkelelerin değiştirdiği derileri duvar diplerinden topladığın çocukluk günlerini hatırlamıştın .	hatırlamıştın	8	2
Kendinizi bir bağımlılıktan kurtarıp buraya geldiniz .	geldiniz	5	2
Öyle , lodos balığı gibi kendinizi oradan oraya atarsınız .	atarsınız	8	2
Niçin beni rahatsız ediyorsun ufaklık ? diye homurdanmış .	ediyorsun	3	2
Çilingirgillerden Ayhen kart bastırıvemiş , kendini geleceğin cumhurbaşkanı ilan edivemiş ...	edivemiş	9	3
Keşke bu şalı ona armağan etseydim .	etseydim	5	1
Leblebici'nin ustalığı sayesinde adam olmuştur .	olmuştur	4	3
Benim yüküm bana yetiyor , Hülya , halimi görmüyor musun ? dedim .	yetiyor	3	3
Ayla , E , tamiratsa Celal yapıverir , dedi .	yapıverir	6	3
Çin restoranlarını artırmak için otelleri teşvik ediyoruz " diye konuştu .	ediyoruz	6	1
Geldik ! diye bağırdı Kerem .	Geldik	0	1
Sen de dört gecedir bir uğrayıp bakmadın bana , dedim .	bakmadın	6	2
Siz mektubu hazırlayın , ben götürür veririm , dedim .	veririm	6	1
Fısıldadı : Sağ ol .	ol	3	2
Cinsel çekim ... diye mırıldandı adam .	mırıldandı	4	3
Birkaç yıl sonra da , bir gazetede gece sekreteri olarak çalışmaya başladım .	başladım	11	1
Yüzlerini , bakışlarını , sözlerini , hatta seslerini bile değiştirebilirler , ama o seslerin içindeki küçücük vurgulamaları değiştiremezlerdi .	değiştiremezlerdi	17	3
Dosyanın bütün olarak ilgiyle okunacağını düşünüyoruz .	düşünüyoruz	5	1
Bu , dedikodu denen haz dünyasından ırak yaşayan bir püriten olsun , gidip zaman zaman ona içimizi dökelim .	dökelim	17	1
İstatistiklere baktığımızda bu seviyenin mevcut belirsizlik unsurlarının ortadan kalkması durumunda ikibinüç yılında da büyük bir olasılıkla test edilebileceğini tahmin edebiliriz .	edebiliriz	19	1
Hiçbir şey , hiçbir şey anlatamadım .	anlatamadım	5	1
Ben Erbakan'ın yanında onun yanlışlarına ortak olsaydım kırk defa bakan olurdum , elli defa genel başkan olurdum .	olurdum	10	1
Durun , oturun biraz .	Durun	0	2
Sen de benim yaşıma gel , sana da alırlar göreceksin .	göreceksin	9	2
Yandaki odanın kapısını vurdum .	vurdum	3	1
Ağzını yokluyor bir yandan .	yokluyor	1	3
İyice kollarız , dedi Katana , yoksa dalarız .	dalarız	7	1
Yerleştir yerleştirme , devşir devşirme sınavları falan filan yok ...	devşirme	4	2
Ben yeni yedim .	yedim	2	1
Hem hiç merak etme benim annem ona herkesten iyi bakar .	etme	3	2
Bir mektup ulaştırdım Mahmut'a .	ulaştırdım	2	1
Ne demek , Ben evden kaçarım , demek ?	kaçarım	5	1
Öyle mi dersiniz .	dersiniz	2	2
Onu en iyi okullarda okuttum diyerek kendisini rahatlatma yollarını arıyordu .	okuttum	4	1
Başka bir kadına rastladı , dedi kadın .	rastladı	3	3
Sen de benim yaşıma gel , sana da alırlar göreceksin .	gel	4	2
Hem daha çok küçük , sen nasıl bakacaksın Kahve'ye .	bakacaksın	7	2
Ancak o zaman tüm belgelere ulaşabilecek ve bir yön bulabileceklerdi .	bulabileceklerdi	9	3
O kayıtsızlığıyla beni yerden yere vurdu , ben uğradığım muamele karşısında kapıldığım dehşetle kendimi yerden yere vurdum .	vurdum	16	1
Herkes aynı miktar harçlık alamıyor .	alamıyor	4	3
Elini sol cebine sokup bir fotoğraf çıkarttı , uzun uzun baktı .	çıkarttı	6	3
Sırtına yapışan kumlar , otlar bile uyandıramadığına göre çok yorgun olmalıydı .	olmalıydı	10	3
İzlenimlerini ertesi sabah , duru gün ışığında kaleme alması daha sağlıklı olacaktı .	olacaktı	11	3
Gidelim , birlikte saldıralım .	saldıralım	3	1
Dayım , Eee , kes şu şarkıyı , demişti de , o da dayıma , Bu şarkı değil bi defa - , marş bu marş , akıllım , diye karşılık vermişti .	vermişti	30	3
Attım dışarıya , can havliyle .	Attım	0	1
Düşen " Konya " uçağında kabin görevlisi olan Deniz Karasu'nun hostes ablası Gaye Karasu , kardeşinin öldüğüne inanamadı .	inanamadı	17	3
Mektubu yazdım , dedi .	yazdım	1	1
Masanın öbür tarafında oturan yaşlı adamın doksan yaşında olduğunu söylediler .	söylediler	9	3
kavramlar değişti mi , her şey değişiyor .	değişiyor	6	3
Her gün de Adsız Narkotikler toplantısına katılıyor .	katılıyor	6	3
Sopa yiyeceğiz , dedi Miskoye .	yiyeceğiz	1	1
Bazı geceler kulağımı kapısına dayar , dayak yerken attığı çığlıkları dinlerdim .	dayar	4	3
Bu ay tencere , öbür ay pompalı gazocağı , ev düzdüm .	düzdüm	10	1
Aynada kendimi çok beğendim .	beğendim	3	1
Tamam ! tamam ! Hadi çabuk anlat , meraktan öleceğim .	anlat	6	2
Gazetecileri , yüksek meslek standartları tutturmaya , metinlerinde insani bir anlayış düzeyi kurmaya çağırıyorum .	çağırıyorum	13	1
Bu kuruluşlar da paralarını Merkez Bankası veya muhabiri niteliğindeki Ziraat Bankası'nda açacakları hesaplarda toplayacaklar .	toplayacaklar	13	3
Keskin toplum eleştirisi , esprili ve zeki özeleştiri , bir çeşit kara mizah , bilgi düzeylerinin çok üstünde bir entelektüel performans onlarla tanışanları şaşırtır ve çarpar .	şaşırtır	23	3
Anladım ki bu taşınma kararımdan hoşnut , doğallaştırıp sıradanlaştırmaya çalışıyor , ama nafile , ben başlayacak bu yeni beraberliğin taze heyecanını bastıracak halde değilim .	Anladım	0	1
Elini , rengi atmış kirli beyaz , uzun donunun içine soktu , orasına burasına yapışmış kumları temizledi .	temizledi	16	3
Ben Erbakan'la Erdoğan'ı aynı kefeye koymam " dedi .	koymam	5	1
' Cumhuriyet'ten sapmayız Verheugen .	sapmayız	2	1
Fısıldadı : Sağ ol .	Fısıldadı	0	3
Berkeley ve yazarlarının savlarının , benzerliğine demeyeceğim , aynılığına dikkat ediniz !	ediniz	10	2
Buna karşılık ben de onun mutsuzluk oyununu oynamadım .	oynamadım	7	1
Sonunda Esin Abi şimdi bizim bir köpeğimiz mi olacak ? deyince anlattıklarımın sadece bir kısmını dinlediklerini anladım .	anladım	16	1
Bu koca yuvarlak Dünya'nın etrafında dönüyordu .	dönüyordu	5	3
- Okuyorum .	Okuyorum	1	1
Merdiveni geri çıkarken başımı Hülya'nın sırtına yasladım .	yasladım	6	1
Adam kızın annesini görür görmez kadının güzelliğine vurulmuş .	görür	3	3
Aydınlatır mısınız ? " diye soruyor .	Aydınlatır	0	3
Biraz da telaşlandığımı itiraf etmeliyim .	etmeliyim	4	1
Dil bükmüş , bize uydurmuşuz .	uydurmuşuz	4	1
Harbiyeli Gidin , evinize yatın diye talimat verdi .	Gidin	1	2
Katana başı önünde yerine yürürken Ramiz'e kaçamak bir bakış attı .	yürürken	4	3
Ben bir hizmet insanıyım , söylerim , söylediğimin arkasından giderim ve bana neye mal olursa olsun ben bununla iftihar ederim .	giderim	9	1
Kalktım , sarıldım boynuna , zoraki öptürdü pembeliğini koruyan yanaklarını .	öptürdü	6	3
Bakarız , dedi kadın , sonra sandalyesini biraz yan çevirdi , çalgıcıları görmek için .	Bakarız	0	1
Bunlar olup biterken küçük sarışın çocuk , kucağında , bacaklarının arasına sıkıştırdığı darbukaya sol eliyle hiç ses çıkarmadan , okşarcasına vuruyor , sağ eliyle de tabağındakileri ağzına tıkıştırıyordu .	okşarcasına	19	3
Yatırım teşvik belgesi süreleri bir yıl uzatılsın .	uzatılsın	6	3
Kıskanmanın çaresizliğinden ve içimde yarattığı aşağılanma duygusundan kurtulmak ve bana kaçınılmaz gözüken o terk edilme gününun acısını daha baştan hafifletmek için , hayatıma kattığım kadınların sayısı artıyordu .	artıyordu	26	3
Kemal : Çok parçalıyorsun her şeyi , Nesrin .	parçalıyorsun	3	2
Öğretmenim , babam tarlada çalışıyordu ...	çalışıyordu	4	3
İkili , bu birbuçuk saat zarfında dosyaların ellerine ulaşmayan parçalarını çıkarttılar .	çıkarttılar	10	3
Ya okula geç kalırsak .	kalırsak	3	1
Ailesinden kendisine büyük bir miras kalmış olan karısını , türlü numaralar çevirip Bakırköy Akıl Hastalıkları Hastanesi'ne yatırıyor .	yatırıyor	16	3
Doğum günüm yaklaşıyor .	yaklaşıyor	2	3
Ya da ardından mutlaka sevgi sözcükleri kullanır .	kullanır	6	3
Bir arkadaki kızağı çeken Yeltsin ve Çernomirdin ile ara ara göz göze geldiğimizde şefkatli bakışlarını seziyordum .	seziyordum	15	1
Orada , denizi gören yamaçlarda , ağaçların altına uzanıyor , piknik yapıyor , sonra da sonsuzca öpüşmelere başlıyorduk .	yapıyor	11	3
Bu işlem , bardak ağzına ulaşana dek özenle sürerdi .	ulaşana	5	3
Tam o sırada Hülya birisiyle gelebilir ve beni görebilir diye ...	gelebilir	5	3
Eksi elli dereceye varan kış , onu son nefes aldığı günkü kadar zinde gösteriyor .	gösteriyor	13	3
Almanca ve İngilizce'yi çok iyi konuşan Jouni , sık sık yurtdışı seferlerine çıkıyordu .	çıkıyordu	12	3
Evlenseydiniz , bak nasıl üstüne titrer , çekip çevirirdi seni .	çevirirdi	8	3
Hülya duydu , yaramaz ama çalışkan öğrenciye kızan öğretmen gibi kararsız , dudak büktü .	duydu	1	3
Hiçbir şey anlatamadım , diye acıyla inledi .	anlatamadım	2	1
Her zamanki masasında oturuyordur .	oturuyordur	3	3
Çoğu konuda birbirimizi anlamıyoruz .	anlamıyoruz	3	1
Onu tanıyanlar Bakırköy'de en yatmayacak insan diye tanımlıyor .	tanımlıyor	7	3
Bu kadar yeter , dedi , inin de gidelim artık .	gidelim	8	1
Bu gece ulaştırmam gerek ...	ulaştırmam	2	1
Bir köpeğin bütün kokuları birbirinden ayırdedip insanların duygularını kokularından anlamaları gibi kadınların sesini tanırdım , her tonunu bilirdim , yalnızca kulaklarımla değil bütün vücudumla duyardım onların sesini .	tanırdım	13	1
Durum böyle olsaydı , ona şu kentin en canlı yeri olan alandaki kahvelerden birinde rastlardım şimdiye kadar .	rastlardım	14	1
" Mülklerimiz için ' gasp edildi ' diyebiliriz .	diyebiliriz	7	1
Bila , " Sizinle ilgili izlenimlerimi yazacağım , isterseniz , bu söylediklerinizi de yazayım , ancak teypteki ifadenizi de yazmak zorundayım " karşılığını verdi .	yazayım	13	1
Susup durduk .	durduk	1	1
Zarfı açtı ve mektubu okuyor .	okuyor	4	3
Bana değil de arkamda duran , dönüp baksam benim göremeyeceğim bir şeye , belki de bir aslana bakıyordu .	göremeyeceğim	9	1
on günde bir Diyarbakır'a giderdi .	giderdi	4	3
Orada , denizi gören yamaçlarda , ağaçların altına uzanıyor , piknik yapıyor , sonra da sonsuzca öpüşmelere başlıyorduk .	başlıyorduk	17	1
O sizi gene parkın içine çeker dedi Şakir .	çeker	5	3
Başını kaşıyor , kararsız .	kaşıyor	1	3
Buradan pozisyon açan yatırımcı , 1.Şub yıl içinde İMKB yuz Endeksi'nin yuzon sente gelmesi durumunda dolar bazında yüzde yuz reel getiri sağlayabilir .	sağlayabilir	21	3
Bulutların ardındaki güneşin ışığı , donuk bir kuzey aydınlığı yaratıyor , bana Ulusal Müzedeki bazı resimleri düşündürtüyordu .	düşündürtüyordu	16	3
Kalkmaya hazırlanan masadaki iki genç kadının ayaklarının oynamaya başladığını , ince hırkalarının altında omuzlarının titrediğini , parmaklarının tempo tuttuğunu gördü , sevindi .	sevindi	21	3
Aydınlık gazetesinde konuştuğu muhabirler , Biz size yardımcı olalım , dediler .	olalım	8	1
Öğretmenim , diyeceğim , köpeklerden korktuğum için Miskoye ile Katana da benimle geldiler .	diyeceğim	2	1
Oturup sigara yaktım , telaşe halimin geçmesini bekledim .	bekledim	7	1
İkimiz de kendimizi yenik hissediyorduk , bu , ilişkimiz süreceği anlamına geliyordu .	hissediyorduk	4	1
Halbuki arada gidip günah çıkardın mı , kendini bir miktar yırtmış hissediyorsun , temizlenmiş hissediyorsun , aynı haltı yiyeceğini bilsen bile bir güvencen var .	bilsen	19	2
Ormanlarda , sularda dans ediyordum .	ediyordum	4	1
- Ben de yazdıklarımı sana gösteririm .	gösteririm	5	1
Geçmiş ola .	ola	1	3
Depoda bir kenara atılmış siyah ayı postu , boynuzlarıyla birlikte bir geyik kafası , kesilmiş geyik boynuzları duruyor .	duruyor	17	3
Onun yerine okula , ' Adını mezar taşına değil , okula yazdır ' pankartı asıldı .	asıldı	14	3
Bastır pehlivan , dal çakşırına ...	Bastır	0	2
dortyuz-besyuz milyarlık bir katkı daha yapacaklar " dedi .	yapacaklar	5	3
MCB'ye kimse anlam veremiyor .	veremiyor	3	3
Halam nasıl böyle büyüklerine laf çakıştıran bir çocuk yetiştirir diye şaşakalmıştık .	yetiştirir	8	3
Buraya bir şeyler anlatmaya geldiniz .	geldiniz	4	2
Ben saydım .	saydım	1	1
Öbür bardağı da doldurdu , döke saça .	doldurdu	3	3
Onları sekiz maddede tanıyalım !	tanıyalım	3	1
Niye susmuştunuz ben dönüp baktığımda ! ?	susmuştunuz	1	2
Dosyamızın esas unsuru olan ikinci bölümde ise sona eren bin yılın en büyük bilim ve düşün devrimlerini yansıtmaya çalıştık .	çalıştık	18	1
Yatak odamı beğeneceksin ama .	beğeneceksin	2	2
Aşınmış mermer merdiveni tırmandım .	tırmandım	3	1
Hüseyin ile Nükhet en iyi dans eden çiftti aralarında , gerçek hayatta bir çift oluşturmasalar bile .	oluşturmasalar	14	3
Oysa sılada daha az kazanıyor .	kazanıyor	4	3
Gene de dedemi çok seviyorum , yanlış anlama .	anlama	7	2
Oturma odasında cam kaseye kurulur .	kurulur	4	3
İnanmıyorsanız , Türkiye'nin kentlerinde ve kasabalarında bir pazar günü sokağa çıkın .	çıkın	10	2
Yeni gelecek öğretmeni çok merak ediyoruz .	ediyoruz	5	1
Benim adam her zamanki masasında oturuyordu .	oturuyordu	5	3
Bir ara babanızla annenizin ayrılacağından korktunuz .	korktunuz	5	2
O sırada çınlayan telefonla uyandım .	uyandım	4	1
Artık savını şöyle düzeltmeyi öneriyorum : Deneysel ve gözlemsel içerikten yoksun olan bir bilimsel kuram , kendi içinde tutarlı da olsa mantıksal olarak zayıftır , metafiziktir .	öneriyorum	4	1
Dönüp baktı , Ramiz ile Katana .	baktı	1	3
Şimdi de yaşayacaksınız .	yaşayacaksınız	2	2
Yaşamın ruhunu duygularla yakalarız .	yakalarız	3	1
Melek bana yardım edersen çocuklarla başa çıkarım , dedi üsteleyerek Memo .	çıkarım	6	1
Dosyanın önümüzdeki günlerde ele alınması bekleniyor .	bekleniyor	5	3
Bana bak , geliyorum yanına ha , kalk haydi !	geliyorum	3	1
Nereden duydum anneannemde o komşu teyzelerin konuşmalarını ?	duydum	1	1
Gece yarısı sokaklarında dolaşıyor , zamanın geçmesini bekliyordum .	bekliyordum	7	1
Duyguları öldürme eşiği hücrelerinde kayıtlı olduğu için yerine başka bir şey koysa da o şeyi de had safhada kullanıyor .	kullanıyor	18	3
Arabanın altına girip gebereceksiniz .	gebereceksiniz	3	2
Neleri sevmediklerine gelince , müşteri , beklemeyi , kendisine gereksiz soruların sorulmasını , stokta kalmamış ürünleri , okunamayan fiyat etiketlerini ve rahatsız edici hizmeti sevmez .	sevmez	24	3
Buraya uğra , bir kadeh içtikten sonra , kentin merkezine ineriz .	ineriz	10	1
Yaptığı nice düşüncesizlikleri başına kakmak istemedim , şunun şurasında birlikte yaşamaya başlayalı ne kadar oldu , yaparsam küstahlık olur .	istemedim	5	1
Olur , dedi Jul .	Olur	0	3
Girme suya oğlum , gidiyoruz .	gidiyoruz	4	1
Yanında oturan annesinin , ağzına zorla tıkıştırdığı lokmayı bir hamlede yuttu ; parmakları darbukanın derisini okşadı ; başını çevirip , arkası dönük oturduğu sahneye baktı .	okşadı	15	3
Onun güzelliğine duyduğum hayranlıkla başlayan ilişki daha sonra kesin bir cinsel bağımlılığa dönüşmüş ve hep öyle sürmüştü , hatta bir ara artık onun güzelliğini bile fark edemez hale gelmiştim .	sürmüştü	16	3
Doğru , dedim , bunun için içiyoruz ya .	içiyoruz	6	1
Nereye yönelsem arkamdan yetişiyordu , Sen kömür sobasını beceremezsin , yan odadan elektrikli zamazingoyu al , dolaptaki rakı çok soğuktur , en iyisi yattığım odanın aç kapısını , bak hemen kapının arkasında , kap gel ...	yönelsem	1	1
Şimdi , beni iyi dinleyin , dedi .	dinleyin	4	2
, Bonham'a gidemem , Hülya'nın yanında kalmalıyım ; ya da arkasında , cephe gerisinde ...	kalmalıyım	6	1
Ancak kapsamı genişletiliyor .	genişletiliyor	2	3
Kalmayız , dedi , koşa koşa gideriz , erikleri de senin heybene doldururuz .	gideriz	6	1
Hangi aday kazanırsa kazansın birlikte mücadeleyi sürdüreceklerini ifade eden Çelebi , ANAP'ı ayağa kaldırmak için hep birlikte çaba harcayacaklarını söyledi .	kazansın	3	3
Yüreğim delice çarpıyor , ellerim uyuştu .	uyuştu	5	3
Hepimiz heyecanla yerlerimizden fırladık .	fırladık	3	1
Ayhan imrenmiş .	imrenmiş	1	3
Bu yıl mutlaka evde büyük bir doğum günü yapacağız .	yapacağız	8	1
Tayyip Erdoğan'ın yanında , onun yanlışlarına ortak olsaydım kesinlikle bu noktalarda bulunmazdım .	olsaydım	7	1
Ürkerim o an ondan .	Ürkerim	0	1
Kazadaki adamın sinirleri kaç kişiye bağlansa bunların hepsi , aynı Politzer gibi , kazayı başından sonuna kadar yaşayacaktır .	yaşayacaktır	17	3
Aptallığıma şaşırdığını belli eden bir şekilde yüzünü buruşturdu .	buruşturdu	7	3
Bu hafta borsa sekizbinbesyuz dokuzbinuzyuz - aralığı bandında hareket edebilir .	edebilir	9	3
Tamam oğlum , haydi çık sudan , diye yineledi Recep , çocuğun pantolonuna doğru giderken .	çık	4	2
İnsanlar , beyinlerinde ya da genlerinde mantıkla donanmış olarak doğmazlar .	doğmazlar	9	3
Yerde araç izinin olmaması ve kamyonun ilerleyecek yol bulamaması , ormanın bu bölümüne kasabadan sıkça gelinmediğini gösteriyordu .	gösteriyordu	16	3
Dinleniyorum bu odada .	Dinleniyorum	0	1
Heyecan adrenalini yükseltiyor , bu yaşamda kalma mücadelesi içinde adaleler daha da geriliyordu .	geriliyordu	12	3
Kızardı yanakları .	Kızardı	0	3
Ne kadar zengin olursan ol , diyor , seyirci olduktan sonra ( al işte Nurettin Bey ; sattı yedi , sattı yedi şimdi beş parasız , onun bunun eline bakıyor ) sıfırı tüketirsin .	tüketirsin	32	2
Yeter ki o boşluğun acısını duymayayım .	duymayayım	5	1
Sen içebilirsin .	içebilirsin	1	2
Kırmızı kartona tenis raketi ilgisini çeker sanıyorum .	sanıyorum	6	1
Giremiyor içeriye .	Giremiyor	0	3
Melek kaç tane sattın ? diye yaklaştı Memo .	yaklaştı	6	3
Üstelik para da kaybediyorsun .	kaybediyorsun	3	2
Birinci günkü başlıkta farklı olarak şeyler yazıldı orada .	yazıldı	6	3
Yüreğim delice çarpıyor , ellerim uyuştu .	çarpıyor	2	3
Yaşamı çekilmez hale getiriyorsunuz .	getiriyorsunuz	3	2
Bu önermelerin usa yatkın olmaları , nesnel gerçekliğin herhangi bir öğesiyle örtüşüyor veya benzeşiyor olması gerekmez .	gerekmez	15	3
Ben ürkerim zamandan .	ürkerim	1	1
Nasıl kaldıracağım ?	kaldıracağım	1	1
Aşık olduğumu sanıyorum .	sanıyorum	2	1
Onu rakıya ayırıyorum ) .	ayırıyorum	2	1
Onu tanıyorsunuz o zaman , dedi .	tanıyorsunuz	1	2
Gidiyoruz , gelin .	Gidiyoruz	0	1
Şahin , " BDDK istese de istemese de kamuda rahatlama için emekliliği gelenleri emekli etmeyi düşünüyoruz " dedi .	gelenleri	12	3
Yapbozun parçaları yerlerine oturuyordu .	oturuyordu	3	3
o Eyüp Fatsa ( Grup Başkanvekili ) : Erbakan'ın ismini seçim döneminde kullanmadık .	kullanmadık	12	1
Biz sadece Milli Görüş tabanından değil , bütün kesimlerden oy aldık .	aldık	10	1
Beni görür görmez kendini yere atıp göbeğini bir açışı var ki sevdirmek için özellikle şişiriyor sanırsın .	sanırsın	15	2
Sosyal bir kurum olarak bilim , başlangıçta öncü bir rol oynarken , bugün artçı ve tabi bir konuma sıkıştırılmıştır .	sıkıştırılmıştır	18	3
Böylece , insanlarla beraber kal ve yalnızlığı unut .	unut	7	2
Bu Türkiye Kuzey Kıbrıs'tan vazgeçene kadar sürecek .	vazgeçene	4	3
Gecenin hangi saatinde eve dönsem de , yakındaki açık gece mağazasından yiyecek birşeyler alabilirdim .	dönsem	4	1
Nereden biliyorsunuz ki o kadın olduğunu .	biliyorsunuz	1	2
Hangisini sen kazandın ki ? deyip dik dik bakmıştı yüzüme .	bakmıştı	8	3
Bak buzdolabına .	Bak	0	2
Onun garip çekimine girmişimdir artık .	girmişimdir	3	1
Durun , oturun biraz .	oturun	2	2
Tamam kapatıyorum .	kapatıyorum	1	1
Erkek öğretmen daha sert olur , kızlarla anlaşamaz diye düşünüyorum .	anlaşamaz	7	3
Ben Erbakan'ın yanında onun yanlışlarına ortak olsaydım kırk defa bakan olurdum , elli defa genel başkan olurdum .	olurdum	16	1
Ama bir ihtimal var , değil mi ? Sırf sana olan kızgınlığımı birine anlatmam halinde üzerimden bir yük kalkar , gerilimim azalır , sana daha hoşgörülü yaklaşabilirim , daha bağışlayıcı olabilirim .	yaklaşabilirim	26	1
Oysa kıçlarını kaldırma zahmetine katlansalardı kendilerine bıraktığım dosyada yapacağım deneylerin üreme organlarıyla ilgili olduğunu , gönderilecek kadavranın cinsiyetinin de önemle dişi olması gerektiğini görebilirlerdi .	görebilirlerdi	23	3
Şimdi varırız oraya , dedi Kerem .	varırız	1	1
Biz , geçmişte ne varsa güzel olan , yanımıza aldık , kalbimize gömdük .	gömdük	12	1
Kapıya yürüdüm , açtım .	yürüdüm	1	1
Fransızlar rekabete aldırmıyorlar .	aldırmıyorlar	2	3
Öyle bir felsefe ki bu , kendi içinde bir çelişkiyi taşıyor ; varoluşla yaşamanın birbirine hiç uygun düşmeyeceğini , bu ikisi arasındaki çelişkiyi anlatıyor .	anlatıyor	23	3
Davetiye iki kişilik olduğu için ben babamla gittim .	gittim	7	1
Keşke hayata ve aşka dair konuşsaydınız önce .	konuşsaydınız	5	2
Elinde beyaz bir zarf tutuyordu .	tutuyordu	4	3
Anlar mıyız .	Anlar	0	3
Soruları sürekli tekrarladığınızı fark etseler bile utangaç ifadelerini bir kenara bırakıp sinirlenmez , sıkıldıklarını belli etmezler .	etseler	4	3
Yaklaştım yanına .	Yaklaştım	0	1
Nesnel bir gerçekliğin ve buna ilişkin nesnel yasaların varlığının kabulü , bilginin doğruluğunun ölçütünün pratik olması ilkesini beraberinde getirir .	getirir	18	3
Saime Sezginler aylarca çalışmış , kardeşinin arkadaşlarıyla saatlerce konuşmuş , kitaplar tercüme etmiş , ettirmiş ve bir uzmanın sahip olacağı teknik bilgiyi öğrenmişti .	ettirmiş	14	3
Bana ne ! Yine de dayanamadım , ondan söz açmaya can atıyor belli .	atıyor	11	3
Aşağıda ayrıntılarıyla değineceğiz .	değineceğiz	2	1
İşte geldik gidiyoruz , dedim , sana bir şey sormak istiyorum .	geldik	1	1
Üniversitede hocayız desek Şüpheli kişi olacağız çünkü .	desek	2	1
Siz gene de demeyin .	demeyin	3	2
Bir kadını daha çok sevip daha çok bağlandıkça , bir gün onu kaybedip yapayalnız , acılarla kalma korkusu büyüyordu ve gittikçe artan bir hızla kıskançlık uçurumundan aşağıya yuvarlanıyordum .	büyüyordu	18	3
Bacağımı da sabah değil , gece köpek ısırdı .	ısırdı	7	3
Gizli heyecanımı , bu heyecanın altında yatan kaygıyı sezmiş gibiydi .	sezmiş	8	3
Hepsi bir sepetin içindeydi ve benim görevim , tabi eğer bu köpeği istiyorsam , bunların hepsinin yerli yerinde durmasını sağlamaktı .	istiyorsam	12	1
Kapı dışarıdan vuruluyor , hafifçe itiliyor , aralanıyor , yeniden kapanıyordu .	aralanıyor	7	3
Hiç konuşmasanız da aklınızdan geçirdiğiniz her şey duyulacak .	konuşmasanız	1	2
Hatta siz bile denmezdi .	denmezdi	3	3
Bir yudum içki , bir nefes sigaradan sonra anlatmaya başlıyor .	başlıyor	9	3
Kocaman bir kafası , iri iri elleri vardı .	vardı	7	3
Demedik mi .	Demedik	0	1
Bir ara köpeği kimin dolaştıracağına karar veremedikleri için kavgaya bile tutuştular .	tutuştular	10	3
" Sizin SUV aracınız , ülkenin milli güvenliği için ne yapıyor ? " .	yapıyor	10	3
Bankanın , cari faizin yüzde yirmibeş fazlası temerrüt faizi aldığını bildiren Demiray , " Çıkacak olan yasa gecikme faizini cari faizin yüzde elli fazlası ile sınırlıyor .	sınırlıyor	25	3
Beni yeme be moruk , dedim , ne panayırlar kuruldu bu kasabaya , ama hiçbir zaman aslan gelmedi .	yeme	1	2
Ortada böyle bir ihtimal yokken sen kendi kendine kuruntular yaratıyorsun .	yaratıyorsun	9	2
Geceleri kakıp , konuklara sunulacak rakı , votka , viski ne bulursam ; birer ikişer yudum kafama dikmeden , bölük pörçük uykumu bile sürdüremiyorum .	bulursam	11	1
Bana değil de arkamda duran , dönüp baksam benim göremeyeceğim bir şeye , belki de bir aslana bakıyordu .	baksam	7	1
Bu kadar çabuk da bulamaz değil mi ?	bulamaz	4	3
Yeşil fasulye diyip geçemezsiniz .	geçemezsiniz	3	2
Ama şimdi duramıyorum .	duramıyorum	2	1
Ben de ondan iki sene sonra geliyorum ya .	geliyorum	6	1
Esra Özmen'in Muazzez Ersoy'u konuk ettiği programına katılan Ciguli , " Binnaz satış rekorları kırdı ama bana bir faydası olmadı .	olmadı	19	3
Yoğun siste uçak piste doğru gelirken pilota " Yaklaşma hattının solunda kaldın " uyarısı yapıldığı , bunun üzerine pilotun uçağı düzeltmeye çalıştığı , ancak sol dikmenin ( ana iniş takımı solu ) tepeye çarptığı ifade edildi .	kaldın	11	2
Oh , iyi ki aradın Maryline .	aradın	4	2
Geceyarısından sonra biten işimden çıktığımda , o zamanların Beyoğlu'sunda varolan , kendine özgü , sabaha kadar açık kulüplere dadandım .	dadandım	18	1
Biraz hayal kırıklığına uğramıştım aslında .	uğramıştım	3	1
Zekametre yok ki ölçülsün .	ölçülsün	3	3
Beni yeme be moruk , dedim , ne panayırlar kuruldu bu kasabaya , ama hiçbir zaman aslan gelmedi .	kuruldu	9	3
Esin de Özer de Uykudan Önce programı gibi dinlediler anlattıklarımı , bir yandan esniyorlardı bir yandan da gözleri sevinçle parlıyordu .	esniyorlardı	13	3
Buraya uğra , bir kadeh içtikten sonra , kentin merkezine ineriz .	uğra	1	2
O zaman , lise son sınıfta Fen - Edebiyat diye ayrılırdı .	ayrılırdı	10	3
Kısmetse çarşamba günü İstanbul eğlence yaşamında buluşmak üzere hoşkalın , hep mutlu yaşayın .	hoşkalın	8	2
Hastaneye yatırmışlar kaç defa , biraz düzelir gibi oluyor , ay geçmeden başlıyor daha beter içmeye .	yatırmışlar	1	3
Özen gösterin onlara .	gösterin	1	2
Diyelim ki , dedi Kemal , ben sana kızgınım .	Diyelim	0	1
Israr etseydin bize , daha güzel bir isim önerseydin ! ..	etseydin	1	2
Daha da kötüsü , bu gerçeği bilmeme rağmen , her seferinde elimde olmadan hep aynı şeyi yapıyordum , bunun önüne geçemiyordum .	yapıyordum	16	1
Tamam ! tamam ! Hadi çabuk anlat , meraktan öleceğim .	öleceğim	9	1
Hülya kolumu tutmuştu .	tutmuştu	2	3
Sen iyi düşün ki iyi olsun her şey .	düşün	2	2
Bu yüzden alışveriş bilimini yaratırken antroplojinin katkısı tartışılmaz .	yaratırken	4	3
Küçük görmeyin .	görmeyin	1	2
Yaz nasıl içinden geliyorsa .	Yaz	0	2
Biliyor musun ben bu bourbon viskiyi daha çok seviyorum .	Biliyor	0	3
Ben yavrumdan nasıl ayrılırım ? Onu nerelere gönderirim ? diye adamın ayaklarına kapanmış zavallı kadın .	gönderirim	7	1
Dayım , Eee , kes şu şarkıyı , demişti de , o da dayıma , Bu şarkı değil bi defa - , marş bu marş , akıllım , diye karşılık vermişti .	kes	4	2
İzzettin Doğan ve Alevi Bektaşi Kültürü Derneği Başkanı Ali Balkız gibi Alevi temsilcileri oturdu .	oturdu	13	3
Şimdi düşünüyorum da , galiba o parkın dışında yapamayacağım ben , dedi Kerem .	yapamayacağım	8	1
Sonra , gözlüksüz olduğunu da iyice anımsıyorum .	anımsıyorum	6	1
Beni çok seven eski bir hocamın yardımıyla laboratuarıma bir kadavranın gönderilmesi için gerekli izinleri almak çok zor olmadı .	olmadı	17	3
Ama burada sorumluluk kişiye düşüyor .	düşüyor	4	3
DENİZ Akkaya , dün akşam saatlerinde karın ağrısı şikayeti nedeniyle Amerikan Hastanesi'ne kaldırıldı .	kaldırıldı	12	3
Gel , dedim Celal'e .	Gel	0	2
Uçucu bir bulutçuk ağdı , sararmışlığıma , tuttum biteğini .	tuttum	7	1
Belgin Dorukları , Sadri Alışıkları , Kırık Hayatları ve Ölümsüz Aşkları , eski resimlerde yanımıza aldık , gidiyoruz .	aldık	15	1
İstersen önce oraya gidelim .	İstersen	0	2
Karl Popper'ın geliştirmiş olduğu yanlışlanabilirlik ilkesi materyalist felsefenin yadsımanın yadsıması ilkesini andırmaktadır .	andırmaktadır	11	3
Ne okulu severdi , ne de Naci Beyi .	severdi	2	3
Boşuna üzülüyorsun istediğin zaman gelip Kahve'yi görebilirsin .	görebilirsin	6	2
O gecenin - daha doğrusu sabahın - öyküsü şöyle : Sevda'nın güzel yemekleriyle şiş midemizle Özer'lerden çıktık .	çıktık	16	1
Boş sokakta topuklu ayakkabıların çıkarttığı , yankılanan bir ses duyuldu .	duyuldu	9	3
Felsefeye merakı onu ünlü yazar , çizer ve ressamların dünyasına sokuyor .	sokuyor	10	3
Saime Sezginler aylarca çalışmış , kardeşinin arkadaşlarıyla saatlerce konuşmuş , kitaplar tercüme etmiş , ettirmiş ve bir uzmanın sahip olacağı teknik bilgiyi öğrenmişti .	konuşmuş	8	3
Ayrıca dokuz deri yüklendi odunların üstüne .	yüklendi	3	3
Bunlara yeşiller diyecektim .	diyecektim	2	1
Ezberlediği bir kaç cümleyi robot gibi tekrarlıyordu ; Bayan lütfen bir flaster alın .	alın	12	2
Türkler , Çinliler , Moğollar ve Kitaylar arka arkaya saldırıp yirmibeş yıl süren bir savaş sonunda Tunguzları toparlanamayacak şekilde yıktılar .	yıktılar	19	3
Şaşkın şaşkın onları izledim .	izledim	3	1
Çöktü koltuğa , pıtır pıtır dökülüyor gözyaşları .	dökülüyor	5	3
Ona tapıyordum .	tapıyordum	1	1
Tüketici kredisinin yabancı para birimi cinsinden kullanılması durumunda , geri ödemeye ilişkin taksitlerin ve toplam kredi tutarının hesaplanmasında , hangi tarihteki kurun dikkate alınacağına ilişkin bilginin sözleşmede yer alması koşulu getiriliyor .	getiriliyor	30	3
Hiç satamadım Memo , bugün işler kesat .	satamadım	1	1
Genetikle mi , sosyal hayatımızla mı var oluruz .	oluruz	7	1
Leblebi koydum tasa .	koydum	1	1
Hakkı'yla ihtilale bakmak istiyorduk .	istiyorduk	3	1
Dört yıl depoda bekleyen ve soğuk duvarların arasında hapsedilen geçmişim , bana dünyayla arasına duvarlar ören bir masal ülkesini hatırlattı .	hatırlattı	19	3
Sonra , patron olduğunu anımsatmak için , soymakta olduğu patatesleri bırakıp , bir çay doldurdu , masalardan birine geçti , sabahtan beri bakıla bakıla paçavra gibi olmuş gazeteyi eline aldı .	doldurdu	14	3
Biraz daha anlatmalıyım diye düşündüm .	düşündüm	4	1
Gözün kanlanmış , sol gözün , dedi Gül Abla .	kanlanmış	1	3
Ayrılıkların hüzünleriyle yeni birlikteliklerin neşesi birbirine karışıyor , aynı günde birkaç duyguyu bir - iki saat arayla yaşıyordum .	yaşıyordum	17	1
İnsanlara özgü zannettiğim bir çok özelliğin hayvanlar aleminde de geçerli olabileceğini daha önce hiç düşünmemiştim .	düşünmemiştim	14	1
Bana bak , geliyorum yanına ha , kalk haydi !	kalk	7	2
Çilingirgillerden Ayhen kart bastırıvemiş , kendini geleceğin cumhurbaşkanı ilan edivemiş ...	bastırıvemiş	3	3
Kuşatma olmasın .	olmasın	1	3
Evet , Ali Babaoğlu'nun dediği gibi ben de bu zeka pırıltılarından etkilendim .	etkilendim	11	1
Lafı ağzına tıkadım : Yahu , kızın ne kabahati var ! Anababalar münasebetsizse ...	tıkadım	2	1
Ne kadar zengin olursan ol , diyor , seyirci olduktan sonra ( al işte Nurettin Bey ; sattı yedi , sattı yedi şimdi beş parasız , onun bunun eline bakıyor ) sıfırı tüketirsin .	olursan	3	2
Dolayısıyla başkaları için ev yapmak - o evi yapan mimar da olsa - o başkalarının , o ailenin yaşantısını ve hatta hayatını yönlendirmek demektir : Ne büyük bir sorumluluk , acaba altından kalkılabilinir mi ?	kalkılabilinir	32	3
Bir tane de ben ekleyeyim : Yiyebilir miyim ? diye bayılmış .	bayılmış	10	3
Buna kapılalı beri bana seyrek gelir oldun .	oldun	6	2
Devlet bizi azınlık olarak kabul etmiyor .	etmiyor	5	3
Gecekondu yapmak için para biriktiriyor .	biriktiriyor	4	3
Sonra gücü , olanağı elverdiğince de , gereksinimi çerçevesinde , o bir göz odaya zamanla , mutfak , banyo , başka bir oda ekliyordu .	ekliyordu	23	3
Kim bilir belki bir gün , mezara girmeden ya da hapse düşmeden önce arar ve katılır .	bilir	1	3
Kolayca eşelenen kuru karın altındaki otlar , kış ayları boyunca yeterli gıdayı sağlıyordu onlara .	sağlıyordu	12	3
Sevdiği genç trafik kazasında ölünce küsmüş hayata , teyzemden rivayet - olabilir de , insaf , on beş yıl geçmiş aradan .	küsmüş	5	3
Beni niye sevdiğini hiçbir zaman anlayamamıştım , ama beni niye terk ettiğini biliyordum , bütün kadınlar beni hep aynı şekilde ve aynı nedenden terk ederlerdi zaten .	ederlerdi	24	3
Arınç da " Kastımın Erbakan'la Erdoğan'ı aynı kefeye koymak olmadığını da yazarsanız sevinirim " karşılığını verdi .	yazarsanız	11	2
Biri kazanmış .	kazanmış	1	3
Hiç de öyle değil , gencecik oğlunun dizi dibinden ayrılmasını göze alamıyordu , yanında olmasını istiyordu mutlaka .	alamıyordu	11	3
Orda bana bir şiir okudu , Allah taş etsin tek kelimesini anlamadım .	etsin	8	3
Giremedi içeriye , dedim .	Giremedi	0	3
Çoğu , çok kere beni daha çok falan filan bulurlarmış .	bulurlarmış	9	3
Oldum olası merak ettiğim bir konu vardı ; kimsenin doğru dürüst bilmediği , sormaktan çekindiği bir sır .	Oldum	0	1
Ama , dedi umutsuzlukla kadın , O beni düşünmediği sürece hiçbir şey yapamam ki !	yapamam	12	1
Yutmadım ama , bu seferlik geç yerine otur , demek istiyordu .	otur	7	2
Oğlan kurulmuş yay gibi fırladı yerinden : .	fırladı	4	3
Kurtulmak istemiyorum .	istemiyorum	1	1
Ünlü markaların bir yıl önceki modellerini uygun fiyatlarla Oparia Continuato'da , Magazine Montenapoleone'de bulabilirsiniz .	bulabilirsiniz	13	2
Yüksek Seçim Kurulu'nun ( Taylor ) bu seçimi iptal etmesinin ardından dosya Adalet Bakanlığı kanalıyla Yargıtay'a yeniden iletildi .	iletildi	17	3
Neden bir akım oluşmadı aramızda .	oluşmadı	3	3
El vurdum basa basa .	basa	3	3
Böylece imece usulü ile kimseye ağır yük olunmuyordu .	olunmuyordu	7	3
Lange Leidsewards Straat'da Kierkegaard okuyan kıza , kendisiyle yeniden görüşmekten sevinç duyacağımı söylemiş , ertesi gün öğleye doğru , onun oturduğu sokağın başındaki o güzel , iki katlı kahveye çağırmıştım onu .	söylemiş	12	3
yirmi milyar dolarlık paketle geliyorlar .	geliyorlar	4	3
Lan Miskoye , burda ne yapıyon .	yapıyon	5	2
Melek her zamanki yerinde , ümitle gelene geçene flasterlerini ve kalemlerini uzatıyordu , ama nafile ; kimsenin ona aldırdığı yoktu .	geçene	7	3
Pencerelerde ışık olsa gidip kapıyı çalacak mıydım , emin değildim .	değildim	9	1
Yattım nilüfer kayığına ...	Yattım	0	1
Eski kulübeyi ise mutfak haline getirmişti .	getirmişti	5	3
Ama , hafiften titreyen sesi öyle etkiliydi ki , kendimi tutamadım , ağlamaya başladım .	tutamadım	10	1
Genelde bir erkeği mağazada ilgilendiği bölüme doğru sabırsızca hareket ederken görürsünüz .	görürsünüz	10	2
Sen beni şaşırtıyorsun , dedi .	şaşırtıyorsun	2	2
Kapattınız mı zarfı .	Kapattınız	0	2
Hadi bakalım düşelim yola . dedi babam .	düşelim	2	1
Onu görmedim .	görmedim	1	1
Bana sarılmış .	sarılmış	1	3
Ona bir mektup yazsanız ...	yazsanız	3	2
Önlerinde hazırlanan raporların hepsi vardı artık ve zaman makinesi bir kez daha , bu sefer geriye , kazanın olduğu o ilk anlara doğru çalıştı ..	çalıştı	23	3
Melek her gün yüz bin lira kazansam , kış gelene kadar bir kondu alabilir miyiz ?	kazansam	6	1
Onun yerine okula , ' Adını mezar taşına değil , okula yazdır ' pankartı asıldı .	yazdır	11	2
Yolu yarılamıştık neredeyse .	yarılamıştık	1	1
Ben Erbakan'ın yanında onun yanlışlarına ortak olsaydım kırk defa bakan olurdum , elli defa genel başkan olurdum .	olsaydım	6	1
Bitti , kendiliğinden kapandı parantez .	Bitti	0	3
Günlük azığı kara ekmekle peyniri bu mağaraya koymuş .	koymuş	7	3
Haydi oğlum , gidiyoruz .	gidiyoruz	3	1
Nedenini anlayamadığım bu terk edilme korkusu ve kendime itiraf etmekten bile utandığım hırpalayıcı kıskançlığımla , aptalca olduğunu bile bile daha çok kadınla birlikte oluyor ve sonunda korktuğuma uğrayıp bir başka erkek için terk ediliyordum .	ediliyordum	33	1
Bir hanımefendi sakız çiğnemez , deyip kesip atıyor .	çiğnemez	3	3
Şimdi bir hukuk maratonu başlıyordu .	başlıyordu	4	3
Gece zamanı buldunuz bu kıraathaneyi .	buldunuz	2	2
Benim arkamda bir iz kalırsa , ben siyasette ilkeli , kararlı , cesur işler yaparsam benim için en doğrusu odur .	yaparsam	14	1
Allah Allah , bu da nereden çıktı ? diye sormadık , şaşırmadık .	şaşırmadık	11	1
Ama , hafiften titreyen sesi öyle etkiliydi ki , kendimi tutamadım , ağlamaya başladım .	ağlamaya	12	3
Bugün Ulusal Müzeyi gezdim , sonra da seni düşündüm .	gezdim	3	1
Artık içeriye giremiyorum .	giremiyorum	2	1
" Yurtdışında kazan konusunda uzman bir firmayla ortaklık yapmak istiyoruz .	istiyoruz	9	1
Sokağa çıkmamaya hazırlandık .	hazırlandık	2	1
Sesler değişse bile duyguların seslere kattığı tonlamalar değişmez , ne kadar saklamak isteseler de bunu beceremezler , bir köpekten kokularını saklayamayacakları gibi benden de seslerini saklayamazlardı .	değişmez	7	3
O zaman ben ne yaparım ?	yaparım	4	1
Annem , telefonda dedeme bir doğum günü partisi düzenlediklerini söyledi , yarın dönsem iyi olurmuş ...	olurmuş	14	3
Bu tevazuyu gerektiriyor .	gerektiriyor	2	3
Ama şimdi o anlatmak istediklerimi nasıl anlatacağımı bilmiyorum .	bilmiyorum	7	1
Tutulmuşsun ona .	Tutulmuşsun	0	2
Fatih'in , gemileri Haliç'e karadan indirme planının Fatih'in kafasından çıkmadığını , Said Nursi'nin - i de arkasına Nurcu ordularını toplayıp başkente yürüme planları yapmadığını işitiyorsunuz .	işitiyorsunuz	24	2
Bazı bilim adamları evrenin genişlemesini tanımlayan anda ortaya çıkan matematiksel tekilliği Tanrı sandılar ve Tanrı'nın evreni o noktada yarattığını düşündüler .	sandılar	12	3
Ben bir hizmet insanıyım , söylerim , söylediğimin arkasından giderim ve bana neye mal olursa olsun ben bununla iftihar ederim .	ederim	19	1
Hayır , sonraları hiç de sevmiyordum onu .	sevmiyordum	5	1
Ne yazayım ? diye sordu Mebrure .	yazayım	1	1
Timur , uyuşturucu kullanırken etrafımda olan biten her şeyin benimle ilgili olduğunu sanıyordum .	sanıyordum	12	1
Siz olmasanız , ben olmasam , yani nasıl ...	olmasanız	1	2
Bak şimdi birdenbire aklıma geldi .	Bak	0	2
Ütopya biliyorsunuz , olmayan yer , düş ülkesi demektir .	biliyorsunuz	1	2
Tabanımız çok farklı , bütün eğilimleri topladık .	topladık	6	1
Bize gideceğiz , dedi .	gideceğiz	1	1
Bu fotoğrafı çektirir çektirmez İstanbul'a göçmeye karar vermişler , ama olmamış .	olmamış	10	3
Nereye yönelsem arkamdan yetişiyordu , Sen kömür sobasını beceremezsin , yan odadan elektrikli zamazingoyu al , dolaptaki rakı çok soğuktur , en iyisi yattığım odanın aç kapısını , bak hemen kapının arkasında , kap gel ...	gel	34	2
Nasıl anlatsam bilemiyorum , ama seviniyordum .	bilemiyorum	2	1
Ama onu bir daha gören olmadı .	olmadı	5	3
Meyhanelerin , o dönemlerde , erkeklerin sayıca ağır bastığı havası , sıkıyordu beni .	sıkıyordu	11	3
Kursanız bile sonunu çok başka bir biçimde bitirirsiniz .	bitirirsiniz	7	2
Ara ara aklıma takılan soruları da anlatır gibi , ona mı , kendime mi , bilmeden sordum .	anlatır	6	3
Ramiz yerine oturana dek de gözlüklerinin üstünden izledi .	izledi	7	3
Uçak seferlerini de artıracağız .	artıracağız	3	1
FDR'nin altıyüzotuzdört sefer sayılı Konya uçağının tekerleklerinin , yaklaşma hattının soluna kaydığı , ancak kaptanın uçağı düzeltme manevrası yaparken sol ana iniş takımının tepeye çarptığı ve pist başına yakın bir noktada parçalandığı ileri sürüldü .	yaparken	18	3
Akşam eşiyle baş başa yemek yemeyi planlıyordu .	planlıyordu	6	3
Ölüler konuşmadığı için mi böyle yapılır dedim .	yapılır	5	3
Üveylik konusunda senin düşüncelerine katılmıyorum .	katılmıyorum	4	1
Bir süre kapısında bir köpek gibi süründüm .	süründüm	6	1
Siz nedenini anlayabiliyor musunuz .	anlayabiliyor	2	3
İşte biz , bu toplantılarımızın kurallarını bugünlerde saptadık .	saptadık	7	1
Güneş yeniden bulutların kalın örtüsü ardında kaybolmuştu .	kaybolmuştu	6	3
yüzyılda bilimin gelişimini genel hatlarıyla betimlemek istersek , şu iki görüngüyü temel almamız gerekir : Birincisi , bu yüzyıl Bilimsel Devrim'in son atılımlarının gerçekleştiği yüzyıl olmuştur .	olmuştur	25	3
Bizim ki diğerlerinden daha hızlı serpildi .	serpildi	5	3
içine alır , besler , büyütür , korur .	korur	7	3
kavramlar değişti mi , her şey değişiyor .	değişti	1	3
Kapıyı tıklattı .	tıklattı	1	3
İnsanları ikiye ayırıyor annem ( sayacağı iki kalem de olsa mutlaka parmaklarını avucuna kapatarak sayacak ; birincisi yaşayanlar ( bunlar başkalarını da yaşatıyor ) , ikincisi yaşayanları seyredenler ( bunlar da başkalarının sırtına yük oluyorlar ) .	yaşayanları	26	3
Bilimsel teori , bir yandan içinde oluştuğu toplumun kavramsal yapısıyla , yani ideolojisiyle sınırlıdır ; öte yandan kendi ürettiği kavramlarla o ideolojiyi etkiler .	etkiler	22	3
Baktı olmayacak , beni yanağımdan öptü , saçlarımı okşadı .	okşadı	8	3
O anlatmak istediklerimi nasıl anlatacağımı bilmiyorum .	bilmiyorum	5	1
Ne soracağımı anlamıştı , sor , dedi gönülsüzce .	sor	4	2
Niye mutsuz olduklarını ise söylemezlerdi , mutsuzluklarının nedenini siz keşfetmek zorundaydınız , bunu keşfedemezseniz biraz daha düşmanlaşırlardı ; bu düşmanlık gerçek değildi , yalnızca mutsuzluklarının üstüne örtmeye çalıştıkları yakıcı bir örtüydü .	keşfedemezseniz	13	2
Babam derdi ki .	derdi	1	3
Ona , Seni çok sevdiğim için seninle olamazdım , sana duyduğum sevgi çok korkuttu beni , diyemezdim .	olamazdım	7	1
Hey , Ömer , kalk oğlum , geç kalmışız .	kalk	4	2
Prezervatif yok mu bu markette ? diye sordun .	sordun	7	2
Belgin Dorukları , Sadri Alışıkları , Kırık Hayatları ve Ölümsüz Aşkları , eski resimlerde yanımıza aldık , gidiyoruz .	gidiyoruz	17	1
Tek başımıza iktidara doğru yürüyoruz " dedi .	yürüyoruz	4	1
Kalktım , sarıldım boynuna , zoraki öptürdü pembeliğini koruyan yanaklarını .	sarıldım	2	1
' O afiş ' kaldırıldı .	kaldırıldı	4	3
Kapıcı hergelesinin bakışını görsen , aç kurt gibi ...	görsen	3	2
Seni üzmekten korkuyorum .	korkuyorum	2	1
' Telefonla görüşüyoruz ' .	görüşüyoruz	2	1
Bir kadınla bir erkeğin oynayabileceği bütün oyunları oynamış , kadınlığı da erkekliği de sonuna kadar yaşamıştık .	yaşamıştık	15	1
Belgin Dorukları da gittiğimiz yere götürüyoruz .	götürüyoruz	5	1
Tekrar ediyorum : Belki .	ediyorum	1	1
Yaktım hemen .	Yaktım	0	1
Ödümü kopardın .	kopardın	1	2
Ancak bu olaylar dizisi nedensellik ilkesi bağlamında değil , tanrının istemi doğrultusunda gerçekleşir .	gerçekleşir	12	3
Kim olduğunu bilmiyorum .	bilmiyorum	2	1
Aşık olduğum için utanıyorum sanıyorum .	sanıyorum	4	1
Timur , Artık kendi yalnızlığımda tutunacak dal kalmamıştı , ruhsal çöküntümün önüne geçemiyordum , madde bana başlangıçta ihtiyacım olan şeyleri verdi : deliğimi kapattı , eksikliğimi giderdi .	giderdi	26	3
elli milyon dolara bakmıyor , yüz bin dolara bakıyor .	bakıyor	8	3
Konser programını anımsamıyorum , ( ! ) tepkilerini incelemeye koyulduğum için herhalde .	anımsamıyorum	2	1
Bir an kafamda bir şimşek çaktı Bu evde iki tane prense ihtiyacımız var , prensesi ve evimizi koruyabilmek için dedim .	çaktı	5	3
Ama onun için korkuyordum da .	korkuyordum	3	1
Tezgahtan ve günün hayhuyundan ne kadar uzak olduğu sanılırsa sanılsın bu oda bir süre sonra tezgahı aratır oldu .	sanılsın	9	3
Bir hanımefendi sakız çiğnemez , deyip kesip atıyor .	atıyor	7	3
Bir kere tuvaletini yapmak için sık sık dışarı çıkarmak yoktu , çünkü o zaman ayakları kirlenir ve her defasında yıkamak gerekirdi .	gerekirdi	20	3
Bu ülkelerde , günümüzde , bilim ve din , eşit bir muameleye tabi tutulmakta , her ikisinden de kendi alanları içinde kalmaları istenmektedir .	tutulmakta	13	3
Aaa , diyorlar , kimi elini saygıyla göğsüne bastırıyor kimi de , işte orada duracaksın anlamında ileri doğru uzatıyor ; büyük adamdı .	uzatıyor	18	3
Bilimde bu tür mucizevi elatmalara yer olmadığı gibi , varlığı , Tanrı'ya inananlar için tehlike yaratır : diferansiyel eşitliklerinizdeki matematiksel tekillikleri daha iyi bir modelle ortadan kaldırdığınızda Tanrınız da tekillikle birlikte ortadan kalkar .	inananlar	12	3
Oldum olası merak ettiğim bir konu vardı ; kimsenin doğru dürüst bilmediği , sormaktan çekindiği bir sır .	vardı	6	3
Hülya , Onu seri düşün , hadi gel , dedi ve kolumdan çekti .	gel	7	2
Eyvah ! Mantara basıyoruz galiba .	basıyoruz	3	1
Timur , Artık kendi yalnızlığımda tutunacak dal kalmamıştı , ruhsal çöküntümün önüne geçemiyordum , madde bana başlangıçta ihtiyacım olan şeyleri verdi : deliğimi kapattı , eksikliğimi giderdi .	geçemiyordum	12	1
Son defa da aynı yokuşun başında durup ışıklı pencerelere bakmıştım .	bakmıştım	9	1
Sezai Uyardı başlıklı haber , Göztepe takımı teknik direktörünün ismini içeriyordu .	Uyardı	1	3
İki hafta önce Türkiye toplumunun yeni sivil , ideolojik ve ekonomik egemenlerini ve onların yaşam tarzlarını anlatmak üzere bu köşede doğan Kozanoğlu Kırmızı Türkler Maksim'den kavramı " artık reşit oldu " diyebiliriz .	diyebiliriz	31	1
Bakalım daha nelere sokacak Grek burnunu ...	Bakalım	0	1
Ben İngilizcesinden okuyorum .	okuyorum	2	1
Tamam usta ya , girmiyorum , bir işeyip geleceğim , diye yanıtladı çocuk .	yanıtladı	11	3
Ferda , Böyle bir konuda deneme yanılma oynanabilir mi , Selma'cım ? diye konuştu .	oynanabilir	7	3
İçeriye girmiyor musunuz ? diye sordum .	girmiyor	1	3
Ama verdikleri çekleri , ' Nakit ödeme yapacağız ' diye aldılar , beş parasız kaldım .	yapacağız	7	1
Böylece kazanları Hablemitoğlu ürünümüze katma değer kazandıracağız .	kazandıracağız	6	1
Bir yediğin peyniri bir daha yeme .	yeme	5	2
Sonra yarım saat , üç saat , bir gün , üç gün önce görüştüğünüz sekreter adaylarının umutsuzluğunu , çaresizliğini düşünürsünüz .	düşünürsünüz	19	2
Az daha unutuyordum : Evde başka eşya da vardı .	unutuyordum	2	1
Gözgöze geldik .	geldik	1	1
Ben : Azıcık pencereyi açayım mı ?	açayım	4	1
Bir an durdum .	durdum	2	1
Bakın , gerçekleşmeye başladı .	Bakın	0	2
Sanırım gezmediği ülke , danışmanı olmadığı kimse , bilmediği ilke kalmadı .	kalmadı	10	3
Gece rüzgarından saçım başım dağıldı , dedi genç erkek ; elleriyle saçını düzeltmeye çalıştı .	çalıştı	13	3
Şahin , makamında gazetecileri gruplar halinde kabul ederek sorularını yanıtladı .	yanıtladı	9	3
Sistemli ve kalıcı her şeyden rahatsız oluyorlar .	oluyorlar	6	3
İkimiz de aynı anda Taşhan'ın kapısına bir kadının yaklaştığını gördük .	gördük	9	1
Bazılarımız buna gerek olmadığını düşünüyordu ama çoğunluk , apartmana esprili bir ad taksak fena mı olur a yatkındı .	taksak	12	1
Bakışları özlemle parkın ulu yeşil ağaçlarının dallarında , havuzdaki fıskiyenin parıltısında , kenardaki çiçek tarhlarının üstünde geziniyordu .	geziniyordu	16	3
Ölümü ensemde hissediyordum .	hissediyordum	2	1
Beyan edenden az vergi alınsın .	alınsın	4	3
Bayındır Sokak'taki bekar evimden çıktım .	çıktım	4	1
Kavrulmamışı da olmaz .	Kavrulmamışı	0	3
Perakendecilikte araştırmaları ve metodoljik çalışmalarıyla tanınan Underhill , dünyada " Why We Buy : The Science of Shopping " ( Neden satın Alıyoruz : Alışveriş Bilimi ) adlı kitabıyla tanındı .	Alıyoruz	22	1
Mekan da bir deniz kenarı olmalıydı .	olmalıydı	5	3
Ali'yi üzmeden bu köpeği çok sevdiğimi ve ona sahip olabilmek için ne çok engeli aştığımı anlatmalıydım .	anlatmalıydım	15	1
Türkçe'ye çevrilen konuşmasını ben seslendirmiştim radyoda .	seslendirmiştim	4	1
Şahin , " BDDK istese de istemese de kamuda rahatlama için emekliliği gelenleri emekli etmeyi düşünüyoruz " dedi .	istemese	6	3
Artık hiçbir şey avutamaz beni , kendimi kandırabileceğim bir şey yok .	avutamaz	3	3
Ne kadar zengin olursan ol , diyor , seyirci olduktan sonra ( al işte Nurettin Bey ; sattı yedi , sattı yedi şimdi beş parasız , onun bunun eline bakıyor ) sıfırı tüketirsin .	sattı	20	3
Hayır , önce yemeğini bitir , diye üsteledi anne .	üsteledi	7	3
Türkiye'de darbeciler ellerini kollarını sallayarak dolaşıyor , evet ...	dolaşıyor	5	3
Ne sandın sen beni .	sandın	1	2
Allah rahmet eylesin , dediler , büyük adamdı .	eylesin	2	3
O arada geri dönüp olanları anlatmaya çalışan Ramiz'in kafasına indirdi cetvelini .	indirdi	9	3
Bu konudan bahsettim .	bahsettim	2	1
Annem hep korkmuş , çocuklarımdan biri büyük amcalarına benzer diye ; ama şimdi bakıyormuş da , benim yolum yol değilmiş .	değilmiş	19	3
Yeni ilişkiler yeni hipotezlere ve bu hipotezler temelinde yükselen yeni kuramlara götürür .	götürür	11	3
Bir ilişki yepyeniyken nasıldır , bilirsiniz ... dedi .	bilirsiniz	5	2
Eğer ilk anda şarlamazsanız , size ciddi ciddi şunu öneriyorum : Aramızdan birini tesbit edelim .	öneriyorum	9	1
Akşamları lokantada , kenar köşe bir masa kendilerine ayrılıyor , hesaptan ayrı getirdikleri balıklarla , bedava bir küçük rakıyla , ufak tefek mezelerle ucuz , güzel bir gece geçiriyorlardı .	ayrılıyor	8	3
Üstünde bir atlet vardı .	vardı	3	3
Şunu niçin düşünmüyorsun , diye başladı Hülya yeniden , bu insanların hemen hepsi çeşitli zamanlarda özel birtakım konularını seninle konuşurlar , sana danışırlar , senin söyleyeceklerine önem vermeye hazırdırlar .	düşünmüyorsun	2	2
Annem avukat değildi ama bir avukat kadar , hatta daha çok tanırdı insanları .	tanırdı	11	3
Ben dün gece siz yattıktan sonra evden kaçtım .	kaçtım	7	1
Ramiz yerinden kalkmış Naci Beyin yanına kadar sokulmuştu .	sokulmuştu	7	3
Ne kadar zorlarsam zorlayayım , her biri cılız birer siluet olarak gözlerimin önünden geçip kayboluyor .	zorlayayım	3	1
Öyleyse ben de oturup bir üvey baba masalı yazayım .	yazayım	8	1
Değil mi ağabeyisi ? dedi bana dönerek .	Değil	0	3
Ben de mutlaka tenis öğreneceğim .	öğreneceğim	4	1
Yüzeyinde bazı karaltılar vardı .	vardı	3	3
Artık Beyoğlu'na , geceleri içki içmek için çıkışları azaltmıştım .	azaltmıştım	8	1
Döndü arkasını , burnunu siler gibi yapıyor .	yapıyor	6	3
Nasılsınız ? Vurgu : Ortadan kayboldunuz , iyileştiniz mi ?	kayboldunuz	5	2
Nasıl çıkabildiğimi anımsamıyorum .	anımsamıyorum	2	1
İnanmıyorsanız , Türkiye'nin kentlerinde ve kasabalarında bir pazar günü sokağa çıkın .	İnanmıyorsanız	0	2
Hadi lan , zil çalmıştır bile .	çalmıştır	4	3
Melek kaç tane sattın ? diye yaklaştı Memo .	sattın	3	2
Hem yarın sokağa çıkma yasağı olacaktır .	olacaktır	5	3
- Sen yaptın , beni yalnız bıraktın , hep başkaları oldu hayatımızda .	bıraktın	6	2
Sakinleştirir bu beni yavaş yavaş .	Sakinleştirir	0	3
Karşıtları ya da muhalifleri iktidar şansını elde etmişlerse sütü çalkalıyor , limanı dalgalandırıyorlar .	dalgalandırıyorlar	12	3
Orda bana bir şiir okudu , Allah taş etsin tek kelimesini anlamadım .	anlamadım	11	1
Ancak Batı'nın şekerle başlayan ve ağrı kesicilerle devam eden bağımlılıkları onlara da ulaşmıştı .	ulaşmıştı	12	3
İzleyiciler bu bakışın farkında olmasalar da , Recep kahrolur , darbukasına hırsla vurmaya , tempoyu hızlandırıp Saffet'i zorlamaya başlardı .	kahrolur	8	3
Bu pazar bize katılsanıza ...	katılsanıza	3	2
Evet , bir bilim dalı olmayan matematikte doğruluğunu kendi içinde barındıran önermelerden yola çıkılır ; bunlara aksiyom denir .	çıkılır	13	3
Ona her şeyi yazdım .	yazdım	3	1
Gel bak , sana evi göstereyim .	Gel	0	2
Yürüdüğümüz yol bitmiş , bir başka sokağa açılmıştı .	açılmıştı	7	3
Dere yatağından getirilip köpeklerin erişemeyeceği bir yükseklikteki kütük setin üstüne istiflenmiş buz bloklarından bıçağıyla kopardığı parçaları kovaya dolduruyor .	dolduruyor	17	3
Hiç konuşmasanız da aklınızdan geçirdiğiniz her şey duyulacak .	duyulacak	7	3
Atatürk'ün maiyetinde , Muhafız Kıtasında görev yapmış bir ağabeyimizden ( Halim Tokmakçıoğlu ) dinledim .	dinledim	13	1
Herkes bir şey yakıştırıyor .	yakıştırıyor	3	3
Kapı dışarıdan vuruluyor , hafifçe itiliyor , aralanıyor , yeniden kapanıyordu .	vuruluyor	2	3
Bırakamazsınız o parkı .	Bırakamazsınız	0	2
Kapıyı itiyorum , zorluyorum , tam biraz açılır gibi oluyor , gene kapanıyor .	kapanıyor	12	3
Sesinden tanıyordum kadınların mutsuzluğunu , sanki seslerinin özel bir kokusu oluyordu , kıyılmış tütün kıvamında , yanık gül yaprağı gibi kokuyordu sesleri , daha ilk notasında alıyordunuz kokusunu , bezgin , mesafeli ve biraz da düşmanca bir ses çıkarıyorlardı .	alıyordunuz	26	2
Sezginler ne ile uğraştığını o güne kadar tam olarak bilemese de Senem başlarına gelebilecekleri tahmin edebiliyor ve bu yüzden Sezginler'i uyarma ihtiyacını hissediyordu .	bilemese	9	3
Belki bir daha hiç giremeyeceğim oraya .	giremeyeceğim	4	1
Her gün yüz bin mi verecekler sana .	verecekler	5	3
İlhami büyük ama , biz iki kişi olunca onu döveriz .	döveriz	9	1
En yakınımıza bile anlatamadığımız şeyleri ona anlatalım .	anlatalım	6	1
Akşamları lokantada , kenar köşe bir masa kendilerine ayrılıyor , hesaptan ayrı getirdikleri balıklarla , bedava bir küçük rakıyla , ufak tefek mezelerle ucuz , güzel bir gece geçiriyorlardı .	geçiriyorlardı	28	3
En zıt fikirler ileri sürülüyor , kimse kimseye hakaret etmiyor , tarizde bulunmuyordu .	bulunmuyordu	12	3
Ama bir ihtimal var , değil mi ? Sırf sana olan kızgınlığımı birine anlatmam halinde üzerimden bir yük kalkar , gerilimim azalır , sana daha hoşgörülü yaklaşabilirim , daha bağışlayıcı olabilirim .	olabilirim	30	1
Gerçi ben kendi kendime idare ederdim ama şu dersler yok mu , o konuda kesinlikle yardıma ihtiyacım vardı .	ederdim	5	1
Henüz iki saattir yoldaydık ve ben altı kez düşmüştüm .	düşmüştüm	8	1
Erkekler Parkı'nın yolunu bilmiyorum .	bilmiyorum	3	1
Rakı sofranı onunla beze .	beze	3	2
Cebimdeki jetonları şıngırdattım .	şıngırdattım	2	1
Taksitli kartların bu kadar yaygınlaşmasının bu rekabetin bir sonucu olduğunu belirten Demiray , " Aslında özü itibarıyla bu kredi kartı işiyle biraz çelişiyor " dedi .	çelişiyor	22	3
Gördün mü el konulduk bile .	konulduk	3	1
Adam , yani mandıra sahibi bakmış ki , başının etini yiyor , rezil olacak , dayalı döşeli bir daire alıp , üstüne yapmış Kumru'nun , çekmiş gitmiş ...	gitmiş	26	3
Ben akşama vurulacak insanların o sırada neler yaptığını merak ederek cinayet haberlerini kesip dosyalarına koyardım ; arada ilginç bir cinayet çıkarsa , kimin , nerede , nasıl öldürdüğünü yanımda taşıdığım özel cinayet defterime kendim için kaydederdim .	koyardım	14	1
Ayrıca bunlardan birincisi , daha çok yüzyılın ilk yarısında gerçekleşmiş , ikincisi ise , yüzyılın ikinci yarısında zirvesine ulaşmıştır .	gerçekleşmiş	9	3
Güzel rakı mezeleri verir patlıcan .	verir	3	3
Ve fark ettim ki , onlarca kutudan , yüzlerce eşyanın arasından bir tek bilgisayar disketi bile düşmedi yere .	düşmedi	16	3
Anneme Tibet konusunu daha açamadım .	açamadım	4	1
Ürünlerinizin konuşulduğu bir atmosfer yaratabiliyorsanız , ürün kendi kendini satacaktır .	satacaktır	9	3
Başesgioğlu verdiği önergeyle güvenlik , savunma amaçlı hibe ve yardımlara ilişkin uygulama boşluğu doğmaması için , 2002'de mevcut olan düzenlemelerin devamı sağlandı .	sağlandı	21	3
Ben susmuyordum : Hayır ! Hayır ! Tavandan üstüme kan damlıyordu .	susmuyordum	1	1
Kardeşinin eşiyle birlikte Bismil Oğuzlar Köyü İlköğretim Okulu'nda görev yaptığını anlatan ağabey Mehmet Karamutlu , " Gerçeği ona nasıl söyleriz bilmiyorum .	bilmiyorum	20	1
Çıt ! Söndürdüm masa lambasını .	Söndürdüm	2	1
Boru hattının geçeceği bölgelerde sivil toplum örgütlerinin de katılımıyla teklif komisyonları kurulacak .	kurulacak	11	3
Sesinden tanıyordum kadınların mutsuzluğunu , sanki seslerinin özel bir kokusu oluyordu , kıyılmış tütün kıvamında , yanık gül yaprağı gibi kokuyordu sesleri , daha ilk notasında alıyordunuz kokusunu , bezgin , mesafeli ve biraz da düşmanca bir ses çıkarıyorlardı .	tanıyordum	1	1
Sen buralarda ne geziyorsun aylak aylak .	geziyorsun	3	2
Zafer Piknik'te alıyordum soluğu ...	alıyordum	2	1
Ramiz hala anlatmakta diretiyor : Evde yemek götürecek kimse yoktu , diyor , sonra annem bana ...	diretiyor	3	3
Ayhan bitirmiş İTÜ'yü , tamir edemiyor bir basit ütüyü ...	bitirmiş	1	3
Cevap vermedim .	vermedim	1	1
Bırakın gideyim , ne olur bırakın .	gideyim	1	1
Gerçek parçacıklar Geiger sayıcılarında click sesi üretirler .	üretirler	6	3
Genç yaşına karşın , bütün bunları biliyorsun Maryline .	biliyorsun	6	2
Lokantası her gece doluyordu .	doluyordu	3	3
Dünkü Amerikalı iki paket bırakmıştı .	bırakmıştı	4	3
Sonunda elde kalanın doyum mu , doyumsuzluk mu olduğuna karar veremediğin , tütsülerin savrulduğu anıt - mezarlar ...	kalanın	2	3
Pilaki ile Piyaz yarışırlar .	yarışırlar	3	3
Beni terk etmekte olan sevgilimle buluşup yemek yiyecektim .	etmekte	2	3
Evet , geri dönüyorum .	dönüyorum	3	1
O anda anladım ki , büyük amcan gidici .	anladım	2	1
Yani üstü kapatıldı , olayın gerçek yüzü kapatıldı .	kapatıldı	2	3
Evden mi kaçtın ? ...	kaçtın	2	2
Hafife almayın .	almayın	1	2
Bak ondan yakınırım ama belki de haksızım .	Bak	0	2
Şimdi hiçbir şeye yaramadıklarını düşünsem de , yaşayabilmek için yazmak ! Böylece , o beklemekle , aramakla , bütün bu zaman parçalarını dolduracak olan boşlukla ve sıkıntıyla dolu yaşam çizgimi belirledim sanıyorum .	belirledim	30	1
Bizi kıyaslayan , karşılaştıranlar bilsinler ki ... Biz , yarışta değiliz .	değiliz	10	1
Ummadığı inandırıcı soğukkanlılığım , açığa vurmasına yaradı , umut beklentisini ...	yaradı	6	3
Çünkü yukarıda da değindiğimiz gibi , kanıt sözcüğü felsefi anlamda kapalılığı anlatır .	anlatır	11	3
Kadın bakmış ev konak gibi koskocaman , ambarları yiyecek dolu , bağlarda üzümler salkım salkım , ineklerin memelerinden süt damlıyor .	damlıyor	19	3
Anne iyice sağlığına kavuşunca bir de ben gidip bu adamı göreyim diye düşünmüş ve kızın peşine takılıp şehrin ucundaki eve gitmiş .	göreyim	10	1
Yedi yıl boyunca çocuk hasretiyle yanıp tutuşuyorlardı .	tutuşuyorlardı	6	3
Soru da sormazlar .	sormazlar	2	3
Fezlekede , Almanya'daki bazı Türk vatandaşlarının " dolandırıcılık " iddiasıyla Akgündüz hakkında suç duyurusunda bulundukları belirtildi .	belirtildi	15	3
Cumhurbaşkanı ile sürtüşmeyiz .	sürtüşmeyiz	2	1
Oradaki , kalemdeki görevlilerin kaprisiyle de karşılaştık .	karşılaştık	6	1
İçeriden fırlayan genç çobanlar , geyikleri kızaklarından çözmeye başlarken yolcular hızla içeri girdi , ben de arkalarından .	başlarken	8	3
İşçi Partisi ve Aydınlık gazetesinin çeşitli davaları dahil belalı denebilecek pek çok davayı alıp , üzerine gitmekten çekinmiyordu .	çekinmiyordu	17	3
Tehlikeli Oyunlar'ın sonu malumdur , diye mırıldandım .	mırıldandım	6	1
Uzadıkça uzamış .	uzamış	1	3
Hiç böyle düşünmemiştim , doğrusu bugüne kadar hiç böyle düşünmemiştim .	düşünmemiştim	2	1
Bugün doksaniki gün vadeli referans bono ihalesi ile piyasaların önüne çıkılacak .	çıkılacak	10	3
Sanıyorum bütün entellektüel züppeler oradalar .	Sanıyorum	0	1
DYP Trabzon İl AKP'li partililere seslenen Ağar , Tansu Çiller'i üstü kapalı şekilde eleştirmeyi sürdürdü .	sürdürdü	14	3
O haftayı iple çektiğimi dün gibi hatırlıyorum .	hatırlıyorum	6	1
Gülce , incecik de olsa altın bilezik alabiliriz , diyor .	alabiliriz	7	1
Bilene rastlamadım .	rastlamadım	1	1
Şahin , " BDDK istese de istemese de kamuda rahatlama için emekliliği gelenleri emekli etmeyi düşünüyoruz " dedi .	düşünüyoruz	15	1
Asıl sen beni ne sandın .	sandın	4	2
Binlerce , onlarca , yüzlerce soru sorabilirdim daha .	sorabilirdim	6	1
Bir müzikal yapalım : Hadi fıstık , ya da fındık aryaları söyledi .	yapalım	2	1
Bunun cezasını babası askerliğinde çok çekmişti .	çekmişti	5	3
Geliyoruz , diyerek geldiler .	Geliyoruz	0	1
Diyarbakır'da bir inşaat firmasında proje müdürü olarak çalışan inşaat mühendisi Servet Karadağ , evlendikten sonra da eşini yanından hiç ayırmadı .	ayırmadı	19	3
Köpeklerin çok sık yıkanması da iyi olmayacağından bu kurala uymam köpeğimin de iyiliği içindi .	uymam	9	1
Ancak özellikle evrenbilim ve parçacık fiziğinde bugün bu ilke ne yazık ki çiğnenmiş , bu iki bilim dalı metafizik öğelerle , hayaletlerle dolmuştur .	dolmuştur	22	3
Yaşamöyküsünü sürdürelim .	sürdürelim	1	1
Olur olur ...	Olur	0	3
Yerleştir yerleştirme , devşir devşirme sınavları falan filan yok ...	devşir	3	2
Birden , geldiğini duydum , parktaki kalabalık karıştı .	duydum	3	1
Görünen o ki Bitlis dosyası askeri makamlarca açılmamak üzere çoktan kapatılmıştı .	kapatılmıştı	10	3
Canı sıkılmış gibiydi .	sıkılmış	1	3
Siz dükkandan çıkıp onların arasına gireceksiniz ve yürümeye başlayacaksınız .	gireceksiniz	5	2
Herkesin vicdanına yükleniyorsun .	yükleniyorsun	2	2
Giderek doğruluğuna inandığım ifade şu olmuştur : Yaşantı , hayat tarzı , evi biçimlendirir .	biçimlendirir	13	3
Şostakoviç dinleteceğim sana .	dinleteceğim	1	1
Makinenin renkleri ve ışıkları yoruyor gözümü , dedim .	yoruyor	4	3
Memur zammı geçmiş enflasyona göre yapılırsa , yıl sonu gerçekleşme beklentisine göre yüzde otuz'un altında olmayacak .	olmayacak	15	3
Kurtulup buraya gelmeyi başardım .	başardım	3	1
Diz çök karşısında , okşa saçlarını , özür dile , bağış dile , ne dilersen dile it herif , ağla hatta elinden geliyorsa ...	dile	8	2
Onun bu evde yeri yok artık , diye bağırmış .	bağırmış	8	3
Oğlan pantolonunu , gömleğini giyinmiş , donunu kayığın üstüne sermişti .	sermişti	9	3
Boş ver , dedi , bazı şeyleri unutmak gerek .	ver	1	2
Ulan hayvan , al bir kalem yaz işte , değil mi ?	al	3	2
- Yazdığın kadarını okurum .	okurum	3	1
Çocuğun tabaktakileri bir solukta silip süpüreceğini biliyordu artık .	biliyordu	6	3
Seçim gezilerine Şanlıurfa'dan başlayan SP'nin Topçu Meydanı'nda düzenlenen " Saadete Davet " mitingine Erbakan da katıldı .	katıldı	15	3
Hadi koşalım .	koşalım	1	1
Bebelerin toplantılarındaki üslubu özlemle anıyorum .	anıyorum	4	1
İş Güvencesi Yasası , ölçüsüz popülizmin simgesi olarak tarihteki yerini alacak .	alacak	10	3
Öğleden sonra kanallar kıyısında dolaşırken , sanki uzun yıllardır buradaymışım , hep de kanallar kıyısında dolaşıp durmakla vakit tüketirmişim gibi geliyordu bana .	tüketirmişim	18	1
Önce tanıştılar .	tanıştılar	1	3
Sanılıyordu ki , ülkenin devasa sorunlarına , dair , basmakalıp siyaset tiradlarının düellosunu kazanan muzaffer olacaktı .	olacaktı	15	3
Niye mutsuz olduklarını ise söylemezlerdi , mutsuzluklarının nedenini siz keşfetmek zorundaydınız , bunu keşfedemezseniz biraz daha düşmanlaşırlardı ; bu düşmanlık gerçek değildi , yalnızca mutsuzluklarının üstüne örtmeye çalıştıkları yakıcı bir örtüydü .	söylemezlerdi	4	3
Hiçbir şey düşünemiyorum .	düşünemiyorum	2	1
Bu fotoğrafı çektirir çektirmez İstanbul'a göçmeye karar vermişler , ama olmamış .	çektirmez	3	3
Hiç böyle düşünmemiştim , doğrusu bugüne kadar hiç böyle düşünmemiştim .	düşünmemiştim	9	1
Soğukça yanıtladım .	yanıtladım	1	1
Halbuki arada gidip günah çıkardın mı , kendini bir miktar yırtmış hissediyorsun , temizlenmiş hissediyorsun , aynı haltı yiyeceğini bilsen bile bir güvencen var .	çıkardın	4	2
Erkekler bakmaya da daha az zaman harcarlar .	harcarlar	6	3
Dört külah dondurmayı iki eliyle tutan kız takunyalarını tıkırdatarak içeri girdi .	girdi	10	3
İnan bizim yazlık sitedeki Ufuk abiden bile daha yakışıklı .	İnan	0	2
Artık duygularının , hastalıklarının ağrılarını kesecek uyuşturucu da olmadığı için neye sığınacağını bilemeyecek hale geliyor .	kesecek	5	3
Tutamadım kendimi aga .	Tutamadım	0	1
Yanımdaki koltuğa yerleştirdi ince bedenini .	yerleştirdi	2	3
Bütün delilleri , dosyayı inceleme hakkına sahipiz hukuki olarak , fakat bu haktan mahrum edildik .	edildik	14	1
Haftanın sorunsuz atlatılacağı tahmin ediliyor .	ediliyor	4	3
Kimseyi doldurmadık .	doldurmadık	1	1
Pikabı vardı .	vardı	1	3
Boş zamanlarımda bazen cinayetlerin işlendiği yerlerde dolaşıp çevreye bakınır , cinayet anını gözümde canlandırmaya uğraşırdım .	bakınır	8	3
Artık hiçbir şey avutamaz beni , kendimi kandırabileceğim bir şey yok .	kandırabileceğim	7	1
Ama yaşamdan duygularımızla zevk alırız .	alırız	4	1
Kendiniz bulun .	bulun	1	2
Kamu Tek Hesabı'nın kapsamı genişletildi .	genişletildi	4	3
Kızını çok beğendik .	beğendik	2	1
Bu komisyonlar , arazilerini satın almak için köylülere sunulacak fiyat teklifini belirlemede söz sahibi olacaklar .	olacaklar	14	3
Gidersiniz , sonra geri gidersiniz Erkekler Parkı'na .	Gidersiniz	0	2
NA toplantılarında ilk kez başkalarına yöneldim .	yöneldim	5	1
Aaa , diyorlar , kimi elini saygıyla göğsüne bastırıyor kimi de , işte orada duracaksın anlamında ileri doğru uzatıyor ; büyük adamdı .	bastırıyor	8	3
Yolculuk , başka bir kentte olmak , hep karşılaştığım yeni şeyler , derinden derine izini süren heyecan dirilik yaratmıştı bende .	yaratmıştı	18	3
Kendinden emin bir biçimde Taşhan'ın kapısını itip içeri girdi .	girdi	8	3
Başkalarının en iyi gizlenen sırlarına bile ulaşmanın daima bir yolu bulunurdu , ama insanın kendi sırlarına erişmesi neredeyse imkansızdı ve yazarlık bu imkansızı yaşamaktı sürekli .	bulunurdu	10	3
Kaptan Pilot Alaattin Yunak'ın dokuz ay önce THY hosteslerinden Deniz Yunak'la evlendiği ve hostesliği bırakan eşinin İstanbul'da ailesinin yanında olduğu belirtildi .	belirtildi	20	3
Bu konuda Cumhurbaşkanı Ahmet Necdet Sezer'in de " Türban tartışması bitmiştir " diyerek son noktayı koyduğu belirtildi .	bitmiştir	10	3
Diz çök karşısında , okşa saçlarını , özür dile , bağış dile , ne dilersen dile it herif , ağla hatta elinden geliyorsa ...	geliyorsa	22	3
Aldırma sen bana .	Aldırma	0	2
Gülce'nin dayısı kuyumcu olduğundan bize indirim de yapabilirmiş .	yapabilirmiş	7	3
Giderdik konserlere , tiyatrolara , sinemalara .	Giderdik	0	1
Bir mucize gerçekleşse .	gerçekleşse	2	3
Esin'le Özer birbirlerine baktılar Özer Prensesi ben koruyacağım ! dedi , Esin de gülümseyerek odanın ortasında dönmeye başladı yeniden : Ben bir prensesim , ben bizim evin prensesiyim . diye mırıldanarak .	baktılar	3	3
Kahramanlarınızın , kadın - erkek ilişkilerine dönük yönlerinde de , kulaklarınıza inanamıyor ve duyduklarınızla düş kırıklıklarına duçar oluyorsunuz .	inanamıyor	11	3
Oysa tebligat yapılmamıştı .	yapılmamıştı	2	3
Bir Aydınlık gazetesi aldı , kazayla ilgili çıkan ilk haberi okudu ve hemen telefona sarıldı .	sarıldı	14	3
Bunun senin için gündelik hayatın olağan bir parçası olduğunu düşün .	düşün	9	2
Zeynep merak ve endişeyle kardeşine baktı : Orhan sen benden bir şeyler gizliyorsun ?	gizliyorsun	12	2
Üstümdekiler eski , ipek gömleğim sararmış ...	sararmış	5	3
Ama hiçbir zaman emin olamazsın .	olamazsın	4	2
House Zirvesi'nde TÜSİAD Başkanı , her yıl istihdam yaratmanın yolunun , yüksek ve istikrarlı büyüme temposundan geçtiğini vurguladı .	vurguladı	17	3
Bazen şarkı söylerken de olur bu , arkadaşlar bilir ( arkadaşlar , yani bıyıklarına ak düşmüş emekli sarhoşlar gözlerini yumup başlarını hafifçe eğerek onaylıyorlar ) okursa hüzzam okur , herkesi kahırlandırır .	okur	27	3
Destek olun bana .	olun	1	2
Zaman içersinde o teoreme yeni aksiyomlar , türetimler girmez ; ondan yeni bilgiler , öngörüler çıkmaz .	girmez	8	3
Esin de Özer de Uykudan Önce programı gibi dinlediler anlattıklarımı , bir yandan esniyorlardı bir yandan da gözleri sevinçle parlıyordu .	parlıyordu	19	3
Eylemde , " ABD kuklası iktidar istemiyoruz " yazılı pankart ve kırmızı boyalarla vampir çağrışımı yaratılan ABD Başkanı George Bush'un resimleri dikkat çekti .	istemiyoruz	6	1
Gelin , birlikte girelim , dedim .	girelim	3	1
Sonra da adamdan sayılıp başımıza bela olacaksınız ! diye bağırdı .	olacaksınız	6	2
Potaya girerken arkadan gelen bir diğeri onları vurabilir .	vurabilir	7	3
Matematikte doğruluğunu kendi içinde barındıran hipotezlerden yola çıkarak bir teoremi kanıtlarsınız ve dosya kapanır .	kanıtlarsınız	10	2
Madem iş istiyorsun gir içeri , demiş .	istiyorsun	2	2
Kadın uyuduysa okur , dedi adam .	okur	2	3
Recep , pantolonunu giymiş , gömlek cebinden çıkardığı sigarayı ağzına koymuştu .	giymiş	3	3
Geçici bütçe tasarısı , Meclis'e sunuldu .	sunuldu	5	3
Poynter direktörü Bob Steele , " Bence ' biz intihar haberi hiç vermiyoruz ' düşüncesi de açıkça sorgulanmalı " diyor .	vermiyoruz	12	1
Bir taksi bulduk .	bulduk	2	1
Ben konuşsam .	konuşsam	1	1
Zamanından önce programa başlamak zorunda kalan Saffet , baktı ki olacak gibi değil , türkünün ardından hemen kıvrak bir oyun havasına geçti .	baktı	8	3
Naci Bey elini masaya öyle bir vurdu ki , ön sırada oturan kızlar hii diye bağırıp yerlerinden sıçradılar .	sıçradılar	17	3
Prof. Dr. Semih Koray'ın , dergimizdeki eski yazılarından derlenerek kaleme alınan makalesini dosyamızın sunuş yazısı yaptık .	yaptık	15	1
Ama orada gayet normal hareket eden insanların çoğu , yandaki salona geçtiğinde şoka giriyorsunuz ; Resmen hard seks yapıyorlar .	giriyorsunuz	13	2
Bir insanın ruhundan geliyorum ben , dedi .	geliyorum	3	1
ABD'nin Ankara Büyükelçisi Robert ' , Irak konusunda barışçı çözümde ısrar edeceklerini ve sorunun savaşsız bitmesini arzu ettiklerini belirterek , " Saddam giderse savaş şartları ortadan kalkar " dedi .	giderse	22	3
Şimdi içeriye girip onu Mahmut'a vereceğim , dedim .	vereceğim	5	1
Kim tamir edecekti beni ?	edecekti	2	3
Bazen çabuk söner böyle şeyler , dedim .	söner	2	3
Nasıl da zorluyor kapıyı ...	zorluyor	2	3
Tamam , geliyorum .	geliyorum	2	1
Beğenili bakışları üstümüzde gelip geçenin .	geçenin	4	3
Neden yeni alternatifler üretilemedi .	üretilemedi	3	3
- İstemesen de gidelim .	İstemesen	1	2
" Bu sözleri ağlayarak dinleyen Özmen , programında çalışması için Ciguli'ye teklifte bulununca o da seve seve kabul etti .	seve	16	3
Ağır , babacan bir gülüşle gülüyorlar , önlerine eğdikleri başlarını ( saygıdan tabii ) ağır ağır sallıyorlar : Yazık , çok yazık , diyorlar .	sallıyorlar	16	3
Hayret , ne zaman yazmışım ?	yazmışım	4	1
Kadın uyuduysa okur , dedi adam .	uyuduysa	1	3
Ulvi meslek öğretmenliğe sığındık .	sığındık	3	1
Bilimsel Devrim'in başlangıçtaki esas etkisi , daha önce de değindiğiniz gibi ideolojik düzlemde olmuştur .	olmuştur	13	3
Böyle olduktan sonra , ben , sadece otlu peynirlerimizden futbol takımı kurarım .	kurarım	11	1
Ona anlatmayıp da kime anlatacaktım ? Kimim kimsem yoktu , her şeyim oydu .	anlatacaktım	4	1
Anlat , anlat ...	anlat	2	2
Botel Maliye Hesap Uzmanları Vakfı'na hazırlattığı " Türk Vergi Sistemi , Sorunlar ve Çözüm Önerileri " başlıklı raporda vergi mevzuatı bütün yönleriyle değerlendirildi .	değerlendirildi	22	3
Ben bir dolaşıp geleceğim , dedim .	geleceğim	3	1
Beni zorla çağırmadı ya ...	çağırmadı	2	3
Kalktım , sarıldım boynuna , zoraki öptürdü pembeliğini koruyan yanaklarını .	Kalktım	0	1
Hep uzaktan uzağa kuşatmazlar mı birbirlerini , hep araya giren anaların yatıştırmalarıyla sakinleşmez mi ortalık .	kuşatmazlar	3	3
Hablemitoğlu'na ortak aranıyor .	aranıyor	2	3
Gülmeyin , zor durum ...	Gülmeyin	0	2
Kabuğunu bile korumuştur .	korumuştur	2	3
Vazgeç bu huyundan .	Vazgeç	0	2
Delikanlıyı Adsız Narkotikler ( NA ) grubuna katılması için teşvik ediyorum .	ediyorum	10	1
Nasıl olup da erkeklerin tam tersine , kısa hedeflerde fantezilerini , uzun hedeflerinde mantıklarını kullanırlar .	kullanırlar	14	3
Cumhurbaşkanı ile sürtüşen bir iktidar olmak istemiyoruz .	istemiyoruz	6	1
Melek her zamanki yerinde , ümitle gelene geçene flasterlerini ve kalemlerini uzatıyordu , ama nafile ; kimsenin ona aldırdığı yoktu .	uzatıyordu	11	3
Belki de rastlayacaksınız ona .	rastlayacaksınız	2	2
Bakma hoşnut görünmesine , aklı başka yerde .	Bakma	0	2
Zor kurtuldum oradan .	kurtuldum	1	1
- İstemesen de gidelim .	gidelim	3	1
Melek üsteledi , Nerden buldun öyleyse ?	buldun	4	2
Çek şu albümü , şunu şunu , hani gidip gelip karıştırdığın , bilmem mi sanırsın , hah işte o albümü ver bakayım .	Çek	0	2
Türkiye savaş alanlarında değil , kelimelerle yürütülen mücadelelerde kaybediyor .	kaybediyor	8	3
Siz olmasanız , ben olmasam , yani nasıl ...	olmasam	4	1
Biraz daha inandırıcı olmak için Bak mesela sadece bir tane annemiz var çünkü bir evde sadece bir tane kraliçe olabilir . dedim .	Bak	5	2
Suya doğru bir adım attı , sonra vazgeçip geri döndü , kıyıya çekilmiş , ters döndürülmüş , birkaç yıldan beri denize indirilmeyen eski kayığın yanına geldi .	döndü	9	3
Kendimizi bir yoklayalım .	yoklayalım	2	1
Ben her sabah yürüyorum .	yürüyorum	3	1
Annem hep korkmuş , çocuklarımdan biri büyük amcalarına benzer diye ; ama şimdi bakıyormuş da , benim yolum yol değilmiş .	korkmuş	2	3
KÜTÜK , yaşadıklarını şöyle anlattı : " Yapımcıyla konuşup dizide oynamak istediğimi söyledim .	söyledim	12	1
Yine kafam bulanıkken , teyzemin defterinden aktarmışımdır .	aktarmışımdır	6	1
Kafamın yetmediği fen derslerinde düşünürdüm : Aynı hoca ağabeyime de böyle anlatmış .	düşünürdüm	4	1
" Kamunun bilgilenmesini gerektiren , ciddi boyutlu bu konuda anlamlı bir habercilikle , kimi intiharlar işlenebilir .	işlenebilir	15	3
Üstelik mitolojilere inanmayan birisiyse , boşluk üzerinden akacaktır onun .	akacaktır	7	3
Önce kahvelerimizi içelim de ...	içelim	2	1
Sevinmez mi ?	Sevinmez	0	3
Buzlanma olmadığını ifade ediyordu .	ediyordu	3	3
Senaryolar çıkışı zorlayabilir .	zorlayabilir	2	3
Eşi ve kızı öldü ama o bilmiyor .	öldü	3	3
Çıkar şu donunu , çıkar da pantolonunu öyle giy .	giy	8	2
Önüne gelenle yatıp kalkıyormuşum .	kalkıyormuşum	3	1
Çok alışmıştım Kahve'ye belki vazgeçersin almaktan , annem de alıştığı için kalır diyordum kendi kendime .	diyordum	12	1
Üniversitede hocayız desek Şüpheli kişi olacağız çünkü .	olacağız	5	1
Çocukluğumuz hep Anadolu'da geçti .	geçti	3	3
Yoksulluk içinde olan kişileri gözetmeyi amaçlayan yardım politikasında , sadelik , titizlik ve kişiliklere saygı esasına özenle gösterilmesini eşitlik ve adalete riayet edilmesini önemli rica ederim .	ederim	25	1
Anlattım mı .	Anlattım	0	1
O araba her gün oradan mı geçecek , geçse bile sana her gün yüz bin mi verecek ? Akılsız , dedi Melek .	geçse	8	3
Biliyordum seveceklerini .	Biliyordum	0	1
Sen de benim yaşıma gel , sana da alırlar göreceksin .	alırlar	8	3
Kalemlerin de flasterlerin de duruyor .	duruyor	4	3
İnsanları ikiye ayırıyor annem ( sayacağı iki kalem de olsa mutlaka parmaklarını avucuna kapatarak sayacak ; birincisi yaşayanlar ( bunlar başkalarını da yaşatıyor ) , ikincisi yaşayanları seyredenler ( bunlar da başkalarının sırtına yük oluyorlar ) .	yaşatıyor	22	3
Şimdi birini oradan oraya alarak tayin edeceksiniz , öbürünü açığa alacaksınız , öbürünü sorgulayacaksınız .	sorgulayacaksınız	13	2
Sana bakıyordum .	bakıyordum	1	1
Birbirimize hiç dokunmadan , ben onun ellerine o da benim gözlerime bakarak sevişirdik kalabalığın içinde .	sevişirdik	12	1
Kaçtım , kurtuldum oradan , diyordunuz , dedi .	diyordunuz	5	2
Çin Komünist Partisi'yle işbirliği kararı alan yankee , Avrupa'da da Hıristiyan Demokratlar'a üye olmaya hazırlanıyor .	hazırlanıyor	14	3
Aptalca düşüncelerinizi , ruhunuzun hasta olduğunu sandığınız yanını başkalarının duymasından , bilmesinden korktunuz yıllarca .	korktunuz	12	2
O gece rüyamda ben balerin olmuştum .	olmuştum	5	1
Askerler , Anayasa çiğnendi diye rejime müdahale etmişler , sonra da Anayasayı toptan kaldırarak yeniden başka bir metin yazdırmışlardı .	çiğnendi	3	3
Rum Kesimi'nin AB'ye üye olması durumunda Türkiye - AB ilişkilerinde sürekli sürtüşme yaşanacak .	yaşanacak	12	3
Gidiyoruz , gelin .	gelin	2	2
SON ANDA VAZGEÇTİ .	VAZGEÇTİ	2	3
Sonra birdenbire her şeyini verir bana .	verir	4	3
Dışardaki çadırda Şura ekmek hazırlıyor .	hazırlıyor	4	3
Ellerimi tuttu , şefkatle gözlerime baktı : .	baktı	5	3
Bazı bilim adamları evrenin genişlemesini tanımlayan anda ortaya çıkan matematiksel tekilliği Tanrı sandılar ve Tanrı'nın evreni o noktada yarattığını düşündüler .	düşündüler	19	3
Ay çoktan batmıştı .	batmıştı	2	3
Arınınki petek , kuşunki yuva , ayınınki in ; ama insanın barınağı hemen ev olmamış , çünkü ev başlangıcı barınak olan bir sürecin ifadesi aynı zamanda .	olmamış	14	3
Sabah olup da saatimin zili çaldığında kuşlarla gökyüzünde bale yaparak uçuyordum .	uçuyordum	10	1
Ya dayak yerseniz , ya karakola gidersiniz .	yerseniz	2	2
Hakkı , Seni bu kafayla bekar evine göndermem .	göndermem	7	1
Sen de kolluyordun canım teyzeciğim , sezdirmemeye çalışarak ikimizi ...	kolluyordun	2	2
Ne kadar zengin olursan ol , diyor , seyirci olduktan sonra ( al işte Nurettin Bey ; sattı yedi , sattı yedi şimdi beş parasız , onun bunun eline bakıyor ) sıfırı tüketirsin .	al	12	2
Bu yüzden , çaldığı iki ağır türkünün ardından yine kıvrak bir göbek dansına , ya da bir bozlağa geçer , balıkçılar oturmayacak olurlarsa , kaş göz işaretleri yaparak , masalarına gitmeleri gerektiğini anlatırdı .	anlatırdı	32	3
On sekiz yaşında sırasıyla , içki , kokain ve eroinle tanışıyor .	tanışıyor	10	3
Kanım birden beynime fırladı , kafatasımı dağıtarak tavana doğru fışkırmaya başladı .	fırladı	3	3
Hiç anlamasalar da , hiç bilmeseler de , hiç ilgilenmeseler de , neden , kadınlar bütün erkeklerin iş hayatlarını pürdikkat dinlerler .	ilgilenmeseler	9	3
Güreş daha sonra Kara Havacılık Okulu'na gidiyor ve orada bir demeç veriyor .	veriyor	11	3
Toplantıyı evinde yapacak olan kişi , Sakarya caddesindeki iki büyük bakkaldan , ya da Bulvar üzerindeki Trakya Şarküterisi'nden peynir , salam , tarama , Rus salatası , dolma gibi şeyler alırdı .	alırdı	30	3
Uluslararası onyedi. ekononomik Bilim Yarışması'nda dereceye giren öğrencilere ödüllerini veren Mumcu , daha sonra soruları yanıtladı .	yanıtladı	15	3
Sana olacağını nereden çıkarıyorsun ?	çıkarıyorsun	3	2
Kahveden çıkarak alana doğru yürüdük .	yürüdük	4	1
- En çok hangisini seviyorsun .	seviyorsun	4	2
Nereden biliyorsunuz ? diye hayretle sordum .	biliyorsunuz	1	2
İstersen biraz daha kalsın , biraz daha annesi baksın ona .	baksın	8	3
Aydınlık yetkilileri ellerindeki kimi belgelerden , duyumlardan bahsettiler .	bahsettiler	7	3
ya da belki ben böyle bir vaziyeti görürüm diye , bilemiyorum ...	görürüm	7	1
Arçelik olarak genelde tahminimizin üzerinde iyi bir yıl geçirdik .	geçirdik	8	1
Annemle babam benimle ilgilenmiyor demek istemiyorum ; ama ben onlarla daha fazla birlikte olmak istiyorum .	istemiyorum	5	1
Yıl boyunca her gün değişik bir peynir yiyebilirsin .	yiyebilirsin	7	2
Açma , sakın açma , izleniyorum .	Açma	0	2
Hepimiz Cumhuriyet devrinde doğmuştuk .	doğmuştuk	3	1
Sevgilinin ışıksız pencerelerine uzaktan bakarken kalbim böyle küt küt atmamıştı .	atmamıştı	9	3
Ağar meydan okudu .	okudu	2	3
Yanlışlanan kuramın doğurganlığı burada yatar .	yatar	4	3
Ağabeyinizi öldürmek ya da kanın fışkırışını görmekten çok , bu düşüncenizin başkalarınca bilineceğinden korktunuz .	korktunuz	13	2
Hülya , Onu seri düşün , hadi gel , dedi ve kolumdan çekti .	düşün	4	2
Mersedes buldum mu bırakmam abi .	buldum	1	1
70'lere kadar gidebildim .	gidebildim	2	1
Emaye bobin teli üretecekler .	üretecekler	3	3
Beş dakika sonra sor , o da tek kelimesini söyleyemiyor .	söyleyemiyor	9	3
Ben senin gibi pis boğaz değilim , koy cebine akşam abime verirsin .	koy	7	2
Ancak big bang yanlıları genellikle böyle bir davranış sergileyemiyorlar .	sergileyemiyorlar	8	3
Ben böyle fedakar , yufka yürekli , candan insan tanımadım .	tanımadım	9	1
Ama kurtardım kendimi .	kurtardım	1	1
Irak'ta süreç uzuyor .	uzuyor	2	3
Bu konuda Cumhurbaşkanı Ahmet Necdet Sezer'in de " Türban tartışması bitmiştir " diyerek son noktayı koyduğu belirtildi .	belirtildi	16	3
Nasılsınız ? Vurgu : Ortadan kayboldunuz , iyileştiniz mi ?	iyileştiniz	7	2
Nefes nefese kalmıştım .	kalmıştım	2	1
Perakende ortamı da bu karakteristiklere göre uyarlanmalıdır .	uyarlanmalıdır	6	3
Eller havaya dediler .	dediler	2	3
Bir kere tuvaletini yapmak için sık sık dışarı çıkarmak yoktu , çünkü o zaman ayakları kirlenir ve her defasında yıkamak gerekirdi .	kirlenir	15	3
Pay çıkaracaksın kendine .	çıkaracaksın	1	2
Fasulye , pilakide havuçtan ve sarmısaktan takviye alır .	alır	7	3
O günün son içkilerini içiyorduk .	içiyorduk	4	1
TBMM Başkanı Bülent Arınç , önceki akşam CNN Türk'te Taha Akyol'un sunduğu " Eğrisi Doğrusu programında " Milliyet'te yirmialtı Kasım ikibiniki tarihinde " Yanlışlara Ortak Olmam " başlığıyla yayımlanan röportajındaki ifadesinin farklı yansıtıldığını iddia etti .	Olmam	25	1
Diz çök karşısında , okşa saçlarını , özür dile , bağış dile , ne dilersen dile it herif , ağla hatta elinden geliyorsa ...	çök	1	2
Diz çök karşısında , okşa saçlarını , özür dile , bağış dile , ne dilersen dile it herif , ağla hatta elinden geliyorsa ...	dile	11	2
çalışmak da değil , hayatla boğuşuyorlar .	boğuşuyorlar	5	3
Oturup sigara yaktım , telaşe halimin geçmesini bekledim .	yaktım	2	1
Maliye Bakanı adına inceleme yapıyor .	yapıyor	4	3
Hiçbir şey anlatamıyorum işte .	anlatamıyorum	2	1
Şimdi ; gidip günah çıkarsam - bakın , üstelik burada benim bir günahım yok aslında - , rahatlamaz mıyım ? Sana normal davranır hale gelmez miyim ? Belki .	gelmez	24	3
Döndü arkasını , burnunu siler gibi yapıyor .	Döndü	0	3
Verebildiniz mi mektubu ? diye sordu .	Verebildiniz	0	2
Şefkatle okşadım çizmeleri oturduğum kızakta .	okşadım	1	1
Peki . dedi kısaca Gelin o zaman .	Gelin	4	2
Üçümüz birden girsek , dedi Miskoye , sen konuşsan .	girsek	2	1
Bir dilim ekmek ve bir fincan çayı hızla midesine indirdi .	indirdi	9	3
Bütün bunlara rağmen , Sav familyası imajını zedelemeyerek aynı okulları bitirdim ben de .	bitirdim	10	1
O kişi olmazsa yaşayamam ; sekssiz yaşayamam ; alkolsüz bir hayat düşünemem ; başarı için günde on altı saat çalışmam gerekir vb .	düşünemem	11	1
Ben de yeni kadınlar buluyordum , daha önceleri tanıştığım , bir - iki günlüğüne birlikte olduğum kadınları arayıp onlarla ilişkilerimi sıkılaştırıyordum .	sıkılaştırıyordum	20	1
Telaşla ayağa fırladı , telefona koşarken kapı vuruldu .	fırladı	2	3
Leş gibi kokuyor .	kokuyor	2	3
Cumhuriyet'in temel nitelikleri , Anayasa'nın değişmez ilkeleri ve değiştirilmesi teklif edilemez maddeleri yeni anayasada yer alacaktır " dedi .	alacaktır	15	3
Kısmetse çarşamba günü İstanbul eğlence yaşamında buluşmak üzere hoşkalın , hep mutlu yaşayın .	yaşayın	12	2
Her şey bitmişti , anlamıştım .	anlamıştım	4	1
Çantasını karıştırıyor , bir kalem arıyordu .	karıştırıyor	1	3
Ayakta duramayacak kadar yorgun olduğumu sanıyordum , o ilk adıma kadar ...	sanıyordum	5	1
Konuşmayı sevmezdi , konuşunca da iyi konuşurdu .	sevmezdi	1	3
Kemal : Bakın , bu ideolojik bir kavrayıştır , aynı zamanda .	Bakın	2	2
Teşvik uygulama , Sanayi Bakanlığı'na bağlansın .	bağlansın	5	3
Ankara Temsilcisi Fikret Bila da , Arınç'ı arayarak , " Bir serzenişte bulunmuşsunuz , ama sözleriniz teypte böyle , isterseniz deşifresini okuyayım , dedi .	bulunmuşsunuz	12	2
Muhabbet duyduk .	duyduk	1	1
Belki de inadına sokmuyor .	sokmuyor	3	3
Pencerelerde ışık olsa gidip kapıyı çalacak mıydım , emin değildim .	çalacak	5	3
Aç şimdi .	Aç	0	2
Kerem ; ışıkta değişen , şimdi koyu bir yeşile dönmüş olan gözlerini bana çevirdi .	dönmüş	9	3
Onların gürültülü neşesi , duyduğum yalnızlık duygularını azaltıyordu , ama neler konuştuklarını da anlamıyordum .	azaltıyordu	7	3
Elli bin kağıtlık sigaradan içmem , dedi .	içmem	4	1
Ama önce , Ben buraya taşınıyorum artık , seninle birlikte yaşamaya karar verdim , diye söze başladım .	taşınıyorum	5	1
Buldum işte .	Buldum	0	1
İyice hastaydı , diyor , karnı davul gibi şişmişti .	şişmişti	8	3
Çıkar şu donunu , çıkar da pantolonunu öyle giy .	Çıkar	0	2
Hülya'nın yerleştiği apartmanın önüne kadar gittim gecenin bir vakti .	gittim	5	1
Bu nedenlerle uçağın yerde buzlanma şartları altında olmadığı kıymetlendirilmiştir deniyordu .	kıymetlendirilmiştir	8	3
Ben de bastırdım : Öğretmenim .	bastırdım	2	1
Acaba şimdiden davetiyeleri yazıp dağıtsam mı ?	dağıtsam	4	1
Rakının yanından eksik etmeyin .	etmeyin	3	2
Beni köşeye sıkıştırırlarsa çıkaracaktım ortaya .	sıkıştırırlarsa	2	3
Benzetmek gerekirse , Lahana kanlı - canlı , tuttuğunu koparan bir Kuzeyli güzelidir .	gerekirse	1	3
Uzakta köşk görülüyordu .	görülüyordu	2	3
Beni terk etmekte olan sevgilimle buluşup yemek yiyecektim .	yiyecektim	7	1
Cennet bekçisi İrfan oynamayı bırakıp bir köşeye çekilmişti .	çekilmişti	7	3
Philips mağazasının önünden geçmemeye özen gösteriyorum .	gösteriyorum	5	1
Baksanıza hallerine ... diyerek Mahmut'un masasını işaret etti .	Baksanıza	0	2
Saffet bunu görünce , yörenin daha yavaş ritimli , eski bir türküsünü çalmaya başlardı .	başlardı	13	3
İsterseniz yanına dilimlenmiş hıyar .	İsterseniz	0	2
Bitti , kendiliğinden kapandı parantez .	kapandı	3	3
Gitmeliyim , kalkıp gitmeliyim .	gitmeliyim	3	1
Bir mektup yazayım ona , dedi Mebrure .	yazayım	2	1
Ama göremedim onu .	göremedim	1	1
Göğüs geçiriyordu ara sıra .	geçiriyordu	1	3
Hiç anlamasalar da , hiç bilmeseler de , hiç ilgilenmeseler de , neden , kadınlar bütün erkeklerin iş hayatlarını pürdikkat dinlerler .	bilmeseler	5	3
Şimdilerde yeni bir korku edindiniz .	edindiniz	4	2
Aşık olduğum için utanıyorum sanıyorum .	utanıyorum	3	1
- Çiziyor musun yani .	Çiziyor	1	3
Ali Talip Özdemir ise kongrenin çok büyük olacağını vurguladı .	vurguladı	8	3
El vurdum basa basa .	vurdum	1	1
Ve o filmden gitgide uzaklaşıyoruz .	uzaklaşıyoruz	4	1
Ne kalın kafalı adamlarız ki , bir kelimesini bile hatırlamıyoruz .	hatırlamıyoruz	9	1
Leblebi deyip geçmeyin .	geçmeyin	2	2
Sigarama davrandım , saygılıyım , ikincisine .	davrandım	1	1
Yatırım indiriminde yüzde ondokuz.sekiz stopaj kaldırılsın .	kaldırılsın	5	3
Gidersiniz , sonra geri gidersiniz Erkekler Parkı'na .	gidersiniz	4	2
Tamamen yaşayanları korumaya yönelik bir rapor hazırlandı , dedi .	yaşayanları	1	3
Kim bilir belki bir gün , mezara girmeden ya da hapse düşmeden önce arar ve katılır .	katılır	15	3
İşi şakaya vurdum , iyi ya , dedim , Ceza'nın cezası da bitse keşke ; kimbilir daha kaç tanker şarap içmem gerekecek .	içmem	20	1
- Niye çizgi - roman kahramanının hayatını yazıyorsun peki , çizgi - roman kahramanının çizilmesi gerekmez mi .	yazıyorsun	7	2
Oysa insan bir kez anımsamaya başlarsa gizlediklerini , beyninin içine giren kurt onu kemirir , yeni korkular , daha büyük , daha dehşetli korkular , en olmayacak düşünceler , günahlar , suçlar yaratır .	yaratır	32	3
Koşarak ona yaklaştı heyecanla Abi ! ...	yaklaştı	2	3
Kuşkuyla baktı yüzüme .	baktı	1	3
Kapıyı açtı , dönüp bize baktı .	baktı	5	3
Artık eski iktidar mevzilerini yitirmiş olan Kilise , varlığını sürdürebilmek için , burjuvazi egemenliğinde daha geri noktalarda tutunmaya razı olmuştur .	olmuştur	19	3
İnşaat ortamına ve getireceği değişikliklere alışması için hazırlanan tanıtım filmi ile alıştırılacak ve bilgilendirilecek olan köylüler , çalışma ekiplerine hizmet satabilecekler .	satabilecekler	20	3
Acı patlıcanı kırağı çalmaz .	çalmaz	3	3
Timur , uyuşturucu kullanırken etrafımda olan biten her şeyin benimle ilgili olduğunu sanıyordum .	kullanırken	3	3
Kısık kısık gülüyor arada bir .	gülüyor	2	3
Onun yüzünün yarısı gülerken yarısı ağlardı .	ağlardı	5	3
Ben kızdığım insanla halleşmezsem imkanı yok rahatlamam .	rahatlamam	6	1
Bahse girebilirdim ki : i ) şu anda Kemal'in ortaya attığı fikirler bugün değilse bile yarın genel kabul görecektir .	girebilirdim	1	1
Mersedes'liden kazandım ...	kazandım	1	1
İstersen önce oraya gidelim .	gidelim	3	1
Bunların yararını da görmüştü .	görmüştü	3	3
Çünkü diğerleri koyun sütü kullanmıyor .	kullanmıyor	4	3
Haftaya iki ay doluyor Cumartesi beraber gidip alalım bence dedim babama .	alalım	7	1
Bu kadar yeter , dedi , inin de gidelim artık .	inin	6	2
Anne , ne olur , ses çıkartmadan çalayım , içine kazağımı tıkarım , diye yalvardı çocuk .	çalayım	7	1
Ama kaçtın ondan .	kaçtın	1	2
Melek üsteledi , Nerden buldun öyleyse ?	üsteledi	1	3
Geyiklerin alışık olmadıkları bu durum karşısındaki olgun davranışları , hatta kızak hattının tam ortasındaki düşüşlerimde dahi bana basmamaya özen göstermeleri çarpıcıydı ; sanki aramızda bir sıcaklık doğmuştu .	doğmuştu	26	3
Ben onu bir an önce eve getirmek istemiştim ama veteriner İki ay dolmadan annesinden ayırmayın .	istemiştim	7	1
Çok alışmıştım Kahve'ye belki vazgeçersin almaktan , annem de alıştığı için kalır diyordum kendi kendime .	alışmıştım	1	1
home lideri Recep Tayyip Erdoğan'ı taşıyan uçağın Pekin'e zorunlu iniş yapacağının duyulmasının ardından olayı Türkiye'ye bildirmek isteyen gazetecilerle işadamları arasında kısa süreli bir gerginlik yaşandı .	yaşandı	24	3
İçinde cinayet olmayan bir cinayet romanı yazmayı düşünüyordum .	düşünüyordum	7	1
Eğer ilk anda şarlamazsanız , size ciddi ciddi şunu öneriyorum : Aramızdan birini tesbit edelim .	edelim	14	1
Tayyip Erdoğan'ın yanında , onun yanlışlarına ortak olsaydım kesinlikle bu noktalarda bulunmazdım " sözünün Milliyet tarafından farklı yansıtıldığını öne sürdü .	olsaydım	7	1
Üçümüz birden girsek , dedi Miskoye , sen konuşsan .	konuşsan	8	2
Celal irkildi .	irkildi	1	3
Hangisini sen kazandın ki ? deyip dik dik bakmıştı yüzüme .	kazandın	2	2
Ben onu tanıyamadım , diyorum bıyıklarına kır düşmüş emekli sarhoşlara .	tanıyamadım	2	1
Durun ! Gitmeyin ! diye bağırdı Hacı Murat .	bağırdı	5	3
Onunla başlayalım .	başlayalım	1	1
Demin övüp duruyordun patlıcanı !	duruyordun	2	2
Hiç değilse kaliteli bir film bularak Hülya ve Selma'yı ayartabilirdim , o da olmadı .	ayartabilirdim	9	1
Çok isabet buyurdunuz .	buyurdunuz	2	2
Mutsuz ya da parçalanmış ailelerden gelen çocuklar - bir yudum mutluluk için - uyuşturucuyla ilk karşılaştıklarında ona dört elle sarılıyorlar .	sarılıyorlar	19	3
Ütüden anlamam .	anlamam	1	1
Teknik raporun deşifresi kısa süre içinde yaptırıldı .	yaptırıldı	6	3
Acıyorum , içim sızlıyor o kadar .	Acıyorum	0	1
Sonra da bu parka düştüm işte .	düştüm	4	1
Evlenseydiniz , bak nasıl üstüne titrer , çekip çevirirdi seni .	Evlenseydiniz	0	2
bırakın ben götüreyim .	götüreyim	2	1
Bakarız , dedi kadın , sonra sandalyesini biraz yan çevirdi , çalgıcıları görmek için .	çevirdi	9	3
Ağlamaya başladım .	başladım	1	1
Konduramadım , teşhirci değil .	Konduramadım	0	1
Sesinden tanıyordum kadınların mutsuzluğunu , sanki seslerinin özel bir kokusu oluyordu , kıyılmış tütün kıvamında , yanık gül yaprağı gibi kokuyordu sesleri , daha ilk notasında alıyordunuz kokusunu , bezgin , mesafeli ve biraz da düşmanca bir ses çıkarıyorlardı .	kokuyordu	20	3
ya da belki ben böyle bir vaziyeti görürüm diye , bilemiyorum ...	bilemiyorum	10	1
Kerem'in sözünü ettiği fotoğraf olmalıydı .	olmalıydı	4	3
Hakkı , Subay Evleri'nde oturuyordu .	oturuyordu	4	3
Siz istemediniz mi .	istemediniz	1	2
Allah rahmet eylesin , dediler , büyük adamdı .	dediler	4	3
Daha sonra bu avukatla birlikte bir dosya hazırlamalısınız .	hazırlamalısınız	7	2
Gece rüzgarından saçım başım dağıldı , dedi genç erkek ; elleriyle saçını düzeltmeye çalıştı .	dağıldı	4	3
Sloganla çarpıcı tanıtma yapmaya çalıştım .	çalıştım	4	1
Biz avucumuzda darı her yere ekiyoruz " dedi .	ekiyoruz	5	1
Muhaliflerin kışkırtmasıyla iç karışıklık çıkabilir .	çıkabilir	4	3
Yani , elektron - pozitron çiftinden iki gamma fotonu da üretebilirsiniz .	üretebilirsiniz	10	2
Kadının eski kocası olduğunu tahmin ettiğim ; kır saçlı , lacivert takım elbiseli bir adam havuzun yanında ayakta duruyor , dalgın dalgın önündeki suyu seyrediyordu .	seyrediyordu	24	3
Celal'le karşısına geçtik .	geçtik	2	1
Şoför gidiyor ama , anayollar kapatılmış .	kapatılmış	5	3
Sen geç yerine otur !	otur	3	2
O zaman , klasik şube vardı .	vardı	5	3
Ne kadar zorlarsam zorlayayım , her biri cılız birer siluet olarak gözlerimin önünden geçip kayboluyor .	zorlarsam	2	1
Hayır ! diye haykırdım .	haykırdım	3	1
İncecik bacaklarını birbirinin üzerine atmıştı , geniş koltuğun üzerinde rahatça oturuyordu .	oturuyordu	10	3
Doğrusu size yardım edebilmek isterdim , dedi Jul .	isterdim	4	1
Geçmek bilmedi sanki .	bilmedi	1	3
Ne kadar zengin olursan ol , diyor , seyirci olduktan sonra ( al işte Nurettin Bey ; sattı yedi , sattı yedi şimdi beş parasız , onun bunun eline bakıyor ) sıfırı tüketirsin .	bakıyor	29	3
Olur , alayım .	alayım	2	1
Dün gece de giremedim içeriye .	giremedim	3	1
Mahmut Beyi aramıştım .	aramıştım	2	1
Hadi biraz daha ileri gidelim .	gidelim	4	1
Nereye yönelsem arkamdan yetişiyordu , Sen kömür sobasını beceremezsin , yan odadan elektrikli zamazingoyu al , dolaptaki rakı çok soğuktur , en iyisi yattığım odanın aç kapısını , bak hemen kapının arkasında , kap gel ...	yetişiyordu	3	3
Gülce ile bir grup gidip fiyatları öğrenecek .	öğrenecek	6	3
Meraklanıyorum ama anneme hiçbir şey soramıyorum .	soramıyorum	5	1
Şimdi ikimiz yan yana koşar adım gecenin içinde ilerliyorduk .	ilerliyorduk	8	1
Ve fakat bu yeni gerçek , Kadıköy vapurunun karşıdan karşıya geçiş süresini hiçbir şekilde değiştirmedi .	değiştirmedi	14	3
Anneme sorsan hiç özlemediğini söyler ; ama bence herkes birbirini arıyor .	arıyor	10	3
Halbuki şu anda işyerlerinin sağladığı finansmanla bu iş yürüyor " dedi .	yürüyor	8	3
Sen donunu taşı , dedi Recep oğlana , kayığın üstünde unuttuğu donu gösterip .	taşı	2	2
İyi ki ordu sesini yükseltti , şimdi ne yapacaklar bakalım , deyip bekledik .	bekledik	12	1
- Bir yerden mi bakıp yazıyorsun .	yazıyorsun	5	2
Kapıyı itiyorum , zorluyorum , tam biraz açılır gibi oluyor , gene kapanıyor .	itiyorum	1	1
Siz bu işin üzerine fazla gitmeyin dedi .	gitmeyin	5	2
Seninle tartışmadan önce düşünmek isterim ben .	isterim	4	1
Ayhan , tüm gururu ve de onuru ve de mühendislik şuuru ile cevapladı .	cevapladı	12	3
Nesrin bize kızardı , falan , konu değişirdi .	kızardı	2	3
Ancak burada üretilen elektron - pozitron çifti hiç yoktan yaratılmamış , gama fotonundan üretilmiştir .	yaratılmamış	9	3
Dar yollarda koşarak giden Kerem'i yakaladım .	yakaladım	5	1
Ama denetimde bir reorganizasyon yapacağız .	yapacağız	4	1
Hiçbir şey anlatamadım , diye acıyla inledi .	inledi	6	3
Son iki saat , gitgide daralan bir ırmağın yatağında ilerledik .	ilerledik	9	1
Zeynep merak ve endişeyle kardeşine baktı : Orhan sen benden bir şeyler gizliyorsun ?	baktı	5	3
Sana gölgede yatma dedik sıpa .	dedik	3	1
Onu gözlemledim .	gözlemledim	1	1
Zeynep , onlara bir şekilde yardım etmeliyiz .	etmeliyiz	6	1
Eski Devlet Bakanı ve Başbakan Yardımcısı , Toplumcu Kurtuluş Partisi ( TKP ) Lefkoşa Milletvekili Mustafa Akıncı da , " Denktaş'ın , izlediği politikayla Kıbrıs'ı kalıcı taksime götürdüğünü " öne sürdü .	sürdü	30	3
Yutmadım ama , bu seferlik geç yerine otur , demek istiyordu .	istiyordu	10	3
Ayrıca , mülteci ve göçmenler için yapılacak harcamaların bazı kanunlardan istisna tutulması için Bakanlar Kurulu'na yetki verildi .	verildi	16	3
Hangi aday kazanırsa kazansın birlikte mücadeleyi sürdüreceklerini ifade eden Çelebi , ANAP'ı ayağa kaldırmak için hep birlikte çaba harcayacaklarını söyledi .	kazanırsa	2	3
Cevat , Nasıl yani ? diye sordu , Selahattin de , Rahip bulup günah mı çıkaralım ? diye .	çıkaralım	15	1
Kemal : Ama öbür yolu denemedin ki .	denemedin	5	2
Önüme uzun boylu biri gelmemesi için duaya başladım .	başladım	7	1
Dalgınlığıma geldi ya da üşendim , sapmadım ara yola ...	üşendim	4	1
Zeynep : Giyecek , yiyecek götürelim .	götürelim	5	1
Bense korkuyordum .	korkuyordum	1	1
O zamanlar toprağı bol olsun Sayın Tului Sönmez ile konuyu tartışmış ve ondan epey şey öğrenmiştim .	öğrenmiştim	15	1
Ben akşama vurulacak insanların o sırada neler yaptığını merak ederek cinayet haberlerini kesip dosyalarına koyardım ; arada ilginç bir cinayet çıkarsa , kimin , nerede , nasıl öldürdüğünü yanımda taşıdığım özel cinayet defterime kendim için kaydederdim .	kaydederdim	35	1
Onu görmek için , tüm zamanınızı o parkta geçirmeye başlarsınız .	başlarsınız	9	2
Sanırım dinsel anlatımlara benzemiyor .	benzemiyor	3	3
Şimdi hiçbir şeye yaramadıklarını düşünsem de , yaşayabilmek için yazmak ! Böylece , o beklemekle , aramakla , bütün bu zaman parçalarını dolduracak olan boşlukla ve sıkıntıyla dolu yaşam çizgimi belirledim sanıyorum .	sanıyorum	31	1
Ne diyecektik .	diyecektik	1	1
Üç kamp kurulacak .	kurulacak	2	3
içine alır , besler , büyütür , korur .	büyütür	5	3
Erkek öğretmen daha sert olur , kızlarla anlaşamaz diye düşünüyorum .	düşünüyorum	9	1
Bakın bu olabilir , dedi acıyla .	Bakın	0	2
bırakın ben götüreyim .	bırakın	0	2
Son olarak Diyarbakır'da maden ocakları ile ilgileniyordu .	ilgileniyordu	6	3
Çay yapıp içersin .	içersin	2	2
Ayakta alkışladık .	alkışladık	1	1
Söyleniyor kendi kendine .	Söyleniyor	0	3
Dönüp gülümsedi , bu işe bir son ver demek istiyordu .	ver	7	2
Kendimi katilin yerine koyardım , onun o son anda , tetiği tam çekerken neler hissettiğini anlamaya çalışırdım .	koyardım	3	1
Bence yeterince değil , hiç araştırmadan haber yapılmış ; okurlar yanıltılmıştır .	yapılmış	7	3
Bağcılar Cumhuriyet Başsavcılığı , Siirt'teki seçimin iptaliyle milletvekilliği düştükten sonra gıyabi tutuklama kararı vicahiye çevrilerek cezaevine konulan Fadıl Akgündüz hakkında , dörtyüzdoksandört - binikiyüzotuzbeş yıl arasında hapis cezası istemiyle fezleke hazırladı .	hazırladı	30	3
Drugstore'da alışveriş yapanların yüzde 91'i ambalajın önyüzünü , yüzde 42'si arkasını , yüzde 8'i de yan yüzlerini okuyor .	okuyor	17	3
Mali Barış'tan yararlanacakların hürriyeti bağlayıcı cezalarla ilgili düzenlemeler karşısında sorumlulukları devam etmeli .	etmeli	11	3
Onu dinlemeyip çıktım , kapıyı kapamadan , arkamdan geleceğini biliyordum .	çıktım	2	1
- Evet , meslektaş sayılırız .	sayılırız	4	1
Sorumluluk taşıyan insanlarımız var ; verdikleri sözün arkasında durdular ve eserler yarattılar .	yarattılar	11	3
İnsanları korkutup caydırma .	caydırma	2	2
Çarpıntısı geçince yazmayı sürdürdü .	sürdürdü	3	3
Hiçlikten geliyor , görünüyor , bu görünüşe gerçeklik adı veriliyor ; sonra da bir parabol gibi kayıp gidiyordu .	veriliyor	9	3
Aklından sil böyle düşünceleri .	sil	1	2
Kız sabah olunca rüyasını hatırlamış .	hatırlamış	4	3
Eğer makineme başka birisi oturmuşsa , kıskanırım .	kıskanırım	6	1
Yanıma Gaziantep Milletvekili Mustafa Doğan düştü .	düştü	5	3
Yine cevap vermesine fırsat bırakmadan , Bir erkek gibi değil yani , erkekler yalnızca sevişebilmek için yalan söyleyebilir , ama seviştikten sonra sevebilir , bundan sonra ise yalan söylemez .	söylemez	28	3
Niçin beni rahatsız ediyorsun ufaklık ? diye homurdanmış .	homurdanmış	7	3
Bul bir fıstık kan , at evine , rahatla , derdin bu senin .	Bul	0	2
İki adım yürümüştüm ki , Ceza ! diye seslendi .	yürümüştüm	2	1
Bu ara pek vaktim olmuyor .	olmuyor	4	3
Buna hiç şaşırmadım ben zaten herşeye razıydım .	şaşırmadım	2	1
İşi şakaya vurdum , iyi ya , dedim , Ceza'nın cezası da bitse keşke ; kimbilir daha kaç tanker şarap içmem gerekecek .	vurdum	2	1
Bul bir fıstık kan , at evine , rahatla , derdin bu senin .	rahatla	8	2
Buraya kadar geldiniz .	geldiniz	2	2
Ağustos güneşi epeyce yatmış olduğu halde etkisini sürdürüyordu .	sürdürüyordu	7	3
O söyledi : Atatürk , sakız leblebi severmiş .	severmiş	7	3
Çek dedik .	dedik	1	1
Nesrin bize kızardı , falan , konu değişirdi .	değişirdi	7	3
İyi ki o zamanlar Milliyetçi Cephe icat edilmemiş .	edilmemiş	7	3
Hazine tarafından dış borçlanmalar için verilebilecek garanti tutarı beşyüz milyon dolarla sınırlandırıldı .	sınırlandırıldı	11	3
Kahramanlarınızın , kadın - erkek ilişkilerine dönük yönlerinde de , kulaklarınıza inanamıyor ve duyduklarınızla düş kırıklıklarına duçar oluyorsunuz .	oluyorsunuz	17	2
Dün gece , insanlar hakkında bazen acele hüküm verdiğimi kavradım .	kavradım	9	1
Ben de sakız çiğnemekle ayıp arasında bir bağlantı kuramıyorum .	kuramıyorum	8	1
Çocuk sudan çıkmış , titriyordu .	titriyordu	4	3
Haftada beş saat Latince okurduk lise dersleri yanında .	okurduk	4	1
Kalmayız , dedi , koşa koşa gideriz , erikleri de senin heybene doldururuz .	doldururuz	12	1
Bu gerçeklik içinde bir nesne gibi bakabiliriz ona , öznel bir nesne , bir gerçeklik görünüşü var .	bakabiliriz	6	1
Şimdi bir süredir nereye baksam Tibet'in gözlerini görüyorum .	baksam	4	1
Rakı sofrasının öz evlatları yeşillikleri unutmayalım .	unutmayalım	5	1
Ailesinden kalan , harcasa harcasa bitiremeyeceği kadar çok parası olan bu kadınla tanışmamın öyküsü bile tek başına bir kitap konusu olabilir .	harcasa	3	3
Önce gözlerimin önüne Zübeyde'nin yeğenlerini getirmeye çalıştım .	çalıştım	6	1
Bir de tel kullanılmış fazladan .	kullanılmış	3	3
Çin'e tanıtım için altıyüz bin dolarlık bütçe ayırdıklarını söyleyen Akşit , " Çince seksen bin broşür bastırdık .	bastırdık	16	1
İşi şakaya vurdum , iyi ya , dedim , Ceza'nın cezası da bitse keşke ; kimbilir daha kaç tanker şarap içmem gerekecek .	gerekecek	21	3
Bir o , bir ben , hiç önceden kararlaştırmadan , kendiliğinden bir o , bir ben , olup bitenleri anlatmaya başladık ... dese diye , sabırsızlana sabırsızlana dinledim onu .	bitenleri	18	3
Sevilme peşinde koşan ve sevmeyi bilemeyen iki genç , yasal ve yasal olmayan uyuşturucuların etkisiyle sevme oyunu oynayacaklar ve minik bağımlı çocuklar dünyaya getirecekler .	getirecekler	23	3
O alanda doğruyu bulmuş olan bilim dalı daha fazla ilerleyemez ; son bilgiye ulaşmıştır , kapalıdır ; yeni bilgilere , olaylara , süreçlere yer yoktur .	ilerleyemez	9	3
Onlara uyarsan , büyük amcan gibi sokaklarda geberip gidersin .	uyarsan	1	2
Boğuluyorum , perişanım , dedi .	Boğuluyorum	0	1
Anlat , anlat ...	Anlat	0	2
Ancak çok deneyimli bir psikiyatrist ya da psikolog bu kabuğun altındaki duygusal boşluğu sezebilir ve pek çok aydının çok dokunaklı bulduğu bu zeka parıltılarından etkilenmeden tanısını koyabilir .	sezebilir	13	3
Meraklanıyorum ama anneme hiçbir şey soramıyorum .	Meraklanıyorum	0	1
Şura'nın yaşlı babası Abanasi , sobanın başında yarı erimiş geyik etini balta ve bıçakla tencereye girebilir parçalara ayırıyor .	ayırıyor	17	3
Sınıfta en arka sırada otururdu Ramiz .	otururdu	4	3
Annem , telefonda dedeme bir doğum günü partisi düzenlediklerini söyledi , yarın dönsem iyi olurmuş ...	dönsem	12	1
Dışarıda birisi ile konuşuyordum .	konuşuyordum	3	1
nasıl anlatacağımı biliyorum , basit : üzülüyordum .	üzülüyordum	6	1
Kaçtım , kurtuldum oradan , diyordunuz , dedi .	kurtuldum	2	1
Yerimden fırladım .	fırladım	1	1
Bir o , bir ben , hiç önceden kararlaştırmadan , kendiliğinden bir o , bir ben , olup bitenleri anlatmaya başladık ... dese diye , sabırsızlana sabırsızlana dinledim onu .	sabırsızlana	26	3
Sanki o konuştukça beynim daha bir kışkırtılıyor , o konuştukça anlattığı tarihlere denk düşen öbür görüntüler aynı tarihe paralel yürüyüp gidiyor .	gidiyor	20	3
Salonun kapısındaki görevliye davetiyelerimizi gösterdik ve içeri girdik .	gösterdik	4	1
Şimdi bu büyük korkunuzu yaşayacaksınız .	yaşayacaksınız	4	2
Sana gölgede yatma dedik sıpa .	yatma	2	2
Bazı geceler kulağımı kapısına dayar , dayak yerken attığı çığlıkları dinlerdim .	dinlerdim	10	1
Herhalde doğru yazdım .	yazdım	2	1
Esin'le Özer birbirlerine baktılar Özer Prensesi ben koruyacağım ! dedi , Esin de gülümseyerek odanın ortasında dönmeye başladı yeniden : Ben bir prensesim , ben bizim evin prensesiyim . diye mırıldanarak .	koruyacağım	7	1
Vaktin varsa görüşelim .	görüşelim	2	1
Erkekler Parkı'ndan geliyorum .	geliyorum	2	1
Onun bir çocuk olmadığını , takındığı çocuksu tavırların aslında bir maske olduğunu bir tek ben biliyordum .	biliyordum	15	1
Kaç kez denemişti ; iki türküden sonra balıkçılar , utangaç hallerinden sıyrılıp , tarihin değil , doğanın kendilerine verdiği niteliği yeğleyerek , masalarda oturan yabancı kadınlara göz süzmeye başlıyorlardı .	başlıyorlardı	28	3
Yürüyelim mi biraz , sakıncası yoksa ?	Yürüyelim	0	1
Ölmek istemiyordum .	istemiyordum	1	1
Ana Jet Üs Komutanlığı'na ait iki adet CASA - dört keşif uçağı , eğitim uçuşu için Erhaç Havaalanı'ndan kalkışlarından kısa bir süre sonra iddiaya göre havada çarpıştıktan sonra çakıldı .	çakıldı	28	3
Görürüz bakalım , yarın o arabayı kim silecek , diye tehditler savurarak uzaklaştı diğer siliciler .	silecek	7	3
Kabloda güç birliği yaptılar .	yaptılar	3	3
Aman sus , kapa almacı ...	sus	1	2
Ama düşündüm ...	düşündüm	1	1
Aaa , diyorlar , kimi elini saygıyla göğsüne bastırıyor kimi de , işte orada duracaksın anlamında ileri doğru uzatıyor ; büyük adamdı .	duracaksın	14	2
Dönüp baktı bana .	baktı	1	3
Ne ondan bahsedebildim , ne yaşadıklarımdan ...	bahsedebildim	2	1
Eşi , çocukları , kız kardeşi Makbule merakla bekliyorlardı bizi .	bekliyorlardı	8	3
Zeynep şaşkınlıkla kardeşine baktı , Sen ne dediğinin farkında mısın ?	baktı	3	3
Ancak onun beyninde olduğum sürede varoluyorum .	varoluyorum	5	1
Gençliğinde yazdıklarını tercih ederim .	ederim	3	1
Tahkikat doğru yapılmıştır , yeniden ortaya dökülmesi gerekmez şeklinde .	gerekmez	7	3
Yönetmelikle , sadece Lozan Antlaşması'na göre azınlık statüsü tanınan Rumlar , Ermeniler ve Yahudi cemaatlerine mülk edinme hakkı verilmesi tartışma yarattı .	yarattı	20	3
Bu da bölgedeki ticarete katkıda bulunacak .	bulunacak	5	3
Hiç kafasını yerden kaldırmıyor , hiçbir sempati belirtisi göstermiyordu .	kaldırmıyor	3	3
Gazetelerde kaçak çocuklar var ya aynen öyle yaparım .	yaparım	7	1
O mu seni terk etmiş saydın , sen mi onu .	saydın	5	2
Avrupa'da ilk beş şirket arasına girmek için büyüme planları yapan Hablemitoğlu'nun , satın alma olasılığıyla Almanya'daki iki şirketi izliyor .	izliyor	18	3
Ancak o zaman tüm belgelere ulaşabilecek ve bir yön bulabileceklerdi .	ulaşabilecek	5	3
Şöyle bir çevreme bakındım .	bakındım	3	1
Bu sorunuzu , garsonun bakışları , çevredekilerin gürültüleri yüzünden siz bile duyamadınız ; ama ben duydum .	duydum	15	1
Yeniden , Ellerini masanın üstüne koy , dedim , sesimde kölesine emreden bir efendinin sesi vardı ve o benim kölemdi .	vardı	15	3
Bu atılımın son dalgaları , sonuna ulaşmakta olduğumuz yüzyılın ilk yarısında , fizikte izafiyet ve kuantum teorileriyle , biyolojide genetik alanında gerçekleşmiştir .	ulaşmakta	6	3
Ayla : Böyle olur mu bilmiyorum .	bilmiyorum	5	1
Madem Suna istiyorsunuz , sırf Suna olsun diye az diretmemiştim , Söyledik ya , dedim , kulak asmadınız ki .	istiyorsunuz	2	2
Bir yere varamadık henüz , dedim .	varamadık	2	1
İşte o zaman , bu turistik yörenin olağanüstü tarihine merak duyanlar , buradaki insanların birkaç bin yıl önceki bir uygarlığın torunları olduğunu bilenler , tarihten bir sahnenin canlanmakta olduğunu sezerlerdi .	sezerlerdi	29	3
Ankara Temsilcisi Fikret Bila da , Arınç'ı arayarak , " Bir serzenişte bulunmuşsunuz , ama sözleriniz teypte böyle , isterseniz deşifresini okuyayım , dedi .	okuyayım	21	1
Unakıtan hükümeti , işçilerin yasal zorunluluktan kaynaklanan ve toplusözleşmeye konulması şartıyla ödenen iki ikramiyeden ikisini ödememe konusunu değerlendirecek .	değerlendirecek	17	3
Görmüyorlar mıydı : Girişten mağlup başlıyor , gelişme bölümünün ortasına bile sağ salim varamıyordum ; sonucu da felaket oluyordu bu durumda tabii .	varamıyordum	13	1
Birçok kez eroinden kurtulmak için yurtdışında değişik hastanelerde yatmış ama her seferinde kendisinden daha bencil olan eroine dönmüştü .	yatmış	8	3
Ya havayı katılaştırır , seferleri kaldırır , yollarını kaparlarsa .	katılaştırır	2	3
Nerdeydin ? diye bağırdı .	bağırdı	3	3
Nasıl anlatsam bilemiyorum , ama seviniyordum .	anlatsam	1	1
Oysa insan bir kez anımsamaya başlarsa gizlediklerini , beyninin içine giren kurt onu kemirir , yeni korkular , daha büyük , daha dehşetli korkular , en olmayacak düşünceler , günahlar , suçlar yaratır .	kemirir	13	3
Hiç çalışmamış .	çalışmamış	1	3
Artık birbirimizin sinyallerini çok iyi tanıyoruz .	tanıyoruz	5	1
Şimdi ; gidip günah çıkarsam - bakın , üstelik burada benim bir günahım yok aslında - , rahatlamaz mıyım ? Sana normal davranır hale gelmez miyim ? Belki .	rahatlamaz	17	3
Mahmut'un aklını başından alıverdi .	alıverdi	3	3
İzleyiciler bu bakışın farkında olmasalar da , Recep kahrolur , darbukasına hırsla vurmaya , tempoyu hızlandırıp Saffet'i zorlamaya başlardı .	zorlamaya	17	3
Birden esti aklıma .	esti	1	3
Tombul dizleri , masanın altından Mahmut'un dizlerine yapışmıştı .	yapışmıştı	7	3
O da gömlek cebinden bir paket sigara çıkardı .	çıkardı	7	3
Eğer sözünü ettiğiniz şey virtual parçacıklarsa ( aşağıdaki satırlarda Verschuur'dan yapılan alıntıya bakınız ) durum hala inandırıcı olmaktan uzak demektir .	bakınız	12	2
Melek bana yardım edersen çocuklarla başa çıkarım , dedi üsteleyerek Memo .	edersen	3	2
Sözgelimi , Gümrük Birliği gibi bir yolculuğa çıkarken , çevresindeki duvarları yıkmaya çalışınca , eski eşyayla yenilerin bakışması gibi , hüzünlü ve çarpıcı yalnızlıklar yaşayan bir ülkeyi ...	çıkarken	7	3
Bu dosyayı Milli Savunma Bakanlığı'na iletmelisiniz .	iletmelisiniz	5	2
Artık rehberimden utandığım için bağırıp kervanı durdurmasını istemiyor , hızlı planjonlarla , kızağa yeniden tırmanıyordum .	tırmanıyordum	14	1
Kasabanın doğal mağaralarında mayalanmaya bırakılıyor .	bırakılıyor	4	3
İçimi çektim , sesim tahminimden daha dertli çıktı .	çektim	1	1
Kapıyı itiyorum , zorluyorum , tam biraz açılır gibi oluyor , gene kapanıyor .	açılır	7	3
Madem Suna istiyorsunuz , sırf Suna olsun diye az diretmemiştim , Söyledik ya , dedim , kulak asmadınız ki .	Söyledik	11	1
Çünkü anlattığı şeyler , bir dindarın anlattıklarına benzemiyor .	benzemiyor	7	3
Gittikleri mekanlar , seçtikleri giysiler , arabalar sürekli değişiyor .	değişiyor	8	3
Şimdi ; gidip günah çıkarsam - bakın , üstelik burada benim bir günahım yok aslında - , rahatlamaz mıyım ? Sana normal davranır hale gelmez miyim ? Belki .	çıkarsam	4	1
Görmüyorlar mıydı : Girişten mağlup başlıyor , gelişme bölümünün ortasına bile sağ salim varamıyordum ; sonucu da felaket oluyordu bu durumda tabii .	başlıyor	5	3
Kimseye zararı yoktu ha , yanlış anlama , bütün derdi kendinleydi .	derdi	9	3
Buralarda bekledim .	bekledim	1	1
O zaman damda , ineklerle yatsın .	yatsın	5	3
O ara kapı yeniden tıkladı .	tıkladı	4	3
PKK Ateş Açtı başlığı ise içerde kullanılmış .	Açtı	2	3
Bak , kapı zorlanıyor .	Bak	0	2
Onların karşısında olmak yerine onların yerinde olmayı hayal edersiniz .	edersiniz	8	2
Yine cevap vermesine fırsat bırakmadan , Bir erkek gibi değil yani , erkekler yalnızca sevişebilmek için yalan söyleyebilir , ama seviştikten sonra sevebilir , bundan sonra ise yalan söylemez .	sevebilir	22	3
Kalkıp ardına kadar açtım pencereyi .	açtım	3	1
Gecenin hangi saatinde eve dönsem de , yakındaki açık gece mağazasından yiyecek birşeyler alabilirdim .	alabilirdim	13	1
Birkaç haftaya kadar geyikler doğurmaya başlayacak .	başlayacak	5	3
Her iki olgu da , bilim için yeni bir başlangıçtan çok , bir dönemin kapanışına işaret etmektedir .	etmektedir	16	3
Ama , hafiften titreyen sesi öyle etkiliydi ki , kendimi tutamadım , ağlamaya başladım .	başladım	13	1
Aşk öyküsü yazmayalım mı yani .	yazmayalım	2	1
Beni görür görmez kendini yere atıp göbeğini bir açışı var ki sevdirmek için özellikle şişiriyor sanırsın .	şişiriyor	14	3
Öğleden sonra kanallar kıyısında dolaşırken , sanki uzun yıllardır buradaymışım , hep de kanallar kıyısında dolaşıp durmakla vakit tüketirmişim gibi geliyordu bana .	dolaşırken	4	3
Bizde , günahı işledin mi bitti .	işledin	3	2
Onların ölümünden habersiz olduğunu zannediyorum .	zannediyorum	4	1
Hey , Ömer , kalk oğlum , geç kalmışız .	kalmışız	8	1
Korkunç bir şey bu ! diye mırıldandım .	mırıldandım	6	1
sekizonikibindokuzyuzdoksansekiz tarihli bildirisinde şöyle bir düşünce deneyi yapılıyor : Politzer'in otobüs kazası örneğini ele alalım .	alalım	14	1
Bu saman sarısı saçların , takma kirpiklerin ve kelebek kanadı gibi boyalı dudaklarınla daha önce de arkadan vermiş olmalısın mı demişti .	olmalısın	18	2
Başka güne alırız doğum günümü .	alırız	2	1
Hiç durmadan bu konuyu gizli gizli tartışıyoruz .	tartışıyoruz	6	1
Oturun yerinize .	Oturun	0	2
Epey iş yaptılar .	yaptılar	2	3
Bırakın gideyim , ne olur bırakın .	bırakın	5	2
Evet , dayanamıyorum .	dayanamıyorum	2	1
Doğum günü yapmakta asıl amacım Tibet'i bize davet etmek .	yapmakta	2	3
Annem onun için özel yemek kabı , özel el bezi - daha doğrusu ağız silme bezi - özel örtü , özel paspas gibi tüm eşyaları hazırlamıştı .	hazırlamıştı	25	3
O da , benim gibi , bir kente geldi mi , kentin en canlı yerini seçer , kahvelerin de tiryakisidir .	seçer	15	3
Ya reddedilirsem ! korkusu var ya .	reddedilirsem	1	1
Hemen Esin'le Özen'in odasına koştum .	koştum	4	1
Orhan ümitle ona baktı , Sen bir şeyler düşünüyorsun ?	düşünüyorsun	8	2
Hayır , önce yemeğini bitir , diye üsteledi anne .	bitir	4	2
Harbiyeli Gidin , evinize yatın diye talimat verdi .	yatın	4	2
Olaydan bir yıl sonra ben davayı üstlendim .	üstlendim	6	1
Yeniden , Ellerini masanın üstüne koy , dedim , sesimde kölesine emreden bir efendinin sesi vardı ve o benim kölemdi .	koy	5	2
Esra ile bu aralar medyada görünmeni istemiyorum " dedi .	istemiyorum	6	1
Uzak uzak ülkelerden birinde fakir bir anne ve kızı yaşarmış .	yaşarmış	9	3
Pencereden tramvayların son durağı olan , caddenin ötesinde , soldaki , ağaçlıklı küçük alana bakıyordum .	bakıyordum	14	1
Elim ayağım tutmuyor .	tutmuyor	2	3
Kemal Ulusu oğlunun naaşını almak için Diyarbakır'a giderken , anne İlkin Hanım ile diğer oğlu Atilla ilaçlarla yatıştırılmaya çalışıldı .	çalışıldı	18	3
Ağustos güneşi epeyce yatmış olduğu halde etkisini sürdürüyordu .	yatmış	3	3
Lan tamam , sizi de kurtaracağım , var mı öyle kalleşlik .	kurtaracağım	5	1
Yanına annesini de alan Şıkel , " Herkes beni zaten yanlış tanıyor , ne desem boş , inanılmaz derecede bunaldım .	bunaldım	19	1
Nusret Senem : Bu başvurumuzda birkaç noktaya değinmişlerdi .	değinmişlerdi	7	3
İyi ki ordu sesini yükseltti , şimdi ne yapacaklar bakalım , deyip bekledik .	yükseltti	4	3
Bir süre kepenkleri inmiş dükkanların önünden yürüdüm , gece zamanı karanlık ve sessiz duran şadırvana bir göz attım .	attım	17	1
Neyse , nasıl buldun öykümün girişini .	buldun	3	2
Anlatırım tabii Ayhan .	Anlatırım	0	1
Tuhaf bir kadın , diye mırıldandım .	mırıldandım	5	1
Dönmüyor da zaten ...	Dönmüyor	0	3
yüzyılda bilimin gelişimini genel hatlarıyla betimlemek istersek , şu iki görüngüyü temel almamız gerekir : Birincisi , bu yüzyıl Bilimsel Devrim'in son atılımlarının gerçekleştiği yüzyıl olmuştur .	istersek	6	1
Türkiye , geçmişle ve geçmişin korkularıyla bağlarını kopardı gidiyor .	kopardı	7	3
Bu savların hepsinin yanlışlığı ( fallacies ) gösterilmiş , idealist dizgeler yadsınmıştır ( refuted ) .	yadsınmıştır	11	3
Kasketini yan iliştirirdi kafasına .	iliştirirdi	2	3
Onun güzelliğine duyduğum hayranlıkla başlayan ilişki daha sonra kesin bir cinsel bağımlılığa dönüşmüş ve hep öyle sürmüştü , hatta bir ara artık onun güzelliğini bile fark edemez hale gelmiştim .	gelmiştim	28	1
Elinde kağıtlar tutuyordu .	tutuyordu	2	3
Tabii aralarındaki sınıf ve kültür uçurumunu bildiğinden övgülerinde onun kadar ileri gitmiyordu .	gitmiyordu	11	3
Matematikte doğruluğunu kendi içinde barındıran hipotezlerden yola çıkarak bir teoremi kanıtlarsınız ve dosya kapanır .	kapanır	13	3
Kim dertli onda alır soluğu ...	alır	3	3
Kullanıyor ama kafa bulamıyordum .	Kullanıyor	0	3
Keskin toplum eleştirisi , esprili ve zeki özeleştiri , bir çeşit kara mizah , bilgi düzeylerinin çok üstünde bir entelektüel performans onlarla tanışanları şaşırtır ve çarpar .	tanışanları	22	3
Annem bendeki bu ani değişime çok sevindi .	sevindi	6	3
Kafamı dinleyeceğim " dedi .	dinleyeceğim	1	1
Bu raporlardan birer fotokopi aldılar .	aldılar	4	3
Ben ona hep Kahve ismini yakıştırdım .	yakıştırdım	5	1
Oraya nasıl ulaşılacağını , nereden gidileceğini hiç bilmiyorum .	bilmiyorum	7	1
Beş dakika sonra sor , o da tek kelimesini söyleyemiyor .	sor	3	2
Ne yalan söyleyeyim biz babamı özlüyoruz .	özlüyoruz	5	1
Durumu çok iyi özetliyordu .	özetliyordu	3	3
o Köye dönüş projesi başlatılacak .	başlatılacak	4	3
O parktan kurtulana pek rastlamadım .	rastlamadım	4	1
Daha sonra babanızın , sizinle yalnızken öleceğinden korktunuz .	korktunuz	7	2
En yakınlarınızdan başlayarak , tanıdıklarınız , tanımadıklarınız , milyonlarca , milyarlarca insan size bu koridoru hazırladı .	hazırladı	15	3
Hiç tartışmayalım .	tartışmayalım	1	1
Sırtına geçirdiği kürk yeleğiyle kemendini aldı sadece , dışarı çıkarken .	çıkarken	9	3
Birçok kez eroinden kurtulmak için yurtdışında değişik hastanelerde yatmış ama her seferinde kendisinden daha bencil olan eroine dönmüştü .	dönmüştü	17	3
Keşke duymasaydım .	duymasaydım	1	1
İşe yarar mı ki ...	yarar	1	3
Bu hükümet neden dağıldı .	dağıldı	3	3
Gül Abla ! dedim Sen benim bu makinemi anlamıyorsun !	anlamıyorsun	8	2
Gözleri kor gibi yanıyordu .	yanıyordu	3	3
Tamamen yaşayanları korumaya yönelik bir rapor hazırlandı , dedi .	hazırlandı	6	3
Yazın mektubu .	Yazın	0	2
Halbuki arada gidip günah çıkardın mı , kendini bir miktar yırtmış hissediyorsun , temizlenmiş hissediyorsun , aynı haltı yiyeceğini bilsen bile bir güvencen var .	hissediyorsun	11	2
Konuşmayı biraz uzatır , işlerin yoğunluğundan filan söz edersiniz .	edersiniz	8	2
- Artık olmaz , onu kıramam .	kıramam	5	1
Çünkü uyarıldık ...	uyarıldık	1	1
Uçağın tam inişi sırasında yolculardan birinin cep telefonu açtığının tespit edildiğini bildiren Yıldırım , " Cep telefonunun açılmaması gerekirdi .	gerekirdi	18	3
Sınıf atlamıştır yani .	atlamıştır	1	3
Öteki kadını nereden duydunuz .	duydunuz	3	2
Sahnede dans edenler sanki insan değil de tüy gibi geldi bana .	edenler	2	3
Hayır , yalnızca iki kez gittim .	gittim	5	1
Ne kaybedersiniz ?	kaybedersiniz	1	2
Girdi içeriye .	Girdi	0	3
Çocuk , başını bir yandan diğer yana çevirmekle yetindi .	yetindi	8	3
Küçük bir dalga , ayaklarını örtüp , geri çekilirken ayağının altındaki kumların da denize doğru kaydığını fark etti .	çekilirken	8	3
Kapı hafifçe aralandı .	aralandı	2	3
Kentten iki mikrofonla , gerekli öteki aygıtları getirtmişti .	getirtmişti	7	3
Şimdi bir süredir nereye baksam Tibet'in gözlerini görüyorum .	görüyorum	7	1
Ona , Seni çok sevdiğim için seninle olamazdım , sana duyduğum sevgi çok korkuttu beni , diyemezdim .	diyemezdim	16	1
İşte , rakı bunları temizliyor .	temizliyor	4	3
Konuştun mu onunla .	Konuştun	0	2
Bak işte bu fotoğrafta yan yana duruyorlar .	duruyorlar	6	3
Duvarlarla konuşmaktan bıktım .	bıktım	2	1
Kocacığım ! El sallardım işine giderken balkondan ...	sallardım	3	1
Kız aklımdan çıkıp gitmişti .	gitmişti	3	3
Ama onun bir an görünebileceği bir yerden ayrı kalmaya dayanamıyorsun .	dayanamıyorsun	9	2
Hadi lan , dedi Katana , sopa yiyeceğiz Naci Beyden .	yiyeceğiz	7	1
Ancak özellikle evrenbilim ve parçacık fiziğinde bugün bu ilke ne yazık ki çiğnenmiş , bu iki bilim dalı metafizik öğelerle , hayaletlerle dolmuştur .	çiğnenmiş	12	3
Ben yavrumdan nasıl ayrılırım ? Onu nerelere gönderirim ? diye adamın ayaklarına kapanmış zavallı kadın .	ayrılırım	3	1
Giremiyorum , dedi .	Giremiyorum	0	1
Zaten kendileri duygularını tanımadıklarını söylüyorlar .	söylüyorlar	4	3
Kendini o halinle yeni doğmuş bebeklere benzetmiştin .	benzetmiştin	6	2
Sesler değişse bile duyguların seslere kattığı tonlamalar değişmez , ne kadar saklamak isteseler de bunu beceremezler , bir köpekten kokularını saklayamayacakları gibi benden de seslerini saklayamazlardı .	beceremezler	15	3
Ömür Uzatma Kıraathanesi'nin kapısı güm güm vuruldu .	vuruldu	6	3
Gene gittin oraya .	gittin	1	2
Bir mektup getirmiştim Mahmut Beye .	getirmiştim	2	1
O alanda doğruyu bulmuş olan bilim dalı daha fazla ilerleyemez ; son bilgiye ulaşmıştır , kapalıdır ; yeni bilgilere , olaylara , süreçlere yer yoktur .	ulaşmıştır	13	3
Ağabey , ben taşıyayım , diye atıldı çocuk darbukaya doğru .	taşıyayım	3	1
Bir tane de ben ekleyeyim : Yiyebilir miyim ? diye bayılmış .	ekleyeyim	4	1
Yine sinirlendim .	sinirlendim	1	1
Ama bir türlü , Ben de yıllar önce sizin gibi diye başlayan bir cümle kuramazsınız .	kuramazsınız	14	2
Kimse zorlamadı beni , üç ölü zamanlar alanını ben terkedip geldim bu eve .	zorlamadı	1	3
Bila , " Sizinle ilgili izlenimlerimi yazacağım , isterseniz , bu söylediklerinizi de yazayım , ancak teypteki ifadenizi de yazmak zorundayım " karşılığını verdi .	yazacağım	6	1
Hayatın böyle ya da başka türlü olmasını ne ya da kim sağlıyor , bu iyi mi kötü mü .	sağlıyor	11	3
Notlar tuttular .	tuttular	1	3
Saime Sezginler aylarca çalışmış , kardeşinin arkadaşlarıyla saatlerce konuşmuş , kitaplar tercüme etmiş , ettirmiş ve bir uzmanın sahip olacağı teknik bilgiyi öğrenmişti .	öğrenmişti	22	3
Yanına annesini de alan Şıkel , " Herkes beni zaten yanlış tanıyor , ne desem boş , inanılmaz derecede bunaldım .	desem	14	1
Her ne kadar Amatem'de görev yapan psikiyatrist Ali Babaoğlu bu zeka pırıltılarını eleştirse de : ...	eleştirse	12	3
Bağımlılar her şeyin en iyisini bildiklerinden kendileri için birinden yardım istemek egolarına ters düşer .	düşer	13	3
Uyandım ve sabah rolü bana verdiklerine dair telefon alacağımı bilerek tekrar uyudum .	Uyandım	0	1
Gelin , birlikte girelim , dedim .	Gelin	0	2
Kapıya yürüdüm , açtım .	açtım	3	1
Uzun zamandır mı gidersiniz oraya .	gidersiniz	3	2
Muammer elinde viski şişesiyle belirmişti .	belirmişti	4	3
Çıkar şu donunu , çıkar da pantolonunu öyle giy .	çıkar	4	2
Arkaya taranmış .	taranmış	1	3
Madem Suna istiyorsunuz , sırf Suna olsun diye az diretmemiştim , Söyledik ya , dedim , kulak asmadınız ki .	diretmemiştim	9	1
Kuzey Halkları Enstitüsü'nün kurulması ise Evenlerin sorunlarının bilimsel platformlara taşınmasını sağladı .	sağladı	10	3
yüz bin dolarlık Rusya'ya yaptığı ihracatın alıcısı bulunamıyor .	bulunamıyor	7	3
Nasıl çıkabilirim oraya .	çıkabilirim	1	1
yedi yabancıyı ölüm Türkiye'de yakaladı .	yakaladı	4	3
Bütün komşular ağız birliği etmişçesine , Bizde iş çok ama sana verecek para yok , diye yanıtlamışlar .	yanıtlamışlar	16	3
Bunu yapamayacağını biliyordun .	biliyordun	2	2
Geceleri kakıp , konuklara sunulacak rakı , votka , viski ne bulursam ; birer ikişer yudum kafama dikmeden , bölük pörçük uykumu bile sürdüremiyorum .	sürdüremiyorum	23	1
Kamu personeline ödenecek aylık ve ücretlerin belirlenmesinde esas alınacak katsayılar ile sözleşme tavan ücretlerini belirleme yetkisi tasarıya konmayarak bu konu Bakanlar Kurulu'na bırakıldı .	bırakıldı	22	3
Adam , argoyla karışık da olsa - ki bu , sınıfını gizlemediğini gösterdiğinden bir erdem sayılabilirdi - Necmi Bey'i aratmayan güzel cümleler kurabiliyordu .	kurabiliyordu	22	3
babasına yemek götürdük , dedi Katana duyulur duyulmaz bir sesle .	götürdük	2	1
Kendimi katilin yerine koyardım , onun o son anda , tetiği tam çekerken neler hissettiğini anlamaya çalışırdım .	çalışırdım	16	1
Onlara uyarsan , büyük amcan gibi sokaklarda geberip gidersin .	gidersin	8	2
Ailenin görev ( ! ) anlayışıyla yaptığı tüm fedakarlıklar da içten bir sarılmanın , doğal bir sevginin yerini tutmuyor .	tutmuyor	18	3
Nereden biliyorsunuz ? diye sordu .	biliyorsunuz	1	2
Vurun yumruğu soğana .	Vurun	0	2
Nereye yönelsem arkamdan yetişiyordu , Sen kömür sobasını beceremezsin , yan odadan elektrikli zamazingoyu al , dolaptaki rakı çok soğuktur , en iyisi yattığım odanın aç kapısını , bak hemen kapının arkasında , kap gel ...	al	14	2
Bu süreç de , bir ürünün somut ve öznel niteliklerinden sıyrılıp , kendisine soyut ve nesnel bir nicelik yüklenmesiyle gerçekleştirilir .	gerçekleştirilir	19	3
Onunla konuyu enine boyuna görüştük .	görüştük	4	1
Kemal , Günah çıkarma esprisine , bir çeşit yakıt alma gibi , yıkanıp temizlenme gibi , yüzeysel , hatta bazen köklü bir tamirat gibi yaklaşmalıyız , bunu kastediyorum , dedi .	yaklaşmalıyız	24	1
O da , sizin onu sevdiğiniz kadar , sizi seviyorsa , yarısını kesip size verir ( Karım böyle yapar ) .	seviyorsa	9	3
Ne kadar zengin olursan ol , diyor , seyirci olduktan sonra ( al işte Nurettin Bey ; sattı yedi , sattı yedi şimdi beş parasız , onun bunun eline bakıyor ) sıfırı tüketirsin .	ol	4	2
Bir an önce dönmeliyim oraya .	dönmeliyim	3	1
Mahmut Beyi arıyordum ...	arıyordum	2	1
Kendini niye karıştırıyordu şimdi !	karıştırıyordu	2	3
Ben götürür veririm .	veririm	2	1
Kurtulamamışım demek , diye mırıldandı .	Kurtulamamışım	0	1
Seben Gölü'ne ulaşmıştık artık .	ulaşmıştık	2	1
Yok abi , beyin meyin her şey bitmişti .	bitmişti	7	3
Ne duruyorsun ...	duruyorsun	1	2
Siz mektubu hazırlayın , ben götürür veririm , dedim .	hazırlayın	2	2
birlikte , barın yakınına kadar sokulabildik .	sokulabildik	5	1
Biz çıkaramadık .	çıkaramadık	1	1
Terk ettiği bir aşığıyla konuşmuştum bir akşamüstü .	konuşmuştum	4	1
Bir o , bir ben , hiç önceden kararlaştırmadan , kendiliğinden bir o , bir ben , olup bitenleri anlatmaya başladık ... dese diye , sabırsızlana sabırsızlana dinledim onu .	dinledim	27	1
Doldurduğu bardağın yarısı boşaldı ağzına .	boşaldı	3	3
Bilimsel bilgiler de teknoloji aracılığıyla bir üretici güce dönüşür .	dönüşür	8	3
Olayda pilot hatası olduğuna inanmıyorum " dedi .	inanmıyorum	4	1
Ama bir ihtimal var , değil mi ? Sırf sana olan kızgınlığımı birine anlatmam halinde üzerimden bir yük kalkar , gerilimim azalır , sana daha hoşgörülü yaklaşabilirim , daha bağışlayıcı olabilirim .	kalkar	18	3
Gözünü kapa Melek !	kapa	1	2
Müşteri neyi sever ?	sever	2	3
Orada olmalıyım şimdi .	olmalıyım	1	1
Evlilik aşkı desek ! ..	desek	2	1
Erten'e , ne de bana ulaşmış değil .	ulaşmış	5	3
sekizonikibindokuzyuzdoksansekiz tarihli bildirisinde şöyle bir düşünce deneyi yapılıyor : Politzer'in otobüs kazası örneğini ele alalım .	yapılıyor	7	3
Dışarının parlak güneş ışığını yansıtarak çoğaltan beyazından bir anda karanlığın içinde bulduk kendimizi .	bulduk	11	1
Madem Suna istiyorsunuz , sırf Suna olsun diye az diretmemiştim , Söyledik ya , dedim , kulak asmadınız ki .	asmadınız	17	2
Kitabı çıktığı dönemde bazı yayın organları Underhill'i " Perakendecilerin Sherlock Holmes'ü " diye tanımladılar .	tanımladılar	13	3
Ne kadar zorlarsam zorlayayım , her biri cılız birer siluet olarak gözlerimin önünden geçip kayboluyor .	kayboluyor	14	3
Annemin bahsettiği sürpriz yoksa üvey baba olmasın ?	olmasın	6	3
O başrolde olmalıdır .	olmalıdır	2	3
Buz kesiyorum gitgide , aldırdığı yok .	kesiyorum	1	1
İstersen biraz daha kalsın , biraz daha annesi baksın ona .	İstersen	0	2
Yola düştük .	düştük	1	1
Bu ilişkiyi bitirelim , böyle yürütemeyeceğim , dedi .	yürütemeyeceğim	5	1
Kahveleri bende içelim .	içelim	2	1
Bırak zırlasın .	Bırak	0	2
Anneme yeni sınıf arkadaşlarımı çağırmak istediğimi söyledim .	söyledim	6	1
Bira , o kadar , kaldıramıyorum sert içkileri .	kaldıramıyorum	5	1
Evet , buraya bir şey anlatmak için gelmiştim , dedi Kerem .	gelmiştim	7	1
Ayhan ise grubu yurtseverce kurmuş .	kurmuş	4	3
Beni sınava mı çekiyorsunuz ?	çekiyorsunuz	3	2
paralel bağlanabiliyor ; ama bir trafik kazasında insanların paralel bağlanabileceğini ilk kez duyuyorum .	duyuyorum	12	1
Artırım otuz gün önceden bildirilecek .	bildirilecek	4	3
Berkeley ve yazarlarının savlarının , benzerliğine demeyeceğim , aynılığına dikkat ediniz !	demeyeceğim	6	1
Önce Tanrı'nın ve Bey'in kulu olmadığımızı öğrendik ; sonra dünyayı değiştirebileceğimizi .	öğrendik	6	1
İşte geldik gidiyoruz , dedim , sana bir şey sormak istiyorum .	gidiyoruz	2	1
Yanakları hafifçe pembeleşmişti .	pembeleşmişti	2	3
O üç geceyi unutamaz .	unutamaz	3	3
Tanışmadınız , görsen şaşarsın , çok zeki , anlayışlı ama ...	Tanışmadınız	0	2
Oğlunuza aldığınız o kitabın arkasını okurken , kendinize , gerçek korkularınızı sordunuz , anımsayın .	anımsayın	13	2
Onlara hiç anlamıyorlarmış gibi gelirken birden en can alıcı soruyu , nasıl olup da bulup sorabilirler .	gelirken	4	3
Daha önce nerede çalışıyordunuz .	çalışıyordunuz	3	2
Durun ! Gitmeyin ! diye bağırdı Hacı Murat .	Durun	0	2
Allah Allah , bu da nereden çıktı ? diye sormadık , şaşırmadık .	sormadık	9	1
El kaldırmadık .	kaldırmadık	1	1
Sanıyorum , zaman aşımına uğradığı için benim itiraz sürem de geçmişti .	Sanıyorum	0	1
Elini , rengi atmış kirli beyaz , uzun donunun içine soktu , orasına burasına yapışmış kumları temizledi .	soktu	10	3
İyi ki kedi olalı bir fare tuttun , dedi Melek .	tuttun	6	2
Babasının ıslığının ne amaçla çalındığını anası da , Ramiz de , kardeşleri de , öküzler de , sarı köpek de bilirdi .	bilirdi	20	3
Maastricht Anlaşması değerleri esas alınarak çok yıllık bütçe uygulansın .	uygulansın	8	3
Şimdi ben başlıyorum .	başlıyorum	2	1
ÇALIŞTIĞI şirketi suçlayan Ciguli şunları söyledi : " İkinci kaset için çağırdılar .	çağırdılar	11	3
Kazancını yatırıma dönüştürdü .	dönüştürdü	2	3
Hadi hadi söyletme beni ..	söyletme	2	2
Bakalım daha nelere sokacak Grek burnunu ...	sokacak	3	3
Sadece donuk bakışlarla etrafını süzüyor .	süzüyor	4	3
Nüfuslarının azalmasına paralel , kültürleri de dönüşüme uğradı .	uğradı	7	3
Yağma yok diye diklendi Memo , hepiniz havanızı alırsınız .	alırsınız	8	2
Kapıyı kapattı .	kapattı	1	3
Aman Allahım yüz bin lira ! diye hayretle bağırdı Melek .	bağırdı	8	3
Bahçesi de , ağacı , çiçeği , tavuğuyla , ona göre biçim alıyordu .	alıyordu	12	3
Kemal devam etti : Ben bunun , hem tek tek hepimiz için çok rahatlatıcı olacağından eminim hem de birbirimize yaklaşımımızı , ilişkilerimizi olumlu etkileyecektir , eminim .	etkileyecektir	23	3
Çoğulu çoğul yapmayı anlamam .	anlamam	3	1
Hem bir şey kırk kere söylenirse olurmuş .	olurmuş	6	3
Soğuk iklimi severler .	severler	2	3
Tamam oğlum , haydi çık sudan , diye yineledi Recep , çocuğun pantolonuna doğru giderken .	yineledi	8	3
Şaka bir yana yakıştık birbirimize .	yakıştık	3	1
Ben de onu dövdüm .	dövdüm	3	1
Bu arada , aynı bilim dünyasından bu konuda aykırı sesler çıkaran birkaç bilim insanına kulak verelim .	verelim	15	1
Gideceğiz , dedim .	Gideceğiz	0	1
Ben annemden izin koparabilmek için onca dil dökmüş , onca gün sabırla beklemiştim .	beklemiştim	12	1
Ben de yeni kadınlar buluyordum , daha önceleri tanıştığım , bir - iki günlüğüne birlikte olduğum kadınları arayıp onlarla ilişkilerimi sıkılaştırıyordum .	buluyordum	4	1
karma fonlar : Bu kategorideki fonlar ikibiniki yılını yüzde onbir'lik ortalama getiri ile kapattılar .	kapattılar	13	3
O barışın temelleri yıllar önce Norveç'te , ormandaki bir dağ evinde atılmıştı .	atılmıştı	11	3
Avukat Nusret Senem : Olayın böyle üstünkörü kapatılmaya çalışıldığı konusunda , askeri makamlarda genel bir mutabakat olduğu anlaşılıyordu .	anlaşılıyordu	17	3
Mersedes buldum mu bırakmam abi .	bırakmam	3	1
Bir tane de ben ekleyeyim : Yiyebilir miyim ? diye bayılmış .	Yiyebilir	6	3
Bilimde bu tür mucizevi elatmalara yer olmadığı gibi , varlığı , Tanrı'ya inananlar için tehlike yaratır : diferansiyel eşitliklerinizdeki matematiksel tekillikleri daha iyi bir modelle ortadan kaldırdığınızda Tanrınız da tekillikle birlikte ortadan kalkar .	yaratır	15	3
Onu tanıyanlar Bakırköy'de en yatmayacak insan diye tanımlıyor .	tanıyanlar	1	3
Soruları sürekli tekrarladığınızı fark etseler bile utangaç ifadelerini bir kenara bırakıp sinirlenmez , sıkıldıklarını belli etmezler .	sinirlenmez	11	3
Kimseye zararı yoktu ha , yanlış anlama , bütün derdi kendinleydi .	anlama	6	2
Havaalanından yaklaşık otuz kişiyi aramış , herkesle şakalaşıp vedalaşmış .	vedalaşmış	8	3
Madem iş istiyorsun gir içeri , demiş .	gir	3	2
Düşünüyor mu Mebrure'yi .	Düşünüyor	0	3
Fotokopi çekme yasağı kondu .	kondu	3	3
Leblebiyle kız isteyen adama da servi boylu kız verecek değiller ya .	değiller	9	3
Nereden biliyorsun .	biliyorsun	1	2
Az kalsın kaçırıyordum ağzımdan .	kaçırıyordum	2	1
Anlarsın ya ...	Anlarsın	0	2
Dalgınlığıma geldi ya da üşendim , sapmadım ara yola ...	sapmadım	6	1
Tehlikeyi bilirim .	bilirim	1	1
Nasıl anlatsam bilemiyorum , ama seviniyordum .	seviniyordum	5	1
İşte o zaman , bu turistik yörenin olağanüstü tarihine merak duyanlar , buradaki insanların birkaç bin yıl önceki bir uygarlığın torunları olduğunu bilenler , tarihten bir sahnenin canlanmakta olduğunu sezerlerdi .	canlanmakta	27	3
Diz çök karşısında , okşa saçlarını , özür dile , bağış dile , ne dilersen dile it herif , ağla hatta elinden geliyorsa ...	okşa	4	2
Yan gözle inceleniyorum bir yandan .	inceleniyorum	2	1
Oraya saptık .	saptık	1	1
Eee , sen tarlaya yemek götürdün , biz ne yapacağız .	götürdün	5	2
Kemal'in sözlerini tekrarlayarak , sevgilinin uyurkenki beş ayrı halini yirmisekizer , Hülya'nın gözkapaklarına çöküp toplanan buğunun renklerini otuzbeşer defa gözlerimin önünden geçirdikten sonra , uyuyamayacağımı anlayıp doğruldum .	doğruldum	26	1
Okulun açılış törenine İstanbul Emniyet Müdürü Hasan Özdemir , İstanbul Milli Eğitim Müdürü Ömer Balıbey ve Yaşar Nuri Öztürk de katıldı .	katıldı	20	3
Kaçtım , kurtuldum oradan , diyordunuz , dedi .	Kaçtım	0	1
Giremiyorum içeriye .	Giremiyorum	0	1
Göklere çıkarıyordun .	çıkarıyordun	1	2
Arınç da " Kastımın Erbakan'la Erdoğan'ı aynı kefeye koymak olmadığını da yazarsanız sevinirim " karşılığını verdi .	sevinirim	12	1
Balerinler nasıl bu kadar hafif olabiliyor .	olabiliyor	5	3
Tamam usta ya , girmiyorum , bir işeyip geleceğim , diye yanıtladı çocuk .	girmiyorum	4	1
Konuşmayı biraz uzatır , işlerin yoğunluğundan filan söz edersiniz .	uzatır	2	3
Artık kimse kel kafalı bir fahişe ile sevişmek istemezdi .	istemezdi	8	3
Özellikle de günümüz teknolojisinin ilerleme hızını düşününce birçok insan faktörünün geri plana itildiğini gözlemleyebiliriz .	gözlemleyebiliriz	13	1
Alev için bugün yaşamak ya da ölmek bir anlam ifade etmiyor .	etmiyor	10	3
Yerleştir yerleştirme , devşir devşirme sınavları falan filan yok ...	Yerleştir	0	2
Onlar krizmalarıyla yaşıyorlar .	yaşıyorlar	2	3
Memo elindeki yüz bin liraya şaşkınlıkla bakıyordu .	bakıyordu	6	3
Çantasını karıştırıyor , bir kalem arıyordu .	arıyordu	5	3
Çek şu albümü , şunu şunu , hani gidip gelip karıştırdığın , bilmem mi sanırsın , hah işte o albümü ver bakayım .	sanırsın	14	2
Diyor ki Uçak buzlanmadan düşmüştür .	düşmüştür	4	3
Aşağıdaki karanlık vadiyi seyrettim bir süre .	seyrettim	3	1
Anlatılmalı bir gün .	Anlatılmalı	0	3
Bu heyecana nasıl dayanabilirim . diye mırıldandı Celal .	dayanabilirim	3	1
Ya orayı bir daha bulamazsam ?	bulamazsam	4	1
Beyan edenden az vergi alınsın .	edenden	1	3
Çünkü savcılığın raporu çıkmıştı .	çıkmıştı	3	3
Diyarbakır'a gitmeden önce annesine , " Merak etme , bu küçük uçakla son görevim " dedi .	etme	7	2
Ne kaybedersin .	kaybedersin	1	2
Kristof Kolomb'un , öyle insanlık adına keşiflere çıkmış bir seyyah değil , yeni zenginlikler peşinde koşan ve tayfasına kan kusturan zalim bir kaptan olduğunu fark ediyorsunuz .	ediyorsunuz	25	2
KOBİ'ler finansal yeniden yapılandırma programından yararlansın , Halkbank KOBİ bankası olsun .	yararlansın	5	3
Bununla neden sözedilir ?	sözedilir	2	3
Şimdi birini oradan oraya alarak tayin edeceksiniz , öbürünü açığa alacaksınız , öbürünü sorgulayacaksınız .	alacaksınız	10	2
Çok sevineceğim .	sevineceğim	1	1
Oğlunuza aldığınız o kitabın arkasını okurken , kendinize , gerçek korkularınızı sordunuz , anımsayın .	sordunuz	11	2
Örneğin , annelerin bebek arabalarını rahatça sürecek genişlikte koridorlar olmaması 20'li 30'lu yaşlarındaki kadın müşteri kitlesinin bu mağazayı tercih etmemesine neden olacaktır .	olacaktır	21	3
Kırılacak kızım yavaş .	Kırılacak	0	3
Ancak , bu amaçla yapılacak düzenlemelerde aksi ispat edilmedikçe mükellef beyanının doğru olarak kabul edileceği şeklinde ve benzeri hükümlere yer verilmemeli .	verilmemeli	20	3
Yani , diyem ...	diyem	2	1
Ben de sahneye çıktım " dedi .	çıktım	3	1
Bazen ondan nefret ediyorum , dedim .	ediyorum	3	1
Cami avlusundan koşarak çıktılar .	çıktılar	3	3
Meyhaneye gelip masaya oturunca kravatını çözer , ince ucunu elinin sol bileğine bağlar , kalın ucunu ensesinden aşırtıp sağ eliyle tutardı .	bağlar	12	3
Geceyi böylece geçirebilecektik .	geçirebilecektik	2	1
Buna sorun çözme diye bakamazsınız .	bakamazsınız	4	2
Bu beni çok üzdü .	üzdü	3	3
Taşhan'ın kapısını itip içeriye girdim .	girdim	4	1
Uyandım ve sabah rolü bana verdiklerine dair telefon alacağımı bilerek tekrar uyudum .	uyudum	11	1
Hakkı'nın evine geldik .	geldik	2	1
Bu hanım , son beş yıldır eroin kullanıyor .	kullanıyor	7	3
Üç ocaklı demirci dükkanı deyip geçme , fayton imalatından zengin bile olmuşlar .	geçme	5	2
Unutmadım onu .	Unutmadım	0	1
Sonra sen de bir kertenkele oluverip o göbekli , geniş burunlu , kırmızı yüzlü adamın öptüğü , ellerini gezdirdiği ince beyaz derinden ve hatta ruhundan kurtulmak istemiştin .	istemiştin	26	2
Rastgele bir odanın kapısını vurdum .	vurdum	4	1
Aptallığıma doymayayım .	doymayayım	1	1
Kız içeri girmedi .	girmedi	2	3
Ağır , babacan bir gülüşle gülüyorlar , önlerine eğdikleri başlarını ( saygıdan tabii ) ağır ağır sallıyorlar : Yazık , çok yazık , diyorlar .	gülüyorlar	5	3
Yutmadım ama , bu seferlik geç yerine otur , demek istiyordu .	Yutmadım	0	1
Tramvaylar geçiyor , biraz önce dinmiş olan yağmurun ıslattığı kaldırımları , ara sıra elektrik tellerinde yol açtıkları kıvılcımlanmalar aydınlatıyordu .	aydınlatıyordu	18	3
Derhal müzik koymalıyım , beni alıp götürsün , şuradan Lou Reed kasetini .	koymalıyım	2	1
Yani ... günah çıkaralım işte .	çıkaralım	3	1
Taşhan'ın kapısını itip bu yarı karanlık dünyanın içine girdim .	girdim	8	1
İncecik bacaklarını birbirinin üzerine atmıştı , geniş koltuğun üzerinde rahatça oturuyordu .	atmıştı	4	3
Çok alışmıştım Kahve'ye belki vazgeçersin almaktan , annem de alıştığı için kalır diyordum kendi kendime .	vazgeçersin	4	2
Hostes abla kardeşinin ölümüne inanamadı .	inanamadı	4	3
Bunlar , kuşkusuz insanlığın kolektif yaratıcılığının eşsiz örneklerini oluşturmakta ve bilimin geleceğine olan güvenimizi ayakta tutmaktadır .	oluşturmakta	8	3
Harun Yahya ve yazarlarının herbiri sanki reenkarnasyona uğramış Berkeley ! İlgili okura , Bertrand Russell'ın Türkçe'ye de çevrilmiş olan The History of Western Philosophy adlı kitabının Berkeley bölümünü okumalarını salık veririm .	veririm	30	1
Tümüyle meşru yollarla yüksek rakımlı tepeye çıkmış adamı şişman ve ahaliyi pişman eyliyorlar .	eyliyorlar	12	3
Her bakımdan ikna etmek konusunda titiz davranırsanız , karlılığınız garanti altına girer .	davranırsanız	6	2
Bir köpeğin bütün kokuları birbirinden ayırdedip insanların duygularını kokularından anlamaları gibi kadınların sesini tanırdım , her tonunu bilirdim , yalnızca kulaklarımla değil bütün vücudumla duyardım onların sesini .	bilirdim	17	1
Saçlarını boyattı , modelini değiştirdi .	boyattı	1	3
Oktay Sarıtop nazik bir dille kaleme aldığı eleştirisinde " Türkiye'nin en iyi gazetesi olan Milliyet'i her zaman takdir ettiğimi bilmenizi isterim " diyor .	isterim	20	1
Timur , Artık kendi yalnızlığımda tutunacak dal kalmamıştı , ruhsal çöküntümün önüne geçemiyordum , madde bana başlangıçta ihtiyacım olan şeyleri verdi : deliğimi kapattı , eksikliğimi giderdi .	kalmamıştı	7	3
Çek şu albümü , şunu şunu , hani gidip gelip karıştırdığın , bilmem mi sanırsın , hah işte o albümü ver bakayım .	ver	20	2
Aman sus , kapa almacı ...	kapa	3	2
Arsel , daha önce Koç Holding'de Enerji ve Maden Grubu Başkanlığı yapmış , Dünya Kamhi Birliği Başkan Yardımcılığı görevine seçilmişti .	seçilmişti	19	3
Halbuki arada gidip günah çıkardın mı , kendini bir miktar yırtmış hissediyorsun , temizlenmiş hissediyorsun , aynı haltı yiyeceğini bilsen bile bir güvencen var .	temizlenmiş	13	3
Görgü tanıklarının ifadesine göre havada çarpışan uçaklar , İnkaya mevkiindeki ormanlık alanda ateş topu halinde düştü .	düştü	15	3
Ben , içeriye giremiyorum , dedi .	giremiyorum	3	1
Beni görür görmez kendini yere atıp göbeğini bir açışı var ki sevdirmek için özellikle şişiriyor sanırsın .	görür	1	3
Nereye yönelsem arkamdan yetişiyordu , Sen kömür sobasını beceremezsin , yan odadan elektrikli zamazingoyu al , dolaptaki rakı çok soğuktur , en iyisi yattığım odanın aç kapısını , bak hemen kapının arkasında , kap gel ...	beceremezsin	8	2
Sinirim tuttu , ben de başladım gülmeye .	başladım	5	1
Ağbime güvenirim .	güvenirim	1	1
Biz , geçmişte ne varsa güzel olan , yanımıza aldık , kalbimize gömdük .	aldık	9	1
Oğlan pantolonunu , gömleğini giyinmiş , donunu kayığın üstüne sermişti .	giyinmiş	4	3
EN SON ANNESİNİ ARADI .	ARADI	3	3
, Bonham'a gidemem , Hülya'nın yanında kalmalıyım ; ya da arkasında , cephe gerisinde ...	gidemem	2	1
Giremeyecek , dedim umutsuzlukla .	Giremeyecek	0	3
Hepimiz dahi bellemişiz onu .	bellemişiz	2	1
Baksanıza hoş kadın , şık kadın .	Baksanıza	0	2
Sofra kurulmuş .	kurulmuş	1	3
Orhan kuşkuyla : Ağzımdan laf almaya çalışıyorsun değil mi ? Sonra da anneme babama yetiştir , dedi sinirli sinirli .	çalışıyorsun	6	2
Aileye damat olarak pancar da girdi .	girdi	5	3
Kimbilir güneşte ne güzel görünürlerdi .	görünürlerdi	4	3
Öğretmenler derlerdi ki .	derlerdi	1	3
Ben şimdi içeriye giriyorum .	giriyorum	3	1
Neredeyse kasıklarına çekildi , sımsıkı etekliği .	çekildi	2	3
Hem hiç merak etme benim annem ona herkesten iyi bakar .	bakar	9	3
Benim her zaman konuştuğum adam , yanıbaşımda masasında oturuyordu .	oturuyordu	8	3
Böylece , insanlarla beraber kal ve yalnızlığı unut .	kal	4	2
Tamam usta ya , girmiyorum , bir işeyip geleceğim , diye yanıtladı çocuk .	geleceğim	8	1
Dövizde yapılan analizlerde yıl sonuna kadar ciddi bir sıçrama beklenmiyor .	beklenmiyor	9	3
Kardeşimin kurtulacağını biliyordum " diye konuştu .	biliyordum	2	1
Bu savların hepsinin yanlışlığı ( fallacies ) gösterilmiş , idealist dizgeler yadsınmıştır ( refuted ) .	gösterilmiş	7	3
Norveç'ten ithal edilen Destecioğlu cihazının maliyeti üçyüzelli bin doları ( yaklaşık beşyüzelli milyar lira ) buluyor .	buluyor	15	3
Eee , sen tarlaya yemek götürdün , biz ne yapacağız .	yapacağız	9	1
Ben uzak bir yolculuğa çıkıyordum .	çıkıyordum	4	1
Rehberim Yura'nın ne kadar haklı olduğunu düşündüm .	düşündüm	6	1
Bir an için sokaktaki köpekler nasıl hayatta kalıyorlar diye düşündüm .	düşündüm	9	1
Heyecanlanmıştım birden .	Heyecanlanmıştım	0	1
Evlerine sığınmıştım .	sığınmıştım	1	1
Üniversiteyi bitirdikten sonra ilk girdiği şirketin müdürü delikanlıya yakın ilgi gösteriyor , baba ilgisi açlığı çeken delikanlı , çocuksu bir ben merkezcilikle müdürün ilgisini bir baba ilgisi olarak algılıyordu : Değerini bilen bir baba .	gösteriyor	10	3
Özellikle biyoloji ve jeolojinin insanın ve dünyanın kökenine ilişkin bulguları , evrenin merkezindeki durağan dünyasının sıradan bir gezegen olmasına yeni yeni kendini alıştırmaya başlamış olan Kilise'nin elinde kalan son önemli alana - Yaratılış Efsanesine - cepheden darbeler indirmiştir .	indirmiştir	37	3
Ve de yapabiliyorlar .	yapabiliyorlar	2	3
Bahse girebilirdim ki : i ) şu anda Kemal'in ortaya attığı fikirler bugün değilse bile yarın genel kabul görecektir .	görecektir	18	3
Öbür bardağı da doldurdu , döke saça .	saça	6	3
Ürünlerinizin konuşulduğu bir atmosfer yaratabiliyorsanız , ürün kendi kendini satacaktır .	yaratabiliyorsanız	4	2
Çeşitli bilim dallarının görece özerk içsel gelişmeleri sonucu , bu atılım dalgalar halinde ilerlemiştir .	ilerlemiştir	13	3
Orhan kuşkuyla : Ağzımdan laf almaya çalışıyorsun değil mi ? Sonra da anneme babama yetiştir , dedi sinirli sinirli .	yetiştir	14	2
Hazine garantileri nedeniyle doğabilecek ödemeler için de üçyüzyirmialtı trilyon liralık ödenek ayrıldı .	ayrıldı	11	3
Babam , Ali'nin annesi Nihan teyzeden kağıt kalem isteyerek yapmamız gerekenleri tüm ayrıntılarıyla yazdı .	gerekenleri	10	3
Boşalmasını sabırsızlıkla beklerim .	beklerim	2	1
Bilim tarihinde , çok uzun ve zahmetli bir kolektif sürecin ürünü olan mantığı saymazsak , iki önemli teorik atılım dönemi vardır .	saymazsak	13	1
Yerimden fırladım , kapıyı hızla açıp Ömür Uzatma Kıraathanesi'nden dışarıya çıktım .	fırladım	1	1
Sinek uçsa vızıltısı duyulacaktı .	uçsa	1	3
Gitmeliyim , kalkıp gitmeliyim .	Gitmeliyim	0	1
Ayhan bitirmiş İTÜ'yü , tamir edemiyor bir basit ütüyü ...	edemiyor	5	3
Hemen onunla evlenmek istemiş .	istemiş	3	3
Dil bükmüş , bize uydurmuşuz .	bükmüş	1	3
Ne zaman tepem attı , kaptım bekletilen tepsiyi masadan ?	kaptım	5	1
Haberin yanındaki analizde KADEK sözcüğü geçiyor .	geçiyor	5	3
Ara sıra temizliği aksatsa da kendisine hep siz diyen bir kızcağız .	aksatsa	3	3
Açma , sakın açma , izleniyorum .	izleniyorum	5	1
Eğer ilk anda şarlamazsanız , size ciddi ciddi şunu öneriyorum : Aramızdan birini tesbit edelim .	şarlamazsanız	3	2
Hıçkırıklarımın arasında söylediklerini dinlemeye başladım .	başladım	4	1
Kardeşinin eşiyle birlikte Bismil Oğuzlar Köyü İlköğretim Okulu'nda görev yaptığını anlatan ağabey Mehmet Karamutlu , " Gerçeği ona nasıl söyleriz bilmiyorum .	söyleriz	19	1
Onu dinlemeyip çıktım , kapıyı kapamadan , arkamdan geleceğini biliyordum .	biliyordum	9	1
O gün çaya karıştırılacak miktarı çarçabuk sağıp , soğuktan üşüyen ellerini sıvazlayarak içeri koştular .	koştular	13	3
Kendimi katilin yerine koyardım , onun o son anda , tetiği tam çekerken neler hissettiğini anlamaya çalışırdım .	çekerken	12	3
Bu kuruluşların ciro büyüklüklerine göre yaklaşık elli trilyonluk bir gelir sağlanacak .	sağlanacak	10	3
Kendi yaşam alanını güvence altında gören Papalık , bunun verdiği rahatlıkla , yakın geçmişte Darwin'le bile barışmakta bir beis görmemiştir .	barışmakta	16	3
Sürünür şimdi .	Sürünür	0	3
Bozduğunu o düzeltemez artık , lafını ilk defa o gün orada ettim .	düzeltemez	2	3
Lange Leidsewards Straat'da Kierkegaard okuyan kıza , kendisiyle yeniden görüşmekten sevinç duyacağımı söylemiş , ertesi gün öğleye doğru , onun oturduğu sokağın başındaki o güzel , iki katlı kahveye çağırmıştım onu .	çağırmıştım	29	1
Naci Bey hala sınıfa bakıyordu .	bakıyordu	4	3
Bir adama Kabak diyin .	diyin	3	2
Yüzümün değişiminden ürkmüş gibi .	ürkmüş	2	3
Güneş batarken ve eylül rüzgarları kuruyan otların üstünde belli belirsiz gezinirken buluşmalıydınız .	gezinirken	10	3
Kendimi uyuşturucularla adım adım öldürürken bile ölmekten korkuyordum .	öldürürken	4	3
Sanki bir şeye üzülmüş gibiydi .	üzülmüş	3	3
Sarı mı , beyaz mı ? Yazmamışlar .	Yazmamışlar	6	3
Bir kuramı oluştururken kullanılan ilk ilkelerin , hipotezlerin gözlemlerden türetilmiş olması istenen bir durumdur .	oluştururken	2	3
Albümleri geriye doğru çevirdim .	çevirdim	3	1
Boyalarının altından kırmızı yamaları görünen büyük bir gemi Karadeniz'e doğru gidiyordu .	gidiyordu	10	3
Hatta aramızda birbirimize söz de verdik , ölmek var dönmek yok diye .	verdik	5	1
Bu sorunuzu , garsonun bakışları , çevredekilerin gürültüleri yüzünden siz bile duyamadınız ; ama ben duydum .	duyamadınız	11	2
Başlığı bulunca rahatladım , krizden kurtuldum ...	kurtuldum	5	1
Beni ziyan ettin , diyor , ziyan ettin .	ettin	2	2
Onlar çalışıyorlar ...	çalışıyorlar	1	3
Bu ülkelerde , günümüzde , bilim ve din , eşit bir muameleye tabi tutulmakta , her ikisinden de kendi alanları içinde kalmaları istenmektedir .	istenmektedir	22	3
Ötesini sen anlat .	anlat	2	2
Oturduğum yerden çevreme göz gezdiriyordum .	gezdiriyordum	4	1
Hem sonra annem buna sürpriz diyebilir mi ?	diyebilir	5	3
Bir o , bir ben , hiç önceden kararlaştırmadan , kendiliğinden bir o , bir ben , olup bitenleri anlatmaya başladık ... dese diye , sabırsızlana sabırsızlana dinledim onu .	dese	22	3
İnanmıyor musunuz .	İnanmıyor	0	3
Yani ben imkansız olduğuna hükmetmişim bir kere .	hükmetmişim	4	1
üç ) Çok yemiş , bayılmış .	bayılmış	5	3
' Grup Başkanvekilleri Salih Kapusuz , Eyüp Fatsa ve CHP Grup Başkanvekili Haluk Koç ile Büyükelçilik Konutu'nda dün sabah kahvaltıda bir araya gelen ' , milletvekilleri ile Irak'ı görüştü .	görüştü	28	3
Oğlunun ölüm haberini Antalya'da alan baba Kemal Ulusu , dostlarının gönderdiği özel uçakla İstanbul'a döndü .	döndü	14	3
Biz kızlar Gülce'nin önerisine oy vereceğiz .	vereceğiz	5	1
Kursanız bile sonunu çok başka bir biçimde bitirirsiniz .	Kursanız	0	2
Diz çök karşısında , okşa saçlarını , özür dile , bağış dile , ne dilersen dile it herif , ağla hatta elinden geliyorsa ...	dile	15	2
Kliniğe yatırma önerilerine karşı çıkamadım sonunda .	çıkamadım	4	1
Allahım üveylerden beni koru .	koru	3	2
Muammer çayları getirmişti .	getirmişti	2	3
Hakkı'nın kız kardeşi benim adımı Karanlıkta Gelen Adam koydu bu olaydan sonra .	koydu	8	3
Poynter direktörü Bob Steele , " Bence ' biz intihar haberi hiç vermiyoruz ' düşüncesi de açıkça sorgulanmalı " diyor .	sorgulanmalı	17	3
Gerçekten de bu bin yılda önce evrenin merkezinde değil , Güneş etrafında dönen sıradan bir gezegende olduğumuzu öğrendik ; sonra sıradan bir canlı türü olduğumuzu .	öğrendik	17	1
Irak savaşının Kasım Aralık - ayından önce olmayacağı varsayımıyla borsada bir hareketlilik beklenebilir .	beklenebilir	12	3
Orada şöyle ,bir şey dikkatimi çekti .	çekti	5	3
Sezer'in , " erteleme değil , af " diye nitelendirdiği yasayı veto etmesi , AB uyum yasaları ile öne açılan Erdoğan'ı etkilemeyecek .	etkilemeyecek	21	3
( Bakınız : Emre Aköz , Perihan Mağden , Cihan Demirci .	Bakınız	1	2
Ama yolu bilmiyorum .	bilmiyorum	2	1
Az kalsın kaçırıyordum ağzımdan .	kalsın	1	3
Beni köşeye sıkıştırırlarsa çıkaracaktım ortaya .	çıkaracaktım	3	1
Kısmetsiz adam Leblebi bile diyemeden pazar bitermiş .	bitermiş	6	3
Sessizce onayladık .	onayladık	1	1
Ama önce , Ben buraya taşınıyorum artık , seninle birlikte yaşamaya karar verdim , diye söze başladım .	başladım	16	1
Ter içinde uyandım .	uyandım	2	1
Ben anlamıyorum .	anlamıyorum	1	1
Kerem çayına iki şeker atıp yavaşça karıştırdı .	karıştırdı	6	3
Nicedir elinden düşürmediği kitabını kapattı , kaldığı sayfaya kağıt sıkıştırmayı unutmayarak .	kapattı	4	3
İNANOĞLU , bu konuda " Evet , böyle şeyler söyledim ama artık işlerim yoluna girdi .	söyledim	9	1
Üstlerdeki ince kazaklar , hırkalar , ayaklardaki rahatsız ayakkabılar çıkarıldı .	çıkarıldı	9	3
Ona , Seni çok sevdiğim için seninle olamazdım , sana duyduğum sevgi çok korkuttu beni , diyemezdim .	korkuttu	13	3
Sonra , patron olduğunu anımsatmak için , soymakta olduğu patatesleri bırakıp , bir çay doldurdu , masalardan birine geçti , sabahtan beri bakıla bakıla paçavra gibi olmuş gazeteyi eline aldı .	soymakta	7	3
İyice kollarız , dedi Katana , yoksa dalarız .	kollarız	1	1
Geçmiş ola .	Geçmiş	0	3
Daha otuz ikisinde , acımamışlar ...	acımamışlar	4	3
Ama sen saçlarını evde boyayan kadınlara benzemiyordun .	benzemiyordun	6	2
Bu sözler , Batılı yiyecek ve tedavi kültürünün Evenlere ulaşmadan önceki durumu özetliyordu aslında .	özetliyordu	12	3
Benim , açın kapıyı .	açın	2	2
Eline geçirdiği kişiyi kendi kölesi yapmayı çok iyi bilir ; eroin tacirleri gibi ...	bilir	8	3
Genelkurmay Başkanı ve dört komutanın da bu konuda söz alarak görüş birliğini ifade ettikleri öğrenildi .	öğrenildi	14	3
Şöyle anlatayım : SEVİNİYORDUM .	SEVİNİYORDUM	3	1
Beni niye sevdiğini hiçbir zaman anlayamamıştım , ama beni niye terk ettiğini biliyordum , bütün kadınlar beni hep aynı şekilde ve aynı nedenden terk ederlerdi zaten .	biliyordum	12	1
Bu atılım , insanlığı çağdaş bilim kavramının eşiğine ulaştırmış , ama Roma İmparatorluğu ve onu izleyen feodal dönemle kesintiye uğramıştır .	ulaştırmış	8	3
Elde kalan o güzelim göbeği de özenle soyun .	soyun	7	2
Naci Bey , şu sayfadan şu sayfaya kadar okuyun , demiş .	okuyun	8	2
Bu nedenle Güzide'yi dizide oynattım " yorumunu yaptı .	oynattım	4	1
Anne iyice sağlığına kavuşunca bir de ben gidip bu adamı göreyim diye düşünmüş ve kızın peşine takılıp şehrin ucundaki eve gitmiş .	düşünmüş	12	3
Kağıt mendil , şeker , çikolata aldın .	aldın	6	2
Annem hep korkmuş , çocuklarımdan biri büyük amcalarına benzer diye ; ama şimdi bakıyormuş da , benim yolum yol değilmiş .	bakıyormuş	13	3
Girme suya oğlum , gidiyoruz .	Girme	0	2
Bu yola başvurun , dedi .	başvurun	2	2
Yaşlandıkça tuhaflaşıyorsun .	tuhaflaşıyorsun	1	2
Birincisi pervane buzlanmasından bahsediyordu .	bahsediyordu	3	3
Biliyor musunuz ?	Biliyor	0	3
Annemle babam benimle ilgilenmiyor demek istemiyorum ; ama ben onlarla daha fazla birlikte olmak istiyorum .	ilgilenmiyor	3	3
Kazadaki adam komaya girse , hepsi komaya girecektir .	girecektir	7	3
Boşuna üzülüyorsun istediğin zaman gelip Kahve'yi görebilirsin .	üzülüyorsun	1	2
Yurdundan kopup gelen aile , büyük kentin kendine uygun bir yerinde , önce başını sokacak bir göz oda ve çevrelediği alanın odadan kopuk bir yerinde helasını yapıyordu .	yapıyordu	26	3
Bilmiyorum , dedim .	Bilmiyorum	0	1
Hele o zamanlar moda olan sizler sözcüğüne ben hala şaşarım .	şaşarım	9	1
Bir mücadeleyi izliyoruz işte .	izliyoruz	2	1
NA'nın on iki basamağında , tıpkı bir bebek gibi duygularıyla tanışmayı öğreniyorlar .	öğreniyorlar	11	3
Ben onu bir an önce eve getirmek istemiştim ama veteriner İki ay dolmadan annesinden ayırmayın .	ayırmayın	14	2
Biz partide Atila Ağbiyi çok severiz .	severiz	5	1
Bütün gece rahatça izledim .	izledim	3	1
Çünkü örneğin ses ile de boşluklar mekanlaşabilir .	mekanlaşabilir	6	3
O sırada , akşam gezintisine çıkmış gençlerin selamlarına karşılık verilir .	verilir	9	3
Ama eğer olacaksa sürecin uzaması ekonomik açıdan Türkiye için ciddi dezavantajlar da doğuruyor .	olacaksa	2	3
Ona yetişebilmek için peşinden koşuyordum .	koşuyordum	4	1
Ama orada bulundum .	bulundum	2	1
Nereye yönelsem arkamdan yetişiyordu , Sen kömür sobasını beceremezsin , yan odadan elektrikli zamazingoyu al , dolaptaki rakı çok soğuktur , en iyisi yattığım odanın aç kapısını , bak hemen kapının arkasında , kap gel ...	kap	33	2
Ben ağabeyleri olarak onların rahatını sağlamalı , onları zorluklardan kurtarmalıydım .	kurtarmalıydım	9	1
Dünyaya yayabilsek .	yayabilsek	1	1
Cumartesileri tenis kursuna yazılmak istediğimi anneme söyledim .	söyledim	6	1
Öyle bir felsefe ki bu , kendi içinde bir çelişkiyi taşıyor ; varoluşla yaşamanın birbirine hiç uygun düşmeyeceğini , bu ikisi arasındaki çelişkiyi anlatıyor .	taşıyor	10	3
Aydınlık gazetesinde konuştuğu muhabirler , Biz size yardımcı olalım , dediler .	dediler	10	3
Bu gece geç kaldınız , dedi adam .	kaldınız	3	2
Sonra Kuzey Avrupa'ya yayıldılar .	yayıldılar	3	3
Bin yıl kadar sonra da Moğol kavimlerinin saldırısı ile bugün yaşadıkları bölgeleri yurt edindiler .	edindiler	13	3
Baktı olmayacak , beni yanağımdan öptü , saçlarımı okşadı .	olmayacak	1	3
Bakın soluk soluğa kaldınız .	Bakın	0	2
Hep kıyasladılar bizi .	kıyasladılar	1	3
Bu hafta okurlardan gelen umumi talep üzerine Kırmızı Türkler'in temel özelliklerini madde madde sıralıyoruz : .	sıralıyoruz	13	1
Esra Özmen'in Muazzez Ersoy'u konuk ettiği programına katılan Ciguli , " Binnaz satış rekorları kırdı ama bana bir faydası olmadı .	kırdı	14	3
Israr etseydin bize , daha güzel bir isim önerseydin ! ..	önerseydin	8	2
Fakat bu muammayı sonunda çözdüm .	çözdüm	4	1
O sırada , iş dönüşü yorgun ve dalgın adımlarla geçip gidenlerden bir ikisinin gözleri takılır kenardakilere .	takılır	14	3
Siz , sonsuza dek yürüyeceksiniz .	yürüyeceksiniz	4	2
Ben bir hizmet insanıyım , söylerim , söylediğimin arkasından giderim ve bana neye mal olursa olsun ben bununla iftihar ederim .	söylerim	5	1
Koray , bilim etkinliğinin tarih içindeki serüvenini geleceğe de uzanarak analiz ederken dosyamıza güzel bir giriş de yapıyor .	yapıyor	17	3
Üç ocaklı demirci dükkanı deyip geçme , fayton imalatından zengin bile olmuşlar .	olmuşlar	11	3
Ben kalemimi düşürdüm .	düşürdüm	2	1
Buyur etmişler .	Buyur	0	2
Niçin geldim buraya bilmiyorum .	bilmiyorum	3	1
the , " Irak'ta muhtemel bir çatışmanın Türkiye ekonomisi üzerindeki etkilerini görüşeceğiz .	görüşeceğiz	11	1
Şangır ! Oldu işte , battı ortalık .	Oldu	2	3
Bu araştırma konusunda onun da yardımını isteyeceğim .	isteyeceğim	6	1
" Bu tanımla , örneğin Almanya'da şirket kuran vergisini Alman hükümetine ödeyen fakat Türk vatandaşı olan kimseler yerli ama Türkiye'de yıllardan beri yerleşik bulunan bizler yabancı oluyoruz " diyen ' , teknik bir hata olabileceğine dikkat çekti .	oluyoruz	26	1
Öbürleri de başlarıyla onayladılar .	onayladılar	3	3
Hiç mi kavuşamadınız .	kavuşamadınız	2	2
Yanına annesini de alan Şıkel , " Herkes beni zaten yanlış tanıyor , ne desem boş , inanılmaz derecede bunaldım .	tanıyor	11	3
Niye olmasın ; iş hayatındaki başarının sırrı , ciddiyet ; güvenilir olmak , ama en çok da takipçiliktir , bütün bunlar da yeğenlerde fazlasıyla var doğrusu .	olmasın	1	3
Türkiye , o limandan gitgide uzaklaşıyor .	uzaklaşıyor	5	3
Biz de oradan almışız .	almışız	3	1
Daha da kötüsü , bu gerçeği bilmeme rağmen , her seferinde elimde olmadan hep aynı şeyi yapıyordum , bunun önüne geçemiyordum .	geçemiyordum	20	1
Aradığımı Buldum Sandım .	Buldum	1	1
Babanız yaşlanmıştı .	yaşlanmıştı	1	3
Zeynep : Yemin ederim ki kimseye bir şey söylemeyeceğim .	ederim	3	1
Nasıl yaptığımı anımsamıyorum .	anımsamıyorum	2	1
Yaptığı nice düşüncesizlikleri başına kakmak istemedim , şunun şurasında birlikte yaşamaya başlayalı ne kadar oldu , yaparsam küstahlık olur .	yaparsam	16	1
Bunları yazan Su olamaz diye geçirdim aklımdan .	geçirdim	5	1
Öyle oyuncu öyle oyuncu ki anlatamam .	anlatamam	5	1
Halam nasıl böyle büyüklerine laf çakıştıran bir çocuk yetiştirir diye şaşakalmıştık .	şaşakalmıştık	10	1
Geldiğin günü çok iyi hatırlıyorum .	hatırlıyorum	4	1
Bu da gösteriyor ki , uçak pist yerine toprağa vurmuştur " diye konuştu .	vurmuştur	9	3
( Tutkunluğumun başlangıcı , hızla düşkırıklığına dönüşmesi , boşanmayla sonuçlanan on yıllık evlilik boğuşmasından sonraki yılgın günlerime rastlıyor .	rastlıyor	17	3
Hamamcıoğlu , gelir oranı aynı olan ülkelerle kıyaslandığında anne ve bebek ölümleri oranının Türkiye'de yüksek olduğuna da dikkat çekti .	çekti	18	3
Sosyal güvenlik kuruluşları , belediyeler , il özel idareleri , KİT'ler , bağlı ortaklıkları , kamu kuruluşu niteliğindeki meslek kuruluşları da kapsama alınıyor .	alınıyor	22	3
Bu atılımın son dalgaları , sonuna ulaşmakta olduğumuz yüzyılın ilk yarısında , fizikte izafiyet ve kuantum teorileriyle , biyolojide genetik alanında gerçekleşmiştir .	gerçekleşmiştir	21	3
bir ) Lezzetine bayılmış .	bayılmış	3	3
Rapor uçağın uçuş rotası ile ilgili gerekli bilgilerin verildiğini ve yer personelinin hiçbir şekilde kusurlu olmadığının da altını çiziyor ve olayın neden olacağını anlatmaya başlıyordu .	başlıyordu	24	3
Sorumluluk taşıyan insanlarımız var ; verdikleri sözün arkasında durdular ve eserler yarattılar .	durdular	8	3
Paketin salı günkü Bakanlar Kurulu toplantısında ele alınacağını ifade eden IMF , " Aynı gün ' sevk etmeye çalışacağız " dedi .	çalışacağız	18	1
Dünya şirketi olma hedefimiz için ikibiniki senesinde önemli atılımlar yaptık .	yaptık	9	1
Hiç değilse kaliteli bir film bularak Hülya ve Selma'yı ayartabilirdim , o da olmadı .	olmadı	13	3
Hülya için seviniyordum .	seviniyordum	2	1
Rus sömürgeciler Sibirya'ya adım attıklarında karşılarında savunmasız halkları bulmuşlardı .	bulmuşlardı	8	3
Hem sonuna kadar senin arkanda olacağımı söyledim ya .	söyledim	6	1
Kabaklık eden adama kabak demeyin .	demeyin	4	2
Ayırmayalım onları .	Ayırmayalım	0	1
Son köşeyi dönerken , bembeyaz elbisesi içinde , kucağında yastığı , kaldırımda cansız yatan Hülya'nın üzerine kapanmaya hazırdım .	dönerken	2	3
Siz dükkandan çıkıp onların arasına gireceksiniz ve yürümeye başlayacaksınız .	başlayacaksınız	8	2
Bir kadını daha çok sevip daha çok bağlandıkça , bir gün onu kaybedip yapayalnız , acılarla kalma korkusu büyüyordu ve gittikçe artan bir hızla kıskançlık uçurumundan aşağıya yuvarlanıyordum .	yuvarlanıyordum	27	1
Daha sonra da bir yüzbaşıya veriliyor dosya .	veriliyor	5	3
CHP'lilerin tarım ve sağlık sektörüne destek amacıyla verdiği önergeler ise " gider Başesgioğlu " olduğu gerekçesiyle kabul edilmedi .	edilmedi	17	3
maddeyi değerlendirmeye ağırlık vereceğiz .	vereceğiz	3	1
Rolü başkasına verdik dediler .	verdik	2	1
Koray , bilim etkinliğinin tarih içindeki serüvenini geleceğe de uzanarak analiz ederken dosyamıza güzel bir giriş de yapıyor .	giriş	15	2
Hannes Alfven : Big bang bir söylencedir , haksızlık etmeyelim , belki de iyi bir söylence .	etmeyelim	9	1
Son zamanlarda anne , hastalanıp yataklara düşmüş .	düşmüş	6	3
Yeğenlerin Zübeyde Halayı unutmalarını hoş görmek gerekir , kolay olmuyor bu işler .	olmuyor	9	3
Kemal , Günah çıkarma esprisine , bir çeşit yakıt alma gibi , yıkanıp temizlenme gibi , yüzeysel , hatta bazen köklü bir tamirat gibi yaklaşmalıyız , bunu kastediyorum , dedi .	kastediyorum	27	1
Hastaneye yatırmışlar kaç defa , biraz düzelir gibi oluyor , ay geçmeden başlıyor daha beter içmeye .	düzelir	6	3
Kırmızıya boyattım .	boyattım	1	1
Kapı tokmağını defalarca çalmış .	çalmış	3	3
Kamara örneği veriyor .	veriyor	2	3
İnsanları ikiye ayırıyor annem ( sayacağı iki kalem de olsa mutlaka parmaklarını avucuna kapatarak sayacak ; birincisi yaşayanlar ( bunlar başkalarını da yaşatıyor ) , ikincisi yaşayanları seyredenler ( bunlar da başkalarının sırtına yük oluyorlar ) .	seyredenler	27	3
Sebze yeşil demek dedik .	dedik	3	1
Bakın soluk soluğa kaldınız .	kaldınız	3	2
Şirket aleyhine bir tazminat davası olacaktı .	olacaktı	5	3
Bir akşam üstü de başındaki o komik perukla fahişe olmadan önce ( sadece basım evinde çalışan , mürekkep kokan sevgilinle yattığın günlerde ) çalıştığın markete girdin .	girdin	25	2
O kadar iyisin ki özgürlüğüm kısıtlanıyor , istediğim gibi davranamıyorum .	davranamıyorum	9	1
Çok yakışıklıydı , hemen fark etmiştim .	etmiştim	5	1
Irak'ta savaş tehdidi yanısıra , Amerika'nın baskısına rağmen AB için Türkiye'ye müzakere tarihi verilmeyeceği yönündeki sinyaller piyasada moral bozdu .	bozdu	18	3
Üniversiteyi bitirdikten sonra ilk girdiği şirketin müdürü delikanlıya yakın ilgi gösteriyor , baba ilgisi açlığı çeken delikanlı , çocuksu bir ben merkezcilikle müdürün ilgisini bir baba ilgisi olarak algılıyordu : Değerini bilen bir baba .	algılıyordu	28	3
Adam , yani mandıra sahibi bakmış ki , başının etini yiyor , rezil olacak , dayalı döşeli bir daire alıp , üstüne yapmış Kumru'nun , çekmiş gitmiş ...	yiyor	10	3
Annem dünyada evlenmez .	evlenmez	2	3
Çağdaş Sanatlar Merkezi önünde toplanan grup , Atatürk bulvarındaki trafiği bir süre durdurarak , elçilik önüne kadar sloganlarla yürüdü .	yürüdü	18	3
Bir yerlere yetişirler .	yetişirler	2	3
Zaman içersinde o teoreme yeni aksiyomlar , türetimler girmez ; ondan yeni bilgiler , öngörüler çıkmaz .	çıkmaz	15	3
Nereden biliyorsunuz .	biliyorsunuz	1	2
Açık kapıları boşuna bulmaya çalışırsın , dedi .	çalışırsın	4	2
Beraberce korkunç bir sahne yarattık .	yarattık	4	1
Ne derdik .	derdik	1	1
Belki de bir daha bulamayacağım orayı .	bulamayacağım	4	1
Ne yalan söyleyeyim biz babamı özlüyoruz .	söyleyeyim	2	1
( İsim vermiyorum .	vermiyorum	2	1
Hemen oracıkta kafanı bir güzel tıraşlayıvermiştin .	tıraşlayıvermiştin	5	2
Sen diye başlarlar , Atila diye devam ederler .	başlarlar	2	3
Konuşmayı sevmezdi , konuşunca da iyi konuşurdu .	konuşurdu	6	3
Çeyrek asırdır , milyonlarca insanın ve üç kuşak nüfusun kaderini terk ve teslim ettiği liderlik kadroları güçlerini nereden alıyordu .	alıyordu	18	3
Yerleştir yerleştirme , devşir devşirme sınavları falan filan yok ...	yerleştirme	1	2
İyi tanıyamadık onu .	tanıyamadık	1	1
Beni tanır , gelip karşısına oturduğumu hisseder .	tanır	1	3
Her şeyi anlattım mı dediniz .	dediniz	4	2
Gidelim , birlikte saldıralım .	Gidelim	0	1
Kampın kasabaya yakın olmasının avantajından masadaki çilek reçelini tadarak yararlanıyoruz .	yararlanıyoruz	9	1
Tersine , giderek yavaşlıyor ve durmaya yaklaşıyordu .	yaklaşıyordu	6	3
Senin de bu gösteriyi izlemeni isterdim .	isterdim	5	1
Bitecek bu şaşkın serüven ...	Bitecek	0	3
Çek şu albümü , şunu şunu , hani gidip gelip karıştırdığın , bilmem mi sanırsın , hah işte o albümü ver bakayım .	bakayım	21	1
Tanışmadınız , görsen şaşarsın , çok zeki , anlayışlı ama ...	görsen	2	2
Madem yaşlı olacaktı , yeğenine varsaydım keşke .	varsaydım	5	1
Bu ilişkiyi bitirelim , böyle yürütemeyeceğim , dedi .	bitirelim	2	1
Oysa yeşil değil , akik de , gitsin .	gitsin	7	3
Nasıl buldun onu .	buldun	1	2
Birbirimize bakarız .	bakarız	1	1
Durun ! Gitmeyin ! diye bağırdı Hacı Murat .	Gitmeyin	2	2
Kullanıyor ama kafa bulamıyordum .	bulamıyordum	3	1
İki genç çoban biraz daha erken kahvaltılarını bitirip geyikleri geceledikleri bölgeden toplamış , sürerek getiriyorlardı .	toplamış	11	3
Bütün sınıf önümüzdeki hafta harçlıklarımızı harcamayıp biriktireceğiz .	biriktireceğiz	6	1
Onlara hiç anlamıyorlarmış gibi gelirken birden en can alıcı soruyu , nasıl olup da bulup sorabilirler .	sorabilirler	15	3
Güneş ağaçların arkasına inerken kasabaya yollandı kamyon .	yollandı	5	3
Tanışmadınız , görsen şaşarsın , çok zeki , anlayışlı ama ...	şaşarsın	3	2
- Nereden biliyorsun .	biliyorsun	2	2
Serhat , Öyle bir şey öneriyorsun ki Kemal , dedi , bu öyle bir çırpıda karar verilebilecek bir şey değil .	öneriyorsun	5	2
Tartışmaktan yorulmuş gibi sustuk .	sustuk	3	1
Hazine'nin yaptığı çalışmaya göre Irak'a askeri operasyon durumunda Türkiye en az otuz milyar dolarlık kayıp yaşayacak .	yaşayacak	15	3
Oturun şöyle .	Oturun	0	2
Saime Sezginler o güne kadar yayınlandığından haberi bile olmadığı Aydınlık gazetesi ile ilk kez bu haber üzerine tanıştı .	tanıştı	17	3
Kokteyle CHP Genel Başkanı Deniz Baykal ile çok sayıda partili katıldı .	katıldı	10	3
Gel bak , sana evi göstereyim .	göstereyim	5	1
Tuzluk sağa üst rafta , çorbayı da ısıt .	ısıt	7	2
Şehvet ve arzu yaşanırken , eski bir kadının düşüncelere girmesi çok zordur .	yaşanırken	3	3
Sana açmayacağıma söz vermiştim ...	vermiştim	3	1
Raporlarda , tanıkların uçağın sağ kanadı aşağıda , diğeri yukarıda olarak dalış halinde gelip yere vurduğunu , vurmayı müteakip bir ateş topu meydana geldiğini beyan ettiği yeralıyordu .	yeralıyordu	26	3
Size kalırsa nal toplayacağız " diye tepki gösterdiler .	toplayacağız	3	1
Kalmayız , dedi , koşa koşa gideriz , erikleri de senin heybene doldururuz .	Kalmayız	0	1
Ramiz yerine oturana dek de gözlüklerinin üstünden izledi .	oturana	2	3
Beyin Takımı diye isim edindiler .	edindiler	4	3
Bu yüzden , çaldığı iki ağır türkünün ardından yine kıvrak bir göbek dansına , ya da bir bozlağa geçer , balıkçılar oturmayacak olurlarsa , kaş göz işaretleri yaparak , masalarına gitmeleri gerektiğini anlatırdı .	olurlarsa	22	3
İyi ki dedem var da gündüzleri onunla konuşabiliyorum .	konuşabiliyorum	7	1
Ona yardımcı olmalıyız , dedi .	olmalıyız	2	1
Öyle sanıyorum , dedi Jul .	sanıyorum	1	1
Güvenemem ona , anlıyor musun beni ? Hızlı araba kullanmayı , geceyi , içkiyi ve kadınları seven , arada kadife gibi yumuşayıveren , bazen sessiz ve suskun ...	Güvenemem	0	1
Özene bezene kurulan her eve eninde sonunda ölüm girer .	bezene	1	3
Beni ziyan ettin , diyor , ziyan ettin .	ettin	7	2
Bıktırırlar insanı .	Bıktırırlar	0	3
Zeynep : Yemin ederim ki kimseye bir şey söylemeyeceğim .	söylemeyeceğim	8	1
Bazen şarkı söylerken de olur bu , arkadaşlar bilir ( arkadaşlar , yani bıyıklarına ak düşmüş emekli sarhoşlar gözlerini yumup başlarını hafifçe eğerek onaylıyorlar ) okursa hüzzam okur , herkesi kahırlandırır .	onaylıyorlar	23	3
Kerem ; ışıkta değişen , şimdi koyu bir yeşile dönmüş olan gözlerini bana çevirdi .	çevirdi	13	3
Her gün kırmızı Mersedesi bekleyeceğim , dedi Memo heyecanla .	bekleyeceğim	4	1
" Söz konusu meblağ sosyal yardımlaşma ve dayanışma vakıflarına gönderilmiştir .	gönderilmiştir	9	3
Sezginler ne ile uğraştığını o güne kadar tam olarak bilemese de Senem başlarına gelebilecekleri tahmin edebiliyor ve bu yüzden Sezginler'i uyarma ihtiyacını hissediyordu .	edebiliyor	15	3
Bakın , şu demir korkulukların ardında görünen kapılar .	Bakın	0	2
Yapmacıksız sıktı elimi , bekletti biraz .	bekletti	4	3
İnsanları , kuralları iyi bilirdi .	bilirdi	4	3
altı yıl önce Aysun Hanım'la evlenen Ulusu , kaderinin bu denli tesadüfi çizilebileceğini bilemezdi belki .	bilemezdi	13	3
- İstemiyorum .	İstemiyorum	1	1
Kesilmiş , iç organları temizlenmiş ve soğuğun etkisiyle kaskatı olmuş dört geyik , boynuzları , başları , bacakları ile kamyona taşındı .	taşındı	20	3
Gitmeden yapamıyorsun .	yapamıyorsun	1	2
Patlıcan deyin .	deyin	1	2
Damla damlatacağım .	damlatacağım	1	1
Kendi yaşam alanını güvence altında gören Papalık , bunun verdiği rahatlıkla , yakın geçmişte Darwin'le bile barışmakta bir beis görmemiştir .	görmemiştir	19	3
Partinin bu hale gelmesine neden olanların artık yönlendirme yapmaya hakkı yoktur " diye konuştu .	olanların	5	3
Yavaşça yanına yaklaştım .	yaklaştım	2	1
Dolapta yeterince makarna ve margarin bulunup bulunmadığına baktık .	baktık	7	1
Ne diyeceğimi bilemedim .	bilemedim	2	1
Yattığı yerde , kumların üzerinde gerinebildiği kadar gerindi .	gerindi	7	3
Olacakları bilmiştim edasıyla başını usul usul sallıyordu .	bilmiştim	1	1
Geldik ! diye bağırdı Kerem .	bağırdı	3	3
Oğlunuza sarıldığınızda , aklınızdan , Ya bu ona son sarılışımsa gibi aptalca bir düşünce geçiyor .	geçiyor	14	3
O geceye doğru yolculuğa çıktığından ( biraz zorlanacak tabii , onda da beyin meyin kalmamış ) dalıp gidiyor .	gidiyor	17	3
Hülya , Onu seri düşün , hadi gel , dedi ve kolumdan çekti .	çekti	12	3
Nasıl başlayacağımı bilemiyorum .	bilemiyorum	2	1
Daha doğrusu takipsizlik kararı verilmişti .	verilmişti	4	3
Ana'nın orada olmadığını söyledikten sonra ben , buna ne inanırmış , ne de inanmazmış gibi bir tavır takındım .	takındım	17	1
Hakikaten de önüme kısa boylu biri oturdu .	oturdu	6	3
Çevreyi araştırırlar .	araştırırlar	1	3
O kayıtsızlığıyla beni yerden yere vurdu , ben uğradığım muamele karşısında kapıldığım dehşetle kendimi yerden yere vurdum .	vurdu	5	3
Diz çök karşısında , okşa saçlarını , özür dile , bağış dile , ne dilersen dile it herif , ağla hatta elinden geliyorsa ...	ağla	19	2
Tanrı öldü ve biz sokağa bırakıldık .	bırakıldık	5	1
Neyse ki üçüncü kez sorduğunda iyi bir cevap hazırlamıştım : Esinciğim evde tek kız olmasının daha iyi olduğuna karar verdik .	hazırlamıştım	8	1
Olmuyor , tekrarlayalım ...	tekrarlayalım	2	1
Ya dayak yerseniz , ya karakola gidersiniz .	gidersiniz	6	2
Çünkü , sanık sandalyesinde oturan darbecilerden birisi kalkıp dinleyici sıralarına parmağını uzatsa ve sorsa .	sorsa	13	3
Bulabilirler onu .	Bulabilirler	0	3
O zamanlar toprağı bol olsun Sayın Tului Sönmez ile konuyu tartışmış ve ondan epey şey öğrenmiştim .	tartışmış	10	3
Baban sana rağmen mi astı kendini , sana bağlı olarak mı .	astı	4	3
Kalkmaya hazırlanan masadaki iki genç kadının ayaklarının oynamaya başladığını , ince hırkalarının altında omuzlarının titrediğini , parmaklarının tempo tuttuğunu gördü , sevindi .	gördü	19	3
Yağla soğanla tencere içine kapatılmaz .	kapatılmaz	4	3
Bana ne ! Yine de dayanamadım , ondan söz açmaya can atıyor belli .	dayanamadım	5	1
Ama verdikleri çekleri , ' Nakit ödeme yapacağız ' diye aldılar , beş parasız kaldım .	aldılar	10	3
Görmüyorlar mıydı : Girişten mağlup başlıyor , gelişme bölümünün ortasına bile sağ salim varamıyordum ; sonucu da felaket oluyordu bu durumda tabii .	Görmüyorlar	0	3
Anneme sorsan hiç özlemediğini söyler ; ama bence herkes birbirini arıyor .	sorsan	1	2
İhtiyaç olabileceği düşüncesiyle evin etrafında gün boyu bekleyecek on kadar geyik seçildikten sonra diğerleri serbest bırakıldı .	bırakıldı	15	3
Beyaz peynir , Bulgaristan'da da Türkler tarafından yapılır .	yapılır	7	3
içine alır , besler , büyütür , korur .	besler	3	3
Melek her gün yüz bin lira kazansam , kış gelene kadar bir kondu alabilir miyiz ?	gelene	9	3
Hızla kapıya doğru gidiyordu .	gidiyordu	3	3
Omzunun üstünden fotoğrafı görebiliyordum .	görebiliyordum	3	1
Bu herhangi bir rahatlama sağlamıyor ki , en fazla o sorunu nasıl çözeceğime ilişkin tavsiye almış oluyorum .	oluyorum	16	1
O zamana kadar da , umarım ki , Ana'dan bir haber alırım , dedim .	alırım	11	1
Ama böyle birdenbire nasıl oldu bu iş ? Yüreğinden ve beyninden nasıl çıktınız ? İçeride mi o ? dedim .	çıktınız	12	2
Bir defasında laf oraya gelir gibi oldu , derhal , halledilmemiş bir başka tartışmayı açarak herkesi sürükledim .	sürükledim	16	1
Ayhan'ın hikayesini dürelim ..	dürelim	2	1
İzini bulursanız , bu numaraya haber verirsiniz , dedi .	bulursanız	1	2
