Mlčky mi podal obálku , čo sa podobala obálke , ktorú mi zverila Liza .	zverila	12	Sing
Kým som si to stačila uvedomiť , po tvári mi tiekli slzy a potichu som vzlykala .	vzlykala	15	Sing
Fil mu vysvetlil , že doteraz ho sklamali všetci , ktorým pomáhal .	sklamali	7	Plur
“ Tomuto ja hovorím najpotrebnejšie veci , “ výsmešne škriekala opica .	škriekala	9	Sing
Bola špička a cez okienka som videla , že všetky sedadlá obsadili ľudia , čo pracujú v centre .	videla	6	Sing
Maja s Vilkom sedeli na lesnej čistine a vymýšľali si o nich príbehy .	vymýšľali	8	Plur
Vyhol som sa jej , pretože som rýchlo stratil naivnosť , túto vznešenú a krásnu vlastnosť .	Vyhol	0	Sing
V úvode pasáže volchvi symbolizujú bielych šamanov , vysporiadávajúcich sa s čiernymi šamanmi .	symbolizujú	4	Plur
Nikdy predtým som nevidela živú korytnačku .	nevidela	3	Sing
Skúste siahnuť po nejakej knižnej novinke , zoznam nájdete v Knižnom katalógu .	Skúste	0	Plur
Kriminalisti dospeli k záveru , že ich napísali ženy .	napísali	7	Plur
“ Kým neodíde , nevylieziem na žiaden strom . “	nevylieziem	4	Sing
Tarzana to povzbudilo a prisahal : “ Budem najlepšia opica , aká kedy prišla na svet ! “	prisahal	4	Sing
“ Zastavte ho !	Zastavte	1	Plur
Vidím , že začínam strácať niť .	začínam	3	Sing
“ Hraj ako ja , “ zašepkal .	zašepkal	6	Sing
“ Môžeš si dať za mňa , “ povedala som .	Môžeš	1	Sing
Vyrába umelé potreby , ktoré nás aktivujú , vyprázdňujú , ničia a zotročujú .	aktivujú	6	Plur
“ Nijakú kobylku nepoznám , ukážeš mi ju , Vilko ? “	ukážeš	5	Sing
Nechápeš , že smrť jednotlivca nie je vôbec smrť .	Nechápeš	0	Sing
V prípade , že z manželstva nevzišli deti , Strana nepovoľovala rozvod , zato podporovala odlúčenie .	nevzišli	6	Plur
Počuješ ma ?	Počuješ	0	Sing
Odkiaľ berú títo ľudia presvedčenie , že pre Bratislavčanov reformy neznamenajú záťaž ?	berú	1	Plur
Bolo to bláznovstvo , povedala a ja som jej za seba potvrdil , že má pravdu .	potvrdil	11	Sing
Muži zo sprievodu to jednohlasne odobrili .	odobrili	5	Plur
Najprv so mnou nechcela hovoriť .	nechcela	3	Sing
Viem , že človeka spravodlivo vypočujú .	vypočujú	5	Plur
“ Na tú som alergický , “ zastonal Wayne .	zastonal	7	Sing
“ Pochodujeme naprieč celým územím ! “	Pochodujeme	1	Plur
Bohužiaľ , vzali si z nich príklad všetky deti a tiež sa chceli hrať v odpadovej jame .	chceli	12	Plur
Sú mojimi obeťami a prišli sem z jediného dôvodu : aby ma súdili .	prišli	4	Plur
“ Určite hľadáte Fawada , obchodníka so šperkami , “ povedala , keď k nej podišli .	hľadáte	2	Plur
Najskôr som začul psí brechot .	začul	2	Sing
o Herkulovu slávu sa s vami podelíme .	podelíme	6	Plur
Zhlboka sa nadýchla , poriadne si vydrhla predné nohy a ostala nehybne sedieť na liste ako prikovaná .	nadýchla	2	Sing
Hoci bývali naproti , vídala som ich zriedka .	bývali	1	Plur
“ Nechcú nám ublížiť , Kerchak ! “ povedal .	Nechcú	1	Plur
Vydesený som si sadol do prvej lavice .	sadol	3	Sing
Zvyšné zuby mu vytrhli a dali mu nové protézy .	vytrhli	3	Plur
Všetky pôžitky sa zničia .	zničia	3	Plur
Otec veľa rozprával o svojom literárnovednom výskume , ale nevyhýbali sme sa , samozrejme , ani súčasným problémom .	nevyhýbali	9	Plur
Priatelia po sebe hlasno pokrikovali .	pokrikovali	4	Plur
Po týchto slovách zmenila tému , začala mi rozopínať nohavice .	zmenila	3	Sing
Tým výrazne prispeli ku vzniku učenia o transsubstanciácii .	prispeli	2	Plur
Najspokojnejšie však boli pestúnky , lebo im vrátia ukradnuté vajíčka .	vrátia	7	Plur
Plukovník Hatí sa zlostne zamračil .	zamračil	4	Sing
My krájame vlastný chlieb	krájame	1	Plur
Nákladné autá ešte stále prechádzali okolo a ľudia ešte stále na ne hladovo civeli .	prechádzali	4	Plur
Tí prašiví tuláci nedajú pokoj ! “	nedajú	3	Plur
Raz sa podobali na rybu , potom na obra alebo na obriu včelu .	podobali	2	Plur
Pre svoju krátkosť a úryvkovitosť sa nedajú podrobiť podrobnejšej analýze .	nedajú	6	Plur
“ Padajme , kým nás tu zbadá správca , “ zašepkala som .	Padajme	1	Plur
Medzitým som sa už naučila čítať , a keď som ich našla , hneď som si ich , samozrejme , prečítala .	prečítala	20	Sing
Vilko s Majou doleteli na lúku s koňmi .	doleteli	3	Plur
Zaťal zuby .	Zaťal	0	Sing
Winston sa zľahka poškrabal na nose sponkou na spisy .	poškrabal	3	Sing
“ Nedopustíme predsa , aby utiekli a varovali netvora , “ povedal ľuďom .	Nedopustíme	1	Plur
Uvidíme , ako do celé dopadne .	Uvidíme	0	Plur
Ale odkiaľ ho vezmem ?	vezmem	3	Sing
“ Chcete ju vidieť ? “	Chcete	1	Plur
Ukazuje sa teda , že tým stredoslovenským nárečím , ktorÉ Štúrovci povýšili na spisovný JAZYK , bol prestížny liptovský mestský jazyk .	povýšili	11	Plur
“ Taký balíček s prekvapením , “ dodal Smí .	dodal	7	Sing
“ Chcem to spraviť tak , aby si ostal v džungli . “	ostal	8	Sing
Na zastávke na Záhradkách nás čakal veľmi zaujímavý pohľad .	čakal	5	Sing
Jachtala som , rýchlo som zavrela notes a strčila ho späť do vaku .	Jachtala	0	Sing
“ Počkaj , až ochutnáš Safiyinu špecialitu , “ nadšene vravel , keď sluhovia kládli na stôl ťažký strieborný podnos s polguľovitým vrchnákom .	kládli	14	Plur
Odišiel som od okna .	Odišiel	0	Sing
Nesmieme strácať ani chvíľočku . “	Nesmieme	0	Plur
Parsons , ktorého to bombardovanie číslami priviedlo až do akéhosi nedefinovateľného nadšenia , si vytiahol fajku z úst .	priviedlo	6	Sing
Skočili sme do bazéna Joea Favatu . “	Skočili	0	Plur
“ Netráp sa , niečo vymyslíme , “ povedala Makulienka .	Netráp	1	Sing
Toto každodenné falšovanie minulosti , ktoré robí Ministerstvo pravdy , je pre stabilitu režimu rovnako nevyhnutné ako represálie a špicľovanie , ktoré robí Ministerstvo lásky .	robí	6	Sing
“ Dúfal som , že ťa tu nájdem , “ povedal a zosadol z bicykla .	zosadol	12	Sing
Viete , koľko tu stojí 1 - izbový byt ?	Viete	0	Plur
Netrvalo dlho a nad jaskynkou sa zachvel list , spod ktorého vyliezol prečudesný chrobák .	Netrvalo	0	Sing
Vlci súhlasne pokývali hlavami .	pokývali	2	Plur
Veľmi ste mi pomohli .	pomohli	3	Plur
V kapitole o Novgorode sme už rozobrali súvis tzv . Najstaršej Pravdy s protivarjažskými nepokojmi .	rozobrali	6	Plur
Ktosi si všimol Marginu bledosť a zdvorilo jej uvoľnil miesto , aby si mohla sadnúť .	mohla	13	Sing
Spevák skupiny sa s deťmi rozprával a pýtal sa ich na to , čo si myslia o Bohu .	myslia	15	Plur
V prípade , ak si poslanci odsúhlasia platených sekretárov , môže sa stať , že " Ringom Čechom " budú poslanci a efekt bude mať sekretár .	odsúhlasia	6	Plur
Ak sa priznám , zastrelia ťa , ak sa priznať odmietnem , aj vtedy ťa zastrelia .	zastrelia	4	Plur
“ Chcem sa pozrieť zblízka .	Chcem	1	Sing
Samozrejme , že autorom pôvodnej myšlienky je VB , " dodal .	dodal	10	Sing
Jej bledosť a mlčanie stačili , aby som okamžite pochopil , že som urobil hlúposť .	stačili	4	Plur
Iba my s Chrisom sme tak zúrivo nepísali a nehrbili sa nad lavicami .	nepísali	7	Plur
Nálože jeho nenávisti explodujú .	explodujú	3	Plur
Nad ňou sa vznášal cudzí motýľ .	vznášal	3	Sing
“ To nemyslíš vážne ?	nemyslíš	2	Sing
Síce sme nevyhrali , ale verím , že aj to príde .	príde	10	Sing
Pripadalo mu to , akoby sa džungľou rútili tisíce zvierat .	rútili	7	Plur
Marga nechcela , aby sme zobudili Irmu .	nechcela	1	Sing
Maja súhlasila .	súhlasila	1	Sing
Hrozba rozvodu visela nado mnou ako Damoklov meč .	visela	2	Sing
Práve došli na okraj malého lesíka .	došli	1	Plur
Pozoroval som každý štvorcový milimeter jej tváre .	Pozoroval	0	Sing
Pôjde najmä o precíznejšiu personálnu prácu , efektívnejšie využitie ich vlastných kontrolných a inšpekčných mechanizmov , ale tiež o uplatňovanie nových špecifických protikorupčných postupov .	Pôjde	0	Sing
Na chvíľu ožiarilo murény oslnivé hrôzostrašné svetlo , no po chvíli sa rozprskli na tisíc márnych kusov .	rozprskli	12	Plur
Už dávno sa s nimi nehrám , ale ani vo sne by mi nenapadlo , aby som ich vyhodila .	nenapadlo	13	Sing
Ide v nich napospol o reglementovanie podmienok azylu pre zlodejov , ktorí utečú do kostolov .	utečú	12	Plur
Ja som vedel , že jej portrét sa nachádza medzi viečkami medailónu v skrini , kde sú uložené aj biele svadobné šaty so závojom .	nachádza	8	Sing
Rovnakú spoluprácu so svetským sudcom predpokladajú v citovaných ustanoveniach aj sledované súdobé cirkevnoprávne príručky .	predpokladajú	5	Plur
Keď to navrhol Júlii , súhlasila neočakávane horlivo .	súhlasila	5	Sing
To je tajomstvo , povedalo , neprezradím ho každému .	neprezradím	6	Sing
“ Mhm , “ zamrmlala som .	zamrmlala	4	Sing
“ Poďme do reštaurácie mojich rodičov .	Poďme	1	Plur
Pristáli sme u slimáka Oskara .	Pristáli	0	Plur
Spolu s nimi som uvidel Háda .	uvidel	4	Sing
Mlčky sme sedeli a dívali sa , ako medená žiara pomaly bledne .	dívali	4	Plur
Objala ho okolo krku , nazývala ho miláčikom , zlatkom , láskou .	nazývala	5	Sing
Z dverí vykúkli ospalé včely .	vykúkli	2	Plur
Vtom sa v temnici zjavili dobré víly .	zjavili	4	Plur
Už sme spomenuli , že pápežský úrad bol v desaťročiach pred reformou v hlbokej kríze .	spomenuli	2	Plur
Sprevádzali ho ďalší štyria strážcovia s vytasenými mečmi .	Sprevádzali	0	Plur
Podporíme intenzívnu ekonomickú poľnohospodársku výrobu .	Podporíme	0	Plur
Veď okolo neho lietame celé dni .	lietame	3	Plur
Katka si zaumienila , že Maja musí ísť do paláca s ňou .	zaumienila	2	Sing
“ Nie , “ odvetila som a žmurkla na Chrisa .	žmurkla	7	Sing
Vytvoríme kapitálotvornú vrstvu , ktorá bude zárukou blaha ľudu , presvedčivo hlásal tvorca blaha svojich prívržencov .	Vytvoríme	0	Plur
Chlap pochopí , že vlky môžu prísť každú chvíľu .	pochopí	1	Sing
V tej chvíli som otvoril oči a začul som vzlykot .	otvoril	4	Sing
Neboli sme tam už dosť dlho .	Neboli	0	Plur
Pred domom kuny Chytráčky viali pestré slepačie perá , Alfonz vystavoval lesklú kukuricu a kliešťak Drakula voňavé krvavé klobásky .	viali	4	Plur
Už sa teším , to bude krása !	teším	2	Sing
Poznali ho všetky ženy , vedeli , o čo mu ide .	Poznali	0	Plur
Začiatkom mája sme vstúpili do Európskej únie .	vstúpili	3	Plur
Než si ju vzal , vedel podľa vône , že je to veľmi netypická čokoláda .	vedel	5	Sing
“ Zahoďte ho .	Zahoďte	1	Plur
Priveľmi by to kričalo .	kričalo	3	Sing
Zoskočili sme do mäkkej trávy .	Zoskočili	0	Plur
“ Netráp sa , niečo vymyslíme , “ povedala Makulienka .	vymyslíme	5	Plur
Slovenská republika prekonala obdobie spochybňovania demokratických inštitúcií a ohrozovania demokratických slobôd .	prekonala	2	Sing
Možno som vôbec nič nepovedal .	nepovedal	4	Sing
Duchovní v tejto funkcii sa netešia veľkej úcte , sú ohováraní svojimi nevoľníkmi , mučení a zabíjaní .	netešia	5	Plur
Teraz sa chvíľu bavme o tebe . “	bavme	3	Plur
Začínali sa aj pochôdzky chlapa v zelenom vojenskom kabáte .	Začínali	0	Plur
Pri raňajkách som mame vyrozprávala ten sen .	vyrozprávala	4	Sing
“ Videl som ťa v bazéne a mal som sa ti vyhnúť .	Videl	1	Sing
Sviečky som vložila do mosadzných svietnikov a postavila ich na stôl .	postavila	7	Sing
“ Kedykoľvek , “ odvetil Chris s úsmevom , zvrtol sa a plával k trénerovi .	plával	12	Sing
Než však stačili vzlietnuť , obkolesila ich horda zelených mužíčkov .	stačili	2	Plur
Pomaly kráčali po dlhom schodišti , ktoré viedlo na strechu , kde bývali , a boli hladní , unavení a veľmi sklamaní .	bývali	12	Plur
Zarazene vstali a skúmali , či sú celí .	skúmali	3	Plur
Táto imunita ( nenarušiteľnosť ) sa potom vzťahovala aj na všetkých ľudí , ktorí sa v objekte zdržiavali .	zdržiavali	17	Plur
“ Ako to myslíš ? “ zaujímal sa škriatok .	myslíš	3	Sing
Koniec sa blížil , ale Wendy bola pokojná a statočná .	blížil	2	Sing
V každom prípade musím otvoriť oči a nesmiem veriť legendám .	musím	3	Sing
“ Strachopud , “ nafučala sa , ale pretože bola zvedavá , spomalila .	spomalila	12	Sing
“ Dotkni sa vretena ! “ prikazovala jej .	Dotkni	1	Sing
Chúďa Maja ronila trpké slzy .	ronila	2	Sing
Uvedomujem si to , takáto obhajoba prezrádza určitý komplex .	Uvedomujem	0	Sing
Keď búrka ustala , zistili , že pristáli na púšti .	zistili	4	Plur
Najskôr prišli spomenutí krásni mladí , nakoniec Zhlúpnutý Sokrates .	prišli	1	Plur
“ Vezmi ju stadiaľ , ona odíde , a ty ostaneš . “	ostaneš	10	Sing
Máme tu teda ďalší argument pre to , aby sme kánony o celibáte z druhej kolomanovskej synody nepovažovali za prejav úplného príklonu k normám reformného pápežstva .	Máme	0	Plur
Pamätajte na Ježišove slová : Kto vytrvá do konca , bude spasený .	Pamätajte	0	Plur
Chris je najrýchlejší plavec v Delfíne , ale rekord v prsiach doteraz neprekonal .	neprekonal	12	Sing
“ Ak to je dôvod na oslavu , tak oslavuj častejšie , “ odvetila som .	oslavuj	9	Sing
Mešťania sa nazlostili a upozornili Herkulovho otca , nech ho viac do mesta nepúšťa .	nazlostili	2	Plur
Po tréningoch som ostávala v bazéne a trénovala som sama .	ostávala	3	Sing
“ U mravcov , “ odvetila mravčia zdravotná sestrička .	odvetila	5	Sing
Všetci vedeli , že na papieri sa každý kvartál vyrobili astronomické počty topánok , kým vari polovica obyvateľov Oceánie chodila bosá .	vedeli	1	Plur
Kasandra preto vyslala včielky popoludní na pole , aby nazbierali kukuricu .	nazbierali	9	Plur
Odskočili od seba .	Odskočili	0	Plur
Naši chirurgovia dokážu zmeniť ľudí na nepoznanie .	dokážu	2	Plur
Sedel na stoličke neprirodzene vzpriamene a jeho mocné prsia sa nadúvali a zachvievali , akoby mal čeliť nárazu vlny .	nadúvali	10	Plur
Ponáhľala som sa , lebo ak pozrú z okna , uvidia , ako sedíme na múre .	sedíme	13	Plur
Preto predpokladáme , že žili pomerne izolovane od ostatného uhorského mníšstva .	žili	4	Plur
Chcem , aby si mi splnil druhé želanie , džin .	Chcem	0	Sing
Vtedy mi utkveli v pamäti dátumy , mená i dôležité udalosti z minulosti , medzi ktoré bolo neskôr ľahšie dokladať nové dátumy , mená i vzťahy .	utkveli	2	Plur
Všetci vedeli , že na papieri sa každý kvartál vyrobili astronomické počty topánok , kým vari polovica obyvateľov Oceánie chodila bosá .	vyrobili	9	Plur
Učili sa poznávať všetky jesenné farby kvetov a každé ráno kontrolovali na teplomeri teplotu .	kontrolovali	10	Plur
Témy na rozhovor sme už vyčerpali .	vyčerpali	5	Plur
Môj úsmev do diaľky žiari , tvár zdobia mandľové oči .	zdobia	7	Plur
Rahim pohladkal Abua po hlave .	pohladkal	1	Sing
Žiaľ , bol priťažký , lebo maškrtil kandizované datle .	maškrtil	6	Sing
Sledovalo línie Lorinho tela , hltalo ho očami .	Sledovalo	0	Sing
Chvíľu čakal , ale mnoho ľudí mu netlieskalo .	netlieskalo	7	Sing
Na povrchu hlainy sa ukázali špinavé bublinky a obecenstvo tlieskalo .	ukázali	4	Plur
“ Zdvihni hore hlavu . “	Zdvihni	1	Sing
Abu síce nevedel čítať , no páčili sa mu obrázky .	nevedel	2	Sing
Voláte sa . . .	Voláte	0	Plur
Ak má môj rod zomrieť , tak chcem zomrieť i ja , pomyslela si .	pomyslela	12	Sing
Chceli zistiť , čo sa deje .	Chceli	0	Plur
Bol som šťastný ako blška , že sa jej nič nestalo .	nestalo	10	Sing
Ešteže to spozorvali mravce a zavolali hasičov !	zavolali	5	Plur
Poďakovanie patrí aj posudzovateľom rukopisu – pánovi prof . PhDr . Richardovi Marsinovi , DrSc . a pánovi PhDr . Jánovi Steinhübelovi , CSc . , ktorí mi pomohli vylepšiť text svojimi cennými postrehmi .	pomohli	28	Plur
Umožniť jazykovedcovi rozhovoriť sa o systéme v jazyku , prináša zdanlivo nebezpečenstvo , že sa vstúpi do nezaujímavého a nudného sveta .	vstúpi	15	Sing
Zúčastnili sa jej aj chovanci ústavu .	Zúčastnili	0	Plur
Shannon s Waynom sa hrabali vo vreckách , aby dali dokopy drobáky na prvú pizzu .	hrabali	4	Plur
Sú náznaky , že po duševnej stránke prežíva veľmi pochybné obdobie .	Sú	0	Plur
To všetko mi jedného dňa porozprával Sergej , pri močiari .	porozprával	5	Sing
Bežali do domu , aby zistili , či niečo nezmizlo .	Bežali	0	Plur
Zarazene vstali a skúmali , či sú celí .	vstali	1	Plur
Zavolajte Ferda Mravca !	Zavolajte	0	Plur
Pomyslel som si , že keď ju tam zvalili a vláčili po uliciach , podarilo sa jej nejako utiecť , ako utekajú sochy , a prišla sa postaviť sem .	utekajú	21	Plur
Prejav ma neprekvapil .	neprekvapil	2	Sing
Na stenách viseli zaprášené police s prastarými knihami zaklínadiel a čarov .	viseli	2	Plur
Neveríme princípom angsocu .	Neveríme	0	Plur
“ No dovoľ ! “ vyhŕkla som .	vyhŕkla	5	Sing
Alia sa tvárila zamyslene .	tvárila	2	Sing
Lúče slnka , ktoré pretínali okno priečne , dopadali na zaprášené dosky stolov .	pretínali	4	Plur
A predsa ma Faika už nevolala do školy .	nevolala	5	Sing
Pokým nás kryjú tieto konáre , sme v bezpečí . "	kryjú	2	Plur
Chlapci sa vyšplhali z rokliny , no len čo zastali Hádesovi pri nohách , premenili sa na Bôľ a Zmätok .	vyšplhali	2	Plur
Keď sa telo spojilo s dušou , dievčina zažmurkala a otvorila oči .	spojilo	3	Sing
Potom som k nej podišiel .	podišiel	4	Sing
Ale pri pochodovaní sa nerozpráva .	nerozpráva	4	Sing
Lori to trvalo dlho , ale neplakala .	neplakala	6	Sing
“ Odteraz patríš iba mne !	patríš	2	Sing
Ide o unikátny nález brezovej listiny v karelčine , s využitím ruskej abecedy .	Ide	0	Sing
Ja tomu len verím . Viem , že raz padnete .	padnete	9	Plur
Už sa zberala preč , ale vo dverách sa otočila .	zberala	2	Sing
Vnútri jedného z nich som uvidel fotografiu ženy .	uvidel	5	Sing
Posledný szabolcsský kánon , ktorý sa venuje kláštornému životu nariaďuje opátom a mníchom , aby sa nezúčastňovali na kalendových sedeniach , ale aby prijímali oblácie ich účastníkov v kláštoroch .	prijímali	23	Plur
Keď leteli nad potokom , vodná hladina sa pod nimi tak jagala , akoby do nej spadla hviezda .	jagala	11	Sing
Meg trápili starosti .	trápili	1	Plur
“ Balú , ty žiješ ! “ zvolal Mauglí a hodil sa mu okolo krku .	žiješ	4	Sing
“ Tieto zbrane ti pomôžu zvíťaziť nad zlom , “ povedali mu .	povedali	10	Plur
Vtedy víly pochopili , že je načase , aby dievčine povedali pravdu .	povedali	10	Plur
Potrebujem finančnú podporu , ak chcem študovať .	chcem	5	Sing
Prijme systém finančnej podpory preventívnych projektov .	Prijme	0	Sing
Samozrejme , ja som o tom nič nevedel .	nevedel	7	Sing
Poskladali sme vlhkú deku , napchali ju do koša , ktorý sme pomaly uväzovali o korman .	Poskladali	0	Plur
Opäť som poslúchol .	poslúchol	2	Sing
Začali sme na kolotočoch , kde sme vyliezli na koňa .	vyliezli	7	Plur
V temnej miestnosti blikalo iba svetlo sviec .	blikalo	3	Sing
Odpovedala , že je v poriadku .	Odpovedala	0	Sing
Každý deň som chodievala do školy spolu s mamou .	chodievala	3	Sing
Jedného dňa sochu odtiaľ strhol dav , ktorý rozzúrilo jej namyslené povýšenectvo .	strhol	4	Sing
Napokon mu prezradila aj svoje najväčšie želanie .	prezradila	2	Sing
Ak si želáte dievča , povedala , zariadime to .	zariadime	7	Plur
Nesmieme strácať čas . “	Nesmieme	0	Plur
Kolektívne postupovať nemôžeme .	nemôžeme	2	Plur
Svetové ríše , silné krajiny , politické systémy vznikajú a zanikajú , nič netrvá večne .	vznikajú	8	Plur
Spomenula si na ďatla , a tak zaletela poňho .	zaletela	7	Sing
Snažím sa vidieť päť . "	Snažím	0	Sing
Sadol si na zem a povedal : “ Tak čo mám teda robiť ? “	Sadol	0	Sing
Sú tu správy !	Sú	0	Plur
Hroby majú vedľa seba a mama ma kedysi brávala každú nedeľu so sebou zapáliť im sviečky .	brávala	8	Sing
Ale oni nič nerobili ani nehovorili .	nerobili	3	Plur
Zajac mohol byť vykladaný v systéme predkresťanských názorov jednak ako symbol plodnosti / dodnes spájame na veľkú noc vyobrazenia zajacov s vajíčkami , Nemci počas tohto sviatku hľadajú v záhrade vajíčka ukryté veľkonočným zajacom / .	hľadajú	27	Plur
“ PÄŤ TELEFONÁTOV ! “ zvolala som , keď som zbadala , že doma v chodbe bliká svetielko na odkazovači .	zbadala	10	Sing
Usnul šepkajúc : " Zdravý rozum sa nedá zaznamenať štatisticky " a s pocitom , že táto jeho poznámka obsahuje hlbokú múdrosť .	obsahuje	19	Sing
Najprv zavládlo neprirodzené ticho .	zavládlo	1	Sing
Neskôrnateli vnútorne .	Neskôrnateli	0	Plur
V deň , keď som prišiel do bábkového divadla sám , pochopil som pravdu : naše správanie bolo škandalózne , skôr či neskôr by si nás všimli .	všimli	26	Plur
Dnes tu však mali návštevu , sedeli na terase a jedli lahodne rozvoniavajúci ovocný koláč .	sedeli	6	Plur
" Nenávidím mravnú čistotu , nenávidím dobrotu !	nenávidím	5	Sing
Takmer ihneď usnuli a driemali asi polhodinu .	usnuli	2	Plur
Bol som v jeho pracovni , mal som v sebe nerozumnú dávku alkoholu a čakal som , že všetko sa definitívne vyjasní a ja odídem .	čakal	14	Sing
Po známej zrážke s okrajom bazéna ma boleli päty a prestala som si veriť .	boleli	7	Plur
Rudko im vysvetlil pravidlá a odpískal začiatok zápasu .	vysvetlil	2	Sing
Krútili hlavou .	Krútili	0	Plur
Nebolo tajomstvom , že odoslané listy sa bežne otvárajú .	otvárajú	8	Plur
V utorok píšeme test z astronómie .	píšeme	2	Plur
“ Ubezpečujem vás , že nič nehrozí , “ kričal žene sultánov hlavný vezír Džafar .	kričal	9	Sing
Na dne oceána sa otriasali vraky lodí a potopené poklady .	otriasali	4	Plur
Ak odpovedala záporne , nenáhlil som sa .	nenáhlil	4	Sing
V dôsledku rímsko - centralistickej tendencie zbierok prevzali do nich zostavovatelia i viaceré úplne alebo čiastočne sfalšované texty , ktoré však svojím obsahom zodpovedali stanoviskám a snaženiam reformátorov .	prevzali	7	Plur
Cez obed som zavolala mame do práce .	zavolala	3	Sing
Rodičia zaujímali miesta naproti sebe , ja som sedával medzi nimi .	zaujímali	1	Plur
Medzitým Mauglí vo vzduchu kričal : “ Pustite ma !	Pustite	7	Plur
Toto dielo vznikalo postupne od konca 10 storočia do počiatku storočia 12 .	vznikalo	2	Sing
So žiarivým trojzubcom v mohutnej ruke sa nad nimi týčila ako predzvesť smrteľných bleskov .	týčila	9	Sing
Rovnako prirodzené bolo , že zablúdila očami k fľaši s vodkou značky Smirnoff na stole .	zablúdila	5	Sing
Ponáhľala som sa , lebo ak pozrú z okna , uvidia , ako sedíme na múre .	uvidia	10	Plur
Marga nechcela , aby sme zobudili Irmu .	zobudili	5	Plur
Vláda bude pri všetkých reformách venovať osobitnú pozornosť tomu , do akej miery navrhované zmeny prispievajú k zníženiu nezamestnanosti a finančnej náročnosti pre daňovníkov a k posilňovaniu motivácie hľadať prácu .	prispievajú	15	Plur
“ Spím , “ odvetilo lekno .	odvetilo	4	Sing
Moje záhady sa vyriešili .	vyriešili	3	Plur
Svätoštefanský zákon pripúšťa , aby sa žena , ktorú manžel za istých okolností opustí , znovu vydala .	vydala	16	Sing
Už na to prišli .	prišli	3	Plur
Parsonsa odviedli .	odviedli	1	Plur
Okolo hučal a bzučal najrôznejší hmyz a v stromoch na plné hrdlo vyspevovali vtáci .	vyspevovali	12	Plur
Začala som s kapitolou o zatmení a snažila sa spomenúť na to , čo som videla .	snažila	7	Sing
Niekoľko dvojíc tancovalo , iní sa bavili pri stoloch a bolo tam veselo i príjemne .	bavili	6	Plur
Šaty boli dlhé , biele a viseli medzi Profesorovými oblekmi .	viseli	6	Plur
Akékoľvek doklady o Fulbertovom ideovom vplyve na Boniperta však chýbajú .	chýbajú	9	Plur
V tejto kapitole budeme hovoriť o cirkevnoprávnych normách , ktoré reglementujú podmienky pre vznik , obsah a zánik manželstva .	reglementujú	10	Plur
“ Prepáč , Herkules .	Prepáč	1	Sing
Potom mu priložila ucho k jej srdcu .	priložila	2	Sing
Keď sa však priblížila , uvidela v tráve svetlovlasé spiace dievčatko v červených šatôčkach .	priblížila	3	Sing
Nech ma Tom netrápi , chcel som jej povedať .	netrápi	3	Sing
" Možno som sa nevyjadril celkom presne , " poznamenal .	poznamenal	9	Sing
Polly sa začervenala a hanblivo klapla zobákom .	klapla	5	Sing
Vtrhli do panského domu ako roj sršňov až sa Maja s Rudkom hanbili .	hanbili	12	Plur
“ Tak uspíme slniečko ! “ navrhla Makulienka .	uspíme	2	Plur
Zvedavo zdvihol hlavu a pýta sa : “ Zdá sa , že ma poznáte ?	zdvihol	1	Sing
A tu či inde sa v úplnej tajnosti nachádzali riadiace mozgy , ktoré koordinovali toto úsilie a určovali politickú líniu : rozhodovali o tom , že tento fragment minulosti sa zachová , tento sa sfalšuje a ďalší prestane jestvovať .	koordinovali	13	Plur
Od tejto chvíle si môžete ľubovoľne vytvárať fotoalbumy s neobmedzeným počtom fotiek .	môžete	4	Plur
Stiahli si zo seba šaty a vliezli do mohutnej mahagónovej postele .	Stiahli	0	Plur
Deti si obľúbia veľký zobák pelikánej slečny a radi sa s ním zahrajú , keď uvidia slová KLIP ‐ KLAP !	zahrajú	12	Plur
Jasajúci diváci ho odniesli na pleciach domov .	odniesli	3	Plur
Keď však videl tých zamyslených zubáčov , nedalo mu to .	nedalo	7	Sing
Ďakujeme Ti za všetko dobré i ťažké , radostné i smutné , povzbudzujúce i skľučujúce , čo s Tvojou pomocou zvládli a prijali vo svojom živote .	zvládli	20	Plur
Je síce pravda , že nijaký súdruh Ogilvy nikdy neexistoval , ale zopár riadkov v tlači a niekoľko vyfabrikovaných fotografií čoskoro splodia jeho existenciu .	splodia	21	Plur
Boris svieti zrkadielkom do očí , končím , “ hlásil vysielačkou Vilko .	hlásil	9	Sing
Na moje kaktusové obdobie som si spomenula celkom nedávno .	spomenula	6	Sing
Približovala sa k nemu zohnutá , popolavo sivá postava , ktorá pripomínala kostlivca .	pripomínala	11	Sing
Nechodieval k nemu nikto okrem stareny v širokých nohaviciach .	Nechodieval	0	Sing
Tu sa jeho snahy stretávali s úsilím miest rostovsko ‐ suzdaľskej oblasti .	stretávali	4	Plur
Roztrhajte jej tvár , roztrhajte jej ju až na kosť .	roztrhajte	4	Plur
Svojim členom nikdy nepomáhame .	nepomáhame	3	Plur
Podľa mojich predstáv sa vracali do pekných domov s vyhrievanými bazénmi .	vracali	4	Plur
Pozrela som na hodinky a zmocnili sa ma obavy .	Pozrela	0	Sing
Na festivale sa predstavia rómske aj nerómske hudobné zoskupenia z celého Slovenska .	predstavia	3	Plur
Bolo zamračené , malo pršať .	malo	3	Sing
Aby mu to nebolo ľúto , zlizol aj on jeden pohlavok ako ostatní .	zlizol	6	Sing
“ Chcem , “ odvetil .	odvetil	4	Sing
Zavolajte a rezervujte .	rezervujte	2	Plur
Dieťa prikývlo , akoby mu rozumelo .	rozumelo	5	Sing
Preleteli sme cez oddelenie topánok , kozmetiky , vyhli sme sa nápadne namaľovaným predavačkám , ktoré ponúkali masky , líčidlá a vzorky kolínskej .	ponúkali	16	Plur
“ Pravú lásku stretnete čoskoro .	stretnete	3	Plur
Často mi vyčítali , že som neskutočne neľudský .	vyčítali	2	Plur
Pokým nás kryjú tieto konáre , sme v bezpečí . "	kryjú	2	Plur
Na chvíľu zadriemali .	zadriemali	2	Plur
“ A teraz mi zaplať ! “ zhúkol na Jazmínu predavač .	zhúkol	7	Sing
“ Ako ti chutí čaj ? “	chutí	3	Sing
“ Vidíš tú maličkú žltú hviezdu ?	Vidíš	1	Sing
Cvrčkovia dali signál a diváci celkom zmĺkli .	zmĺkli	6	Plur
Nemala inú možnosť , keď jej Roger odmietol šteniatka predať .	Nemala	0	Sing
“ Čo to robíte ? “	robíte	3	Plur
V takomto prípade hovoríme o tzv . primárnej prevencii .	hovoríme	3	Plur
Zabili ho spolu s ďalším odsúdencom pri pokuse o útek z väzenia .	Zabili	0	Plur
Mal pocit , že ho v žalúdku páli oheň .	páli	7	Sing
Tu boli zvyknutí vyberané spôsoby a správali sa podľa spoločenských pravidiel .	správali	6	Plur
Stalo sa to len včera večer a Rick sa určite pred chalanmi nevyťahoval , ako vlažne som ho odbila .	odbila	18	Sing
Keď všetko zjedli , plánovali ďalšie vlámanie .	zjedli	2	Plur
Pomaly , sotva lapajúc dych , kráčali vpred .	kráčali	6	Plur
Na hrebeni sa otočil a zaparkoval autom celkom pri okraji cesty .	otočil	3	Sing
Na obidvoch stranách ulice , kde sa chodci náhlili po chodníkoch , parkovali autá .	náhlili	8	Plur
“ My ? “ spýtala som sa .	spýtala	4	Sing
Uteč ! “ kričal .	Uteč	0	Sing
Podarilo sa mi vybehnúť na chodbu , ale tam sa mi podlomili nohy .	podlomili	11	Plur
Z dejinného procesu ťa načisto odstránime .	odstránime	5	Plur
Horace a Jasper sedeli na starej pohovke obklopení tuctami šteniatok a pozerali televíziu .	sedeli	3	Plur
Nič som nevidel .	nevidel	2	Sing
Ten takmer ihneď ustúpil , ibaže zanechal po sebe akýsi zvierací nepokoj .	ustúpil	3	Sing
Keby som tade išiel ako dieťa , určite by som mal chuť zavolať kamarátov z dvora a ísť sa tam hrať „ dole - dole “ .	išiel	3	Sing
Každý pokus o systematizáciu tejto otázky totiž nevyhnutne naráža na kolíziu metódy vedeckého prístupu s rozumovo nedefinovateľným fenoménom náboženstva a viery .	naráža	8	Sing
Ak drží grifon v pazúroch štyri púčky , vyjadruje sa tým jeho všadeprítomnosť .	vyjadruje	8	Sing
“ Otrávte ich , utopte , roztrieskajte im hlavy .	roztrieskajte	6	Plur
“ A to hovoríš ty ! “ zvolala som .	hovoríš	3	Sing
Môj mozog by na to asi nestačil .	nestačil	6	Sing
Podišiel som k oknu , že sa spýtam svojich postáv , čo si o tom myslia .	myslia	15	Plur
Čarodejnica odhrnula vejúci plášť a dobré víly onemeli od hrôzy , keď zbadali Zorničku .	odhrnula	1	Sing
Priadli , priadli až upriadli .	upriadli	4	Plur
Ponúka nám niečo , čo nepotrebujeme .	nepotrebujeme	5	Plur
Ale ona sa nepredvídateľne poponáhľala s odchodom .	poponáhľala	4	Sing
Ja som zazrela na ňu , ona na mňa .	zazrela	2	Sing
V ten deň mi povedala , že sa podobáme na Čechovových provinčných hrdinov .	podobáme	8	Plur
Veľmi sa za to hanbím . “	hanbím	4	Sing
Preto neskrývame obavy , či sa nechytí aj nás táto nemoc .	neskrývame	1	Plur
“ To nemyslíte vážne ! “ rozhorčene zvolal Hanibal .	nemyslíte	2	Plur
“ Chcete povedať , že som herec ? “ pýtal sa Pinocchio .	Chcete	1	Plur
“ Neskáč ! “ kričali naňho ženy a deti a muži zatiaľ uzatvárali stávky .	Neskáč	1	Sing
Jej slová ma prekvapili .	prekvapili	3	Plur
Už dávno dostal prezývku podľa starovekého filozofa a už dávno si nikto nepamätal , ako sa skutočne volá .	nepamätal	12	Sing
Dofajčí ju po smene , ak ju dokáže nevytrúsiť .	Dofajčí	0	Sing
Toľko oblizoval Jazmíne tvár , až ju zadúšalo od smiechu .	zadúšalo	7	Sing
Keď Šer Chán nenašiel v záhyboch Káaovho tela nič , zavrčal .	zavrčal	10	Sing
Winstona vyparia .	vyparia	1	Plur
Tak je po Jaroslavovom víťazstve položený základ novgorodských výsad , ktorí Novgorodcom garantujú ochranu pred kniežacími družiníkmi a Varjagmi / no zároveň zabezpečujú kniežaciu družinu pred ľudom / .	garantujú	12	Plur
Prikývla a povedala , že sa o chvíľu vráti .	vráti	8	Sing
Len čo vošiel dnu , čakali ho tam Kráľovná zla a jej sluhovia .	vošiel	2	Sing
A odtiahla sa odo mňa .	odtiahla	1	Sing
Uznal som za vhodné požiadať ich , aby ma zobudili o pol piatej .	zobudili	9	Plur
Ako sprievodcovia do podsvetia Samojedov slúžia napr . hranostaj a myš .	slúžia	5	Plur
Môže ísť o toporčeky s predĺženým poriskom , ktoré boli v Škandinávií predmetom symbolizujúcim hromy vrhajúceho Thora .	Môže	0	Sing
Miznú tak i zvyšky existencie predkresťanskej náhrady za škodu , nahradzujúce prechodne krvnú pomstu .	Miznú	0	Plur
Dofajčí ju po smene , ak ju dokáže nevytrúsiť .	dokáže	7	Sing
Vcelku ľutujem , že som to neurobil . "	ľutujem	1	Sing
Vyslovil som výraz „ neskutočný “ , povedal som nervózne .	povedal	7	Sing
Zakryte nádobu pokrievkou a nechajte vychladnúť na izbovú teplotu .	Zakryte	0	Plur
Keď preberal znova volant , prikryl mi ruky , ktoré ostali naspodu .	ostali	10	Plur
A odišla , stratila sa v dave .	stratila	3	Sing
Uvedomovali sme si , že „ sa môže “ .	Uvedomovali	0	Plur
Práve sa chystala roztiahnuť krídla a vzlietnuť , keď v tieni steny zbadala strážcu .	chystala	2	Sing
Chvíľu len tak posedával a hlúpo zízal na papier .	posedával	3	Sing
Ten grobian sa usmieval a vraví : “ ' Koho to tu máme ? '	vraví	5	Sing
Išli sme do mojej izby a mne sa podarilo zapáliť piecku .	Išli	0	Plur
Toto posledné konštatovanie sa ma dotklo .	dotklo	5	Sing
Takého odporného tvora ešte nevidela .	nevidela	4	Sing
Abu naňho pozrel .	pozrel	2	Sing
“ Nedopustíme predsa , aby utiekli a varovali netvora , “ povedal ľuďom .	varovali	7	Plur
Ľudia sa však neukázali .	neukázali	3	Plur
Pravdepodobne sa napokon nevyrobili vôbec nijaké topánky .	nevyrobili	3	Plur
“ Fajn , “ odvetil Chris , ale keď prechádzal okolo modelu , rozkrútil prstence Saturna .	rozkrútil	13	Sing
“ Prečo ste neoslavovali aj vy ? “ vypytoval sa Vilko .	neoslavovali	3	Plur
Do nášho podvedomia pomaly a nenápadne ukladá hrdzu , ktorá ukradomky rozožiera našu psychiku .	ukladá	6	Sing
Tú ženu som nepoznal , nikdy som ju nestretol .	nestretol	8	Sing
“ A to je čo ? “ spýtal sa Mauglí .	spýtal	7	Sing
A predovšetkým , nedovoľujeme mŕtvym , aby povstali proti nám .	nedovoľujeme	3	Plur
To sa Vilkovi náramne hodilo .	hodilo	4	Sing
Pri príležitosti svojho odchodu a ukončenia zimného obdobia som vyhlásil , že zaplatím koňak všetkým , ktorí budú od dvanástej až do tretej poobede v kaviarenskej časti obchodu .	budú	17	Plur
“ Čo to tu vidím ? “ zasyčal .	zasyčal	7	Sing
Ani jeden návrh ma nechytil za srdce .	nechytil	4	Sing
Prikývla som a tuhšie ma privinul .	Prikývla	0	Sing
Postavila sa na špičky prstov a pobozkala ma .	pobozkala	6	Sing
Výsledkom bude , že v nijakej oblasti sa nespotrebuje viac zdrojov , ako na ňu bude vyčlenených v rozpočtoch , ktoré schváli NR SR , resp . jednotlivé samosprávne orgány .	nespotrebuje	8	Sing
Vláda si uvedomuje obsah svojho mandátu od voličov .	uvedomuje	2	Sing
Zajac mohol byť vykladaný v systéme predkresťanských názorov jednak ako symbol plodnosti / dodnes spájame na veľkú noc vyobrazenia zajacov s vajíčkami , Nemci počas tohto sviatku hľadajú v záhrade vajíčka ukryté veľkonočným zajacom / .	spájame	14	Plur
Pred zotmením sa vracala domov a na noc starostlivo zatvárala škáročku v strome .	vracala	3	Sing
Aby anonym urobil svoje obvinenie dôveryhodným , uvádzal iniciálky tej ‐ ktorej ženy a z tohto hľadiska mala Marga dôvod podozrievať ma .	uvádzal	7	Sing
Nové , moderné pedagogické postupy v mnohých oblastiach zlyhávajú .	zlyhávajú	8	Plur
Inštitúciou , ktorej človek vďačí za to , že ho vo dne i v noci obklopujú dôverne informovaní špicli .	obklopujú	15	Plur
Vonku sa ozýval bzukot a cvrlikanie , všade poletovali motýle a slniečko krásne prehrievalo zem .	ozýval	2	Sing
Ako si sa sem dostala ?	dostala	4	Sing
Mama postupne napísala otcovi niekoľko listov , ale on jej neodpovedal .	neodpovedal	10	Sing
Nad palácom sa sťahovali ťažké čiernočervené mraky .	sťahovali	3	Plur
Abu sa zamračil a poodišiel nabok od krištáľovej gule .	zamračil	2	Sing
Winston spustil ruky pozdĺž bokov a pomaly nabral vzduch do pľúc .	spustil	1	Sing
Nepýtam sa , či len so mnou .	Nepýtam	0	Sing
Asi verili svojim po zuby ozbrojeným bojovníkom , pred ktorými sa všetci trasú .	verili	1	Plur
Priadli , priadli až upriadli .	priadli	2	Plur
Urobíme nejaké rozbory , určíme liečbu . . .	určíme	4	Plur
Za jasotu spoluobčanov prevzali cenu a Dr . Slimák slzil od dojatia , pretože v tejto súťaži doteraz nijaký slimák nevyhral .	nevyhral	20	Sing
Maja vymyslela lesť .	vymyslela	1	Sing
Vedľa v sieni sa zatiaľ zhromaždenie skončilo a v sršňom meste zavládol pokoj .	skončilo	6	Sing
Deti si obľúbia veľký zobák pelikánej slečny a radi sa s ním zahrajú , keď uvidia slová KLIP ‐ KLAP !	obľúbia	2	Plur
Pomaly vstala a po niekoľkých knísavých krokoch zasa našla rovnováhu .	našla	8	Sing
Na rozdiel od svätoštefanskej legislácie sú tí , ktorí v nedeľu neprídu do kostola , potrestaní prísnejšie – telesným trestom .	neprídu	11	Plur
Všetci smutne hľadeli do prázdneho košíka , kde predtým ležali šteniatka .	ležali	9	Plur
Zastali sme na červenú a Chris sa na mňa usmial .	Zastali	0	Plur
Čakal som márne .	Čakal	0	Sing
Uvedomila som si , že to , čo vravela , mohlo pokojne platiť aj na Chrisa .	Uvedomila	0	Sing
V Oceánii právo nejestvuje .	nejestvuje	3	Sing
Od straníkov sa vyžadoval podobný názor , aký mali starovekí Židia , ktorí síce vedeli , že všetky iné národy uctievajú nepravých bohov , ale to bolo všetko , čo o nich vedeli .	vedeli	14	Plur
Júlia tíško zapišťala , v jej hlase sa ozvalo prekvapenie .	ozvalo	8	Sing
Takýto svet pripravujeme , Winston .	pripravujeme	2	Plur
“ Máte pekné tykadlá , “ povedala .	Máte	1	Plur
Neskôrnateli vnútorne .	Neskôrnateli	0	Plur
A síce , že vôbec nejde o odkaz od Ideopolície , ale od nejakej ilegálnej organizácie .	nejde	5	Sing
Na rozdiel od rodičov som sa Profesora nebál .	nebál	7	Sing
“ Vy máte šťastie ! “ povedala mora Maji , lebo vedela , čo znamená stretnutie so škriatkom kvetov .	máte	2	Plur
“ Chyť volant , “ povedal a otočil sa k zadnému sedadlu , kde mal športový vak .	Chyť	1	Sing
Obsah tvorili nevyberané útoky na maďarskú menšinu žijúcu na Slovensku .	tvorili	1	Plur
Reformátori 11 . storočia však už dospeli k precíznejšej formulácii , ktorá , podľa nás , reprezentuje nimi presadzovanú snahu o čo najpresnejšie vymedzenie sfér vplyvu svetskej a cirkevnej moci .	dospeli	6	Plur
Odmietla , povedala , že nepije alkohol .	nepije	5	Sing
“ Poďte za mnou ! “	Poďte	1	Plur
Rozvinutie tohto nariadenia nachádzame v prvom Kolomanovom zákonníku .	nachádzame	3	Plur
Vilko najprv reptal , ale potom ho Maja nespoznávala .	nespoznávala	8	Sing
Ak im dovolíme , aby na nás zaútočili zo všetkých strán , nikdy sa neubránime .	neubránime	14	Plur
Formulácia „ Volumus , ut episcopi habeant potestatem . . . “ implikuje interpretáciu , že biskupi , vykonávali svoj úrad z vôle panovníka , že on im udeľoval mandát na reálne pôsobenie v ich úrade .	vykonávali	18	Plur
Kalich zvončeka , kde strávila noc , sa knísal vo vetre a bolo tam chladno .	knísal	8	Sing
Kolektívne postupovať nemôžeme .	nemôžeme	2	Plur
Ako kráčal k dverám , mince v mešci príjemne zacinkali .	zacinkali	9	Plur
Medzi tieto nedovolené zamestnania patrilo i krčmárstvo , ktorého vykonávanie zakázali aj ostrihomskí synodálni otcovia .	zakázali	10	Plur
Poskladali sme vlhkú deku , napchali ju do koša , ktorý sme pomaly uväzovali o korman .	uväzovali	13	Plur
Uvedomila som si , že na mňa čaká , a rozbúchalo sa mi srdce .	rozbúchalo	10	Sing
Keď sa o tom dozvie , usporiada slávnostný obed .	usporiada	6	Sing
Vyzeral akoby ho oposkladali z niekoľkých plemien psov .	oposkladali	3	Plur
Toto spoločenstvo nám poskytlo hlboké zážitky , mnoho podnetov na zamyslenie , mnoho motivácie k modlitbám a pocit Božej prítomnosti .	poskytlo	3	Sing
Bol to nádherný okamih : sedeli sme vedľa seba v prítmí autobusu a žlté pouličné osvetlenie ožiarilo Chrisovi tvár .	ožiarilo	16	Sing
Prikývol a naozaj , spočiatku šiel krokom .	šiel	5	Sing
Jazmína otvorila dvere .	otvorila	1	Sing
Keby ste ho nenašli , leťte za slnečným svitom .	nenašli	3	Plur
KDH v januári 2000 zablokovalo vstup SMK do Európskej demokratickej únie .	zablokovalo	4	Sing
Po prehliadke hudobných skupín sa o zábavu postarajú dídžeji .	postarajú	7	Plur
“ Tak tú mágiu sledujme .	sledujme	4	Plur
“ Neskáč ! “ kričali naňho ženy a deti a muži zatiaľ uzatvárali stávky .	uzatvárali	12	Plur
Prinajmenšom ohľadom zlata v peňaženke sa mýlila , obavy som však určite nemal .	mýlila	6	Sing
Keď mravenisku hrozilo nebezpečenstvo , statočne ho bránili .	bránili	7	Plur
Keďže ide o individuálnu záležitosť , škola v tomto dieťaťu veľmi nepomôže .	nepomôže	11	Sing
Opustila strom , ktorý ju chránil , a veľkými oblúkmi letela povetrím .	Opustila	0	Sing
Usmiala sa naňho a potom odišla .	Usmiala	0	Sing
Som chorá , povedala , zomriem .	zomriem	5	Sing
Včielky sa držali za ruky .	držali	2	Plur
“ Otrávte ich , utopte , roztrieskajte im hlavy .	Otrávte	1	Plur
Nemal topánky , veľké špinavé prsty mu vyčnievali z dier na ponožkách .	vyčnievali	7	Plur
Práve došli na okraj malého lesíka .	došli	1	Plur
Nálezy pečatí umožňujú určiť autorstvo , pravosť a čas vzniku dokumentu , dopĺňajú tak informácie o ňom .	dopĺňajú	12	Plur
“ Hneď to bude , “ odvetil .	odvetil	6	Sing
Zvláštni ľudia tam varili neznáme , no voňavé dobroty .	varili	3	Plur
Pokrútil hlavou .	Pokrútil	0	Sing
Podišla som ku kuchynskej doske a zapla rádio .	Podišla	0	Sing
“ Cítil som , že to povieš . “	povieš	6	Sing
Potrebujeme ľudí , ktorí budú ochotní počúvať svojho partnera , budú dostatočne vzdelaní na to , aby dokázali zaujať jasné stanovisko k mnohým problémom súčasnosti .	dokázali	17	Plur
Medzitým prišlo na plaváreň zopár deciek z oddielu a ich hlasy sa ozývali po vykachličkovanom priestore .	ozývali	12	Plur
“ Kam ideme ? “	ideme	2	Plur
Celou cestou domov som sa dívala z okna do tmavej prázdnoty .	dívala	5	Sing
Neprestal zvončeky trhať .	Neprestal	0	Sing
“ Už som veľká , poradím si sama .	poradím	5	Sing
Jachtala som , rýchlo som zavrela notes a strčila ho späť do vaku .	Jachtala	0	Sing
Winstonovi stuhli vnútornosti .	stuhli	1	Plur
Herkules odniesol Meginho ducha k telu .	odniesol	1	Sing
Sopky vreli , vyčíňali búrky a zemetrasenia , svet bol plný zmätku a veľkého zdesenia .	vyčíňali	3	Plur
Dobre sa bavíte ? “ spýtal sa Džafar .	bavíte	2	Plur
Naopak , pamätala si niečo iné : pohľad mojich očí .	pamätala	2	Sing
Prišla i Maja , ktorá cítila zodpovednosť za Vilka .	Prišla	0	Sing
“ Balú , ty žiješ ! “ zvolal Mauglí a hodil sa mu okolo krku .	Balú	1	Plur
Neuspokojme sa s tým , že sme poslali svojím blízkym veľkonočný pozdrav , ale ukážme im ako vyzerá život v nádeji vzkriesenia a víťazstva v Kristu .	ukážme	14	Plur
Zrazu sa nad ňou ktosi tichučko zasmial a akýsi hlások sa jej spýtal : “ Prečo sa bavíte so bzdochou ? “	bavíte	17	Plur
Zrazu v tom tichu zaburácal jeho hlas .	zaburácal	4	Sing
Soni nedodržala našu dohodu , nenapísala nič .	nenapísala	5	Sing
Prikrčená som vyliezla na vrchol strechy , chvíľu som balansovala a opatrne som zliezla na opačnú stranu .	balansovala	9	Sing
Mlčky sme sedeli a dívali sa , ako medená žiara pomaly bledne .	sedeli	2	Plur
Asistovali im naše sestry , ktoré v zariadení pracujú .	pracujú	8	Plur
Hladko som vkĺzla pod vodu a vynorila sa na hladine .	vynorila	6	Sing
Modlime sa a pomáhajme im na ich ceste , aby sa aj ich srdce zapálilo víťazstvom lásky , pravdy , nádeje a života .	Modlime	0	Plur
Na zem padal teplý dážď a obyvatelia Makovej lúky sa skryli .	skryli	10	Plur
Pomyslel som si , že sa nebojí môjho semena .	Pomyslel	0	Sing
Nevytrvali ísť za Pánom Ježišom .	Nevytrvali	0	Plur
Vrátil som sa a znovu som si sadol k stolu .	Vrátil	0	Sing
Maja sa rozbehla za veliteľom mravčieho vojska .	rozbehla	2	Sing
“ To je zbytočné , “ odvetila , prišla za mnou a objala ma okolo pliec .	objala	12	Sing
Dá do hry všetko .	Dá	0	Sing
Odstreľte ma !	Odstreľte	0	Plur
Dokonca mi na krk uviazala bodkovanú šatku , ktorú odvtedy stále nosím .	nosím	11	Sing
Aladin sa prehrabával v starej truhlici .	prehrabával	2	Sing
Sopky vreli , vyčíňali búrky a zemetrasenia , svet bol plný zmätku a veľkého zdesenia .	vyčíňali	3	Plur
“ Nepridátete sa ku mne , Alia ?	Nepridátete	1	Plur
Mnohí z nás s nimi nadviazali hlboké priateľstvá , spoznali sme ich krehučké duše prahnúce po láske , priateľstve a uznaní .	spoznali	9	Plur
Napísali ho ceruzkou .	Napísali	0	Plur
Podišli sme k pultu , kde som objednala tortillu so syrom .	Podišli	0	Plur
" Ľutujem , " podotkol Winston .	podotkol	4	Sing
Pekne začali , ale zle skončili .	skončili	5	Plur
Najvýraznejšie sa prvky predkresťanských systémov prejavil v severoruských oblastich .	prejavil	5	Plur
Ako starý priateľ tvojho nebohého otca považujem za potrebné , aby sme sa porozprávali celkom otvorene .	považujem	6	Sing
Mnohí z nás s nimi nadviazali hlboké priateľstvá , spoznali sme ich krehučké duše prahnúce po láske , priateľstve a uznaní .	nadviazali	5	Plur
“ Cvičíme . “	Cvičíme	1	Plur
O tom , že si v nich počínajú veľmi dobre , svedčia niektoré úspechy .	počínajú	7	Plur
S ťažkým srdcom sa Herkules lúčil s rodičmi a oni ho s ťažkým srdcom púšťali .	púšťali	14	Plur
“ Odišla , “ povedal škriatok .	Odišla	1	Sing
A v mozgu sa mi vynorila zabudnutá scéna .	vynorila	5	Sing
Neostanú však verní fanúšikovia skrátka .	Neostanú	0	Plur
Víťazoslávne na nich hľadela a pritom sa škodoradostne rehotala .	rehotala	8	Sing
V útrobách pocítil zamrazenie .	pocítil	2	Sing
Systematicky podrýva súdržnosť rodiny , zato svojho vodcu označuje pomenovaním , ktoré priamo vyvoláva pocity rodinnej vernosti .	podrýva	1	Sing
Dohodneme sa ? “	Dohodneme	0	Plur
Vari ho špehuje ?	špehuje	2	Sing
Nič sme o sebe nevedeli .	nevedeli	4	Plur
Duchovia sa však v tomto prípade nechcú objaviť — boja sa kríža , ktorý má Novgorodec pri sebe .	nechcú	6	Plur
“ Čo sa s tebou deje , Amy ? “ vypytoval sa ma po pretekoch tréner August a odviedol ma nabok , kým ostatní nastupovali do autobusu .	vypytoval	10	Sing
Snažili sa zachytiť každučké jeho slovo .	Snažili	0	Plur
Zelený tvor sa na Maju bezočivo díval veľkými , ale dobrosrdečnými očami .	díval	6	Sing
Teplé letné dni sa skončili a mladé včielky prvý raz zažili jeseň .	zažili	10	Plur
Pomyslel som si , že keď ju tam zvalili a vláčili po uliciach , podarilo sa jej nejako utiecť , ako utekajú sochy , a prišla sa postaviť sem .	zvalili	8	Plur
Winstona vyparia .	vyparia	1	Plur
Potkany by ho určite napadli a zakrátko by ho obžrali na kosť .	obžrali	9	Plur
Robili taký rámus , že sa ich rev ozýval široko ‐ ďaleko po celej džungli .	Robili	0	Plur
Nemohla sa dočkať , kedy preberieme moje citové záležitosti , a tak prišla k nám .	preberieme	5	Plur
Moja trpezlivosť sa vyčerpala , keď ručičky na hodinkách stihli ukázať pol dvanástej a mne sa nikto nevenoval .	stihli	9	Plur
“ Tu strávime noc .	strávime	2	Plur
V šalátovej mise zmiešajte olej , korenie , soľ , uhorku , cibuľu , petržlenovú vňať a bazalku .	zmiešajte	3	Plur
Maja dobre poznala Fridolína .	poznala	2	Sing
Keby som bol prehltol tú návnadu , moje postavy by ma boli priviedli do hrobu .	priviedli	12	Plur
Spolu sme sa potichučky vyšplhali na studenú strechu , a ako dvaja námesačníci sme vyliezli až hore .	vyšplhali	4	Plur
Sexuálne puritánstvo Strany im nikto nevnútil .	nevnútil	5	Sing
Všetka moc , všetky zbrane , ktoré Ho chceli zlikvidovať , sú nanič .	chceli	8	Plur
Aj Maja so škriatkom opustili topoľ a leteli , kým nedoleteli k domu , kde sa v oknách ešte svietilo .	nedoleteli	10	Plur
Všetky zvieratká bežali do bezpečia , no Polly letela po zobák vody .	bežali	2	Plur
Zasmiala sa .	Zasmiala	0	Sing
Na Makovej lúke sa nič nedialo , a tak zamierila do lesa .	zamierila	9	Sing
Učili sa poznávať všetky jesenné farby kvetov a každé ráno kontrolovali na teplomeri teplotu .	Učili	0	Plur
“ Musíte to urobiť ešte dnes ! “ skríkla na nich Cruella .	skríkla	8	Sing
Raz zaútočil na tlupu ich odveký nepriateľ Sabor .	zaútočil	1	Sing
Husté čierne vlasy jej padali na plecia a zakrývali tvár .	zakrývali	8	Plur
Všetky formality vytrvalo vybavila naša kurátorka Justína Petrová , ktorá v tomto smere nepozná prekážky .	vybavila	3	Sing
“ Má ťažký otras mozgu , “ určila sestra diagnózu .	určila	7	Sing
Chvíľu ho nechali metať sa vo vode , no potom prilákali k studni muža , čo okopával záhradku .	prilákali	10	Plur
Odtiahol som kameru .	Odtiahol	0	Sing
“ Ďakujem , “ povedala som , lebo nič lepšie mi nenapadlo .	nenapadlo	11	Sing
Zrazu z domu vybehol neznámy muž .	vybehol	3	Sing
Zatriasli námesačníkom a prezradili mu , kto je zlodej .	prezradili	3	Plur
Aladin hodil Rasoulovi horúcu špajľu a ten ju bez rozmýšľania chytil .	chytil	10	Sing
Počul som , že noviny platia dobre , keď chcú .	chcú	9	Plur
“ Zničíme ho ! “ zahrmeli Titan Skala , Titan Sopka , Titan Ľadovec , Titan Tornádo a jednooký Kyklop , keď po jednom vychádzali z jaskyne .	Zničíme	1	Plur
“ Učme sa spolu , “ navrhol Chris .	Učme	1	Plur
Súžitie etník tu teda fungovalo na princípe spoločenstiev v ktorých jednotlivé zložky popri sebe slobodne existovali a zároveň sa ovplyvňovali , miešali a splývali .	miešali	21	Plur
Videl svoj pád v celej hĺbke , pocítil svoj hriech v celej jeho veľkosti .	pocítil	7	Sing
“ Môžem si to ešte rozmyslieť ? “ spýtala sa .	Môžem	1	Sing
Opice skákali z konára na konár a preskakovali koruny stromov , čo rástli pozdĺž brehu rieky .	preskakovali	7	Plur
“ Spomínam si , Ferdo , “ povedal tenkým hláskom .	Spomínam	1	Sing
Zrazu vdýchla sladučkú jemnú vôňu a pustila sa za ňou .	pustila	6	Sing
Poznal som naspamäť všetky Čechovove poviedky a novely , ktoré vyšli v albánčine .	vyšli	10	Plur
Na druhej strane niektoré slová poukazovali úprimne a s pohŕdaním na skutočný charakter oceánskej spoločnosti .	poukazovali	5	Plur
Do tej sa odhadzovala makulatúra .	odhadzovala	3	Sing
“ Chceš povedať , že s tým nemôžeš niečo urobiť ? “ pýtal sa zúfalý Herkules .	pýtal	12	Sing
Boli štyri hodiny popoludní a opäť začalo pršať .	Boli	0	Plur
Ide teda , takpovediac , o problém výchovný .	Ide	0	Sing
Ozval sa melodický piskot a na leknový list sa zniesol jemný priesvitný tieň .	Ozval	0	Sing
Mravce dovliekli celý kôš dobrôt , včielky priniesli ovocný medovník a Kasandra jazmínové želé .	priniesli	7	Plur
Potrebovali sme istý čas , kým sme pochopili , že takáto pretvárka znamená zbytočné utrpenie .	Potrebovali	0	Plur
Súžitie etník tu teda fungovalo na princípe spoločenstiev v ktorých jednotlivé zložky popri sebe slobodne existovali a zároveň sa ovplyvňovali , miešali a splývali .	splývali	23	Plur
Stiahol kombinézu nabok a prezeral si jej hladký , biely bok .	Stiahol	0	Sing
Pritúľte sa k sebe tantricky !	Pritúľte	0	Plur
“ Postavíme ti maštal , chuchlík , “ povedal som mu .	Postavíme	1	Plur
Priplávala som ku kovovým schodíkom a s námahou som vystupovala von , keď ma striaslo .	Priplávala	0	Sing
My takéto chyby nerobíme .	nerobíme	3	Plur
“ A teraz mi zaplať ! “ zhúkol na Jazmínu predavač .	zaplať	4	Sing
A tu či inde sa v úplnej tajnosti nachádzali riadiace mozgy , ktoré koordinovali toto úsilie a určovali politickú líniu : rozhodovali o tom , že tento fragment minulosti sa zachová , tento sa sfalšuje a ďalší prestane jestvovať .	zachová	30	Sing
Keďže v mojej spálni bolo v tej chvíli len negramotné dieťa , odpísala som : " Skuste to osobne , mozno to zaberie .	zaberie	22	Sing
Miloval Veľkého brata .	Miloval	0	Sing
“ Nijaké záhady sa nekonajú , “ odvetil Chris .	nekonajú	4	Plur
Cítila som , že sa pohybujú , ako keby mi chceli prezradiť nejaké tajomstvo .	chceli	10	Plur
Cirkevný trest spočíva v pokání .	spočíva	2	Sing
Je celkom možné , že ho pri odchode hliadka chytí ; možno už teraz naňho vonku čakajú .	čakajú	16	Plur
Nikto ma nikam nepredvolal .	nepredvolal	3	Sing
Zvončeky popadali na zem ako vodopád .	popadali	1	Plur
Netušila som , že počúvajú , ale zrazu všetci hýrili nápadmi .	počúvajú	4	Plur
Ak sa neponáhľate , počkajte chvíľu . “	počkajte	4	Plur
Mám ženu a tri deti .	Mám	0	Sing
Vtáky spievajú , proleti spievajú , Strana nespieva .	spievajú	4	Plur
Netrvalo dlho a predsedov príklad nasledovali súčasne Sabri aj veterinárny technik .	Netrvalo	0	Sing
Obaja sme na okamih upreli zrak na pohybujúce sa svetlo .	upreli	4	Plur
" Vlastne by to na veci nič nezmenilo , " poznamenal .	nezmenilo	7	Sing
A milovali sme sa druhý raz .	milovali	1	Plur
Ak im dovolíme , aby na nás zaútočili zo všetkých strán , nikdy sa neubránime .	dovolíme	2	Plur
Bol to pochmúrny deň , oblaky viseli nízko , smerom k močiaru udierali blesky .	viseli	6	Plur
Všetky slony rýchlo zdvihli choboty .	zdvihli	3	Plur
Priplávala som ku kovovým schodíkom a s námahou som vystupovala von , keď ma striaslo .	vystupovala	9	Sing
V noci sme sa hodiny rozprávali , hovorili sme o všetkom , čo nám napadlo .	rozprávali	5	Plur
Roztiahni krídla a leť .	leť	3	Sing
“ Uf ! “ zamrmlala som .	zamrmlala	4	Sing
Na tomto mieste sa niť mojich úvah zamotala .	zamotala	7	Sing
My sme mravce smelé , my sa nezľakneme .	nezľakneme	7	Plur
“ Zachránil som ťa pred riekou , ale čo si teraz s tebou počnem ?	počnem	13	Sing
Zapojte sa aktívne do zborového života , príjmite pozvanie mládeže , navštevujte tento chrám , prichádzajte k Večeri Pánovej .	Zapojte	0	Plur
Po kráľovskej hostine , na ktorú mravce priniesli obrie porcie špagiet s voškovou omáčkou , si všetci políhali na slniečko , aby si oddýchli .	políhali	17	Plur
Napriek tomu som túžil , aby sme sa takto vliekli nekonečne dlho .	vliekli	9	Plur
Malé dieťa sedelo s ockom pri večeri .	sedelo	2	Sing
Dozvedel som sa a stále tomu neviem uveriť .	Dozvedel	0	Sing
Nedýchala som , lebo skúmavo na mňa pozeral .	Nedýchala	0	Sing
“ Prestaň , “ povedala rázne .	Prestaň	1	Sing
“ Abu , dnes sa dobre najeme ! “ povedal Aladin .	najeme	6	Plur
Tá správa bola jasná : jej telo túži po mojom tele .	túži	7	Sing
Jazmína vystrúhala grimasu .	vystrúhala	1	Sing
Kedy sa zmenili Rickove city ku mne a prečo som si to nevšimla ?	zmenili	2	Plur
Odfukujeme v spoločnosti braníckej desiatky .	Odfukujeme	0	Plur
Noviny ste zabudli v kaviarni , letáky neznášate .	neznášate	7	Plur
“ Možno spolu na niečo prídeme .	prídeme	5	Plur
Zoskočili sme naraz .	Zoskočili	0	Plur
“ A volali ste políciu ? “ spýtala sa Cruella .	volali	2	Plur
Včielky sa o to starajú .	starajú	4	Plur
V tej chvíli zažiarilo v miestnosti zlovestné zelené svetlo .	zažiarilo	3	Sing
Hrabala som sa vo vaku a hľadala som bundu .	Hrabala	0	Sing
Ten film vysielali veľmi zriedka .	vysielali	2	Plur
Možno to , čo sa potom stalo , zvalím na mesiac .	zvalím	8	Sing
V ten večer sa v paláci zhromaždili všetci dvorania , keď princezná Zornička tancovala s princom Filipom .	zhromaždili	6	Plur
Skutočnosť , ktorú mi Lori oznámila , bola jednoduchá .	oznámila	5	Sing
Ani nad záhadnými delegáciami , ktoré ma prišli navštíviť .	prišli	7	Plur
Rodičom sa však taký vývoj udalostí nepáčil a zišli sa na porade .	zišli	8	Plur
Oči ma neklamali .	neklamali	2	Plur
Kývol na sluhu a niečo mu zašepkal .	Kývol	0	Sing
“ Maj sa , princ Ali Abubu ! “ kričal za ním Džafar .	kričal	9	Sing
Väčšinou sedávame na okne za záclonou alebo v kúte izby a sledujeme ho .	sedávame	1	Plur
Džin im naliali do porcelánových šálok bez ucha .	naliali	2	Plur
Vystrela k nemu zdravú ruku a on jej pomohol na nohy .	Vystrela	0	Sing
“ Mauglí je v bezpečí , “ zakričal Dizzy Balúovi .	zakričal	7	Sing
Letné prázdniny sa chýlili ku koncu .	chýlili	3	Plur
Tigríča sledovalo , ako sa rozkotúľali , a skočilo medzi ne !	rozkotúľali	5	Plur
Najbližšie číslo časopisu Patmos pripravíme ku koncu školského roku .	pripravíme	4	Plur
Podľa nich klerici sa nielenže nesmeli opíjať , ale mali aj povinnosť brániť veriacim v prehnanom požívaní opojných nápojov .	nesmeli	5	Plur
Aladina raz z Rahimovho obchodu vyhnali , keď sa Abu usiloval chvostom potiahnuť trs banánov .	vyhnali	5	Plur
TRAVOLTA OPäŤ SPIEVA	SPIEVA	2	Sing
V izbe som našla len Zhlúpnutého Sokrata .	našla	3	Sing
Marga odchádzala , strácala sa v dave , autobus ju viezol do ktorejsi dediny v nížine .	strácala	3	Sing
Keď sme vychádzali z izby , že pôjdeme k autu , uvidel som vec , ktorá zvrátila ten večer nepredvídaným smerom .	vychádzali	2	Plur
Vždy mu odporovala , keď povedal niečo podobné .	odporovala	2	Sing
Navoskované hlavičky zápaliek chránia pred namočením .	chránia	3	Plur
Zvedavo zdvihol hlavu a pýta sa : “ Zdá sa , že ma poznáte ?	poznáte	13	Plur
“ Ako môžem byť múdra , keď ustavične meliete , “ odvrkla Maja .	meliete	8	Plur
Ako teda vysvetliť , že žobráci touto zónou opovrhujú ?	opovrhujú	8	Plur
Vlečiete sa ako slimáky !	Vlečiete	0	Plur
Bál som sa , že zloží slúchadlo , a tak som sa usiloval rýchlo niečo vymyslieť .	zloží	5	Sing
Musíš ísť na Olymp , musíš ho zastaviť . “	musíš	5	Sing
Musím vymyslieť nejakú tajnú skrýšu , kam ťa cez deň ukryjem .	ukryjem	10	Sing
Nazlostený Flip sa jediným obrovským skokom preniesol k pavučine .	preniesol	6	Sing
Aladin pritiahol stoličky a psi na ne vyskočili .	vyskočili	7	Plur
Uvedomila som si , že to , čo vravela , mohlo pokojne platiť aj na Chrisa .	mohlo	10	Sing
Ten telnatý muž sa ma nič nevypytoval .	nevypytoval	6	Sing
V tej chvíli zišiel zo svojho ležoviska na strome Baghíra , ktorý pozorne počúval všetko , čo sa vravelo .	zišiel	3	Sing
Teraz musím publikovať .	musím	1	Sing
Pred dvermi sa objavovali košíky s prekrásnymi plodmi od výmyslu sveta .	objavovali	3	Plur
Zavedie štátnu maturitnú skúšku na stredných školách .	Zavedie	0	Sing
Hladko som vkĺzla pod vodu a vynorila sa na hladine .	vkĺzla	2	Sing
Na Makovej lúke panovalo ticho .	panovalo	3	Sing
Pokúšala by sa presvedčiť ma , že nemá zmysel rozčuľovať sa .	Pokúšala	0	Sing
“ Dúfam , že si nemala problémy , Amy , “ zašepkal .	zašepkal	11	Sing
Len čo sa jej dotkol , myklo ňou a akoby zmeravela .	myklo	6	Sing
Chcela som , aby bral život trocha vážnejšie .	Chcela	0	Sing
Jill a tri plavkyne z plaveckého oddielu Žralokov otvárali vo vode oči , keď som sa vyšvihla hore .	otvárali	8	Plur
“ Počkajte , chvíľu .	Počkajte	1	Plur
Vo Winstonovi zápasili zvláštne pocity .	zápasili	2	Plur
Čujte , čujte !	čujte	2	Plur
Ohrozené boli mestá Brazzaville a Leopoldville . Človek sa nepotreboval pozrieť na mapu , aby vedel , čo to znamená .	vedel	15	Sing
Kompletný program 3 . Gay Film Festivalu Slovakia nájdete na Film Site v rubrike Ceny a festivaly .	nájdete	8	Plur
Na prvý pohľad je tu zrejmá podobnosť so znením kánonov , ktoré sa týkajú rehoľníkov .	týkajú	13	Plur
Vyzerajú ako šťastná dvojica ! “ zvolala prekvapená Sandra .	zvolala	6	Sing
V škole sme sa už nemilovali .	nemilovali	5	Plur
Trávniky sa premenia na oceány bahna a autá uviaznu pred domami .	uviaznu	8	Plur
Práve sme sa pomilovali .	pomilovali	3	Plur
Touto syntézou môžme vysvetliť mnohé osobitosti hospodárskeho i politického života oblasti .	môžme	2	Plur
Generál zreval : “ Bojujte ako levy ! “	Bojujte	4	Plur
Hoci sme to nechceli !	nechceli	3	Plur
“ Vidím , že nič neviete o našom žartíku .	neviete	5	Plur
Bol to nádherný okamih : sedeli sme vedľa seba v prítmí autobusu a žlté pouličné osvetlenie ožiarilo Chrisovi tvár .	sedeli	5	Plur
Tradičnú retrospektívnu sekciu programovo každý rok napĺňajú filmy zástupcov jednotlivých krajín všetkých troch zúčastnených kinematografií .	napĺňajú	6	Plur
Pani Parsonsovú vyparia .	vyparia	2	Plur
Niektoré úmrtia tak akosi predpokladáme , ľudia sa k nim systematicky dopracovávajú .	dopracovávajú	11	Plur
“ Určite hľadáte Fawada , obchodníka so šperkami , “ povedala , keď k nej podišli .	podišli	15	Plur
Osobitne by sme si chceli povšimnúť právne normy , v ktorých ide o odvádzanie desiatku klérom .	chceli	4	Plur
S čím som mala súhlasiť ? “ nechápala som .	nechápala	7	Sing
Na okraji Tirany , keď sme prechádzali cez predmestie Lapraka , uviazli sme na križovatke .	prechádzali	6	Plur
Pili sme víno .	Pili	0	Plur
Winstona sa zmocnila úzkosť .	zmocnila	2	Sing
V prúde krvi a slín mu z úst vypadli dve polovice zubnej protézy .	vypadli	8	Plur
Len spomedzi študentov náročnej školy vzídu študenti , ktorí sa dokážu presadiť v silnej konkurencii .	dokážu	10	Plur
Celý deň som snívala len o ňom .	snívala	3	Sing
Nemyslite si , že nepôjdu .	Nemyslite	0	Plur
Ako vyzerajú ?	vyzerajú	1	Plur
Chcem poďakovať aj sestrám , ktoré sa podieľajú na upratovaní nášho chrámu .	podieľajú	7	Plur
“ Nechceš ochutnať ? “ spýtala sa bosorka .	Nechceš	1	Sing
“ Nech ti nelepí , vyhnem sa ti , ak sa vyhneš ty mne !	nelepí	3	Sing
Ide o autografy Kosťu a Vojatu so schematicky načrtnutými krížmi .	Ide	0	Sing
Keď sa napokon obzrela , škriatka už nebolo .	nebolo	7	Sing
Tyranizuje nás ťaživou krásou obrazov .	Tyranizuje	0	Sing
Šľahali okolo nej , no zakaždým ju o vlások minuli .	Šľahali	0	Plur
Nečudujem sa , že výborne urobil záverečné ročníkové testy .	Nečudujem	0	Sing
Neničíme kacíra preto , že nám odporuje ; pokým nám odporuje , neničíme ho .	Neničíme	0	Plur
Všimnime si audiotextové reklamy .	Všimnime	0	Plur
Stáli pred obrazovkou .	Stáli	0	Plur
“ Čo tu tak príšerne smrdí ? “ čudovala sa Maja .	čudovala	8	Sing
Nateraz sa uzavrel pred vzdialenejšími zvukmi a počúval len kvákanie , ktoré sa valilo z obrazovky .	valilo	13	Sing
Poletím za tebou , “ povedal Vilko , obrátil sa na bok a zaspal .	Poletím	0	Sing
Bežali kľukatými cestičkami , až prišli k prijímacej sieni .	Bežali	0	Plur
V takom prípade som vedel , čo mi povedia .	povedia	8	Plur
Miestnosť bola priveľmi stiesnená , lebo všetky steny dookola podopierali nespočítateľné množstvo zaprášených rámov naukladaných jeden na druhý .	podopierali	9	Plur
“ Máte Baghírovo slovo , “ dodal .	dodal	6	Sing
Chcem byť tvojím kňazom , povedal som jej .	povedal	5	Sing
Nerob to ! “ zvolal Aladin .	zvolal	4	Sing
A nohy ma priviedli do obchodu , kde predávali alkoholické nápoje .	priviedli	3	Plur
“ Ospravedlníte ma na chvíľu ? “ spýtala sa .	Ospravedlníte	1	Plur
Zefektívnime kontrolu a elimináciu stále rozšíreného zneužívania štátnej pomoci .	Zefektívnime	0	Plur
Uršuľa sa usmievala , keď princa ťahali na morské dno .	ťahali	6	Plur
V jeho mysli sa vôňa spájala neoddeliteľne so smilstvom .	spájala	5	Sing
“ Toto robia ľudia každý deň ? “ čudovala sa .	robia	2	Plur
Zviera síce svojím výzorom naháňalo hrôzu , no Gaston bol presvedčený , že ho aj tak zabije a Bela oľutuje deň , keď sa zaňho odmietla vydať .	zabije	16	Sing
“ Môžeš , “ odvetilo sloníča .	Môžeš	1	Sing
“ Niet za čo , to je predsa samozrejmé , “ skromne odvetil Chrabroš .	odvetil	12	Sing
Vtom sa mu zlatisté oči rozžiarili .	rozžiarili	5	Plur
Cítil som sa ako vidiečan , ktorý prvýkrát prišiel do hlavného mesta .	Cítil	0	Sing
Obaja rýchlo dýchali , ale okolo kútikov úst sa jej znovu objavil úsmev .	dýchali	2	Plur
Prepáčte , musím vám niečo povedať .	Prepáčte	0	Plur
Biely vždy dáva mat .	dáva	2	Sing
Spomenula som si na Blythe .	Spomenula	0	Sing
Počkajte , na okamih vás vyrušíme !	Počkajte	0	Plur
Nepretrvá . "	Nepretrvá	0	Sing
Paravojenské oddiely pritom zabíjali a vyháňali nesrbských civilistov .	zabíjali	3	Plur
Vtedy sa Profesor opäť púšťal do práce .	púšťal	4	Sing
Cítila som , že sa červenám .	Cítila	0	Sing
Hru , ktorú hráme , nemôžeme vyhrať .	hráme	3	Plur
Uprene si navzájom hľadeli do očí .	hľadeli	3	Plur
A uzlovým bodom všetkých právnych formúl , ktoré sa týkajú rozoberaných hnutí , je vzťah tohto spoločenstva k štátnej moci , t . j . stret sveta šamanistického dualizmu s predstaviteľmi kniežacej moci , zjednocujúcimi krajinu .	týkajú	9	Plur
Nezhromaždilo sa tam veľa ľudí .	Nezhromaždilo	0	Sing
Možno to , čo sa potom stalo , zvalím na mesiac .	stalo	6	Sing
Opice skákali z konára na konár a preskakovali koruny stromov , čo rástli pozdĺž brehu rieky .	rástli	12	Plur
A vtedy ho omráčila tá myšlienka . . .	omráčila	3	Sing
“ Cítil som , že ma čoskoro prepustí . “	Cítil	1	Sing
Iba my s Chrisom sme tak zúrivo nepísali a nehrbili sa nad lavicami .	nehrbili	9	Plur
Pinta je predsa polovica štvrtky a štyri štvrtky idú do galóna .	idú	8	Plur
Nadýchol sa .	Nadýchol	0	Sing
“ Mhm , nehovorte tak , “ namietal lúčny koník Flip .	nehovorte	3	Plur
Chytil ma za ruku a bežali sme dolu kopcom až k svetlám .	bežali	5	Plur
Vari letím do mravčieho neba ?	letím	1	Sing
Súčasnému vedúcemu katery doc . M . Danišovi patrí okrem toho aj moje srdečné poďakovanie za vytrvalú a všestrannú podporu pri vydaní tejto knihy .	patrí	8	Sing
“ Čo sa deje ? “ spýtal sa Chris , hoci sme to obaja vedeli .	deje	3	Sing
Chichúňali sme sa ako pojašení , prebehli sme cez trávnik a smerovali k múru .	prebehli	6	Plur
Tak si to želá Sergejova stará matka .	želá	3	Sing
S kŕdľami strák , ktoré poletovali po pustom parku pri Domove dôstojníkov .	poletovali	5	Plur
Strhol sa ukrutný víchor .	Strhol	0	Sing
" Len prechádzam , " odvetil neurčito Winston .	prechádzam	2	Sing
Začiatkom týždňa sme písali ďalší test a profesor Tayerle nám ho dnes priniesol opravený .	písali	3	Plur
Taniere obložte hlávkovým šalátom , na ktorý servírujte kuskus a zeleninovú zmes .	obložte	1	Plur
Naozaj stenám , ale ty si to , preboha , poriadne zveličil .	zveličil	11	Sing
“ A ďakujem , že ste tu zdržali to ľudské mláďa . “	zdržali	7	Plur
Radža zdvihol hlavu a hrozivo zavrčal .	zdvihol	1	Sing
Nemajú čas ani myseľ na spory , ktoré by mohli vyplynúť z ich odlišných vyznaní .	Nemajú	0	Plur
Zničíme ho ! “ kričali .	kričali	4	Plur
Netušili , čo to znamená a čoskoro sa dostali do úzkych .	Netušili	0	Plur
Irma neuverí rozprávkam , vyľaká sa .	vyľaká	4	Sing
Väčšie zlá sústavne unikali ich pozornosti .	unikali	3	Plur
“ Čo sa s tebou deje , Amy ? “ vypytoval sa ma po pretekoch tréner August a odviedol ma nabok , kým ostatní nastupovali do autobusu .	nastupovali	24	Plur
Zabočila za roh a pridala plyn .	pridala	4	Sing
“ To my poznáme , “ povedal Flaps .	poznáme	3	Plur
Vnútri bolo teplúčko a sucho a voňali tam hríby .	voňali	6	Plur
Títo Sosolci tiahnú proti Rusom , plienia ruský oporný bod Jurjev a útočia na Pskov .	útočia	12	Plur
Odpovedala mi vyhýbavo .	Odpovedala	0	Sing
Hmotný svet existuje , jeho zákony sa nemenia .	nemenia	7	Plur
Ak muža s tvárou umrlca odviedli o polnoci , bolo ráno , ak ráno , bolo popoludnie .	odviedli	5	Plur
“ Nejdeme domov , “ odvetil Baghíra .	Nejdeme	1	Plur
Mama postupne napísala otcovi niekoľko listov , ale on jej neodpovedal .	napísala	2	Sing
Poprosil som Lori , aby sme odišli .	odišli	6	Plur
Vyrába umelé potreby , ktoré nás aktivujú , vyprázdňujú , ničia a zotročujú .	vyprázdňujú	8	Plur
Tieto slová básne sú melódiou toho , čo sme cítili v srdciach .	cítili	9	Plur
Pripomínali mi najdaromnejšie obdobie môjho života .	Pripomínali	0	Plur
Potom dodala známu vec s ujom a v priestore môjho mozgu zaburácalo slovo „ impotent “ .	dodala	1	Sing
Stretli sme sa o týždeň .	Stretli	0	Plur
Zdôrazňoval pritom výsadné postavenie apoštolom Petrom založenej rímskej cirkvi a Apoštolského stolca .	Zdôrazňoval	0	Sing
Potlačila som zívnutie .	Potlačila	0	Sing
“ Švihaj , Dean ! “ zakričal Rýchlik .	Švihaj	1	Sing
Brat kantor pre vážne osobné dôvody nemohol prísť , preto brat farár sprevádzal nábožný spev na gitare spolu s mládežníkmi , ktorí poslúžili programom a vystúpili aj s osobným vyznaním .	vystúpili	25	Plur
Povrávalo sa , že aj samotného Goldsteina tam pred rokmi a desiatkami rokov niekoľkokrát videli .	videli	14	Plur
Mauglí veselo poskakoval vedľa medveďa .	poskakoval	2	Sing
Teraz ma prenasledovatelia chytia , pomyslel si Ferdo .	chytia	3	Plur
Kráčal ďalej .	Kráčal	0	Sing
Chytil Balúovi hlavu a nežne ju hladkal .	Chytil	0	Sing
Ak mám byť úprimná , ešte včera by som odušu písala ako ostatní spolužiaci .	mám	1	Sing
Keď víly nechali princeznú na chvíľočku v paláci osamote , zjavilo sa pred ňou jagavé svetlo .	nechali	2	Plur
Všetci sme sa podobali na postavy absurdného divadla .	podobali	3	Plur
Ostatní ho nasledovali .	nasledovali	2	Plur
“ Tuším pôjdeme zajtra zasa po žobraní .	pôjdeme	2	Plur
“ Vážne som chcela ísť po tréningu za tebou , ale vyfučalo mi to z hlavy .	vyfučalo	11	Sing
Alfonz zakričal : “ Neuveriteľné !	zakričal	1	Sing
Na spoločnom výlete niekde v Kente zablúdili .	zablúdili	6	Plur
Kým som ich mal tajne odložené , stelesňovali moju vinu .	stelesňovali	7	Plur
“ Hádes nás zabije , keď to zistí ! “	zistí	7	Sing
Volám sa Sergej .	Volám	0	Sing
Premáhal ho spánok .	Premáhal	0	Sing
Neodpovedali mi .	Neodpovedali	0	Plur
Kala pozrela do domu a zbadala stopy po zápase .	pozrela	1	Sing
A strechu Džahijovej chatrče strhla púštna búrka .	strhla	4	Sing
Prsty sa jej skrivili a nechty sa premenili na zahnuté pazúriská .	skrivili	3	Plur
Nespomínali moje ruské dobrodružstvo .	Nespomínali	0	Plur
Možno moje postavy vedia hrať šach .	vedia	3	Plur
Nemohli sme k nej chodievať , ani ona nemohla chodievať k nám .	Nemohli	0	Plur
Otvoril mešec a vysypal zlaté mince na zem .	Otvoril	0	Sing
“ Počkaj , “ povedal , vyzul si tenisku a vylial z nej vodu na trávnik .	Počkaj	1	Sing
Možno sa tam jedného dňa vráti .	vráti	5	Sing
Utekala som , čo mi nohy stačili .	stačili	6	Plur
Spolu s ním ma objala aj Irma a obidvaja sa rozvzlykali .	rozvzlykali	10	Plur
Spočiatku som mala nepríjemný pocit , že sa na mňa všetci dívajú , ale trvalo to len moment .	dívajú	11	Plur
Vnútil mi liace a koč s tým divým koňom .	Vnútil	0	Sing
Tu dávam povely ja ! “	dávam	1	Sing
Ponáhľala som sa , lebo ak pozrú z okna , uvidia , ako sedíme na múre .	pozrú	6	Plur
Odlož masku , povedal som mu .	povedal	3	Sing
Obeste ma !	Obeste	0	Plur
V skutočnosti sa vyplácali iba malé sumy a výhercovia veľkých výhier neexistovali .	vyplácali	3	Plur
Ak mám byť úprimná , ešte včera by som odušu písala ako ostatní spolužiaci .	písala	10	Sing
“ Tak čo je ? “ spýtal sa .	spýtal	6	Sing
“ Pán Shepherd , “ povedal profesor Tayerle a kývol rukou , “ nemyslite si , že som nevidel lístok , ktorý ste dali pred chvíľou slečne Wyseovej .	kývol	9	Sing
Uršuľa sa zahnala trojzubcom .	zahnala	2	Sing
Neskôr mi Sergej povedal , že obyvatelia vily volajú toho muža Cerberus .	volajú	8	Plur
Chytila Petronilu pod krk a niekoľkokrát ňou zatriasla .	zatriasla	7	Sing
Stiahol ju nadol , takže kľačali tvárou v tvár .	kľačali	5	Plur
Vliali mi iskierku nádeje .	Vliali	0	Plur
“ Toto robia ľudia každý deň ? “ čudovala sa .	čudovala	8	Sing
V tú nedeľu básne vyšli .	vyšli	4	Plur
Už sme spomenuli , že za Ladislavovej vlády prichádza k postupnej konsolidácii pomerov v krajine .	spomenuli	2	Plur
Vtedy som vyriekol jediné slová , o ktorých som si myslel , že vystihujú moje rozpoloženie .	vystihujú	13	Plur
Poznali ho všetky ženy , vedeli , o čo mu ide .	vedeli	5	Plur
Cieľom Strany nebolo len to , aby medzi mužmi a ženami nevznikali vzťahy vernosti , nad ktorými nemala moc .	nevznikali	11	Plur
Rozvinul príkaz , ktorý predtým odložil stranou .	odložil	5	Sing
Cítila som , že sa červenám .	červenám	5	Sing
Netušil som , že na druhý deň moju formu , ktorú som opäť nadobudol vďaka Raise , zničí tá najabsurdnejšia udalosť v mojom živote .	Netušil	0	Sing
“ Napadli ma , “ rozčúlene vysvetľoval Balú .	Napadli	1	Plur
Keď konečne zaspala , bola tma .	zaspala	2	Sing
Keď Ferdovi muži zajali celé nepriateľské vojsko , aj hlavný veliteľ otrokárov vyšiel z podzemnej chodby .	zajali	3	Plur
Keď dedinskí nafúkanci z môjho ročníka uverejnili na jeho stránkach nejakú báseň , naparovali sa celý mesiac .	uverejnili	6	Plur
Čujte , čujte !	Čujte	0	Plur
Preto szabolcsská synoda schválila niekoľko kánonov , ktoré ich mali brániť pred takouto ujmou .	schválila	3	Sing
Keď na mňa pozrel a usmial sa , pripadala som si krásna , zbožňovaná a múdra .	usmial	5	Sing
Ešte aj dnes cítim na sebe jeho pohľad .	cítim	3	Sing
Svetové ríše , silné krajiny , politické systémy vznikajú a zanikajú , nič netrvá večne .	zanikajú	10	Plur
Poprosil som čašníka , aby mi priniesol koňak , dvojitý .	Poprosil	0	Sing
A otočil som sa na druhý bok .	otočil	1	Sing
“ Ty tu bývaš ? “ spýtala sa .	spýtala	6	Sing
Mohli si nás všimnúť a vyjavene sa na nás dívať .	Mohli	0	Plur
“ Chcela by som , aby ste mi vyveštili budúcnosť , ale nemám veľa peňazí . “	vyveštili	8	Plur
Kerchak bránil rodinu proti zákernej mačke , zatiaľ čo ostatní členovia ho pozorovali zo stromov .	pozorovali	12	Plur
Od straníkov sa vyžadoval podobný názor , aký mali starovekí Židia , ktorí síce vedeli , že všetky iné národy uctievajú nepravých bohov , ale to bolo všetko , čo o nich vedeli .	vedeli	32	Plur
Urobte to Júlii !	Urobte	0	Plur
Poslúchli ma .	Poslúchli	0	Plur
Spomínaní suzdaľskí volchvi sa zjavujú práve v čase neúrody , aby ju pomohli zahnať .	zjavujú	4	Plur
Fajčila cigaretu a čítala noviny .	Fajčila	0	Sing
Mauglí so supmi sa smiali , keď im tiger zmizol z dohľadu .	smiali	4	Plur
Však vieš , že sa tá zbierka robí od domu k domu .	robí	7	Sing
" Nenávidím mravnú čistotu , nenávidím dobrotu !	Nenávidím	1	Sing
Pretekáme s tromi dobrými plavkyňami z Octilla , a mňa tu deptá vlastná kolegyňa .	deptá	11	Sing
Jej vládcov nespájajú pokrvné zväzky , ale príslušnosť k spoločnému učeniu .	nespájajú	2	Plur
Povedala mi , že sa milujeme naposledy .	Povedala	0	Sing
Uvedomila som si , že na mňa čaká , a rozbúchalo sa mi srdce .	Uvedomila	0	Sing
Menšie rozmery potešia pri balení .	potešia	2	Plur
Rozoberané nepokoje sa odohrávajú v Beloozere , Novgorode , Suzdali , roku 1091 sa objavuje volchv i v Rostove .	objavuje	14	Sing
Máme prvé dve požiadavky na modernú baterku .	Máme	0	Plur
S námahou som otvoril oči .	otvoril	3	Sing
Ženy a deti sledovali z úkrytu , ako sa muži skrývajú za Jumbom .	sledovali	3	Plur
“ Myslím na dnešné preteky , “ zaklamala som .	Myslím	1	Sing
Chýba jej predovšetkým jasnosť .	Chýba	0	Sing
Trošku sa pritom začervenal .	začervenal	3	Sing
Prikazujem ti to ! “	Prikazujem	0	Sing
Jedného letného popoludnia sa na Makovej lúke zjavila obluda , akú ešte nikto nevidel .	zjavila	7	Sing
Rozčúlil sa , že ho vyrušujem po pracovnom čase .	vyrušujem	5	Sing
Jednostaj prichádzali a odchádzali všakovakí väzni : distribútori drog , zlodeji , banditi , šmelinári , opilci , prostitútky .	odchádzali	3	Plur
Raňajky sa podávajú na prízemí , do deviatej .	podávajú	2	Plur
Rýchlo som upratala zo stola a ponáhľala sa do svojej izby .	upratala	2	Sing
Známe uskromňovacie heslo " Jeme preto , aby sme žili . " nie je pravdivé .	Jeme	4	Plur
Mediácii bráni násilný zásah zvonku — Janova prítomnosť , narúšajúca tak prvotnú rovinu mýtu .	bráni	1	Sing
Po príchode „ trestnej výpravy “ však nepokoje už opadli a všetko bolo v poriadku — no príchodzích museli kolonisti živiť .	opadli	9	Plur
Medzitým Mauglí vo vzduchu kričal : “ Pustite ma !	kričal	4	Sing
Bola špička a cez okienka som videla , že všetky sedadlá obsadili ľudia , čo pracujú v centre .	pracujú	15	Plur
Stoly a stoličky boli prevrhnuté , vázy rozbité a obrazy viseli nakrivo .	viseli	10	Plur
Môžeme ich pripraviť o existenciu .	Môžeme	0	Plur
Vyskočil na rovné nohy a Gaston užasnuto hľadel na mohutnú postavu , ktorá sa nad ním vztýčila .	Vyskočil	0	Sing
K tejto problematike patria podľa nášho názoru i právne normy , ktoré upravujú niektoré procesné záležitosti .	upravujú	12	Plur
“ Medvedí život sa mi páči , “ povedal Mauglí , keď sa s Balúom pokojne vznášali na vode .	vznášali	16	Plur
Napokon sme z kríkov vybrali Chrisov bicykel a pomaly sme vyšli na ulicu .	vyšli	10	Plur
Keď máme čo jesť , máme všetko ostatné , čo potrebujeme .	potrebujeme	10	Plur
“ Dávajte pozor ! “	Dávajte	1	Plur
Nenadarmo platí " Sýty hladnému neverí " a zároveň neexistuje žiadne porekadlo typu " Ukojený nadržanému neverí " .	platí	1	Sing
Namiesto toho Pinocchia jemne zdvihol a opäť sa nasilu zasmial .	zasmial	9	Sing
Samozrejme , že som mu nepovedala , že mám domáce väzenie .	nepovedala	5	Sing
Odporná extáza strachu a pomstychtivosti , túžba zabíjať , mučiť , drúzgať tváre kováčskym mlátom akoby preskočila sťa elektrický prúd na všetkých a premenila každého aj proti jeho vôli na vrieskajúceho pomätenca s pokrivenou tvárou .	premenila	23	Sing
Vtedy bola zároveň jedným z hlavných nástrojov , vďaka ktorému udržiavali ľudské spoločnosti kontakt s hmotnou skutočnosťou .	udržiavali	10	Plur
Pohrebná trúba stále vyhrávala v ktoromsi kúte prázdneho priestoru môjho mozgu .	vyhrávala	3	Sing
Povedala , že by sme mali odísť bez rozlúčky , nechcela , aby sme nechali Irme odkaz , kam ideme , a ja som pozbieral odvahu .	nechali	14	Plur
Priniesol mi ju z Ameriky môj syn .	Priniesol	0	Sing
Našťastie sme zastali pri obrubníku pred pizzeriou Rajské slasti a všetci náhle stratili o nás záujem , keďže snívali o pizze .	snívali	18	Plur
Jej prenikavý krik Vilka prebral .	prebral	4	Sing
Nič také som neurobil .	neurobil	3	Sing
Chvíľami ho prenasledovali klamlivé spomienky .	prenasledovali	2	Plur
Vypil ďalší dúšok džinu , vzal bieleho jazdca a pokusne ním tiahol . Šach !	Vypil	0	Sing
Účastníci jedného letu stratili smer .	stratili	3	Plur
Na plece mu zľahka doľahla čiasi ruka .	doľahla	4	Sing
Kapitoly vytvoria protiváhu hlboko miestne ukotveného archeologicko ‐ historického prehľadu a predkladajú nový zorný uhol na skúmanú tému .	vytvoria	1	Plur
Vyšiel a žalostne zaplakal .	Vyšiel	0	Sing
Strážca zaváhal .	zaváhal	1	Sing
Tentoraz mu ju však pripomenula najmä dusná horúčava toho popoludnia , keď mu na čele vyrazili kropaje potu .	vyrazili	15	Plur
Mauglí rýchlo zaspal na lôžku z lístia , ale Baghíra poúčal Balúa .	poúčal	10	Sing
Poďte Herta a Siracha , nastal čas bojovať !	Poďte	0	Plur
Potom sa v jednej zákrute objavil ďalší stôl , za ktorým sedeli ďalšie dve ženy .	sedeli	11	Plur
Čujte , čujte !	čujte	2	Plur
Vzhľadom na vytrvalosť , akú prejavoval , som očakával , že takto zaboduje .	očakával	8	Sing
Musím rešpektovať Marginu požiadavku , aby som deťom nič nepovedal , a zároveň musím nájsť pre Irmu nejaké presvedčivé vysvetlenie .	musím	13	Sing
V nasledujúcej chvíli nastal obrovský rozruch .	nastal	3	Sing
Ďalší predavač ho zasa zbil vreckom šošovice .	zbil	4	Sing
“ Vedel som , že s mamkou vlčicou problémy nebudú . “	Vedel	1	Sing
“ Začni na ostrove Idra , kde vyhľadáš Filokteta , učiteľa hrdinov . “	Začni	1	Sing
Bol presvedčený , že niečo začul .	začul	5	Sing
Vtedy ho však zamestnávali iné veci .	zamestnávali	3	Plur
Hrali sa s Efrou a Ahmadom .	Hrali	0	Plur
“ Predstavujem si , ako prekonávam krajský rekord v prsiach , “ vysvetľoval mi .	Predstavujem	1	Sing
Vláda vypracuje a realizuje projekt transformácie štátnych podnikov lesného hospodárstva v pôsobnosti Ministerstva pôdohospodárstva SR na štátnu akciovú spoločnosť založenú podľa osobitného zákona .	realizuje	3	Sing
Napokon preletel cez domček slimáka Oskara a skončil na baze .	preletel	1	Sing
Spočiatku nevidel nič .	nevidel	1	Sing
U dovážaných produktov zabezpečí elimináciu tých , ktoré nespĺňajú kritériá kvality a ktoré neprešli colným a daňovým vysporiadaním .	neprešli	13	Plur
Vláda prijme strednodobý komplexný programový dokument rozvoja regiónov , zabezpečí prípravu , prerokovanie a schválenie plánovacích a programových dokumentov v oblasti regionálnej politiky s dôrazom na zlepšenie ekonomickej a sociálnej súdržnosti a prehĺbi uplatňovanie princípu partnerstva .	prijme	1	Sing
Už mnoho generácií múch obývalo kráľovský palác v stajni .	obývalo	4	Sing
Hypnotizujúce oči civeli do jeho vlastných .	civeli	2	Plur
Tatko sa hneval na deti , lebo ukrutne vyvádzali , a mamka sa hnevala na tatka , že je precitlivený .	vyvádzali	8	Plur
“ Odprevadíš ma ? “	Odprevadíš	1	Sing
Nato sa zvrtol a stratil sa v džungli .	zvrtol	2	Sing
Druhý a tretí riadok spolu dávajú meno Sežir .	dávajú	5	Plur
V tej chvíli som otvoril oči a začul som vzlykot .	začul	7	Sing
“ Ty , “ odvetil .	odvetil	4	Sing
u Martina nemám čo do zvonca .	nemám	2	Sing
Chichúňali sme sa ako pojašení , prebehli sme cez trávnik a smerovali k múru .	Chichúňali	0	Plur
Všetky prísady sa zmiešali a vznikla tmavá tekutina .	vznikla	5	Sing
Keby ste ho nenašli , leťte za slnečným svitom .	leťte	5	Plur
Čašníci ich obskakovali , akoby patrili do kráľovskej rodiny .	patrili	5	Plur
Pri analýze skúmaného javu v práci sme použili viac vrstiev v úvode spomenutých prvkov .	použili	7	Plur
Bola noc a biele tváre a šarlátové transparenty zalievalo zlovestné svetlo .	zalievalo	8	Sing
Jazmína pokrútila hlavou .	pokrútila	1	Sing
Bol vo väzení a do väzenia zatvárajú zlých ľudí , ale otec nebol zlý človek .	zatvárajú	6	Plur
“ Zobuď sa , Baghíra !	Zobuď	1	Sing
Niekto sa nám snaží ublížiť a nie je ďaleko čas , keď bude vypátraný a potrestaný .	snaží	3	Sing
V takýchto mrákotách zaznel v ktoromsi kúte môjho mozgu pohrebný motív vzdialenej trúby .	zaznel	3	Sing
Nestrácal som čas a priložil som oko k škáre v podlahovej doske .	Nestrácal	0	Sing
Zadusím sa ! “ kričala .	Zadusím	0	Sing
Zároveň však Cluny urobilo veľký krok na ceste k libertas , lebo vytvorilo spoločenstvo ( zväčša ) úplne slobodných kláštorov , ktoré nepodliehali laikom .	urobilo	3	Sing
Na okraji Tirany , keď sme prechádzali cez predmestie Lapraka , uviazli sme na križovatke .	uviazli	11	Plur
Našťastie sme zastali pri obrubníku pred pizzeriou Rajské slasti a všetci náhle stratili o nás záujem , keďže snívali o pizze .	stratili	12	Plur
“ Neopustím ťa ! “ zakričal princ .	Neopustím	1	Sing
Winston bol ženatý a pravdepodobne ešte stále je ženatý , lebo pokiaľ vie , jeho žena nezomrela .	vie	12	Sing
Systematicky podrýva súdržnosť rodiny , zato svojho vodcu označuje pomenovaním , ktoré priamo vyvoláva pocity rodinnej vernosti .	označuje	8	Sing
“ Presne , “ odvetil Chris .	odvetil	4	Sing
“ Zima ? “ spýtal sa .	spýtal	4	Sing
A keď sa Dolora na znak pochopenia spýtala Toma na jeho meno , neodpovedal jej ani on .	neodpovedal	13	Sing
Nevlastní rodičia sa o Herkula dobre starali a vyrástol z neho milujúci syn a mladík .	starali	6	Plur
“ Nevydeli ste tu nejakého koňa ? “ vypytoval som sa chrobákov .	vypytoval	8	Sing
Istý zmysel v ňom nachádzali moji neprajníci .	nachádzali	4	Plur
Za jasotu spoluobčanov prevzali cenu a Dr . Slimák slzil od dojatia , pretože v tejto súťaži doteraz nijaký slimák nevyhral .	prevzali	3	Plur
Rozbehla som sa a skočila , pričom sa hladina rozbúrila ako po výbuchu .	rozbúrila	9	Sing
“ Zaletíme spolu do stajne , “ navrhol .	Zaletíme	1	Plur
Naše hlasy sa donekonečna odrážali od orosených skál .	odrážali	4	Plur
Alebo prežili príliš náročnú noc .	prežili	1	Plur
Potom si ľahli spať .	ľahli	2	Plur
Nová Koncepcia ochrany prírody a krajiny bude obsahovať racionálny systém manažmentu chránených území , prehodnotí ich cieľový stav a navrhne opatrenia a programy starostlivosti tak , aby chránené územia slúžili aj verejnosti .	slúžili	29	Plur
“ Uteč , Mauglí , uteč ! “ kričal Balú .	kričal	8	Sing
Ťava sa potkla o voz a všetky granátové jabĺčka popadali na zem .	popadali	9	Plur
Napokon vstal , tackavo a hojdavo prešiel celou , hlboko ponoril ruku do vrecka na kombinéze a s rozpačitým výrazom podal mužovi s umrlčou tvárou ufúľaný kúsok chleba .	podal	20	Sing
Všimli ste si ?	Všimli	0	Plur
V jednom kuse táral o Týždni nenávisti .	táral	3	Sing
“ O chvíľu príde lejak .	príde	3	Sing
Mňa zaujímame my . "	zaujímame	1	Plur
“ Džafar , rozkazujem ti , aby si prestal ! “ zlostne skríkol sultán .	prestal	8	Sing
Podobalo sa to pokusu o ťah v šachovej partii , keď už má človek mat .	Podobalo	0	Sing
Keby ste si mohli vybrať , žili by ste radšej vtedy či teraz ?	žili	6	Plur
Objal ju okolo pása .	Objal	0	Sing
Všetci chceli súťažiť .	chceli	1	Plur
“ Vzdávam sa . “	Vzdávam	1	Sing
Berte to tak , že ich píšu Marťania , s ktorými sa nikdy nedorozumiete .	nedorozumiete	13	Plur
Podľa N . M . Tichomirova ide len o označenie ich sociálneho postavenia , my však vyslovujeme domnienku , že ide o pozostatok matriarchátu , zvlášť silného u ugrofínskych plemien .	vyslovujeme	16	Plur
Abu významne pokrčil plecami .	pokrčil	2	Sing
Zostupujúc do hĺbok duševných priepastí , ( seba ) obnažuje , bičuje ( sa ) .	bičuje	11	Sing
Pozostáva z krátkych pasáží o jednotlivých mníchoch , v ktorých sa neopakovateľným spôsobom preplieta fantastika s reálnym videním sveta .	Pozostáva	0	Sing
Ako sme vychádzali z miestnosti , nastal v triede všeobecný ruch .	vychádzali	2	Plur
Zavalíme ľan kameňom , aby ostal vo vode .	Zavalíme	0	Plur
Nejedno dieťa už vytklo s bolesťou svojim rodičom : Vy ste na vine , že som sa dostal na zlú cestu , lebo vy sami ste nebrali Ježiša vážne a neviedli ste ma k Nemu .	neviedli	30	Plur
Veľmi som chcela , aby ostali spolu , no cítila som sa pri nich trochu navyše .	ostali	5	Plur
“ Správne , “ povzbudzovali ich akrobati .	povzbudzovali	4	Plur
Čujte , čujte !	Čujte	0	Plur
“ Vidíte , čo ste spravili ? “ zabzučala a starostlivo si kefovala jemné chĺpky na tele .	spravili	5	Plur
Winston vedel , že tam sú , ale zazrel ich iba podchvíľou .	vedel	1	Sing
Aladina raz z Rahimovho obchodu vyhnali , keď sa Abu usiloval chvostom potiahnuť trs banánov .	usiloval	10	Sing
Keď si Lori sadla do auta , sklonila sa nad volant , plecia sa jej roztriasli a ja som si zarazene uvedomil , že vzlyká .	uvedomil	21	Sing
Na druhej strane je zaujímavé , že v sledovaných cirkevnoprávnych zbierkach sme nenašli žiadne ustanovenia o podmienkach využívania azylu .	nenašli	12	Plur
Prečo sa pýtate ?	pýtate	2	Plur
V jedno vetristé popoludnie zaspala pani Mandelinka uprostred obeda na stoličke a oni sa jej starali o drobizg .	starali	15	Plur
Obaja Aladinovi zákazníci chvíľu mlčali .	mlčali	4	Plur
Po celý deň ho chvíľami znepokojovali .	znepokojovali	5	Plur
Nechýbali vrúcne kontakty , dlhé lúčenie a pozvanie na ďalšie stretnutie .	Nechýbali	0	Plur
Snehulienka váhala .	váhala	1	Sing
Onedlho začul dupot čižiem niekde mimo cely .	začul	1	Sing
Nerúhajme sa Bohu a nereptajme na všetko a všetkých .	Nerúhajme	0	Plur
Trkotali , sŕkali med a zapíjali ho pálenkou !	sŕkali	2	Plur
Boli ako zmyslov zbavené .	Boli	0	Plur
Bosorka sa nad ňou víťazne skláňala a zaškriekala .	zaškriekala	7	Sing
Nespýtala som sa ho to .	Nespýtala	0	Sing
Stúpame po schodíkoch , ktoré jej dali meno , a mierime na Karlovo naměstí .	Stúpame	0	Plur
V prijímacej sieni to vyzeralo , akoby sa tadiaľ prehnala búrka .	prehnala	9	Sing
Nikdy nepočula o Bratstve a odmietala veriť v jeho existenciu .	odmietala	5	Sing
Vtom sa na schodoch ozvali rýchle kroky .	ozvali	4	Plur
Nikde nedajú pokoj .	nedajú	1	Plur
Zaleteli k lesu , kde Svetlanka ukázala na uzučkú škárku v zemi .	Zaleteli	0	Plur
Dal im zvláštnu ponuku .	Dal	0	Sing
“ Radšej padajme . “	padajme	2	Plur
Oči jej vystúpili z jamiek a z vyškerených úst vypadali všetky zuby okrem jedného .	vystúpili	2	Plur
So srdcom , ktoré mu tuhlo , kráčal Winston v jeho pätách .	tuhlo	5	Sing
“ Z nás sa nikdy nestanú piráti , “ hrdo vyhlásila Wendy .	nestanú	5	Plur
Teraz sa v noci budievam zo spánku a hrdlo mi zviera úzkosť : trápi ma nočná mora , že aj ja som v dave , ktorý ženie mamu v ústrety smrti .	trápi	13	Sing
Naozaj stenám , ale ty si to , preboha , poriadne zveličil .	stenám	1	Sing
Táto odpoveď mi stačila .	stačila	3	Sing
Zrazu od úžasu onemela .	onemela	3	Sing
Neodvážila sa otvoriť oči a ja som pochopil , že očakáva niečo strašné .	Neodvážila	0	Sing
Opice , čo držali Mauglího , sa zaškerili a pustili ho .	zaškerili	7	Plur
Napokon sa mucha upokojila .	upokojila	3	Sing
Aj Maja zbledla .	zbledla	2	Sing
Človek očakával , že ho zabijú .	zabijú	5	Plur
„ Akže umierajú vaši ľudia , sú do neba vynášaní , akže naši , idú k našim do priepasti . . . “	umierajú	2	Plur
Nepovedal som jej nič .	Nepovedal	0	Sing
Večer ma začala znepokojovať pohrebná trúba .	začala	2	Sing
“ Musíš vyslať signál , “ hovorieva mi .	Musíš	1	Sing
“ Vidím , že nič neviete o našom žartíku .	Vidím	1	Sing
Odpovedala na môj dotyk .	Odpovedala	0	Sing
“ Mhm , “ zamrmlal .	zamrmlal	4	Sing
Jeden výhonok bol fuksiovej , druhý tehlovej farby , hoci zrejme vyrastali z jediného koreňa .	vyrastali	11	Plur
Smiali sme sa , až sme lapali dych , a držali sa za ruky .	držali	10	Plur
Skutočnosť , že som na teba myslela , bola nebezpečná .	myslela	6	Sing
Nákladné autá ešte stále prechádzali okolo a ľudia ešte stále na ne hladovo civeli .	prechádzali	4	Plur
Winstonovo telo zalial razom na každom kúsku studený pot .	zalial	2	Sing
Kŕčovito sa pridržiaval kôry , aby ho neodfúkol vietor .	pridržiaval	2	Sing
Nakoniec to nevydržal a snažil sa upratovačku na problém upozorniť .	nevydržal	2	Sing
Povedal , že môjho starého otca zabili , lebo tak prikázal Hádes .	Povedal	0	Sing
Bežala za veliteľom mravcov a prosila ho , aby vyhlásil po Flipovi pátranie .	prosila	5	Sing
Keď v nej uviazneš , čaká ťa hrozná smrť .	uviazneš	3	Sing
Spomenula si na ďatla , a tak zaletela poňho .	Spomenula	0	Sing
Zatiaľ čo sa Chris profesora na všeličo vypytoval , Rick si pedantne zapisoval každé jeho slovo .	zapisoval	12	Sing
Poznali sme ho podľa klopania , boli to tri ľahké údery .	Poznali	0	Plur
Zavedenie inštitútu manažéra súdu zníži počet funkcionárov súdov , ktorí obmedzene vykonávajú súdnictvo .	vykonávajú	11	Plur
Podľa zoznamu posadnikov , uvedených v novgorodskom prvom letopise mladšieho vydania sa nazýval Zavid .	nazýval	12	Sing
“ To je ono ! “ zvolal Balú .	zvolal	6	Sing
Ráno sa porozprávame . “	porozprávame	2	Plur
Niekedy zaútočia najprv na oči .	zaútočia	1	Plur
Niekedy sa objavovali obyvatelia Čarodejníckej vily , všetkých som poznala a vedela som , aký bol osud každého z nich .	poznala	9	Sing
Nikdy by jej nezišlo na um , že bezvýsledný čin nemá význam .	nezišlo	3	Sing
Vtedy mohol klopať ktokoľvek , my sme neotvárali .	neotvárali	7	Plur
Vláda pripraví legislatívne opatrenia , ktoré zjednodušia sankčný systém v daňovej oblasti .	zjednodušia	6	Plur
Na príjazdovej ceste pred Taco Villa stál dlhočizný rad áut , v ktorých sedeli decká z našej školy .	stál	6	Sing
Kráčal chodbou s bielymi kachličkami a mal pocit , že sa prechádza na slnku , v pätách mu kráčal ozbrojený dozorca .	prechádza	11	Sing
A tu či inde sa v úplnej tajnosti nachádzali riadiace mozgy , ktoré koordinovali toto úsilie a určovali politickú líniu : rozhodovali o tom , že tento fragment minulosti sa zachová , tento sa sfalšuje a ďalší prestane jestvovať .	nachádzali	8	Plur
Chris síce prikývol , ale šibalsky mu sem ‐ tam myklo kútikmi úst .	prikývol	2	Sing
Poslúchol som ju a podišiel k oknu .	podišiel	4	Sing
Šetrí aj pani ministerka financií , ktorá stále nevylučuje ďalšie zvyšovania cien a zodpovednosť za to prenechala na vedúcich úsekov ?	Šetrí	0	Sing
“ Poďme najprv do Bula , “ navrhla .	Poďme	1	Plur
Jasne som chápal len absurdnosť situácie , v akej som sa ocitol .	chápal	2	Sing
Najskôr som sa zarazil .	zarazil	3	Sing
Činnosť nášho združenia zatisli do pozadia iné potreby .	zatisli	3	Plur
“ Tu niekde mám bundu , “ zamrmlal .	mám	3	Sing
Všetky ďalšie uhorské právne normy , ktoré reglementujú život kláštorných spoločenstiev nachádzame potom až medzi kánonmi I . ostrihomskej synody .	reglementujú	7	Plur
Zrýchlil sa mi pulz a spomenula som si na sen , v ktorom ma bozkával .	bozkával	14	Sing
V podstate som nedúfala , že príde , no keď som ho zbadala na opačnom konci preplnenej a zadymenej telocvične , myslela som si , že sa mi marí .	marí	28	Sing
Vláda pripraví legislatívny rámec inštitucionálneho vzdelávania zdravotníckych pracovníkov prostredníctvom rezortu školstva s možnosťou postgraduálnej prípravy pracovníkov v zdravotníctve v školách a inštitúciách , ktoré získajú akreditáciu pre príslušný typ vzdelávania .	pripraví	1	Sing
Vrátili sme sa dovnútra a zaujali svoje miesta .	Vrátili	0	Plur
Išla som k dverám jej izby : “ Volá Rick , “ zašepkala som .	Išla	0	Sing
“ Kamže sa ponáhľate , “ prehovoril pavúk .	ponáhľate	3	Plur
Ja sa na Vianoce teším .	teším	4	Sing
Vilko visel na Maji ako ťažké bremeno .	visel	1	Sing
Za tým všetkým sa skrýva strach .	skrýva	4	Sing
Buchta láskyplne sledovala siláka Fridolína .	sledovala	2	Sing
Winston i dievča vytrvalo jedli .	jedli	4	Plur
Rozbúrila more a na rozčerenej , spenenej hladine sa ako atrament černela tekutina , ktorú vypúšťajú iba chobotnice .	vypúšťajú	15	Plur
Ani bratanci sa sem už neodvážia prísť , priatelia k nám prestali chodiť na návštevu už dávno .	prestali	11	Plur
“ V Aquitare jedia červíky , otec !	jedia	3	Plur
“ Ďakujem , “ odvetila mora trochu rozpačito .	odvetila	4	Sing
V sledovaných zbierkach kánonického práva nachádzame celý rad podobných ustanovení .	nachádzame	5	Plur
Rozbehla som sa a skočila , pričom sa hladina rozbúrila ako po výbuchu .	skočila	4	Sing
Maja s Vilkom poprisili o kúsok smrčka a statočne ho prežúvali , len aby sa zavďačili hostiteľovi .	prežúvali	10	Plur
“ Vysvetlíme mu , že ja také niečo nikdy neurobím ! “	Vysvetlíme	1	Plur
Nejedno dieťa už vytklo s bolesťou svojim rodičom : Vy ste na vine , že som sa dostal na zlú cestu , lebo vy sami ste nebrali Ježiša vážne a neviedli ste ma k Nemu .	nebrali	26	Plur
Povzbudzovalo svojich favoritov a už sa ozývali aj prvé heslá .	ozývali	6	Plur
Na druhej strane všetky špinavé práce robia politickí väzni .	robia	6	Plur
Rusi prenasledovali kacírstvo ešte krutejšie , než inkvizícia .	prenasledovali	1	Plur
Za nič na svete však nechcela opustiť svoju rodinku , a tak sa Rudko a Flip rozhodli , že jej občas pomôžu .	pomôžu	21	Plur
Bolesť opäť pominula .	pominula	2	Sing
Rýchlo vyčarila drevený kolovrátok so zradným zeleným vretenom .	vyčarila	1	Sing
Chodili jej normálnou poštou do školy , kde učila .	Chodili	0	Plur
I ja mám občas dojem , že môj život riadia mamine nesplnené sny .	riadia	9	Plur
Po chvíli prišli na svet štyri drobnučké šteniatka .	prišli	2	Plur
Skôr či neskôr sa Abdullah vráti , ale dovtedy sa na Aladina usmialo šťastie .	usmialo	12	Sing
Chcela mu ukázať strom , z ktorého viseli liany .	viseli	7	Plur
Veronika sa najprv urazila , ale keď jej Ferdo vysvetlil , že rehotanie je taká zvláštna psia choroba , trochu sa upokojila .	urazila	3	Sing
“ Vyzeráš , akoby si tu mysľou ani nebola . “	nebola	8	Sing
“ Začni na ostrove Idra , kde vyhľadáš Filokteta , učiteľa hrdinov . “	vyhľadáš	7	Sing
“ Porozprávame sa inokedy , “ zavolala Blythe a veselo mi zakývala , keď odchádzali .	Porozprávame	1	Plur
Zachvel som sa .	Zachvel	0	Sing
Chvíľu sa preťahovali , až napokon odlomili panvici rúčku .	odlomili	6	Plur
Netrvalo dlho a obaja lavínu skyprili , takže sa párik cvrčkov ľahko dostal von .	skyprili	5	Plur
Veď nás Duchom Svätým a pomáhaj nám prekonávať všetko , čo v EÚ a našom svete bude slúžiť smrti a zániku .	Veď	0	Sing
Deti boli v kostole veľmi tichučko a správali sa vzorne .	správali	7	Plur
Zhlboka sa nadýchla , poriadne si vydrhla predné nohy a ostala nehybne sedieť na liste ako prikovaná .	vydrhla	6	Sing
Zvieratká odpočívali pred svojimi príbytkami , večerali a popíjali púpavovú šťavu od cikád .	večerali	6	Plur
“ Myslíš , že nás spoznal ? “ spýtal sa Chris , keď sme sa prestali triasť .	prestali	15	Plur
Sadli si na konár medzi šuštiace lístie topoľa .	Sadli	0	Plur
Nastolíme po voľbách zmenu - odhalením zbohatlíkov , mafiánov , delikventov , korupčníkov a lobistov pri stálom sledovaní blaha občana .	Nastolíme	0	Plur
Srdce mu divoko bilo .	bilo	3	Sing
Keď dohovoril , usmial sa svojím záhadným úsmevom a ustúpil nabok , aby uvoľnil cestu Lori .	dohovoril	1	Sing
Práve sme sa pomilovali .	pomilovali	3	Plur
Stranu nezaujímajú konkrétne činy : my si potrpíme len na myšlienky .	potrpíme	7	Plur
Vôbec som im neprotirečil , postupoval som podľa inej taktiky .	postupoval	5	Sing
“ Kto ma volá ? “ ozvalo sa .	volá	3	Sing
“ Čo sa s tebou deje , Amy ? “ vypytoval sa ma po pretekoch tréner August a odviedol ma nabok , kým ostatní nastupovali do autobusu .	deje	5	Sing
Všetci okolo mňa pokojne písali odpovede , kým ja som ich horúčkovito čmárala .	písali	4	Plur
Keď vyniesli nahor aj poslednú stoličku , bolo už celkom tma .	vyniesli	1	Plur
Makovej lúky sa totiž chceli zmocniť lúpežné mravce .	chceli	4	Plur
V prípade , že z manželstva nevzišli deti , Strana nepovoľovala rozvod , zato podporovala odlúčenie .	nepovoľovala	10	Sing
Spoločne mu ukázali upravené domčeky i podzemné chodby .	ukázali	2	Plur
Pozrite sa na mňa ešte raz .	Pozrite	0	Plur
Neviem , či som na ne pripravená .	Neviem	0	Sing
Sopky vreli , vyčíňali búrky a zemetrasenia , svet bol plný zmätku a veľkého zdesenia .	vreli	1	Plur
Vrátila sa za svitania a hneď si ľahla .	ľahla	7	Sing
V prvej časti kapitoly teda najprv načrtneme ich základný argumentačný potenciál , aby sme mohli v časti druhej pristúpiť k pokusu o vlastnú interpretáciu .	načrtneme	6	Plur
“ Máte pridobré srdce , “ poznamenala Kráska .	Máte	1	Plur
Je mi fuk , čo jej urobíte .	urobíte	6	Plur
Jaskyne ma vždy lákali .	lákali	3	Plur
Nerob to ! “ zvolal Aladin .	Nerob	0	Sing
Pedra totiž široko ‐ ďaleko poznali ako záletníka a donchuana .	poznali	5	Plur
Odvahy a zbabelosti sa to netýka .	netýka	5	Sing
Zákon prispeje k stabilizácii príjmov územnej samosprávy .	prispeje	1	Sing
“ A ty si mu to veľmi neuľahčil . “	neuľahčil	7	Sing
Meg márne odmietala , lebo podľa starej dohody s Hádesom vymenila svoju slobodu za život bývalého priateľa .	vymenila	10	Sing
Zavrela oči .	Zavrela	0	Sing
“ Už ste na niečo prišli ?	prišli	5	Plur
Dejiny sa zastavili .	zastavili	2	Plur
“ Zastavte svet , nech sa prestane krútiť ! “ zvolal .	Zastavte	1	Plur
V záhrade sa oslavovali narodeniny .	oslavovali	3	Plur
Moji rodičia sa báli .	báli	3	Plur
Boli sme najedení až po krk , keď Rýchlik vyhlásil , že sa ide na tortilly , po ktorých Delfíni zaručene zvíťazia .	zvíťazia	21	Plur
Odkazy tohto druhu Margu obyčajne rozčuľovali .	rozčuľovali	5	Plur
Na lúke vrcholili prípravy na dožinkovú slávnosť .	vrcholili	2	Plur
" Nezabil som ju .	Nezabil	1	Sing
Priateľky a príbuzní ju ponechali svojmu osudu .	ponechali	4	Plur
Vláda zjednotí sadzby DPH pred vstupom do EÚ .	zjednotí	1	Sing
Slnko na nich pražilo , pot ho svrbel na tvári .	pražilo	3	Sing
Hoci mu bude chýbať , Zeus vedel , že Herkules konečne našiel svoje šťastie .	vedel	6	Sing
Sadol si na zem a povedal : “ Tak čo mám teda robiť ? “	mám	10	Sing
Možno by jej to celkom prospelo . “	prospelo	5	Sing
V oblasti prepravných povolení v cestnej doprave sa realizuje nový transparentný systém založený na princípe nárokovosti pri splnení požadovaných kritérií a podmienok	realizuje	8	Sing
Nepatrí teda k spomenutému typu „ poľnohospodárskych miest “ .	Nepatrí	0	Sing
Vzápätí pribehli mandelinčatá s boľavými bruchami , takže musela ošetriť aj ich .	pribehli	1	Plur
NASLEDUJÚCI TÝŽDEŇ som sa Chrisovi v škole vyhýbala .	vyhýbala	7	Sing
V poslednom čase ju Ministerstvo hojnosti veľmi obľubovalo .	obľubovalo	7	Sing
Nakoniec si urobila z nosidiel trampolínu , začala skákať kotrmelce a nosidlá tak rozhojdala , že ich včielky sotva udržali .	rozhojdala	13	Sing
Sľubujem , že všetko preberieme , “ presviedčal ma Chris .	preberieme	4	Plur
V obvodnom kine , vzdialenom od centra , obyčajne premietali staré filmy .	premietali	9	Plur
Na stoloch stáli všelijaké fľaštičky a v bankách bublali záhadné tekutiny .	stáli	2	Plur
Povedala , že sa volá Liza .	volá	4	Sing
V tomto podniku si nemôžem dovoliť luxus v podobe ďalšej whisky , ani keby som išiel dušu vypustiť .	nemôžem	4	Sing
Pedro stál práve pred zrkadlom a obdivoval sa .	stál	1	Sing
Slnko vychádza i zapadá	zapadá	3	Sing
Vedel dôvod . Šírila okolo seba atmosféru hokejového ihriska , studených kúpeľov , spoločného stopovania a akejsi všeobecnej čistoty mysle .	Šírila	3	Sing
Vyliezla spod listu a obzerala sa okolo seba .	Vyliezla	0	Sing
Na okraji makového poľa sedel motýľ s malým oranžovým cylindrom na hlave .	sedel	4	Sing
Keď som vychádzal z izby , že za ním zájdem a poprosím ho o nejakú radu , opäť som pocítil svrbenie .	poprosím	11	Sing
“ Super , “ povedala som , keď sme kráčali ku kabrioletu .	kráčali	9	Plur
Zaznel zvonec a všetko stíchlo .	Zaznel	0	Sing
“ Nastavme si rovnako hodinky , “ povedal Chris .	Nastavme	1	Plur
Leopard Sabor sa chystal zaútočiť .	chystal	3	Sing
Koľkokrát Aladin počul , ako po nich pokrikujú tie isté slová !	pokrikujú	7	Plur
“ To je ono ! “ zvolal Balú .	zvolal	6	Sing
Ako som takto táral , pochopil som , že rozprávam hlúposti .	pochopil	5	Sing
Prišla za mnou , objala ma a hojdala v náručí .	Prišla	0	Sing
Nedokážeme uspokojivo vysvetliť , prečo uhorský kráľ takto postupoval .	Nedokážeme	0	Plur
Starého dobráckeho sultána zahalili kúdoly hmly .	zahalili	3	Plur
Vtom sa pred ním otvorila zem a vyliezla z nej tenká červenohnedá dážďovka .	vyliezla	7	Sing
Prebehli sme okolo nich a prešmykli sa dozadu k dvojmetrovému múru .	prešmykli	5	Plur
Im všetkým však patrí moja srdečná vďaka .	patrí	3	Sing
Odstránime orgazmus .	Odstránime	0	Plur
Ty si ten problém , pomyslela som si .	pomyslela	5	Sing
Tekla vychrlila niekoľko oplzlých pavúčich nadávok , ale na silného Chrabroša si netrúfla , a tak kľajúc zaliezla pod vädnúci list .	zaliezla	17	Sing
“ Prestaň sa krútiť !	Prestaň	1	Sing
Nemá inú možnosť , musí to skúsiť .	Nemá	0	Sing
Ide sa vydávať .	Ide	0	Sing
Neotvoril oči ihneď .	Neotvoril	0	Sing
Všetci by lavínu najradšej čo najrýchlejšie odstránili , no nevedeli ako .	odstránili	6	Plur
Syreeta vyvesila oznam o Abuovom úteku a kto ho nájde , dostane odmenu .	dostane	11	Sing
Človek nikdy nevie , na čo natrafí .	natrafí	6	Sing
Je to kúsok histórie , ktorú zabudli zmeniť .	zabudli	6	Plur
“ Odíď a daj mi pokoj !	daj	3	Sing
Biele lístočky kvetu sa jemne odhrnuli a zjavila sa malá rúčka .	odhrnuli	5	Plur
Napätá sledovala obzor .	sledovala	1	Sing
Polovica z nej nikdy nespoznala topánky .	nespoznala	4	Sing
Pousmejú sa a zíde im na um moja prezývka .	Pousmejú	0	Plur
Zadychčaní od behu sme sa smiali .	smiali	5	Plur
Oficiálne sa partneri nikdy nezmenili .	nezmenili	4	Plur
“ Pozeraj mi do očí , keď sa s tebou rozprávam ! “ prikázal mu Káa .	rozprávam	10	Sing
Videla som , že Chrisovi síce odľahlo , no po chvíli sa zasa tváril vážne .	Videla	0	Sing
Hneď nás pribehla spolu odfotiť .	pribehla	2	Sing
Čarodejnica odhrnula vejúci plášť a dobré víly onemeli od hrôzy , keď zbadali Zorničku .	onemeli	7	Plur
“ Toľko peňazí neminiem na oblečenie za celý rok . “	neminiem	3	Sing
Napokon chytil vak a hodil mi ho na kolená .	chytil	1	Sing
“ Tu býva jeden môj známy a veľmi rád prijíma návštevy . “	býva	2	Sing
Grifony zapriahnuté v nebeských záprahoch božstiev fungovali ako zjednotitelia neba a zeme .	fungovali	6	Plur
Počas jazdy sa Rýchlik a Jill hádali , ktorú stanicu naladia .	hádali	6	Plur
“ Vyzeráš , akoby si tu mysľou ani nebola . “	Vyzeráš	1	Sing
“ Zlatúšikovia moji , “ nariekala skormútene .	nariekala	5	Sing
Potkany vedeli , čo bude nasledovať .	vedeli	1	Plur
Zaznel rachot .	Zaznel	0	Sing
Lavdima Lavdoshaja zaraďovali k príslušníkom konzervatívneho krídla .	zaraďovali	2	Plur
“ Zaklopal som Amy na okno .	Zaklopal	1	Sing
Porota však ocenila práce slimákov Šuchtáka a Plazivca , ktorý si prekrásne vymaľovali domčeky .	vymaľovali	12	Plur
Ako starý priateľ tvojho nebohého otca považujem za potrebné , aby sme sa porozprávali celkom otvorene .	porozprávali	13	Plur
Šikovne využil pobyt folklórnych skupín a súborov z celého Slovenska v Bratislave , ktoré sem chodili na náklady Opusu alebo rozhlasu nahrávať platne .	chodili	15	Plur
Od ľaku som nevládal vyriecť slova .	nevládal	3	Sing
Pramenné materiály , ktoré zachytávajú 11 . storočie sa zmieňujú o prudkom nástupe novej ideológie do všetkých oblastí života .	zmieňujú	9	Plur
Nechal som tam Margu stáť a podišiel som k dverám .	Nechal	0	Sing
Maja pocítila hlad .	pocítila	1	Sing
Makulienka a motýľ Emanuel sklopili zrak .	sklopili	4	Plur
Nechal som ju vzlykať .	Nechal	0	Sing
Príčiny ochorenia úzko súvisia s nezdravým životným štýlom , svoju významnú úlohu zohrávajú alkohol , fajčenie , nedostatok pohybu , nadváha a obezita , stres , poprípade nedostatok zdravých potravín .	zohrávajú	12	Plur
Ubiehali sekundy , nekonečne dlhé .	Ubiehali	0	Plur
V škole mi vtedy nadávali , že som dcéra pobehlice .	nadávali	4	Plur
Strčil som tam aj fľašu so zvyškom vodky Smirnoff .	Strčil	0	Sing
“ Prepáč .	Prepáč	1	Sing
Abu síce nevedel čítať , no páčili sa mu obrázky .	páčili	6	Plur
Čakal som , kým zaparkuje auto , a potom sme išli do kaviarne pri ceste .	Čakal	0	Sing
Oni to hlúpe drevené chlapčisko priam zbožňovali .	zbožňovali	6	Plur
More postupne zmizlo a ona sa otočila ku mne .	otočila	6	Sing
Vo vzduchu sa vznášali farebné balóniky , v pestrých stánkoch bolo množstvo všakovakých dobrôt .	vznášali	3	Plur
Holeňový vred mu natreli hojivou masťou .	natreli	3	Plur
Nemal topánky , veľké špinavé prsty mu vyčnievali z dier na ponožkách .	Nemal	0	Sing
Sexuálny pud vyklčujeme .	vyklčujeme	2	Plur
Noviny ste zabudli v kaviarni , letáky neznášate .	zabudli	2	Plur
Musíš Veľkého brata milovať .	Musíš	0	Sing
Máte kvalitnú vodku , poznamenala , čo som vôbec nečakal .	Máte	0	Plur
So zvyšnými dvoma tretinami som išiel do izby .	išiel	5	Sing
Hodili sme reč o Ježiškovi .	Hodili	0	Plur
Začali sa letné prázdniny .	Začali	0	Plur
Zo zlatej čaše popíjal víno a džin mu masíroval nohy .	popíjal	3	Sing
Zarazilo ma to .	Zarazilo	0	Sing
Bolo by to v poriadku , keby si sa v duchu nestiahla , len čo sa dotkneš steny .	dotkneš	16	Sing
Dvakrát sa mi pod vodou omotal okolo krku a prehodil sa na chrbát .	prehodil	9	Sing
Preleteli sme cez oddelenie topánok , kozmetiky , vyhli sme sa nápadne namaľovaným predavačkám , ktoré ponúkali masky , líčidlá a vzorky kolínskej .	Preleteli	0	Plur
“ Prečo nie , “ odvetil Chris , keď chvíľu snoril v knižnici a prezeral si farebné obaly kníh .	snoril	10	Sing
Trúbeľko preto rýchlo dodal , že bez Ňufka by veru mravenisko neubránili .	neubránili	11	Plur
Prsty sa jej skrivili a nechty sa premenili na zahnuté pazúriská .	premenili	7	Plur
Na slnku jej telo žiarilo .	žiarilo	4	Sing
Zaželala mi , aby ma rýchlo preložili .	Zaželala	0	Sing
Popoludní o tretej sa začínali Majstrovstvá Makovej lúky v skákaní .	začínali	4	Plur
“ Obviňujeme vás , že ste nám odcudzili drahocennú potravu , “ povedal prísne veliteľ a dal pokyn , aby ich zajali a postavili pred sudcu .	odcudzili	7	Plur
Berte to tak , že ich píšu Marťania , s ktorými sa nikdy nedorozumiete .	Berte	0	Plur
Keď oheň začal slabnúť , drkotali mi zuby .	začal	2	Sing
Trojzubec sa odchýlil iným smerom .	odchýlil	2	Sing
" Kto vytrvá do konca , bude spasený .	vytrvá	2	Sing
Áno , teraz videl , že to odnepamäti vedel .	vedel	8	Sing
A obchody , ktoré chcú predávať zaručene čerstvý , v noci upečený a nezabalený chlieb , musia ho držať v osobitných zasklených policiach , takže skôr nebalenie chlieb zdražuje .	musia	16	Plur
Usmiala som sa .	Usmiala	0	Sing
“ U nás budete zaručene spokojní , inak vám vrátime peniaze ! “ kričal .	vrátime	9	Plur
“ Možno sa zajtra vrátim , keď budem mať peniaze , aby ste mi o ňom povedali viac . “	povedali	16	Plur
Ony , samozrejme , vyzváňali ďalej .	vyzváňali	4	Plur
Páči sa mi tvoja myseľ .	Páči	0	Sing
Smiala som sa , akoby sme boli len kamoši , ale keď som si sadla do auta vedľa Shannon , naskočili mi na ruke zimomriavky , keď sa ma Chris dotkol .	naskočili	20	Plur
Čosi podobné nariaďujú i uhorské právne normy .	nariaďujú	2	Plur
Deti sa veľmi tešili , keď Lulu kŕmila mláďatká .	tešili	3	Plur
Teším sa na Vaše odpovede a prajem príjemný týždeň ,	prajem	6	Sing
" Máte dojem , že ste slobodnejší , než ste boli vtedy ?	Máte	1	Plur
Dnes tu však mali návštevu , sedeli na terase a jedli lahodne rozvoniavajúci ovocný koláč .	jedli	10	Plur
Snežilo husto , padali veľké vločky .	Snežilo	0	Sing
Tentoraz to prišlo skôr . "	prišlo	2	Sing
“ Ty pokúšaš moju trpezlivosť ? “ zreval .	pokúšaš	2	Sing
Panterov nápad však zabral .	zabral	3	Sing
Do dvoch rokov ju tie jej decká udajú Ideopolícii .	udajú	7	Plur
“ Nejdem ! “ odvrkol Mauglí .	Nejdem	1	Sing
“ Hovoríte peniaze ? “	Hovoríte	1	Plur
Preháňali sa po ňom autá .	Preháňali	0	Plur
“ Čo sa deje ? “ spýtal sa Chris , hoci sme to obaja vedeli .	vedeli	14	Plur
Pokiaľ mohol predvídať , jestvovali dve možnosti .	jestvovali	4	Plur
“ Zabije ? “ zvolal Mauglí .	Zabije	1	Sing
Po chvíli však medzi nami zavládlo napäté ticho a obaja sme sa otočili k oknu .	otočili	12	Plur
Vysypte do nej kuskus a vypnite oheň .	Vysypte	0	Plur
Ukázala na oblohu .	Ukázala	0	Sing
Každé ráno sme sa na mojom balkóne hrali hru na mačku a myš .	hrali	7	Plur
Nemôžete ho minúť . “	Nemôžete	0	Plur
„ Akže umierajú vaši ľudia , sú do neba vynášaní , akže naši , idú k našim do priepasti . . . “	idú	14	Plur
Navyše technológia našich tlačiarní sa ani dnes veľmi neodlišuje od technológie z čias Gutenberga .	neodlišuje	8	Sing
Veď ho strhne do hlbočiny , pomyslela si Polly .	strhne	2	Sing
Moje bunky sa rozochveli .	rozochveli	3	Plur
Tam na kamennom tróne sedel sám kráľ opíc .	sedel	4	Sing
Začala som s kapitolou o zatmení a snažila sa spomenúť na to , čo som videla .	Začala	0	Sing
Ráno sa Alfonz za bratovo správanie všetkým ospravedlňoval .	ospravedlňoval	7	Sing
Američania by nemuseli bombardovať Irak .	nemuseli	2	Plur
Nezáleží na tom , čo povieš či urobíš ; záleží jedine na tom , čo cítiš .	cítiš	15	Sing
“ Poď sem , sadni si vedľa mňa . “	Poď	1	Sing
Otočila sa a odletela .	odletela	3	Sing
“ Žobrákov nekŕmime , “ povedal sluha .	nekŕmime	2	Plur
Dal som mu takéto meno , keď som s akousi ľahkosťou presvedčil sám seba , že toto meno najlepšie pristane môjmu hrdinovi .	pristane	19	Sing
Začiatkom 11 storočia bolo pomerne málo významným sídlom — nespomína sa napr . pri delení údelov Vladimírovým synom .	nespomína	9	Sing
Unášajú ma preč ! “	Unášajú	0	Plur
“ Máš nejaký problém ? “ spýtala sa Jill , keď plávala popri mne .	spýtala	6	Sing
Veselo sa prechádzali medzi hosťami , usmievali sa a povzbudzovali ich , aby sa u nich cítili ako doma .	prechádzali	2	Plur
Vediem ho do osady . “	Vediem	0	Sing
My z nich robíme pravdu .	robíme	3	Plur
Blythe dobre vedela , že mama by ma pustila .	vedela	2	Sing
Sergej mi vysvetlil , že tak sa volal jeden hrôzostrašný pes .	vysvetlil	2	Sing
Napriek tomu nerob unáhlené závery .	nerob	2	Sing
Podchvíľou naňho ukradomky pozriem bez toho , aby som pohla hlavou .	pozriem	3	Sing
“ Vítame vás , Pichuľko ! “ povedala Makulienka .	Vítame	1	Plur
Bolo by to v poriadku , keby si sa v duchu nestiahla , len čo sa dotkneš steny .	nestiahla	11	Sing
Chrobáčiky ju najprv utešovali , no potom sa rozhodli , že to povedia Maji .	utešovali	3	Plur
O ' Briena vyparia .	vyparia	3	Plur
Má pokojný , rozvážny hlas , dbá na každé slovo a tvári sa vážne .	dbá	6	Sing
Sklo je prirodzene náchylné rozbiť sa a plech nezaručuje odolnosť voči vlhkosti .	nezaručuje	8	Sing
“ Nechcela som ťa nahnevať , “ vravela som rozpačito .	vravela	7	Sing
Iba na bodliaku sa jagali veľké kvapky rosy , lebo sa báli skotúľať do trávy .	báli	11	Plur
Viedli ma polámané vetvičky a udupaná tráva .	Viedli	0	Plur
Obaja sme sa usmiali , lebo nám obom bolo jasné , že naše rande nikdy nebude len také obyčajné .	usmiali	3	Plur
Chcel som povedať tým civilistom , aby mi aspoň vysvetlili , čo odo mňa chcú .	vysvetlili	9	Plur
Uvedomila som si , že ma nepočúval .	Uvedomila	0	Sing
Potom leteli ponad lúkou , až sa dostali k topoľovej aleji .	leteli	1	Plur
“ Nebolelo ! “	Nebolelo	1	Sing
Zdivočenci sa zarazili .	zarazili	2	Plur
Keď sme sa v pološere prechádzali na korze , všimol som si akúsi ženu .	prechádzali	5	Plur
Vtom zbadal Aladin pred sebou jasnovidca .	zbadal	1	Sing
Vari dnešní otcovia národa často nevravievajú , že naša milovaná vlasť je banánová republika ?	nevravievajú	5	Plur
Podľa Irminých pokynov – samotná Irma vybavovala všelijaké formality – ma poprosili , aby som odišiel z domu a vrátil sa podľa možnosti až večer .	poprosili	11	Plur
Hrebene / okrem svojej prvotnej funkcie slúžili ako amulety na ochranu od zlých síl .	slúžili	6	Plur
Na zem padal teplý dážď a obyvatelia Makovej lúky sa skryli .	padal	2	Sing
“ Nikdy ! “ zvolala .	zvolala	4	Sing
" Niekedy , " poznamenala , " pohrozia človeku niečím -- niečím , čomu nedokáže vzdorovať , na čo nedokáže ani pomyslieť .	nedokáže	14	Sing
Nevládal by bežať , nevládal by uderiť .	Nevládal	0	Sing
Obra Jumba všetci oslavovali a vymenovali za čestného občana Makovej lúky .	oslavovali	3	Plur
Mešťania sa nazlostili a upozornili Herkulovho otca , nech ho viac do mesta nepúšťa .	upozornili	4	Plur
“ Ďakujem , “ povedala Makulienka , “ ibaže neviem , čo mám robiť , aby drozd vrátil Emanuelovi cylinder . “	mám	12	Sing
Spomenul si , že sedí s drevenou bábkou , na ktorej zarobí milióny .	sedí	4	Sing
" My však na všetkých stupňoch život ovládame , Winston .	ovládame	7	Plur
“ Ja som navine ! “ hrdo zvolal Tarzan .	zvolal	7	Sing
Odkiaľ berú títo ľudia presvedčenie , že pre Bratislavčanov reformy neznamenajú záťaž ?	neznamenajú	10	Plur
“ Myslíte tamtoho ? “ spýtal sa .	Myslíte	1	Plur
“ Tu opice hniezdia .	hniezdia	3	Plur
Spamätala sa , až keď zacítila jemný dotyk .	zacítila	5	Sing
Celý dojem nie je nijako uchvacujúci až do chvíle , keď požiadate o jedálny lístok .	požiadate	11	Plur
Mal som ten hrebeň odložený až donedávna .	Mal	0	Sing
Uma Thurman a jej priateľ Ethan Hawke očakávajú v júni narodenie dieťaťa .	očakávajú	7	Plur
Mal som veľké potešenie z knižky Antona Dinku Skalica – moja láska , osud a poťešeňí .	Mal	0	Sing
Uložia doň Korine šteniatka .	Uložia	0	Sing
Pokračovali v pomalej chôdzi po chodbe , keď vtom sa O ' Brien zastavil .	Pokračovali	0	Plur
Všetci traja sme sa hystericky rehotali na pozadí čudných tropických rastlín v plastových črepníkoch .	rehotali	5	Plur
Vysvetlil mi , že mi musia položiť iba niekoľko otázok .	musia	5	Plur
Odmalička mi napríklad šila .	šila	3	Sing
Prijatie novely zákona o štátnej službe umožní okrem iného zamestnanie špičkových odborníkov v ústredných štátnych orgánoch za adekvátneho mzdového ohodnotenia a odstráni nepružnosť zamestnávania v štátnej službe .	odstráni	21	Sing
Potom sa predstavila .	predstavila	2	Sing
Už sa zberala preč , ale vo dverách sa otočila .	otočila	9	Sing
Samonafukovačky sa pýšia výbornými izolačnými schopnosťami , vysokým komfortom pri ležaní a neprepúšťaním vlhkosti .	pýšia	2	Plur
" Urobte to Júlii !	Urobte	1	Plur
Vysypte do nej kuskus a vypnite oheň .	vypnite	5	Plur
Aj tak sa vybrala pod harmanček , či náhodou pod lístkom neostala nejaká kvapôčka .	vybrala	3	Sing
Domčeky vyzdobili girladnami a Vilko s Emilom urobili na jednom krtinci kĺzačku , kde šantili deti .	šantili	14	Plur
Zobuď sa ! “ kričal Mauglí .	kričal	4	Sing
Rozhodol sa letieť za nimi a za trest , že naňho zabudli , vzal so sebou všetkých susedov .	zabudli	11	Plur
Kupovali sa tam jednosmerné lístky na cestu do Hádovho kráľovstva .	Kupovali	0	Plur
Cítila som , ako sa mi do hlavy hrnie krv .	Cítila	0	Sing
Oznámili mi to raz večer aj moje postavy v slávnostných čiernych dvojradových oblekoch .	Oznámili	0	Plur
Tu je prirodzené , že človek dostane vši .	dostane	6	Sing
Keď Ferdovi muži zajali celé nepriateľské vojsko , aj hlavný veliteľ otrokárov vyšiel z podzemnej chodby .	vyšiel	12	Sing
Bola som hrdá na to , čo som za posledné týždne dokázala a chcela som sa s ním o tú radosť podeliť .	chcela	13	Sing
Rozsiahla a pomerne dobre organizovaná archeologická práca na teritóriu bývalého ZSSR , detailne zachytená v materiáloch časopisu „ Sovetskaja Archeologija “ / od roku 1990 Rosijskaja Archeologia / ho dáva k dispozícií veľké množstvo .	dáva	29	Sing
Popri potoku kvitli biele lekná .	kvitli	2	Plur
Tarzan skočil vrčiac ako leopard a vyrušil rodinu .	vyrušil	6	Sing
Winston i dievča vytrvalo jedli .	jedli	4	Plur
Hubert pokrútil hlavou .	pokrútil	1	Sing
“ Musíš vyslať signál , “ hovorieva mi .	hovorieva	6	Sing
“ Tak predsa ste sa bozkávali ! “ zvolala .	bozkávali	5	Plur
Keď som čítala posledné riadky , myslela som na mamu , ktorá robila zázraky , aby sme dajako vyšli .	vyšli	18	Plur
Práve tadiaľ prechádzal po tráve .	prechádzal	2	Sing
Keď zazneli prvé tóny pomalej skladby , rozhodla som sa , že za ním pôjdem .	zazneli	1	Plur
Za nič na svete však nechcela opustiť svoju rodinku , a tak sa Rudko a Flip rozhodli , že jej občas pomôžu .	rozhodli	16	Plur
Paradoxne som si želal , aby neprišiel .	neprišiel	6	Sing
Maja naň mala obrovskú chuť , no držala sa v úctivej vzdialenosti .	držala	7	Sing
Vtáky spievajú , proleti spievajú , Strana nespieva .	spievajú	1	Plur
“ Ihneď ma pustite , “ zvolala Maja .	pustite	3	Plur
Zaželala mi , aby ma rýchlo preložili .	preložili	6	Plur
Krist , nenamáhaj sa , nepoučuj ma o tom , o čom ma stará mama poučila už dávno ‐ pradávno .	poučila	15	Sing
Žiadne z nich nevykazujú nejaké reformné vplyvy .	nevykazujú	3	Plur
Čoskoro sa spriatelili a stále vymýšľali nové hry .	spriatelili	2	Plur
Po desiatich dňoch lekárske konzílium posilnili českí lekári .	posilnili	5	Plur
Majine jemné krídelká sa jagali ako perly a zlatisté telíčko na slnku len tak žiarilo .	jagali	4	Plur
Na rozdiel od iných nedieľ ma vtedy nečakala vo foyeri .	nečakala	7	Sing
Za veľkými stolmi sedeli princovia a šľachtici .	sedeli	3	Plur
Keď leteli okolo sladko rozvoniavajúceho jazmínového kra , neodolali a sadli si naň .	sadli	10	Plur
Nasťahovali sme sa sem iba pred štyrmi dňami .	Nasťahovali	0	Plur
Tváril sa hrozivo .	Tváril	0	Sing
Po špičkách som zišiel do salóna na prízemí , kde som na chvíľu zastal so zatajeným dychom .	zastal	13	Sing
Pozrime sa , teraz , ktoré z týchto statí sú relevantné pre našu tému .	Pozrime	0	Plur
V tej chvíli mi bolo všetko jasné , vedela som , v čom je problém .	vedela	8	Sing
Z Odilonovho listu Štefanovi I . sa dozvedáme , že clunyjský opát a prvý uhorský kráľ boli vo vzájomnom styku už pred odoslaním tohto listu vzniknuvšieho medzi rokmi 1031 – 1038 .	dozvedáme	7	Plur
Sergej , ktorému pohľad na zvieratá spôsoboval pôžitok , začal zo seba vyrážať akési výkriky .	začal	9	Sing
Kto si o Snehulienke rozum trúsi , ten rozletí sa na márne kusy !	trúsi	5	Sing
Zažal fakľu a vysadol na koňa .	Zažal	0	Sing
Kým som si to stačila uvedomiť , po tvári mi tiekli slzy a potichu som vzlykala .	stačila	4	Sing
Neotvoril oči ihneď .	Neotvoril	0	Sing
Nepostupoval by bezpečne , keby odmietol .	Nepostupoval	0	Sing
Už sa nemôžem vrátiť .	nemôžem	2	Sing
Reklama nás každý deň bombarduje rôznymi výzvami , sľubuje bohatstvo , zdravie a úspech .	sľubuje	8	Sing
A tak sa stalo , že nakoniec som sa na jednej hodine roztriasla , keď som si predstavila niečo strašné : v budúcnosti ma čaká to isté , čo stihlo moju mamu .	predstavila	17	Sing
“ Ale sú veci , ktoré nemôžeš zmeniť ani ty ! “	nemôžeš	6	Sing
Hefaistos kul rýchlo blesky , ktoré bohom slúžili ako zbrane .	slúžili	7	Plur
Ďakujeme vám , bratia a sestry , za vaše modlitby , pomoc s potravinami , za vaše rady a inú praktickú pomoc !	Ďakujeme	0	Plur
Vidí priveľmi jasne a rozpráva priveľmi otvorene .	Vidí	0	Sing
Rástol , zrel až dozrel .	dozrel	4	Sing
“ Ale mňa to zaujíma , “ namietla som .	namietla	7	Sing
Chrobáčiky ju najprv utešovali , no potom sa rozhodli , že to povedia Maji .	rozhodli	8	Plur
Košičanov vítali v Trnave kamene	vítali	1	Plur
Niečo v jej posunku mu naznačilo , že sestrička umiera .	umiera	9	Sing
Odhrnula som mokré plavky , prázdne kokakolové plechovice , ceruzky , listy vytrhnuté z notesa a knižku Kto chytá v žite so somárskymi ušami .	Odhrnula	0	Sing
Radili sme mu , aby išiel pomaly .	Radili	0	Plur
Veď čo už zvýšilo z toho , čo z neho mučením nevypáčili ?	nevypáčili	11	Plur
“ Pusti mi chvost , ty tupec , “ skríkol Šer Chán .	Pusti	1	Sing
Zavolajte a rezervujte .	Zavolajte	0	Plur
“ Naozaj ? “ úctivo sa pýtal Pinocchio .	pýtal	6	Sing
Išla prvá , ja za ňou a ocitli sme sa uprostred izby .	ocitli	7	Plur
Rozrývalo mi to dušu a ničilo nervy .	ničilo	5	Sing
Bojujte zo všetkých síl !	Bojujte	0	Plur
Zvieratká odpočívali pred svojimi príbytkami , večerali a popíjali púpavovú šťavu od cikád .	popíjali	8	Plur
Môj otec po jeho rozpade niekoľko týždňov nespal . . .	nespal	7	Sing
Preletela na list toho neznámeho tvora a sadla si vedľa neho .	sadla	7	Sing
Tak si to teda zhrňme .	zhrňme	4	Plur
Marga neverila jej klamstvám , ja som ich prijímal .	neverila	1	Sing
Winstona predovšetkým dráždilo , že v tom rámuse hlasov sotva počul Parsonsove slová , takže ho musel sústavne žiadať , aby svoje nezmysly opakoval .	dráždilo	2	Sing
Chvíľu ho nechali metať sa vo vode , no potom prilákali k studni muža , čo okopával záhradku .	okopával	16	Sing
Zdalo sa mi , že to v ňom vrie .	Zdalo	0	Sing
“ Ako môžete také niečo povedať ! “ vyhŕkla Maja .	môžete	2	Plur
“ No povedzte , nebola som krásna ? “ ubezpečovala sa vážka Kráska .	povedzte	2	Plur
Mauglí sa trocha upokojil .	upokojil	3	Sing
“ Narušujú morálku našich detí , “ kričal do mikrofónu .	Narušujú	1	Plur
Hlavu si oprela o jeho rameno a príjemná vôňa jej vlasov zahnala zápach holubieho trusu .	oprela	2	Sing
Uhorskí zákonodarcovia vytvárali zákony a kánony v prvom rade s ohľadom na konkrétne domáce podmienky a snaženia reformátorov boli pre nich druhoradé .	vytvárali	2	Plur
Pomaly kráčali po dlhom schodišti , ktoré viedlo na strechu , kde bývali , a boli hladní , unavení a veľmi sklamaní .	kráčali	1	Plur
Myslím , že o sebe urobili veľmi pekný obraz , že aj Rómovia a deti z detského domova sa vedia správať na úrovni .	vedia	19	Plur
Poznáte to .	Poznáte	0	Plur
Dlho som sedel pred tým plným pohárom .	sedel	2	Sing
Nemala som nijaký dôvod namietať .	Nemala	0	Sing
Už ma bolia nohy . “	bolia	2	Plur
Volal Jasper .	Volal	0	Sing
Keď som tak urobil , spamätal som sa .	spamätal	5	Sing
Hrozne ma bolia kĺby a nestihla som spojenie . “	bolia	2	Plur
Niekto zo susedov si mohol všimnúť , že som bol preč , mohol by sa ma zvedavo vypytovať , kde som bol , a to by stačilo , aby sa som sa rozčúlil .	stačilo	26	Sing
Ani družka , ani sok ho nesledujú . Čo ho núti vysedávať na konári osamoteného stromu a vyludzovať hudbu do prázdna ?	nesledujú	6	Plur
Nemohla som pochopiť , ako to zo mňa vyletelo .	vyletelo	8	Sing
Jednostaj prichádzali a odchádzali všakovakí väzni : distribútori drog , zlodeji , banditi , šmelinári , opilci , prostitútky .	prichádzali	1	Plur
Trkotali , sŕkali med a zapíjali ho pálenkou !	zapíjali	5	Plur
Po chodníku kráčali ľudia sem a tam .	kráčali	2	Plur
Ktosi vystúpil , aby splnil rozkaz .	vystúpil	1	Sing
“ Môžeme vám nejako pomôcť ? “ zdvorilo sa vypytovala Maja .	Môžeme	1	Plur
Aladin pokrčil plecami .	pokrčil	1	Sing
“ Som včela , pane ! “ zvolala výhražne .	zvolala	7	Sing
Je známe , že hlinené nápodoby medvedích láb , slúžili na ochranu domáceho krbu .	slúžili	9	Plur
Uvedomujem si to , takáto obhajoba prezrádza určitý komplex .	prezrádza	6	Sing
Schytil jeden z mečov a zahnal sa na Džafara .	zahnal	5	Sing
Naučil ju i zopár tónov a zakrátko už Jazmína zabávala hostí jednoduchou melódiou .	zabávala	9	Sing
“ Bol som sebecký a viem to .	viem	5	Sing
Hľadali ju všade , vnútri i vonku , ale bezvýsledne .	Hľadali	0	Plur
Musí byť pohodlný , viem , aby sa v ňom Lienke dobre sedelo a dobre pérovaný , aby nedostala kočovú chorobu .	Musí	0	Sing
" My sme mŕtvi , " povedal .	povedal	6	Sing
A neutekala som otvoriť .	neutekala	1	Sing
Zazrela som ho , keď vystrkoval z obloženia svoj odporný rypák .	Zazrela	0	Sing
“ Nesklamem ťa , otec , “ zvolal Herkules , keď s Pegasom leteli na ostrov Idra .	leteli	13	Plur
Sedel na stoličke neprirodzene vzpriamene a jeho mocné prsia sa nadúvali a zachvievali , akoby mal čeliť nárazu vlny .	zachvievali	12	Plur
Neskôr som sa dozvedel , že sa volá Sergej .	volá	7	Sing
V hoteli ubytovali len mňa .	ubytovali	2	Plur
Najstaršie z nich sa objavujú v I . zákonníku sv . Ladislava .	objavujú	4	Plur
Nemala jediný zub .	Nemala	0	Sing
“ Buďme priatelia , “ navrhol kráľ .	navrhol	5	Sing
Na jeho tvári viseli matkine ustráchané oči .	viseli	3	Plur
“ Dobre , “ povedal .	povedal	4	Sing
Najprv si myslel , že to vybaví podobrotky .	vybaví	6	Sing
Môj potôčik vyrazil von , rozlial sa a ja som zostal zahalený v horúcej pare sauny .	rozlial	5	Sing
“ Obviňujeme vás , že ste nám odcudzili drahocennú potravu , “ povedal prísne veliteľ a dal pokyn , aby ich zajali a postavili pred sudcu .	Obviňujeme	1	Plur
Dva ostrihomské kánony ustanovujú záležitosti okolo biskupov .	ustanovujú	3	Plur
Otvorila som okno a zazrela na Chrisa .	zazrela	4	Sing
Omar sa zasmial od ucha k uchu .	zasmial	2	Sing
Je to celá svorka , oči im žiaria v tme .	žiaria	7	Plur
Preto neskrývame obavy , či sa nechytí aj nás táto nemoc .	nechytí	6	Sing
Chvíľu sme stáli vo dverách , pretože nás ovalil svieži závan klimatizovaného vzduchu .	stáli	2	Plur
Zbombardovali ju -- no , pred mnohými a mnohými rokmi .	Zbombardovali	0	Plur
V osobnosti a profesionalite učiteľa vidí vláda kľúčový prvok rozvoja školského systému .	vidí	5	Sing
“ Čo tu tak príšerne smrdí ? “ čudovala sa Maja .	smrdí	5	Sing
Chcela dva doláre .	Chcela	0	Sing
Postávali v tieni lieštiny .	Postávali	0	Plur
Ukázalo sa , že v jednom stánku predávali plechové panvice .	predávali	7	Plur
A ako mi len pristanú .	pristanú	4	Plur
Winston poznal , že mu za hlavu prisúvajú akýsi ťažký prístroj .	prisúvajú	7	Plur
“ To nič , “ odvetila som , ale pripúšťam , že som bola sklamaná .	odvetila	5	Sing
Tí vo väčšine prípadov velebili filmy nakrútené podľa mojich scenárov .	velebili	4	Plur
V roku 1977 kvôli zdravotným ťažkostiam odchádza do dôchodku po náročnej a požehnanej práci na vinici Pánovej .	odchádza	6	Sing
Pomyslel som si , že keď ju tam zvalili a vláčili po uliciach , podarilo sa jej nejako utiecť , ako utekajú sochy , a prišla sa postaviť sem .	vláčili	10	Plur
Považovala to za skvost vtipnosti a s potešením ho vzala do náručia .	Považovala	0	Sing
" Je to druhá Zlatá krajina , alebo takmer , " zašuškal .	zašuškal	11	Sing
“ Tu niekde mám bundu , “ zamrmlal .	mám	3	Sing
“ Prestaň zúriť , Blythe , “ šepkala som do slúchadla , aby ma mama nepočula .	nepočula	15	Sing
Postav ho na okrúhly stôl .	Postav	0	Sing
Také meno si želal môj otec .	želal	3	Sing
“ Vidíte , čo ste spravili ? “ zabzučala a starostlivo si kefovala jemné chĺpky na tele .	Vidíte	1	Plur
Lulu , ošetrovateľka v ZOO pre mláďatká , zvieratká ľúbila .	ľúbila	9	Sing
Chrobáčiky ju najprv utešovali , no potom sa rozhodli , že to povedia Maji .	povedia	12	Plur
Napokon zvíťazila láska .	zvíťazila	1	Sing
Rozzúrená sa zvrtla a kamennými schodmi zbehla do zámockej pivnice .	zbehla	6	Sing
“ Porozprávame sa inokedy , “ zavolala Blythe a veselo mi zakývala , keď odchádzali .	zakývala	11	Sing
Našťastie , komár letel po chvíli preč .	letel	3	Sing
Nechcela , aby sme jej nechali odkaz .	nechali	5	Plur
Nerob zo seba hlupáka , povedali mi .	povedali	5	Plur
Smrti sa , samozrejme , bojím .	bojím	5	Sing
“ Jill potrebovala pomoc , “ povedala som Shannon .	potrebovala	2	Sing
V Studiofilme sa povrávalo , že šéfa čochvíľa odvolajú ; označovali ho za liberálneho modernistu a bolo iróniou osudu , že najostrejšie na neho útočil týždenník Október .	odvolajú	8	Plur
O päť sekúnd sedel Winston s rozbúchaným srdcom pri stole dievčiny .	sedel	3	Sing
Mám osem nôh , osem očí a sedem chutí .	Mám	0	Sing
Musíte byť tolerantní , musíte pochopiť , že som nemal iné východisko .	Musíte	0	Plur
Džafar oboma rukami schmatol čarodejnú palicu .	schmatol	3	Sing
Vtedy sa naraz ukázalo , že komunistická strana s jej zločineckými spôsobmi skrachovala .	skrachovala	12	Sing
Správal sa , akoby sa nič nestalo .	Správal	0	Sing
Opice , čo držali Mauglího , sa zaškerili a pustili ho .	držali	3	Plur
Tento delikt poznali oba hlavné zdroje cirkevného práva – Biblia i rímske právo .	poznali	2	Plur
Ukradomky pozrel na Kalifa .	pozrel	1	Sing
“ Nebojím sa ťa . “	Nebojím	1	Sing
Presadni si na druhú stranu postele .	Presadni	0	Sing
“ Vidíš , Jago , “ povedal svojmu papagájovi .	Vidíš	1	Sing
Zosobášili sme sa , keď bola v štvrtom mesiaci .	Zosobášili	0	Plur
“ To je idiotský nápad ! “ zvolal , ale videla som , že sa mu to páči .	páči	17	Sing
Možno si až teraz uvedomila , kam to jej klamstvo viedlo .	uvedomila	4	Sing
Po tréningoch som ostávala v bazéne a trénovala som sama .	trénovala	7	Sing
“ Oslavujeme na tvoju počesť , “ povedala Halima .	Oslavujeme	1	Plur
A kým je môj pas v rukách toho muža , veci vonkoncom nevyzerajú dobre .	nevyzerajú	12	Plur
Aj keď v noci ešte nelietala , rozprestrela krídla a opustila svoju bezpečnú dutinku v strome .	rozprestrela	7	Sing
Samozrejme , že Maja s Vilkom zablúdili v jesennej hmle ako prví .	zablúdili	6	Plur
Nemohla som si spomenúť , odkiaľ ju poznám .	poznám	7	Sing
Viečka sa roztvorili .	roztvorili	2	Plur
Keď som v dráhe zastala a šliapala vodu , zabrzdila som ostatných plavcov .	šliapala	6	Sing
Usadili sme sa na pohovke a z kuchyne sme počuli tikanie hodín na rúre .	Usadili	0	Plur
Abu túžobne pozeral na palác v pozadí .	pozeral	2	Sing
Ešteže to spozorvali mravce a zavolali hasičov !	spozorvali	2	Plur
Maja zaviedla hostí na slávnostne vyzdobenú lúku a ponúkla im vyhliadkový let s vážkou , medové guľôčky , cukrovú vatu a mnoho iných dobrôt .	ponúkla	8	Sing
Už tretíkrát sme sa mohli stretnúť na neformálnej úrovni a prebrať pálčivé problémy , s ktorými sa stretávame na chodbách našej školy .	stretávame	17	Plur
Napokon sme z kríkov vybrali Chrisov bicykel a pomaly sme vyšli na ulicu .	vybrali	4	Plur
Prikrčená som vyliezla na vrchol strechy , chvíľu som balansovala a opatrne som zliezla na opačnú stranu .	vyliezla	2	Sing
Potom prišli texty , ktoré som Deline nikdy neukázal .	prišli	1	Plur
Omar pustil vankúš a skočil na zem .	skočil	4	Sing
Sultán spustil plecia .	spustil	1	Sing
Vtedy víly pochopili , že je načase , aby dievčine povedali pravdu .	pochopili	2	Plur
Hravo obopínal jednou rukou celý Júliin pružný pás .	obopínal	1	Sing
Keď som jej zopakoval svoje tvrdenie , poďakovala sa mi .	zopakoval	3	Sing
Vlci sa zhromaždili na Veľkej skale .	zhromaždili	2	Plur
Barbie a Sandra sa zľakli .	zľakli	4	Plur
Uvítala každú príležitosť , aby som vypadla z mesta na čerstvý vzduch .	Uvítala	0	Sing
“ Kam ideme , Baghíra ? “ spýtal sa Mauglí .	ideme	2	Plur
Ženskú časť tejto tretej delegácie tvorili ženy v prechode .	tvorili	5	Plur
Chvíľu ho nechali metať sa vo vode , no potom prilákali k studni muža , čo okopával záhradku .	nechali	2	Plur
Maja , Vilko a Flip sa mu ani nečudovali .	nečudovali	8	Plur
Znak potom môžme vykladať ako zobrazenie vtáka s roztiahnutými krídlami a hlavou vysunutou dopredu .	môžme	2	Plur
Sedela na pohovke len v kombiné a čítala jednu z mojich poviedok .	čítala	7	Sing
Prišli pokušenia , zvody a ony podľahli .	podľahli	6	Plur
Keďže kníh , ktoré mi zostali , nebolo ktovieako veľa , vrece bude ťažšie , ak pridám rukopisy svojich scenárov .	pridám	16	Sing
Jedného večera mi zatelefonovali deti .	zatelefonovali	3	Plur
“ Viete čo ? “ povedal Ferdo kamarátom .	Viete	1	Plur
" Nenávidím mravnú čistotu , nenávidím dobrotu !	nenávidím	5	Sing
Víťaz získava CD alebo DVD podľa vlastného výberu !	získava	1	Sing
Pamätám sa na dvoch z nich .	Pamätám	0	Sing
" Áno , " prisvedčil Winston .	prisvedčil	4	Sing
Nové skupiny stredu však vyhlásili svoju tyraniu vopred .	vyhlásili	4	Plur
Od straníkov sa vyžadoval podobný názor , aký mali starovekí Židia , ktorí síce vedeli , že všetky iné národy uctievajú nepravých bohov , ale to bolo všetko , čo o nich vedeli .	uctievajú	20	Plur
Hugovi životopisci nás informujú o dobrom výsledku účinkovania opáta v Uhorsku .	informujú	3	Plur
Všetci obyvatelia Makovej lúky sa zišli na čistine , kde Rudko poriadal letecké preteky .	zišli	5	Plur
Vyšiel som na kopec , ale nestretol som nijakého psa .	nestretol	6	Sing
Že ste už o mne počuli ?	počuli	5	Plur
Postupne ju cítila čoraz silnejšie .	cítila	2	Sing
Viedol ma ešte asi dvadsať metrov a tam zastal .	Viedol	0	Sing
“ Tentoraz by sme mali hudbu vynechať a usporiadať maratónsky beh , “ navrhol Rudko a všetci nadšene súhlasili .	súhlasili	18	Plur
Ale to vedia všetci .	vedia	2	Plur
Faika musela byť príťažlivé dievča .	musela	1	Sing
Hľadala čosi v šatách , potom sa vrátila , usmiala sa , ľahla si a naznačila mi , aby som urobil to isté .	usmiala	9	Sing
“ Vráťte sa , vy zlodeji ! “ hrmel za nimi predavačov zúrivý rev .	hrmel	8	Sing
Asi je choré , pomyslela si Maja .	pomyslela	4	Sing
Robili tak skôr mocní šľachtici , usilujúci sa o odtrhnutie časti krajiny / najpríhodnejším príkladom je tu uhorské povstanie Vathu roku 1046 v Bekeszi / .	Robili	0	Plur
Zrútil sochu a vláčil ju po uliciach našej štvrte .	Zrútil	0	Sing
A , prosím ťa , nalej mi ešte raz do tohto pohára !	prosím	2	Sing
Prišiel onedlho so stetoskopom v ruke .	Prišiel	0	Sing
Keď sme prišli domov , povedal som im , aby išli do izby .	prišli	2	Plur
Postávali v tieni lieštiny .	Postávali	0	Plur
Nezničil som ich , iba som ich ukryl .	Nezničil	0	Sing
Celá sa triasla , sotva vládala stáť na nohách .	vládala	5	Sing
To sú jediné výsledky , ktoré dosiahnete .	dosiahnete	6	Plur
Aby nás neobvinili z farizejstva .	neobvinili	2	Plur
Nasleduje objavenie sa volchva v Rostove , udalosti v Polocku , sucho a Polovci .	Nasleduje	0	Sing
Rozprávali sme sa až po pretekoch .	Rozprávali	0	Plur
Nerúhajme sa Bohu a nereptajme na všetko a všetkých .	nereptajme	4	Plur
Rešpektovali ste otca bezvýhradne ?	Rešpektovali	0	Plur
Tešila som sa , ale zároveň mi chýbali tie chvíle , keď sme po večierkoch spolu posedeli a rozoberali každý detail .	posedeli	16	Plur
Kedysi ich zalievali do skla .	zalievali	2	Plur
Oba tieto kánony zodpovedajú dávnej praxi latinskej cirkvi .	zodpovedajú	3	Plur
Chcel som povedať tým civilistom , aby mi aspoň vysvetlili , čo odo mňa chcú .	chcú	14	Plur
Počul som , že noviny platia dobre , keď chcú .	platia	5	Plur
Všetci smutne hľadeli do prázdneho košíka , kde predtým ležali šteniatka .	hľadeli	2	Plur
“ Prečo si to spravila ? “ skríkla som na ňu .	skríkla	7	Sing
Bolo tu pododdelenie televíznych programov s inžiniermi , producentmi a s celými tímami špeciálne vybraných hercov , lebo dokázali imitovať hlasy .	dokázali	18	Plur
Keď sa zasa vrátili do triedy , pani učiteľka im prečítala zaujímavú rozprávku .	vrátili	3	Plur
Ani bratanci sa sem už neodvážia prísť , priatelia k nám prestali chodiť na návštevu už dávno .	neodvážia	5	Plur
“ Len sa tak netvárte , “ namietala vážka Kráska .	netvárte	4	Plur
Ak ťažké kvapky zasiahnu jej jemné krídelká , môžu ju poraniť .	zasiahnu	3	Plur
Chvíľu leteli , až pristáli v spustnutej záhrade , kde bola pod obrovskou smutnou vŕbou hlbočizná studňa .	pristáli	4	Plur
Človek očakával , že ho zabijú .	zabijú	5	Plur
Prihlásime ho do vzpieračskej súťaže , “ povedal .	Prihlásime	0	Plur
Vláda uskutoční revíziu úradov , pripraví zmeny v pracovno - právnej legislatíve a uskutoční reorganizáciu štátnej správy .	uskutoční	13	Sing
“ Nemôžeš mi nič zakazovať !	Nemôžeš	1	Sing
Do Winstonovej ruky sa zapichla ihla .	zapichla	4	Sing
Ak sa raz oldspeak nahradí , posledné puto s minulosťou sa pretne .	nahradí	4	Sing
V mnohých prípadoch to zaberie .	zaberie	4	Sing
Vyznajme Bohu svoje hriechy , potom nám Boh daruje tento pokoj skrze vieru v Ježiša Krista .	Vyznajme	0	Plur
“ Takže musím zavolať tvojmu otcovi , “ povedala .	musím	2	Sing
Ľudstvo svojou usilovnosťou prispelo k zrodu dvoch svetových vojen , ba v niektorých kútoch Zeme vojny pokračujú .	pokračujú	16	Plur
O týždeň sme sa dozvedeli , že ju na rok vylúčili z fakulty .	vylúčili	10	Plur
“ Musíš mať fotografickú pamäť . “	Musíš	1	Sing
Zakrátko nevidela na cestu .	nevidela	1	Sing
V niekoľkých sekundách po prebudení sen i spomienka , ktorá ho podnietila , splynuli v jeho mysli v jedno .	splynuli	13	Plur
Veselo sa prechádzali medzi hosťami , usmievali sa a povzbudzovali ich , aby sa u nich cítili ako doma .	cítili	16	Plur
“ Myslel som , že v láske to tak chodí , “ povedal Aladin .	Myslel	1	Sing
Hook sa napokon obrátil k Wendy , zľahka sa dotkol klobúka a vystrúhal poklonu .	vystrúhal	12	Sing
Alebo si ju stiahnite v súbore PDF na tej istej adrese .	stiahnite	3	Plur
Pretekáme s tromi dobrými plavkyňami z Octilla , a mňa tu deptá vlastná kolegyňa .	Pretekáme	0	Plur
Vyzerajú ako šťastná dvojica ! “ zvolala prekvapená Sandra .	Vyzerajú	0	Plur
V sledovaných cirkevnoprávnych zbierkach sme pendanty k uhorským úpravám nenašli .	nenašli	9	Plur
“ Možno by sa princeznej páčili nové šaty , “ navrhol Nassir .	páčili	5	Plur
V prvých troch kapitolách sa teda pokúsime o prieskum problematiky v celoruskom rámci , odhliadnuc od jemnejších miestnych odlišností .	pokúsime	6	Plur
Z Bibinej pokladničky sa stratili peniaze .	stratili	4	Plur
“ Máte Baghírovo slovo , “ dodal .	Máte	1	Plur
Musel niečo napísať .	Musel	0	Sing
Bola horúca júlová noc a vládla dusivá spara .	Bola	0	Sing
Všetky ďalšie uhorské právne normy , ktoré reglementujú život kláštorných spoločenstiev nachádzame potom až medzi kánonmi I . ostrihomskej synody .	nachádzame	11	Plur
Svedčí o tom podobnosť pečatí č . 4 a 5 s pečaťami č . 6 až 9 patriacimi Izjaslavovým bratom Svjatopolkovi a Vsevolodovi .	Svedčí	0	Sing
Pomaly vstala a po niekoľkých knísavých krokoch zasa našla rovnováhu .	vstala	1	Sing
Formality vybavíme zajtra .	vybavíme	1	Plur
Tatko sa hneval na deti , lebo ukrutne vyvádzali , a mamka sa hnevala na tatka , že je precitlivený .	hneval	2	Sing
Poletím za tebou , “ povedal Vilko , obrátil sa na bok a zaspal .	zaspal	13	Sing
Nadšene sledovali hru .	sledovali	1	Plur
Zľakli sme sa druhý raz .	Zľakli	0	Plur
Prvý , druhý , tretí aj štvrý odkaz mi nechala Blythe a zneli čoraz rozčúlenejšie .	zneli	12	Plur
Pamätajte na Ježišove slová : Kto vytrvá do konca , bude spasený .	vytrvá	6	Sing
Prepáčila by mi to , aj keby vedela , že som to odkladala kvôli nočnému astronomickému klubu s Chrisom ?	vedela	7	Sing
Nikto ma nepočúval .	nepočúval	2	Sing
Povedala , že by sme mali odísť bez rozlúčky , nechcela , aby sme nechali Irme odkaz , kam ideme , a ja som pozbieral odvahu .	nechcela	10	Sing
Vyspevovali sme odrhovačky , občas sme lúštili krížovky alebo sa hrali slovné hry .	hrali	10	Plur
Keď sa našli uprostred mladiny , obrátila sa k nemu tvárou .	našli	2	Plur
“ Možno sa zajtra vrátim , keď budem mať peniaze , aby ste mi o ňom povedali viac . “	vrátim	4	Sing
Na Aladina celkom zabudli .	zabudli	3	Plur
Zišli sa tu všetci tunajší obyvatelia .	Zišli	0	Plur
Opice skákali z konára na konár a preskakovali koruny stromov , čo rástli pozdĺž brehu rieky .	skákali	1	Plur
V okne na prvom poschodí zbadala uväznenú cvrčicu .	zbadala	5	Sing
Napokon zlá víla priviedla princeznú do izbietky na samom vrchu vežičky .	priviedla	3	Sing
Do slovenských častí Uhorska sa vtedy utiahla jedna časť českých emigrovaných protestantov a tu našli v používaní svoj vlastný spisovný jazyk presne tak , ako vo svojej českej vlasti .	našli	14	Plur
Keď ho vypije , majú ho zabiť .	vypije	2	Sing
Jillina mama s otcom tam zamračení meravo sedeli , ako keby chceli silou vôle dotlačiť dcéru na stupienok víťazov .	sedeli	7	Plur
V prvých listoch reaguje na uhorskú vnútropolitickú situáciu , keď prebiehali boje medzi Gejzom a Šalamúnom o uhorský trón .	prebiehali	10	Plur
Tak je po Jaroslavovom víťazstve položený základ novgorodských výsad , ktorí Novgorodcom garantujú ochranu pred kniežacími družiníkmi a Varjagmi / no zároveň zabezpečujú kniežaciu družinu pred ľudom / .	zabezpečujú	22	Plur
Veľkú tašku hodil do kúta a mľaskavo ho pobozkal .	hodil	2	Sing
Profesor rozprával historku o anglickej vojenskej misii , ktorú cez vojnu zhodili na padákoch .	zhodili	11	Plur
On aj nás prevedie cez križovatky	prevedie	3	Sing
Krútiace sa duše mŕtvych stiahli pána podsvetia medzi seba .	stiahli	4	Plur
Zapojte sa aktívne do zborového života , príjmite pozvanie mládeže , navštevujte tento chrám , prichádzajte k Večeri Pánovej .	prichádzajte	15	Plur
Nezdalo sa mi , že veštia nejaké zásadné zmeny .	veštia	5	Plur
“ Vy tu bývate ? “ spýtala sa Maja .	bývate	3	Plur
Pravdu o jeho smrti sme sa dozvedeli rýchlo .	dozvedeli	6	Plur
Vláda bude zvyšovať prostriedky na vzdelávanie , aby sa postupne priblížili priemernej hodnote podielu z HDP v krajinách EÚ .	priblížili	10	Plur
Zámok sa zatriasol , keď dedinčania vrazili baranidlom do brány .	vrazili	6	Plur
Zapojte sa aktívne do zborového života , príjmite pozvanie mládeže , navštevujte tento chrám , prichádzajte k Večeri Pánovej .	príjmite	7	Plur
Po večeri sme odpratali zo stola a vytiahla som fyziku .	vytiahla	7	Sing
“ Počkajte .	Počkajte	1	Plur
Pripomínala lebku umrlca .	Pripomínala	0	Sing
Nemala názov .	Nemala	0	Sing
Rímski reformátori totiž potrebovali inštrumentárium , prostredníctvom ktorého by zdokladovali oprávnenosť svojich požiadaviek .	potrebovali	3	Plur
Bol by som nerád , keby mi bezočivá penica uchmatla tučnú korisť .	uchmatla	9	Sing
Naopak , mama sedávala za stolom a písala listy .	sedávala	3	Sing
“ Keď napríklad zavrem oči , vidím teba , Amy . “	vidím	6	Sing
A spal som .	spal	1	Sing
Maja s Vilkom sedeli na lesnej čistine a vymýšľali si o nich príbehy .	sedeli	3	Plur
Dôležitejším znakom oboch kategórií šamanov je , že úspech ich činov nezávisí od toho , akú obetu bohu prinesú , ale od toho v akom vzťahu sú oni sami s bohmi — tj . od ich schopností .	prinesú	18	Plur
Pustili sa do upratovania školských plástov .	Pustili	0	Plur
Najdivokejšie vrieskali školopovinné deti .	vrieskali	1	Plur
“ PÄŤ TELEFONÁTOV ! “ zvolala som , keď som zbadala , že doma v chodbe bliká svetielko na odkazovači .	bliká	16	Sing
Ferdo z toho usúdil , že bývalí otrokári nevedia ani písať .	nevedia	8	Plur
Tieto úvahy ma uvrhli do krízy , počas ktorej som si uvedomoval svoju vinu .	uvrhli	3	Plur
Nevyhýbali sme sa ani politike .	Nevyhýbali	0	Plur
Usadili sme sa pripravení sledovať oblohu .	Usadili	0	Plur
Odmlčal sa .	Odmlčal	0	Sing
Zišlo mu na um , že až doteraz ho zrejme nevidela na voľnom priestranstve v plnom dennom svetle .	nevidela	10	Sing
Vytieňoval lícne kosti a tmavé obočie .	Vytieňoval	0	Sing
Robievali sme to vždy postojačky .	Robievali	0	Plur
Z rany na krku jej vyrástli tri krútiace sa hlavy .	vyrástli	5	Plur
Marketing je súborom disciplín , ktoré sa zaoberajú trhom a v trhovej ekonomike človek má cenu , ktorá sa vyjadruje len peniazmi .	zaoberajú	7	Plur
Nezdalo sa mi však , že som ho presvedčila .	presvedčila	8	Sing
Najprv zamierila za Flipom .	zamierila	1	Sing
Strhla aj mladšiu sestru a s rachotom prevrhli otcovu stoličku .	prevrhli	7	Plur
Počas jazdy sa Rýchlik a Jill hádali , ktorú stanicu naladia .	naladia	10	Plur
“ Zničíme ho ! “ zahrmeli Titan Skala , Titan Sopka , Titan Ľadovec , Titan Tornádo a jednooký Kyklop , keď po jednom vychádzali z jaskyne .	vychádzali	24	Plur
Emanuel s Makulienkou tak ‐ tak stačili preskočiť na najbližšie lekno .	stačili	6	Plur
Našiel som vašu opičku ! “	Našiel	0	Sing
Nerozumel som , prečo mi to hovorí .	Nerozumel	0	Sing
" Porazili sme ťa , Winston .	Porazili	1	Plur
Tam hodili Maju do väzenia , kde boli aj iné zvieratká .	hodili	1	Plur
Nateraz sa uzavrel pred vzdialenejšími zvukmi a počúval len kvákanie , ktoré sa valilo z obrazovky .	počúval	7	Sing
Najprv sme sa pomaly a opatrne zakrádali k ich domu , ale potom sme prebiehali od lampy k lampe .	prebiehali	14	Plur
A tak sa stalo , že nakoniec som sa na jednej hodine roztriasla , keď som si predstavila niečo strašné : v budúcnosti ma čaká to isté , čo stihlo moju mamu .	čaká	24	Sing
Nevieme , kde v tú noc odišiel .	Nevieme	0	Plur
“ Kvak , “ zvolala na krtka žaba , “ počkaj , pomôžem ti .	počkaj	10	Sing
“ Nezistia to , “ odvetila Flóra .	Nezistia	1	Plur
Aj Maja so škriatkom opustili topoľ a leteli , kým nedoleteli k domu , kde sa v oknách ešte svietilo .	opustili	4	Plur
Zapojte sa aktívne do zborového života , príjmite pozvanie mládeže , navštevujte tento chrám , prichádzajte k Večeri Pánovej .	navštevujte	11	Plur
Protiprávna vojna v Iraku , ktorú rozpútala nesvätá aliancia náboženských fundamentalistov , megalománov a kšeftárov , je cynickým výsmechom všetkých hodnôt , ktoré naša západná civilizácia pokladá za nedotknuteľné .	rozpútala	6	Sing
Moja trpezlivosť sa vyčerpala , keď ručičky na hodinkách stihli ukázať pol dvanástej a mne sa nikto nevenoval .	nevenoval	17	Sing
“ Stavím sa , že je to bytosť z inej planéty , “ zašepkala Maja a zatiaľ čo sakamaráti skrývali za jej chrbtom , podišla bližšie a navrhla neznámemu prehliadku Makovej lúky .	skrývali	19	Plur
Pred bránou Maju oslepilo žiarivé svetlo , až privrela oči .	privrela	8	Sing
Čítala o tom v knihách .	Čítala	0	Sing
Išli sme až k nášmu vchodu na zadnej strane domu a celou cestou sme mlčali .	Išli	0	Plur
Keď ju môj brat zbadal , od úzkosti div nezomrel .	nezomrel	9	Sing
Prihláste sa do 13 . 6 . 2004	Prihláste	0	Plur
Prečo by vlastne tí mimozemšťania mali byť naši priatelia alebo nepriatelia , keď sa vyvíjali s úplne iným backgroundom , v inom kontexte , majú totálne iný spôsob dorozumievania , ich ciele a motivácie nechápeme ?	vyvíjali	14	Plur
Počujete ma ?	Počujete	0	Plur
Rudko a Flip by s ním najradšej vyrazili dvere .	vyrazili	7	Plur
Lori nemala ani najmenšie podozrenie , že vo mne sa prebudilo zviera .	prebudilo	10	Sing
V oblasti manželského práva je teda uhorské ranoarpádovské zákonodarstvo , ak ho porovnávame s dobovým kánonickým právom , nejednoznačné .	porovnávame	12	Plur
Rozmaznávali ťa .	Rozmaznávali	0	Plur
“ Neviete , že vám piraňa za pár sekúd obžerie všetko mäso ? “	obžerie	9	Sing
Hneď vzali Vilka medzi seba .	vzali	1	Plur
Vďaka týmto skúsenostiam pre mňa teoreticky neexistovalo nijaké tajomstvo súvisiace s túžbami , ktoré nútia muža pokúšať sa o zblíženie so ženou .	nútia	14	Plur
Abu sledoval , kam pozerá , a zbadal dievča .	pozerá	4	Sing
Poslušnosť nestačí .	nestačí	1	Sing
Spustili novú internetovú televíziu Braňa Krála	Spustili	0	Plur
Rád by som v tomto poďakovaní spomenul všetkých , ktorí akoukoľvek radou či pomocou prispeli ku zrodu predkladanej publikácie .	prispeli	14	Plur
Mala Lizine oči .	Mala	0	Sing
Neodvážili sa ho dráždiť ani decká , ani psy .	Neodvážili	0	Plur
“ Pustite ma na zem ! “ kričal Mauglí .	Pustite	1	Plur
Toto ministerstvo však nemuselo uspokojovať mnohoraké potreby straníkov , ale opakovať celú operáciu na nižšej úrovni pre blaho proletariátu .	nemuselo	3	Sing
Okamžite vzlietla nad miesto nešťastia , kde topiace sa mravce zúfalo kričali o pomoc .	kričali	11	Plur
“ Mama mi ho poslala .	poslala	4	Sing
Slovenská republika sa nachádza v tomto globálnom bezpečnostnom prostredí .	nachádza	3	Sing
Jedného dňa sochu odtiaľ strhol dav , ktorý rozzúrilo jej namyslené povýšenectvo .	rozzúrilo	8	Sing
Kŕč povolil .	povolil	1	Sing
Marga nereagovala , takže to bol iba sluchový klam .	nereagovala	1	Sing
Vážka , čo krúžila vysoko nad čistinou , ponúkala vyhliadkový let .	ponúkala	8	Sing
Tigríča sledovalo , ako sa rozkotúľali , a skočilo medzi ne !	skočilo	8	Sing
Chvíľu zúril ako tiger .	zúril	1	Sing
Obe upierali naňho zrak .	upierali	1	Plur
Posledný szabolcsský kánon , ktorý sa venuje kláštornému životu nariaďuje opátom a mníchom , aby sa nezúčastňovali na kalendových sedeniach , ale aby prijímali oblácie ich účastníkov v kláštoroch .	nezúčastňovali	16	Plur
Sadla som si na lavičku a zavrela oči .	Sadla	0	Sing
“ Tak rozprávaj , “ súrila ma Blythe , keď sme nastúpili do jej džípu .	nastúpili	11	Plur
" Koľko prstov zdvíham , Winston ? "	zdvíham	3	Sing
A veselili sa , kým nezapadlo slnko .	veselili	1	Plur
Dotkol som sa jej .	Dotkol	0	Sing
Pokúsil sa o úsmev .	Pokúsil	0	Sing
Vezmeš si tie Finneganky ? “	Vezmeš	0	Sing
Vymenoval som štyri číslice , ktoré tvorili číslo mojej izby .	Vymenoval	0	Sing
Chutilo jedlo vždy takto ?	Chutilo	0	Sing
V reformnom hnutí v 10 . a 11 . storočí musíme zreteľne odlíšiť dve základné línie – staršiu reformu monastickú a mladšiu reformu rímsku , resp . pápežskú .	musíme	10	Plur
Svoju neforemnú topánku presunula o pár centimetrov a naschvál dodrúzgala konárik .	presunula	3	Sing
Škole chýbali priestory , a tak žiaci prvého stupňa , čiže aj my prváčikovia , mávali vyučovanie popoludní .	chýbali	1	Plur
Spomínaní suzdaľskí volchvi sa zjavujú práve v čase neúrody , aby ju pomohli zahnať .	pomohli	12	Plur
“ To bude naše tajomstvo , nikomu ho neprezradíme . “	neprezradíme	8	Plur
V noci sa voľne pohybovali dedinské psy a ja som sa ich bál na smrť .	pohybovali	4	Plur
Otesávame jazyk až na kosť .	Otesávame	0	Plur
Veci sa vyvinuli inak , než som sa obával .	vyvinuli	2	Plur
Smutným hlasom im Kasandra oznámila , že v noci navšítvili komoru s medom zlodeji a spôsobili im veľkú škodu .	navšítvili	9	Plur
Neveriacky som sa na ňu dívala , cítiac , ako ma zadúša od hnevu .	dívala	5	Sing
Chceli si chvíľu odpočinúť .	Chceli	0	Plur
Na bielizníku mi nechala odkaz : “ Dúfam , že si sa dobre bavila , srdiečko . “	Dúfam	7	Sing
Od tej chvíle som sa myšlienky , že tá mačka mi vidí do duše , nevedela zbaviť .	nevedela	15	Sing
“ Nemôžeme čakať .	Nemôžeme	1	Plur
“ Strach z fyziky ? “ spýtal sa , akoby som povedala najväčšiu hlúposť .	spýtal	6	Sing
Vyrába umelé potreby , ktoré nás aktivujú , vyprázdňujú , ničia a zotročujú .	zotročujú	12	Plur
Prichádzali sme zozadu , a tak sme sa vyhli autobusom , autám a nápisom nad vstupom .	Prichádzali	0	Plur
Nemal najmenšie pokušenie jej klamať .	Nemal	0	Sing
Vtedy nás poslali na brigádu do Jonufëru pri Vlore , kde sme mesiac budovali terasové polia .	budovali	13	Plur
V náručí niesol nákupnú tašku .	niesol	2	Sing
Keď som mala bundu na sebe , zistila som , že ju nepotrebujem .	zistila	7	Sing
S letenkou v ruke som vyšiel z izby a zamieril k stolu , kde sedeli recepčné z môjho poschodia .	sedeli	14	Plur
Zdvihol zrak na O ' Briena .	Zdvihol	0	Sing
Heather mu niečo zašepkala do ucha .	zašepkala	3	Sing
Zviera , čo obýva zámok , ja naskutku skolím .	skolím	8	Sing
Vedel , že to tak nie je , jej vzrušenie , keď mu podávala odkaz , bolo príliš skutočné .	podávala	13	Sing
Rýchlo písal , čmáral :	čmáral	3	Sing
Uvedomila som si , že som nevhodne zareagovala , lenže ten bozk ma naozaj vyviedol z miery .	vyviedol	14	Sing
“ Fajn , “ povedal so sileným smiechom .	povedal	4	Sing
“ Viem , “ povedala som a vystúpila z auta , “ ale ak budem myslieť len na zábavu , môžem ísť zametať chodníky . “	môžem	20	Sing
Títo Sosolci tiahnú proti Rusom , plienia ruský oporný bod Jurjev a útočia na Pskov .	tiahnú	2	Plur
Keď prišli na miesto , Alfonz stál v korune stromu .	prišli	1	Plur
Usmiala som sa na Chrisa , a on sa uškrnul , ako keby mu naozaj odľahlo , že súhlasím .	odľahlo	15	Sing
Od chvíle , keď ho uväznili , nepoznal , čo je tma a čo denné svetlo .	uväznili	5	Plur
Keď dohovoril , usmial sa svojím záhadným úsmevom a ustúpil nabok , aby uvoľnil cestu Lori .	usmial	3	Sing
Vláda si uvedomuje výzvy informačného veku .	uvedomuje	2	Sing
Straníčky sa nikdy nefarbili .	nefarbili	3	Plur
“ To je nespravodlivé ! “ namietla som .	namietla	6	Sing
Dodala , že aj ja sa jej páčim .	páčim	7	Sing
Obaja sme začuli mamino zlostné vzdychnutie .	začuli	2	Plur
Na schodisku dupotali čižmy .	dupotali	2	Plur
Anita jej to sľúbila a zložila .	zložila	5	Sing
Maja mu nemohla uniknúť , lebo lietal tri razy rýchlejšie ako ona a určite by ju chytil .	lietal	6	Sing
Známe uskromňovacie heslo " Jeme preto , aby sme žili . " nie je pravdivé .	žili	9	Plur
Keď Herkules počul tie slová , vrátila sa mu odvaha .	vrátila	6	Sing
Chvíľu sa preťahovali , až napokon odlomili panvici rúčku .	preťahovali	2	Plur
Detský biblický tábor pripravujeme v prekrásnom prostredí Žiarskej doliny v dňoch 31 . 7 . až 7 . 8 . 2004	pripravujeme	3	Plur
“ Toto je tvoja detská izba , neskôr dostaneš večeru , “ vysvetľovala mu Maja .	vysvetľovala	12	Sing
“ Určite ťa zaskočila moja výnimočná krása , “ zašveholilo .	zaskočila	3	Sing
Pomôžu vám vyniesť nahor veci , povedal Cerberus a podal ten kľúč mame .	podal	9	Sing
Kravy bučali a zo slamy utekalo všetko živé .	bučali	1	Plur
“ Obviňujeme vás , že ste nám odcudzili drahocennú potravu , “ povedal prísne veliteľ a dal pokyn , aby ich zajali a postavili pred sudcu .	zajali	21	Plur
Povedala mi , že sa milujeme naposledy .	milujeme	5	Plur
Nečakal som , že ju moje slová až tak rozosmejú .	Nečakal	0	Sing
“ Vidíte , čo ste spravili ? “ zabzučala a starostlivo si kefovala jemné chĺpky na tele .	kefovala	12	Sing
Opice , čo držali Mauglího , sa zaškerili a pustili ho .	pustili	9	Plur
“ Nehnevám sa , “ odvetila Makulienka .	odvetila	5	Sing
Obrátila som sa a zbadala som to prekrásne staré autíčko .	zbadala	4	Sing
Tu dnu , to vedel inštinktívne , sa svetlá nikdy nevypínajú .	nevypínajú	10	Plur
Nenatrafili na nikoho , koho by sa mohli opýtať na cestu .	Nenatrafili	0	Plur
Od slečny Kasandry však vedela , že je to povolanie iba pre mravce .	vedela	4	Sing
“ Nechceme pomstu , “ povedal zmierlivo Ferdo .	Nechceme	1	Plur
Za to , že sme mohli deti a chovancov obdarovať , ďakujeme Zuzke Reiszovej , Milke Čopovej a Jankovi Pagurkovi .	ďakujeme	11	Plur
Skúste siahnuť po nejakej knižnej novinke , zoznam nájdete v Knižnom katalógu .	nájdete	8	Plur
Gaston sa obrátil k zástupu dedinčanov , ktorí sa medzitým zhromaždili okolo neho .	zhromaždili	10	Plur
Zrejme uplynuli týždne a mesiace .	uplynuli	1	Plur
Predavačka sa silene usmievala , aby dala najavo , že ju to pobavilo .	usmievala	3	Sing
Domčeky vyzdobili girladnami a Vilko s Emilom urobili na jednom krtinci kĺzačku , kde šantili deti .	vyzdobili	1	Plur
Mnohí z nich by chceli , keby mali možnosť .	chceli	4	Plur
Netušili však , akí je múdry !	Netušili	0	Plur
Winston poznal , že mu za hlavu prisúvajú akýsi ťažký prístroj .	poznal	1	Sing
Prišiel na to niekto iný : Zelené oči .	Prišiel	0	Sing
Ak mu nepomôžeš , zomrie ! “	zomrie	4	Sing
Nemieni sa vzdať bez boja , tak lacno svoju kožu nepredá .	Nemieni	0	Sing
Obraciame ho , zmocňujeme sa jeho myslenia , pretvárame ho .	pretvárame	8	Plur
“ Vráťte sa , vy zlodeji ! “ hrmel za nimi predavačov zúrivý rev .	Vráťte	1	Plur
Mamu už dávno odniesli .	odniesli	3	Plur
Pohľad , ktorý sa mi naskytol , ma vydesil .	naskytol	5	Sing
Nakoniec ťa , pravda , zastrelíme . "	zastrelíme	5	Plur
“ No moment , “ skočila mi do reči Blythe .	skočila	5	Sing
A takisto dúfam , že neskôr nevidel ani film Hmla .	dúfam	2	Sing
Takže väčšina účastníkov oslavy si nemohla uvedomiť súvislosti .	nemohla	5	Sing
Bratovi farárovi prajeme v tejto funkcii múdrosť , vytrvalosť a Božie vedenie .	prajeme	2	Plur
“ Ahmad videl , čo sa stalo , “ vysvetlila Halima .	vysvetlila	9	Sing
Vláda zvýši mieru informovania verejnosti v oblasti regionálnej politiky .	zvýši	1	Sing
Vláda pripraví transformáciu štátnych zdravotných ústavov na inštitúcie verejného zdravotníctva so zvýraznením opatrení zameraných na zníženie , resp . vylúčenie rizika poškodenia zdravia .	pripraví	1	Sing
Istým spôsobom sa mi tam oddávala , v sále bábkového divadla .	oddávala	5	Sing
Z balkóna utiekla , až keď som k odháňacím pohybom pridala aj hlasité zvukové efekty .	pridala	10	Sing
O ' Briena vyparia .	vyparia	3	Plur
Ale kým som tak urobil , muž sa na mňa usmial .	usmial	10	Sing
Asistovali im naše sestry , ktoré v zariadení pracujú .	Asistovali	0	Plur
“ Veď Rahim povedal , že spolu urobíme obchod .	urobíme	7	Plur
Halima chvíľu váhala .	váhala	2	Sing
“ Tieto zbrane ti pomôžu zvíťaziť nad zlom , “ povedali mu .	pomôžu	4	Plur
Zobuď sa ! “	Zobuď	0	Sing
“ Tu budeš bývať ! “ skríkol na ohromeného Pinocchia .	skríkol	6	Sing
Na takú dokonalú odpoveď som sa vtedy nezmohla , napadla mi až na druhý deň .	napadla	9	Sing
Keď videl , ako sa bavia , hneď sa chcel pridať .	bavia	5	Plur
Ak sa raz oldspeak nahradí , posledné puto s minulosťou sa pretne .	pretne	11	Sing
“ Ubezpečujem vás , že nič nehrozí , “ kričal žene sultánov hlavný vezír Džafar .	nehrozí	6	Sing
Namiesto toho som ho opäť poprosila , aby mi dovoliť dotknúť sa ich .	poprosila	5	Sing
Začínam byť vážne neznesiteľný snob .	Začínam	0	Sing
Na oslavu prišli všetci olympskí bohovia a priniesli množstvo nádherných darov .	priniesli	7	Plur
Váhavo sme sa od seba odtrhli a Chris ma odprevadil k nášmu oknu .	odtrhli	5	Plur
Vytvorí mechanizmy na získavanie a vyhodnocovanie informácií a odhaľovanie týchto prípadov .	Vytvorí	0	Sing
Márne sa prezliekala , v našej izbe sa vždy našlo niečo , čo smrdelo kravínom .	prezliekala	2	Sing
Musím sa priznať , že sa mi ten nápad ohromne páčil , hoci znel neuveriteľne .	znel	13	Sing
Brána sa opäť zachvela pod úderom baranidla .	zachvela	3	Sing
Vonku sa ozýval bzukot a cvrlikanie , všade poletovali motýle a slniečko krásne prehrievalo zem .	poletovali	8	Plur
Máme spoločnú príležitosť napísať vynikajúcu kapitolu slovenských dejín .	Máme	0	Plur
“ Kedykoľvek , “ odvetil Chris s úsmevom , zvrtol sa a plával k trénerovi .	zvrtol	9	Sing
Ďakujte Hospodinu , lebo je dobrý , lebo naveky trvá jeho milosť .	trvá	9	Sing
Kráľovná sa premenila na starú škaredú bosorku .	premenila	2	Sing
Tešila som sa , ale zároveň mi chýbali tie chvíle , keď sme po večierkoch spolu posedeli a rozoberali každý detail .	Tešila	0	Sing
Honoráre oboch hviezd vzrástli .	vzrástli	3	Plur
Vnútri sa krásna kobylka rozdvojila a vyskočili z nej Bôľ a Zmätok .	vyskočili	6	Plur
Už vedela , na čo ho Barbie potrebuje .	potrebuje	7	Sing
“ Odpočiňme si , “ povedal .	Odpočiňme	1	Plur
A takisto dúfam , že neskôr nevidel ani film Hmla .	nevidel	6	Sing
Zopár minút preskakovali z témy na tému , keď vtom ich rev z televíznej obrazovky vyzval , aby držali jazyk za zubami .	držali	18	Plur
Stáli pred obrazovkou .	Stáli	0	Plur
Chcem jej uniknúť , zväzuje mi nohy .	zväzuje	4	Sing
Zrazu Jazmína zastala s otvorenými ústami .	zastala	2	Sing
Vtedy som si pomyslel na syna .	pomyslel	3	Sing
Na lúke postávali skupinky rozčúlených obyvateľov .	postávali	2	Plur
Na stole ležala strieborná tabatierka .	ležala	2	Sing
Išli sme za školu , kde – trochu vyššie – vyvieral prameň , ktorý tam vymlel priehlbinu .	Išli	0	Plur
Jabĺčko vypadlo dievčine z ruky .	vypadlo	1	Sing
Táto správa ma omráčila a doktor ma odprevadil až dolu , k východu z budovy .	omráčila	3	Sing
Cruella sa naňho strašne nazlostila .	nazlostila	4	Sing
Keď búrka ustala , zistili , že pristáli na púšti .	pristáli	7	Plur
V dôsledku rímsko - centralistickej tendencie zbierok prevzali do nich zostavovatelia i viaceré úplne alebo čiastočne sfalšované texty , ktoré však svojím obsahom zodpovedali stanoviskám a snaženiam reformátorov .	zodpovedali	23	Plur
“ Skúsme ich preľstiť , “ navrhol Rudko .	Skúsme	1	Plur
Táto povinnosť sa však nevzťahovala na produkty , ktoré sa jednak priamo a jednak symbolicky týkali základných prejavov kresťanského kultu .	týkali	15	Plur
Všetky prísady sa zmiešali a vznikla tmavá tekutina .	zmiešali	3	Plur
Síce sme nevyhrali , ale verím , že aj to príde .	nevyhrali	2	Plur
Okolo nás pulzovala noc a ozývali sa známe zvuky okolia : tlmený hukot čerpadiel v okolitých bazénoch .	ozývali	5	Plur
Keď sme dojedli a mama upratala stôl , rodičia hrávali karty .	dojedli	2	Plur
Spýtal som sa ho , ako sa volá , ale ono mi nechcelo povedať svoje meno .	Spýtal	0	Sing
“ Pustíš ? “ spýtal sa Ferdinand .	Pustíš	1	Sing
Navyše , koniec 9 . a veľká časť 10 . storočia predstavujú aj vrchol úpadku stredovekého pápežstva .	predstavujú	11	Plur
Rýchlo ju prezrela a zistila , že sa na svet pýtajú šteniatka .	pýtajú	10	Plur
“ Tú šóru v žiadnom prípade nezvládneme , “ povedal Rýchlik a začal cúvať .	nezvládneme	6	Plur
Ukrutne sa zľakli a hneď to hlásli svojmu veliteľovi .	zľakli	2	Plur
Na rube sa nachádza ľudská postava v korune s insígniami v rukách .	nachádza	3	Sing
Keď leteli okolo sladko rozvoniavajúceho jazmínového kra , neodolali a sadli si naň .	neodolali	8	Plur
A ak sa za týchto okolností zjavil Hádes , bolo to nedobré .	zjavil	6	Sing
Počula som neznáme vrčanie a z diaľky sem doliehala hudba .	Počula	0	Sing
Zrazu si Aladin uvedomil , že naňho so záujmom hľadí vysoký , vážny a trochu zavalitý mladík .	hľadí	9	Sing
Nevyšiel som ku dverám .	Nevyšiel	0	Sing
Všetko som doň nahádzal bez ladu a skladu .	nahádzal	3	Sing
Keď som to vyslovil , prebehli mi po tele zimomriavky .	prebehli	5	Plur
Makové zrniečka v nej zašušťali , ako keď sa presýpajú myšlienky .	presýpajú	9	Plur
Chodíš tadiaľto domov pravidelne ?	Chodíš	0	Sing
Položil mi poslednú otázku .	Položil	0	Sing
Boli to prekrásne slová , ale zároveň ma vystrašili .	vystrašili	8	Plur
Zdvihli sa obrovitánske vlny .	Zdvihli	0	Plur
Sú to postavy z filmov , ktoré nakrútili podľa mojich scenárov .	nakrútili	7	Plur
Vysvetli mi to . “	Vysvetli	0	Sing
Bála som sa , že mi povie , že ich chytil , keď sa milovali .	milovali	14	Plur
Winstona bolestne bodlo pri srdci .	bodlo	2	Sing
Krtko sa rozosmial .	rozosmial	2	Sing
“ No , dovoľte ! “ zvolal chrobák a ukázal svaly .	dovoľte	3	Plur
Neničíme kacíra preto , že nám odporuje ; pokým nám odporuje , neničíme ho .	odporuje	10	Sing
A tak sa pavúčikovia pustili priasť ľan .	pustili	4	Plur
Vyvoláva pokušenie .	Vyvoláva	0	Sing
" Neviem -- mne už je to fuk .	Neviem	1	Sing
Nimi vysvätení kňazi teda nie sú právoplatne vysvätenými a nemôžu teda veriacim sprostredkovať dary Ducha Svätého .	nemôžu	9	Plur
Len čo sa jej dotkol , myklo ňou a akoby zmeravela .	zmeravela	10	Sing
Straníčky sa nikdy nefarbili .	nefarbili	3	Plur
Veľký panter si zhlboka vydýchol .	vydýchol	4	Sing
Zjavila sa vo dverách , mala na sebe čierno ‐ bielu uniformu .	Zjavila	0	Sing
Všetci len oddychovali pod slnečníkmi z ďatelinových lístočkov .	oddychovali	2	Plur
Džin ho každý večer otupoval a džin ho každé ráno znovu oživoval .	otupoval	4	Sing
Nijaká dvojica nevstávala , že pôjde tancovať , plač toho dievčaťa pokazil atmosféru .	pokazil	11	Sing
Chris roztrhol jedno balenie , ale veľmi sa s ním nemaznal .	nemaznal	10	Sing
Starec po ňom hodil bochník starej pity .	hodil	3	Sing
A pomyslel som si , že ju už neuvidím .	pomyslel	1	Sing
Takmer ihneď usnuli a driemali asi polhodinu .	driemali	4	Plur
V prípade , že klerik žaluje laika , má sa spor prerokovať pred svetským sudcom .	žaluje	5	Sing
Zaskočil ma .	Zaskočil	0	Sing
“ Takto vonia more ? “	vonia	2	Sing
Nevedel som dešifrovať jej pohľad , neprečítal som v ňom nič .	Nevedel	0	Sing
V tomto podniku si nemôžem dovoliť luxus v podobe ďalšej whisky , ani keby som išiel dušu vypustiť .	išiel	15	Sing
Asi hnedú , lenže tmavovlasí ľudia mávajú aj belasé oči .	mávajú	6	Plur
Mama nazrela do izby , aby sa presvedčila , či spím .	presvedčila	7	Sing
Lietal kade ‐ tade a volal jej meno .	Lietal	0	Sing
Zostal som sedieť v kresle , aj keď sa dvere otvorili a do miestnosti vošli dvaja muži , nové tváre .	vošli	14	Plur
A vtedy zaznel prenikavý treskot .	zaznel	2	Sing
Keď dedinskí nafúkanci z môjho ročníka uverejnili na jeho stránkach nejakú báseň , naparovali sa celý mesiac .	naparovali	13	Plur
Teraz ťa pozývam ja , povedal som , ale Lori odvetila , že nič nechce .	odvetila	10	Sing
“ Veru mohla , “ odvetila makovica .	odvetila	5	Sing
Mlčky ho sledovala celá trieda .	sledovala	2	Sing
Pôsobil tam ako tlmočník a povedal , že keď Angličania pristáli , ich prvou požiadavkou bolo vybudovať poľné WC .	pristáli	10	Plur
Jazmína zdvihla hlavu a uvidela , že princ Omar tuho spí .	uvidela	4	Sing
Program prehliadky nájdete tu .	nájdete	2	Plur
Nik neprehovoril .	neprehovoril	1	Sing
A dospeli k paradoxným poznatkom .	dospeli	1	Plur
“ A odkiaľ pochádzte ? “	pochádzte	3	Plur
Dôsledky učenia Strany ju ani trochu nezaujímali .	nezaujímali	6	Plur
Mauglí nevinne pokrútil hlavou .	pokrútil	2	Sing
Povedala , že sa volá Liza .	Povedala	0	Sing
Keď leteli nad potokom , vodná hladina sa pod nimi tak jagala , akoby do nej spadla hviezda .	leteli	1	Plur
Obraciame ho , zmocňujeme sa jeho myslenia , pretvárame ho .	Obraciame	0	Plur
Utiekli ste z väzenia ? “	Utiekli	0	Plur
Pozreli vyššie , ešte vyššie a zistili , že je to človek .	Pozreli	0	Plur
Na takomto mieste prelínania sa dvoch kultúr sa ľahšie uchovávajú archaické prežitky .	uchovávajú	9	Plur
Obyvatelia lúky sa začali zbiehať pred jej domom a chválili Klotildin spev .	chválili	9	Plur
Dejiny sa zastavili .	zastavili	2	Plur
“ Ricka zaujímajú vážne veci , “ namietla Blythe .	namietla	7	Sing
