Nie podjęto jednak w tej sprawie żadnych decyzji .	podjęto	1	Fin
Podeszły do lady i zaczęły zabierać kosmetyki i odzież .	zabierać	5	Inf
Celników z rzepińskiej Izby Celnej wspierali funkcjonariusze z Poznania i Krakowa .	wspierali	5	Part
Niedobory pozostałych składników , które biorą aktywny udział w przemianie białkowej , mogą powodować schorzenia włosów i paznokci .	powodować	13	Inf
Leniwie zdejmowali mundury , układając je na ławeczce .	układając	4	Conv
Zdecydowano także zdjąć z programu salwę honorową .	zdjąć	2	Inf
Tutaj udało nam się wyciąć sporo tej tkanki .	wyciąć	4	Inf
Daktyle sparzyć , drobno pokroić i dodać z pozostałym masłem do kuskusu .	sparzyć	1	Inf
Wysiadł więc i piknął pilotem , blokując centralny zamek .	piknął	3	Part
Prosi się też zakłady pracy , które dysponują autobusami , by wspomogły komunikację zastępczą .	Prosi	0	Fin
Trzeba działać , niedługo zacznie świtać .	świtać	5	Inf
Przyszedł tu ze mną . . .	Przyszedł	0	Part
Stał na środku przedpokoju , hipnotyzując wzrokiem Lidkę , która wpatrywała się w niego z niedowierzaniem i zachwytem .	hipnotyzując	5	Conv
Organizatorzy postarali się też o prezenty dla wykonawców .	postarali	1	Part
Duch Boży mówi , abym szedł . . .	szedł	5	Part
Nadszedł normalny , szary dzień po dniu .	Nadszedł	0	Fin
Poruszyłem się na łóżku , które odpowiedziało sprężyście .	odpowiedziało	6	Part
Miał nią sobie obetrzeć twarz .	obetrzeć	3	Inf
Konsjerżka , jak większość konsjerżek Portugalka , szorowała chodnik i mury ryżową szczotką .	szorowała	7	Part
Moge ta książke cczytac cały czas .	cczytac	3	Inf
Szafę zamykamy na klucz i obiecujemy sobie otworzyć ją dopiero po egzaminach .	zamykamy	1	Fin
Ledwo widać drogę , u Gontarczyków całe okno zawiało .	zawiało	8	Part
Prosze ułożyć mi coś , żeby ludzie zębami zgrzytali , włosy darli , płakali , ale i równocześnie wroga szukali . . .	zgrzytali	8	Part
Odkąd walczę ze starą , on głównie mnie utrzymuje .	walczę	1	Fin
Duduś wymusza rzucanie , dopominając się o nie przeraźliwym miauczeniem .	dopominając	4	Conv
Na trasie przejazdu stały tłumy oklaskując samochody , które wiozły maleństwa i ich rodzinę .	oklaskując	5	Conv
Poszerzył em uśmiech , unosząc puste dłonie .	unosząc	4	Conv
W poniedziałek we wczesnych godzinach popołudniowych podano , że zdołano uratować siedemset dwadzieścia dwie osoby .	podano	6	Fin
Funkcję tę pełnił przez 35 lat i wywarł ogromne piętno na prawodawstwie amerykańskim .	pełnił	2	Part
Owoc dojrzały nie wyda nasion , kiść uschnie .	uschnie	7	Fin
Po zajęciu miejscowości Krzyżacy zmasakrowali miejscową ludność .	zmasakrowali	4	Fin
To samo dotyczy leczenia , służba zdrowia praktycznie przestała istnieć .	istnieć	9	Inf
Człowieka po prostu ogarnia przerażenie .	ogarnia	3	Fin
Co czynię dla Chrystusa ?	czynię	1	Fin
W takie wieczory milkły rozmowy .	milkły	3	Fin
W poniedziałek we wczesnych godzinach popołudniowych podano , że zdołano uratować siedemset dwadzieścia dwie osoby .	uratować	10	Inf
Zagrzebali się w słomę .	Zagrzebali	0	Fin
MNIEJ MYŚLĘ STRUKTURAMI , BARDZIEJ CHCĘ DOJŚĆ DO KONKRETNEJ WYPOWIEDZI .	DOJŚĆ	6	Inf
To sam Wei nie chciał wyjechać .	wyjechać	5	Inf
Po rzucie rożnym obrońcy Vardaru zbyt wolno wychodzili spod swojej bramki , podanie z linii pola karnego dotarło do Kucharskiego , a ten strzelił , stojąc tyłem do bramki .	dotarło	17	Part
Po letniej przerwie w najbliższą niedzielę wznowią rozgrywki pięściarze pierwszej i drugiej ligi bokserskiej .	wznowią	6	Fin
- Mógłbyś obrać ?	obrać	2	Inf
Tymczasem konflikt izraelsko - palestyński wydaje się zaostrzać .	zaostrzać	7	Inf
I oczywiście zaczął koncertować .	koncertować	3	Inf
Zaraz potem zaczęli się spotykać .	spotykać	4	Inf
Zniszczyć , zamrozić i trzymać sto lat , a może przekazać do badań ?	zamrozić	2	Inf
Tom Spencer posiadał przy sobie pisma pornograficzne i kasety video dla homoseksualistów oraz marihuanę .	posiadał	2	Part
Zenek prosił kolegów , żeby nic nie mówili mamie , gdyby go przysypało .	przysypało	12	Fin
Mała lampka rozpraszała mrok , rzucając nikłe światło na błękitną tapetę .	rzucając	5	Conv
Czy powinnam powiadomić syna tego pana , że ona ich okrada ?	powiadomić	2	Inf
Oparł się o ścianę i stał , dysząc ciężko .	dysząc	7	Conv
Roman klęczał na posadzce i szukał pieniędzy , które mu podczas inkasowania wypadły z ręki .	szukał	5	Part
Tomek zsunął się ze skały i podbiegł do nich .	zsunął	1	Part
Wydawało się nieprawdopodobne , by po tylu godzinach wydostać malca żywego z pułapki .	wydostać	8	Inf
Przygryzając wargi z bezsilnej złości , Chmura wołał Adasia .	Przygryzając	0	Conv
Polonia zagrała bez trzech piłkarzy z podstawowego składu .	zagrała	1	Part
Stefan nieraz nadkładał drogi po pracy , by popatrzyć , jak rośnie ich dom .	popatrzyć	8	Inf
Przy wspólnym stole jadają tu studenci izraelscy i palestyńscy .	jadają	3	Fin
Załadował na wóz wynajętych gazeciarzy i rozwiózł po mieście , każąc rozdawać list przechodniom .	Załadował	0	Part
Oczy powlekła biaława szklistość , co wzmogło tajemnicę spojrzenia .	powlekła	1	Fin
Czyżby tam zabrnął Barski ?	zabrnął	2	Fin
- Ostatnio powiedział Pan , że Trybunał zachował się w sprawie konkordatu jak Piłat .	zachował	7	Part
- Przed wrotami , ćmiąc papierosa , czekał na niego ojciec .	ćmiąc	4	Conv
W czasie wojny zarekwirowali mi samochód .	zarekwirowali	3	Part
Na ostatnich dziesięć lat osiem obfitowało w opady śnieżne w kwietniu i maju .	obfitowało	5	Part
Zrealizował go Polak , wykorzystując literaturę rosyjską i japońskich wykonawców .	wykorzystując	4	Conv
Nic nie zapowiada takiego scenariusza .	zapowiada	2	Fin
Widzę , że ostatnia lekcja czegoś was nauczyła .	nauczyła	7	Part
Sputnik zawirował po raz ostatni , zatrzymał się i zgasł .	zawirował	1	Part
Oczywiście , to już reguła , że o takich rzeczach rodzice dowiadują się ostatni .	dowiadują	11	Fin
Następne mają się już pojawiać co miesiąc .	pojawiać	4	Inf
- Chcesz poprowadzić ?	poprowadzić	2	Inf
Stało się dokładnie tak , jak zaplanowały .	Stało	0	Fin
Firma skontaktowała się ze mną , przedstawiając opinię rzeczoznawcy .	przedstawiając	6	Conv
Może nad ranem wróci do hali i spróbuje wydostać się przez okno .	spróbuje	7	Fin
Szwagier pana Korzeniowskiego toporem rozrąbał świński łeb i wydobył mózg .	wydobył	8	Part
Jadąc fordem escortem nie ustąpiła pierwszeństwa karetce pogotowia .	Jadąc	0	Conv
Po przewrocie władzę w Algierii objęła Rada Rewolucyjna .	objęła	5	Part
Jeśli pogoda dopisze , będziemy wykonywać te prace bez przerwy .	wykonywać	5	Inf
" Życie jest zbyt krótkie , żeby pić liche wina " .	pić	7	Inf
Przez całą niedzielę sprawdzano każdy wątek i potencjalnych sprawców .	sprawdzano	3	Fin
Poprosił ekspedientkę o dostęp do telefonu , tłumacząc , że musi zadzwonić do swojego wspólnika .	Poprosił	0	Part
Samoloty USA startowały z baz w Wietnamie południowym i lotniskowców Siódmej Floty .	startowały	2	Fin
Czyż i najgenialniejsi ludzie nie kształcili się na wzorach swych poprzedników ?	kształcili	5	Part
Ktoś inny w złości kopie ławkę i rzuca głośno soczyste przekleństwa .	rzuca	7	Fin
- No , nie mówiła m , że wykipi ?	wykipi	8	Fin
Jak realizowano budżet ?	realizowano	1	Fin
- Wierzę .	Wierzę	1	Fin
Teofil trzymał je w ręce , aby włożyć dopiero w ostatniej chwili .	włożyć	7	Inf
Ogłoszone wczoraj dane Narodowego Banku Polskiego , dotyczące wielkości deficytu na rachunku obrotów bieżących , zaskoczyły ekonomistów .	zaskoczyły	15	Part
Biała prawica w RPA zarzucała Treurnichtowi nadmierną ugodowość wobec rządzącej Partii Narodowej , a także pasywność .	zarzucała	4	Part
Udział zgłosiło ponad 200 osób z Polski i zagranicy .	zgłosiło	1	Part
Historia zaczęła biec szybciej .	biec	2	Inf
Pięć osób ocalało .	ocalało	2	Fin
Coraz mniej się dziwię , że tylu ludzi nas nie cierpi .	dziwię	3	Fin
Radosny uśmiech nie gościł jednak na twarzy pana Adama .	gościł	3	Part
Strawione jedzenie krąży po organizmie , odżywiając komórki .	odżywiając	6	Conv
Prawa ręka spoczęła na klamce , lewa , dygocąc , przywarła do zamka .	dygocąc	8	Conv
Wycina się je tam dla celów rolniczych i hodowlanych A NIE PAPIERNICZYCH !	Wycina	0	Fin
Furtka skrzypi , Dostojewski wystaje z pyska psa .	skrzypi	1	Fin
Nie boi się pani tak improwizować w czasie swoich koncertów ?	improwizować	5	Inf
- Pytał em też Mędrców , ale pokiwali tylko głowami i orzekli , że ich komputery nie są w stanie tej zagadki rozwikłać .	pokiwali	7	Fin
Starannie domykał drzwi za sobą .	domykał	1	Fin
Załogi z niepokojem śledzą ciche chmury nadchodzące z południa .	śledzą	3	Fin
Poszukiwała go policja z Gostynia za kilka innych przestępstw .	Poszukiwała	0	Part
Odrywa dłonie i powoli zaczyna schodzić na parter , kierując kroki do kuchni .	kierując	9	Conv
Adam szukał do nowego domu parkietu .	szukał	1	Part
Abraham zdał test lojalności .	zdał	1	Part
– tamta babcia niech jej kupi . .	kupi	5	Fin
Powiodła m oczami dookoła i nagle zastygła m z przerażenia .	zastygła	6	Fin
Wystarczyło paru lat , aby konkret został wyklęty .	Wystarczyło	0	Fin
W milczeniu uścisnęli sobie ręce .	uścisnęli	2	Fin
W wózku wiozła 13-miesięcznego synka .	wiozła	2	Part
Zmarłych żołnierzy francuskich i bawarskich pogrzebano na cmentarzu przykościelnym .	pogrzebano	5	Fin
Przystupa odstawiła szklankę po whisky i skuliła się w fotelu , pan Cox wyglądał , jakby się właśnie obudził .	skuliła	6	Part
Przestał em marzyć .	Przestał	0	Fin
Polecił em go zabrać .	zabrać	3	Inf
Szwagier pana Korzeniowskiego toporem rozrąbał świński łeb i wydobył mózg .	rozrąbał	4	Part
A on tak spał na dworze .	spał	3	Part
Dodawał też , że korzystał z jawnych źródeł .	korzystał	4	Part
Na ich temat nic również nie powiedzieli płatni informatorzy , do których w tej sprawie zwrócili się policjanci prowadzący dochodzenie .	zwrócili	15	Part
Dopiero waląc ramieniem o ziemię , poczuł strach .	waląc	1	Conv
Wypadła m ze sklepu i pobiegła m na umówione miejsce .	Wypadła	0	Fin
W różnych krajach Europy Joint zachęcał do tworzenia miejscowych organizacji , zdolnych do samodzielnej pracy z sierotami .	zachęcał	5	Part
Masę utrzeć z masłem .	utrzeć	1	Inf
To jest wspaniały sport , a w życiu warto spróbować wszystkiego .	spróbować	9	Inf
Mogli by w nich uczestniczyć kandydaci Unii Wolności oraz Wałęsa i Olszewski , jeśli tylko zechcą i będą mieli poparcie 15 parlamentarzystów i 300 radnych .	Mogli	0	Fin
Na wrocławski Rynek rzeczywiście przybyły tłumy .	przybyły	4	Fin
- Nawet po śmierci potrafisz się kurwić .	kurwić	6	Inf
Maluchy i starsza młodzież spędzały tam czas po lekcjach , ucząc się i bawiąc .	bawiąc	13	Conv
Jechał coraz szybciej .	Jechał	0	Fin
Byli w wielu innych związkach , które się jednak rozsypały .	Byli	0	Part
Jadący z nadmierną szybkością wartburgiem Marek Ch . , będąc pod wpływem alkoholu , został wyrzucony na łuku jezdni na pobocze , a następnie przekoziołkował i uderzył w drzewo .	będąc	9	Conv
– Widownia ze zrozumieniem pokiwała głowami .	pokiwała	4	Fin
Trudno stwierdzić , kiedy nowa ustawa wejdzie w życie .	stwierdzić	1	Inf
Rządy Leszka Millera dużo dały wielu ludziom .	dały	4	Part
Przestrzegać zasad .	Przestrzegać	0	Inf
Władza w tym okresie nie chciała ośmieszać się tak prymitywną propagandą .	ośmieszać	6	Inf
Posłowie udzielili też rządowi absolutorium z wykonania ubiegłorocznego budżetu .	udzielili	1	Fin
Zmarł w klinice onkologicznej w Warszawie .	Zmarł	0	Fin
Długi ograniczył się do spojrzenia .	ograniczył	1	Part
Co chwila dzwonili towarzysze z różnych instancji i coś Pomianowiczowi delikatnie sugerowali .	dzwonili	2	Fin
Ogolić jaja na skina ?	Ogolić	0	Inf
Zaczął podnosić się na rękach .	podnosić	1	Inf
Miało płonąć mieszkanie na dziewiątym piętrze jednego z bloków .	płonąć	1	Inf
Od poniedziałku toczyły się walki o jego odbicie .	toczyły	2	Part
Teraz Jasienica będzie musiała usunąć część wodociągu , który bezprawnie postawiła na prywatnej ziemi Pałuchy .	postawiła	10	Part
Kilka osób spytało mnie , czy jestem dzięki feminizmowi szczęśliwsza .	spytało	2	Part
Samolot Ignacego odrywał się od ziemi , a Dominika i Adaś nie mogli oderwać się od siebie i intensywność ich spotkań rosła kosztem ostrożności .	oderwać	13	Inf
- Nie mam ochoty wpaść przez was .	wpaść	4	Inf
Rozlał , podniósł i zaczął sączyć , świdrując oczami .	sączyć	5	Inf
Poruszał rytmicznie kolanami , unosząc lekko siedzącą na nich kobietę .	unosząc	4	Conv
- W szkole jest mniej uczniów , dlatego musiałem tym paniom podziękować .	podziękować	11	Inf
ludzie , jak dostają coś takiego , w pierwszej chwili myślą , ze źle policzyli zera .	policzyli	14	Part
Morderca żony i córki trafi do szpitala psychiatrycznego , lekarze co pół roku będą sporządzać raporty dla sądu o stanie jego zdrowia .	sporządzać	14	Inf
Nawet Nagroda Nobla mu nie dorównuje !	dorównuje	5	Fin
Przy władającym Uranie twoja twórczość może ujawniać się jako zdolności wynalazcze .	ujawniać	6	Inf
Dlaczego dała m sobie wmówić ciemnotę i sobą poniewierać ?	poniewierać	8	Inf
No , kolego pośle , chyba pan w siebie wierzy albo nie wierzy .	wierzy	12	Fin
Może nie zdawał sobie sprawy z gry , w której uczestniczy ?	uczestniczy	10	Fin
A ona nie doczeka się pochwały i może popadać w kolejne frustracje .	popadać	8	Inf
Towarzysz jego wzywał Jezusa i jego Matkę , a tacy ludzie jak Esteban wołają te słowa tylko twarzą w twarz ze śmiercią .	wzywał	2	Part
Po upieczeniu można zdjąć ze strąków oddzielającą się skórkę .	zdjąć	3	Inf
Nie różnią się one niczym .	różnią	1	Fin
Padł strzał , ale to było pudło .	Padł	0	Fin
– Całą noc coś mnie gryzło .	gryzło	5	Part
Jeszcze inni bezradnie rozkładają ręce oznajmiając , że nie są w stanie czegokolwiek zapłacić .	oznajmiając	5	Conv
Katarakta nocy zasnuwa każdą rubinową szybkę witrażowej rozety nad portalem .	zasnuwa	2	Fin
Wyraźnie stara się nie obciążać oskarżonych .	obciążać	4	Inf
Byłby upadł .	upadł	1	Part
Ze stolicy przywiozła autokar dziennikarzy .	przywiozła	2	Part
Należała do mojego pokolenia , została też przez to pokolenie dobrze przyjęta .	Należała	0	Part
Jego karogga zagłębiła się w płomienie , sięgnęła czegoś twardego .	sięgnęła	7	Part
Wysiadł więc i piknął pilotem , blokując centralny zamek .	blokując	6	Conv
Zgadzając się co do celu , uważamy , że metoda jego osiągnięcia nie jest dobra .	Zgadzając	0	Conv
Za każdy samochód zabierali się od razu mechanicy , zmieniali koła , usuwali uszkodzenia powstałe w czasie forsownego treningu , wymieniali zdarte nakładki hamulcowe , regulowali silniki .	zabierali	3	Part
Nie boisz się wilków ?	boisz	1	Fin
Po jego obu bokach zwisają nawleczone na sznur perły nazywane Paternoster .	zwisają	4	Fin
Kiermasze te zapowiadały Wielki Tydzień , który charakteryzował się postem i wyrzeczeniami .	charakteryzował	7	Part
Sądząc po sztućcach , może nią być danie rybne .	Sądząc	0	Conv
Komu w tej sytuacji wierzą gliny ?	wierzą	4	Fin
- Gdybym niszczył pieczywo , fiskus byłby zadowolony .	niszczył	2	Part
Chłopak zerwał się z miejsca , złapał posążek i ścisnął mocno w dłoni .	złapał	6	Part
Na dowód dobrej woli natychmiast odwołało z rady nadzorczej dwóch największych banachożerców , w tym Poczobutta .	odwołało	5	Part
Poznali śmy już nazirejczyków , ponieważ należał do nich Samson .	należał	6	Fin
Kiedy mówi się o cudach w Lourdes , kiedy ktoś dostąpił cudownego uzdrowienia , Kościół prosi lekarzy , aby wypowiedzieli się na ten temat .	wypowiedzieli	19	Part
Rozlał , podniósł i zaczął sączyć , świdrując oczami .	świdrując	7	Conv
W biurze rajdu kolejka kierowców topniała w oczach .	topniała	5	Part
Prosiła , żeby ucałować ciotkę i podziękować jej za paczkę .	podziękować	6	Inf
Rano Odra nasyca niebieskawą mgłą ulice obu miast .	nasyca	2	Fin
Okupując wejście , czekały , co się wydarzy .	Okupując	0	Conv
W tegorocznym VIII turnieju wystartowało 18 drużyn podzielonych na 6 grup .	wystartowało	4	Part
Kiedy w Banja Luce skończył się ostatni , decydujący o medalu mecz , Halina leżała na parkiecie , a na niej kłębiła się góra ciał .	kłębiła	21	Part
Następnie rozłożyła wysoki statyw , zawiesiła na nim pudełko , przeprowadziła od niego przezroczysty przewód do igły , którą wcześniej automatyczny iniektor umieścił w żyle na przedramieniu Irka .	rozłożyła	1	Part
Słońce ożywiło ludzi nie ożywiając jeszcze natury .	ożywiając	4	Conv
Nawet trochę pomieszkać , może nawet popracować w kibucu .	pomieszkać	2	Inf
- Chcesz nas w to wrobić ?	wrobić	5	Inf
Tańczono zapamiętale , wykrzykując i piosenką dogryzając sobie wzajemnie .	Tańczono	0	Fin
Czy Dominik , broniąc się , mógł przewidzieć aż tak dramatyczne skutki ? !	broniąc	3	Conv
Zachęcany , aby również w czasie Wielkiego Tygodnia zrezygnować z oglądania telewizji .	Zachęcany	0	Fin
Uczestniczki wysłuchały wykładów doradców zawodowych i prawników , uczestniczyły w zajęciach psychologicznych , poznawały podstawy obsługi komputera i korzystania z Internetu .	poznawały	13	Part
Wiedźma odwróciła się ku niemu z mozołem , wkładając w ten drobny ruch wszystkie swoje siły .	wkładając	8	Conv
Lubił wiązać to .	wiązać	1	Inf
Nazajutrz nie mógł się dobudzić Szczęsnego .	dobudzić	4	Inf
Przygoda u czoła Lodowca Hansa uświadomiła mi , że lepiej bezpośrednio nie dotykać lodowego klifu .	dotykać	12	Inf
Ale nie mógł za mną nadążyć .	nadążyć	5	Inf
Owa niezapomniana chwila zawierała nieprawdopodobny ładunek patosu .	zawierała	3	Part
Ale obiecał kupić obraz .	obiecał	1	Part
Funkcjonariusze policji przypuszczają , że ofiara zasnęła .	zasnęła	6	Part
Przystupa odstawiła szklankę po whisky i skuliła się w fotelu , pan Cox wyglądał , jakby się właśnie obudził .	wyglądał	13	Part
Podpłynął księżyc , przywarł i zaczął ssać .	Podpłynął	0	Part
W Europie początkowo kawę sprzedawali medycy , zalecając ją na smutki i przygnębienie .	zalecając	7	Conv
Trzeba było cię porządnie ugościć .	ugościć	4	Inf
Dlaczego miała by m się go wystrzegać ?	wystrzegać	6	Inf
Połowa zareagowała na leczenie pozytywnie .	zareagowała	1	Part
Pamiętam , że stawaliśmy o 3 . 15 nad ranem , udając się do zakładu samochodów małolitrażowych .	udając	11	Conv
Dlatego chciał się jej oświadczyć w niezwykłym miejscu .	oświadczyć	4	Inf
- Muszę wyjechać .	wyjechać	2	Inf
Poruszał rytmicznie kolanami , unosząc lekko siedzącą na nich kobietę .	Poruszał	0	Part
Bóg raczy wiedzieć .	raczy	1	Fin
Niechętnie przecież opuszczali Legnicę i inne bazy wojskowe .	opuszczali	2	Fin
Tak jakby ludzie z kręgów kulturalnych bali się Szuwara , jakby mając nieczyste sumienie , chcieli jednak go wysłuchać , dopuścić do głosu .	wysłuchać	18	Inf
– dej spokój .	dej	1	Fin
Kaneyasu kiwał głową , akceptując pomysł Kiry .	kiwał	1	Part
Jestem siłą roboczą , nie mogę cię oceniać .	oceniać	7	Inf
W środę do Jana Kwiatkowskiego , wujka Adama , zadzwonili policjanci z sekcji kryminalnej w Legionowie .	zadzwonili	9	Fin
- Dowiedziała m się , że pan spotyka się od pewnego czasu z Renią .	spotyka	7	Fin
Nie podał Klossowi ręki , wskazał mu tylko krzesło .	wskazał	5	Fin
Lamentują , jakby śpiewali .	śpiewali	3	Part
Nakręcił 60 filmów dokumentalnych i stworzył ponad 300 programów telewizyjnych .	stworzył	5	Part
Oni z kolei odkryli Związek Radziecki .	odkryli	3	Part
Z pozostałymi członkami dawnego kierownictwa związanymi z Gomułką plenum obeszło się bezceremonialnie , usuwając ich w większości ze składu KC .	usuwając	13	Conv
KOKS MUSI BYĆ !	MUSI	1	Fin
Wszystkie psy świata mogły mu w tym momencie naskoczyć .	naskoczyć	8	Inf
Po chwili odsłonił głowę i uważnie lustrował zaniepokojone twarze .	lustrował	6	Part
Zbierał te suche rozstajne krótkie drogi , wiązał w pokaźne drapadła o ściśniętym kierunku .	Zbierał	0	Part
Sytuację komplikował wrogi , nieprzejednany stosunek , który rząd niemiecki nadal przejawiał wobec Polski .	przejawiał	11	Part
I odnowi oblicze ziemi .	odnowi	1	Fin
– Nie twierdzę , że działamy najlepiej i nie popełniamy błędów .	popełniamy	9	Fin
Żałował , że to powiedział .	Żałował	0	Part
Izba tonęła w półmroku .	tonęła	1	Fin
Od tego zależą losy SLD .	zależą	2	Fin
Ostatni zawodnicy maratonu przybiegli na metę nawet kilka godzin po Afrykańczyku .	przybiegli	3	Part
Michaelson wyróżniał się z tłumu w siłowni .	wyróżniał	1	Part
Pamiętał teraz także , że Rychezę polecili mu poniekąd margrabiowie .	polecili	6	Fin
Przecież nie umarła , kiedy my żyjemy .	żyjemy	6	Fin
– Uważam , że pani sama musi odnaleźć swoją przyjaciółkę .	odnaleźć	7	Inf
Chce uruchomić przewozy w Raciborzu-Markowicach i Nieborowicach .	uruchomić	1	Inf
Tam dokonał czynów lubieżnych na dziewczynce .	dokonał	1	Fin
Salony na parterze udostępniono publiczności i pełniły one rolę muzeum .	pełniły	6	Part
Doszli do orbisowskiej restauracji i przy wejściu przestali rozmawiać .	Doszli	0	Fin
Zapalają się świece .	Zapalają	0	Fin
Musieli śmy go ściągnąć do komisariatu .	Musieli	0	Fin
Dla zdrowia psychicznego i fizycznego trzeba wówczas chwilowo panią uśpić .	uśpić	9	Inf
Świeczka na stole migotała nikłym płomykiem .	migotała	3	Fin
Zimą , przylatując na popas do Polski , zadowala się pozostałymi na krzakach jagodami .	przylatując	2	Conv
Truchtali spokojnie , bez pośpiechu , z przodu dostrzegli sylwetkę w zielonym mundurze , zbliżyli się powoli .	Truchtali	0	Part
Chmury rozsunęły się na moment , odsłaniając wytarty miedziak słońca .	odsłaniając	6	Conv
Urwał em .	Urwał	0	Fin
Obedrzeć z niej właściciela .	Obedrzeć	0	Inf
Po paru chwilach można już było wiosłować .	wiosłować	6	Inf
Zaczął em pracować w kibucu .	pracować	2	Inf
- Przyjechać po ciebie ?	Przyjechać	1	Inf
Zaczął się wielki exodus .	Zaczął	0	Part
Prosze ułożyć mi coś , żeby ludzie zębami zgrzytali , włosy darli , płakali , ale i równocześnie wroga szukali . . .	płakali	13	Part
Komendant się roześmiał odstawiając szklankę .	odstawiając	3	Conv
W zasadzie absolutorium będzie dotyczyć poprzedniego zarządu .	dotyczyć	4	Inf
Jemu niewiele było potrzeba , żeby upić .	upić	6	Inf
– Ktoś polał drzwi do mieszkania łatwopalną substancją i podpalił .	podpalił	9	Fin
Dziewczyny mówią , że piszczała , płakała , śmiała się , przykucnęła , usiłując uspokoić drżące od wysiłku mięśnie i wtedy rzuciły się na nią . . .	przykucnęła	11	Part
Chciał ją spytać o wiele rzeczy .	spytać	2	Inf
Aureliusz słuchał kątem ucha , odbierając teczkę z depozytu .	odbierając	5	Conv
Miejmy nadzieję , że ich nowa redakcja zawierać będzie wnioski autorów omawianej publikacji .	zawierać	7	Inf
Zatrzymał się na miejscu i na wszelki wypadek uniósł ręce .	Zatrzymał	0	Part
Realizuje ono wśród młodzieży w całym kraju program profilaktyki , który uzyskał akceptację Państwowej Agencji Rozwiązywania Problemów Alkoholowych .	Realizuje	0	Fin
Chmury rozsunęły się na moment , odsłaniając wytarty miedziak słońca .	odsłaniając	6	Conv
Radni poruszyli problem złych nawierzchni dróg , domagając się ich remontu .	domagając	7	Conv
Po Jugosławii podróżowali śmy z namiotem , szukając pól campingowych .	szukając	7	Conv
Fabrykę zaplombowano , konfiskując także podejrzane materiały .	konfiskując	3	Conv
Wieprzek zatrzymał się nie przestając kwiczeć .	przestając	4	Conv
Czy w Kielcach uczył się w szkole rabinackiej i czy naprawdę był rabinem , jak zapewniał Fangora i inne osoby w Ameryce ?	zapewniał	15	Part
Na pierwszy plan wjeżdża długa , biała limuzyna .	wjeżdża	3	Fin
Wczoraj kolegium Instytutu usiłowało wyłonić nowego kandydata na prezesa .	wyłonić	4	Inf
Nie wstąpi jego stopa junacka w strzemiona ojcowe .	wstąpi	1	Fin
Dwunastościan foremny miał symbolizować ład kosmiczny .	symbolizować	3	Inf
Bywało , że musiała ich odpędzać policja .	odpędzać	5	Inf
Polonii aura nie przeszkadzała w odniesieniu wysokiego zwycięstwa .	przeszkadzała	3	Fin
Słuchaj , co ci rzeknie herold !	rzeknie	4	Fin
Po wypiciu wódki i wina również inni schodzili na dół , bo widział em na schodach i pana Jaworka , i pana Napiórkowskiego .	schodzili	7	Fin
Ewentualna ratyfikacja Konkordatu przed przyjęciem nowej konstytucji zaważyłaby zapewne na jej ostatecznym brzmieniu , odbierając Konstytucji RP charakter nowoczesnej ustawy zasadniczej demokratycznego państwa .	odbierając	14	Conv
Napadła ś na Kucyka , a to jest ich człowiek w terenie i nie dadzą go ruszyć .	dadzą	14	Fin
Po decyzji parlamentu zawiesiły działalność polityczną Batasuny .	zawiesiły	3	Part
Poprosił ekspedientkę o dostęp do telefonu , tłumacząc , że musi zadzwonić do swojego wspólnika .	tłumacząc	7	Conv
Mijała minuta za minutą , czas wlókł się w nieskończoność , a nie pojawiał się nikt .	wlókł	6	Part
Płakał , nie odważył się do niej wejść .	wejść	7	Inf
Sygnał dźwięku wielokanałowego możemy wyprowadzić tylko przez cyfrowe złącze optyczne , ale kabla , niestety , nie znajdziemy w pudełku .	wyprowadzić	4	Inf
- Jeszcze poczekać ?	poczekać	2	Inf
Rozwijano taśmę , wbijano paliki , ustawiano płotki , a w niebie i w krzewach śpiewały ptaki .	śpiewały	15	Fin
Wyborcy zdecydowali , że powinni zasiąść w Sejmie .	zasiąść	5	Inf
Nigdy nie wykroczył poza zasady wiary chrześcijańskiej .	wykroczył	2	Fin
Chciała by m tego posłuchać .	posłuchać	4	Inf
- Biegał po domu , obszukiwał szafy .	obszukiwał	5	Fin
Nieźle tam zarabia , ale niejednokrotnie chwali się drogimi rzeczami kupionymi za pieniądze , które syn tego pana zostawia na utrzymanie ojca .	zarabia	2	Fin
Kot obejrzał się na mnie i usiadł , starannie zawijając ogon na przednie łapki .	zawijając	9	Conv
DZIŚ idę płakać nad moim losem , rozumiesz ?	płakać	2	Inf
Debren udał , że nie zrozumiał .	udał	1	Part
Nagle ktoś psyknął za moimi plecami .	psyknął	2	Part
- Zapytał em żartobliwie , choć starała się mówić poważnie .	starała	6	Fin
Podniosła słuchawkę telefonu i wystukała numer Filipa .	wystukała	4	Part
O wywiad z prezydentem zabiegam od 3 miesięcy .	zabiegam	4	Fin
Czyżby teraz przepuściła okazję , mając tuż obok przystojnego młodego mężczyznę ?	mając	5	Conv
Stacja Nędza wielokrotnie zmieniała swoją nazwę .	zmieniała	3	Part
- Pomagasz mi .	Pomagasz	1	Fin
Nie martw się , już przechodzę .	przechodzę	5	Fin
Angelika przystąpi do komunii w kościele w Dytmarowie .	przystąpi	1	Fin
Odpowiedział eś posługując się sztandarowym obok Białorusi argumentem .	posługując	2	Conv
Na dodatek pod koniec dekady zaczęło rosnąć bezrobocie , zwłaszcza wśród kobiet i młodzieży .	rosnąć	6	Inf
Powiedzieli , że dom płonie .	Powiedzieli	0	Part
Pani z jamnikiem spytała Kuronia , czy to jego samochód .	spytała	3	Part
Zdaniem włoskich ekspertów , jest to słabe tłumaczenie , ponieważ wszyscy wiedzą , że region Molise leży w strefie silnej aktywności sejsmicznej .	wiedzą	11	Fin
Zrobił em szybko dwa przysiady i skierował em się do łazienki .	Zrobił	0	Fin
W Chadaju odezwała się podlaska dusza .	odezwała	2	Fin
Często chodzili do pubu , pili piwo , rozmawiali .	pili	5	Part
- Wstydź się , Zuzanno , tak kłamać , zapłacił ci za Jadzię .	kłamać	7	Inf
Kontakty towarzyskie utrzymywali jednak przez cały czas .	utrzymywali	2	Part
Alkoholu jeszcze nie podano , popielniczki błyszczały czyste i nie skażone .	błyszczały	6	Fin
- Czy ktoś jeszcze pragnie zabrać głos ?	zabrać	5	Inf
Ten musiał zbiec ze schodów , gdzie też coś ciągnął .	zbiec	2	Inf
Znalazł się generał !	Znalazł	0	Part
Co chwila łapał em się za rękę , zakrywając zegarek .	zakrywając	8	Conv
Wtedy nikt nas nie zauważy .	zauważy	4	Fin
Wcale się nie ucieszył z naszego spotkania .	ucieszył	3	Part
Może nauczysz się wreszcie , jak się takie rzeczy załatwia .	załatwia	9	Fin
Porozmawiajmy o ludziach .	Porozmawiajmy	0	Fin
Zakup tego urządzenia pozwoli wykonywać podstawowe analizy na miejscu w Brzeziu , bez konieczności wyjazdu chorego do Gminnego Ośrodka w Kłaju .	wykonywać	4	Inf
Według relacji świadków , gdy biały opel frontera zbliżył się do ambasady , wyskoczył z niego człowiek ubrany w panterkę , z granatnikiem w ręku , i próbował odpalić granat w kierunku ambasady .	odpalić	28	Inf
Dotarł do zabudowań Ilii .	Dotarł	0	Fin
Prasa francuska opublikowała sporo takich zestawień .	opublikowała	2	Part
Wkrótce ma ruszyć przeciw Sparcie cała armia etolska .	ruszyć	2	Inf
Radykalnie negując ład istniejący na ziemiach ukraińskich w Polsce i ZSRR , nacjonalizm odrzucał każdą próbę prowadzenia polityki w ramach realnego układu sił .	odrzucał	13	Part
Gdy kupowali lekarstwa , ojciec zabrał wózek z dzieckiem i zniknął .	kupowali	1	Part
Ale czy u nas wylewa się kogoś z roboty za chlanie ?	wylewa	4	Fin
Możemy go obejrzeć , ale nie wolno fotografować .	fotografować	7	Inf
Mamy nadzieję , że Państwowa Komisja Wyborcza zainteresuje się tym trikiem .	zainteresuje	7	Fin
Wyszli śmy na ląd , żeby rozprostować kości .	rozprostować	6	Inf
Wiadomo , że w tym roku uczniowie będą zdawać albo starą , albo nową maturę .	zdawać	8	Inf
Lęka się widocznie , że ktoś przedstawienia nie zauważył .	Lęka	0	Fin
– czterdzieści pięć minut starczy . .	starczy	4	Fin
Warta obsługuje powodzian w pierwszej kolejności .	obsługuje	1	Fin
Ćwiczyli wojacy z 25 krajów .	Ćwiczyli	0	Part
Nagle zaczęła jęczeć i płakać .	jęczeć	2	Inf
Raczej to szczęście , że się w porę dowiedział .	dowiedział	8	Part
Już trzykrotnie odwoływali się do Samorządowego Kolegium Odwoławczego , by unieważnić decyzję o warunkach zabudowy wydaną przez Wydział Architektury .	odwoływali	2	Part
– trzeba się najeść cebuli . .	najeść	3	Inf
Jak zwykle pośliznął się na posadzce w przedpokoju , chłodnym i białym niczym Antarktyda we mgle .	pośliznął	2	Part
Trzeba było przekonać prokuratora , aby wniósł sprawę z urzędu .	przekonać	2	Inf
Kochał Dorę , ale nie potrafił odejść od Zofii , swej żony .	odejść	6	Inf
IV Zjazd Absolwentów Liceum Ogólnokształcącego odbył się w sobotę w Tucholi .	odbył	5	Part
– Ja w każdym razie wybieram chłodny prysznic .	wybieram	5	Fin
Siadam w kącie i usypiam , budząc się na Gare du Nord .	budząc	6	Conv
Bezpowrotnie stracił piękne synowskie uczucie i mocno poranił wrażliwą duszę młodego człowieka .	poranił	7	Part
Kilka innych firm ogłosiło zamiar podwyższenia kapitału .	ogłosiło	3	Part
Odnosił em literacki sukces .	Odnosił	0	Fin
Jelcyn nie wykorzystał swej władzy dla prawdziwego zreformowania gospodarki .	wykorzystał	2	Part
Nie chcąc zaskoczyć krywów , starał się wywołać jak największy hałas .	zaskoczyć	2	Inf
Skończyła makijaż i zaczęła przeglądać ciuchy .	przeglądać	4	Inf
Ze stara wyciekał olej i płyn chłodzący , a przyczepa miała zdemontowany hamulec awaryjny .	wyciekał	2	Part
- Dopiero teraz uśmiechnęła się blado .	uśmiechnęła	3	Part
Wchodzimy w wiraż , coraz bardziej zbliżając się do sklepienia kanału , które naraz przybiera jaskrawoniebieski kolor z domieszką fosforyzującego fioletu .	zbliżając	6	Conv
W szybkim tempie spijało rosę .	spijało	3	Part
Należy starać się odnaleźć każdego postrzałka .	starać	1	Inf
Rozlał , podniósł i zaczął sączyć , świdrując oczami .	sączyć	5	Inf
W okolicach Ełku i Giżycka nie pracują 3 linie .	pracują	6	Fin
Tuż po Nowym Roku na miejscu znowu pojawili się budowniczowie igloo .	pojawili	7	Part
Przechodził on długą ewolucję , stając się najpopularniejszym tanim zegarkiem .	stając	5	Conv
Radykalnie negując ład istniejący na ziemiach ukraińskich w Polsce i ZSRR , nacjonalizm odrzucał każdą próbę prowadzenia polityki w ramach realnego układu sił .	negując	1	Conv
Krzesimir Dębski po obejrzeniu pierwszego montażu może wreszcie zacząć komponować muzykę , którą zresztą nosił w sobie od rozpoczęcia pierwszych zdjęć .	komponować	9	Inf
Tu składała ręce błagalnie , tam rozkładała je gestem perswazji .	rozkładała	6	Part
On tu miał pełnić straż .	pełnić	3	Inf
Znów się zawahała , ale nie miała przecież nic do ukrycia .	zawahała	2	Part
Dokąd zdąża i czego pragnie ?	pragnie	4	Fin
Wszedł do kuchni ledwie zapukawszy .	zapukawszy	4	Conv
Czy Dominik , broniąc się , mógł przewidzieć aż tak dramatyczne skutki ? !	przewidzieć	7	Inf
– Leżał na rękawicach ochronnych i też był popaprany ziemią .	Leżał	1	Part
Poradziła sobie wreszcie i sięgnęła po krzesło , lokując się tuż przy piecu .	Poradziła	0	Part
Julek okazał się mniej drażliwy .	okazał	1	Part
Marchewą wstrząsnęła taka sugestia .	wstrząsnęła	1	Part
Z klatki wyszedł sąsiad i w pijackim amoku rzucił się na niego z siekierą .	rzucił	8	Part
Tajny dziw krył się w głębokości ostępów .	krył	2	Fin
Aby właściwie odebrać myśli autora , wskazane jest odpowiednie przygotowanie matematyczne .	odebrać	2	Inf
- Pani mnie zwodzi .	zwodzi	3	Fin
Pudel wabił się Oskar .	wabił	1	Fin
Nikt nie zamierzał ustąpić .	ustąpić	3	Inf
Odebrać bogactwa wszystkim bogaczom i uczynić je własnością powszechną .	Odebrać	0	Inf
Straciwszy wreszcie cierpliwość , podniósł głowę i zagwizdał .	Straciwszy	0	Conv
Potrafił wznieść się ponad fałszywą ambicję .	wznieść	1	Inf
Można pójść z nim do szkoły i zaznajomić się z jej atmosferą , zanim dziecko zostanie uczniem .	zaznajomić	7	Inf
Podczas niemieckiej okupacji spotykaliśmy się , należąc do podziemnej literackiej Warszawy .	należąc	6	Conv
Na witrynie umieścili też nazwiska ponad 500 znanych ludzi , którzy podpisali się pod protestem przeciwko zakazowi Marszu Równości .	umieścili	2	Part
Nieco częściej czyniły to kobiety .	czyniły	2	Part
Pan konsul obiecał , że poruszy natychmiast tę sprawę z attaché wojskowym , generałem brygady .	obiecał	2	Part
Co jakiś czas muszę jeździć na badania kontrolne .	jeździć	4	Inf
– Boi się zaufać komukolwiek .	zaufać	3	Inf
Wystarczy nacisnąć jeden przycisk , by zobaczyć niebo nad głową .	nacisnąć	1	Inf
Mężczyźni zakomunikowali , że przychodzą z bardzo korzystną ofertą .	zakomunikowali	1	Part
A tu osobisty kontakt mógł zaważyć . . .	zaważyć	5	Inf
Bała się , aby nie ponieść kolejnej porażki .	ponieść	5	Inf
To będzie dobry moment , żeby przedstawić Krzysztofa ojcu .	przedstawić	6	Inf
Staads posłał mu urażone spojrzenie .	posłał	1	Part
Na ich temat nic również nie powiedzieli płatni informatorzy , do których w tej sprawie zwrócili się policjanci prowadzący dochodzenie .	powiedzieli	6	Part
Zawiesił słuchawkę .	Zawiesił	0	Part
Zdążyli dojechać do Knurowa .	dojechać	1	Inf
Dyskusje utykały na poziomie kosztorysów .	utykały	1	Fin
Jasieńczyk o nią zapytał .	zapytał	3	Part
Ale nie chciała chodzić , udawała , że nic nie rozumie .	udawała	5	Fin
Zdradzisz nam sekrety urody Cosmodziewczyny ?	Zdradzisz	0	Fin
A może , gdybym się przemógł , potłumiłbym jej zaklęcia ?	przemógł	5	Part
Kobiety przystrajają drzewko kolorowymi wstążkami , śpiewając przy tym tradycyjne pieśni .	śpiewając	6	Conv
Liście kołysały się na wietrze , gałęzie drzew szumiały jak morze w snach .	szumiały	8	Part
- Mógł by ś obrać ?	obrać	4	Inf
Należą do nich morderstwa i książki .	Należą	0	Fin
Nie sądzisz ?	sądzisz	1	Fin
Mogę się tylko domyślać , co to znaczy . . .	domyślać	3	Inf
Fizycznie i psychicznie znęcał się też nad konkubiną .	znęcał	3	Fin
Osiągnęła sukces .	Osiągnęła	0	Part
On umarł siedząc przy stole .	siedząc	2	Conv
Ziewnął , przeciągnął się , mocno napinając mięśnie .	napinając	6	Conv
Podczas ceremonii otwarcia Spływu organizatorzy przyznali liczne odznaczenia zasłużonym kajakarzom .	przyznali	5	Fin
Tańczono zapamiętale , wykrzykując i piosenką dogryzając sobie wzajemnie .	dogryzając	6	Conv
Potem otworzył jakąś książkę i mruczał .	mruczał	5	Part
Ale w tym momencie nie należało przeciągać struny .	przeciągać	6	Inf
– nie będę cię później znosić .	znosić	5	Inf
Jak je spłacić ?	spłacić	2	Inf
- Jakby kładli śnieg z dołu do góry , nic by się nie stało .	kładli	2	Fin
Przyjechali też strażacy z OSP z Poronina , Suchego i Kościeliska .	Przyjechali	0	Part
Maluchy i starsza młodzież spędzały tam czas po lekcjach , ucząc się i bawiąc .	ucząc	10	Conv
Grożąc bonią wepchnęli go do citroena i odjechali .	Grożąc	0	Conv
Sprzeciwili się projektowi ustawy , która pozwoli na przynoszący zysk import odpadów nuklearnych .	Sprzeciwili	0	Part
W kinie , na ostatnim filmie Allena , zasnęła m .	zasnęła	8	Fin
Wciąż traktowała mnie z góry .	traktowała	1	Part
Przez pierwszy tydzień leżą ukryte w wysokiej trawie , a następnie zaczynają wędrować za matką .	wędrować	12	Inf
Nim przekroczy granice raju , musi wyrazić skruchę .	przekroczy	1	Fin
Odpalił to makro , nawet nie wychodząc z trybu edycji .	wychodząc	6	Conv
Kupili jakieś zmiotki w ruskiej hurtowni i zbijają na mnie kasę .	zbijają	7	Fin
Za wszelką cenę starał się dogonić swoich , ale nie pomyślał , jak to będzie praktycznie wyglądało .	dogonić	5	Inf
Próbował ugasić ogień rękami .	ugasić	1	Inf
- Z biegiem lat pańska gniewność ustąpiła ?	ustąpiła	6	Part
To wcale nie znaczy , że nietypowa towarzyszka przestała sprawiać kłopoty .	sprawiać	9	Inf
Zaczyna mnie na dobre wkurzać .	wkurzać	4	Inf
Jeden z mężczyzn przystąpił do majstrowania przy kablach telefonicznych .	przystąpił	3	Part
Byłoby dziwne , gdyby ta większość przekazywała opozycji przewodnictwo najważniejszych komisji .	przekazywała	6	Part
Trochę mnie zatkało i zastanowiło , czy on czasami nie jest aktualny obecnie ?	zastanowiło	4	Part
Ilia jeszcze drzemał .	drzemał	2	Part
– możemy pomóc ci opiekować się jakimiś Niemcami .	opiekować	4	Inf
Nie zawiązał eś dobrze sznurowadła .	zawiązał	1	Fin
Prawdopodobnie zapuścił się dalej .	zapuścił	1	Part
- Działania operacyjne ustały , a C . ciągle piął się w górę .	piął	9	Part
Rozpaczliwie próbował em coś wyjaśnić , nie licząc na sukces .	licząc	7	Conv
Pośliniła palec i zaczęła trzeć .	Pośliniła	0	Part
Ponownie musiał użyć ręcznika .	użyć	2	Inf
Poprosił ekspedientkę o dostęp do telefonu , tłumacząc , że musi zadzwonić do swojego wspólnika .	tłumacząc	7	Conv
A to może uratować od śmierci , bo początek choroby zostanie w porę wykryty .	uratować	3	Inf
Myśleli śmy konkretnie o twoim szwagrze .	Myśleli	0	Fin
Franciszek wychodząc z cmentarza dojrzał samotnego Wilhelma .	wychodząc	1	Conv
Potem opłukała naczynia i ustawiła na drucianej kratce , by obeschły .	obeschły	10	Part
Podobnie jest ze świeczkami , ustawmy je tak , by kot nie mógł ich strącić .	strącić	14	Inf
Potwierdził to prezydent Jiang podczas niedawnego spotkania z prezydentem Clintonem .	Potwierdził	0	Part
– Wątpię .	Wątpię	1	Fin
Zdecydowano także zdjąć z programu salwę honorową .	zdjąć	2	Inf
Po odsiadce nie zaprzestał złodziejskiego procederu .	zaprzestał	3	Part
Szukając zysku , musiały ryzykować .	musiały	3	Part
Zmarszczyła brwi .	Zmarszczyła	0	Fin
Już wrosłem w to środowisko i uważam , że potrafię pogodzić swoje sprawy .	pogodzić	10	Inf
A pan nigdy się z nimi nie zetknął ?	zetknął	7	Part
Kto mógł przypuszczać .	przypuszczać	2	Inf
Jerzy zdał obszerną relację z podróży .	zdał	1	Part
Reformy ograniczono do totalnej prywatyzacji , która przyjęła raczej ramy wyprzedaży majątku narodowego .	przyjęła	7	Part
Decydując się na życie mnisze , Siostra odbiera sobie możliwość bycia matką .	Decydując	0	Conv
Dopiero waląc ramieniem o ziemię , poczuł strach .	waląc	1	Conv
Bo krzyż zdążono już umieścić na ścianie katedry górującej nad miastem .	umieścić	4	Inf
Prosze ułożyć mi coś , żeby ludzie zębami zgrzytali , włosy darli , płakali , ale i równocześnie wroga szukali . . .	darli	11	Part
Ale ramy , instytucje i aspiracje Cesarstwa narzuciły się apostołom , biskupom , kapłanom i wiernym jako odniesienie oczywiste i nieuniknione .	narzuciły	7	Part
Adam podzielił się swoim pierwszym wrażeniem na temat Klaudii , dodając , że się pomylił .	dodając	10	Conv
Zbierał te suche rozstajne krótkie drogi , wiązał w pokaźne drapadła o ściśniętym kierunku .	wiązał	7	Part
Bardzo zachęcam do wizyty w ICM i stałego korzystania z jej usług .	zachęcam	1	Fin
Wyłączyła komputer i podeszła do lustra .	Wyłączyła	0	Part
Nie zdążyli śmy go zatrzymać .	zdążyli	1	Fin
– A chciałaś poczuć porządnie ?	poczuć	3	Inf
Biedny Wojtek wysługuje się .	wysługuje	2	Fin
A więc chroniła i tuliła .	tuliła	4	Part
Załapać się trzeba teraz , bo potem będzie trudniej .	Załapać	0	Inf
Oddział mógł się spóźnić .	spóźnić	3	Inf
Rozłożyli śmy mapę na stoliku .	Rozłożyli	0	Fin
Chciał em odespać tę noc w czasie postoju .	odespać	2	Inf
- Agatka mówiła , że to ją strasznie bolało , ale nie mogła nawet pisnąć . . .	pisnąć	14	Inf
Rocznie na świecie ponad milion osób ginie w wypadkach drogowych , a ok . 40 mln odnosi rany .	ginie	6	Fin
Poradziła sobie wreszcie i sięgnęła po krzesło , lokując się tuż przy piecu .	lokując	8	Conv
Szukając zysku , musiały ryzykować .	Szukając	0	Conv
Po obu stronach muszą kisnąć jakieś mokradła , co oddychają mgłami .	oddychają	9	Fin
Stanął w nich ubrany w piżamę , zakrwawiony 12-letni Łukasz , wnuk gospodarzy , po chwili osunął się na ziemię .	osunął	16	Part
W pewnym momencie Łukasz mocno nadepnął na hamulec , samochód się zatrzymał , a chłopak wyskoczył i zatrzasnął komandora w środku .	zatrzasnął	17	Part
Mówić on będzie o swej twórczości .	Mówić	0	Inf
Istotnie , w damskim pokoju aż syczało .	syczało	6	Part
Wsunąwszy ją w ramy , położył na niej obrazek i zaczął skrupulatnie wbijać ćwieczki .	Wsunąwszy	0	Conv
Żeby jej coś wytłumaczyć .	wytłumaczyć	3	Inf
Bywa jednak , że ja pytam , aby przedłużyć jej obecność .	Bywa	0	Fin
Wspinając się , potrącił nogą ów kształt , który stoczył się ze stopni . . .	stoczył	9	Part
Dzięki wysiłkowi lekarzy udało się uratować mu życie .	uratować	5	Inf
Szedłem niskim i wąskim korytarzykiem , oświetlając sobie drogę uniesioną ku górze latarką .	oświetlając	6	Conv
Nieruchomo stojąc w powietrzu nad kwiatami lecimy .	stojąc	1	Conv
Musieli mu aż palce wyłamywać .	wyłamywać	4	Inf
Odwróciła się i zaczęła szybko iść w moją stronę .	Odwróciła	0	Part
Karol od świtu do nocy tkwił w wejściowych drzwiach , odnotowując czerwonymi oczami moje wyjścia i powroty .	odnotowując	10	Conv
Zdrzemnęła się przed telewizorem .	Zdrzemnęła	0	Fin
Mogą przy okazji oberwać .	oberwać	3	Inf
- Dlaczego nie wycierasz buzi chusteczką ?	wycierasz	3	Fin
- Politycy muszą się w końcu zdeklarować i dokonać wyboru .	zdeklarować	6	Inf
Przedstawiał się jako Mohammad Karim Tuszani .	Przedstawiał	0	Part
Mimo że Amerykanie uznali operację za udaną , z rejonu walk zdołało wymknąć się wielu partyzantów .	wymknąć	12	Inf
Trzeba także prowadzić lekcje .	prowadzić	2	Inf
Po zdjęciu serwetki i położeniu jej na kolanach na małym talerzyku spożyjemy przekąskę .	spożyjemy	11	Fin
Napadła ś na Kucyka , a to jest ich człowiek w terenie i nie dadzą go ruszyć .	ruszyć	16	Inf
Administracja Lecha Wałęsy nie przewidziała w nim puli na nagradzanie wyróżniających się młodych Polaków .	przewidziała	4	Part
Którędy się idzie , by zejść na manowce ?	zejść	5	Inf
Największy na świecie producent sieci komórkowych zamierza skupić się na podstawowej działalności , a aparaty będzie kupował od producenta zewnętrznego z siedzibą w Singapurze i tylko sygnował je własnym znakiem towarowym .	skupić	7	Inf
Nawet moje ulubione wędkowanie nie dawało mi zadowolenia .	dawało	5	Part
Wtedy stało się coś , czego nie mogli pojąć .	pojąć	8	Inf
Naprawdę tego żałuję .	żałuję	2	Fin
Otworzyła m , nie sprawdzając .	sprawdzając	4	Conv
KOKS MUSI BYĆ !	BYĆ	2	Inf
Pomiaukując alarmująco , zaprowadził Adama do dużego pokoju .	zaprowadził	3	Part
Zdaniem obrońców polecenie osadzenia Chodorkowskiego w pojedynczej celi przyszło z samego Kremla , który chce złamać byłego szefa koncernu naftowego .	złamać	15	Inf
Podpłynął księżyc , przywarł i zaczął ssać .	ssać	6	Inf
Uczestniczki wysłuchały wykładów doradców zawodowych i prawników , uczestniczyły w zajęciach psychologicznych , poznawały podstawy obsługi komputera i korzystania z Internetu .	wysłuchały	1	Part
Kiedy wznosić toasty ?	wznosić	1	Inf
- Łechczesz moją próżność .	Łechczesz	1	Fin
Musiał eś okropnie wycierpieć . . .	wycierpieć	3	Inf
Chciał się zemścić za to , że zwierzę załatwia się na jego korytarzu .	zemścić	2	Inf
Gospodarze odpowiedzieli dwoma golami Ralfa Hauptmanna i Austriaka Tony Polstera .	odpowiedzieli	1	Part
Niedziela Palmowa na Kociewiu różniła się zresztą od obchodów w innych częściach Polski .	różniła	4	Part
Jego przedsiębiorstwo przestało mu wypłacać pensję w ogóle .	wypłacać	4	Inf
Chciało jej się płakać .	płakać	3	Inf
Pomiaukując alarmująco , zaprowadził Adama do dużego pokoju .	Pomiaukując	0	Conv
Bo nie potrafi usiąść normalnie na sedesie .	usiąść	3	Inf
Kompan zawtórował mu , próbując wszystko w żart obrócić .	obrócić	8	Inf
Codziennie przybywa nowych terenów .	przybywa	1	Fin
Poszła m zdawać na filozofię .	zdawać	2	Inf
Wuja nie uczestniczył w rozmowie przyglądając się im obu bez sympatii .	przyglądając	5	Conv
To pochlebia facetom .	pochlebia	1	Fin
Kiwek , spluwając w palce , uważnie odliczał złotówki .	odliczał	7	Fin
- Wysłaliśmy ponad 500 zapytań , systematycznie przeglądamy odpowiedzi i nie natrafiliśmy jeszcze na urzędnika , na którym ciąży prawomocny wyrok sądowy .	przeglądamy	7	Fin
Reagując na stan zaspokojenia tych potrzeb , przeżywa emocje .	Reagując	0	Conv
Żelezik rzuca mi spłoszone spojrzenie .	rzuca	1	Fin
W ciemnym miejscu chodnika do samotnie idącej dziewczyny podbiegł mężczyzna i zgwałcił ją .	podbiegł	8	Fin
Pokrzepiła mnie tym na duchu .	Pokrzepiła	0	Part
Oczywiście tę moją zapobiegliwość o każdy szczegół bryczki spostrzegł kowal .	spostrzegł	8	Part
Obcowanie z księgą może odbywać się w całkowitej pustce .	odbywać	4	Inf
- Nie wracał do domu .	wracał	2	Fin
Bo staram się nie grzeszyć i zasłużyć na niebo ?	zasłużyć	6	Inf
Z pism Slazskiej Energetiki wynika , że opalana węglem nowa elektrociepłownia w Trzyńcu będzie spełniała wszystkie europejskie normy ekologiczne .	spełniała	14	Part
W dokumentach dowódcy szczycą się tym , że stłumili bunt bez użycia broni .	stłumili	8	Fin
Bo staram się nie grzeszyć i zasłużyć na niebo ?	grzeszyć	4	Inf
Kontrolerzy nie wzięli pogróżek poważnie , bo wiedzieli z doświadczenia , że w podobnej sytuacji prawie każdy podatnik powołuje się na możnego protektora . . .	wiedzieli	7	Fin
Policja przesłuchuje świadków , zbiera informacje , zabezpiecza ślady .	zabezpiecza	7	Fin
Stwierdził , że chciał w ten sposób skrócić jego cierpienia .	Stwierdził	0	Fin
Powiedzieć im ? !	Powiedzieć	0	Inf
Za każdym razem informacje te okazywały się nieprawdziwe .	okazywały	5	Fin
Na maszynce syczała woda do zmywania , radio grało .	grało	8	Fin
Widownia westchnęła ze współczuciem , a Iwana to uskrzydliło .	uskrzydliło	8	Part
W Paryżu , grając na giełdzie , majątek podobno podwoił .	podwoił	9	Fin
Bałamucić słowem i myślą .	Bałamucić	0	Inf
Przez dwa ostatnie tygodnie policjanci zaczęli podejrzliwie obserwować Staszka i Dawida .	obserwować	7	Inf
W Drygałach koło Białej Piskiej zatrzymany do kontroli 47-letni kierowca zionął na policjantów czosnkiem .	zionął	10	Part
Na zakończenie uroczystości głos zabrał sam ks . kardynał Sodano , który na początku niemal czystą polszczyzną przywitał przybyłych gości oraz wyraził swoje zadowolenie z pobytu we Wrocławiu .	przywitał	17	Part
Saszce rzeczywiście odeszła chętka do dalszej rozmowy .	odeszła	2	Fin
Zawsze przegrywam .	przegrywam	1	Fin
Krystyna Kofta ogłosiła , że przyjmuje na siebie misję walki o równouprawnienie Bożen z Krystynami i za dwa lata zaprosiła panie do Trójmiasta , by równość tę udowodnić .	zaprosiła	19	Part
Każdy znał tylko swoje karty , a więc grał na wyczucie .	znał	1	Part
Zbliżała się godzina bankietu , trzeba było zejść na dół .	Zbliżała	0	Part
Śmiał się wesoło , nacisnął dziewuszce nos , a ona obruszyła się , grożąc palcem .	grożąc	13	Conv
Ponadto prezes powiadomił o przestępstwie tutejszą prokuraturę .	powiadomił	2	Part
Usiedli śmy , zamówili śmy do picia napoje chłodzące .	Usiedli	0	Fin
Spustoszył potem Kujawy i zabrał wielkie łupy , które jednak mistrz prowincji mu wydarł .	Spustoszył	0	Part
Jako członek komisji śledczej , który cały czas dążył do zniesławienia lewicy , zaszkodził nam najbardziej .	zaszkodził	13	Part
Inwestorzy zagraniczni muszą wpłacić pieniądze z góry w nadziei , że biuro maklerskie wywiąże się ze zobowiązania .	wpłacić	3	Inf
Dotychczas obowiązek donoszenia WKU o studentach , którzy przerwali naukę , spoczywał na uczelniach .	przerwali	8	Part
Jak poinformował Cesar Fraga z Uniwersytetu w Buenos Aires , przeprowadzone tam badania wykazały , że czekolada wzmacnia antyutleniacze znajdujące się we krwi , zwiększając odporność na zaburzenia serca i naczyń wieńcowych .	zwiększając	24	Conv
nie zapytał em . .	zapytał	1	Fin
- Muszę kończyć .	kończyć	2	Inf
Z wypłowiałego zdjęcia uśmiechała się azjatycka , młoda twarz pana Korzeniowskiego , wystrojonego w mundur zapięty pod szyją .	uśmiechała	3	Part
Gdy dojeżdżał do bramy ogrodzenia , spojrzał za siebie .	dojeżdżał	1	Part
Lekarze opatrzyli stłuczenia , zwichnięcia i złamania u 14 pacjentów .	opatrzyli	1	Fin
Ambulatorium Chirurgiczne Pogotowia Ratunkowego udzieliło pomocy 80 pacjentom .	udzieliło	4	Part
Jest tak , jak pan pisze .	pisze	5	Fin
Myślę , że pamiętał czasy Cezara .	pamiętał	3	Part
Musiał milczeć .	milczeć	1	Inf
Tylko współlokatorka nie rokowała przyjemnego pobytu . . .	rokowała	3	Part
Policjanci śmieją się , odreagowując stres .	odreagowując	4	Conv
Wyrównują one nierówności , jednocześnie przyklejając płytki .	przyklejając	5	Conv
755 tys . zł od Ministerstwa Edukacji Narodowej zażądał starosta człuchowski .	zażądał	8	Part
Ale trzej bracia nie zważali na przeszkody .	zważali	4	Part
Rzecznik Białego Domu odmówił jednak ich podania , informując tylko , że dowody zostaną przekazane inspektorom ONZ w Iraku .	informując	8	Conv
O tych wszystkich wydarzeniach Agnus dowiedział się z opóźnieniem , gdyż rodzice w pierwszym okresie nie chcieli przekazywać mu złych wiadomości .	dowiedział	5	Fin
Czym zapełnić dziurę w budżecie ?	zapełnić	1	Inf
Zamierzał ją zawieść do inseminatora .	Zamierzał	0	Part
Według nieoficjalnych informacji próbował otruć suczkę .	otruć	4	Inf
Prowadzone obecnie postępowanie rozstrzygnie , kto zawinił .	rozstrzygnie	3	Fin
Należało spróbować nawiązać łączność .	Należało	0	Part
Zniszczyć , zamrozić i trzymać sto lat , a może przekazać do badań ?	przekazać	10	Inf
Zwykły mieszkaniec kraju ma się leczyć ziołami , które zaleca tradycyjna medycyna koreańska .	leczyć	5	Inf
Zachrobotało w bramie , zachrzęściło i błysnęła latarka Softa .	zachrzęściło	4	Part
Ale później , w latach sześćdziesiątych , wywiązała się intensywna publiczna debata na temat stosunków polsko - niemieckich . . .	wywiązała	7	Part
Przeglądam dziennik swój .	Przeglądam	0	Fin
I szukał tych swoich hitlerowców po lasach .	szukał	1	Fin
Ściemnia się .	Ściemnia	0	Fin
Oddając zużyte elektrolity , które tam będą regenerowane , napełnimy zbiorniki nowymi roztworami .	Oddając	0	Conv
Podać kurs !	Podać	0	Inf
Dwoisz się i troisz , aby rozwiązać kilkadziesiąt praktycznych problemów równocześnie .	rozwiązać	6	Inf
Nawet bałem się ją tknąć , ale mnie uspokoiła , że jest w porządku . . .	tknąć	4	Inf
Dalej autor artykułu sugestywnie opisuje , jak na ów obszar spada potężna rakieta z głowicą wodorową , powodując kolosalną eksplozję .	powodując	17	Conv
- Nie twierdzę , że jesteśmy bez winy , ale w zasadzie zarzut ten mógł by dotyczyć strony państwowej .	dotyczyć	16	Inf
Narrator znajduje ostre nożyczki i przecina kabel .	przecina	5	Fin
Bawiąc się chwastami swojej simlah Manahem mrużył coraz podstępniej oczy .	Bawiąc	0	Conv
Za każdy samochód zabierali się od razu mechanicy , zmieniali koła , usuwali uszkodzenia powstałe w czasie forsownego treningu , wymieniali zdarte nakładki hamulcowe , regulowali silniki .	wymieniali	20	Part
Na trasie przejazdu stały tłumy oklaskując samochody , które wiozły maleństwa i ich rodzinę .	wiozły	9	Part
- Tylko my zdołali śmy ujść .	ujść	5	Inf
Gdyby Bergvall zdecydował się przewieźć wydobyty alkohol do Finlandii , zapłaciłby ogromny podatek .	przewieźć	4	Inf
Zanieczyszczenia cytoplazmatyczne i błonowe są również groźne , stanowiąc prawdopodobne źródło zarówno aktywności proteolitycznej , jak i białek cytoplazmatycznych w puli niehistonowej .	stanowiąc	8	Conv
Przedstawiciele Stalexportu zapewniają , że banki chcą dalej finansować holding .	finansować	8	Inf
Dyskusje utykały na poziomie kosztorysów .	utykały	1	Part
Odbyło się taksowanie .	Odbyło	0	Part
Odrobina zazdrości utrzyma miłość w dobrej formie .	utrzyma	2	Fin
Poprawkę skrytykował już dyrektor wykonawczy Światowego Kongresu Żydów Elan Steinberg .	skrytykował	1	Part
Proszę bardzo odczytać komunikat .	odczytać	2	Inf
- Czy twój bóg zapewnił cię o tym ?	zapewnił	4	Part
Kiedy wznosić toasty ?	wznosić	1	Inf
- Ale nie dopadła .	dopadła	3	Fin
Do 1939 miasto leżało po niemieckiej stronie granicy .	leżało	3	Part
Maluchy i starsza młodzież spędzały tam czas po lekcjach , ucząc się i bawiąc .	spędzały	4	Fin
W krem wcisnąć osączone i pokrojone ananasy .	wcisnąć	2	Inf
Maszyna ta musi w ciągu trzech lat się zamortyzować , by zarobić na następną , jeszcze nowocześniejszą i szybszą .	zamortyzować	8	Inf
Kłaniając się przepraszająco , opuścili śmy z panem Adamkiem zakład pogrzebowy .	Kłaniając	0	Conv
Dlatego umówił em się z nim w restauracji i zawiadomił em policję .	umówił	1	Fin
Na desperacki krok zdecydowała się 19-letnia mieszkanka Radymna .	zdecydowała	3	Fin
ładnie nawiązał eś do Łazarza i przepaści potępiając mnie i skazując na nie .	skazując	10	Conv
Według relacji pracowników ambasady próbowali oni podejść do budynku z dwóch przeciwnych stron .	próbowali	4	Part
- Trawianka azjatycka w Wiśle miała nie wytrzymać sezonu .	wytrzymać	7	Inf
Dominować będą piosenki do tekstów Edwarda Stachury .	Dominować	0	Inf
Pogróżkowy ton pod adresem duce podtrzymał A . Hall .	podtrzymał	5	Part
Ani my ciebie nie pobudzamy , ani ty się nie dzielisz .	dzielisz	10	Fin
Musimy wypracować nowy polityczny model społeczeństwa .	wypracować	1	Inf
Tęsknota ogarniała chłopców .	ogarniała	1	Part
Pomiaukując alarmująco , zaprowadził Adama do dużego pokoju .	Pomiaukując	0	Conv
Nawet go to nie poruszyło .	poruszyło	4	Part
Skończyła makijaż i zaczęła przeglądać ciuchy .	Skończyła	0	Fin
Używając pożyczonych magnetofonów szpulowych połączył em dźwięki suity z fragmentami poematu Wergilego .	Używając	0	Conv
Zanim udaje im się wyjechać z miasta , mija często cały dzień .	wyjechać	4	Inf
W ziemi ziały ogromne dziury .	ziały	2	Part
Mag osunął się bezwładnie .	osunął	1	Part
- Chcemy również upowszechnić ten rodzaj sportu wśród osób niepełnosprawnych .	upowszechnić	3	Inf
- Sądząc po ilości , nie masz już czym .	Sądząc	1	Conv
Sprzedaż monti i stanowisk nie pokrywała chronicznego deficytu .	pokrywała	5	Part
Nauczyciele wymienili spojrzenia .	wymienili	1	Part
W swoim dawnym kształcie kapelusz nie ostał się .	ostał	6	Part
Przyzwoitość każe szanować gości i ja właśnie w ten elegancki sposób uszanuję Jagodowe wakacje .	szanować	2	Inf
Powstał w ten sposób schemat ich unifikacji .	Powstał	0	Part
Nie opal sobie skrzydeł , zbyt wysoko wylatując pod słońce .	wylatując	7	Conv
Stanowią one razem z rzodkiewką potrawę pełnowartościową , dając jednocześnie ciekawy efekt dekoracyjny .	dając	8	Conv
Trudno przewidzieć wynik głosowania nad skróceniem tygodnia pracy .	przewidzieć	1	Inf
Mock przytulił się do hrabiny i objął jej kruche ramiona .	objął	6	Part
Powstało z komitetów na rzecz referendum w sprawie karania za aborcję .	Powstało	0	Part
Otworzyła m , nie sprawdzając .	Otworzyła	0	Fin
Trzecioligowcy strzelili kontaktowego gola , ale w ostatnim kwadransie dwie bramki dla Lecha wypracował Remień .	strzelili	1	Part
Jego anegdoty traktowały o najrozmaitszych księżach dziwakach , których w okolicy nie brakło , a których przygody tchnęły często humorem z epoki Seweryna Soplicy czy nawet Paska .	tchnęły	17	Part
Ludzi to drażni , złości .	złości	4	Fin
W tym czasie musiał stać w szatni , żeby otwierać drzwi .	otwierać	9	Inf
Jeżeli ciąża zagraża życiu matki , trzeba dokonać aborcji .	dokonać	7	Inf
Nie lubię rozpamiętywać .	rozpamiętywać	2	Inf
Był to kredyt zaufania , który zobowiązywał .	zobowiązywał	6	Part
Mała lampka rozpraszała mrok , rzucając nikłe światło na błękitną tapetę .	rozpraszała	2	Part
Ale możemy przecież za nią podziękować .	podziękować	5	Inf
Firma ponosiła duże straty .	ponosiła	1	Fin
Przeprowadziła się tutaj z Krakowa .	Przeprowadziła	0	Fin
Zastawił się przed cięciem w prawy bok .	Zastawił	0	Part
- Jak pan sądzi , zobaczycie się z Bagsikiem w tym tysiącleciu ?	zobaczycie	5	Fin
Niewiele mogła dociec .	dociec	2	Inf
Odpalił to makro , nawet nie wychodząc z trybu edycji .	wychodząc	6	Conv
Będę pracować , żyć jak dawniej .	pracować	1	Inf
Nadmieniamy , że w pierwszą niedzielę lutego br . przeprowadzono zbiórkę pieniędzy na zakup niezbędnego urządzenia medycznego do pracowni analitycznej w Wiejskim Ośrodku Zdrowia w Brzeziu .	Nadmieniamy	0	Fin
Skarżył się jej przecież , że w kieracie prozaicznych zajęć , wśród ludzi zajętych tylko sprawami chleba powszedniego , brak mu rozmów na poważne tematy .	Skarżył	0	Part
Wirował nad domami i zaczęło go trząść .	trząść	6	Inf
Najpierw związał się z Kongresem Liberalno - Demokratycznym .	związał	1	Part
Grożąc skrzywdzeniem Anety , zabronili też powiadamiać policję .	Grożąc	0	Conv
– zaczną sobie wyobrażać . .	wyobrażać	3	Inf
Twoje słowa trafiły na podatny grunt .	trafiły	2	Part
A wy nie zdążyli ście !	zdążyli	3	Fin
Prowadził też agencję reklamową .	Prowadził	0	Part
- Pisali śmy razem komunikaty z posiedzeń TKK .	Pisali	1	Fin
Dym i kurz dławił , ale jeszcze bardziej dławił strach .	dławił	3	Fin
Ale ambicja kazała mu natychmiast odrzucać obrzydzenie i opory .	kazała	2	Fin
Jako członek komisji śledczej , który cały czas dążył do zniesławienia lewicy , zaszkodził nam najbardziej .	dążył	8	Part
W tej sytuacji Fidel Castro postanowił ratować swą reputację .	ratować	6	Inf
Teofil trzymał je w ręce , aby włożyć dopiero w ostatniej chwili .	włożyć	7	Inf
Sprawiłoby to , że Radzie Bezpieczeństwa znacznie trudniej byłoby podjąć niezbędne decyzje .	podjąć	9	Inf
- W 1997 r. rozwiodł em się .	rozwiodł	4	Fin
– mącili śmy w bierki . .	mącili	1	Fin
Jeżeli nieszczęściem zakochasz się we mnie .	zakochasz	2	Fin
Na wczorajszej rozprawie zeznania składali kolejni świadkowie w procesie , który niedawno został rozpoczęty ponownie .	składali	4	Part
Wychowała m tam 10 specjalistów chirurgii dziecięcej .	Wychowała	0	Fin
Wszystkiego doszukać się w sobie .	doszukać	1	Inf
Zajęły one terytoria w sąsiedztwie swych matek .	Zajęły	0	Part
Przerwał na chwilę chwytając świszczący oddech .	chwytając	3	Conv
Ruszył przed siebie , szurając nogami .	szurając	4	Conv
Wieczorami spacerował wzdłuż kawiarni i zaglądał w okna pod firanki .	spacerował	1	Part
Pozwolą Państwo , że coś przypomnę .	Pozwolą	0	Fin
Korzystał chętnie z tego , gdyż otrzymywał piętnaście centów na kino .	Korzystał	0	Fin
Bóg zesłał Anioła , bo go zatrzymać w ostatniej minucie .	zesłał	1	Part
Przymknął oczy i trwał w zadumie nie słysząc nawet roztrzepanej gadaniny niezliczonych wróbli .	słysząc	7	Conv
Podróżujący pierwszą klasą będą odtąd mogli wypoczywać podczas lotu na rozkładanych podwójnych siedzeniach .	wypoczywać	6	Inf
I doczekać z antykaczyńskim rządem do jesiennych wyborów .	doczekać	1	Inf
Musiał em się uśmiechnąć .	uśmiechnąć	3	Inf
Odkręcił korek , oblał się i podpalił .	Odkręcił	0	Part
Lopez odchrząknął .	odchrząknął	1	Part
I umie przewidzieć ceny ?	przewidzieć	2	Inf
I zrozumieli ludzie , że tu Bóg był , i zburzyli ten sądowy dom , aby w nim nikt już więcej po Panu Jezusie nie sądził , a przed jabłonnymi drzewami postawili krzyż i on do dziś tam stoi .	sądził	25	Part
Rodzice nie będą już mogli wmawiać swoim pociechom , że przynosi je bocian bądź znaleziono je w kapuście .	wmawiać	5	Inf
Idź lepiej na podwórze , pobiegaj !	pobiegaj	5	Fin
- Każdy twórca marzy chyba , żeby odnieść wielki sukces .	marzy	3	Fin
Niebacznie stanął pod nawisem , oberwało się i przywaliło .	przywaliło	8	Part
Czyżby teraz przepuściła okazję , mając tuż obok przystojnego młodego mężczyznę ?	mając	5	Conv
Meseńczycy , odwieczni wrogowie Sparty , zgodzili się przepuścić ich przez swoje terytorium .	przepuścić	8	Inf
Mucha spaceruje też po ścianie , dostrzegam ją spod przymrużonych powiek .	dostrzegam	6	Fin
Wystarczy otworzyć kopertę i spisać dane .	spisać	4	Inf
Społeczeństwo wychowywano w ślepym posłuszeństwie wobec Cesarstwa .	wychowywano	1	Fin
Lekarze zdecydowali się na operację , ale brakowało dawcy .	zdecydowali	1	Part
Następnie zbiegł po jakichś schodach ; zbiegał długo .	zbiegał	6	Part
- Robić dalej to samo .	Robić	1	Inf
Pracowicie wyodrębnił pojęcia takie jak ból , smutek , rozpacz , cierpienie , żal .	wyodrębnił	1	Part
Downar wyjął papierośnicę i w zamyśleniu począł obracać ją w palcach .	obracać	7	Inf
Jakże naiwny był Józef , kolejny raz ufając obietnicom białych !	ufając	7	Conv
- Musiała by m się zabezpieczyć .	zabezpieczyć	5	Inf
W Wojewódzkim Szpitalu Zespolonym odbyła się pierwsza w Poznaniu udana operacja przeszczepienia rogówki .	odbyła	4	Part
Michał naciągnął mi na oczy kaptur , omotał szalikiem i kazał wracać do domu .	omotał	7	Part
Okazuje się , że zaproszona grupa baletowa prawdopodobnie będzie musiała zrezygnować z udziału w festiwalu .	zrezygnować	10	Inf
Brigitte Bardot zaczęła bronić zwierząt histerycznie , szlachetne intencje popsuły się i pogniły jak robaczywe jabłka .	popsuły	9	Part
Gospodarz wyprostował się .	wyprostował	1	Fin
Ten biało - czarny kocur zdobył szturmem serca pracowników Downing Street , a z czasem jego sława rozprzestrzeniła się na cały kraj .	rozprzestrzeniła	17	Part
Jak sądzisz ?	sądzisz	1	Fin
Potrząsnął głową , odchrząknął .	Potrząsnął	0	Fin
Policjanci z pobliskiego komisariatu przyznają , że docierają do nich sygnały o rozbojach .	docierają	7	Fin
Młodzi zamieszkali na ul . Chrobrcgo .	zamieszkali	1	Part
- Będziemy grali , mam taką nadzieję .	grali	2	Part
Gospodarz milczał opuściwszy powieki , jakby się lękał zdradzić spojrzeniem .	opuściwszy	2	Conv
Wędrował po Tatrach od 1914 r. , wspinał się od 1924 .	Wędrował	0	Fin
Mijając miejsce , w którym zginął Młody , wzdrygnęła się i odwróciła wzrok .	wzdrygnęła	8	Part
Dotyczyło to zresztą wyłącznie ubioru .	Dotyczyło	0	Part
Musi skończyć się plebiscyt .	skończyć	1	Inf
Kobiety muszą zakrywać włosy , ramiona , nogi .	zakrywać	2	Inf
Nakryto tu silną stację nadawczą .	Nakryto	0	Fin
Stali dłuższą chwilę niezdecydowani , nie ważąc się na ryzykowny krok .	ważąc	6	Conv
Do sali zjechaliśmy godnie , windę znarowioną już naprawili .	naprawili	8	Part
Na placach poczęły gromadzić się grupy przechodniów z zadartymi do góry głowami .	gromadzić	3	Inf
Kuskus przygotować według przepisu na opakowaniu , dodając 2 łyżki masła i szczyptę soli .	dodając	7	Conv
II wojna światowa skończyła się ponad pół wieku temu .	skończyła	3	Part
Nie ma czym zmierzyć , bo ON , wyprowadzając się , zabrał aparat .	wyprowadzając	8	Conv
Taboret upadł z dramatycznym łoskotem , a on , wierzgając nogami , zawisł niczym gotowy do wypatroszenia wieprz .	wierzgając	9	Conv
Porozumienie to podpisano bez wstępnego konsultowania się z rządem .	podpisano	2	Fin
- Wierzę , że kandydaci do członkostwa w NATO powinni spełniać generalne kryteria demokratycznych rządów i gospodarki wolnorynkowej , włączając w to poszanowanie dla praw człowieka oraz cywilną kontrolę nad wojskiem .	włączając	19	Conv
- Szanując czas Wysokiej Izby , w razie pytań będę do dyspozycji .	Szanując	1	Conv
ZSRR zgodził się zwolnić zatrzymanych marynarzy .	zwolnić	3	Inf
ja nie mam gdzie rzucać łachów .	rzucać	4	Inf
Tego tolerować nie można !	tolerować	1	Inf
Proszę stawić się w moim gabinecie za godzinę .	stawić	1	Inf
Patrzyła na mnie tak , aż zrobiło mi się nieprzyjemnie i zaczęła m żałować swoich słów .	żałować	13	Inf
Nie musiał się zalecać ani kokietować .	zalecać	3	Inf
Zaczął em się obawiać , że wyrządził em mu krzywdę .	Zaczął	0	Fin
Księgowe potwierdziły , że działały w porozumieniu z kilkoma członkami spółdzielni .	działały	4	Part
Smażyli ryby złowione w strumieniu .	Smażyli	0	Part
Pierwsze krople deszczu zadudniły o trumnę i zmieszały się ze święconą wodą , którą ksiądz rozpryskiwał z kropidła podobnego do królewskiego berła .	zadudniły	3	Part
Wojewoda doda jej dla splendoru nieszczupły taborek .	doda	1	Fin
--Żeby do niej dotrzeć , trzeba było wyrąbać na nowo leśną drogę .	wyrąbać	7	Inf
Zażerała się orzechami w czekoladzie i kasztanami mrożonymi , oblizując swoim obyczajem czubki palców .	oblizując	9	Conv
Patrzył w niego w zachwyceniu , a potem przestał widzieć cokolwiek , bo zemdlał .	widzieć	9	Inf
Dopiero dzisiaj w trędowatej kaplicy rozdzielili się na kata i ofiarę .	rozdzielili	5	Fin
Iluż poważnych obecnie pisarzy czytało swe pierwsze próby literackie w sali przy Krupniczej , siedząc wokół dębowych stołów zsuniętych pośrodku .	siedząc	14	Conv
- Lepiej się na razie pomartwić , niż samochód stracić .	pomartwić	5	Inf
Płacić również nie zamierzały .	Płacić	0	Inf
Po ustaleniu , że występują w tym zakresie nieprawidłowości , policjanci przystąpili do działań .	przystąpili	11	Fin
Wczoraj w nocy zziębnięci złodzieje skradli mu kilkadziesiąt skórzanych ubrań o wartości ponad 65000 zł .	skradli	5	Part
Niedawno zapytał darłowskie dzieci , kim był król Eryk .	zapytał	1	Part
Podporucznik Kowalik , nie mogąc znieść kuchenno - masarnianego obrządku i słodkawego zapachu krwi , ubrał się i wyszedł z domu .	znieść	5	Inf
Rozdzielali zwaśnione strony w ramach misji pokojowych ONZ .	Rozdzielali	0	Fin
Po bombardowaniach wojsko przeczesuje dom po domu , starając się odnaleźć porwanego w niedzielę swego kolegę , Gilada Shalita .	starając	8	Conv
Poprosił ekspedientkę o dostęp do telefonu , tłumacząc , że musi zadzwonić do swojego wspólnika .	zadzwonić	11	Inf
Wpatrywał się w niego wyczekująco .	Wpatrywał	0	Part
Interesanci spojrzeli we wskazanym kierunku i oniemieli z radości .	oniemieli	6	Part
Może wolał przemilczeć tragedię .	przemilczeć	2	Inf
Rozłożył dłonie .	Rozłożył	0	Part
Do sześciu głodujących w Poznaniu dołączyło w piątek trzech związkowców ze Śremu .	dołączyło	5	Part
Publiczność oszalała z radości . . .	oszalała	1	Fin
Gdyby mógł wtedy dopaść Szamila , niechybnie by go zabił .	dopaść	3	Inf
- Kierowca otworzył drzwi i kazał mi wsiadać .	wsiadać	7	Inf
Kąpać się w tej samej wodzie ?	Kąpać	0	Inf
Kocham cię w kapeluszu i w berecie .	Kocham	0	Fin
Na czwartym rogu Żelaznej wywrócili kiosk z papierosami , jako przeszkodę , papierosy się posypały .	wywrócili	4	Fin
Dotknął wilgotnego ręcznika w łazience , pogładził mięsistą połę szlafroka , powąchał mydło w cedrowej kasetce .	pogładził	6	Part
Jak pani zareagowała ?	zareagowała	2	Part
Umieć wytrwać .	Umieć	0	Inf
Wymiata wszystko z lodówki .	Wymiata	0	Fin
Nawet piędź ziemi nie zostanie , rozdrapią jak głodne kruki .	rozdrapią	6	Fin
Marta nie może powstrzymać uśmiechu .	powstrzymać	3	Inf
Kiedy w Banja Luce skończył się ostatni , decydujący o medalu mecz , Halina leżała na parkiecie , a na niej kłębiła się góra ciał .	skończył	4	Part
– Próbował em teraz w lecie na jachcie .	Próbował	1	Fin
Z rodziną bawili się w ciuciubabkę .	bawili	2	Part
W pierwszej kolejności będzie służyła ponad 400 uczniom szkoły podstawowej i gimnazjum .	służyła	4	Fin
Wiał wiatr szarpiąc jego ubranie .	szarpiąc	2	Conv
Nawet laik wie , że do 1939 r. nie błyszczeli śmy specjalnie w kinie .	błyszczeli	9	Fin
Do Warszawy dotarli już o gęstym zmroku .	dotarli	2	Part
Część młodych osób chce pracować w państwowej firmie , bo to daje zabezpieczenie socjalne .	pracować	4	Inf
Suzanne pokręciła przecząco głową .	pokręciła	1	Part
Czy trzeba się z tym godzić ?	godzić	5	Inf
W poniedziałek dwaj gorzowianie podbili ją do 1.000 zł .	podbili	4	Part
- Mogło by się tak komuś wydawać .	Mogło	1	Fin
Wszarz pchnął go opierając o pień w półmroku .	opierając	3	Conv
Cztery kowane wozy pojechały za siostrami .	pojechały	3	Part
W USA rozpyla się na przykład streptomycynę i tetracyklinę na drzewa owocowe i pola ziemniaków .	rozpyla	2	Fin
Cameron będzie obserwować , jak wolno objeżdża trotuar , oglądając inne dziewczyny .	obserwować	2	Inf
W dyskusji zabrało głos siedemnastu mówców .	zabrało	2	Fin
- Co robicie , by w tak świetnej kondycji dotańczyć do finału ?	dotańczyć	9	Inf
Nagle zaczęła jęczeć i płakać .	płakać	4	Inf
Jako metal szlachetny nie wypiera wodoru z kwasów , reaguje jedynie z gorącym kwasem azotowym i siarkowym , redukując je do odpowiednich tlenków .	reaguje	9	Fin
To zabrzmiało ostro .	zabrzmiało	1	Part
Całość realizacji miała kosztować 8 tys . euro .	kosztować	3	Inf
- Mogło by się tak komuś wydawać .	wydawać	6	Inf
Papieros sparzył mi palce , rzucił em go w śnieg .	sparzył	1	Fin
Zaniżają lub w ogóle nie wypłacają ekwiwalentów za niewykorzystane urlopy .	wypłacają	5	Fin
Nie wiedziała , jak udzielić mu tych rad , czuła , że śmiałby się znowu .	czuła	9	Part
- Nie nudź .	nudź	2	Fin
Jednak główną rolę w pracy nad brzmieniem płyty odegrały gitarzystka Wendy Melvoin i grająca na instrumentach klawiszowych Lisa Coleman .	odegrały	8	Part
Wiedział em , że tej krzywdy mi nie wybaczy .	wybaczy	8	Fin
- Położyć się ?	Położyć	1	Inf
Jako metal szlachetny nie wypiera wodoru z kwasów , reaguje jedynie z gorącym kwasem azotowym i siarkowym , redukując je do odpowiednich tlenków .	redukując	18	Conv
Sesję zorganizował Zakład Słowianoznawstwa PAN .	zorganizował	1	Part
W głębi izby ktoś nagle zapłakał .	zapłakał	5	Part
- Przejdzie , nie warto się przejmować .	przejmować	6	Inf
Obok klatek z dorosłymi ptakami krążyły dwa małe kazuary , grzebiąc w odpadkach w poszukiwaniu pożywienia .	grzebiąc	10	Conv
Tu mogłem obserwować rzetelną , telewizyjną realizację bez pośpiechu , w której uczestniczenie było naprawdę przyjemnością .	obserwować	2	Inf
Kto by uwierzył , że kiedykolwiek będziemy się chlubić kopalniami , nie mówiąc o obiektach PKP ?	uwierzył	2	Part
Wyjaśnił w niej , że został wychowany w bardzo purytańskim domu , w którym wpojono mu szacunek dla takich cnót jak skromność i oszczędność .	Wyjaśnił	0	Part
Wszystko zaczyna się nieźle układać .	układać	4	Inf
Każdy myślał , że wystarczy włożyć do worka z solą i zanieść na strych .	włożyć	5	Inf
Nakazał też zdemontowanie istniejących terminali .	Nakazał	0	Part
Kto ją sformuował ?	sformuował	2	Part
O tym , że on sam chciał oszukać przeciwnika , Iwanuszka nie pomyślał .	oszukać	7	Inf
Usiadła , obejmując dłońmi ramiona .	obejmując	2	Conv
Takie stanowisko może się jednak słusznie wydawać nazbyt łatwą dymisją rozumu .	wydawać	6	Inf
Nie chcę tego stracić .	stracić	3	Inf
Następnie rozłożyła wysoki statyw , zawiesiła na nim pudełko , przeprowadziła od niego przezroczysty przewód do igły , którą wcześniej automatyczny iniektor umieścił w żyle na przedramieniu Irka .	przeprowadziła	10	Part
Krępa i kanciasta sylwetka zdaje się ją rozsadzać .	rozsadzać	7	Inf
Wydawało się , że wojna jednak go przerosła , przeraziła .	przeraziła	9	Fin
Cudem przeżyła 9-letnia dziewczynka .	przeżyła	1	Part
– co ty opowiadasz ?	opowiadasz	3	Fin
Teraz uczynimy to posługując się Boską Świadomością .	posługując	3	Conv
Jak obsługiwać menu ?	obsługiwać	1	Inf
Przekazał policjantowi dziewczynę i popłynął do brzegu .	Przekazał	0	Part
Ja widział em ich niewiele , ale wciąż i wciąż mnie przed nimi ostrzegano .	ostrzegano	13	Fin
Nie nalegał .	nalegał	1	Part
Sędziowie orzekli , że nie można ratować jednych , poświęcając życie innych ludzi .	poświęcając	9	Conv
Nie wolno naruszać czyichś praw autorskich .	naruszać	2	Inf
Spore zdziwienie mieszkańców Gdyni wywołał widok jachtów w basenie Prezydenta .	wywołał	4	Part
Jest rok 1962 i USA wloką się wciąż ze swym programem rakietowym .	wloką	5	Fin
Swoja drogą można by przełożyć ją na lato , można by tłoczyć jakieś bułgarskie winogrona , przynajmniej wino nie byłoby takie cierpkie .	przełożyć	4	Inf
Po piętnastu minutach nadchodzi .	nadchodzi	3	Fin
Izrael nie godzi się na żadne warunki .	godzi	2	Fin
Otworzyła szerzej drzwi wpuszczając wszystkich do środka .	wpuszczając	3	Conv
O możliwości pracy w Azerbejdżanie wspominał już w Warszawie .	wspominał	5	Part
To , niestety , będzie kosztowało .	kosztowało	5	Fin
- Wiem , trzeba będzie zaiwaniać . . .	zaiwaniać	5	Inf
Lewicki wystartował spod lexusa , aby pomóc jej nieść bagaże .	nieść	8	Inf
Pozostali ministranci postanowili dalej pełnić służbę ministrancką .	pełnić	4	Inf
Mogą jednak interweniować , gdy mają dowody przestępczej działalności .	interweniować	2	Inf
- Czy chce otrzymać azyl w Danii ?	otrzymać	3	Inf
Były to także czasy pierwszej rewolucji przemysłowej , do której szybko się dostosowali .	dostosowali	12	Part
Siadam w kącie i usypiam , budząc się na Gare du Nord .	budząc	6	Conv
Później współpracowali z Szewardnadze , strzegąc jednak zazdrośnie swojej sfery wpływów .	strzegąc	5	Conv
Zauważono też nagminne zaniżanie zarobków pracowników za dni urlopowe lub chorobowe .	Zauważono	0	Fin
Rolnik , szukając schronienia , błyskawicznie wskoczył na dwukółkę .	szukając	2	Conv
Na ułamek sekundy znieruchomieli , patrząc sobie w oczy , i w sekundę potem przywarli do siebie .	znieruchomieli	3	Part
Ktoś inny w złości kopie ławkę i rzuca głośno soczyste przekleństwa .	kopie	4	Fin
Popełniasz błąd .	Popełniasz	0	Fin
Chcą tworzyć , konstruować .	konstruować	3	Inf
W zamian kuria proboszczem tego kościoła uczyniła jego starszego brata , ks . Zdzisława Struzika .	uczyniła	6	Part
Podczas którejś kolacji wyznał , że przez kilkanaście lat uprawiał pięściarstwo .	uprawiał	9	Fin
Teraz wstała , podpierając się kulą .	podpierając	3	Conv
Nie wiedziała , jak udzielić mu tych rad , czuła , że śmiałby się znowu .	udzielić	4	Inf
- Mimo stacjonujących w Groznym wojsk i patroli Rosjanie nie będą się tam czuli bezpiecznie .	czuli	13	Part
Jeszcze większe wrażenie na współczesnych sprawiał Tomasz z Akwinu , dyktując dwa albo trzy traktaty filozoficzne .	dyktując	10	Conv
Immonen , w czarnych dżinsach welwetowych i w zgniłozielonym golfie , nie zdążył jeszcze zrzucić kożucha .	zrzucić	14	Inf
Ale ciągle go gdzieś gnało , stawiał sobie nowe wyzwania .	gnało	4	Part
Nowa ustawa zobowiąże szefów do zakupu okularów korekcyjnych dla pracowników , którzy potrzebują ich podczas wykonywania swoich zajęć .	potrzebują	12	Fin
- To bardzo pomogło .	pomogło	3	Fin
Prokuratura orzekła , że jest niepoczytalny .	orzekła	1	Fin
Pan poseł pomagał panu ministrowi , nie mogę za to go skarcić .	skarcić	11	Inf
Można by je przyrównać do haczyków .	przyrównać	3	Inf
Zmarszczywszy brwi zastanawiał się chwilę .	Zmarszczywszy	0	Conv
W samej Warszawie w Internecie swoje auta eksponuje już kilkadziesiąt komisów .	eksponuje	7	Fin
Polska może na tym stracić najbardziej .	stracić	4	Inf
Nie dopuszcza żadnej kontroli , nie uznaje żadnych norm , nie widzi żadnych granic .	dopuszcza	1	Fin
Jednak po dokładnych oględzinach straż pożarna odkryła ofiarę pożaru .	odkryła	6	Part
Według dokumentów celnych miał przewozić wyroby czekoladowe .	przewozić	4	Inf
- Podwieźć pana ?	Podwieźć	1	Inf
Ten , porwawszy swój kord , pobiegł za nim .	porwawszy	2	Conv
Potem , gdy próbowali je sprzedać w Szanghaju , zostali zauważeni przez policję .	próbowali	3	Part
Zaczną czerpać wodę .	czerpać	1	Inf
Apfelbaum szedł przed siebie , nie zwracając na niego uwagi .	zwracając	6	Conv
Kaneyasu kiwał głową , akceptując pomysł Kiry .	akceptując	4	Conv
- Ale ich liczba w Europie będzie szybko rosnąć .	rosnąć	8	Inf
Pożeracz Chmur przełknął ostatni kęs i oblizał palce .	oblizał	6	Part
- Słyszysz ?	Słyszysz	1	Fin
Wtedy napastnicy zaczęli go kopać po całym ciele .	kopać	4	Inf
Łagodzić . . .	Łagodzić	0	Inf
Należało spróbować nawiązać łączność .	spróbować	1	Inf
Uważają nas za moskalofilów , takich zaprzańców antyukraińskich , podczas gdy sami deklarują ukraiński patriotyzm .	Uważają	0	Fin
Podmuch obrócił go i Nicholas zahaczył barkiem o coś miękkiego .	zahaczył	5	Part
Związkowcy podkreślili jednak , że mają gwarancje ministra w sprawie modelu PKP i przyszłych przekształceń kolei oraz dalszych rozmów z nimi .	podkreślili	1	Part
I rzeczywiście , taczając się , po chwili ruszyli przed siebie .	taczając	3	Conv
Nie mógł już dłużej dusić .	dusić	4	Inf
Tak orzekł wczoraj niemiecki Trybunał Federalny w Karlsruhe .	orzekł	1	Part
Nawet trochę pomieszkać , może nawet popracować w kibucu .	popracować	6	Inf
Potem przemawiali inni mówcy i debata ciągnęła się przez następną godzinę .	ciągnęła	6	Fin
Widząc to kobieta poważnie zaniepokoiła się .	Widząc	0	Conv
Kontemplując Jezusa pragnę budować na takiej skale .	Kontemplując	0	Conv
Podchodzi coraz bliżej .	Podchodzi	0	Fin
Docierają pracodawcy .	Docierają	0	Fin
Wtedy do akcji wkroczyli rodzice Marianny Czupinki .	wkroczyli	3	Fin
miał tutaj do nas przyjechać . .	przyjechać	4	Inf
We współczesnej dyskusji takie zarzuty stawiali H . Williams , N . Abercrombie , J . Larrain , W . Carlsnaes .	stawiali	5	Part
- Przecież mieli śmy sobie pobiegać .	pobiegać	5	Inf
Patrzył na nich nieufnie .	Patrzył	0	Part
Potem zadzwonił ksiądz Franciszek Blachnicki z gratulacjami .	zadzwonił	1	Fin
Wikary Pudło odprawia je żując gumę .	żując	4	Conv
Czy komornik poprzestanie na aucie byłego ministra , skoro śledczy kazali zabezpieczyć majątek wart 150 tys . zł ?	zabezpieczyć	11	Inf
Sądzi , że śmierci nie ma .	Sądzi	0	Fin
Nie odkładając pocisku , sięgnął em do kabury .	odkładając	1	Conv
- Będziemy udawali , że śpimy .	śpimy	5	Fin
Jak wielu moich rówieśników inaczej swoje życie planował , a inaczej się potoczyło .	planował	7	Part
Do konkursu stanęło piętnastu traktorzystów .	stanęło	2	Fin
Ojciec chciał przepić pieniądze ze skarbonki syna .	przepić	2	Inf
Burza toczyła się leniwie , zanim zapadła w zachodnią czeluść nieba .	zapadła	6	Part
- Tym bardziej nie zechcą wypuścić .	wypuścić	5	Inf
Który naród w Europie najbardziej kocha telefony komórkowe ?	kocha	5	Fin
Proszę bardzo odczytać komunikat .	odczytać	2	Inf
W Berchtesgaden specjalnością jest tor saneczkowy , na którym osiąga się niebywałe prędkości .	osiąga	9	Fin
Po bombardowaniach wojsko przeczesuje dom po domu , starając się odnaleźć porwanego w niedzielę swego kolegę , Gilada Shalita .	odnaleźć	10	Inf
Wszystkie składniki razem połączyć .	połączyć	3	Inf
Poprzewracawszy się z boku na bok , towarzysz Lecoq zapalił papierosa .	Poprzewracawszy	0	Conv
Zresztą nawet bez Twego wyznania dalo się to odczuć .	dalo	5	Part
Mijała minuta za minutą , czas wlókł się w nieskończoność , a nie pojawiał się nikt .	pojawiał	13	Part
- I poszły , duszając rupkami .	duszając	4	Conv
Wymknął się za kotarę z dzbankiem po wodę .	Wymknął	0	Fin
Saperzy wydobyli we wtorek sześć artyleryjskich pocisków burzących z czasów II wojny światowej , odkrytych na terenie budowy na krakowskim Prądniku Czerwonym .	wydobyli	1	Part
Malwina spojrzała na niego z odrazą , Kulesza się zaczerwienił , ale Ewa , o dziwo , parsknęła śmiechem .	parsknęła	17	Part
W jej twarzy , mokrej od łez rozmazanych i czerwonej , tężały w osłupieniu szkliste , bladoniebieskie oczy .	tężały	11	Part
- To nie może wpływać na osoby zainteresowane .	wpływać	4	Inf
Ważył w dłoniach mały , srebrny aparacik .	Ważył	0	Part
Anatom Worobjew i biochemik Zbarski mieli ten zamysł wcielić w życie .	wcielić	8	Inf
Odbyło się taksowanie .	Odbyło	0	Fin
Powiedzieli mi , że ojciec popełnił samobójstwo .	Powiedzieli	0	Fin
Ja klękam , uklęknijcie ze mną . . .	uklęknijcie	3	Fin
Później strzałami w powietrze sterroryzował kasjerkę i zmusił ją do wydania pieniędzy .	zmusił	7	Part
W zeszłym roku w Cieszynie zawiązał się CKH i występował w naszej II lidze .	zawiązał	5	Fin
Straciła w powstaniu dwóch synów i męża .	Straciła	0	Fin
Podczas niemieckiej okupacji spotykali śmy się , należąc do podziemnej literackiej Warszawy .	należąc	7	Conv
Detektyw precyzyjnym sztychem przeszył jego prawe ramię .	przeszył	3	Part
Mam się gnieść wśród tylu osób ?	gnieść	2	Inf
Dodać majonez , przyprawić do smaku i dokładnie wymieszać .	wymieszać	8	Inf
Wydawało się , że fiskus nie będzie dłużej gnębił Waldemara Gronowskiego , legnickiego piekarza , który przez ponad 10 lat rozdawał pieczywo najuboższym .	gnębił	8	Part
Brzęcząc pustymi kuflami , weszła do środka .	Brzęcząc	0	Conv
Za każdy samochód zabierali się od razu mechanicy , zmieniali koła , usuwali uszkodzenia powstałe w czasie forsownego treningu , wymieniali zdarte nakładki hamulcowe , regulowali silniki .	zmieniali	9	Part
Niewytłumaczalna zbrodnia wstrząsnęła Polską .	wstrząsnęła	2	Part
Byli zbyt zmęczeni , aby roztrząsać przestrogę pana Bazylego .	roztrząsać	5	Inf
Mam się gnieść wśród tylu osób ?	gnieść	2	Inf
Ogarnięci paniką mieszkańcy porzucili swe mieszkania wybiegając na ulicę .	wybiegając	6	Conv
Ani on , ani zastępca Grzegorz Paluch nie chcieli jednak wypowiadać się o całej sprawie na łamach prasy .	wypowiadać	10	Inf
Zerwałem suchą trawkę i zacząłem ją powoli żuć .	żuć	7	Inf
Poznali się na weselu brata Edyty .	Poznali	0	Part
– weźmiesz wódkę i przyjdziesz ?	przyjdziesz	4	Fin
Właśnie wyskoczyła .	wyskoczyła	1	Fin
Po rzucie rożnym obrońcy Vardaru zbyt wolno wychodzili spod swojej bramki , podanie z linii pola karnego dotarło do Kucharskiego , a ten strzelił , stojąc tyłem do bramki .	stojąc	25	Conv
W przeciwnym wypadku należy je rozrzedzić wodą .	rozrzedzić	5	Inf
R . pomagał ukryć zwłoki .	pomagał	2	Part
Skazał go na wiele niepotrzebnych cierpień .	Skazał	0	Fin
Bawić się !	Bawić	0	Inf
Chodzi o to , żeby demonstracje odbywały się w spokoju , żeby w minimalnym stopniu zakłócały życie innych ludzi i żeby nie było polską normą bicie policjantów , okupowanie budynków , wyrywanie znaków drogowych czy niszczenie samochodów .	zakłócały	15	Part
Można wpisać kilka losów w jedno życie albo rozbić jedno życie w parę fabuł .	wpisać	1	Inf
Motyl , który drzemie przysiadłszy na dzwonie .	przysiadłszy	4	Conv
Wolała puszczać w kinach filmy kung-fu licząc , że dzięki temu ludzie przestaną myśleć o polityce .	puszczać	1	Inf
I nie tracić czujności , bo wtedy , kiedy wierzysz , że szczęście jest blisko , tak jak teraz , pojawia się archanioł z mieczem .	tracić	2	Inf
Znakomicie lokalizuje miejsca , w których kryją się szkodniki .	lokalizuje	1	Fin
Ponownie musiał użyć ręcznika .	użyć	2	Inf
Uroiła sobie , że lekarze chcą ją zabić .	Uroiła	0	Part
Na poszczególnych lodowcach warunki lokalne modyfikują tę zależność .	modyfikują	5	Fin
Siedzieli śmy w pokoju Maćka , oglądając jakiś film .	oglądając	6	Conv
Drugą ręką podsuwała kierowcom listę do podpisu .	podsuwała	2	Part
Z kolei postanowił zamieszkać we Lwowie .	zamieszkać	3	Inf
– rozwiązuje krzyżówki . .	rozwiązuje	1	Fin
- Oto w ubóstwie idę głosić Twoją chwałę .	głosić	5	Inf
Gdzieś tam w toalecie cicho zaskrzypiały drzwi , a na dużej sali czyjeś kroki szybko zdążały w tę stronę .	zdążały	15	Fin
Mężczyznę uwolnił dopiero inny pracownik , który zszedł do piwnicy , w której znajdują się pomieszczenia magazynowe .	zszedł	7	Part
Zawalili śniegiem całą górę nierówno i musiało strzelić .	Zawalili	0	Part
Nigdy nie przypuszczał , że jest aż do tego stopnia nędzny i słaby .	przypuszczał	2	Part
Bawiąc się w salonie z Jurkiem Łobzowskim , zaczepił em kiedyś rękawicą bokserską o lep na muchy .	Bawiąc	0	Conv
Nie trzeba jednak od razu spiętrzać Wisły , żeby wytwarzać energię elektryczną .	spiętrzać	5	Inf
Biją z całego frontu przed nami .	Biją	0	Fin
Wysyłamy panu gratis lodowy dom . "	Wysyłamy	0	Fin
tak się kroi go i tak się macza w tym sosie .	kroi	2	Fin
Marta opuściła mury Kliniki przedwcześnie , na własną prośbę .	opuściła	1	Part
Chłopcy wahali się .	wahali	1	Fin
Po co mu o tym przypominać ?	przypominać	5	Inf
" Jestem inny , ale potrafię więcej , niż mogło by się wydawać .	wydawać	12	Inf
Żeby skutecznie leczyć żywych , trzeba się uczyć na martwych .	leczyć	2	Inf
Gagosian nadal milczał , siedząc za biurkiem na swój sztywny sposób .	siedząc	4	Conv
Przyznaje , że w jej życiu skończyła się pewna epoka .	Przyznaje	0	Fin
Mścić się nie będę . . .	Mścić	0	Inf
Rezultat wydaje się z góry przesądzony , ale każdy z autorów chciał by dorzucić własne argumenty .	dorzucić	13	Inf
Niedźwiedź broniąc się przed napastnikiem uciekł na drzewo .	broniąc	1	Conv
Do 1995 roku francuscy przedsiębiorcy mogli legalnie dotować partie polityczne .	dotować	7	Inf
Pseudokibicom ze Stalowej Woli upiekło się , choć nieźle w sobotę nabroili .	nabroili	11	Part
– ja sobie to wyobraziła m inaczej .	wyobraziła	4	Fin
Tak bardzo pani schudła , że poznać trudno .	schudła	3	Part
Z ciał potopionych stryjów wylęgły się tysiące myszy i wyruszyły wszystkie do Kruszwicy , prosto na dwór zbrodniarza .	wylęgły	4	Part
Przeziębicie się !	Przeziębicie	0	Fin
Ericsson kończy produkcję telefonów komórkowych , która przynosiła szwedzkiej spółce ogromne straty .	przynosiła	7	Part
Myślał już o czekającym go etapie .	Myślał	0	Part
Hempel umarł prawdopodobnie dość szybko , to był człowiek chory , słabowity i prawdopodobnie nie wytrzymał .	umarł	1	Part
Jeśli sumienie na to wam zezwala .	zezwala	5	Fin
Zajęcia teatralne i plastyczne , konkursy , zabawy , filmy i wycieczki przyciągnęły nowych uczestników .	przyciągnęły	12	Part
Wywiozą nas do Polski !	Wywiozą	0	Fin
Niedługo w sprawie umocujemy dodatkowego prokuratora , aby przyspieszyć prace .	przyspieszyć	8	Inf
Żegnamy się nowo poznaną piosenką i okolicznościowym hasłem .	Żegnamy	0	Fin
Nauczyciel szybko uporał się z zakupami i , nie powracając już do poprzedniego tematu , z widoczną ulgą pożegnał chałupniczkę .	powracając	9	Conv
Teraz to wszystko staje się naprawdę , doczekał się Stefan Chmura Piaskowej Góry .	doczekał	7	Part
Musiały jej powiedzieć , teraz .	Musiały	0	Fin
Policjant zaświecił lizakiem .	zaświecił	1	Fin
- Przysięgam .	Przysięgam	1	Fin
Teraz już nie było wątpliwości i ręce zaczęły mi drżeć .	drżeć	9	Inf
Potem szli na romantyczny spacer , przytulali się i całowali .	całowali	9	Part
W jej twarzy , mokrej od łez rozmazanych i czerwonej , tężały w osłupieniu szkliste , bladoniebieskie oczy .	tężały	11	Fin
Mądrzej było by ominąć go szerokim łukiem .	ominąć	3	Inf
Grenlandia nie zniknie .	zniknie	2	Fin
Wańkowicze wrośli już w tutejszy teren i próbowali się utrzymać .	utrzymać	9	Inf
Piranię wyłowiono też w wodach Brdy .	wyłowiono	1	Fin
Patrzyła biernie , nie widząc niczego , na mijające za oknem podmiejskie pejzaże .	widząc	4	Conv
Postawisz mi pizzę ?	Postawisz	0	Fin
- Powinno być łatwiej , bo Husajna nie otaczają fanatycy .	Powinno	1	Fin
Sugerowała , że przed egzaminem można było kupić testy .	Sugerowała	0	Part
Gdyby tylko do tego sprowadziły się zmiany , to byłyby one niewielkie .	sprowadziły	4	Part
Wydaje mi się , że na tym odcinku Krupówek wykonano kanalizację zbyt wąskimi rurami .	Wydaje	0	Fin
Należało spróbować nawiązać łączność .	nawiązać	2	Inf
Wzorem większości producentów przeczytał wyłącznie krótkie streszczenie zawarte na pierwszej stronie , ale po jego minie można było wyczytać , że sama koncepcja go urzekła .	wyczytać	18	Inf
Zobaczy pan .	Zobaczy	0	Fin
Komendantowi OSP z Wąsosza wszyscy mówili , że ma wśród swoich ludzi podpalaczy , ale nie wierzył .	mówili	5	Part
Według stołecznych policjantów , udało mu się zgromadzić wokół siebie młodych przestępców z Pragi .	zgromadzić	7	Inf
W czasie pobytu u sióstr w klasztorze Krystyna korespondowała z ojcem , niecierpliwie wyczekując jego listów .	wyczekując	13	Conv
Tłumaczę mu to , ale nie może pojąć , o co chodzi .	pojąć	7	Inf
- A więc poznał mnie w tych łachmanach , pomimo zarostu na gębie .	poznał	3	Fin
Głosić takie wywrotowe poglądy przed takim audytorium !	Głosić	0	Inf
W pewnym momencie neoprezbiter klęka twarzą do wiernych , wyciąga ku nim ręce i prosi o modlitwę .	wyciąga	9	Fin
Do programu zgłosiły się cztery powiaty .	zgłosiły	2	Fin
Już drugi dzień próbują pocieszyć Ewę .	pocieszyć	4	Inf
Wypił go i otarł usta ręką .	Wypił	0	Part
Grodzicki nie chciał się wyrzec nadziei , że odzyska syna .	wyrzec	4	Inf
Oczywiście do zerwania zmówin dochodziło .	dochodziło	4	Part
Przedtem włóczyli się po mieście , topniał śnieg , szumiało w rynnach , czuć było powiewy ciepła i zgnilizny , nad dachami tłukły się kłębiaste chmury .	topniał	6	Part
Rzeczywiście można szlagier znienawidzić .	znienawidzić	3	Inf
- Też musiał em się uśmiechnąć .	uśmiechnąć	5	Inf
Stworzyła polski oddział EquiLibre , organizowała konwoje z pomocą dla byłej Jugosławii , Kazachstanu , Czeczenii .	organizowała	5	Part
Dwa samochody zderzyły się dachami .	zderzyły	2	Part
Pluj i jedz , wymagała .	wymagała	4	Part
- Pocałował em go .	Pocałował	1	Fin
Może mają zamiar mnie rozwalić .	rozwalić	4	Inf
Gdy goście opuścili jego dom i pozostał jedynie 63-letni emeryt , doszło między nimi do sprzeczki .	opuścili	2	Part
Ojciec był zapalonym myśliwym i często wybierał się na polowania , zasilając w ten sposób naszą spiżarnię .	zasilając	11	Conv
- I utopić .	utopić	2	Inf
Franka , czterdziestoletniego chłopa , te rzeczy nie obchodzą wcale .	obchodzą	8	Fin
Szef mówił , że Niemcy zebrali tam co najlepsze swoje dywizje , okrutnie umocnili sia , obwarowali i przygotowali do długiej obrony .	umocnili	13	Part
Przed snem pornole oglądać , laski kręcić .	kręcić	6	Inf
Podczas obchodu można było się przekonać , że nastąpiły gruntowne zmiany w pomieszczeniach CSiK .	przekonać	5	Inf
Wyrównują one nierówności , jednocześnie przyklejając płytki .	przyklejając	5	Conv
Protokół i listę mówców prowadzić będą pani posłanka Zdzisława Kobylińska oraz pan poseł Andrzej Zapałowski .	prowadzić	4	Inf
Może warto odkryć Amerykę .	odkryć	2	Inf
Jeśli dręczą cię złe myśli , spróbuj się odprężyć .	odprężyć	8	Inf
Widziałem , jak wielka epidemia uderzyła w Hongkong .	uderzyła	5	Part
Było ciemno , płonęły znicze .	płonęły	3	Part
Nieruchomo stojąc w powietrzu nad kwiatami lecimy .	stojąc	1	Conv
Pakowali się dalej , nie reagując .	reagując	5	Conv
Witały ich entuzjastyczne oklaski .	Witały	0	Part
Ani my ciebie nie pobudzamy , ani ty się nie dzielisz .	pobudzamy	4	Fin
Zaczęło się od tego , że kupili śmy koledze na urodziny tarczę i sami zaczęli śmy grać .	kupili	6	Fin
Kiwek , spluwając w palce , uważnie odliczał złotówki .	odliczał	7	Part
Na huśtawce huśta się dziecko , huśtawka skrzypi .	skrzypi	7	Fin
Kuśtykając ruszyli wolno pod górę , w stronę prześwitującego między drzewami kościoła .	Kuśtykając	0	Conv
JAK OBSERWOWAĆ ?	OBSERWOWAĆ	1	Inf
Pogańskie zwyczaje zapalania światełek przerodziły się we wspaniałe festyny światła w szaleńcze przedświąteczne dni .	przerodziły	4	Part
- Jajo przywiózł do nas osobiście dyrektor płockiego zoo .	przywiózł	2	Part
Zaczerwieniła się , wzgardliwie odymając usta .	odymając	4	Conv
- Nasi koledzy powinni się przespać i rano zastanowić . . .	przespać	5	Inf
- Ale chyba nie uchylił się od pojedynku ?	uchylił	4	Fin
Trzeba było lżej się ubrać .	ubrać	4	Inf
Wszystkiego doszukać się w sobie .	doszukać	1	Inf
Trzeba zwolnić ! "	zwolnić	1	Inf
Gagosian nadal milczał , siedząc za biurkiem na swój sztywny sposób .	siedząc	4	Conv
Zdaje się , że wpatrywała się we mnie od dłuższego czasu .	Zdaje	0	Fin
Zarządca komisaryczny przestał pełnić ją dopiero po ostatnich wyborach samorządowych .	pełnić	3	Inf
Wtacza się pociąg .	Wtacza	0	Fin
Wszedł em w rów , zapadając się w pas , i wydostał em z bagażnika szmaty .	zapadając	5	Conv
Wysiadłem nie zastanawiając się .	zastanawiając	2	Conv
Duże kontrowersje wzbudził zapis wywalczony przez Związek Nauczycielstwa Polskiego .	wzbudził	2	Part
Nie znosił em tych białych zup .	znosił	1	Fin
W Zborowie powstał obiekt o powierzchni użytkowej 3364 metrów kwadratowych , w którym zamieszka 50 osób .	powstał	2	Part
Posłuchajcie , prześmiewa się z naszej drogi , chichocze .	Posłuchajcie	0	Fin
Bronił eksmitowanych na bruk , naprawiając błędy przyjętej przez koalicję SLD­PSL ustawy , grzmiał na globalistów i świeżych krajowych , drapieżnych kapitalistów .	naprawiając	5	Conv
– bo wtedy ty będziesz miała okazję już tego swojego pomijając . .	pomijając	10	Conv
Z oficjalnym żądaniem wobec MKOl , złożonym na piśmie , wystąpił Narodowy Komitet Olimpijski KRLD , domagając się od naczelnej władzy sportowej rewizji listy triumfatorów olimpijskich .	domagając	16	Conv
Kiwek , spluwając w palce , uważnie odliczał złotówki .	spluwając	2	Conv
Tymczasem do sieni wsadził głowę Kropa i dzwonił natarczywie .	wsadził	3	Part
Zdjąć te cholerne obrazki po właścicielu .	Zdjąć	0	Inf
Kukufat szybko opanował zamieszanie , nawołując zgromadzonych do zachowania spokoju .	nawołując	5	Conv
Na cóż pogłębiać straszliwy kryzys ?	pogłębiać	2	Inf
Nie mogą one zająć się w sposób szczególny dziećmi autystycznymi .	zająć	3	Inf
W ogrodzie tego domu wznosiły się kiedyś pawilony obserwacyjne .	wznosiły	4	Fin
- Wierzyła m , że żyjesz . . .	Wierzyła	1	Fin
Starostwo katowickie zwraca się do Giesche SA , by bezdomnych pozostawić w spokoju .	pozostawić	10	Inf
Krystyna Kofta ogłosiła , że przyjmuje na siebie misję walki o równouprawnienie Bożen z Krystynami i za dwa lata zaprosiła panie do Trójmiasta , by równość tę udowodnić .	przyjmuje	5	Fin
Nie ma lekarza , który wszystkim dogodzi .	dogodzi	6	Fin
My też nie możemy narzekać .	narzekać	4	Inf
Już dochodząc do ulicy Krupskiej , spotkaliśmy przy jakimś domku babcię , która dziarskimi ruchami próbowała miotłą zatrzymać potok wypełzającego na ganek błota .	dochodząc	1	Conv
Prokuratorowi oraz sędziom mówił , iż pojechał na Wschód , aby holować do Polski uszkodzony za Bugiem samochód .	holować	11	Inf
Ustawiwszy ją wygodnie człowieczek również odstąpił od grobu .	Ustawiwszy	0	Conv
Jeśli radni wyrażą na nią zgodę , to nowe ceny zaczną obowiązywać po dwóch tygodniach od opublikowania uchwały Rady w dzienniku urzędowym wojewody śląskiego .	wyrażą	2	Fin
Nie wystarczy mieć rację , trzeba jeszcze umieć do niej przekonać .	umieć	7	Inf
Warto również zaznaczyć ich wysoki poziom artystyczny .	zaznaczyć	2	Inf
I nagle zrywa się , zachłystując radosnym gwarem .	zachłystując	5	Conv
Ludzie odeszli i zwrócili się w stronę Wiktora .	odeszli	1	Part
Karierę zakończył w 1998 roku .	zakończył	1	Part
Inżynier Arthur Kühne westchnął , ale uśmiech nie schodził z jego twarzy .	schodził	8	Fin
Dzieci się uczą na pamięć długości rzek , głębokości jezior . . .	uczą	2	Fin
Jak czuła się Krystyna , schodząc tu co rano na śniadanie ?	schodząc	5	Conv
Więc można go zaszantażować .	zaszantażować	3	Inf
Artyści z trzech akademii sztuk pięknych oglądali wczoraj budynki przy ulicy Zamkowej .	oglądali	6	Part
Warszawski Indeks Giełdowy zyskał 5 procent , a WIG20 , indeks największych spółek na parkiecie , wzrósł o 6,1 procent .	zyskał	3	Part
Na kartce należy wypisać plusy i minusy ?	wypisać	3	Inf
Mogę rzucić pracę i wyjechać do Włoch .	wyjechać	4	Inf
Nakładamy rękawice ochronne , zapinamy swetry i wychodzimy na pokład .	zapinamy	4	Fin
Na dużym talerzu uformować kopczyk z kuskusu i posypać go ozdobnie cynamonem .	posypać	8	Inf
Ruch w tym miejscu odbywał się wahadłowo .	odbywał	4	Part
Większa liczba emerytów oznacza przecież , że ludzie aktywni zawodowo będą musieli wydajniej pracować , wzrośnie również obciążenie służby zdrowia i służb socjalnych .	pracować	13	Inf
Przed rozpoczęciem zdjęć przez dwa tygodnie spotykali śmy się na próbach .	spotykali	6	Fin
Obudzimy Anamarię o dwunastej .	Obudzimy	0	Fin
Przyklękli pobożnie i weszli na stopnie ołtarza .	Przyklękli	0	Part
Trudno mu nawet wytłumaczyć , skąd się biorą .	wytłumaczyć	3	Inf
Do samolotu wolno zabrać bagaż podręczny o wadze 5 kg .	zabrać	3	Inf
Usiadła na fotelu , zakładając nogę na nogę , miała spódniczkę przed kolana .	zakładając	4	Conv
Najpierw pan Klecki poszedł sprawdzić , czy wódka jest zimna .	poszedł	3	Fin
- Zbiórkę poprzedziła akcja informacyjna , uczniowie wiedzą , na jaki dobry cel popłyną pieniądze .	poprzedziła	2	Part
Odkręcił korek , oblał się i podpalił .	oblał	3	Part
Kiwek , spluwając w palce , uważnie odliczał złotówki .	spluwając	2	Conv
Tylko częściowo można to wytłumaczyć względami historycznymi .	wytłumaczyć	4	Inf
Ksiądz Korniłowicz odmawiał brewiarz , chodząc tutaj po ścieżkach .	chodząc	5	Conv
Teraz kmieci zamieniono w niewolników .	zamieniono	2	Fin
Stanowi klasę sam dla siebie .	Stanowi	0	Fin
Zatopieni w pełnym kontakcie , przestali śmy zauważać resztę świata .	zauważać	7	Inf
Wybrali stertę gnojownika w zagrodzie ofiary .	Wybrali	0	Part
– ależ nie przesadzaj . .	przesadzaj	3	Fin
Sektor dla publiczności może pomieścić 300 kibiców .	pomieścić	4	Inf
Mężczyzna śmiał się głośno pokazując górną lewą złotą trójkę .	pokazując	4	Conv
A ten głupi Rzymianin powiedział , że go tam odeśle . . .	odeśle	9	Fin
Obecnie mieścić się one będą w Zweibruecken i w Wormacji .	mieścić	1	Inf
Weszli do lodowatej rzeki , by ratować zwierzaka .	Weszli	0	Fin
Kaneyasu kiwał głową , akceptując pomysł Kiry .	akceptując	4	Conv
Po paru dniach znał już wszystko i wszystkich i spędzał na górnych piętrach każdą wolną chwilę , wychodząc tylko w porze posiłków i oczywiście snu .	wychodząc	17	Conv
Do Gdyni dotarła wczoraj oczekiwana od kilku dni amerykańska koszykarka Edna Campbell .	dotarła	2	Fin
Na koniec owego wspaniałego dnia zaprosili go , by odwiedził ich w domu .	zaprosili	5	Part
Czasem krzyżowały się statki .	krzyżowały	1	Fin
Sławomir często zastanawia się nad nazwiskami .	zastanawia	2	Fin
Zawsze powtarzał , że od dziecka chciał ją poznać .	poznać	8	Inf
Dwie młode istoty patrzyły sobie w oczy i nagle zaczęły się uśmiechać ku sobie radośnie .	uśmiechać	11	Inf
Posługując się nim z szermierczą precyzją i taneczną lekkością , można grać na barwnych strunach duszy .	Posługując	0	Conv
- Musisz się chyba strasznie nudzić .	nudzić	5	Inf
– Ile pan zarabia ?	zarabia	3	Fin
Nie składają donosów do prokuratury , nie przejmują się całodobowym uśmiercaniem poczętych ?	składają	1	Fin
Reprezentujący konsorcjum Bank Przemysłowo - Handlowy poinformował o tym ministra gospodarki oraz skarbu państwa .	poinformował	6	Part
Trochę mnie zatkało i zastanowiło , czy on czasami nie jest aktualny obecnie ?	zatkało	2	Part
Obdarował pan ojciec klasztor , obdarował !	Obdarował	0	Part
Zobaczył mnie i krzyknął .	Zobaczył	0	Part
Bronił eksmitowanych na bruk , naprawiając błędy przyjętej przez koalicję SLD­PSL ustawy , grzmiał na globalistów i świeżych krajowych , drapieżnych kapitalistów .	Bronił	0	Part
Wózek zwolnił biegu i przystanął .	przystanął	4	Part
Niektórzy z idiotów tylko onanizując się zaspokajają swoje potrzeby seksualne .	onanizując	4	Conv
Począł myśleć gorączkowo .	Począł	0	Part
Ale ambicja kazała mu natychmiast odrzucać obrzydzenie i opory .	odrzucać	5	Inf
Fin zrobił ruch , jakby chciał wejść do środka , ale tylko szerzej otworzył drzwi .	wejść	6	Inf
Na razie gromadzi zeznania poszkodowanych .	gromadzi	2	Fin
Pod jej nosem błyszczał pot , musiała biec , widocznie firma pilnująca mieszkania nie zawiadomiła jej o wyłączeniu alarmu .	zawiadomiła	14	Part
Według KAI zaskarżenie ustawy do sądu zapowiedziała już organizacja American Civil Liberties Union .	zapowiedziała	6	Fin
Nie trzeba jednak od razu spiętrzać Wisły , żeby wytwarzać energię elektryczną .	wytwarzać	9	Inf
Nakazał też wypłatę wynagrodzenia , które by otrzymywały , gdyby świadczyły pracę w poradni .	świadczyły	10	Part
Wykorzystując przerwę w popołudniowych grach , Agassi i Graf zrobili sobie małą sesję treningową .	Wykorzystując	0	Conv
Ten musiał zbiec ze schodów , gdzie też coś ciągnął .	ciągnął	9	Fin
Dlaczego ugrupowanie , które będzie rozliczane przez wyborców z efektów rządzenia , ma sobie utrudniać pracę ?	utrudniać	14	Inf
- Nawet nie próbowała ukrywać , że tylko to jedno chodzi jej po głowie .	ukrywać	4	Inf
Wezwał mnichów i kapłanów do współpracy .	Wezwał	0	Fin
Podciągnęła ku brodzie także drugie kolano .	Podciągnęła	0	Fin
Nie odkładając pocisku , sięgnąłem do kabury .	odkładając	1	Conv
Każdemu kazał wprzódy próby odbywać i różnych sztuk dokazywać w swojej obecności .	dokazywać	8	Inf
Ale później kazali mu odejść .	odejść	4	Inf
Ich klientów wiąże z nimi przecież głównie zaufanie .	wiąże	2	Fin
Musi na niego skoczyć .	skoczyć	3	Inf
Uniwersytety przyjęły w ostatnim czasie ogromną liczbę studentów .	przyjęły	1	Part
Spłoszyły się nasze oczy .	Spłoszyły	0	Fin
Co mnie jeszcze śmieszyło ?	śmieszyło	3	Part
Dlaczego nie potrafię tego rozegrać ?	rozegrać	4	Inf
Starannie wymieszać .	wymieszać	1	Inf
Zamierzał ją zawieść do inseminatora .	zawieść	2	Inf
Uprawnienia selekcjonerskie dają prawo do odstrzału samców zwierzyny płowej .	dają	2	Fin
46-letni Marek Ch . doznał jedynie złamania prawej nogi .	doznał	4	Part
Nikogo nie zmuszamy .	zmuszamy	2	Fin
Podobnie zachowała się burżuazja niemiecka .	zachowała	1	Fin
Roosevelt po dwóch kadencjach wybrał się polować do Afryki , ale już nie mógł żyć bez polityki .	polować	6	Inf
W pięć minut później przypomniał sobie , że należało wpierw wytrzeć gumką uwagi na marginesach .	wytrzeć	10	Inf
Drugi pod względem kapitalizacji giełdowej Wielkopolski Bank Kredytowy osiągnął bardzo dobrą miesięczną dynamikę zysków wynoszącą 81,4 proc .	osiągnął	8	Part
Miał prawo nie panować nad emocjami .	panować	3	Inf
Słuch po nim zaginął .	zaginął	3	Fin
Już w 15 . minucie Stal objęła prowadzenie po strzale Grecha .	objęła	6	Fin
Schmidt skinął na towarzysza .	skinął	1	Part
Podręczniki powinny uwzględniać zasadę równych praw kobiet i mężczyzn .	uwzględniać	2	Inf
Pięciu marynarzy niszczyciela poniosło śmierć a dwóch odniosło ciężkie rany .	odniosło	7	Fin
We wtorek ci sami uczestnicy licytacji zaproponowali 1.500 zł .	zaproponowali	6	Part
Można sądzić , że w innych gminach jest podobnie .	sądzić	1	Inf
Nieruchomo stojąc w powietrzu nad kwiatami lecimy .	stojąc	1	Conv
Handzia leżała na plecach , postękując lekko , Wiktor rżnął ją monotonnie i beznamiętnie .	postękując	5	Conv
Wcześniej trzeba jednak zaliczyć 100 godzin zajęć i zdać egzamin .	zaliczyć	3	Inf
Zdążył w ostatniej chwili .	Zdążył	0	Fin
Usiadł em na jednej z nich i zaczął em odczytywać gazetę świetlną .	odczytywać	9	Inf
W czasach uczelnianego wyścigu szczurów i masowego bezrobocia pełni często rolę bezpłatnej terapii .	pełni	8	Fin
Z radością witali również państwa Paleniów sąsiedzi , którzy na tę okazję upiekli specjalny tort .	witali	2	Part
Rydzyki marynuje się tak .	marynuje	1	Fin
Zamknął em tylko oczy , aby lepiej czuć dotyk i słyszeć własne myśli .	czuć	7	Inf
Rozlał , podniósł i zaczął sączyć , świdrując oczami .	Rozlał	0	Part
Jeśli odczuwasz zbyt silną potrzebę izolacji , samotności , nie pozwól na zamknięcie się w swoich myślach , obawach i wyobrażeniach .	odczuwasz	1	Fin
Przylgnął do niej z całych sił .	Przylgnął	0	Part
Dlaczego mrozimy mięso ?	mrozimy	1	Fin
Bo chcą sobie zrekompensować samotne dzieciństwo .	zrekompensować	3	Inf
Otaczają one miasto od południa i zachodu .	Otaczają	0	Fin
Dzieciak zaczął drzeć się wniebogłosy .	drzeć	2	Inf
Nazwał to nawet stalinizmem XXI wieku .	Nazwał	0	Part
Mentalnie posłali energię miłości .	posłali	1	Part
Patriotyzm polski utracił aktywność .	utracił	2	Part
Każdemu kazał wprzódy próby odbywać i różnych sztuk dokazywać w swojej obecności .	dokazywać	8	Inf
Albo sami z ochotą wplątywali się w lokalne wojenki i rebelie .	wplątywali	4	Part
Grożąc skrzywdzeniem Anety , zabronili też powiadamiać policję .	powiadamiać	6	Inf
- Ruski przerzucił się na Turcję .	przerzucił	2	Part
Dom aż pachnie od farby i mydła .	pachnie	2	Fin
Patrzył na Petera ze smutkiem i zdumieniem zmieszanym z podziwem .	Patrzył	0	Fin
– No wolał by m coś nowego oczywiście .	wolał	2	Fin
Pomyliła się .	Pomyliła	0	Part
W tym roku uszkodzenia pogłębiła jeszcze zima .	pogłębiła	4	Part
Usłyszałem go , wsiadając do windy .	wsiadając	3	Conv
- Ucząc języka , jednocześnie budzimy w dzieciach intelekt , ciekawość świata .	Ucząc	1	Conv
Przez cały czas trwania ćwiczenia oddychaj , zwracając szczególną uwagę na wydech .	zwracając	7	Conv
Czy musiały śmy tu przyjechać z tą wstrętną Grochulską ?	przyjechać	4	Inf
- Sąd obawiał się , że nie zdąży przesłuchać pana ministra .	przesłuchać	8	Inf
Dotknięta wojennymi ciężarami buntowała się i odmawiała odrabiania pańszczyzny .	odmawiała	6	Fin
Ten były hiszpański duchowny nigdy nie krył wrogości do Jana Pawła II .	krył	6	Part
Iskierka zgasła , ustępując miejsca podejrzliwości .	ustępując	3	Conv
Potem , gdy próbowali je sprzedać w Szanghaju , zostali zauważeni przez policję .	próbowali	3	Fin
- Myślisz , że pomagam Millerowi ?	Myślisz	1	Fin
Ekolodzy zaopatrzyli młodszych kolegów w worki na śmieci i rękawiczki .	zaopatrzyli	1	Part
Zachowują się jak jacyś ekstremiści , niszcząc piękną tradycję .	niszcząc	6	Conv
Tata musiał pojechać do domu .	pojechać	2	Inf
– ja sunę .	sunę	2	Fin
Nie powiedzieli .	powiedzieli	1	Part
Wyborcy zdecydowali , że powinni zasiąść w Sejmie .	zdecydowali	1	Part
Batura poczerwieniał z upokorzenia i gniewu .	poczerwieniał	1	Part
- Żeby było trudniej zgadnąć .	zgadnąć	4	Inf
– Zwierzęta skinęły głowami .	skinęły	2	Part
Wicemistrzynie Polski z Mielca nie dały pograć w Krakowie Wiśle i opuściły ostatnie miejsce w tabeli właśnie na rzecz podopiecznych Lesława Kędryny .	opuściły	11	Part
Zatrzymały się w odległości kilkudziesięciu metrów od miejsca narodzin Chrystusa .	Zatrzymały	0	Part
Nie musi pan biec .	biec	3	Inf
Co odpowie na to dominikanin ?	odpowie	1	Fin
Między wami narasta konflikt , powietrze gęstnieje , znajomi pośpiesznie się żegnają .	gęstnieje	6	Fin
Felek jakiś niepewny siedzi na linach i przeciera oczy .	przeciera	7	Fin
Można zagrać bez niego , a potem go dokręcić .	dokręcić	8	Inf
Świadkowie twierdzą , że spod siedziby SdRP odjechało w ostatnich kilkunastu miesiącach kilka takich grup .	odjechało	7	Part
Stanął em na przybitych deskach , a Judasz podszedł do mnie , chwiejąc się na stromiźnie .	chwiejąc	12	Conv
Wieczorami spacerował wzdłuż kawiarni i zaglądał w okna pod firanki .	zaglądał	5	Part
- Zabraniam ci !	Zabraniam	1	Fin
Wybili szybę w drzwiach wejściowych sklepu betonowym krawężnikiem .	Wybili	0	Part
Po ofiarach tylko czasem zawyje wierny pies .	zawyje	4	Fin
Asystent już podawał chirurgowi fartuch .	podawał	2	Fin
Proboszcz uczepił się ostatniego słowa .	uczepił	1	Part
Zdarza się , że kompresja niszczy nerki .	niszczy	5	Fin
Ostatecznie mogł em przyjść z donosem wcześniej i nie wchodzić w to tak głęboko .	przyjść	3	Inf
Idę płakać nad moim losem .	płakać	1	Inf
Uczę się hebrajskiego .	Uczę	0	Fin
Takie przygody nie będą przecież powodować bólu .	powodować	5	Inf
Ale zdecydowanie nie pozwalam , abyś nazywał mnie głupią albo pozbawioną rozumu .	nazywał	6	Part
Rozlał , podniósł i zaczął sączyć , świdrując oczami .	świdrując	7	Conv
Ograniczenie szybkości obowiązuje tutaj od soboty z powodu rutynowych prac konserwatorskich .	obowiązuje	2	Fin
- Lubimy zaglądać do takich dużych centrów .	zaglądać	2	Inf
Odprawiła nawet TVN , która chciała podpisać umowę na wyłączność w informowaniu o seksaferze .	podpisać	6	Inf
Zasklepiamy się w pozycji skrzywdzonego , dotkniętego nieszczęściem .	Zasklepiamy	0	Fin
Wezwane pogotowie ratunkowe odwiozło go do szpitala .	odwiozło	3	Fin
Sąd potwierdził wszystkie priorytety , jakie przyjęli śmy .	przyjęli	6	Fin
Firma skontaktowała się ze mną , przedstawiając opinię rzeczoznawcy .	skontaktowała	1	Part
Nie mogę się napatrzeć .	napatrzeć	3	Inf
W poniedziałek dwaj gorzowianie podbili ją do 1.000 zł .	podbili	4	Fin
I rzeczywiście , taczając się , po chwili ruszyli przed siebie .	taczając	3	Conv
Nie uchroniono się od wypadków .	uchroniono	1	Fin
- Mógł ofiarować Kaliszowi swoje obrazy .	ofiarować	2	Inf
Ale Dzidzia mordowała mnie wczoraj o Olka . . .	mordowała	2	Fin
Nie mógł oderwać od niej wzroku ani myśli .	oderwać	2	Inf
Sól , z jakiej była uczyniona , rozpuściła się całkowicie . . .	rozpuściła	7	Fin
- Nie może atakować i obciążać nogi .	obciążać	5	Inf
Który z ministrów może bez pytania wtargnąć w nocy do prywatnych apartamentów prezydenta ?	wtargnąć	6	Inf
Ziuta uściskała go i ucałowała w oba policzki .	uściskała	1	Part
Postaramy się spełnić jej życzenie .	spełnić	2	Inf
Doświadczenie zawodowe zdobyła pracując w teatrze i telewizji w Polsce i na Ukrainie .	pracując	3	Conv
Nie wspomniał , że idzie o zatrudnienie w lokalu nocnym Turka .	wspomniał	1	Part
Czemu uderzyli ście pięścią w stół , rzucili ście taką ładną misę ?	rzucili	7	Fin
Zazwyczaj są to ich 6­9-letni synowie , których trzeba wyżywić .	wyżywić	9	Inf
Milczącemu urodziła się córka .	urodziła	1	Part
Załadował na wóz wynajętych gazeciarzy i rozwiózł po mieście , każąc rozdawać list przechodniom .	każąc	10	Conv
Udzielając poparcia świętej wojnie , mogli poprawić swoją nadszarpniętą reputację .	Udzielając	0	Conv
Posiada Pan jedynie dyplom magistra filozofii . . .	Posiada	0	Fin
Wtedy wlecze się taka choroba przez lata i nie można jej wyleczyć .	wyleczyć	11	Inf
Tymczasem moi wspólnicy mieli zgarniać forsę .	zgarniać	4	Inf
Zabrał głos Mussolini .	Zabrał	0	Fin
Chcemy też , by nasi gracze wzorowali się na najniebezpieczniejszej odmianie raptorsów - globoraptorach .	Chcemy	0	Fin
Ani mu się śniło opowiadać o słonecznej wiośnie .	śniło	3	Part
- Nie wierzył em , że Ance uda się oderwać pana od tropienia przestępców .	uda	7	Fin
Rozumiem , że można , a nawet trzeba piętnować wszelki ton agresji i pogardy w stosunku do innych wyznań .	piętnować	8	Inf
Dzisiaj telefon mnie wyprzedził , zaczął terkotać głośno .	terkotać	6	Inf
Czy powinnam powiadomić syna tego pana , że ona ich okrada ?	okrada	10	Fin
Wybierz sobie jakiś cel i podaruj pieniądze .	Wybierz	0	Fin
Jak on by głosował ?	głosował	3	Fin
Doznał poważnych obrażeń ciała i przebywa w szpitalu .	Doznał	0	Part
Mężczyzna dotykał ciała dziewczynki w miejscach intymnych .	dotykał	1	Fin
Już na schodach usłyszała dźwięki dobiegające z komnaty dziadka .	usłyszała	3	Part
Bar powoli zaczął się zapełniać .	zapełniać	4	Inf
Mag osunął się bezwładnie .	osunął	1	Fin
Tu można by przedstawić nielichą litanię .	przedstawić	3	Inf
Reputację intelektualisty potwierdził , cytując obficie Witolda Gombrowicza i Stanisława Jerzego Leca .	cytując	4	Conv
Blask gwiazdy uciekał od oka .	uciekał	2	Fin
Pożeracz Chmur przełknął ostatni kęs i oblizał palce .	przełknął	2	Part
Panie , pustynią odtąd władać będziesz . . .	władać	4	Inf
Kompan zawtórował mu , próbując wszystko w żart obrócić .	próbując	4	Conv
Poszłam zdawać na filozofię .	zdawać	1	Inf
Wypytywała rodaków o Warszawę , interesowała się przeżyciami Tomka w czasie wyprawy i nawet namawiała go usilnie , aby pozostał w Australii .	interesowała	5	Part
Lecz kontynuował polemikę .	kontynuował	1	Fin
Oficer wyszedł , rencistka odkręciła gaz .	odkręciła	4	Part
Kilka razy pociągnął nosem .	pociągnął	2	Fin
Wcześniej objął władzę w wyniku zamachu stanu .	objął	1	Part
Oznacza to , że zgadzają się one na taką praktykę .	zgadzają	4	Fin
Następnie wycofując się , wyciągamy tułów i nogi .	wycofując	1	Conv
Myślę , że nierzadko improwizuje .	improwizuje	4	Fin
Wiedźma odwróciła się ku niemu z mozołem , wkładając w ten drobny ruch wszystkie swoje siły .	odwróciła	1	Part
Opiekun dzieciaków sądził , że w górach jest już wiosna .	sądził	2	Part
Odczytał list głośno .	Odczytał	0	Fin
Ale dzięki temu można uratować komuś życie !	uratować	4	Inf
Nawet w tych nerwowych czasach spokojnie się z nim pracowało .	pracowało	9	Part
Mieszkający samotnie w starej drewnianej chałupie inwalida nie ukrywa , że jest rozczarowany .	ukrywa	8	Fin
Trafił do Tary , ale zgodnie z umową nadal miano przyjeżdżać po jego krew .	przyjeżdżać	10	Inf
W tej chwili Francuz westchnął ciężko i boleśnie .	westchnął	4	Fin
Wtedy Bóg złapie to całe towarzystwo łącznie ze mną i wrzuci w ogień piekielny , a będzie tam płacz i zgrzytanie zębów .	wrzuci	10	Fin
Poruszał rytmicznie kolanami , unosząc lekko siedzącą na nich kobietę .	unosząc	4	Conv
Postanowił em poczekać .	poczekać	2	Inf
Darek P . widząc , że jego zeznania nie przyniosły żadnego skutku , a Komor chodzi na wolności , sprzedaje majątek i dalej prowadzi swoje lewe interesy , zwrócił się z prośbą o pomoc do dziennikarzy .	widząc	3	Conv
Dla czternastolatków sześćdziesięcioletnich warto by natomiast zastosować większą czcionkę .	zastosować	6	Inf
Wszystko się kołysze , obie jednostki płyną .	płyną	6	Fin
Zakończyły się sukcesem .	Zakończyły	0	Part
Ale trzeba na niego zapracować , zwłaszcza przed stresującym dniem .	zapracować	4	Inf
Czy lekarz może leczyć pacjenta wbrew jego woli ?	leczyć	3	Inf
Nasze działania nie zagrażają nikomu .	zagrażają	3	Fin
Większość utrzyma pracę .	utrzyma	1	Fin
Musieli śmy go ściągnąć do komisariatu .	ściągnąć	3	Inf
A dlaczego miał pojechać ?	pojechać	3	Inf
Można się bezkarnie czaić po kątach .	czaić	3	Inf
Jej słowa wwiercają się w mózg , nie pozwalają zebrać myśli .	zebrać	9	Inf
A jak wycenić straty na zdrowiu ?	wycenić	2	Inf
Za Wankiewiczem ja sam głosował em .	głosował	4	Fin
Wiatr przynosił ostry alkoholowy zapach traw .	przynosił	1	Fin
Kongresy Międzynarodówki poruszały zawsze ważne problemy , istotne dla życia politycznego i społecznego danego okresu .	poruszały	2	Part
Cameron będzie obserwować , jak wolno objeżdża trotuar , oglądając inne dziewczyny .	oglądając	9	Conv
Pan Korzeniowski zerwał się z krzesła , podbiegł do szafy , wysunął dolną szufladę , chwilę grzebał w papierzyskach .	grzebał	16	Part
musztarda szybko wysycha .	wysycha	2	Fin
– Rzucili się na pana ?	Rzucili	1	Part
W czasie pobytu u sióstr w klasztorze Krystyna korespondowała z ojcem , niecierpliwie wyczekując jego listów .	wyczekując	13	Conv
Jak ja mogła m zauroczyć się facetem bez klasy ? !	zauroczyć	4	Inf
Tańczono zapamiętale , wykrzykując i piosenką dogryzając sobie wzajemnie .	wykrzykując	3	Conv
Unosiła się wokół nich anielska aura .	Unosiła	0	Part
Ukończyły wyścig razem , trzymając się za ręce .	Ukończyły	0	Part
Pierwsza dama Rosji przyleciała do Polski na zaproszenie Jolanty Kwaśniewskiej .	przyleciała	3	Part
Przytul się mocno I podnieś głowę Patrząc w ich oczy Moim spokojem .	Patrząc	6	Conv
Niewątpliwie znał się na tej pracy i lubił konie .	znał	1	Fin
Takie parlamentarne metody nie odpowiadają mi , rozumiecie ?	rozumiecie	7	Fin
Gdy we wspomnianych dwu pionach narożnikowych ktoś się kąpie , wówczas woda spływa w dół nawilgacając po drodze niżej położone mieszkania .	nawilgacając	15	Conv
– Jeden z nich zaczął napierać na mnie ciałem .	napierać	5	Inf
Sejm zaaprobował przekroczenie budżetowe , co przekreśliło sens dalszych działań Trybunału Stanu .	zaaprobował	1	Part
Dzisiaj robotnicy zaczną frezować nawierzchnię .	frezować	3	Inf
Resa pośpieszyła do Ab–Rama , czekającego niecierpliwie w swoim namiocie .	pośpieszyła	1	Part
Z niepokojem spoglądają oni na pochmurne niebo i termometr , śledząc przy tym pilnie prognozy meteorologiczne .	śledząc	10	Conv
Zranił go w głowę .	Zranił	0	Fin
Zasypiam , ssąc chrupką skórkę przy migoczącym w telewizji Człowieku z żelaza .	ssąc	2	Conv
Dwaj nieznani mężczyźni okradają restauratorów we Włochach , Opaczy , Pruszkowie .	okradają	3	Fin
Jak próbował eś sobie z nimi radzić ?	radzić	6	Inf
Ale takiej nikt nie złapie !	złapie	4	Fin
Wysoka liczba urodzeń hamuje także rozwój gospodarczy kraju , w którym znaczny procent mieszkańców żyje poniżej uznanego progu ubóstwa .	hamuje	3	Fin
Witam wszystkich klubowiczów ! ! !	Witam	0	Fin
Uczył się w Liceum Technik Plastycznych w Zakopanem prowadzonym przez Antoniego Kenara .	Uczył	0	Part
Mogę się tylko domyślać , że mechanicy zabiją barana , który od rana obgryza skraj plastikowego worka , i przyniosą mi moją część .	domyślać	3	Inf
Wyrzekliśmy się naszych zasad i małpujemy kraje , które pogrążyły się w nihilizmie moralnym !	pogrążyły	9	Part
Przeczytał dokładnie , po czym obejrzał się na tablicę .	Przeczytał	0	Part
Osiełek chce połknąć tajemniczą kartkę .	połknąć	2	Inf
Stali wśród namiotów , w których krzątali się nadwołżańscy Niemcy , zruszczeni po wiekach .	krzątali	6	Part
Szukając zysku , musiały ryzykować .	Szukając	0	Conv
Firma skontaktowała się ze mną , przedstawiając opinię rzeczoznawcy .	przedstawiając	6	Conv
Czy w Kielcach uczył się w szkole rabinackiej i czy naprawdę był rabinem , jak zapewniał Fangora i inne osoby w Ameryce ?	uczył	3	Part
Wyrównują one nierówności , jednocześnie przyklejając płytki .	Wyrównują	0	Fin
Zmieniła się również polityka sądu .	Zmieniła	0	Part
Lenda złożyła powoli papier .	złożyła	1	Fin
Ten list matki i fotografię wykradła m jej uciekając z tobą .	uciekając	8	Conv
Czy miał obowiązek aż tak mocno ryzykować ?	ryzykować	6	Inf
Trzeba ratować .	ratować	1	Inf
Niektóre zachodziły , żeby się odmłodzić .	odmłodzić	5	Inf
Celników wspomagały specjalnie szkolone psy oraz sprzęt techniczny .	wspomagały	1	Part
Nie zdołałeś do dna wyrwać tej maleńkiej drobiny , zachowanej w czeluści mego serca .	wyrwać	4	Inf
Muszę to wszystko z siebie wydalić .	wydalić	5	Inf
Protestują przeciwko zamierzonej budowie .	Protestują	0	Fin
Weźmiemy to pod uwagę , przygotowując zmiany .	przygotowując	5	Conv
Dyrektoriat ten funkcjonował zgodnie , dopóki istniała równowaga sił w rządzie .	funkcjonował	2	Part
Ludka potrząsnęła głową .	potrząsnęła	1	Fin
Przerażona dziewczyna pobiegła do ciotki , która mieszka za ścianą , i w sekrecie opowiedziała , co robił jej tata .	pobiegła	2	Part
Dojedli śniadanie , wyjęli papierosy , zapalili .	wyjęli	3	Part
Lufki wysunęły się z większości oczu , ustalając osobę chichotu .	ustalając	7	Conv
Dostał eś ostatnio piątkę z algebry ?	Dostał	0	Fin
- Kilka godzin spędziła m przed lustrem zastanawiając się , co włożyć .	zastanawiając	7	Conv
Ich przedstawiciele , służąc w Gwardii Szlacheckiej , dodawali splendoru Stolicy Piotrowej , a jednocześnie znajdowali tam niejednokrotnie środki dla wygodnego życia , ponieważ za swą służbę otrzymywali pensje .	służąc	3	Conv
Następnie zbiegł po jakichś schodach ; zbiegał długo .	zbiegł	1	Part
W Krakowie symbolizowały je deski .	symbolizowały	2	Part
W 90 % trzeba polegać tylko na sobie .	polegać	4	Inf
Komisja Europejska chce nam zabrać pieniądze , bo Sejm do tej pory nie przyjął trzech ustaw .	zabrać	4	Inf
Staruszka wyjęła z kredensu album oprawiony w zniszczoną ciemnowiśniową skórę .	wyjęła	1	Part
Odsłonili jednak tyły i kolejną bramkę zdobyli lechici .	Odsłonili	0	Part
Solenizantki złożyły życzenia sąsiadującym z nimi w kalendarzu Ernestom i Bożenom .	złożyły	1	Part
Dziś stąd wyruszamy , może jeszcze zdążę ucałować jego stygnącą rękę .	ucałować	7	Inf
Ciągnąc go za rękaw , zmusiła do obrócenia się wśród otaczającego ich korowodu .	Ciągnąc	0	Conv
Żywiła m tym Dominikę .	Żywiła	0	Fin
Cena wywoławcza czarnego watermana ze złotą stalówką wynosiła 300 zł .	wynosiła	7	Part
Zapowiedział pan , że niebawem młodzież nie będzie zdawać egzaminów na studia , że matura zastąpi dodatkowy dziś egzamin .	Zapowiedział	0	Part
Mam chcieć być lepsza od innych .	chcieć	1	Inf
Dżabie odbiło się walerianą .	odbiło	1	Part
Trzymała mnie kurczowo .	Trzymała	0	Fin
Polska powoli suszyła się po wielkiej powodzi , a uwaga Czytelników kierowała się na politykę .	suszyła	2	Part
Szafir umilkł .	umilkł	1	Fin
Kiedy wieczorem po raz kolejny przegryzał całą historię , oprócz żalu i rozczarowania odkrył w sobie także uczucie ulgi .	odkrył	13	Part
Jeden z uczestników rusza w las , licząc kroki .	licząc	7	Conv
W pierwszej kolumnie kroczą woje Chrobrego .	kroczą	3	Fin
Teodor skinął głową i stał dalej .	skinął	1	Fin
Z łatwością pokonują one rzeki i jeziora jadąc pod wodą .	jadąc	7	Conv
Cagliostro krzyknął z bólu .	krzyknął	1	Part
Bo nie potrafi usiąść normalnie na sedesie .	usiąść	3	Inf
Tusk też tak początkowo myślał lokalizując Muzeum Wojny na Westerplatte .	lokalizując	5	Conv
Papierową śmierć zafundowali śmy już kilku osobom .	zafundowali	2	Fin
– Jeden z nich zaczął napierać na mnie ciałem .	napierać	5	Inf
Będę więc dalej pracować , pojutrze lecę do Meksyku , ale w sobotę wracam .	pracować	3	Inf
Oczekując na swoją kolej , rozmawiają i oglądają filmy w świetlicy pod czujnym okiem opiekuna Rudolfa Dyrksa .	oglądają	7	Fin
Lech Kaczyński nie żałuje , że jego filmowa kariera się nie rozwinęła , a do swojego aktorskiego talentu podchodzi z rezerwą .	żałuje	3	Fin
Zaroiło się po ścierniskach i bruzdach .	Zaroiło	0	Fin
Podczas obchodu można było się przekonać , że nastąpiły gruntowne zmiany w pomieszczeniach CSiK .	nastąpiły	8	Part
Że nie wolno było wchodzić do pokoju kolegów .	wchodzić	4	Inf
- Czekać w korytarzu .	Czekać	1	Inf
Rzecznik Prokuratury Okręgowej w Łodzi Krzysztof Kopania , zasłaniając się dobrem postępowania , odmówił na tym etapie śledztwa odpowiedzi na pytanie , czy ksiądz przyznał się do stawianych mu zarzutów .	zasłaniając	8	Conv
Ale demokrata Al Gore obiecał emerytom dopłaty państwa do leków . . .	obiecał	4	Part
Przyglądam się ich nieszczęściu od lat .	Przyglądam	0	Fin
We własnym pokoju rzuciła się na łóżko i prędko zasnęła .	rzuciła	3	Fin
Do zebranych przemówił premier Fidel Castro .	przemówił	2	Fin
Milcząc , spuściła wzrok .	Milcząc	0	Conv
Podążał wytrwale , polną drogę mając za przewodnika .	mając	5	Conv
Działo się to podczas dochodzenia do nabrzeża w Ystad .	Działo	0	Part
Dante raczył zajmować się przede wszystkim potępionymi .	zajmować	2	Inf
Zaczęły spadać .	spadać	1	Inf
Pan hrabia nawet przez moment nie miał nas za szpiegów , inaczej nie udzielił by nam tak dogłębnych wyjaśnień .	udzielił	13	Fin
Po przyjeździe do Izraela trzeba się rozstać ze złudzeniem , że ktoś tu na nas czeka .	rozstać	6	Inf
Osoba przypadkowa zorientuje się , że powinna odejść .	odejść	7	Inf
Co chwila łapałem się za rękę , zakrywając zegarek .	zakrywając	7	Conv
W 1989 roku Humphrey zaczął pracować w rezydencji premierów Wielkiej Brytanii w charakterze niezłomnego pogromcy myszy i szczurów .	pracować	5	Inf
Chociaż wcale sie do tego nie przyznają . .	przyznają	6	Fin
Ustaliwszy , że powódka otrzymała odszkodowanie na podstawie rozporządzenia Rady Ministrów w sprawie melioracji wodnych , oddalił powództwo .	Ustaliwszy	0	Conv
Od którego tygodnia dołączyć teścia ?	dołączyć	3	Inf
Tam kierowca forda , wymijając volkswagena golfa , uderzył w niego .	wymijając	4	Conv
Urodę stołu znakomicie podniosą antyczne lichtarze ze świecami , kryształy i srebra .	podniosą	3	Fin
Po paru dniach znał już wszystko i wszystkich i spędzał na górnych piętrach każdą wolną chwilę , wychodząc tylko w porze posiłków i oczywiście snu .	znał	3	Part
Przez dwa ostatnie tygodnie policjanci zaczęli podejrzliwie obserwować Staszka i Dawida .	obserwować	7	Inf
Potem wypełniał ankietę i kładł się na kozetkę .	kładł	4	Part
Księgowe potwierdziły , że działały w porozumieniu z kilkoma członkami spółdzielni .	potwierdziły	1	Part
Przeczytał uważnie , przeczytawszy , zaczął od początku .	przeczytawszy	3	Conv
Czy zdążymy przed deszczem pochować pana Sierożę ?	pochować	4	Inf
Do dziś w sądownictwie pracują osoby , które rozpoczynały swoją karierę w latach stalinowskich .	rozpoczynały	8	Fin
Chodź do kuchni , zrobimy sobie coś dobrego , kupiłem to hiszpańskie wino , które lubisz , wypijemy po kieliszku .	lubisz	15	Fin
Niektóre z nich nie przyjmują już zgłoszeń .	przyjmują	4	Fin
Nie trzeba wielkiej przenikliwości , aby się domyślić , że Anglicy przeprowadzają rewizję .	domyślić	7	Inf
" Dąbrowska odnotowuje , że zarys którejś z nowel Kowalska w pośpiechu rzuciła na papier po francusku " .	odnotowuje	2	Fin
A my na te konto gruchniem sobie piwa .	gruchniem	5	Fin
Płetwonurkom nie udało się dopłynąć do wraku .	dopłynąć	4	Inf
Wanda Gąsior w to jednak powątpiewa .	powątpiewa	5	Fin
Obiecankami zakończyło się sylwestrowe połączenie z Wrocławiem .	zakończyło	1	Part
A ja z Armenami świetnie się po rosyjsku dogaduję .	dogaduję	8	Fin
Ćwiczyli wojacy z 25 krajów .	Ćwiczyli	0	Fin
I wojna światowa strąciła nam z głowy te cudeńka .	strąciła	3	Part
- Umiesz markować na kasie ?	markować	2	Inf
Ale wydaje mi się , że Lech , Czech i Rus musieli bardzo długo pędzić za jeleniem , dzikiem i niedźwiedziem .	pędzić	14	Inf
I o to się rozchodzi !	rozchodzi	4	Fin
Niewątpliwie najbardziej okazałym egzemplarzem dysponował Henry Fischer z Berlina .	dysponował	4	Part
może ktoś rozjaśnić moje wątpliwości ?	rozjaśnić	2	Inf
Stojąc , mógł się od biedy bronić .	Stojąc	0	Conv
Czy chcę ich oboje z Cezarem obrazić , zapytała .	obrazić	6	Inf
Dziewczyna podziękowała .	podziękowała	1	Part
Zaczerwieniła się , wzgardliwie odymając usta .	odymając	4	Conv
Batura przygryzł wargi .	przygryzł	1	Part
Przyjechali saperzy , zabrali granat i zdetonowali go w bezpiecznym miejscu .	zdetonowali	6	Part
- A chciał by ś mnie nieść ?	nieść	6	Inf
Ukrywający się od wielu lat serbski zbrodniarz wojenny gen . Ratko Mladić nie może już czuć się bezpieczny .	czuć	15	Inf
Nie odzywając się przez cały czas do siebie , dojechali śmy do Wisły .	odzywając	1	Conv
Wszystko razem urzekało .	urzekało	2	Fin
Za to , że wrócił bez pieniędzy , gość zapłaci życiem .	zapłaci	9	Fin
Sędziowie orzekli , że nie można ratować jednych , poświęcając życie innych ludzi .	ratować	6	Inf
Termin ten nie może przekraczać dwóch tygodni .	przekraczać	4	Inf
Splotła silne dłonie .	Splotła	0	Part
toż do roku żadnej nocy nie przespała m . .	przespała	6	Fin
Po zdjęciu serwetki i położeniu jej na kolanach na małym talerzyku spożyjemy przekąskę .	spożyjemy	11	Fin
Na razie trudno dociec , co było przyczyną wypadku .	dociec	3	Inf
Oceniając strajk , Gawin oświadczył , że ruch towarowy praktycznie się nie odbywał , a na Śląsku stanęło wiele pociągów pasażerskich .	Oceniając	0	Conv
Chodzę , chodzę .	chodzę	2	Fin
Mogą przeżerać dotacje .	Mogą	0	Fin
Jezus z fresku wyciągał do mnie rękę z małym woreczkiem .	wyciągał	3	Part
Teraz Jasienica będzie musiała usunąć część wodociągu , który bezprawnie postawiła na prywatnej ziemi Pałuchy .	usunąć	4	Inf
Zakończył się VIII Raciborski Rajd Rowerowy Środowisk Trzeźwościowych Dookoła Polski .	Zakończył	0	Part
Bo koledzy starsi o rok , dwa mogli stracić dziewictwo jeszcze w komunizmie .	stracić	8	Inf
Tymczasem w bufecie panna Tola czyściła koszyki do chleba .	czyściła	5	Fin
Gertruda nie miała pewnie licencji a zaczęła wykorzystywać komercyjnie .	wykorzystywać	7	Inf
Załamała się tradycja zbiorowych wystąpień i manifestacji .	Załamała	0	Part
– Sąsiedzi opowiedzieli coś ciekawego ?	opowiedzieli	2	Fin
Posolić , zalać oliwą .	Posolić	0	Inf
- Uznał sprawę za skończoną i , nie zawracając sobie więcej głowy dziewczynkami , pomaszerował przez boisko .	zawracając	8	Conv
Chciała m usiąść , ale nie starczyło mi sił .	usiąść	2	Inf
Kosiński wcisnął drugi hak linki holowniczej między swój błotnik i oponę , wsiadł do samochodu .	wcisnął	1	Part
Cieszę się , że wystąpili teraz .	wystąpili	4	Part
Trzech mężczyzn postanowiło wczoraj wzbogacić się tanim kosztem .	wzbogacić	4	Inf
- To rekin , a ty się boisz , że przy pierwszej okazji wytarmoszę go za płetwy .	wytarmoszę	13	Fin
Jej program układał radca handlowy ambasady RP w Rzymie .	układał	2	Part
Dzieci muszą doskonalić ważne społeczne i szkolne sprawności .	doskonalić	2	Inf
Pojechał za nim ojciec i brat .	Pojechał	0	Part
Nie podał Klossowi ręki , wskazał mu tylko krzesło .	wskazał	5	Part
Sześciokrotnie wygrywał zawody pucharu świata .	wygrywał	1	Part
Skrzypczak układał swoje poczynania .	układał	1	Fin
Łódź odnaleziono porzuconą i ogołoconą z silnika i kosztownego wyposażenia .	odnaleziono	1	Fin
W 2007 roku neurolodzy amerykańscy wyciągnęli je z muzeum i poddali badaniu rezonansem magnetycznym .	wyciągnęli	5	Part
Wcisnął pan Bogucki czapkę na głowę , dopiął kufaję i wypadł z pokoju .	Wcisnął	0	Part
Pobył em tu i wstydzę się odezwać .	odezwać	6	Inf
Gdzieś daleko leniwie poszczekiwał pies .	poszczekiwał	3	Fin
- Nawet oka nie zmrużyli śmy .	zmrużyli	4	Fin
Nie potrafił dojrzeć .	dojrzeć	2	Inf
Uciekali szukając bezpieczeństwa .	szukając	1	Conv
Wasielewski wyprowadził wóz z parkingu i włączył się do ruchu .	wyprowadził	1	Part
Pawłowi M . zarzuca się również , że działał z zamiarem spowodowania ciężkiego kalectwa rzucając nożem w głowę włoskiego piłkarza Dino Baggio .	rzucając	14	Conv
Potem Rosomak podał mu strzelbę , a stary ją przyjął , jak święty spadek , i oddał Bartnikowi .	podał	2	Part
Dziękuję , że mimo trudności odwiedza mnie Pan i komentuje moje teksty .	komentuje	9	Fin
Naczelnik ulicznych rzeźników wykrzywił twarz .	wykrzywił	3	Fin
Polscy producenci nie dają za wygraną , dotrzymując kroku modzie i zachodnim nowinkom .	dotrzymując	7	Conv
Będę pracować , żyć jak dawniej .	pracować	1	Inf
U młodej dziewczyny psychiatra z Modusa rozpoznał początki choroby psychicznej , dziewczyna myśli o samobójstwie .	rozpoznał	6	Fin
Wyjaśnia on w przystępny sposób tajniki stosowanych w programie konwencji .	Wyjaśnia	0	Fin
Z drugiej strony pisowcy chyba mnie polubili .	polubili	6	Part
Średnio płacąc kartą , wydawali śmy 211 złotych .	płacąc	1	Conv
Ekonomiści dodają , że motorem owego progresu jest , mimo wysokiego kursu złotego , eksport .	dodają	1	Fin
Wydaje się , że o decyzji przesądziły trzy czynniki .	przesądziły	6	Part
Zaczęła na to kręcić głową .	kręcić	3	Inf
Brzęcząc pustymi kuflami , weszła do środka .	Brzęcząc	0	Conv
Sznur tirów przecina niemal cały Wrocław , ma dziesięć kilometrów długości , stoi w nim kilkaset ciężarowek .	przecina	2	Fin
Może warto odkryć Amerykę .	odkryć	2	Inf
Wolał em nie ujawniać swej wiedzy .	ujawniać	3	Inf
W piątek , sobotę i niedzielę będziemy wspólnie świętować 1000-lecie Biskupstwa Wrocławskiego i 1000-lecie Wrocławia .	świętować	8	Inf
Szach musi odejść !	odejść	2	Inf
Tak wielka ilość pokryje z nadwyżką chłonność rynku .	pokryje	3	Fin
W Ameryce pozostały do dziś .	pozostały	2	Part
Fenometys wciąż kręcił głową , światło lamp odbijało się na bezwłosej skórze idealnymi refleksami .	odbijało	7	Part
Chociaż faktem jest , że Hubal okropnie przeżył te zdarzenia .	przeżył	7	Fin
Chciał by m poznać osobiście człowieka o tak niesamowitej wyobraźni .	poznać	3	Inf
Przy okazji zauważył , że wcale nie była skończoną pięknością , lecz tylko doprowadziła do artyzmu trudną sztukę makijażu .	doprowadziła	13	Part
Dobrze jest odparować nadmiar wody z ogórków , aby potrawa nie była zbyt wodnista .	odparować	2	Inf
- Miał eś przyjść o szóstej .	przyjść	3	Inf
Nie mógł by m bezczynnie siedzieć w domu .	siedzieć	5	Inf
- Weź sobie , Madziu , kochankę , zobaczysz wtedy , jakie to cudowne uczucie .	Weź	1	Fin
Jak zwykle , kiedy wpadał w falset , uderzał laską o podłogę .	wpadał	4	Part
Z jednej strony umówił em się z państwem dziennikarzami , że zakończymy o godzinie 17 .	umówił	3	Fin
- Gdyby nie zwilżać gardła , można by zdechnąć w ten upał .	zwilżać	3	Inf
Ale nadjechał chłop na rowerze .	nadjechał	1	Fin
Wszyscy spojrzeli na mnie .	spojrzeli	1	Part
Nie sposób nie żywić uczucia podziwu dla odwagi pierwszych żeglarzy .	żywić	3	Inf
Usta mu drżały .	drżały	2	Fin
Ale nie chciała chodzić , udawała , że nic nie rozumie .	udawała	5	Part
Joniec i Miksa spojrzeli po sobie , obcierając oczy .	obcierając	7	Conv
Obie spółki ustaliły identyczne ceny .	ustaliły	2	Part
Postanowił go szybko zlokalizować .	zlokalizować	3	Inf
Zaczynasz się dusić i myślisz tylko o tym , żeby się wyrzygać .	dusić	2	Inf
Rzadko się odzywał , raczej słuchał , notował , łagodził ostre nieraz spory .	łagodził	9	Part
Skądś zeskoczył .	zeskoczył	1	Fin
Musi na niego skoczyć .	skoczyć	3	Inf
Wielu młodych opuściło te tereny , szukając pracy i wykształcenia w okolicznych miastach .	szukając	6	Conv
Musimy się naradzić .	naradzić	2	Inf
Nie zamierzałem zaspokajać ciekawości Mojki .	zaspokajać	2	Inf
W ZUS nie ukrywają , że lekarzom trudno udowodnić , iż nadużywają swych kompetencji .	ukrywają	3	Fin
Nie wiem , czy Putin to Piotr II , który chciałby przywiązać Rosję do Zachodu , by uczynić ją silną .	przywiązać	11	Inf
Udało mi się przemycić tę książkę do kraju .	przemycić	3	Inf
Policję zaalarmowała pracownica jednego z krakowskich szpitali .	zaalarmowała	1	Fin
Spotyka mnie teraz zasłużona kara .	Spotyka	0	Fin
Teraz Bóg jeden raczy wiedzieć .	raczy	3	Fin
Pan lepiej wie , z kim się pan umówił przy Wolnicy .	umówił	8	Fin
Dlatego zdecydowano się go rozebrać .	rozebrać	4	Inf
I były dygnitarz wyszedł trzasnąwszy drzwiami .	trzasnąwszy	4	Conv
Z nieoficjalnych informacji wynika , że PSL nie wyklucza poparcia ani Borusewicza , ani Polaczka .	wyklucza	8	Fin
Odwiedzają moją sąsiadkę , bladą dziewczynę spod ściany .	Odwiedzają	0	Fin
Toteż aby poprawić sytuację materialną wielu rodzin , nie musimy zmieniać zapisów ustawy budżetowej .	zmieniać	10	Inf
Nie widzieli się miesiąc i musiał ponownie oswoić Gosię .	widzieli	1	Part
Gdyby kierownictwo ZUS zdecydowało się na Mercedesa lub BMW , to koszt jednego samochodu przekroczyłby 200 tys . nowych złotych .	zdecydowało	3	Part
W czasie stosowania tabletek te apteczne mogą oszukiwać .	oszukiwać	7	Inf
Kilka par tańczyło w przyćmionym świetle , które zdawało się być substancją podobną do mgły z tiulu .	tańczyło	2	Part
Przewrócił się w hotelowym hallu łamiąc żebra .	łamiąc	5	Conv
Twoi pasterze błogosławią ciągnące na wojnę armaty .	błogosławią	2	Fin
Orzechy i migdały zemleć , wymieszać z cukrem oraz 3 łyżkami masła na gładką masę i połączyć z kuskusem .	połączyć	16	Inf
Nie umiem jeździć , nart nie mam .	jeździć	2	Inf
Federaliści przegrali wybory .	przegrali	1	Part
Kierowca zbiegł .	zbiegł	1	Part
Zimą , przylatując na popas do Polski , zadowala się pozostałymi na krzakach jagodami .	przylatując	2	Conv
Wojewódzki Inspektorat IH był pierwszym w Polsce , który jeszcze na podstawie starych przepisów zawarł porozumienie z Polskim Towarzystwem Towaroznawczym .	zawarł	14	Part
Przyjechał tu na Milkowszczyznę już jako doktor .	Przyjechał	0	Part
Potem , gdy próbowali je sprzedać w Szanghaju , zostali zauważeni przez policję .	sprzedać	5	Inf
Słyszysz mnie ?	Słyszysz	0	Fin
Nic nie wyprawiała , bo nic nie robiła .	wyprawiała	2	Fin
Gwiazda przemieniła się w inkwizytora .	przemieniła	1	Fin
Policjanci śmieją się , odreagowując stres .	odreagowując	4	Conv
Zarządca komisaryczny przestał pełnić ją dopiero po ostatnich wyborach samorządowych .	pełnić	3	Inf
Ostre cięcia grożą też prezesom państwowych spółek .	grożą	2	Fin
Jeszcze gorzej spisali się floreciści , zajmując piąte miejsce .	zajmując	6	Conv
- Nie przyprowadzimy go , senior .	przyprowadzimy	2	Fin
Chodził em tak , aż zatrzymał em się przed domem .	Chodził	0	Fin
Naścinali suchej trawy , aby urządzić sobie miękkie posłania .	Naścinali	0	Part
Lżejsze podpórki chwytał po dwie i prawie biegnąc rzucał je na platformę .	biegnąc	7	Conv
KPN chce zaproponować własne rozwiązania tego problemu i dlatego żąda od resortu danych o imporcie .	zaproponować	2	Inf
Ale trzej bracia nie zważali na przeszkody .	zważali	4	Fin
I jeszcze coś szumiało .	szumiało	3	Fin
Natomiast Gorczyca pominął w ogóle sprawę milczeniem .	pominął	2	Part
- Są to różne pojęcia i nie sądzę , aby można było je mieszać , jeśli chcemy uniknąć nieporozumień .	mieszać	13	Inf
Sanitariuszka Marynia ostrożnie otworzyła drzwi .	otworzyła	3	Fin
Nie składają donosów do prokuratury , nie przejmują się całodobowym uśmiercaniem poczętych ?	składają	1	Fin
Gorące spojrzenia towarzyszyły kandydatkom do korony podczas całego rejsu .	towarzyszyły	2	Part
Wyroki dochodziły często do 10 lat więzienia .	dochodziły	1	Part
W ciągu godziny można było zaobserwować około stu meteorów .	zaobserwować	5	Inf
Nerwy jej niepotrzebnie puściły .	puściły	3	Part
Wędzidło w zęby wsadzić .	wsadzić	3	Inf
Przeciskając się Czerwin natrafił na trzy granaty na przedpiersiu któregoś stanowiska .	Przeciskając	0	Conv
Wikary Pudło odprawia je żując gumę .	żując	4	Conv
Ludzie rozsunęli się natychmiast , robiąc szpaler aż do drzwi plebanii .	robiąc	5	Conv
Wyczuł ze zdziwieniem , że cała klatka odsunęła się od muru , tworząc szparę na szerokość dłoni .	Wyczuł	0	Part
Nie orientował się też , że popełnia przestępstwo dewizowe .	orientował	1	Part
Wolała puszczać w kinach filmy kung-fu licząc , że dzięki temu ludzie przestaną myśleć o polityce .	licząc	6	Conv
Hiszpański wicekról Argentyny kazał wysłać znalezisko do Madrytu .	wysłać	4	Inf
Prototypy powinny odznaczać się światowym standardem .	odznaczać	2	Inf
I padł , wykorzystując impet ciosu .	wykorzystując	3	Conv
Tamta urodziła dziecko z wielkim okiem pośrodku czoła .	urodziła	1	Fin
Przyzwoitość każe szanować gości i ja właśnie w ten elegancki sposób uszanuję Jagodowe wakacje .	szanować	2	Inf
Zabrali do szpitala .	Zabrali	0	Part
Przypomniał swą pierwszą sprzed kilku lat wizytę w Ludwinowie w 1860 roku , zabawił kilka dni , zburzył spokój samotniczki .	zabawił	13	Part
Odpowiedziałeś posługując się sztandarowym obok Białorusi argumentem .	posługując	1	Conv
Piękne dziewczyny zelektryzowały kierowców tirów .	zelektryzowały	2	Part
Nawet Nagroda Nobla mu nie dorównuje !	dorównuje	5	Fin
Tell właśnie zamykał drzwi i zawieszał na nich kłódkę .	zawieszał	5	Part
– Callian wyznaczył nagrodę dla tego , któremu uda się …	wyznaczył	2	Part
A więc chroniła i tuliła .	chroniła	2	Part
Jeszcze przed obcięciem uposażeń , krakowscy rajcy planowali wydać taką właśnie sumę na remont trzech komisariatów oraz zakup 9 samochodów dla policji i 4 dla straży miejskiej .	wydać	8	Inf
Lufki wysunęły się z większości oczu , ustalając osobę chichotu .	wysunęły	1	Part
Oto wybiera się sierota z całą gromadą kopać na hrabiowskich redlinach .	kopać	7	Inf
Widoczny jest wzrost aspiracji społeczeństwa , które chce zdobywać wykształcenie .	zdobywać	8	Inf
Nie chciał kłamać .	kłamać	2	Inf
Te słowa powstały po to , by je ze sobą połączyć .	połączyć	10	Inf
- Przyniosła ś .	Przyniosła	1	Fin
Pili śmy koniak , on wyczuje !	wyczuje	5	Fin
- Jurek mnie puścił .	puścił	3	Part
Według stołecznych policjantów , udało mu się zgromadzić wokół siebie młodych przestępców z Pragi .	zgromadzić	7	Inf
Wiem , że jestem nudna , zalecając rzecz tak oczywistą jak gimnastyka .	zalecając	6	Conv
Z nowym rokiem weszło w życie nowe prawo dewizowe .	weszło	3	Part
Obecnie staramy się to maksymalnie uprościć i są już tego efekty .	staramy	1	Fin
Trzeba wykorzystać szansę .	wykorzystać	1	Inf
Prokuratura Okręgowa w Krakowie , która prowadzi śledztwo w sprawie wycieku testów w 2000 r . , potwierdziła , że sprzedawano testy w cenach od kilkuset złotych do 15 tysięcy .	potwierdziła	17	Part
Co jakiś czas wydawało mi się , że teraz już mogę coś wydrukować albo że już mi wolno wyjechać .	wyjechać	18	Inf
Jakubowski ciężko westchnął .	westchnął	2	Fin
Otwarłszy kran , jął odkorkowywać palcami pierwszą probówkę .	Otwarłszy	0	Conv
- Masz się o niego nie martwić , słyszał eś ?	martwić	6	Inf
Wolała puszczać w kinach filmy kung-fu licząc , że dzięki temu ludzie przestaną myśleć o polityce .	Wolała	0	Fin
Konkurs składał się z etapu ustnego i pisemnego .	składał	1	Part
Facet musiał wyłączyć silnik .	wyłączyć	2	Inf
Podlewajcie kwiaty .	Podlewajcie	0	Fin
- Powiedział em Senece , że się z nim pogodził em .	pogodził	9	Fin
Dzieciak wymazał litery .	wymazał	1	Fin
Lubuscy policjanci rozbili grupę zajmującą się włamaniami do kościołów i kradzieżami figur oraz przedmiotów kultu religijnego .	rozbili	2	Part
– tak to się układa .	układa	4	Fin
Czy na to go dzisiaj plecy swędziały ?	swędziały	6	Part
Muszę się wytężyć maluczko . . .	wytężyć	2	Inf
Miał prawo nie panować nad emocjami .	panować	3	Inf
Iskierka zgasła , ustępując miejsca podejrzliwości .	ustępując	3	Conv
– Callian wyznaczył nagrodę dla tego , któremu uda się …	uda	8	Fin
Był to bowiem pisarz mądry , ciekawy , który oparł się reżymowym nakazom , by nie stracić swej wiarygodności .	stracić	16	Inf
Nagrody przyznała specjalna Kapituła , pragnąc uhonorować osoby i instytucje , których działalność wniosła znaczący wkład w krzewienie tolerancji .	uhonorować	6	Inf
Bóg umieścił ludzi w Raju .	umieścił	1	Fin
Nerwy jej niepotrzebnie puściły .	puściły	3	Fin
Rozmawiając , zboczyli na polną drogę .	Rozmawiając	0	Conv
Odwróciwszy się omal nie uderzył w brzuch starego Pancera .	Odwróciwszy	0	Conv
Zaczynają boleć kolana .	boleć	1	Inf
Powiało ostro naftaliną .	Powiało	0	Fin
Starsza kobieta , niestety , uwierzyła w tę bajeczkę .	uwierzyła	5	Part
Cztery z nich trafiły do szpitala .	trafiły	3	Part
Poprawiał wciąż aparat w uchu , jakby chciał lepiej usłyszeć .	Poprawiał	0	Part
Obrzęk w krtani może zagrażać życiu .	zagrażać	4	Inf
W zeszłym roku lekarz stwierdził , że ma świnkę .	stwierdził	4	Fin
Ich rodzina również powinna ponieść karę .	ponieść	4	Inf
Warzywa umyć i osączyć .	umyć	1	Inf
Sołtys Ligoty Stanisław Kuźnik składa serdeczne podziękowanie wszystkim sponsorom , którzy przyczynili się do zorganizowania festynu i dzięki którym dzieci z Ligoty będą mogły pojechać na wycieczkę .	przyczynili	11	Part
Jaskier jęknął i pobiegł .	jęknął	1	Fin
Samolot wylądował punktualnie o 11 . 10 , a pierwsi podróżni dostali róże od obsługi lotniska .	wylądował	1	Part
Kiedy wreszcie natrafił na schody i znalazł się na ulicy , kolegów przed pałacem już nie było ; najwidoczniej nie mogąc się go doczekać udali się bez niego na miasto .	mogąc	20	Conv
Misję tę powierzyła doktorowi Lane matka Oswalda , Marguerite .	powierzyła	2	Fin
Przyznam , że nie jestem najlepszy w te klocki .	Przyznam	0	Fin
Kazancewa po raz ostatni widziano , gdy podróżował śmigłowcem w rejonie walk .	podróżował	7	Part
Owinięty w zwiewne szaty , zasiadał na schodach świątyń , medytując godzinami .	medytując	10	Conv
Wrócił do domu i w przedpokoju nasłuchiwał .	Wrócił	0	Fin
Karolcia zaczerwieniła się i nic nie odpowiedziała .	zaczerwieniła	1	Fin
Zatrudnia 1100 dziennikarzy i 2000 współpracowników .	Zatrudnia	0	Fin
Chciał em gonić Łesia .	gonić	2	Inf
Czy komornik będzie chciał zająć jeszcze coś innego ?	zająć	4	Inf
Czekać świtu .	Czekać	0	Inf
Podjął Pan już tego typu decyzję ?	Podjął	0	Fin
Wspinając się , potrącił nogą ów kształt , który stoczył się ze stopni . . .	Wspinając	0	Conv
Kiedy się ocknął , szarzało .	ocknął	2	Fin
Słuchaj , Piotr był zalany , spadał ze schodów , wyskakiwał z okna .	spadał	6	Part
Bezwiedne płyną łzy żalu , zasłaniając oczom widok .	zasłaniając	5	Conv
Będą także mogli bezpłatnie zamawiać zdjęcia nagich modelek .	zamawiać	4	Inf
Dlaczego się przestraszyła ?	przestraszyła	2	Fin
Ale chciała by czasem przyjechać was odwiedzić .	przyjechać	4	Inf
Ocean wtargnął w głąb lądu i nie odpłynął cały , tworząc jeziora rozmiaru mórz , bo głęboka płyta litosferycznego płaszcza Kwinty uległa zgnieceniu , a wody zapełniły powstałe na powierzchni depresje .	odpłynął	7	Part
Podporucznik Kowalik , nie mogąc znieść kuchenno - masarnianego obrządku i słodkawego zapachu krwi , ubrał się i wyszedł z domu .	mogąc	4	Conv
ładnie nawiązał eś do Łazarza i przepaści potępiając mnie i skazując na nie .	potępiając	7	Conv
Znajdziemy inny symbol .	Znajdziemy	0	Fin
Wyrok ten uchylił sąd apelacyjny .	uchylił	2	Fin
Zerwał em suchą trawkę i zaczął em ją powoli żuć .	żuć	9	Inf
Przebiegające pod miastem chodniki kopalni zalano wodą , a wzgórze zgniło i zapadło się w ziemię jak przydeptane .	zgniło	10	Part
Zdecydowanie fascynuje mnie rozmaitość mojej pracy .	fascynuje	1	Fin
Oczekując na swoją kolej , rozmawiają i oglądają filmy w świetlicy pod czujnym okiem opiekuna Rudolfa Dyrksa .	Oczekując	0	Conv
Mirosław Seta , miejscowy strażak , wchodzi meldując , że sytuacja wydaje się opanowana .	meldując	7	Conv
– Mieliśmy listę Wildsteina , teraz wypłynęła tak zwana lista 500 , o której istnieniu poinformował prezes IPN Janusz Kurtyka .	poinformował	15	Part
Ukonstytuowały się już wszystkie komisje działające przy Radzie Gminy i od razu zabrały się do roboty nad sporządzeniem planu działania na rok 1999 .	zabrały	12	Part
Mogli by w nich uczestniczyć kandydaci Unii Wolności oraz Wałęsa i Olszewski , jeśli tylko zechcą i będą mieli poparcie 15 parlamentarzystów i 300 radnych .	uczestniczyć	4	Inf
- Zaczął em iść .	Zaczął	1	Fin
To sam Wei nie chciał wyjechać .	wyjechać	5	Inf
- Jeszcze m nie mieniał .	mieniał	4	Fin
nie można nagrać zdjęć ?	nagrać	2	Inf
Kilka dni temu ktoś załatwił się pod ich oknem .	załatwił	4	Part
Tłumaczyli nam , że źle na nich wychodzą .	Tłumaczyli	0	Part
Alkohol przestaje działać i ten czy ów zaczyna ziewać .	ziewać	8	Inf
Dankowski objął Bełchatów na początku sezonu , a pierwszej porażki doznał dopiero w siódmej kolejce .	objął	1	Fin
Orfeusz zmierza pewnie ku światłu , pomyślnie wyprowadzając Eurydykę z krainy zmarłych .	wyprowadzając	7	Conv
Od strony wjazdu zbliżał się ubłocony fiat Kosińskiego .	zbliżał	3	Part
Wsparł się na łokciu i wyjrzał na polankę .	Wsparł	0	Part
Opowiadali oni , że kierowca nie zatrzymał się na wezwanie .	Opowiadali	0	Fin
we dwóch rowerami przyjeżdżali przeważnie . .	przyjeżdżali	3	Fin
– Modesta dotykała ust serwetką , ostrożnie , żeby nie rozmazać szminki .	rozmazać	10	Inf
Modernizacja Opla Frontery miała uczynić go bardziej przyjaznym dla użytkowników , nie zmniejszając jednocześnie jego możliwości .	zmniejszając	12	Conv
Brygada ma w trzy dni usunąć wszystkie usterki .	usunąć	5	Inf
Rozpędzonej karuzeli stanowisk nie zatrzymała minister Piwnik , choć przez pierwsze pół roku urzędowania wstrzymywała się ona z ruchami kadrowymi .	wstrzymywała	14	Part
Jednocześnie tacy ludzie chcą się dalej kształcić i rozwijać , żeby potem móc zmienić pracę na lepszą .	kształcić	6	Inf
Tracić cenne godziny ?	Tracić	0	Inf
- Ulegam przemocy .	Ulegam	1	Fin
W latach 90 . wielu duszpasterzy , kierując się potrzebą posiadania wyrazistego wroga , wskazuje z ambony na wyraźnie nazwany obóz polityczny , lożę , fundację czy partię .	kierując	7	Conv
Utworzył em to hasło , ponieważ nikt wcześniej go nie utworzył .	Utworzył	0	Fin
Dyna nie wydawał się obrażony .	wydawał	2	Part
Zaleźć za skórę !	Zaleźć	0	Inf
Włącza radio , znajduje muzykę , wraca do naczyń .	Włącza	0	Fin
Jeśli resort zaakceptuje programy , będzie je finansować .	finansować	7	Inf
Dotknął wilgotnego ręcznika w łazience , pogładził mięsistą połę szlafroka , powąchał mydło w cedrowej kasetce .	powąchał	11	Part
W wyniku wyborów Kohl utrzymał przewagę w Bundestagu .	utrzymał	4	Fin
Islam zakazuje przemocy .	zakazuje	1	Fin
Dojedli śniadanie , wyjęli papierosy , zapalili .	Dojedli	0	Part
Powołał do życia Centralne Biuro Śledcze .	Powołał	0	Part
Wiatr zmęczył się także .	zmęczył	1	Part
- Ucząc języka , jednocześnie budzimy w dzieciach intelekt , ciekawość świata .	Ucząc	1	Conv
Dalej za płotem ciągnął się sad .	ciągnął	3	Fin
- Zrobiła ręką gest zapraszający do środka .	Zrobiła	1	Fin
Czy macierzyństwo bardzo odmieniło Twoje życie ?	odmieniło	3	Part
I od początku szedł numer , potem znowu ktoś trącił . . .	szedł	3	Fin
I zaczęło się dziać wiele zła .	dziać	3	Inf
- Kto z nas dotknął trupa ?	dotknął	4	Fin
Działo się to po południu .	Działo	0	Part
W piątek i sobotę tylko w Chicago zmarło na skutek gorąca dalszych 26 osób .	zmarło	7	Part
Stanowią one razem z rzodkiewką potrawę pełnowartościową , dając jednocześnie ciekawy efekt dekoracyjny .	dając	8	Conv
Dunlong zamachał rękoma .	zamachał	1	Part
Równie dobrze przeciw płaceniu podatków oponować mógł by kupiec .	oponować	5	Inf
- Trudno to nazwać deszczami .	nazwać	3	Inf
Ale nie rozumiem , jak można w imię ekumenizmu wysuwać roszczenia do tworzenia w Europie stref monopolistycznych wpływów religijnych .	wysuwać	9	Inf
Marchewki obrać i zetrzeć na tarce o dużych oczkach .	zetrzeć	3	Inf
Jakby się nie liczyli w tym spotkaniu .	liczyli	3	Part
- Pokochać i być prawdziwym przyjacielem .	Pokochać	1	Inf
W wyniku nieadiabatycznego ochładzania najniższych warstw troposfery powstają , ogólnie biorąc , najniższe chmury warstwowe .	biorąc	10	Conv
Jakie priorytety wiążą się z mincerzami ?	wiążą	2	Fin
Rybka powędrowała do akwarium ustawionego przez asystentkę na stoliku .	powędrowała	1	Fin
Bała się .	Bała	0	Part
Oscylowałem na pograniczu tych dwóch światów , mając dostęp do obu .	mając	7	Conv
Kupcy ochoczo przyłączyli się do toastu .	przyłączyli	2	Fin
Laboratorium badań serologicznych pozostało w gestii leszczyńskiego szpitala .	pozostało	3	Part
Przestali bić , kiedy znieruchomiał .	bić	1	Inf
- Czy chce otrzymać azyl w Danii ?	otrzymać	3	Inf
Przyjechało pogotowie .	Przyjechało	0	Part
Może narażę się na krytykę ze strony pana premiera Pawlaka , ale wciąż zbyt wielkie znaczenie przywiązujemy do umów międzyrządowych .	narażę	1	Fin
Takiemu psiakowi nie umknie zapewne żaden zapach .	umknie	3	Fin
W zeszłym roku lekarz stwierdził , że ma świnkę .	stwierdził	4	Part
Nadążacie , Towarzysze ?	Nadążacie	0	Fin
Dodawał też , że korzystał z jawnych źródeł .	Dodawał	0	Fin
I nie zgodzili się .	zgodzili	2	Fin
Z jego zeznań wynika , że wczoraj około godziny 15 podjechał samochodem na ulicę Grażyńskiego .	podjechał	10	Part
Siedział odchylony za swoim biurkiem z taką miną , jakby dowodził całą policją , Interpolem i FBI na dodatek i delektował się kawą .	delektował	20	Part
Upuścił żądło .	Upuścił	0	Part
Konia by powaliło .	powaliło	2	Part
Jak się nieoficjalnie dowiedzieli śmy , nie można wykluczyć łącznego osądzenia obu spraw .	wykluczyć	8	Inf
Polska powoli suszyła się po wielkiej powodzi , a uwaga Czytelników kierowała się na politykę .	kierowała	11	Fin
A ja odciągnę ich od ciebie .	odciągnę	2	Fin
- Jeszcze raz westchnęła .	westchnęła	3	Fin
Przygryzając wargi z bezsilnej złości , Chmura wołał Adasia .	Przygryzając	0	Conv
Co dzień , wychodząc ze szkoły , oglądał się jeszcze , jakby już jutro nie miał jej zobaczyć .	wychodząc	3	Conv
I zjechawszy na kolana gorzko zapłakał zapominając , że patrzą na niego ludzie .	zjechawszy	1	Conv
Dlatego zajął się Kołem Młodych i młodzież przyjęła jego patronat z pełną aprobatą .	przyjęła	7	Part
Jeśli nie zatrąbisz , ośmieszysz nas .	zatrąbisz	2	Fin
Po czym ogłoszono , że olimpiadę zawiesza się do odwołania .	zawiesza	6	Fin
Chyba najmądrzej było by wyrwać ten nieszczęsny ząb .	wyrwać	4	Inf
Czy pan minister Hausner chce uzupełnić swoją odpowiedź ?	uzupełnić	5	Inf
Lepiej nie bić piany , tylko pomóc dzieciom .	bić	2	Inf
Przestał regulować należności w 1998 roku .	regulować	1	Inf
– ale kolację zaraz będziemy szykować .	szykować	5	Inf
Wiedźmin biegł za nim , licząc , że potwory rozciągną się w pościgu .	licząc	5	Conv
Zimna woda tryskała na głowę , szyję i płonące uszy .	tryskała	2	Part
Jak dotąd , ani Państwowe Koleje Linowe , ani straż miejska , ani policja nie potrafiły poradzić sobie z konikami .	poradzić	16	Inf
Ministerstwo Rolnictwa , które przed rokiem obłożyło miód importowany opłatami wyrównawczymi , opracowało długofalowy program rozwoju pszczelarstwa .	obłożyło	6	Part
I Pan Jezus krzyż nad nimi uczynił , a oni się zamienili w trzy drzewa jabłonne .	uczynił	6	Part
Sporządzono także portrety pamięciowe napastników .	Sporządzono	0	Fin
Opodal trenowali skoki chłopcy na deskorolkach .	trenowali	1	Part
Księżyc wznosi się , tak pełny , jakby miał się przelać .	przelać	10	Inf
- Powiedziała Anna .	Powiedziała	1	Fin
Woziły im posiłki na wózkach .	Woziły	0	Fin
Franek spał już od dawna , pochrapując przez sen .	pochrapując	6	Conv
Pożeracz Chmur aż się otrząsnął .	otrząsnął	4	Part
Bandytów nie złapano .	złapano	2	Fin
Uderzył w biurokratyzm partyjny .	Uderzył	0	Fin
Pewnie to go zmyliło .	zmyliło	3	Part
Uprzedzali , żeby kopać ostrożnie .	kopać	3	Inf
Nie wiadomo nawet , kiedy do niego w Sejmie dojdzie .	dojdzie	9	Fin
Przedsiębiorcę z Barda niepokoi , że w obrocie gospodarczym brakuje pieniędzy .	niepokoi	3	Fin
- Suutari chwycił wojownika , wyrywając mu broń z ręki .	wyrywając	5	Conv
Buduję , mając zaufanie w Bogu i mając miłość do ludzi .	mając	2	Conv
Płeć piękna zwycięża !	zwycięża	2	Fin
Napisy na murach dodawały otuchy i nadziei .	dodawały	3	Fin
W samym tylko województwie lubelskim co najmniej kilka tysięcy z nich będzie podczas wakacji dorabiać .	dorabiać	14	Inf
Angażują się w niezwykłym stopniu .	Angażują	0	Fin
Wyróżniał się licznymi szybami górniczymi , kryjącymi w swych wnętrzach wieże wyciągowe i windy do przewozu ludzi i węgla .	Wyróżniał	0	Part
- Sierżant stuknął służbiście obcasami i zasalutował .	stuknął	2	Fin
on otwiera oczy i się śmieje .	śmieje	5	Fin
Partia Konserwatywna zawiesiła Spencera w obowiązkach posła .	zawiesiła	2	Part
Leżeliśmy przez chwilę w milczeniu , wsłuchując się we własne oddechy .	wsłuchując	6	Conv
Odbudujmy porozumienie ponad różnicami , tak mało istotnymi wobec rzeczywistych problemów !	Odbudujmy	0	Fin
W 1905 roku Karl Braun zbudował detektor kryształkowy .	zbudował	5	Fin
Mówiły one o uniezależnieniu się Prus Książęcych od Polski .	Mówiły	0	Fin
Wyprostowała plecy .	Wyprostowała	0	Fin
- Nie gniewaj się , pomyśl , zrobili śmy im taką przyjemność .	pomyśl	5	Fin
I montujemy z tego dziewięćdziesięciominutowy program .	montujemy	1	Fin
Banki akcyjne brały prowizje od swych usług i szukały zysku .	szukały	8	Part
Pierwszy cios , który później okazał się śmiertelny , został zadany metalowym krzesłem w tył głowy .	okazał	5	Part
Towarzystwo oddelegowało kilku rzeczoznawców do pełnienia dyżurów i udzielania porad konsumentom .	oddelegowało	1	Part
Albo zesłać mu śmierć , zanim się zestarzeje .	zesłać	1	Inf
Idąc czuł , że wzbudza ciekawość , ludzie stawali , patrzyli za nim .	wzbudza	4	Fin
Wczoraj rano lekarze zaostrzyli akcję .	zaostrzyli	3	Fin
Taboret upadł z dramatycznym łoskotem , a on , wierzgając nogami , zawisł niczym gotowy do wypatroszenia wieprz .	wierzgając	9	Conv
Z tego powodu piosenkarka postanowiła pozwolić komputerowo zretuszować swój wygląd .	zretuszować	7	Inf
Obaj skrupulatnie przepisywali rezultaty kolejnych odcinków specjalnych , by w pokojach hotelowych dokładnie je przeanalizować .	przepisywali	2	Fin
Lekarze zalecili mu odpoczynek przed rywalizacją sztafet .	zalecili	1	Part
W momencie trafienia śmigłowiec znajdował się na wysokości około 1000 metrów .	znajdował	4	Part
Do obserwatorium waszyngtońskiego ściągały tłumy ciekawych .	ściągały	3	Part
Tak jakby ludzie z kręgów kulturalnych bali się Szuwara , jakby mając nieczyste sumienie , chcieli jednak go wysłuchać , dopuścić do głosu .	mając	11	Conv
Dymkę oczyścić i pokroić na kawałki .	oczyścić	1	Inf
Często mdlała i padała na podłogę , płacząc histerycznie .	płacząc	7	Conv
Prace metaloplastyczne w kościele wykonywał Władysław Gąsienica Makowski .	wykonywał	4	Part
W 10 sklepach sprzedawcy odmówili , żądając okazania dokumentów , w jednym przypadku alkohol sprzedano .	żądając	6	Conv
Zmierzch stał się coraz ciemniejszy , na niebie ukazały się pierwsze gwiazdy .	ukazały	8	Fin
Niosło wonią smoły i wodorostów , woda pluskała cicho o łódki przywiązane do omszałych pali .	Niosło	0	Fin
- Pani Salach kazała śledzić każdy jej krok i informować o każdym błędzie .	informować	9	Inf
Jakiś czas mierzyli się wzrokiem .	mierzyli	2	Part
Przygotuje się pan poseł Roman Andrzejewski .	Przygotuje	0	Fin
Ja by m to pytanie uogólnił .	uogólnił	5	Fin
Sam Misztal nie ukrywa , że chce zamknięcia dyskoteki .	ukrywa	3	Fin
- A kiedy mogę przyjść ?	przyjść	4	Inf
Spojrzała w niebo , oceniając , kiedy znów zacznie padać .	oceniając	4	Conv
Gdy rozległ się krzyk , Guilielmo zakryl twarz rękami .	zakryl	6	Fin
Rolnik , szukając schronienia , błyskawicznie wskoczył na dwukółkę .	szukając	2	Conv
Podniosła głowę .	Podniosła	0	Part
Zamierzamy dotrzymywać zawartych umów i porozumień .	dotrzymywać	1	Inf
Komisja rewizyjna rady powiatowej zawnioskowała o udzielenie absolutorium i przesłała stosowny wniosek do Regionalnej Izby Obrachunkowej w Bydgoszczy .	przesłała	9	Part
Tassilo de Tresckow zajechał go i ciął mieczem .	ciął	6	Part
- Przestać się mądrzyć , Łapa !	mądrzyć	3	Inf
W połowie maja laweciarze zorganizowali protest na przejściach granicznych .	zorganizowali	4	Part
- Trudno będzie , ale spróbujemy .	spróbujemy	5	Fin
Zimna woda tryskała na głowę , szyję i płonące uszy .	tryskała	2	Fin
Nie patrzyła już na mnie .	patrzyła	1	Part
- Wiem , że wiesz , ale chciała m nawiązać rozmowę .	nawiązać	9	Inf
Byli w wielu innych związkach , które się jednak rozsypały .	rozsypały	9	Part
Dokonawszy pośpiesznie wieczornej toalety , ułożyłem się w łóżku i zaraz zgasiłem światło .	Dokonawszy	0	Conv
W wielu miastach widzieli śmy gigantyczne kolejki .	widzieli	3	Fin
Strażacy brnąc niemal po kolanach w wodzie wynoszą w drewnianych klatkach świnie .	brnąc	1	Conv
Wypowiedź jednego z robotników pracujących przy drodze zupełnie poraziła .	poraziła	8	Part
Zwierzenia Ani poruszyły mnie do głębi .	poruszyły	2	Part
- Niech pani się przyjrzy tekstowi mojego wystąpienia .	przyjrzy	4	Fin
Baryshnikov automatycznie skorzystał z Rangera .	skorzystał	2	Part
– Bo chyba pana Macierewicza trzymają się żarty .	trzymają	5	Fin
- Czy chce otrzymać azyl w Danii ?	otrzymać	3	Inf
Dwukrotnie SKO przyznało im rację .	przyznało	2	Part
Ale i wiem , że teraz kłamiesz .	kłamiesz	6	Fin
Wszystkiego dowiem się we właściwym czasie .	dowiem	1	Fin
Nagrody przyznała specjalna Kapituła , pragnąc uhonorować osoby i instytucje , których działalność wniosła znaczący wkład w krzewienie tolerancji .	pragnąc	5	Conv
- Czy ktoś z pań posłanek i panów posłów pragnie zabrać głos w sprawie przedstawionych propozycji ?	zabrać	10	Inf
Po chwili odsłonił głowę i uważnie lustrował zaniepokojone twarze .	odsłonił	2	Part
Ubezpieczył eś auto ?	Ubezpieczył	0	Fin
Warto by zażądać wojskowego konsultanta .	zażądać	2	Inf
14-letni chłopak nie jadł , nie mówił , nie umiał korzystać z toalety .	jadł	3	Part
Dostrzegła m , że patrzą na mnie ze współczuciem .	patrzą	4	Fin
Oświadczył też , że idą z polecenia organizacji z bardzo ważnym zadaniem .	Oświadczył	0	Part
Po tym wydarzeniu przez kilka dni przebywał w szpitalu .	przebywał	6	Fin
W szklarniach pozostało ich jeszcze sporo .	pozostało	2	Fin
Przeglądam dziennik swój .	Przeglądam	0	Fin
Ajataka wzruszyła ramionami i pociągnęła mnie do windy .	pociągnęła	4	Part
Ulewne deszcze nawiedziły także Słupsk .	nawiedziły	2	Part
Jeśli resort zaakceptuje programy , będzie je finansować .	zaakceptuje	2	Fin
Wówczas pan Olewnik jeszcze wierzył , że nowa grupa działa sprawnie i robi wszystko , by odzyskać jego syna . . .	odzyskać	16	Inf
Grubas roześmiał się głośno , przytrzymując ręką pióra na głowie .	przytrzymując	5	Conv
Przyjechawszy do Paryża latem Sołomin odszukał ich adres .	Przyjechawszy	0	Conv
co tam wyczytała ś ?	wyczytała	2	Fin
Nie czekajcie na mnie i nie oglądajcie się .	oglądajcie	6	Fin
Ostatecznie rany mu opatrzyli .	opatrzyli	3	Part
Zwłoki psa trafiły do wrocławskiego schroniska dla zwierząt .	trafiły	2	Part
Będą pracować w Wilczycach i w rejonie Ćmielowa .	pracować	1	Inf
Fabrykę zaplombowano , konfiskując także podejrzane materiały .	konfiskując	3	Conv
Deski nosić !	nosić	1	Inf
Lubicie wyciągać z ludzi . . .	wyciągać	1	Inf
Posiadanie pełnych praw akademickich oznacza , że uczelnia nadaje stopień naukowy doktora , przeprowadza przewody habilitacyjne oraz występuje z wnioskiem o nadanie tytułu naukowego profesora .	przeprowadza	13	Fin
Tutaj nie odnajdą go ani Doppler , ani Georg .	odnajdą	2	Fin
Ty przecież też zasnął eś , oglądając w telewizji mecze polskich orłów .	oglądając	6	Conv
Zawsze mówię , że mogę pracować , bo mam dobre zdrowie , a to jest darmo dane .	pracować	5	Inf
Wielkie firmy już dawno dostrzegły , że rządy muszą zabiegać o ich względy , aby przypisywać sobie sukcesy gospodarcze .	przypisywać	15	Inf
Innym razem pojechała z Kaharem do portu Xiamen na południu Chin , gdzie kupili trzy japońskie magnetowidy .	kupili	13	Part
Kazał Paoli przynieść sobie drinka .	przynieść	2	Inf
Seniorska reprezentacja Polski zbliża się do zgrupowania we Wronkach .	zbliża	3	Fin
I zrozumieli ludzie , że tu Bóg był , i zburzyli ten sądowy dom , aby w nim nikt już więcej po Panu Jezusie nie sądził , a przed jabłonnymi drzewami postawili krzyż i on do dziś tam stoi .	postawili	31	Part
Mam zataić , że się wzruszył em ?	zataić	1	Inf
Buduję , mając zaufanie w Bogu i mając miłość do ludzi .	mając	7	Conv
Jak planował , pojechał do Jurka wczesnym popołudniem .	planował	1	Part
Zresztą , to już zaczyna przypominać jakiś nałóg .	przypominać	5	Inf
Puszczaj , bo zabiję !	zabiję	3	Fin
Ale wydaje mi się , że Lech , Czech i Rus musieli bardzo długo pędzić za jeleniem , dzikiem i niedźwiedziem .	pędzić	14	Inf
W Olsztynie pod drzwiami szpitalnymi zmarły ostatnio dwie osoby .	zmarły	5	Part
Nie potrafił dojrzeć .	dojrzeć	2	Inf
Zabrał ponad 30 tys . zł .	Zabrał	0	Part
Za to w wyniku referendum mogą stracić fotele .	stracić	6	Inf
Siedział już w oknie , z nogami wystawionymi na zewnątrz , ale w porę obezwładnili go i ściągnęli z okna strażnicy miejscy .	obezwładnili	14	Part
Harcerze właśnie rozpoczęli naprawę przekazanych im rowerów .	rozpoczęli	2	Part
- Nikt się nie rozłazi , panie kapralu !	rozłazi	4	Fin
Sporządzając mi drinka , Pućka kończy wcześniej rozpoczętą kwestię .	Sporządzając	0	Conv
Przez chwilę spoglądali na siebie jakby badając prawdomówność .	badając	6	Conv
Zalało perony na dworcu kolejowym .	Zalało	0	Fin
Adamiec zatrzymał się i próbował zabrać od góralki swoją walizkę , ale stara nie chciała mu oddać .	zabrać	5	Inf
KOKS MUSI BYĆ !	BYĆ	2	Inf
Choć dziecko złożyło na policji zeznania , sprawców nie zatrzymano .	złożyło	2	Part
- Przesadzasz ?	Przesadzasz	1	Fin
Chciał za to remontować ciężarówkę .	remontować	3	Inf
Polski samolot M-28 rozbił się i eksplodował kilka sekund po starcie z lotniska w Puerto Cabello , 200 km na zachód od Caracas .	eksplodował	6	Part
Opowieść uczestniczy także w pochodzie performatywów , stwarza wzory i poglądy .	uczestniczy	1	Fin
Kudłatemu znowu coś popieprzyło się w obliczeniach finansowych .	popieprzyło	3	Part
Mały podyrdał , nie oglądając się na wybawicielkę .	oglądając	4	Conv
Kia sephia , którą kierował 67-letni Henryk M . , nie zatrzymała się przed przejściem i potrąciła staruszkę .	kierował	4	Part
Leżeli śmy przez chwilę w milczeniu , wsłuchując się we własne oddechy .	wsłuchując	7	Conv
