Irma tak hovorievala od hnevu .	hnevu	4	Gen
Poďakovanie patrí aj posudzovateľom rukopisu – pánovi prof . PhDr . Richardovi Marsinovi , DrSc . a pánovi PhDr . Jánovi Steinhübelovi , CSc . , ktorí mi pomohli vylepšiť text svojimi cennými postrehmi .	posudzovateľom	3	Dat
V tom čase bol vplyvným šéfredaktorom týždenníka Október .	týždenníka	6	Gen
Ku konfliktom a nedorozumeniam výrazne prispelo aj to , že sa maďarské „ nemzet “ dá používať v oboch týchto významoch .	nedorozumeniam	3	Dat
Cieľom reformy poistenia v nezamestnanosti bude posilnenie princípu zásluhovosti ( poistného princípu ) a princípu osobnej zodpovednosti občana za vlastnú pracovnú a sociálnu situáciu .	zásluhovosti	8	Gen
Smutná dážďovka Vendelín	dážďovka	1	Nom
Ale pozor bez povrázkov !	povrázkov	3	Gen
“ Dobrý deň , “ zakričala veselo Blythe mame .	mame	8	Dat
Balú zatiaľ chlapcovi nepovedal , že ho vedie do osady .	chlapcovi	2	Dat
Dúfala som , že sa nápadne zablyští na slnku , ale , žiaľ , v ten deň bolo zatiahnuté .	slnku	8	Loc
Potom som stlačil kľučku na dverách vedúcich do Profesorovej izby .	kľučku	3	Acc
Ide o unikátny nález brezovej listiny v karelčine , s využitím ruskej abecedy .	karelčine	7	Loc
Tento národ teda kládol zúrivý odpor kolonizačným snahám ruských kniežat .	snahám	7	Dat
Novozaložené mesto rýchlo zatláča do úzadia susedné centrum na hradisku Timerevo .	úzadia	5	Gen
Pred domom kuny Chytráčky viali pestré slepačie perá , Alfonz vystavoval lesklú kukuricu a kliešťak Drakula voňavé krvavé klobásky .	perá	7	Nom
Do nášho podvedomia pomaly a nenápadne ukladá hrdzu , ktorá ukradomky rozožiera našu psychiku .	psychiku	13	Acc
Chichúňala sa a s džbánom na hlave sa pobrala do osady .	džbánom	4	Ins
Formálne dodržiavaným zvykom je aj skrývanie moslimských žien .	skrývanie	5	Nom
Kerchak bránil rodinu proti zákernej mačke , zatiaľ čo ostatní členovia ho pozorovali zo stromov .	stromov	14	Gen
Zažmurkala som pri tých slovách .	slovách	4	Loc
Väčšina neskorších bádateľov sa uspokojila s jednoduchým reprodukovaním tohto zistenia .	reprodukovaním	7	Ins
Pomedzi stromy zbadala chalúpku , v ktorej bývali trpaslíci .	chalúpku	3	Acc
“ Chyť volant , “ povedal a otočil sa k zadnému sedadlu , kde mal športový vak .	sedadlu	11	Dat
Začiatkom 11 storočia bolo pomerne málo významným sídlom — nespomína sa napr . pri delení údelov Vladimírovým synom .	sídlom	7	Ins
Bol som jej štvrtým tridsaťpercentníkom .	tridsaťpercentníkom	4	Ins
Zrazu však vyšľahli obrovské plamene a vyrazili princovi štít z ruky .	princovi	7	Dat
Na lúke postávali skupinky rozčúlených obyvateľov .	lúke	1	Loc
Buď to spôsobil príval jej vďačnosti , alebo slovo „ ujo “ , ktoré vyslovila s akousi sexuálnou dôvernosťou .	dôvernosťou	18	Ins
V jeho mysli sa vôňa spájala neoddeliteľne so smilstvom .	mysli	2	Loc
“ Chyť volant , “ povedal a otočil sa k zadnému sedadlu , kde mal športový vak .	vak	16	Acc
Alebo si ju stiahnite v súbore PDF na tej istej adrese .	súbore	5	Loc
Obyvatelia Makovej lúky sa kvôli tej ľudskej stope naozaj pripravovali na evakuáciu .	stope	7	Dat
Trvalá pozornosť bude venovaná rozvoju vzťahov s Ukrajinou , ktorá je naším najväčším susedom .	susedom	13	Ins
Hlas na druhom konci linky patril Lori .	linky	4	Gen
Neveríme princípom angsocu .	princípom	1	Dat
Zovrel ju v náručí a vtedy zistil , že bozkáva živú , teplú tvár .	tvár	13	Acc
Najracionálnejší prístup k vojne majú podrobené národy sporných území .	národy	6	Nom
Cítil som vôňu jeho tela , ktorá bola premiešaná so zápachom tabaku a alkoholu .	zápachom	10	Ins
Aladin sa zakrádal hore po schodoch s Abuom na pleci .	schodoch	5	Loc
Kvietky na lúke sú bohaté .	lúke	2	Loc
Prikázal dopravnej čate , aby ju premiestnila , ale keďže bola veľmi ťažká , robotníci ju občas postavili na zem .	čate	2	Dat
Mušiakovi Pavlovi sa mušia slečna zapáčila na prvý pohľad .	slečna	4	Nom
Ja som zatiaľ porovnal jej tvár so Soninou .	tvár	5	Acc
S cieľom vyhľadávať námety pre kritiku .	kritiku	5	Acc
“ Ako ti chutí čaj ? “	čaj	4	Nom
Nádej na jednotu je preč .	Nádej	0	Nom
Vymenoval som štyri číslice , ktoré tvorili číslo mojej izby .	číslice	3	Acc
Zmĺkla som , lebo som si spomenula , ako sa moja mama pustila do pečenia aj po dvoch šichtách .	šichtách	18	Loc
A zovrel som ruky za chrbtom , silne .	chrbtom	5	Ins
/ Vypitie čaše vína na schodisku chrámu pripomína obrady pohanských kolektívnych hostín , tzv . „ bratčín “ .	vína	3	Gen
“ Už dávno som opustila svoj roj , “ nesmelo odvetila Maja .	roj	6	Acc
Ako predpokladal , pán Charrington nerobil s prenájmom izby nijaké drahoty .	drahoty	10	Acc
Sadol som si k stolu , odkiaľ som mohol sledovať pohyb pred vchodom do televízie Sírius .	stolu	4	Dat
Položil som slúchadlo na vidlicu a uprel som zrak na telefón .	vidlicu	4	Acc
Našla som svojho osobného Spasiteľa , Ježiša Krista vo svetle Ježišovho evanjelia , v ňom som poznala posolstvo pokoja , lásky , radosti a šťastia .	pokoja	18	Gen
Nemám z toho dobrý pocit .	pocit	4	Acc
Tu sú niektoré súhrnné údaje .	údaje	4	Nom
Zbierka uvádza pravé i nepravé dekretály viacerých pápežov , ako aj početné dokumenty pojednávajúce o výnimočných právach rímskeho biskupa .	právach	16	Loc
NEVEDOMOSŤ JE SILA .	NEVEDOMOSŤ	0	Nom
Keď pozrela pod seba , zistila , že uviazla v pavúčej sieti .	sieti	11	Loc
Deti sú v prevažnej miere rímokatolíci .	Deti	0	Nom
Avšak rodine malého paviána sa nepáčilo , ako sa Jane správa k ich mláďaťu a nazlostení začali dievčinu prenasledovať .	mláďaťu	13	Dat
Pokračovali sme v pití mlčky , sediac proti sebe .	pití	3	Loc
Stále som mal pred sebou obraz ženy v medailóne .	medailóne	8	Loc
Jej vládcov nespájajú pokrvné zväzky , ale príslušnosť k spoločnému učeniu .	vládcov	1	Acc
Kacírstvom nad kacírstva je zdravý rozum .	Kacírstvom	0	Ins
Zato na perách mal akýsi poprašok .	perách	2	Loc
Na lúke vrcholili prípravy na dožinkovú slávnosť .	prípravy	3	Nom
Hore budeš v bezpečí . “	bezpečí	3	Loc
Našej susedke - záhradkárke sa naše mičurinčenie ale veľmi nepáčilo .	susedke	1	Dat
Mám osem nôh , osem očí a sedem chutí .	chutí	8	Gen
" Len preto , že uprednostňujem klad pred záporom .	záporom	8	Ins
Keď prišli títo ľudia , bol som na vrchole nervového vyčerpania .	vrchole	8	Loc
Bežali kľukatými cestičkami , až prišli k prijímacej sieni .	sieni	8	Dat
Keď sme asi hodinu kráčali po ceste pre vozy , mama odbočovala ku kravínom a ja som išla ďalej do školy .	školy	20	Gen
1 . zázračné vyberanie obilia a rýb spoza ženských pliec .	pliec	9	Gen
V tomto prestrojení si ma počkala pri Truhlíkovej posteli .	prestrojení	2	Loc
Vtedy však Winston spozoroval výhonky vrbiny , ktoré vyrastali z prasklín brala pod nimi .	prasklín	10	Gen
Na rube sa nachádza postava vcelku s vladárskou korunou , kopiou a štítom , obkolesená zrkadlovým gréckym nápisom „ Dimitrij “ .	korunou	8	Ins
Pani učiteľka sa usmievala a pousádzala ich okolo stola .	stola	8	Gen
Prinesie na oltár lásky obeť tým , že odpoveď začne najhorším .	oltár	2	Acc
Zmocnil sa ma nevysvetliteľný strach , mal som pocit , že ju už neuvidím .	strach	4	Nom
STROMBOLI NEVERIL VLASTNÝM OČIAM , keď pred sebou zbadal dreveného panáčika .	OČIAM	3	Dat
Ležal v bezvedomí na zemi .	bezvedomí	2	Loc
Na okraji studne sedel zelený žabiak s kockovaným klobúkom na hlave .	klobúkom	8	Ins
Bolo sivé popoludnie s oblohou veštiacou sneh , keď sa človeka zmocňuje ubíjajúca otupnosť a uvoľnenie prináša len alkohol .	popoludnie	2	Nom
Nebolo tajomstvom , že odoslané listy sa bežne otvárajú .	tajomstvom	1	Ins
Ministerstvo mieru sa zaoberá vojnou , Ministerstvo pravdy lžami , Ministerstvo lásky mučením a Ministerstvo hojnosti hladomorom .	lžami	8	Ins
Nastala chvíľa , aby princeznú vrátili kráľovi a kráľovnej .	chvíľa	1	Nom
Vláda uskutoční revíziu úradov , pripraví zmeny v pracovno - právnej legislatíve a uskutoční reorganizáciu štátnej správy .	reorganizáciu	14	Acc
Nemal najmenšie pokušenie jej klamať .	pokušenie	2	Acc
Súčasné ľudské poznanie je na veľmi vysokej úrovni , stojí na prahu klonovania nového života .	úrovni	7	Loc
Spomínala na všetkých kamarátov i na to , ako mohla byť aspoň na chvíľočku kapitánom mravcov .	mravcov	15	Gen
Urobila som adventný veniec a zavesila na dvere .	veniec	3	Acc
Zúfalo trepal vo vzduchu nôžkami .	nôžkami	4	Ins
Herkules prišiel do podsvetia vo chvíli , keď Megina duša vošla do Hádesovej jaskyne smrti .	podsvetia	3	Gen
Odporná extáza strachu a pomstychtivosti , túžba zabíjať , mučiť , drúzgať tváre kováčskym mlátom akoby preskočila sťa elektrický prúd na všetkých a premenila každého aj proti jeho vôli na vrieskajúceho pomätenca s pokrivenou tvárou .	extáza	1	Nom
Unaveným krokom som vyšiel po schodoch nášho domu .	schodoch	5	Loc
Chcem dokončiť prácu z angličtiny .	angličtiny	4	Gen
Cvrlikanie cvrčkov je oveľa príjemnejšie .	Cvrlikanie	0	Nom
“ V lese nie je , “ povedala ozvena z lesa .	lese	2	Loc
Vláda predloží zákon o zdravotníckych povolaniach a zariadeniach definujúci úlohy poskytovateľov a zdravotníckych pracovníkov .	poskytovateľov	10	Gen
Johansson je proti vysokým platom	platom	4	Dat
Vzdialené tóny .	tóny	1	Nom
V ten večer sa v paláci zhromaždili všetci dvorania , keď princezná Zornička tancovala s princom Filipom .	večer	2	Acc
Blythe plesla rukou po sedadle a otočila sa ku mne .	rukou	2	Ins
Možno to bola tlmená ozvena nevedomia .	nevedomia	5	Gen
Zrejme nepostrehol Winstonovu belasú kombinézu .	kombinézu	4	Acc
Prvým výskumníkom , zaoberajúcim sa novgorodskými pečaťami bol P . Lichačev , ktorý do roku 1917 objavil šesťsto kusov .	kusov	18	Gen
Až potom zašiel mesiac za mraky .	mraky	5	Acc
Intenzívne sa pamätám na prístavbu javiska k cirkevnej sieni na evanjelickej fare .	fare	11	Loc
Vláda bude pokračovať v znižovaní miery prerozdeľovania prostredníctvom verejných financií .	prerozdeľovania	6	Gen
Smutným hlasom im Kasandra oznámila , že v noci navšítvili komoru s medom zlodeji a spôsobili im veľkú škodu .	hlasom	1	Ins
Keď auto odišlo , ulica sa vyprázdnila .	auto	1	Nom
Otvoril mešec a vysypal zlaté mince na zem .	mince	5	Acc
Vráť sestričke jej čokoládu ! "	čokoládu	3	Acc
Vtom Stromboliho dobrá nálada akoby zázrakom zmizla .	zázrakom	5	Ins
Počula som neznáme vrčanie a z diaľky sem doliehala hudba .	diaľky	6	Gen
Potkany by ho určite napadli a zakrátko by ho obžrali na kosť .	kosť	11	Acc
Ide o autografy Kosťu a Vojatu so schematicky načrtnutými krížmi .	autografy	2	Acc
Vnútil mi liace a koč s tým divým koňom .	koňom	8	Ins
Zabrániť nešťastiu bola konice ‐ koncov jeho povinnosť .	nešťastiu	1	Dat
Porota však ocenila práce slimákov Šuchtáka a Plazivca , ktorý si prekrásne vymaľovali domčeky .	Porota	0	Nom
Ale sukničku s volánikmi horko ‐ ťažko uniesla .	sukničku	1	Acc
Vysoko na oblohe uprostred jasných hviezd žiaril guľatý mesiac .	oblohe	2	Loc
Bol v cele bez okien , s vysokým stropom a so stenami z lesklého bieleho porcelánu .	cele	2	Loc
V hrobovom tichu .	tichu	2	Loc
Bol v tom kus pravdy .	kus	3	Nom
Prišli pokušenia , zvody a ony podľahli .	pokušenia	1	Nom
“ Mal som iba dvoch zákazníkov , ženu a muža .	ženu	7	Acc
Rovnakého problému sa týka i posledný z ostrihomských kánonov , ktorý sa venuje vlastnému ordinačnému právu .	právu	15	Dat
Tisíce áut .	áut	1	Gen
Dvojtvárnosť trickstera súvisí s celkovým dualizmom , prítomným v systéme prírodného polyteizmu .	systéme	9	Loc
Telový gel , šampón ?	gel	1	Nom
Druhou činnosťou , ktorú v Ostrihome klerikom zakázali , bolo úžerníctvo .	klerikom	6	Ins
Sneh trval na tom , že musím zostať v tejto pasci .	Sneh	0	Nom
Slovenská republika prekonala obdobie spochybňovania demokratických inštitúcií a ohrozovania demokratických slobôd .	inštitúcií	6	Gen
Položil som slúchadlo na vidlicu a uprel som zrak na telefón .	slúchadlo	2	Acc
Teraz ma už niekoľko dní sprevádzal letmý dotyk Faikiných pŕs , dotyk jej rúk .	pŕs	9	Gen
Keď prišli na miesto , Alfonz stál v korune stromu .	stromu	9	Gen
JACKIE CHAN AN DIVOKOM ZÁPADE	ZÁPADE	4	Loc
A keď sa Dolora na znak pochopenia spýtala Toma na jeho meno , neodpovedal jej ani on .	znak	5	Acc
Veľký brat je zovňajšok , v ktorom sa Strana ráči ukazovať svetu .	svetu	11	Dat
Pokračovali v pomalej chôdzi po chodbe , keď vtom sa O ' Brien zastavil .	chôdzi	3	Loc
Vyžaduje mnoho trpezlivosti , pokánia , sebazapierania a vernosti .	sebazapierania	6	Gen
Najprv sme sa pomaly a opatrne zakrádali k ich domu , ale potom sme prebiehali od lampy k lampe .	lampe	18	Dat
Umožniť jazykovedcovi rozhovoriť sa o systéme v jazyku , prináša zdanlivo nebezpečenstvo , že sa vstúpi do nezaujímavého a nudného sveta .	jazykovedcovi	1	Dat
Rovnako prirodzené bolo , že zablúdila očami k fľaši s vodkou značky Smirnoff na stole .	očami	6	Ins
Nakrúcanie by sa malo začať v apríli v Luxemburgu .	Nakrúcanie	0	Nom
Nakoniec som jej povedal , že má pravdu , náš nový pokus bol bláznovstvom .	bláznovstvom	13	Ins
Chris ma chytil za ruku a kľúčik sme zvierali medzi dlaňami .	dlaňami	10	Ins
Podišli sme k pultu , kde som objednala tortillu so syrom .	syrom	10	Ins
Potom leteli ponad lúkou , až sa dostali k topoľovej aleji .	lúkou	3	Ins
Lákal ho nádherný palác v diaľke .	diaľke	5	Loc
Júlia merala všetko vlastnou sexualitou .	sexualitou	4	Ins
Dal som mu takéto meno , keď som s akousi ľahkosťou presvedčil sám seba , že toto meno najlepšie pristane môjmu hrdinovi .	ľahkosťou	10	Ins
“ Z očí mi vyhŕkli slzy .	slzy	5	Nom
Slovenská republika sa zapojí do snáh medzinárodného spoločenstva zameraných na riešenie globálnych problémov , ako sú boj proti organizovanému zločinu , medzinárodný terorizmus , ekologické riziká .	zločinu	19	Dat
Začali sme na kolotočoch , kde sme vyliezli na koňa .	koňa	9	Acc
Nastolíme po voľbách zmenu - odhalením zbohatlíkov , mafiánov , delikventov , korupčníkov a lobistov pri stálom sledovaní blaha občana .	odhalením	5	Ins
Stál tam v otrhaných šatách , aké nosieval , keď sa túlal po uliciach .	šatách	4	Loc
Zostupujúc do hĺbok duševných priepastí , ( seba ) obnažuje , bičuje ( sa ) .	priepastí	4	Gen
Vláda podporí dosiahnutie kritérií európskej úrovne stavania , kvalifikácie firiem , úspor energie a energetickej certifikácie budov .	budov	16	Gen
Zaujímavá je tu otázka atribútov na obrázku .	atribútov	4	Gen
Ich najnovší projekt sa volá Tanečný dom .	dom	6	Nom
Zbehom a pútnikom vo filmoch a knihách trvá návrat do rodnej obce neraz celé desaťročia .	Zbehom	0	Dat
Nie nadarmo som v mladosti , ešte pred Tomom Jonesom , býval priaznivcom Adriana Celentana .	priaznivcom	12	Ins
Stlmil hlas ako človek , ktorý z odborných dôvodov musí pred lekárom povedať niečo hrubé .	lekárom	11	Ins
Zničená som si prisahala , že si cez obedňajšiu prestávku zaplávam a budem trénovať obrátky dovtedy , kým ich nezvládnem .	obrátky	14	Acc
Pozvala na ňu Blythe a Ricka a podávala moje obľúbené jedlá : zemiakovú kašu , pizzu , celozrnný chlieb , španielske chimichangas , makaróny so syrom a orechový koláč .	kašu	13	Acc
Po drevenom schodišti som zišiel do salóna na prízemí .	schodišti	2	Loc
Napriek všetkému Delina nevenuje tomuto človeku pozornosť .	človeku	5	Dat
Voš žijúca v lone vystúpi nahor , na krk , voš z vlasov sa spustí dolu , na líce .	vlasov	12	Gen
Potom otvoril sklené dvere na terasu .	dvere	3	Acc
Na jednom z programov Českej televízie sa momentálne dá vidieť skvelá séria ľahkých , avšak nebulvárnych reportáží zo života s názvom Ta naše povaha česká .	reportáží	16	Gen
Vláda sa zároveň zaväzuje presadiť v zdravotníctve tvrdé rozpočtové obmedzenie tak , aby od roku 2004 nedochádzalo k tvorbe nového dlhu .	tvorbe	18	Dat
Keď prišli na miesto , Alfonz stál v korune stromu .	korune	8	Loc
Napriek všetkému úsiliu sa príbuzným Sergeja Duku nepodarilo zistiť u kompetentných orgánov nijaké podrobnosti .	úsiliu	2	Dat
Celkom mi vyfučalo z hlavy , že som sa s ňou mala stretnúť v knižnici .	knižnici	14	Loc
Iba na začiatku textu zbierky je akýsi tematický zoznam , pri jednotlivých častiach ktorého sú uvedené čísla „ kánonov ” , vzťahujúcich sa k tomu - ktorému tematickému okruhu .	okruhu	28	Dat
Aby anonym urobil svoje obvinenie dôveryhodným , uvádzal iniciálky tej ‐ ktorej ženy a z tohto hľadiska mala Marga dôvod podozrievať ma .	iniciálky	8	Acc
Hook sa otočil k pirátovi Smíovi a posmešne napodobnil dievčatko .	pirátovi	4	Dat
Niekoľko dvojíc tancovalo , iní sa bavili pri stoloch a bolo tam veselo i príjemne .	stoloch	8	Loc
Na môj zarazený pohľad odpovedala pozvaním : Ak túto sobotu nepôjdeš domov do Tirany , príď sem .	sobotu	9	Acc
Winston zdvihol šálku džinu , chvíľku naberal odvahu a potom obrátil do seba to tekuté svinstvo , ktoré malo pachuť oleja .	oleja	20	Gen
Veľkú tašku hodil do kúta a mľaskavo ho pobozkal .	kúta	4	Gen
Osobitnú pozornosť bude vláda venovať legislatíve a legislatívnemu procesu .	legislatíve	5	Dat
List bol adresovaný mojej mame .	mame	4	Dat
On – Kristus je novou možnosťou orientácie , cestou znovuzrodenia , novej nádeje a lásky , ktorá hľadá tých , ktorí sú na ceste rezignácie , ubití ľudským egoizmom a hriechom .	egoizmom	28	Ins
Ja to viem , prehovoril som po dlhom váhaní .	váhaní	8	Loc
O týždeň sme sa dozvedeli , že ju na rok vylúčili z fakulty .	týždeň	1	Acc
Vláda vytvorí podmienky pre uskutočnenie úspešného referenda o vstupe do EÚ , ktoré bude dokumentovať udržanie širokej podpory verejnosti tomuto historickému kroku .	udržanie	15	Acc
Rovnakú spoluprácu so svetským sudcom predpokladajú v citovaných ustanoveniach aj sledované súdobé cirkevnoprávne príručky .	ustanoveniach	8	Loc
Vláda však v tejto súvislosti zastáva názor , že NATO i naďalej zostane hlavnou inštitúciou , prostredníctvom ktorej budú európski a severoamerickí spojenci i naďalej riešiť bezpečnostné otázky transatlantického rozmeru .	inštitúciou	14	Ins
V popoludňajšej tíši prekvapovala hlasitosť jeho zvuku .	tíši	2	Loc
Omar ležal chvíľu roztiahnutý na zemi .	chvíľu	2	Acc
O ' Brien mu položil ruku na rameno takmer priateľsky .	ruku	5	Acc
Na chvíľu privrel viečka .	chvíľu	1	Acc
V prúde krvi a slín mu z úst vypadli dve polovice zubnej protézy .	slín	4	Gen
Prečo sa potom letopisec zaoberá ešte akýmsi medveďom ?	medveďom	7	Ins
V uhorských zákonníkoch sa stanovenie týchto pôstnych období objavuje už u sv . Štefana .	stanovenie	4	Nom
Keď som sa vrátila domov , vzala som tranzistor a sadla som si k obloku .	obloku	14	Dat
Winston ho pozoroval kútikom oka .	oka	4	Gen
Stále mala na sebe služobnú uniformu , čiernu sukňu a letnú bielu blúzku s krátkymi rukávmi .	rukávmi	15	Ins
Dodržiaval som toto pravidlo , odkedy som napísal prvú hlúposť z toho cyklu , krátku esej s dlhým názvom Orgazmus alebo Hrôza zo sexuálneho vyčerpania .	hlúposť	9	Acc
Niečo v jej posunku mu naznačilo , že sestrička umiera .	posunku	3	Loc
A začal som chodiť hore ‐ dole po izbe .	izbe	8	Loc
Si drúk , povedal som tomu ksichtovi v zrkadle .	zrkadle	8	Loc
Ako vznikol život na našej planéte ?	planéte	5	Loc
Ťahal voz dovrchu naložený melónmi .	melónmi	4	Ins
Duchovní v tejto funkcii sa netešia veľkej úcte , sú ohováraní svojimi nevoľníkmi , mučení a zabíjaní .	nevoľníkmi	12	Ins
Niekto z mojich niekdajších šéfov , vedúcich kádrového oddelenia alebo veliteľov na vojenských cvičeniach .	šéfov	4	Gen
Chvíľu tam ležal akoby omráčený , pričom mu z úst a z nosa stekal pruh tmavej krvi .	Chvíľu	0	Acc
Súčasťou návrhu bude aj kontrolný a monitorovací mechanizmus efektívneho využívania nástrojov podpory regionálneho rozvoja .	nástrojov	10	Gen
V podstate som blufovala .	podstate	1	Loc
Potom sa moja fantázia zmiatla .	fantázia	3	Nom
Jediným mávnutím zázračnej palice premenil reťaze na zlatú korunku .	mávnutím	1	Ins
Podišla som ku kuchynskej doske a zapla rádio .	doske	4	Dat
“ Kvak , “ zvolala na krtka žaba , “ počkaj , pomôžem ti .	krtka	6	Acc
Na chvíľu zdvihol hlavu ; opäť ten nepriateľský záblesk .	záblesk	8	Nom
Náklady na sociálnu solidaritu budú hradené z jasne pomenovaných zdrojov .	solidaritu	3	Acc
Rovnako prekvapujúco dobre vedela rozprávať bez pohybovania perami .	perami	7	Ins
Nestoja totiž v opozícií voči sebe na rovine ideí a ideológie , ale voči zástupcom orgánov svetských .	zástupcom	14	Dat
Tigríča sledovalo , ako sa rozkotúľali , a skočilo medzi ne !	Tigríča	0	Nom
Za veľkými stolmi sedeli princovia a šľachtici .	šľachtici	6	Nom
Za jej chrbtom mi zostala v zábere Talianova tvár .	tvár	8	Nom
A predsa , po prečítaní vedel , že nie je blázon .	blázon	10	Nom
Očakával náš príchod .	príchod	2	Acc
Vedel dôvod . Šírila okolo seba atmosféru hokejového ihriska , studených kúpeľov , spoločného stopovania a akejsi všeobecnej čistoty mysle .	kúpeľov	11	Gen
“ Podávajú sa raňajky , “ povedal .	raňajky	3	Nom
Vláda pripraví podmienky pre sústredenie kompetencií v oblasti regulácie a koordinácie elektronickej komunikácie a rozvoja informačnej spoločnosti z rôznych orgánov na jeden regulačný orgán .	orgánov	19	Gen
Ležala som na doske a pozerala naňho .	doske	3	Loc
A tak sa na Rusi v tomto období stretávame s uctievaním pohanských bohov v novom rúchu .	rúchu	15	Loc
V oblasti prepravných povolení v cestnej doprave sa realizuje nový transparentný systém založený na princípe nárokovosti pri splnení požadovaných kritérií a podmienok	princípe	14	Loc
Avšak hoci som sa strácal v tieni režisérov a hviezd filmového plátna , netrápil som sa .	režisérov	7	Gen
Čakal som v obývačke , mal som na sebe oblek s kravatou .	obývačke	3	Loc
Že Mečiar , suverénny víťaz prvého kola , v druhom kole bol spektakulárne odmietnutý , je spravodlivý trest za roky jeho vládnutia .	kola	6	Gen
Jeden z nich si sadol do vedľajšieho kresla .	kresla	7	Gen
V každom prípade musím otvoriť oči a nesmiem veriť legendám .	legendám	9	Dat
Marga neverila jej klamstvám , ja som ich prijímal .	klamstvám	3	Dat
Taktáto blízkosť funkcií vedie k ľahkej zameniteľnosti šamana za mnícha .	zameniteľnosti	6	Dat
Od straníkov sa vyžadoval podobný názor , aký mali starovekí Židia , ktorí síce vedeli , že všetky iné národy uctievajú nepravých bohov , ale to bolo všetko , čo o nich vedeli .	straníkov	1	Gen
Zároveň však Cluny urobilo veľký krok na ceste k libertas , lebo vytvorilo spoločenstvo ( zväčša ) úplne slobodných kláštorov , ktoré nepodliehali laikom .	laikom	23	Dat
Tentoraz mu ju však pripomenula najmä dusná horúčava toho popoludnia , keď mu na čele vyrazili kropaje potu .	horúčava	7	Nom
V okne na prvom poschodí zbadala uväznenú cvrčicu .	okne	1	Loc
Je známe , že hlinené nápodoby medvedích láb , slúžili na ochranu domáceho krbu .	nápodoby	5	Nom
Táto výsada zahŕňa najmä , stručne povedané , právomoc uhorského panovníka zriaďovať vo svojej krajine nové diecézy a právomoc dosadzovať biskupov a ďalších vyšších cirkevných hodnostárov do svojich úradov .	právomoc	8	Acc
Pomaly vstala a po niekoľkých knísavých krokoch zasa našla rovnováhu .	rovnováhu	9	Acc
Minule sa môj kolega Rado Ondřejíček fejtónovým perom pustil do problému hlupákov medzi nami .	kolega	3	Nom
Prichádzali sme zozadu , a tak sme sa vyhli autobusom , autám a nápisom nad vstupom .	autobusom	9	Dat
Aj keď mi jeho správanie pripadalo čudné , obdivovala som jeho odhodlanie .	správanie	4	Nom
Chris pokrútil hlavou .	hlavou	2	Ins
Podpredsedom pre ekonomiku je V . Oberhauser .	ekonomiku	2	Acc
Navoskované hlavičky zápaliek chránia pred namočením .	hlavičky	1	Nom
Všetky ďalšie uhorské právne normy , ktoré reglementujú život kláštorných spoločenstiev nachádzame potom až medzi kánonmi I . ostrihomskej synody .	kánonmi	15	Ins
Zlá víla vedela , že iba on môže zrušiť kliatbu , ktorou Zorničku zakliala .	kliatbu	9	Acc
Mauglí natešene vykríkol , vyskočil medveďovi na brucho a pritúlil sa k nemu .	medveďovi	5	Dat
Deti si obľúbia veľký zobák pelikánej slečny a radi sa s ním zahrajú , keď uvidia slová KLIP ‐ KLAP !	zobák	4	Acc
Zaslané médium vám vrátime spolu s vyvolanými fotkami .	fotkami	7	Ins
Vláda bude i naďalej venovať sústredenú pozornosť podpore efektívnych programov boja proti drogám .	podpore	7	Dat
Ako sedemnásťročný sa stal okresným zakladateľom Antisexuálnej ligy mládeže , ako devätnásťročný navrhol nový druh ručného granátu , ktorý zaradilo do výzbroje Ministerstvo mieru a ktorý už pri prvej skúške jediným výbuchom zabil tridsaťjeden euroázijských zajatcov .	výbuchom	31	Ins
Kráčal chodbou s bielymi kachličkami a mal pocit , že sa prechádza na slnku , v pätách mu kráčal ozbrojený dozorca .	pätách	16	Loc
Naproti Hádovej vile .	vile	2	Dat
Nazlostený Džafar vyskočil z trónu , ktorý pripomínal kobru .	trónu	4	Gen
Ako starý priateľ tvojho nebohého otca považujem za potrebné , aby sme sa porozprávali celkom otvorene .	priateľ	2	Nom
Pred zotmením sa vracala domov a na noc starostlivo zatvárala škáročku v strome .	zotmením	1	Ins
U ugrofínskych národov fungoval orol ako predok a ochranca šamanov .	predok	6	Nom
Mal pocit , že ho v žalúdku páli oheň .	oheň	8	Nom
Prešla hodina , a mama nechodila .	hodina	1	Nom
Tomuto cieľu bola podriadená aj metóda ich spracovania .	cieľu	1	Dat
Nerovnosť bola cenou za civilizáciu .	civilizáciu	4	Acc
Odtiaľ som cez neveľké dvere , ktoré sme na noc zatvárali znútra hákom , vyšiel do dvora .	hákom	12	Ins
Priplával k okraju a stiahol polystyrénovú dosku .	okraju	2	Dat
Posledný szabolcsský kánon , ktorý sa venuje kláštornému životu nariaďuje opátom a mníchom , aby sa nezúčastňovali na kalendových sedeniach , ale aby prijímali oblácie ich účastníkov v kláštoroch .	mníchom	12	Dat
Zlý stav pečate znemožňuje podrobnejšiu analýzu .	analýzu	5	Acc
V Gregorovom ponímaní by to znamenalo komendovanie Uhorska sv . Petrovi , ktorého nástupca by vládcovi krajiny udelil kráľovskú korunu .	vládcovi	15	Dat
Je to pravda a nie je to pravda .	pravda	2	Nom
Vyvesili na tabuľu text , ale ani to nepomohlo , lebo Vilko sa z lenivosti nenaučil dobre čítať .	lenivosti	14	Gen
Zrazu Tayerle stratil prehľad , kde je , ale v triede bolo ticho .	prehľad	3	Acc
Pôvodná hudba k muzikálu , alebo komédii : Princ egyptský	komédii	6	Dat
Do hrdinského zápasu o dva litre mlieka som sa zapojil , keď sa narodil Tom .	litre	5	Acc
Dlho sedela na kraji lesa a pozerala , ako zlaté klasy zľahka povievajú v letnom vánku .	kraji	3	Loc
To je asi burina .	burina	3	Nom
Opatrne ju položil na zelené súkno .	súkno	5	Acc
Hra na hudobné nástroje , vozy ako prostriedok na prekonávanie vzdialeností by mohli svedčiť i o narážke na potulných hudcov ‐ igricov , ktorí sú chápaní v celoeurópskom kontexte ako elementy , rušiace zabehaný poriadok .	kontexte	28	Loc
Ale mohli to byť aj prvé minúty januára .	minúty	6	Nom
Keď vystúpila z pásma žltkastého svitu a na chvíľu zastala na rozhraní medzi svetlom a temnotou , nemyslel som na to , že ide priamo ku mne , aby napravila chybnú interpretáciu vecí , ktorú vyprodukoval môj mozog .	temnotou	15	Ins
v prioritných oblastiach verejného záujmu musí byť verejný sektor schopný konkurovať súkromnému sektoru pri získavaní a udržaní kvalitných ľudských zdrojov	udržaní	16	Loc
Nielen na zdravie , ale aj na víťazstvo nad otrokármi .	otrokármi	9	Ins
Bol to pochmúrny deň , oblaky viseli nízko , smerom k močiaru udierali blesky .	močiaru	11	Dat
Chcel byť so svojou rodinou a chcel ostať v džungli .	džungli	9	Loc
Však vieš , že sa tá zbierka robí od domu k domu .	domu	11	Dat
Keď sa našli uprostred mladiny , obrátila sa k nemu tvárou .	mladiny	4	Gen
Pred naším domom sme sa zvalili do trávy .	domom	2	Ins
Alebo si ju stiahnite v súbore PDF na tej istej adrese .	adrese	10	Loc
Vláda pripraví aktualizáciu národnej stratégie prevencie kriminality a vytvorí legislatívne podmienky na jej realizáciu .	prevencie	5	Gen
“ Prv ako som dopovedala , zmocnili sa ma výčitky , že som mala byť inde a venovať sa učeniu .	učeniu	19	Dat
Trendy regionálneho rozvoja vo vyspelých štátoch sú založené na využití vnútorných zdrojov regiónu .	rozvoja	2	Gen
Príležitosť na zmenu imidžu sa mi naskytla o tri týždne .	týždne	9	Acc
Na stoloch stáli všelijaké fľaštičky a v bankách bublali záhadné tekutiny .	fľaštičky	4	Nom
Marketing je súborom disciplín , ktoré sa zaoberajú trhom a v trhovej ekonomike človek má cenu , ktorá sa vyjadruje len peniazmi .	Marketing	0	Nom
Nasleduje objavenie sa volchva v Rostove , udalosti v Polocku , sucho a Polovci .	udalosti	7	Nom
Kráčal po chodbe a očakával guľku .	chodbe	2	Loc
Skupina kánonov I . ostrihomskej synody sa venuje stanoveniu obsahu bohoslužieb a príbuzným kultovým predpisom .	Skupina	0	Nom
Sultán pozrel dcére cez plece .	plece	4	Acc
Na hlavnej stránke v pravom menu je ikona určená pre registráciu nového používateľa .	používateľa	12	Gen
Rozsiahla a pomerne dobre organizovaná archeologická práca na teritóriu bývalého ZSSR , detailne zachytená v materiáloch časopisu „ Sovetskaja Archeologija “ / od roku 1990 Rosijskaja Archeologia / ho dáva k dispozícií veľké množstvo .	dispozícií	31	Dat
Prirodzeným dôsledkom takéhoto stretu je rozbíjanie vervi a úsilie o znevoľnenie smerdov .	vervi	6	Gen
Chvíľami mu na náprsenku kombinézy kvapol pramienok krvi .	náprsenku	3	Acc
S odporným škrekotom z nej stúpali čarodejné výpary .	škrekotom	2	Ins
Jedlo je na stole za necelú polhodinu .	stole	3	Loc
Nerovnosť bola cenou za civilizáciu .	cenou	2	Ins
Prúd mojej energie sa jej vylial na prsia .	prsia	7	Acc
1 . zázračné vyberanie obilia a rýb spoza ženských pliec .	obilia	4	Gen
Kaviareň preťal akýsi elektrický náboj .	náboj	4	Nom
Po oblohe plávali sivé mračná a každú chvíľu menili tvar .	oblohe	1	Loc
Do dvoch rokov ju tie jej decká udajú Ideopolícii .	decká	6	Nom
Triedenie kvalitatívne , podľa druhu nálezu .	nálezu	5	Gen
Pegas naletel každej krásnej hrive a nasledoval kobylu do neďalekej stajne .	hrive	4	Dat
Prívesky podobného typu boli nájdené vo vladimírskych kurganoch a v Jaroslavli .	kurganoch	7	Loc
Poďakovanie patrí aj posudzovateľom rukopisu – pánovi prof . PhDr . Richardovi Marsinovi , DrSc . a pánovi PhDr . Jánovi Steinhübelovi , CSc . , ktorí mi pomohli vylepšiť text svojimi cennými postrehmi .	postrehmi	33	Ins
Pripadalo mu to , akoby sa džungľou rútili tisíce zvierat .	džungľou	6	Ins
Šikovne využil pobyt folklórnych skupín a súborov z celého Slovenska v Bratislave , ktoré sem chodili na náklady Opusu alebo rozhlasu nahrávať platne .	platne	22	Acc
O chvíľu prišiel k stánku chlapec v otrhaných zaplátaných šatách .	stánku	4	Dat
Vláda si uvedomuje , že súčasťou problémov v rezorte zdravotníctva a dôvodom nespokojnosti obyvateľstva je vysoká miera korupcie .	dôvodom	11	Ins
V 19 . storočí dochádza v Bengálsku k úpadku feudalizmu .	feudalizmu	9	Gen
Prítomnosť nálezov kačacích príveskov sa vysvetľuje tiež importom zo Škandinávie , prostredníctvom nápodoby laponských a karelských kovolejárov .	importom	7	Ins
V poslednom čase ju Ministerstvo hojnosti veľmi obľubovalo .	Ministerstvo	4	Nom
Bojoval proti vykorisťovaniu v indickej spoločnosti , proti krviprelievaniu medzi hinduistami a moslimami , proti vojne , za politickú nezávislosť svojej krajiny .	hinduistami	10	Ins
Vedomie más treba ovplyvňovať len negatívnym spôsobom .	más	1	Gen
Pegas naletel každej krásnej hrive a nasledoval kobylu do neďalekej stajne .	kobylu	7	Acc
Keď ju vyvreskúvali stovky hrdiel za dupania pochodujúcich nôh , zmocňovala sa človeka hrôza .	hrdiel	4	Gen
Konfirmáciou sa začína skutočný boj s hriechom , diablom a vlastným telom .	diablom	8	Ins
Sudcovi sa jej smelosť páčila , a tak súhlasil .	Sudcovi	0	Dat
Príslušníka vojenskej polície , poľovníka a manželský pár v stredných rokoch .	poľovníka	4	Acc
Hneď sa vybral za Matúšom do prasačieho chlieva a pozval ho k sebe na celých osem dní !	chlieva	7	Gen
“ Prosím vás pekne ! “ zvolal lúčny koník Flip .	koník	8	Nom
Bronzová čaša , zdobená rúčkou s vtáčikom pripomína uctievanie vtákov u ugrofínskych národov — ak karelský poľovník zabil vtáka čakalo ho nešťastie .	čaša	1	Nom
Keď sme vychádzali z izby , že pôjdeme k autu , uvidel som vec , ktorá zvrátila ten večer nepredvídaným smerom .	autu	9	Dat
Prijatie novely zákona o štátnej službe umožní okrem iného zamestnanie špičkových odborníkov v ústredných štátnych orgánoch za adekvátneho mzdového ohodnotenia a odstráni nepružnosť zamestnávania v štátnej službe .	nepružnosť	22	Acc
V deň , keď som prišiel do bábkového divadla sám , pochopil som pravdu : naše správanie bolo škandalózne , skôr či neskôr by si nás všimli .	divadla	8	Gen
Pred štartovacím stolčekom sa vytvoril dlhý zástup .	stolčekom	2	Ins
Nárazuvzdornosť a odolnosť voči vlhkosti .	Nárazuvzdornosť	0	Nom
“ Bomba ! “	Bomba	1	Nom
Jeho reliéf bol v mojom vnútri .	reliéf	1	Nom
Na niektorých uliciach metropoly sa matky ani na chvíľku neodvážia nechať svoje bábätká samotné .	bábätká	12	Acc
Nikdy som sa nezaoberal otázkami vlastnej tvorby jazyka . "	otázkami	4	Ins
Do minúty zhorí na popol .	minúty	1	Gen
Keď práve nemala v ústach štipec na bielizeň , mohutným kontraaltom spievala :	kontraaltom	10	Ins
" Koľko prstov zdvíham , Winston ? "	prstov	2	Gen
Skvelý psychológ , vyvolávač hrôzy , zaklínač šialenstva .	hrôzy	4	Gen
Lavdima Lavdoshaja zaraďovali k príslušníkom konzervatívneho krídla .	príslušníkom	4	Dat
Položil to na vzdialenejší stôl .	stôl	4	Acc
Tá rozprávka ma priviedla na inú stanicu .	rozprávka	1	Nom
Prichádzali sme zozadu , a tak sme sa vyhli autobusom , autám a nápisom nad vstupom .	autám	11	Dat
Decentralizáciou kompetencií sa presunula podstatná časť zodpovednosti za rozvoj bývania na obce .	bývania	9	Gen
" Ste pripravení obetovať svoje životy ? "	životy	5	Acc
Zaštebotal dobrý deň a cmukol mužovi na líce veľký uslintaný bozk .	mužovi	5	Dat
Povedal som to nezrozumiteľnou , smiešnou ruštinou .	ruštinou	6	Ins
SLOBODA JE OTROCTVO	SLOBODA	0	Nom
Spravované prostriedky poistencov dosahujú objem 200 mil .	poistencov	2	Gen
Chrobák zhovievavo pokrútil hlavou .	Chrobák	0	Nom
Mal pocit , že ho v žalúdku páli oheň .	pocit	1	Acc
Niet pochýb , že mi ju poslala do cesty prozreteľnosť .	pochýb	1	Gen
Doktor zostal v rozpakoch .	rozpakoch	3	Loc
Potom Maja s kamarátmi pomáhala stroskotancom z vody na nové plavidlo .	stroskotancom	5	Dat
Objala ma okolo krku .	krku	3	Gen
Tá za desaťročia sústredeného výskumu vyprodukovala stovky monografických a časopiseckých spracovaní danej témy .	výskumu	4	Gen
Pred dvermi sa objavovali košíky s prekrásnymi plodmi od výmyslu sveta .	plodmi	7	Ins
Bol rehoľníkom v niekoľkých kláštoroch v Itálii i Hispánii , no oveľa viac ho priťahoval eremitský spôsob života .	rehoľníkom	1	Ins
Presne takúto podobu , teda jednoduché príkazy či predpisy , majú i príslušné nariadenia v sledovaných kánonickoprávnych zbierkach .	predpisy	8	Acc
Sedeli sme pri stole oproti sebe .	stole	3	Loc
Na obidvoch stranách ulice , kde sa chodci náhlili po chodníkoch , parkovali autá .	ulice	3	Gen
Pri ďalšej skúške vymenila slák za golfovú palicu , takže Klotilda musela kričať a prišla o hlas .	skúške	2	Loc
Boj proti hospodárskej korupcii	korupcii	3	Dat
Vláda využije všetky možnosti na zintenzívnenie stykov s Poľskom a Maďarskom a je pripravená aktívne sa podieľať na efektívnom a pragmatickom fungovaní vyšehradskej spolupráce .	stykov	6	Gen
Išla prvá , ja za ňou a ocitli sme sa uprostred izby .	izby	11	Gen
Pôvabne sa vzniesol do vzduchu , zatrepotal krídlami a bol preč .	krídlami	7	Ins
“ Prisahám na svoj včelí život , že môj kamarát stratil pri nehode vedomie a prebral sa iba zázrakom ! “	vedomie	13	Acc
Priplávala som ku kovovým schodíkom a s námahou som vystupovala von , keď ma striaslo .	schodíkom	4	Dat
Široký nôž sa pri používaní zle drží v ruke .	ruke	8	Loc
Vošla som do tichého bytu .	bytu	4	Gen
Ako zlodeji sme sa vyhýbali osvetleniu a snažili sa skrývať v bezpečí noci .	osvetleniu	5	Dat
Chan si zahrá Číňana , ktorý pricestuje na Divoký západ , aby zachránil unesenú dcéru čínskeho konzula .	konzula	16	Gen
Napriek maminým radám som pil .	radám	2	Dat
Do dvoch rokov ju tie jej decká udajú Ideopolícii .	Ideopolícii	8	Dat
Poďakovanie patrí aj posudzovateľom rukopisu – pánovi prof . PhDr . Richardovi Marsinovi , DrSc . a pánovi PhDr . Jánovi Steinhübelovi , CSc . , ktorí mi pomohli vylepšiť text svojimi cennými postrehmi .	pánovi	17	Dat
Bol to riskantný nápad , lebo nemusel vyjsť .	nápad	3	Nom
Čašník priniesol druhú whisky .	Čašník	0	Nom
Slnečný svit , ktorý prenikal nespočetným lístím , ich ešte stále pálil na tvárach .	svit	1	Nom
Cvrček pokračoval v hre na svojom krídle .	krídle	6	Loc
Pri realizácii zahraničnej politiky bude vláda SR venovať stálu pozornosť otázkam ľudskej dimenzie .	dimenzie	12	Gen
Jej vládcov nespájajú pokrvné zväzky , ale príslušnosť k spoločnému učeniu .	učeniu	10	Dat
“ Je v šoku , nehýbe sa , “ zistili mravce .	šoku	3	Loc
Cez deň prichádzala do triedy a patrila mne .	triedy	4	Gen
Po vypnutí obrazovky nastalo v miestnosti hrobové ticho .	miestnosti	5	Loc
Na prvý pohľad je tu zrejmá podobnosť so znením kánonov , ktoré sa týkajú rehoľníkov .	znením	8	Ins
Nálezy pečatí umožňujú určiť autorstvo , pravosť a čas vzniku dokumentu , dopĺňajú tak informácie o ňom .	dokumentu	10	Gen
Tak sa učili variť , robiť jednoduché kuchynské práce ako umývanie riadu , škrabanie zemiakov , krájanie chleba .	škrabanie	13	Nom
Mládež a šport	Mládež	0	Nom
Navyše , koniec 9 . a veľká časť 10 . storočia predstavujú aj vrchol úpadku stredovekého pápežstva .	pápežstva	16	Gen
Je to útok na súkromie .	útok	2	Nom
Zo záhybov svojej pamäti vydoloval niekoľko ďalších úryvkov zabudnutých riekaniek .	úryvkov	7	Gen
A za tým obrazom v tieni stála kolíska .	kolíska	7	Nom
“ To ti vo vode vrátim , “ povedala som .	vode	4	Loc
S letenkou v ruke som vyšiel z izby a zamieril k stolu , kde sedeli recepčné z môjho poschodia .	stolu	11	Dat
Ako s kamošom .	kamošom	2	Ins
Stiahol páku .	páku	1	Acc
Rád by som veril čestnosti politikov , ale realita na Slovensku je zatiaľ iná .	čestnosti	4	Dat
“ Prisahám na svoj včelí život , že môj kamarát stratil pri nehode vedomie a prebral sa iba zázrakom ! “	nehode	12	Loc
Sultán pozrel dcére cez plece .	dcére	2	Dat
Profesor Eugen Jóna , ktorý sa dejinami spisovnej slovenčiny dlhé roky zaoberal , si uvedomil potrebu dať do rúk slovenskej i medzinárodnej vedeckej verejnosti dostatočne prístupný skutočný text tohto základného diela .	text	27	Acc
Spoločne vyrazili jabĺčko babizne z ruky .	ruky	5	Gen
Nastolíme po voľbách zmenu - odhalením zbohatlíkov , mafiánov , delikventov , korupčníkov a lobistov pri stálom sledovaní blaha občana .	zbohatlíkov	6	Gen
Chvíľu sa preťahovali , až napokon odlomili panvici rúčku .	panvici	7	Dat
Potom Maju nežne pohladila po hlávke a vraví : “ Spoznáš krásny veľký svet , Maja , hrejivé slniečko a nádherné lúky plné kvetov .	hlávke	5	Loc
“ Chyť volant , “ povedal a otočil sa k zadnému sedadlu , kde mal športový vak .	volant	2	Acc
Zazrela som ho , keď vystrkoval z obloženia svoj odporný rypák .	obloženia	7	Gen
“ Tak tu si , poklad môj .	poklad	5	Nom
Podráždene meditoval o materiálnych stránkach života .	stránkach	4	Loc
Škole chýbali priestory , a tak žiaci prvého stupňa , čiže aj my prváčikovia , mávali vyučovanie popoludní .	Škole	0	Dat
Nateraz sa uzavrel pred vzdialenejšími zvukmi a počúval len kvákanie , ktoré sa valilo z obrazovky .	kvákanie	9	Acc
Chodia vôbec do školy ?	školy	3	Gen
Väčšie zlá sústavne unikali ich pozornosti .	pozornosti	5	Dat
Sankcia teda obsahuje v sebe ako hľadisko trestné , tak aj hľadisko náhrady škody pozostalým .	pozostalým	14	Dat
Jej telo akoby doňho prelievalo časť svojej mladosti a elánu .	elánu	9	Gen
S úsmevom vstal a oprašoval si zodraté , vyblednuté levisky .	levisky	9	Acc
Situáciu umožňujú skompletizovať archeologické vykopávky v Timerevskom hradisku .	hradisku	7	Loc
Herkulovi sa na tvári zračilo záhadné odhodlanie .	tvári	3	Loc
V poviedke s prevzatým názvom Prípad z praxe som mu dal meno Vehap .	praxe	7	Gen
Približovala sa k nemu zohnutá , popolavo sivá postava , ktorá pripomínala kostlivca .	kostlivca	12	Acc
Obrovský panter zdvihol košík a opatrne ho položil na breh .	košík	3	Acc
Každý zo stupňov svätenia od ordinanda vyžadoval , aby spĺňal príslušné predpoklady na jeho získanie .	predpoklady	11	Acc
Závidela som chalanom , tí sa majú .	chalanom	2	Dat
V Gregorovom ponímaní by to znamenalo komendovanie Uhorska sv . Petrovi , ktorého nástupca by vládcovi krajiny udelil kráľovskú korunu .	komendovanie	6	Acc
Bytová politika a príprava územia pre rozvoj bývania je prioritne úlohou obcí a miest .	príprava	3	Nom
Hľadala čosi v šatách , potom sa vrátila , usmiala sa , ľahla si a naznačila mi , aby som urobil to isté .	šatách	3	Loc
Nevznikla sama od seba , jej náväznosť na vierouku z desiateho storočia / i keď došlo k zrejmým posunom / svedčí o kontinuite jej vývoja .	posunom	18	Dat
Kým odletím do nebeského pekla , musím si odčiniť nejaké hriechy tu , v pozemskom pekle .	hriechy	10	Acc
Koberec , krištáľová guľa a niekoľko pomôcok na čarovanie .	pomôcok	6	Gen
Vtedy však zaznelo z obrazovky prenikavé pískanie .	obrazovky	4	Gen
Z balkóna utiekla , až keď som k odháňacím pohybom pridala aj hlasité zvukové efekty .	pohybom	9	Dat
Chvíľu som naňho uprene hľadela a uvedomila si , že hoci to myslel úprimne , nebola to pravda .	pravda	17	Nom
Chrobák zhovievavo pokrútil hlavou .	hlavou	3	Ins
Ako nejaká neviditeľná kamera .	kamera	3	Nom
Aby som sa definitívne vrátil do reality , na prvom poschodí výťah zastal .	poschodí	10	Loc
Pristáli sme u slimáka Oskara .	slimáka	3	Gen
“ Vezmi ju na preteky chrtov , “ navrhol Wayne Dean .	preteky	4	Acc
Maja zletela dole a po prvý raz vo svojom živote uvidela svätojánsku mušku .	mušku	12	Acc
Posledný szabolcsský kánon , ktorý sa venuje kláštornému životu nariaďuje opátom a mníchom , aby sa nezúčastňovali na kalendových sedeniach , ale aby prijímali oblácie ich účastníkov v kláštoroch .	opátom	10	Dat
PREČ S VEĽKÝM BRATOM !	BRATOM	3	Ins
" Zrejme ste dospeli ešte pred mojím narodením .	narodením	7	Ins
Zmienky o skúmanom fenoméne .	Zmienky	0	Nom
Hefaistos kul rýchlo blesky , ktoré bohom slúžili ako zbrane .	zbrane	9	Nom
Následky nárazu bývali rovnako kruté .	Následky	0	Nom
Tri uvedené stupne výskumu nás vedú ku konštatovaniu , potvrdzujúcemu úvodnú tézu o tesnej prepletenosti oboch systémov , obohatenému však poznaním vnútornej dynamiky jej vývoja .	konštatovaniu	7	Dat
“ Ty máš chlp ? “ vykríkla .	chlp	3	Acc
Naším zámerom je odstrániť najmä deformácie , ktoré zakladajú neopodstatnené nerovnosti medzi občanmi alebo zavádzajú do sociálneho systému cudzorodé prvky , akým je napríklad nesystémové včlenenie kúpeľnej starostlivosti do sociálneho poistenia .	starostlivosti	27	Gen
Tento chlapík sa nikdy autorke nepáčil .	autorke	4	Dat
Rád by som v tomto poďakovaní spomenul všetkých , ktorí akoukoľvek radou či pomocou prispeli ku zrodu predkladanej publikácie .	radou	11	Ins
Všetci vedeli , že na papieri sa každý kvartál vyrobili astronomické počty topánok , kým vari polovica obyvateľov Oceánie chodila bosá .	papieri	5	Loc
Prítomný je celý panteon vladimírovej pohanskej reformy .	panteon	3	Nom
V šalátovej mise zmiešajte olej , korenie , soľ , uhorku , cibuľu , petržlenovú vňať a bazalku .	mise	2	Loc
“ Tí psi sú dnes mojimi hosťami . “	hosťami	6	Ins
Jestvuje v pamäti .	pamäti	2	Loc
Dôverujem tomu zasľúbeniu , ktoré som prijala vierou .	zasľúbeniu	2	Dat
Neter môjho kamaráta je vysokoškoláčka .	vysokoškoláčka	4	Nom
" Pred ktorou vojnou ?	vojnou	3	Ins
Tyranizuje nás ťaživou krásou obrazov .	obrazov	4	Gen
Možnože dievča je jeho členkou !	členkou	4	Ins
Bežala k otvorenému oknu .	oknu	3	Dat
Dom bol v predstave vtedajších ľudí akýmsi mikrokozmom , svetom samým osebe s prepracovaným systémom magickej obrany pred zlými silami vonku .	systémom	14	Ins
Vláda však v tejto súvislosti zastáva názor , že NATO i naďalej zostane hlavnou inštitúciou , prostredníctvom ktorej budú európski a severoamerickí spojenci i naďalej riešiť bezpečnostné otázky transatlantického rozmeru .	rozmeru	29	Gen
Zo záhybov svojej pamäti vydoloval niekoľko ďalších úryvkov zabudnutých riekaniek .	pamäti	3	Gen
Plukovníkovi Hatímu sa zježil chobot .	Plukovníkovi	0	Dat
Hlavným motívom výletu bola rozprávka .	rozprávka	4	Nom
Na hrebeni sa otočil a zaparkoval autom celkom pri okraji cesty .	okraji	9	Loc
Obzvlášť odvtedy , čo som sa presťahovala do prízemného bytu po mojej starej tete , ktorá chovala a vykrmovala túlavé mačky z celého sídliska .	tete	13	Loc
Napriek týmto úžasným poznatkom vedy a techniky neexistuje zatiaľ žiadna definícia , čo je to život .	poznatkom	3	Dat
Rad sa predlžoval a čoskoro poskakovala po telocvični polovica študentov .	telocvični	7	Loc
Štúrovský nový slovenský spisovný jazyk má niekoľko vrstiev .	vrstiev	7	Gen
Kým sme sa dostali k ruskému kolesu , boli sme unavení , presladení a vysmiati .	kolesu	6	Dat
Ak nepočítam učebnice , až donedávna jediné knihy , ktoré držala v ruke , boli detské rozprávky .	ruke	12	Loc
Začala som výčitkami , ale teraz pokračujem radami do nového roku .	výčitkami	2	Ins
Maja si z celého srdca vydýchla a náhlila sa k potoku , aby tú radostnú novinu oznámila ostatným .	potoku	10	Dat
Technologické spracovanie vychádza z ľahkého špeciálneho penového plastu s otvorenými pórmi , ktorý je uzatvorený vo vzduchotesnom obale .	pórmi	10	Ins
Chcem poďakovať aj sestrám , ktoré sa podieľajú na upratovaní nášho chrámu .	sestrám	3	Dat
Nastala chvíľa , aby princeznú vrátili kráľovi a kráľovnej .	kráľovnej	8	Dat
Kaťa mi nedovolila pobozkať ju na pery .	pery	6	Acc
V temnej miestnosti blikalo iba svetlo sviec .	sviec	6	Gen
Nárazuvzdornosť a odolnosť voči vlhkosti .	vlhkosti	4	Dat
Konkrétnym príspevkom k prevencii konfliktov a k udržaniu mieru bude aj naďalej aktívna účasť v medzinárodných mierových operáciách .	príspevkom	1	Ins
Premiéra by mala byť už koncom roku .	Premiéra	0	Nom
Nimi vysvätení kňazi teda nie sú právoplatne vysvätenými a nemôžu teda veriacim sprostredkovať dary Ducha Svätého .	veriacim	11	Dat
Naproti Hádovej vile .	vile	2	Dat
V tom sne najsilnejší bol pocit sebaklamu , lebo v skutočnosti vedel , čo je za tým temným múrom .	múrom	18	Ins
V rohu na sklápacom stole v pološere sa jasne lesklo sklené ťažidlo , ktoré tam kúpil na poslednej návšteve .	rohu	1	Loc
Vláda Slovenskej republiky prizýva spoluobčanov k spolupráci .	spoluobčanov	4	Acc
Ľudstvo svojou usilovnosťou prispelo k zrodu dvoch svetových vojen , ba v niektorých kútoch Zeme vojny pokračujú .	zrodu	5	Dat
Podišiel som k oknu , že sa spýtam svojich postáv , čo si o tom myslia .	oknu	3	Dat
Pri stene bola posteľ , na stole lampa s hlboko stiahnutým tienidlom .	stole	6	Loc
Potom zlezie zo stromu a uteká domov . . .	stromu	3	Gen
Hlavu si oprela o jeho rameno a príjemná vôňa jej vlasov zahnala zápach holubieho trusu .	vôňa	8	Nom
Takáto interpretácia stvorenia človeka diablom je zjednodušením .	diablom	4	Ins
Väčšinou sedávame na okne za záclonou alebo v kúte izby a sledujeme ho .	záclonou	5	Ins
Roztvoril dvere a odporný kyslastý zápach zvetraného piva mu vrazil do nosa .	piva	7	Gen
Tigríča jej nešikovne skočilo do náručia a princezná zacítila mäkulinkú teplú guľku s hodvábnou srsťou .	Tigríča	0	Nom
Rozzúrená sa zvrtla a kamennými schodmi zbehla do zámockej pivnice .	schodmi	5	Ins
Tak je to i vo viacerých ranoarpádovských právnych normách .	normách	8	Loc
Pokým nás kryjú tieto konáre , sme v bezpečí . "	bezpečí	8	Loc
Mohlo byť len zo stromu , do ktorého sa zaťalo sekerou so zatvorenými očami .	očami	13	Ins
Na líci sa nachádza ruža so štyrmi lupienkami , obkolesená zložitou dekoratívnou obrubou .	lupienkami	7	Ins
V škole bola kapitánkou hokejového družstva a dva roky po sebe získala trofej v gymnastike .	kapitánkou	3	Ins
Ženské bábky aj mužské bábky .	bábky	4	Nom
Spomínaní clunyjskí opáti boli osobnosťami s mimoriadnymi osobnostnými kvalitami a veľkou morálnou autoritou .	autoritou	12	Ins
V prijímacej sieni to vyzeralo , akoby sa tadiaľ prehnala búrka .	sieni	2	Loc
Namiesto neho som objavil dve nečakané veci : svadobné šaty aj s vencom a fotografiu akejsi ženy .	ženy	16	Gen
So žiarivým trojzubcom v mohutnej ruke sa nad nimi týčila ako predzvesť smrteľných bleskov .	ruke	5	Loc
Na druhej strane niektoré slová poukazovali úprimne a s pohŕdaním na skutočný charakter oceánskej spoločnosti .	pohŕdaním	9	Ins
Mama zjedla otravu na myši .	myši	4	Acc
Mauglí so supmi sa smiali , keď im tiger zmizol z dohľadu .	supmi	2	Ins
Vláda podporí doriešenie vlastníckych vzťahov k pôde a rozvoj trhu s pôdou .	pôde	6	Dat
Čoskoro mal každý muž v rukách vidly alebo sekeru .	vidly	6	Acc
Obaja rýchlo dýchali , ale okolo kútikov úst sa jej znovu objavil úsmev .	úst	7	Gen
Náš dnešný spisovný jazyk je skutočným kompromisom medzi radikálnou normou štúrovcov a požiadavkami bernolákovcov i tradíciou českou či československou .	normou	9	Ins
Tým výrazne prispeli ku vzniku učenia o transsubstanciácii .	učenia	5	Gen
Areál Zväzu spisovateľov smrdí močom .	Areál	0	Nom
Miznem v temnej priepasti , v roztvorených ústach pohlcujúcich rieku času .	priepasti	3	Loc
Priznanie nie je zrada .	Priznanie	0	Nom
Vláda bude naďalej podporovať účasť Ozbrojených síl SR v mierových misiách a operáciách na podporu mieru a na boji proti terorizmu , s dôrazom na operácie pod vedením NATO .	dôrazom	23	Ins
Pri štvrtej obrátke sa mi stužka s kľúčikom z krku vyvliekla .	obrátke	2	Loc
Vláda pripraví a realizuje systém ochrany slovenského spotrebiteľa a prostredníctvom legislatívy ho prispôsobí stavu , ktorý bude zodpovedať legislatíve EÚ .	spotrebiteľa	7	Gen
Vláda bude klásť dôraz na racionalizáciu nákladov spojených s realizáciou výkonov vo verejnom záujme v železničnej osobnej doprave a verejnej autobusovej doprave .	dôraz	3	Acc
Miznem v temnej priepasti , v roztvorených ústach pohlcujúcich rieku času .	ústach	7	Loc
Chcel som tej rieke zabrániť , aby vyrazila von , bolo to však nemožné .	rieke	3	Dat
V náprotivnej stene bol pamäťový otvor .	stene	2	Loc
* Niektorým poslancom padlo zaťažko zverejniť svoje majetkové priznanie .	poslancom	2	Dat
Nôž by mal minimálne obsahovať : veľkú a malú čepeľ , otvárač na fľaše a konzervy , rydlo , výhodné je , ak obsahuje dierovač , pílku na drevo , vývrtku , pinzetu .	drevo	28	Acc
Ja som si nemohla dovoliť také neprístojnosti .	neprístojnosti	6	Acc
Bála som sa to povedať mame , ktorá prišla na polhodinu domov , aby sa prezliekla , kým pôjde do ďalšej práce .	polhodinu	10	Acc
V krátkom čase v rokoch 1989 – 1990 bol členom Generálneho presbyterstva .	presbyterstva	11	Gen
Aby anonym urobil svoje obvinenie dôveryhodným , uvádzal iniciálky tej ‐ ktorej ženy a z tohto hľadiska mala Marga dôvod podozrievať ma .	anonym	1	Nom
Symbolickú úlohu má i výzdoba koníka — krúžky s bodkou uprostred sú ďalšou z mnohých modifikácií solárnych znakov .	krúžky	7	Nom
Rodičom sa však taký vývoj udalostí nepáčil a zišli sa na porade .	porade	11	Loc
Je to chronologicky prvá zbierka , ktorú zostavil neznámy autor z rímskych reformných kruhov .	kruhov	13	Gen
Rodinka prašivých túlavých psov zaliezla od strachu pod haldu kobercov .	Rodinka	0	Nom
Natiahla sa k zásuvke na mojej strane a prehŕňala sa v nej , až kým nenašla škatuľku cigariet .	škatuľku	16	Acc
Jednu z tých , aké nevyvolajú reakciu v podobe telefonátov zhora .	podobe	8	Loc
Ďalšou decentralizáciou verejných financií vláda vytvorí na úrovni obcí lepšie podmienky pre napĺňanie miestnej bytovej politiky .	úrovni	7	Loc
Baghíra prebehol po oboch brehoch rieky , až natrafil na topiaci sa člnok .	rieky	5	Gen
Začali sme na kolotočoch , kde sme vyliezli na koňa .	kolotočoch	3	Loc
Vláda sa bude usilovať o postupné zapájanie kapacít nášho obranného priemyslu do štruktúr európskeho obranného priemyslu .	priemyslu	10	Gen
Škola sa musí stať v regióne kultúrnym , športovým a spoločenským centrom obecnej komunity .	komunity	13	Gen
Opäť ho pochytila temná panika .	panika	4	Nom
Vláda zabezpečí novelu Zákonníka práce a zákona o verejnej službe tak , aby umožnila individuálnu diferenciáciu miezd a mobilitu zamestnancov v zdravotníckych zariadeniach .	zariadeniach	22	Loc
Vodné vtáky teda i kačky sú späté s kultom slnca , keďže svojim jarným príletom zvestujú vzrast jeho moci .	príletom	14	Ins
Súčasnému vedúcemu katery doc . M . Danišovi patrí okrem toho aj moje srdečné poďakovanie za vytrvalú a všestrannú podporu pri vydaní tejto knihy .	vedúcemu	1	Dat
Vláda sa bude usilovať o postupné zapájanie kapacít nášho obranného priemyslu do štruktúr európskeho obranného priemyslu .	priemyslu	15	Gen
Doma Alfonz bratovi vyčítal , že mu svojím správaním urobil hanbu a vyhodil ho .	bratovi	2	Dat
Pôvodná hudba k muzikálu , alebo komédii : Princ egyptský	muzikálu	3	Dat
Komár unudene pozrel do trávy .	trávy	4	Gen
Uvedené komplexy sa vyznačujú zmiešaným osídlením Slovanov s inými etnikami a tvrdošijným zachovávaním archaických prežitkov rodového zriadenia , kým mestá sú čisto slovanskými sídlami , určenými na pacifikáciu a christianizáciu kolonizovaných oblastí .	sídlami	23	Ins
Stala si na kameň a začala vrzúkať .	kameň	3	Acc
Ktosi vystúpil , aby splnil rozkaz .	rozkaz	5	Acc
Na moje prekvapenie sa mama zasmiala .	mama	4	Nom
Baghíra nestrácal ani chvíľu , zdvihol košík a odniesol ho k jaskyni .	košík	6	Acc
Voda bola chladná ako vždy , a tak som si na zahriatie zaplávala niekoľko dĺžok .	dĺžok	14	Gen
Použitie tohto mena pri televíznom uvedení hraného filmu známeho z kín je nezvyčajné .	kín	10	Gen
V náručí niesol nákupnú tašku .	tašku	4	Acc
Ani v ten deň , ani neskôr som nepovedal kamarátom o návšteve , ktorá k nám prišla .	kamarátom	9	Dat
“ Môjmu kráľovskému uchu sa donieslo , že chceš ostať v džungli . “	džungli	11	Loc
ZOO pre mláďatká	mláďatká	2	Acc
To každý človek uznáva , ale toto je príliš veľká záťaž na Mimobratislavčanov . “	záťaž	10	Nom
Oblasť severovýchodnú , rostovsko ‐ suzdaľskú , s nižším stupňom rozvoja ekonomiky a s podmienkami pre dlhšie udržanie konzervatívnych , starých názorov .	stupňom	9	Ins
Ide o unikátny nález brezovej listiny v karelčine , s využitím ruskej abecedy .	listiny	5	Gen
Vláda uplatní rovnaký postup pri priznávaní štátnej pomoci a zriadi register prijímateľov štátnej pomoci a register prijímateľov iných investičných stimulov .	pomoci	13	Gen
Winstonovu čeľusť zovrela bodavá bolesť .	bolesť	4	Nom
V čase , keď sme s nimi skoncovali , boli to už len ľudské škrupiny .	škrupiny	14	Nom
Prebúdzal som sa o druhej v noci na zvonenie mechanického budíka čínskej výroby , ktorý som mal na nočnom stolíku pri záhlaví postele .	zvonenie	8	Acc
“ Kedykoľvek , “ odvetil Chris s úsmevom , zvrtol sa a plával k trénerovi .	trénerovi	14	Dat
Listina je o šesťsto rokov staršia než iné zo známych písomných pamiatok v karelčine .	karelčine	13	Loc
“ Môjmu kráľovskému uchu sa donieslo , že chceš ostať v džungli . “	uchu	3	Dat
Aj reformný kánonista Anselm uvádza vo svojej zbierke viacero nariadení o konaní synod .	zbierke	7	Loc
Predal mi ich za cenu , aká bola uvedená na novinách .	novinách	10	Loc
Legislatívnym základom bude vládou vypracovaný návrh moderného zákona o výchove a vzdelávaní .	výchove	9	Loc
“ Obviňujeme vás , že ste nám odcudzili drahocennú potravu , “ povedal prísne veliteľ a dal pokyn , aby ich zajali a postavili pred sudcu .	potravu	9	Acc
Porušenie tohto zákazu sa trestá odňatím ťažného zvieraťa a náradia .	zákazu	2	Gen
Pustil fľašu z kopca , ale zgúľala sa do potoka a voda ju unášala ako lodičku .	fľašu	1	Acc
Z jeho úvah vyprchal napoly príjemný pocit .	pocit	6	Nom
Vždy hulákaj s davom , to je moja zásada .	davom	3	Ins
Omar ležal rozvalený na gauči .	gauči	4	Loc
Len čo to dopovedala , zniesol sa nad ňou modrý tieň , v ktorom stála ako v jazierku .	tieň	10	Nom
“ Stavím sa , že je to bytosť z inej planéty , “ zašepkala Maja a zatiaľ čo sakamaráti skrývali za jej chrbtom , podišla bližšie a navrhla neznámemu prehliadku Makovej lúky .	neznámemu	28	Dat
Myslím však , že vysoká škola má dve významné úlohy , ktoré so spomínanou rovnicou priamo nesúvisia .	rovnicou	14	Ins
Dolorina tvár , ktorá bývala obyčajne bledá , zbledla ešte viac .	tvár	1	Nom
Potom sa obrátila k bratom .	bratom	4	Dat
S očividným uspokojením dokázal rozprávať o náletoch vrtuľníkov na nepriateľské dediny , o procesoch s ideozločincami , o ich priznaniach a o popravách v katakombách Ministerstva lásky .	lásky	26	Gen
Vláda zdokonalí transparentný systém financovania cirkví a náboženských spoločností .	financovania	4	Gen
“ A nezabudnite na vrecká , kam zabalíte psom zvyšky . “	psom	8	Dat
Keď sme asi hodinu kráčali po ceste pre vozy , mama odbočovala ku kravínom a ja som išla ďalej do školy .	kravínom	13	Dat
Tú bundu ?	bundu	1	Acc
Chris ma chytil za ruku a kľúčik sme zvierali medzi dlaňami .	kľúčik	6	Acc
Nešiel som na letisko .	letisko	3	Acc
K tomu sa podávalo trnkové víno a deťom ponúkli fialovú malinovku .	deťom	7	Dat
Liza s hrôzou zastala .	hrôzou	2	Ins
Našej susedke - záhradkárke sa naše mičurinčenie ale veľmi nepáčilo .	záhradkárke	3	Dat
Preháňali sa po ňom autá .	autá	4	Nom
V zrkadle sa znovu zjavila akási nejasná tajomná tvár .	zrkadle	1	Loc
Zips sa mu už dávnejšie odtrhol .	Zips	0	Nom
Rovnako pri dodaní či vyzdvihnutí fotografií ste ušetrení od úmorného vyčkávania v rade .	vyzdvihnutí	4	Loc
Udalosť — popis Samojedov novgorodcom Gorjatom Rogovičom .	novgorodcom	4	Ins
Srdce mi bilo ako zvon , no odľahlo mi , len čo za sebou zavrela .	Srdce	0	Nom
Nepočetní mladí muži v našom prefeminizovanom ročníku boli zväčša básnici .	ročníku	6	Loc
Opice skákali z konára na konár a preskakovali koruny stromov , čo rástli pozdĺž brehu rieky .	konára	3	Gen
V dôsledku rímsko - centralistickej tendencie zbierok prevzali do nich zostavovatelia i viaceré úplne alebo čiastočne sfalšované texty , ktoré však svojím obsahom zodpovedali stanoviskám a snaženiam reformátorov .	stanoviskám	24	Dat
Prijatie novely zákona o štátnej službe umožní okrem iného zamestnanie špičkových odborníkov v ústredných štátnych orgánoch za adekvátneho mzdového ohodnotenia a odstráni nepružnosť zamestnávania v štátnej službe .	zamestnávania	23	Gen
Z politického hľadiska Koloman pápežovi vyhovel .	pápežovi	4	Dat
Kvôli nutnosti ich lepšieho uchopenia je potrebné vopred určiť , z akého hľadiska budeme pramene skúmať .	nutnosti	1	Dat
Veselo sa prechádzali medzi hosťami , usmievali sa a povzbudzovali ich , aby sa u nich cítili ako doma .	hosťami	4	Ins
Biblia nie je v rozpore s vedeckými objavmi .	objavmi	7	Ins
Toto každodenné falšovanie minulosti , ktoré robí Ministerstvo pravdy , je pre stabilitu režimu rovnako nevyhnutné ako represálie a špicľovanie , ktoré robí Ministerstvo lásky .	Ministerstvo	23	Nom
Tento letopis bol paralelou cyklu bylín o Vladimírovi .	paralelou	3	Ins
Každý pokus o systematizáciu tejto otázky totiž nevyhnutne naráža na kolíziu metódy vedeckého prístupu s rozumovo nedefinovateľným fenoménom náboženstva a viery .	prístupu	13	Gen
Abu pokrčil plecami .	plecami	2	Ins
Miatla ho vôňa povetria i zeleň lístia .	vôňa	2	Nom
Starcova pamäť bola len kopa bezcenných detailov .	detailov	6	Gen
Pomôžu vám vyniesť nahor veci , povedal Cerberus a podal ten kľúč mame .	mame	12	Dat
“ Odišla , “ povedal škriatok .	škriatok	5	Nom
Mal som pocit , že za známymi črtami tváre , ktorých som sa vo sne neraz dotýkal , sa skrýva akési tajomstvo .	črtami	7	Ins
Medzitým prestalo pršať a svitlo slniečko .	slniečko	5	Nom
Zaujímavú skupinu tvoria vyobrazenia s rastlinnými motívmi .	motívmi	6	Ins
“ Spomínaš na tú rozprávku , čo ti mama rozprávala , keď si nemohla zaspať ? “	mama	8	Nom
Hľadajúc osamotenosť založil niekoľko pustovní , no pod vplyvom Ota III . prevzal vedenie rímskeho kláštora Tre Fontane .	pustovní	4	Gen
Každý pohlavný styk , ktorému nič nechýbalo , bol vzburou .	styk	2	Nom
Nikde nedajú pokoj .	pokoj	2	Acc
V Čarodejníckej vile sa nikto netešil takému privilégiu .	privilégiu	7	Dat
Vzala si kráľov trojzubec a jeho zlatá žiara sa jej rozliala po tvári .	trojzubec	3	Acc
Dane a odvody	Dane	0	Nom
V lese som krok za krôčikom snoril pod krami a pod kameňmi .	krôčikom	5	Ins
PREČ S VEĽKÝM BRATOM !	BRATOM	3	Ins
Zhrnutie a porovnanie , súvislosti .	porovnanie	2	Nom
Smutné včielky sedeli pri raňakjách , na stole chýbal tanier s medom .	medom	11	Ins
Po zázraku s ostatkami Feodosija a pred vpádom Polovcov .	ostatkami	3	Ins
Zbadala ho na steble trávy , práve z orlíčka popíjal sladký nektár .	steble	3	Loc
“ Na to sa spoľahnite ! “ začal vyjednávať chrobák Truhlík .	chrobák	9	Nom
Pod rokom 1092 sa nachádza zmienka o „ polockom zázraku “ .	rokom	1	Ins
“ Kedykoľvek , “ odvetil Chris s úsmevom , zvrtol sa a plával k trénerovi .	úsmevom	7	Ins
Človek očakával , že ho zabijú .	Človek	0	Nom
Veľké dvere sa dokorán otvorili .	dvere	1	Nom
Iba na bodliaku sa jagali veľké kvapky rosy , lebo sa báli skotúľať do trávy .	rosy	7	Gen
Chlapci sa smiali , keď mocný pirát napol svaly na ruke , až sa mu na ramene zachvel vytetovaný pirátsky znak ‐ lebka so skríženými hnátmi .	ramene	16	Loc
Po hodine na mňa Chris čakal pred triedou .	hodine	1	Loc
V šalátovej mise zmiešajte olej , korenie , soľ , uhorku , cibuľu , petržlenovú vňať a bazalku .	cibuľu	12	Acc
Dolnolotrinská reforma sa viaže predovšetkým k pôsobeniu Gerharda .	pôsobeniu	6	Dat
Zároveň dochádza k postupnému vyprázdňovaniu symboliky pohanských obyčajov .	vyprázdňovaniu	4	Dat
Bolo oslňujúce popoludnie .	popoludnie	2	Nom
Zbierka uvádza pravé i nepravé dekretály viacerých pápežov , ako aj početné dokumenty pojednávajúce o výnimočných právach rímskeho biskupa .	dekretály	5	Acc
Z televíznej obrazovky zaznel zúrivý , ohlušujúci rev .	rev	7	Nom
Abu mal aj nový fez so strapcom .	strapcom	6	Ins
Mladým včielkam pripadal dážď spočiatku zábavný .	včielkam	1	Dat
Nakoniec si urobila z nosidiel trampolínu , začala skákať kotrmelce a nosidlá tak rozhojdala , že ich včielky sotva udržali .	kotrmelce	9	Acc
Maja si pospomínala na všetky nebezpečenstvá , o ktorých im vykladala slečna Kasandra .	slečna	11	Nom
Predseda našej nadácie mal v tom hoteli raz popoludní tlačovú konferenciu a ja som na ňu pozvala Irmu .	hoteli	6	Loc
Na hlave mal klobúk a na krídlach vzácny vzor .	vzor	8	Acc
Vláda vytvorí podmienky pre uskutočnenie úspešného referenda o vstupe do EÚ , ktoré bude dokumentovať udržanie širokej podpory verejnosti tomuto historickému kroku .	kroku	21	Dat
Slávnostne , s nádejou v lepšiu budúcnosť .	budúcnosť	6	Acc
ZLÁ VÍLA NETRPEZLIVO ČAKALA NA ZÁPAD SLNKA vo vlhkých tmavých rozvalinách kamenného hradu , ktorý stál na vysokom brale .	ZÁPAD	5	Acc
Najprv zavládlo neprirodzené ticho .	ticho	3	Nom
Vytrhal ľan a zviazal ho do snopu .	ľan	1	Acc
V prípade , že klerik žaluje laika , má sa spor prerokovať pred svetským sudcom .	sudcom	14	Ins
Napokon zlá víla priviedla princeznú do izbietky na samom vrchu vežičky .	vrchu	9	Loc
Takéto okrádanie pokračuje , v iných formách , aj dnes .	okrádanie	1	Nom
Nechala dole pred domom auto .	domom	3	Ins
Samozrejme , že Maja s Vilkom zablúdili v jesennej hmle ako prví .	hmle	9	Loc
Hrabala som sa vo vaku a hľadala som bundu .	bundu	8	Acc
Môže ísť o toporčeky s predĺženým poriskom , ktoré boli v Škandinávií predmetom symbolizujúcim hromy vrhajúceho Thora .	hromy	14	Acc
Naučil sa spať s prudkým svetlom na tvári .	svetlom	5	Ins
Ľudstvo svojou usilovnosťou prispelo k zrodu dvoch svetových vojen , ba v niektorých kútoch Zeme vojny pokračujú .	kútoch	13	Loc
Ozýval sa stadiaľ šepot , potom rýchle kroky a napokon sa vo dverách zjavila kráľovná .	šepot	3	Nom
Ja som vedel , že jej portrét sa nachádza medzi viečkami medailónu v skrini , kde sú uložené aj biele svadobné šaty so závojom .	medailónu	11	Gen
Keď sa doktor objavil vo dverách , bol som zmätený .	dverách	5	Loc
Vilko s Majou doleteli na lúku s koňmi .	koňmi	7	Ins
Cez kombinézu cítil jej prsníky , zrelé , ale pevné .	kombinézu	1	Acc
Realita života na vidieku zatláča náboženské rozdiely do úzadia .	úzadia	8	Gen
Chris sa poškriabal na hlave a rozpačito na mňa pozrel .	hlave	4	Loc
Ale ten namyslený chvastúň nemá nijaké sérum proti hadiemu jedu .	jedu	9	Dat
Na hlave mal klobúk a na krídlach vzácny vzor .	klobúk	3	Acc
Ja som ju napriek tomu nehanebne vyzliekal očami .	očami	7	Ins
Za finančnú podporu sa chcem poďakovať Ekumenickej rade cirkví , nášmu drahému zboru a „ staršej “ mládeži ECAV v Prešove , modlitebnému spoločenstvu , kamarátom z tréningu Rovesník a jednotlivcom .	kamarátom	25	Dat
V „ našich “ zbierkach kánonického práva máme doslova záľahu ustanovení , ktoré hovoria o tom istom .	zbierkach	4	Loc
Články , zaujímavosti , recenzie .	zaujímavosti	2	Nom
Hmla je vlastne len jednou z podôb pary , vznikajúcej v parnom kúpeli , spomínanom v rozprávaní o vzniku sveta .	Hmla	0	Nom
Vláda pripraví komplexnú analýzu zadlženosti verejného sektora .	zadlženosti	4	Gen
Neváhal a rozhádzal všetky kamene , zničil všetky znamenia .	znamenia	8	Acc
I . ostrihomská synoda nariaďuje , že únosca je povinný poskytnúť postihnutým majetkovú kompenzáciu a navyše má vykonať aj pokánie .	postihnutým	11	Dat
O nich , ako aj o charakteristike ranoarpádovských zákonníkov a synodálnych uznesení hovoríme konkrétnejšie v samostatných kapitolách .	kapitolách	16	Loc
Niekedy jej rozprával o Oddelení záznamov a o nehanebných falzifikátoch , ktoré v ňom fabrikuje .	záznamov	5	Gen
Bojoval proti vykorisťovaniu v indickej spoločnosti , proti krviprelievaniu medzi hinduistami a moslimami , proti vojne , za politickú nezávislosť svojej krajiny .	krviprelievaniu	8	Dat
Odporná extáza strachu a pomstychtivosti , túžba zabíjať , mučiť , drúzgať tváre kováčskym mlátom akoby preskočila sťa elektrický prúd na všetkých a premenila každého aj proti jeho vôli na vrieskajúceho pomätenca s pokrivenou tvárou .	prúd	19	Nom
Práve vtedy vošiel ráznym krokom guľatý pánko so špicatou briadkou .	pánko	6	Nom
Hltači mečov súperili s predavačmi šperkov o jej pozornosť .	mečov	1	Gen
Na slnku jej telo žiarilo .	slnku	1	Loc
Príhoda s hmlou	hmlou	2	Ins
Druhou činnosťou , ktorú v Ostrihome klerikom zakázali , bolo úžerníctvo .	úžerníctvo	10	Nom
Dochádza k revitalizácií pohanstva v bojarských kruhoch .	revitalizácií	2	Dat
Keď sme všetko spratali , odšuchatala som sa do obývačky a prepínala kanály na televízore .	obývačky	9	Gen
Neviditeľní jazdci na koňoch sú vyjadrením predstavy o zlých duchoch , schopných ubližovať človeku odnesením jeho duše do podsvetia .	človeku	13	Dat
Lori bola vedľa mňa , aby mi potvrdila , že Irma , ktorú pohltilo nebo , teraz letí do iného sveta .	nebo	14	Nom
Kým to hovoril , nenápadne sa posúval bližšie k včelám .	včelám	9	Dat
Usadili sme sa pripravení sledovať oblohu .	oblohu	5	Acc
Okno na izbe bolo otvorené , a bol tam zápach .	zápach	9	Nom
Vtedy som vyriekol jediné slová , o ktorých som si myslel , že vystihujú moje rozpoloženie .	rozpoloženie	15	Acc
Z týchto vzájomných kontaktov totiž vyplývajú isté indície o tom , do akej miery mohli byť myšlienky rímskych reformátorov recipované uhorskou cirkvou a jej zákonodarstvom .	indície	7	Nom
Vláda bude pokračovať v transformácii železníc .	transformácii	4	Loc
Má netradičnú grafickú podobu a svojimi malými rozmermi sa zmestí do každej tašky a ku každému počítaču .	počítaču	16	Dat
Odtrhol som lesnú jahodu a položil ju ku kamennému prístrešku .	prístrešku	9	Dat
V jednej firme majú hluchú upratovačku .	firme	2	Loc
Zároveň zabezpečí včasné a úplné informácie o stave životného prostredia a o príčinách a následkoch tohto stavu .	následkoch	14	Loc
. . . MÔJ PRIMÁRNY ZÁUJEM BOLI HUMANIÓRA .	ZÁUJEM	5	Nom
Do základnej školy chodil v Kukovej , kde ukončil štyri triedy .	školy	2	Gen
Pri stene bola posteľ , na stole lampa s hlboko stiahnutým tienidlom .	tienidlom	11	Ins
Doprava , pošta , telekomunikácie a rozvoj informačnej spoločnosti	Doprava	0	Nom
Obrovský panter zdvihol košík a opatrne ho položil na breh .	breh	9	Acc
Vláda sa zároveň zaväzuje presadiť v zdravotníctve tvrdé rozpočtové obmedzenie tak , aby od roku 2004 nedochádzalo k tvorbe nového dlhu .	obmedzenie	9	Acc
Na druhej strane slovo Kominterna vnuká predstavu prísne štruktúrovanej organizácie a dobre zoštylizovanej ideologickej doktríny .	doktríny	14	Gen
Nemala som najmenšiu chuť rozoberať pred ním svoje zmätené pocity a zbabraný test .	test	12	Acc
Znovu sa ozvala píšťalka a hra pokračovala .	píšťalka	3	Nom
Povedal som im , že to nepovažujem za zlý nápad .	nápad	9	Acc
Vtedy sa prítomným naskytol pohľad na Gimov obrovský penis .	prítomným	2	Dat
Vtedy som si dovolil poznamenať , že aj ja si pamätám jej tvár .	tvár	12	Acc
Terk neverila vlastným očiam .	očiam	3	Dat
Spory spoločenstva a okolia .	Spory	0	Nom
Formálne dodržiavaným zvykom je aj skrývanie moslimských žien .	žien	7	Gen
Dovtedy musí ostať v úkryte vo zvončeku .	zvončeku	6	Loc
Okolo nej , nad ňou i pod ňou boli ďalšie davy pracovníkov s nepredstaviteľným množstvom úloh .	úloh	15	Gen
Sneh trval na tom , že musím zostať v tejto pasci .	pasci	10	Loc
Dievčatko išlo do kúpeľne .	Dievčatko	0	Nom
V zásade príslušnosť k týmto trom skupinám sa nededí .	skupinám	6	Dat
Marga mi svoju túžbu piť vysvetlila na druhý deň .	túžbu	3	Acc
Cirkevnoprávne zbierky naproti tomu obsahujú iba všeobecne formulované zákazy nedeľnej práce bez udania sankcií .	sankcií	13	Gen
Posledný kánon II . kolomanovskej synody o celibáte sa svojím obsahom vymyká prísnejšiemu tónu uznesení tohto cirkevného snemu .	snemu	17	Gen
Moja myseľ opäť postrehla akúsi súvislosť medzi autom a týmito dvoma mužmi .	autom	7	Ins
Vláda vytvorí legislatívne , administratívne a kontrolné mechanizmy pre efektívne čerpanie zdrojov z fondov EÚ .	mechanizmy	7	Acc
Žiarlivá kráľovná sa hrozne nahnevala , že jej nevlastná dcéra je krajšia ako ona , a prikázala poľovníkovi , aby princeznú zabil .	poľovníkovi	17	Dat
Nohavičky s vreckami .	vreckami	2	Ins
Keď Shannon otvorila dvere , sprisahanecky ma objal okolo pliec a vliezol na zadné sedadlo .	sedadlo	14	Acc
V niekoľkých sekundách po prebudení sen i spomienka , ktorá ho podnietila , splynuli v jeho mysli v jedno .	mysli	16	Loc
Obzvlášť odvtedy , čo som sa presťahovala do prízemného bytu po mojej starej tete , ktorá chovala a vykrmovala túlavé mačky z celého sídliska .	mačky	20	Acc
Spadol predtým do nádoby s farbou .	farbou	5	Ins
Hore bolo samé nebo a dole hlbočina .	nebo	3	Nom
Spokojne som sedela na trávniku pred domom , vdychovala eukalyptovú vôňu a chladnejší vzduch i sledovala som , ako nado mnou vetrík povieva palmovými listami .	vetrík	21	Nom
Medzi pretekármi pravdaže nchýbal ani Flip , ktorý mal v hľadisku spústu fanúšikov .	pretekármi	1	Ins
Obrovský vysvietený lunapark s kolotočmi , kľukatými dráhami , hudbou , zábavnými hrami a množstvom vykrikujúcich ľudí .	kolotočmi	4	Ins
S ktorou krajinou je Oceánia vo vojne ? "	krajinou	2	Ins
Hltači mečov súperili s predavačmi šperkov o jej pozornosť .	Hltači	0	Nom
Abdullah pokrčil plecami .	plecami	2	Ins
Vo filiálke Petrovany sme mali koncom minulého roka dva milé zážitky .	zážitky	10	Acc
“ Anita a ten jej nepodarený Beethoven s fajkou v ústach !	fajkou	8	Ins
Vláda pripraví legislatívny rámec inštitucionálneho vzdelávania zdravotníckych pracovníkov prostredníctvom rezortu školstva s možnosťou postgraduálnej prípravy pracovníkov v zdravotníctve v školách a inštitúciách , ktoré získajú akreditáciu pre príslušný typ vzdelávania .	vzdelávania	29	Gen
Všetci s údivom pozerali na obrovské šalátové hlavy .	údivom	2	Ins
Oznam Ministerstva hojnosti zakončilo ďalšie sólo na trúbku , ktoré potom vystriedala dychovka .	hojnosti	2	Gen
Prišli pokušenia , zvody a ony podľahli .	zvody	3	Nom
V takýchto mrákotách zaznel v ktoromsi kúte môjho mozgu pohrebný motív vzdialenej trúby .	mrákotách	2	Loc
Práve vtedy tréner August zapískal .	tréner	2	Nom
Kapitoly vytvoria protiváhu hlboko miestne ukotveného archeologicko ‐ historického prehľadu a predkladajú nový zorný uhol na skúmanú tému .	prehľadu	9	Gen
Irma neuverí rozprávkam , vyľaká sa .	rozprávkam	2	Dat
Obra Jumba všetci oslavovali a vymenovali za čestného občana Makovej lúky .	občana	8	Acc
Meg trápili starosti .	starosti	2	Nom
V ranoarpádovských zákonníkoch nachádzame aj ustanovenia o Božích súdoch , iracionálnom dôkaznom prostriedku , ktorý sa v stredovekom súdnom konaní hojne aplikoval .	zákonníkoch	2	Loc
Winston ihneď vyplatil štyri doláre a zasunul si vysnívanú vecičku do vrecka .	doláre	4	Acc
“ Pán Shepherd , “ povedal profesor Tayerle a kývol rukou , “ nemyslite si , že som nevidel lístok , ktorý ste dali pred chvíľou slečne Wyseovej .	slečne	26	Dat
Ručička ciferníka vystrelila na päťdesiatpäť .	ciferníka	1	Gen
Návrh systému finančného vyrovnávania bude zohľadňovať princíp solidarity a motivácie .	motivácie	9	Gen
Zlej víle ostávala posledná nádej — havran .	víle	1	Dat
Vláda bude podporovať organizovanie významných športových podujatí v SR .	podujatí	6	Gen
Čas — 1091 .	Čas	0	Nom
Na hlavnej stránke v pravom menu je ikona určená pre registráciu nového používateľa .	menu	5	Loc
Tým výrazne prispeli ku vzniku učenia o transsubstanciácii .	transsubstanciácii	7	Loc
Pozrela som na hodinky a zmocnili sa ma obavy .	obavy	8	Nom
Po špičkách som zišiel do salóna na prízemí , kde som na chvíľu zastal so zatajeným dychom .	salóna	5	Gen
Zrejme mala akúsi praktickú ostrieľanosť , ktorá Winstonovi chýbala a podľa všetkého vďaka nespočítateľným spoločenským výletom výborne poznala okolie Londýna .	výletom	15	Dat
Motýľ Emanuel ostal ako obarený .	Motýľ	0	Nom
“ Koniec !	Koniec	1	Nom
“ Čo by si chcela robiť v sobotu ? “ spýtal sa Chris a ja som na uchu zacítila jeho dych .	uchu	17	Loc
Slnečný svit , ktorý prenikal nespočetným lístím , ich ešte stále pálil na tvárach .	lístím	6	Ins
Napriek svojej rozrušenosti som vytušil , že šéf hrá akúsi hru .	rozrušenosti	2	Dat
Niečo mi zvieralo hrdlo .	hrdlo	3	Acc
Pritom je známe , že remeslo kováčske bolo spájané s magickými šamanskými praktikami u mnohých národov — kováč a šaman sú z jedného rodu hovorí jakutské príslovie .	praktikami	12	Ins
Zaleteli k lesu , kde Svetlanka ukázala na uzučkú škárku v zemi .	lesu	2	Dat
V tvári ma pálil pot .	pot	4	Nom
" Vy ste zrejme od svojho mládenectva zažili ohromné zmeny , " opáčil Winston .	mládenectva	6	Gen
Rozbehla som sa a skočila , pričom sa hladina rozbúrila ako po výbuchu .	výbuchu	12	Loc
V jej neprítomnosti som predložil rukopis tej poviedky priamo šéfovi .	šéfovi	9	Dat
Wilsher , blondiak s nasprostastým výrazom na tvári , ktorého takmer nepoznal , ho s úsmevom pozýval na voľné miesto pri svojom stole .	výrazom	5	Ins
Cestou zoťali strom — budú ho potrebovať , ako baranidlo , keď budú chcieť vyvaliť bránu .	bránu	15	Acc
Chvíľu ho nechali metať sa vo vode , no potom prilákali k studni muža , čo okopával záhradku .	vode	6	Loc
Toto spoločenstvo nám poskytlo hlboké zážitky , mnoho podnetov na zamyslenie , mnoho motivácie k modlitbám a pocit Božej prítomnosti .	modlitbám	15	Dat
Novgorodské brezové listiny sú dnes uznávané ako neoceniteľný prameň pre poznanie života v tomto stredovekom meste .	prameň	8	Nom
U citlivejších osôb to môže spôsobiť zbytočné bolesti hlavy .	bolesti	7	Acc
Obzeral sa , no dievčinky nikde .	dievčinky	4	Gen
Mohutná posteľ pri okne bola zastlaná dotrhanými prikrývkami a na poduške chýbala obliečka .	prikrývkami	7	Ins
A s pohľadom Loriných očí vo svojom vnútri .	pohľadom	2	Ins
Premenlivosť minulosti je podstatou angsocu .	Premenlivosť	0	Nom
Vznikla v tretej štvrtine 11 . storočia ( medzi rokmi 1050 – 1076 ) a bola určená na používanie v rímskej kúrii a pre pápežských legátov .	kúrii	21	Loc
Aj ja som tam bol kvôli mame , aby som jej vyhovel .	mame	6	Dat
Prítomnosť ovce nie je podmienkou .	Prítomnosť	0	Nom
Jediným uznávaným zmyslom manželstva bolo splodiť deti , ktoré mali slúžiť Strane .	Strane	11	Dat
Týchto ľudí , ktorí pochádzali zo strednej triedy zamestnancov a z vyšších vrstiev robotníckej triedy , sformoval a zoradil jalový svet zmonopolizovaného priemyslu a scentralizovanej vlády .	triedy	14	Gen
Vláda bude podporovať vývoj a šírenie výrobkov i služieb šetriacich životné prostredie a v rámci legitímnych trhových nástrojov hľadať možnosti podpory malým a stredným podnikateľom zvyšovať investície do „ čistej “ výroby a environmentálnych podnikateľských aktivít .	podnikateľom	24	Dat
A vládca sveta mŕtvych sa mi zjavil v čiernej peleríne .	vládca	1	Nom
Išla som k dverám jej izby : “ Volá Rick , “ zašepkala som .	dverám	3	Dat
V ušiach mi zostala len ozvena jeho hlasu a v diaľke , na úpätí podstavca bez sochy , som uvidel Háda .	úpätí	13	Loc
Moja myseľ opäť postrehla akúsi súvislosť medzi autom a týmito dvoma mužmi .	mužmi	11	Ins
Pozrime sa , teraz , ktoré z týchto statí sú relevantné pre našu tému .	statí	8	Gen
Vlci sa zhromaždili na Veľkej skale .	Vlci	0	Nom
Bolo to , rozumie sa , pred vojnou .	vojnou	7	Ins
S pocitom prihlúpleho vidiečana som prešiel po asfaltovej ceste , ktorá viedla k zhluku novopostavených budov .	zhluku	13	Dat
Celý ďalší týždeň jeho život pripomínal nepokojný sen .	sen	7	Acc
Pri stanovení termínu veľkého pôstu siahli uhorskí zákonodarcovia k jeho starej východnej podobe ešte spred 7 . storočia , ktorá sa v 11 . storočí nepoužívala už ani na kresťanskom východe ani na západe .	podobe	12	Dat
Newspeak bol oficiálnym jazykom Oceánie , vytvorený kvôli ideologickým potrebám angsocu , teda anglického socializmu .	potrebám	9	Dat
Deti sa budú matkám odnímať už pri pôrode , ako vajce sliepke .	matkám	3	Dat
Vytrhol sa z pavúčej priadze takou silou , že nič netušiaceho pavúka s ôsmimi nohami prevrátilo horeznačky .	nohami	14	Ins
Aladin sa zatiaľ usadil so skríženými nohami pred krištáľovou guľou .	guľou	9	Ins
Z dverí vykúkli ospalé včely .	včely	4	Nom
Slová mi uviazli v hrdle .	hrdle	4	Loc
Srdce ťa ešte stále ťahá k oldspeaku s celou jeho neurčitosťou a zbytočnými významovými odtieňmi .	oldspeaku	6	Dat
A on stále striehol na mramorových schodoch podstavca bez sochy .	schodoch	6	Loc
Bratovi farárovi prajeme v tejto funkcii múdrosť , vytrvalosť a Božie vedenie .	Bratovi	0	Dat
V okne na prvom poschodí zbadala uväznenú cvrčicu .	cvrčicu	7	Acc
Ale pri pochodovaní sa nerozpráva .	pochodovaní	2	Loc
Za jej chrbtom mi zostala v zábere Talianova tvár .	zábere	6	Loc
Týchto ľudí , ktorí pochádzali zo strednej triedy zamestnancov a z vyšších vrstiev robotníckej triedy , sformoval a zoradil jalový svet zmonopolizovaného priemyslu a scentralizovanej vlády .	triedy	7	Gen
Takto som trávieval večery , márnil som čas pred televízorom .	televízorom	9	Ins
Hravo obopínal jednou rukou celý Júliin pružný pás .	rukou	3	Ins
Za dverami stáli uplakané pestúnky .	dverami	1	Ins
Z čiernej nočnej oblohy sa spustil lejak .	oblohy	3	Gen
Winston počul v hlave klokotanie krvi .	klokotanie	4	Acc
Vláda bude využívať štátne záruky iba v nevyhnutných prípadoch na prefinancovanie splatných úverov so štátnymi zárukami , ak to umožní zákon o štátnej pomoci a ak hrozí realizácia záruk z prostriedkov verejných financií .	prefinancovanie	10	Acc
Pri analýze skúmaného javu v práci sme použili viac vrstiev v úvode spomenutých prvkov .	vrstiev	9	Gen
Podľa nich klerici sa nielenže nesmeli opíjať , ale mali aj povinnosť brániť veriacim v prehnanom požívaní opojných nápojov .	požívaní	16	Loc
V prúde krvi a slín mu z úst vypadli dve polovice zubnej protézy .	krvi	2	Gen
Vyzývateľom bol Vilko .	Vyzývateľom	0	Ins
Na dne oceána sa otriasali vraky lodí a potopené poklady .	oceána	2	Gen
“ To je lev .	lev	3	Nom
Ďalším dôkazom samosprávy týchto plemien bola paralelná existencia novgorodského a vodského daňového okruhu v Koporí .	plemien	4	Gen
Prirodzeným krokom v napĺňaní integračných ambícií Slovenska je vstup krajiny do Európskej menovej únie .	krokom	1	Ins
Nezískala ho ani Matica , ani občianske združenie Komorra a nedarí sa to ani gymnáziu .	gymnáziu	14	Dat
Bol som rozjarený , ohúrený od šťastia , ktoré vo mne vzbudzovalo obavy .	šťastia	6	Gen
Mohutná posteľ pri okne bola zastlaná dotrhanými prikrývkami a na poduške chýbala obliečka .	okne	3	Loc
Krman si bol vedomý , že meno Slovákov treba aj v latinčine odlišovať od všeobecného názvu slavi a vytvoril nové slovo slovacii .	latinčine	11	Loc
Vláda bude pokračovať v znižovaní miery prerozdeľovania prostredníctvom verejných financií .	financií	9	Gen
Roztvoril denník .	denník	1	Acc
Jodie Foster sa vracia k filmu .	filmu	5	Dat
Lorine prsia ma zľahka tlačili na hrudníku , a o poschodie vyššie ležala v studenej izbe mŕtva Marga .	izbe	15	Loc
Mozog mi pracoval na plné obrátky , keď som zvažovala , ktorá z možností je správna a meravou rukou som úhľadne zakrúžkovávala odpovede ceruzkou , úplne vlhkou od potu .	ceruzkou	23	Ins
Obaja sme začuli mamino zlostné vzdychnutie .	vzdychnutie	5	Acc
Nôž by mal minimálne obsahovať : veľkú a malú čepeľ , otvárač na fľaše a konzervy , rydlo , výhodné je , ak obsahuje dierovač , pílku na drevo , vývrtku , pinzetu .	konzervy	15	Acc
Nad fotografiou bol titulok Dvaja Albánci v putách ruského Interpolu .	fotografiou	1	Ins
“ Som Makulienka , “ vraví motýľovi .	motýľovi	6	Dat
Pri ďalšej skúške vymenila slák za golfovú palicu , takže Klotilda musela kričať a prišla o hlas .	hlas	16	Acc
Ak ste sa na ňu pozreli zblízka , okolo očí mala zopár vrások .	očí	9	Gen
Vnútorný zmysel kresťanstva zostal väčšine ľudí predmongolskej Rusi cudzí .	väčšine	4	Dat
Položil ruku na ciferník .	ruku	1	Acc
Za ním vyšla starena , ktorá sa hneď skryla pod dáždnik .	dáždnik	10	Acc
Mala na sebe len podprsenku a nohavičky .	podprsenku	4	Acc
„ Ypsilon ako hláska nie je funkčný a v slovenskom jazyku takej hlásky niet .	hláska	3	Nom
Igelitku s pivom položila na stôl .	Igelitku	0	Acc
Bolo tu pododdelenie televíznych programov s inžiniermi , producentmi a s celými tímami špeciálne vybraných hercov , lebo dokázali imitovať hlasy .	programov	4	Gen
Nateraz sa uzavrel pred vzdialenejšími zvukmi a počúval len kvákanie , ktoré sa valilo z obrazovky .	kvákanie	9	Acc
Cirkevný trest spočíva v pokání .	trest	1	Nom
Jej priebeh je možné zrekonštruovať zhruba takto — Pred obradom samotným bolo postavené obetisko s pôdorysom štvoruholníka so štyrmi stĺpmi v rohoch .	pôdorysom	15	Ins
Vtedy víly pochopili , že je načase , aby dievčine povedali pravdu .	dievčine	9	Dat
Zrazu ma jedna zúrivá krava nabrala na rohy .	rohy	7	Acc
Areál Zväzu spisovateľov smrdí močom .	močom	4	Ins
Vybavím to rýchlo a hneď zaspím dobrým spánkom .	spánkom	7	Ins
Maja s Vilkom poprisili o kúsok smrčka a statočne ho prežúvali , len aby sa zavďačili hostiteľovi .	hostiteľovi	16	Dat
“ Tu opice hniezdia .	opice	2	Nom
Keď Tayerle povedal slovo dvojica , Chris sa otočil a spýtavo na mňa pozrel , pričom nadvihol obočie .	obočie	17	Acc
Keď ich spustil na zem , zazrel na vzdialenom konci miestnosti trojstranné zrkadlo .	miestnosti	10	Gen
Aj Maja so škriatkom opustili topoľ a leteli , kým nedoleteli k domu , kde sa v oknách ešte svietilo .	domu	12	Dat
Môj cynizmus bol strojený .	cynizmus	1	Nom
Cítil som vôňu jeho tela , ktorá bola premiešaná so zápachom tabaku a alkoholu .	tabaku	11	Gen
A dospeli k paradoxným poznatkom .	poznatkom	4	Dat
Ja som vedel , že jej portrét sa nachádza medzi viečkami medailónu v skrini , kde sú uložené aj biele svadobné šaty so závojom .	portrét	6	Nom
Nilus bol skôr predstaviteľom východného typu mnícha , v osobe ktorého sa spájala vysoká miera asketizmu s rovnako vysokou úrovňou vzdelanosti a kvality duchovného života .	asketizmu	15	Gen
“ Začni na ostrove Idra , kde vyhľadáš Filokteta , učiteľa hrdinov . “	hrdinov	11	Gen
Ako sa princ blížil k palácu , Kráľovná zla mu postavila do cesty múr z tŕňových krov .	palácu	5	Dat
Víťaz získava CD alebo DVD podľa vlastného výberu !	Víťaz	0	Nom
“ Prečo nie , “ odvetil Chris , keď chvíľu snoril v knižnici a prezeral si farebné obaly kníh .	knižnici	12	Loc
Iba sa trochu sklonila , odkryla deku a ja som uvidel tvár spiaceho človiečika , ktorý nemal takmer nijaké vlasy .	deku	6	Acc
Zajac mohol byť vykladaný v systéme predkresťanských názorov jednak ako symbol plodnosti / dodnes spájame na veľkú noc vyobrazenia zajacov s vajíčkami , Nemci počas tohto sviatku hľadajú v záhrade vajíčka ukryté veľkonočným zajacom / .	vajíčka	30	Acc
Nová Koncepcia ochrany prírody a krajiny bude obsahovať racionálny systém manažmentu chránených území , prehodnotí ich cieľový stav a navrhne opatrenia a programy starostlivosti tak , aby chránené územia slúžili aj verejnosti .	manažmentu	10	Gen
Na rube sa nachádza postava vcelku s vladárskou korunou , kopiou a štítom , obkolesená zrkadlovým gréckym nápisom „ Dimitrij “ .	kopiou	10	Ins
Ako vyzerá herec snov ?	snov	3	Gen
Wilsher , blondiak s nasprostastým výrazom na tvári , ktorého takmer nepoznal , ho s úsmevom pozýval na voľné miesto pri svojom stole .	úsmevom	15	Ins
Polícia včera oznámila , že Korac pri pokuse o zadržanie spáchal samovraždu .	pokuse	7	Loc
Mauglí skĺzol po liane dolu .	liane	3	Loc
Osvetovú kampaň Nádej pre život podporili Svetová zdravotnícka organizácia , minister zdravotníctva , Slovenská geriatrická a gerontologická spoločnosť , Slovenská lekárska spoločnosť , Slovenská internistická spoločnosť a Slovenská kardiologická spoločnosť .	organizácia	8	Nom
Sestrička , ktorá si uvedomila , že ju o niečo okradol , tíško zanariekala .	Sestrička	0	Nom
Prepáčila by mi to , aj keby vedela , že som to odkladala kvôli nočnému astronomickému klubu s Chrisom ?	klubu	16	Dat
Týchto ľudí , ktorí pochádzali zo strednej triedy zamestnancov a z vyšších vrstiev robotníckej triedy , sformoval a zoradil jalový svet zmonopolizovaného priemyslu a scentralizovanej vlády .	zamestnancov	8	Gen
Zbehom a pútnikom vo filmoch a knihách trvá návrat do rodnej obce neraz celé desaťročia .	filmoch	4	Loc
Marketing deformuje naše vnímanie a chápanie pravdy .	vnímanie	3	Acc
Na zemi ležal obrázok s prasknutým rámom .	rámom	6	Ins
Ale keď veľký vlk vopchal do košíka ňufák , bábätko sa zasmialo .	košíka	6	Gen
Vláda v každom prípade prijme kroky na zvýšenie motivácie rodičov a ich detí študovať , respektíve skutočne plniť povinnú školskú dochádzku .	rodičov	9	Gen
Po chvíli však medzi nami zavládlo napäté ticho a obaja sme sa otočili k oknu .	oknu	14	Dat
Priznanie bolo len formalitou , zato mučenie bolo ozajstné .	Priznanie	0	Nom
Keď bol ľan poriadne mokrý , krtko ho zaniesol na breh .	breh	10	Acc
Zovrelo mi žalúdok a zrýchlil sa mi pulz .	pulz	7	Nom
Sklo je prirodzene náchylné rozbiť sa a plech nezaručuje odolnosť voči vlhkosti .	vlhkosti	11	Dat
Ani Izraelci neboli na púšti naveky .	púšti	4	Loc
Bližšie pozri Dodatok . Ponoril pero do atramentu a potom chvíľu váhal .	Dodatok	2	Acc
Vyzeráte úžasne ! “ vravel trom zošúvereným babizniam .	babizniam	7	Dat
Pri vchode do školy sa objavila Liza .	vchode	1	Loc
Z Bibinej pokladničky sa stratili peniaze .	pokladničky	2	Gen
V noci sa zatvárala do medailónu a patrila Profesorovi .	medailónu	5	Gen
TEÓRIA A PRAX	PRAX	2	Nom
Celou cestou domov som sa dívala z okna do tmavej prázdnoty .	cestou	1	Ins
V jeho krásnej vile bude určite príjemne .	vile	3	Loc
Cítil som sa ako vidiečan , ktorý prvýkrát prišiel do hlavného mesta .	vidiečan	4	Nom
Nešporné služby Božie sa u nás konajú pravidelne každú prvú nedeľu v mesiaci v modlitebni .	modlitebni	14	Loc
Ako kráčal k dverám , mince v mešci príjemne zacinkali .	dverám	3	Dat
Nastala chvíľa , aby som si oživil v pamäti tú ženu .	pamäti	8	Loc
Duchovné osoby boli ideálnymi parlamenármi , lebo podľa dobových predstáv majú osobitnú ochranu boha pred nebezpečím .	parlamenármi	4	Ins
Považovala to za skvost vtipnosti a s potešením ho vzala do náručia .	náručia	11	Gen
Winston počul v hlave klokotanie krvi .	krvi	5	Gen
Domorodcom prišlo vhod , že som sa ubytoval v tej izbe .	Domorodcom	0	Dat
Tieto funkcie sú nápadne podobné funkcii kléru na starej Rusi — pri kláštoroch boli útulky pre chorých a existovali dokonca „ kláštorní lekári “ , ktorí spadali do kompetencie cirkevného práva .	kláštoroch	12	Loc
Zrazu mi napadlo , že vtedy nás to zblížilo , keď bral vážne môj problém s obrátkou .	obrátkou	16	Ins
Ďalším dôkazom samosprávy týchto plemien bola paralelná existencia novgorodského a vodského daňového okruhu v Koporí .	dôkazom	1	Ins
Z kuchyne som vzala dva vínové poháre a veľkú fľašu malinovky .	malinovky	10	Gen
Začal písať o značkách aj seriál , pretože patria neodmysliteľne k našej civilizácii .	seriál	5	Acc
Sprievod vyšiel z uličky za domom , čo znamená , že musel zomrieť niekto , kto býva v dome .	domom	5	Ins
Po vypnutí obrazovky nastalo v miestnosti hrobové ticho .	vypnutí	1	Loc
Nechal som tam Margu stáť a podišiel som k dverám .	dverám	9	Dat
Chvíľu tam ležal akoby omráčený , pričom mu z úst a z nosa stekal pruh tmavej krvi .	úst	9	Gen
Pohľad , ktorý sa mi naskytol , ma vydesil .	Pohľad	0	Nom
Správu aktív bude v tomto systéme zabezpečovať súkromný sektor , výber správcu bude v plnej kompetencii občana .	kompetencii	15	Loc
Ráno našla Kasandra chrápajúceho strážcu a prázdnu komoru .	strážcu	4	Acc
Osobitne by sme si chceli povšimnúť právne normy , v ktorých ide o odvádzanie desiatku klérom .	klérom	15	Ins
Keď Jazmína vošla na chodbu , čo viedla do prijímacej siene , zjavil sa nesmierne rozrušený sultán .	siene	10	Gen
“ Bude tam titulok : Slávna rekordérka fotografuje reportérov , “ povedala Blythe .	reportérov	8	Acc
Džin ho každý večer otupoval a džin ho každé ráno znovu oživoval .	večer	3	Acc
Chvíľu ho nechali metať sa vo vode , no potom prilákali k studni muža , čo okopával záhradku .	studni	12	Dat
Švihák Pedro sa v letku obrátil a zmizol kdesi v diaľke .	diaľke	10	Loc
Podľa viery ugrofínskych Čuvašov výšivka konskej hlavy na ženskej hrudi chráni pred nebezpečím pôrodu .	nebezpečím	12	Ins
Ale ja som nepoznal šéfa televízie Sírius .	šéfa	4	Acc
Sopky vreli , vyčíňali búrky a zemetrasenia , svet bol plný zmätku a veľkého zdesenia .	Sopky	0	Nom
Sankcia teda obsahuje v sebe ako hľadisko trestné , tak aj hľadisko náhrady škody pozostalým .	náhrady	12	Gen
Winston zapálil horák a postavil naň kanvicu s vodou .	kanvicu	6	Acc
Po špičkách som zišiel do salóna na prízemí , kde som na chvíľu zastal so zatajeným dychom .	prízemí	7	Loc
Najskôr som začul psí brechot .	brechot	4	Acc
Z hľadiska reformátorov bol tento fakt jednou z najvážnejších prekážok na ceste k dosiahnutiu slobody cirkvi .	dosiahnutiu	13	Dat
Newspeak bol oficiálnym jazykom Oceánie , vytvorený kvôli ideologickým potrebám angsocu , teda anglického socializmu .	angsocu	10	Gen
Abdullah vytiahol z vrecka šiat menšiu krištáľovú guľu .	šiat	4	Gen
Naším zámerom je odstrániť najmä deformácie , ktoré zakladajú neopodstatnené nerovnosti medzi občanmi alebo zavádzajú do sociálneho systému cudzorodé prvky , akým je napríklad nesystémové včlenenie kúpeľnej starostlivosti do sociálneho poistenia .	zámerom	1	Ins
Pri rešpektovaní špecifík poľnohospodárskej výroby vláda bude podporovať rozvoj voľného trhu s agropotravinovými výrobkami a slobodnú konkurenciu v poľnohospodárskom podnikaní .	trhu	10	Gen
Keď uplynul tretí deň a ja som sa v ten večer konečne ocitol sám , bol som na pokraji nervového vyčerpania .	pokraji	18	Loc
Chris sa držal vľavo , šiel v pruhu , ktorý rozhodne neviedol ku knižnici .	knižnici	13	Dat
Primeraná pozornosť bude venovaná rozvíjaniu vzťahov s krajinami Ázie , Afriky a Latinskej Ameriky .	rozvíjaniu	4	Dat
Srdce mu poskočilo .	Srdce	0	Nom
Zaujal výberom tém aj ich spracovaním .	výberom	1	Ins
Nazvem ho incidentom s bláznami .	incidentom	2	Ins
V ten večer som štyri hodiny písala prácu o intimite .	intimite	9	Loc
Pod ním bola na fotografii Cruellina priateľka Anita , jej manžel Roger a ich kuchárka .	kuchárka	14	Nom
Duchovní v tejto funkcii sa netešia veľkej úcte , sú ohováraní svojimi nevoľníkmi , mučení a zabíjaní .	úcte	7	Dat
Na jednom z programov Českej televízie sa momentálne dá vidieť skvelá séria ľahkých , avšak nebulvárnych reportáží zo života s názvom Ta naše povaha česká .	programov	3	Gen
Keď prišla k vile , vyhodila som tranzistor z obloka .	vile	3	Dat
Lykožrút Fridolín potom odniesol víťaza medzi jasajúcich divákov .	Lykožrút	0	Nom
Podišli sme k pultu , kde som objednala tortillu so syrom .	tortillu	8	Acc
Pri realizácii zahraničnej politiky bude vláda SR venovať stálu pozornosť otázkam ľudskej dimenzie .	otázkam	10	Dat
Moji priatelia dúfali , že sudcovia a Lienka sfúknu zvyšok a ja nebudem potrestaný .	priatelia	1	Nom
Cieľom reforiem v sociálnom systéme je zníženie jeho zneužívania , odstraňovanie byrokracie a potláčanie korupcie .	potláčanie	13	Nom
Vláda pripraví aktualizáciu národnej stratégie prevencie kriminality a vytvorí legislatívne podmienky na jej realizáciu .	stratégie	4	Gen
Domčeky vyzdobili girladnami a Vilko s Emilom urobili na jednom krtinci kĺzačku , kde šantili deti .	Domčeky	0	Acc
Keď sa však priblížila , uvidela v tráve svetlovlasé spiace dievčatko v červených šatôčkach .	tráve	7	Loc
Spratal neuveriteľné množstvo kukuričných placiek a mľaskal pritom a navyše ich zlostil híkavým smiechom .	smiechom	13	Ins
Zo zlatej čaše popíjal víno a džin mu masíroval nohy .	čaše	2	Gen
Pod bielym strniskom starcova tvár očervenala .	strniskom	2	Ins
Kým komáre krúžili koldokola na kraji lesa , na krajinu pomaličky sadala tma .	tma	12	Nom
Stisla peniaze v ruke a odišla .	ruke	3	Loc
Vláda si uvedomuje , že súčasťou problémov v rezorte zdravotníctva a dôvodom nespokojnosti obyvateľstva je vysoká miera korupcie .	korupcie	17	Gen
Priateľky a príbuzní ju ponechali svojmu osudu .	Priateľky	0	Nom
Vlak bol plný proletov so sviatočnou náladou , ktorú v každom vyvolávalo letné počasie .	náladou	6	Ins
Po niekoľkých pokusoch Aziza pochopila .	pokusoch	2	Loc
Vonku zaznel dupot ťažkých čižiem .	dupot	2	Nom
Chris pootvoril ústa a zľahka mi hrýzol pery , ako keby ich ochutnával .	pery	7	Acc
Pred priateľovou ordináciou čakalo zo dvadsať ľudí , lavice pri stene boli obsadené .	stene	10	Loc
Obsiahly vlastivedný úvod ( Praefatio ) k Doležalovej gramatike napísal o generáciu starší Matej Bel .	gramatike	8	Dat
A táto skvelá žena vyšla v mojom prípade navnivoč ako maslo v psej koži .	koži	13	Loc
Nemal topánky , veľké špinavé prsty mu vyčnievali z dier na ponožkách .	ponožkách	11	Loc
Pokrútila som hlavou .	hlavou	2	Ins
Nastal bod obratu .	obratu	2	Gen
Za nič na svete však nechcela opustiť svoju rodinku , a tak sa Rudko a Flip rozhodli , že jej občas pomôžu .	rodinku	8	Acc
“ Ešte raz blahoželám , “ povedal Chris , keď si cestou späť sadol v autobuse vedľa mňa .	cestou	11	Ins
Lavdim Lavdoshaj sa konečne rozhodol , že mi uverejní jednu poviedku v poslednom septembrovom čísle .	čísle	14	Loc
Keď sa mi posmievala , zmocňovala sa ma trpká zlosť , napriek tomu medzi nami nedochádzalo k scénam .	scénam	17	Dat
V ďalšom potom budeme identifikovať odraz tejto jeho pozície v sledovaných právnych normách .	normách	12	Loc
Zaujímavým náleziskom sú timerevské mohyly .	náleziskom	1	Ins
Oblasť severovýchodnú , rostovsko ‐ suzdaľskú , s nižším stupňom rozvoja ekonomiky a s podmienkami pre dlhšie udržanie konzervatívnych , starých názorov .	podmienkami	14	Ins
Vari letím do mravčieho neba ?	neba	4	Gen
Bola to kvapôčka rosy , ktorá sa v noci vytvorila na kvete .	kvete	11	Loc
Na zlepšenie komunikácie s verejnosťou sa zavedú pravidelné stretnutia funkcionárov polície s občanmi .	verejnosťou	4	Ins
Keď po prižmúrení vytlačil z očí slzy , náhle pocítil hlad .	hlad	10	Acc
Srdce mu od radosti poskočilo , keď Wendy urobila posledný krôčik a zmizla .	krôčik	10	Acc
Ako kňažná s kniežaťom .	kniežaťom	3	Ins
Ako mala vo zvyku v takýchto prípadoch , povedala mi , aby som išiel do svojej izby .	zvyku	3	Loc
„ Akže umierajú vaši ľudia , sú do neba vynášaní , akže naši , idú k našim do priepasti . . . “	priepasti	18	Gen
Zlý sultán bol od šťastia ako omámený .	šťastia	4	Gen
Prvý deň sa deťom v škole veľmi páčilo !	deťom	3	Dat
“ PÄŤ TELEFONÁTOV ! “ zvolala som , keď som zbadala , že doma v chodbe bliká svetielko na odkazovači .	chodbe	15	Loc
Silného človeka .	človeka	1	Gen
Premenlivosť minulosti je podstatou angsocu .	angsocu	4	Gen
Poznal som naspamäť všetky Čechovove poviedky a novely , ktoré vyšli v albánčine .	novely	7	Acc
Celkové dojmy z výletu ?	výletu	3	Gen
Vyliezla spod listu a obzerala sa okolo seba .	listu	2	Gen
Ľudská postava vcelku s kniežacou čiapkou , alebo korunou držiacou atribúty moci .	korunou	8	Ins
Dal priniesť koše kvetov , podnosy so sladkými včelími špicmi a jazmínové koláčiky .	podnosy	5	Acc
Pokrčila som list a zahodila ho v kuchyni do koša .	koša	9	Gen
Chytil ma za ruku a bežali sme dolu kopcom až k svetlám .	ruku	3	Acc
Na tvári som jej videla , že ju to vzalo , a keď vstala zo stoličky , bála som sa , že odíde z kuchyne .	tvári	1	Loc
O kom to chrobáky rozprávali ?	chrobáky	3	Nom
Prvým príznakom jej existencie je pasáž o stvorení sveta . . .	stvorení	7	Loc
Modlime sa a pomáhajme im na ich ceste , aby sa aj ich srdce zapálilo víťazstvom lásky , pravdy , nádeje a života .	víťazstvom	15	Ins
Takáto interpretácia stvorenia človeka diablom je zjednodušením .	zjednodušením	6	Ins
Tajná zbraň : krtkov tunel	zbraň	1	Nom
Rodičom sa však taký vývoj udalostí nepáčil a zišli sa na porade .	Rodičom	0	Dat
Do tváre sa mu opieral príjemný letný vzduch .	tváre	1	Gen
John sa vystrel , vypäl hruď , ale bol nesmierne smutný .	hruď	5	Acc
S cieľom zefektívnenia správy rozpočtových prostriedkov a správy finančných prostriedkov štátu vláda uskutoční kroky na urýchlené dobudovanie systému štátnej pokladnice .	pokladnice	19	Gen
Omar ležal chvíľu roztiahnutý na zemi .	zemi	5	Loc
Dnes priniesla zebre a medvedíkovi plnú škatuľu šťavnatých jabĺk .	medvedíkovi	4	Dat
Vláda bude naďalej podporovať rozvoj bývania vytváraním legislatívnych , inštitucionálnych a finančných podmienok .	vytváraním	6	Ins
Spomínala na všetkých kamarátov i na to , ako mohla byť aspoň na chvíľočku kapitánom mravcov .	chvíľočku	13	Acc
V zásade príslušnosť k týmto trom skupinám sa nededí .	zásade	1	Loc
Oba tieto kánony zodpovedajú dávnej praxi latinskej cirkvi .	praxi	5	Dat
Ani nad záhadnými delegáciami , ktoré ma prišli navštíviť .	delegáciami	3	Ins
Na vrchole koleso chvíľu postálo a náš vozík sa knísal zboka nabok .	vrchole	1	Loc
“ Kým nebude jeho hlava visieť na múre môjho domu , dovtedy nebudeme v bezpečí . “	múre	7	Loc
Netrvalo dlho , a policajti prišli do kaviarne zatknúť zlodeja .	kaviarne	7	Gen
Dievčatko pozrelo hore .	Dievčatko	0	Nom
Škriatok , ktorý opustí kvet , má zázračnú moc .	kvet	4	Acc
Zdravotníkovi som dal meno Vehap a črty ošetrovateľa .	Zdravotníkovi	0	Dat
“ Prevediete nás podzemnými chrobačími chodbami ? “	chodbami	5	Ins
Možno to bola tlmená ozvena nevedomia .	ozvena	4	Nom
Musím rešpektovať Marginu požiadavku , aby som deťom nič nepovedal , a zároveň musím nájsť pre Irmu nejaké presvedčivé vysvetlenie .	deťom	7	Dat
Odložil som pohár a očami som opäť zablúdil k protiľahlým stolom , pri ktorých sedeli spomínaní ľudia .	stolom	10	Dat
Tým bola narušená klasická štruktúra ruského mesta s oddeleným posadom a hradiskom .	posadom	9	Ins
S letenkou v ruke som vyšiel z izby a zamieril k stolu , kde sedeli recepčné z môjho poschodia .	ruke	3	Loc
Wendy a chlapci vyjavene hľadeli , ako k oblohe stúpa čierny dym .	oblohe	8	Dat
Zamieril som k činžiaku .	činžiaku	3	Dat
Ich bojový pokrik prilákal spústu divákov .	divákov	5	Gen
Chlapec mu prebehol prstom po hrdle .	hrdle	5	Loc
Súčasné ľudské poznanie je na veľmi vysokej úrovni , stojí na prahu klonovania nového života .	klonovania	12	Gen
Teraz už neboli v znehybnených pózach .	pózach	5	Loc
Mauglímu vystúpili do očí slzy .	slzy	4	Nom
A vtedy dobráckemu panterovi čosi napadlo .	panterovi	3	Dat
Neveril som vlastným ušiam .	ušiam	3	Dat
Za finančnú podporu sa chcem poďakovať Ekumenickej rade cirkví , nášmu drahému zboru a „ staršej “ mládeži ECAV v Prešove , modlitebnému spoločenstvu , kamarátom z tréningu Rovesník a jednotlivcom .	spoločenstvu	23	Dat
Moje oči márne hľadali pri okne so železnými prútmi nejaký rám s oficiálnym portrétom .	portrétom	13	Ins
Vtedy mi utkveli v pamäti dátumy , mená i dôležité udalosti z minulosti , medzi ktoré bolo neskôr ľahšie dokladať nové dátumy , mená i vzťahy .	dátumy	21	Acc
Poznala som aj všelijaké iné historky , podozvedala som sa ich , keď k mame chodili na návštevu ženy .	mame	14	Dat
“ Ako ste si mohli myslieť , že zvíťazíte nado mnou , nad Kráľovnou zla !	zla	14	Gen
Podporí v rámci krajín EÚ kompatibilnosť v oblasti vzájomného uznávania dokladov o dosiahnutí určitého stupňa vzdelania .	dosiahnutí	12	Loc
/ vedie k pochybnosti o pevnosti náboženského presvedčenia Nikolu .	pochybnosti	3	Dat
Mysľou zalietol do zamotaného sveta doublethinku .	Mysľou	0	Ins
Naďalej som tam stál so spustenými rukami a na Lorino objatie som neodpovedal .	rukami	6	Ins
A nohy ma priviedli do obchodu , kde predávali alkoholické nápoje .	obchodu	5	Gen
Gaston od úžasu onemel , keď uvidel , ako Bela cvála na koni cez kamenný most .	koni	12	Loc
Okolo preletela penica .	penica	2	Nom
Poslúchol som ju a podišiel k oknu .	oknu	6	Dat
Na jeho tvári viseli matkine ustráchané oči .	tvári	2	Loc
Stále som mal pred sebou obraz ženy v medailóne .	ženy	6	Gen
Neodpustiteľným hriechom však bola promiskuita medzi straníkmi .	hriechom	1	Ins
Vzdelanie sa stáva kľúčom k životnému úspechu , najlepšou investíciou do budúcnosti , účinnou prevenciou pred nezamestnanosťou , zločinnosťou , drogami .	prevenciou	14	Ins
Na jednom viečku bola Profesorova tvár .	viečku	2	Loc
Váhavo sme sa od seba odtrhli a Chris ma odprevadil k nášmu oknu .	oknu	12	Dat
Vláda prehodnotí systém výkonu správy súdov , ktorý príliš zaťažuje sudcov administratívnymi činnosťami , osobitne pri štátnej správe jednotlivých súdov .	činnosťami	12	Ins
Júlia tíško zapišťala , v jej hlase sa ozvalo prekvapenie .	prekvapenie	9	Nom
A slabých bytostí , ako bola mama .	mama	6	Nom
Jeden sa volal Plné gate .	gate	4	Nom
“ Si výnimočné dievča , Jazmína . “	dievča	3	Nom
Mauglí pokrútil hlavou a chytil sa neďalekého stromčeka .	stromčeka	7	Gen
Dnes priniesla zebre a medvedíkovi plnú škatuľu šťavnatých jabĺk .	zebre	2	Dat
Napla svaly na nohách , vystrela plecia , pozbierala odvahu a slabo sa na mňa usmiala .	plecia	6	Acc
Oblievala ma smrteľná hrôza a trepal som nohami zo všetkých síl .	nohami	7	Ins
Rozpočet celého okruhu verejných financií bude zostavovaný v metodike Európskej únie .	okruhu	2	Gen
Pri rešpektovaní špecifík poľnohospodárskej výroby vláda bude podporovať rozvoj voľného trhu s agropotravinovými výrobkami a slobodnú konkurenciu v poľnohospodárskom podnikaní .	rešpektovaní	1	Loc
Konkrétnym príspevkom k prevencii konfliktov a k udržaniu mieru bude aj naďalej aktívna účasť v medzinárodných mierových operáciách .	prevencii	3	Dat
S očividným uspokojením dokázal rozprávať o náletoch vrtuľníkov na nepriateľské dediny , o procesoch s ideozločincami , o ich priznaniach a o popravách v katakombách Ministerstva lásky .	vrtuľníkov	7	Gen
V oblasti nemocenského poistenia prijme vláda opatrenia zamedzujúce zneužívaniu systému .	zneužívaniu	8	Dat
Zobrala ďalšie dve dievčatá , ostatných nechala tak a celé popoludnie špehovali dajakého čudáka .	popoludnie	10	Acc
Akýsi muž mi povedal , že odišla pred hodinou .	hodinou	8	Ins
Z ich tiel nikdy nijaké dieťa nepovstane .	tiel	2	Gen
Pred zotmením sa vracala domov a na noc starostlivo zatvárala škáročku v strome .	škáročku	10	Acc
Nahol sa cez otvorené okno a pobozkal ma .	okno	4	Acc
Rád by som v tomto poďakovaní spomenul všetkých , ktorí akoukoľvek radou či pomocou prispeli ku zrodu predkladanej publikácie .	zrodu	16	Dat
Mama rázne podišla k oknu .	oknu	4	Dat
Hodiny a hodiny zabíjam vylepovaním tých ich gebuzín po celom Londýne .	hodiny	2	Acc
Zákon prispeje k stabilizácii príjmov územnej samosprávy .	stabilizácii	3	Dat
Vláda bude hľadať spôsoby legislatívnej úpravy , aby v Národnej rade SR neboli prijímané zákony s nekrytými rozpočtovými dôsledkami .	spôsoby	3	Acc
K tejto problematike patria podľa nášho názoru i právne normy , ktoré upravujú niektoré procesné záležitosti .	problematike	2	Dat
Navyše technológia našich tlačiarní sa ani dnes veľmi neodlišuje od technológie z čias Gutenberga .	tlačiarní	3	Gen
Jeho zbierka totiž , podľa nás , predstavuje prechodný typ cirkevnoprávnej zbierky , ktorý stojí medzi cirkevnoprávnymi zbierkami vzniknuvšími v období dominancie germánskeho práva a zbierkami reformnými , ktoré sú predstupňom diel klasickej kánonistiky .	predstupňom	30	Ins
Po rokom 1044 sa nachádza správa o narodení Vseslava , ktorému matka na radu volchvov uviazala amulet , spôsobiaci že z chlapca vyrástol krutý a nemilosrdný človek .	volchvov	14	Gen
Veď nás Duchom Svätým a pomáhaj nám prekonávať všetko , čo v EÚ a našom svete bude slúžiť smrti a zániku .	zániku	20	Dat
Práve im okazoval svoju trofej .	trofej	4	Acc
To prehovoril kvietok , čo rástol pri vode .	kvietok	2	Nom
Dlho sedela na kraji lesa a pozerala , ako zlaté klasy zľahka povievajú v letnom vánku .	vánku	15	Loc
Prítomnosť nálezov kačacích príveskov sa vysvetľuje tiež importom zo Škandinávie , prostredníctvom nápodoby laponských a karelských kovolejárov .	nálezov	1	Gen
“ Pozrite na toho zbabelca ! “ zakričal nejaký nezbedník .	zbabelca	4	Acc
Zaletela k nim , sadla na kvet a počúvala tiché zurčanie potoka .	zurčanie	10	Acc
Pôvodne sa nachádzal na freske severozápadnej veže .	freske	4	Loc
Variant , že pôjdem po žobraní , sa mi nepáčil .	žobraní	5	Loc
S letenkou v ruke som vyšiel z izby a zamieril k stolu , kde sedeli recepčné z môjho poschodia .	letenkou	1	Ins
V lete 1948 v Prahe zažiadal o zahraničné štipendium .	lete	1	Loc
Mama sa každú chvíľu vráti z práce .	chvíľu	3	Acc
A tak sa stalo , že nakoniec som sa na jednej hodine roztriasla , keď som si predstavila niečo strašné : v budúcnosti ma čaká to isté , čo stihlo moju mamu .	hodine	11	Loc
“ Aký pouličný potkan ? “ priadla Jazmína .	potkan	3	Nom
Ako sa princ blížil k palácu , Kráľovná zla mu postavila do cesty múr z tŕňových krov .	princ	2	Nom
Rozhodila rukami .	rukami	1	Ins
Systematicky podrýva súdržnosť rodiny , zato svojho vodcu označuje pomenovaním , ktoré priamo vyvoláva pocity rodinnej vernosti .	pomenovaním	9	Ins
Dieťa spokojne ležalo a nič nenaznačovalo , že sa vlci chystajú vyjsť z jaskyne .	vlci	9	Nom
Smrteľne nebezpečné bolo predovšetkým to , ak niekto rozprával v spánku .	spánku	10	Loc
Pustili sa do upratovania školských plástov .	plástov	5	Gen
Moja epocha bola uzavretá .	epocha	1	Nom
Kráčal som za ním po tichej chodbe nemocničného pavilónu a ani som si nevšimol , že Irma nie je s nami .	chodbe	6	Loc
Chvíľu leteli , až pristáli v spustnutej záhrade , kde bola pod obrovskou smutnou vŕbou hlbočizná studňa .	studňa	16	Nom
Netrvalo dlho a vedľa nej sa pod veľkým černicovým kríkom zjavil tučný svetlohnedý pavúk .	pavúk	13	Nom
Napokon vstal , tackavo a hojdavo prešiel celou , hlboko ponoril ruku do vrecka na kombinéze a s rozpačitým výrazom podal mužovi s umrlčou tvárou ufúľaný kúsok chleba .	mužovi	21	Dat
Kláštory a ich opáti sú tu podriadení diecéznym biskupom , ktorých povinnosťou je kláštory často vizitovať .	biskupom	8	Dat
Holeňový vred mu natreli hojivou masťou .	masťou	5	Ins
Sama zájdem do chalúpky k siedmim trpaslíkom .	trpaslíkom	6	Dat
Dr . Hanesová nastolila niekoľko veľmi aktuálnych problémov , s ktorými sa borí nejedna cirkevná škola na Slovensku .	škola	15	Nom
Do izby sa vrútila Júlia .	izby	1	Gen
Bola tu celá reťaz zvláštnych oddelení , ktoré sa zaoberali proletárskou literatúrou , hudbou , dramatickým umením a vôbec zábavou .	umením	16	Ins
Na príjazdovej ceste pred Taco Villa stál dlhočizný rad áut , v ktorých sedeli decká z našej školy .	decká	14	Nom
Čakal som , kým zaparkuje auto , a potom sme išli do kaviarne pri ceste .	auto	5	Acc
Vo dverách sa objavila plavovláska , pripomínajúca plavovlasé dievčatá z výťahu .	dverách	1	Loc
Iskra podozrenia voči ošetrovateľovi , ktorá vo mne vzbĺkla , okamžite zhasla .	ošetrovateľovi	3	Dat
Tvárila si sa na štarte ako spiaca krásavica .	krásavica	7	Nom
Bál som sa , že zloží slúchadlo , a tak som sa usiloval rýchlo niečo vymyslieť .	slúchadlo	6	Acc
Politika zameraná na zníženie deficitnosti verejných financií vytvorí spolu s reformami v najvýznamnejších výdavkových rezortoch priestor na zníženie odvodov a priamych daní .	reformami	10	Ins
Kravy bučali a zo slamy utekalo všetko živé .	Kravy	0	Nom
Zostalo ti deväť , desať , jedenásť zubov .	zubov	7	Gen
Chlapec bol voľný .	Chlapec	0	Nom
Ako uviazla v lekne	lekne	3	Loc
Netrvalo dlho , a policajti prišli do kaviarne zatknúť zlodeja .	zlodeja	9	Acc
Za odchodom ženy s okuliarmi nasledoval príchod zvláštneho človeka .	okuliarmi	4	Ins
Právo na prístup ku kultúrnym hodnotám je jedným z dôležitých práv všetkých občanov .	práv	10	Gen
Rozrývalo mi to dušu a ničilo nervy .	nervy	6	Acc
Vláda sprehľadní pravidlá dotačnej politiky a zároveň dokončí realizáciu schválenej licenčnej politiky .	pravidlá	2	Acc
Slovo „ drúk “ malo tentoraz ničivý účinok .	drúk	2	Nom
Muži zo sprievodu to jednohlasne odobrili .	Muži	0	Nom
Mal som strach z niečoho iného : zo stretnutia s Tomom .	stretnutia	8	Gen
Koho máte na mysli ?	mysli	3	Loc
Za jeho stiahnutými mihalnicami sa pohyboval celý les prstov v akomsi tanci , vykrúcal sa a skrúcal , strácal sa jeden za druhým a znova sa objavoval .	prstov	8	Gen
Vláda bude naďalej podporovať účasť Ozbrojených síl SR v mierových misiách a operáciách na podporu mieru a na boji proti terorizmu , s dôrazom na operácie pod vedením NATO .	operáciách	12	Loc
Ani kolegovia .	kolegovia	1	Nom
Naučil ju i zopár tónov a zakrátko už Jazmína zabávala hostí jednoduchou melódiou .	melódiou	12	Ins
Vybrala najligotavejšie jabĺčko a podala ho chlapcovi .	chlapcovi	6	Dat
Nassir zdvihol maličký uzlík .	uzlík	3	Acc
Samo Gorze sa na začiatku 11 . storočia dostalo vďaka zásahu svojho diecézneho biskupa do rúk clunyjského reformátora Viliama z Dijonu .	zásahu	10	Dat
“ Držím ti palce , Amy , “ povedal s úsmevom , ktorý by roztopil i ľad .	úsmevom	10	Ins
Robili taký rámus , že sa ich rev ozýval široko ‐ ďaleko po celej džungli .	rámus	2	Acc
Pelikánia slečna Polly a jej veľký zobák	slečna	1	Nom
Náklady na sociálnu solidaritu budú hradené z jasne pomenovaných zdrojov .	Náklady	0	Nom
Potom sa vrhol do vody a rozpleštil sa na člne , až ma od smiechu rozbolelo brucho .	brucho	16	Nom
“ Ste veľmi pekná , “ povedala Maja more .	more	8	Dat
Netrvalo dlho a obaja lavínu skyprili , takže sa párik cvrčkov ľahko dostal von .	párik	9	Nom
Viem o vašej veľkej finančnej štedrosti .	štedrosti	5	Loc
Vyznajme Bohu svoje hriechy , potom nám Boh daruje tento pokoj skrze vieru v Ježiša Krista .	hriechy	3	Acc
Včeliu kráľovnú chcem živú .	kráľovnú	1	Acc
Ako bábky v tom divadle .	divadle	4	Loc
List Polikarpa igumenovi Pečorského kláštora Akindinovi .	igumenovi	2	Dat
Sprístupnením informácií o poskytnutých dotáciách výrazne obmedzí priestor pre korupciu a klientelizmus v podpornej politike štátu .	Sprístupnením	0	Ins
Husté čierne vlasy jej padali na plecia a zakrývali tvár .	vlasy	2	Nom
Pri raňajkách som mame vyrozprávala ten sen .	mame	3	Dat
Ministerstvo mieru sa zaoberá vojnou , Ministerstvo pravdy lžami , Ministerstvo lásky mučením a Ministerstvo hojnosti hladomorom .	lásky	11	Gen
Chvíľu zúril ako tiger .	tiger	3	Nom
Isté výhrady voči Závodszkého dielu sme pojali aj my .	dielu	4	Dat
Herkules skočil do jaskyne smrti , aby zachránil Meginu dušu , a z mládenca sa razom stal starec na pokraji smrti .	mládenca	13	Gen
A kým je môj pas v rukách toho muža , veci vonkoncom nevyzerajú dobre .	pas	4	Nom
Tieto slová básne sú melódiou toho , čo sme cítili v srdciach .	melódiou	4	Ins
Zaujímavým javom je veľké množstvo hrebeňov .	javom	1	Ins
U ugrofínskych národov fungoval orol ako predok a ochranca šamanov .	ochranca	8	Nom
S pocitom prihlúpleho vidiečana som prešiel po asfaltovej ceste , ktorá viedla k zhluku novopostavených budov .	vidiečana	3	Gen
Do toho , do toho , do toho , povzbudzovala som sa v duchu , cítiac , ako mi pulzuje celé telo .	duchu	13	Loc
A pred očami sa mi zjavila Lorina tvár .	tvár	7	Nom
Za veľkými stolmi sedeli princovia a šľachtici .	princovia	4	Nom
Mestské zastupiteľstvo schválilo umiestnenie menších sôch šiestich patrónov Európy na Nádvorie Európy , ktoré je vo výstavbe .	sôch	5	Gen
Celkové dojmy z výletu ?	dojmy	1	Nom
Keď sa však hlasuje v parlamente o zmluve s Vatikánom , zriadení katolíckej univerzity , SNS to podporila . "	zriadení	11	Loc
Keď sme všetko spratali , odšuchatala som sa do obývačky a prepínala kanály na televízore .	kanály	12	Acc
Nazlostený Flip sa jediným obrovským skokom preniesol k pavučine .	pavučine	8	Dat
Bol to nádherný okamih : sedeli sme vedľa seba v prítmí autobusu a žlté pouličné osvetlenie ožiarilo Chrisovi tvár .	osvetlenie	15	Nom
Winston ho pozoroval kútikom oka .	kútikom	3	Ins
" Dom je naozaj obkľúčený , " povedal ten hlas .	hlas	9	Nom
Maja sa sklonila k zemi .	zemi	4	Dat
Svoje životy zasvätili dobytiu sveta , ale vedia aj to , že vojna má sa viesť do nekonečna a nemá ju korunovať víťazstvo .	dobytiu	3	Dat
Z týchto vzájomných kontaktov totiž vyplývajú isté indície o tom , do akej miery mohli byť myšlienky rímskych reformátorov recipované uhorskou cirkvou a jej zákonodarstvom .	myšlienky	16	Nom
Ani družka , ani sok ho nesledujú . Čo ho núti vysedávať na konári osamoteného stromu a vyludzovať hudbu do prázdna ?	družka	1	Nom
Je síce pravda , že nijaký súdruh Ogilvy nikdy neexistoval , ale zopár riadkov v tlači a niekoľko vyfabrikovaných fotografií čoskoro splodia jeho existenciu .	fotografií	19	Gen
Človeka to bohvieako nezaujímalo , popíjal z pohára a škriabal na papier tie svoje znaky .	pohára	7	Gen
Nastala chvíľa , aby som si oživil v pamäti tú ženu .	ženu	10	Acc
K tejto problematike patria podľa nášho názoru i právne normy , ktoré upravujú niektoré procesné záležitosti .	názoru	6	Gen
Šance na zachovanie výsledkov tunajších reforiem boli lepšie ako v Dolnom Lotrinsku , lebo tieto reformné strediská požívali citeľnú podporu svetskej aristokracie .	výsledkov	3	Gen
Súčasťou návrhu bude aj kontrolný a monitorovací mechanizmus efektívneho využívania nástrojov podpory regionálneho rozvoja .	Súčasťou	0	Ins
Preleteli sme cez oddelenie topánok , kozmetiky , vyhli sme sa nápadne namaľovaným predavačkám , ktoré ponúkali masky , líčidlá a vzorky kolínskej .	predavačkám	13	Dat
A všetci tí ľudia prišli na tvoj pohreb .	pohreb	7	Acc
Takto som sa vyjadril a jej tvár pokryl ľahký rumenec .	tvár	6	Acc
Zachvátila ma panika , nevládal som utekať .	panika	2	Nom
Vláda zabezpečí prepojenie národného obranného plánovania s obranným plánovaním NATO .	plánovaním	8	Ins
Zaujímavá je tu otázka atribútov na obrázku .	obrázku	6	Loc
“ Máš cez obed voľno ? “ spýtal sa .	obed	3	Acc
Preto neskrývame obavy , či sa nechytí aj nás táto nemoc .	obavy	2	Acc
Len spomedzi študentov náročnej školy vzídu študenti , ktorí sa dokážu presadiť v silnej konkurencii .	konkurencii	14	Loc
Na druhej strane jeho činy neupravuje nijaký zákon , ani nijaký jasne sformulovaný kódex správania .	správania	14	Gen
Nestrácal som čas a priložil som oko k škáre v podlahovej doske .	škáre	8	Dat
“ Tento víkend ostanem doma .	víkend	2	Acc
Nebolo ťažké udržať ich pod dozorom .	dozorom	5	Ins
Srdce ťa ešte stále ťahá k oldspeaku s celou jeho neurčitosťou a zbytočnými významovými odtieňmi .	odtieňmi	14	Ins
Vláda vytvorí podmienky pre uskutočnenie úspešného referenda o vstupe do EÚ , ktoré bude dokumentovať udržanie širokej podpory verejnosti tomuto historickému kroku .	vstupe	8	Loc
Na tvári som jej videla , že ju to vzalo , a keď vstala zo stoličky , bála som sa , že odíde z kuchyne .	kuchyne	24	Gen
Stromboli neveril vlastným ušiam .	ušiam	3	Dat
S kŕdľami strák , ktoré poletovali po pustom parku pri Domove dôstojníkov .	kŕdľami	1	Ins
Vytieňoval lícne kosti a tmavé obočie .	obočie	5	Acc
A s týmito neskutočnými útrapami v duši . . .	útrapami	4	Ins
Pre novodobú vedu bola pamiatka objavená v roku 1773 v Archangeľsku V . V . Krestininom v zborníku z prvej polovice 16 storočia .	vedu	2	Acc
Tieto funkcie sú nápadne podobné funkcii kléru na starej Rusi — pri kláštoroch boli útulky pre chorých a existovali dokonca „ kláštorní lekári “ , ktorí spadali do kompetencie cirkevného práva .	chorých	16	Acc
Celý ďalší týždeň jeho život pripomínal nepokojný sen .	týždeň	2	Acc
Prúd áut sa zastavil .	áut	1	Gen
Jej učiteľka Kasandra hovorila o ľuďoch oveľa prívetivejšie .	učiteľka	1	Nom
Do základnej školy chodil v Kukovej , kde ukončil štyri triedy .	triedy	10	Acc
Zdvihol zrak na O ' Briena .	zrak	1	Acc
Nežne pozhŕňal mince do hnedého plátenného mešca .	mince	2	Acc
Vďaka týmto skúsenostiam pre mňa teoreticky neexistovalo nijaké tajomstvo súvisiace s túžbami , ktoré nútia muža pokúšať sa o zblíženie so ženou .	skúsenostiam	2	Dat
Potom som sa po špičkách odkradla do kuchyne a potichu som vypla hodiny .	špičkách	4	Loc
Začul prekrásny hlas Šípkovej Ruženky , ktorý sa niesol lesom .	lesom	9	Ins
Pokračovala v nezmenenom tempe stále bližšie k jeho stolu .	stolu	8	Dat
V svetle lampy som uvidel agresívnu formu jej pŕs .	lampy	2	Gen
Keď ju vyvreskúvali stovky hrdiel za dupania pochodujúcich nôh , zmocňovala sa človeka hrôza .	dupania	6	Gen
Ten medailón patril mojej mame .	mame	4	Dat
Jeho obaja starší bratia išli do škôl a Ferda mal prevziať obchod .	škôl	6	Gen
Vláda sa bude usilovať o postupné zapájanie kapacít nášho obranného priemyslu do štruktúr európskeho obranného priemyslu .	kapacít	7	Gen
Jan prichádza do kraja po zvestiach o zabití žien volchvami .	zabití	7	Loc
V tom sne najsilnejší bol pocit sebaklamu , lebo v skutočnosti vedel , čo je za tým temným múrom .	sne	2	Loc
Omar sa zasmial od ucha k uchu .	uchu	6	Dat
Oči mi na chvíľu zastali na tenkej retiazke , na odhalenej časti pŕs .	retiazke	7	Loc
Keď mravenisku hrozilo nebezpečenstvo , statočne ho bránili .	mravenisku	1	Dat
Jeho pani bola na počudovanie osa a mala veľmi útly driek .	driek	10	Acc
Vtedy sa ma zmocil čudný , nepríjemný pocit .	pocit	7	Nom
Tak znie neodvolateľné proroctvo o osude jeho umenia .	osude	5	Loc
S mamou bol Zhlúpnutý Sokrates .	mamou	1	Ins
V tichosti .	tichosti	1	Loc
Pani učiteľka odviedla svoju triedu a predseda motýlieho spolku hovoril niečo o podvode .	spolku	8	Gen
Vo Zvedoch som robila vedúcu oddielu .	oddielu	5	Gen
“ Neskáč ! “ kričali naňho ženy a deti a muži zatiaľ uzatvárali stávky .	ženy	6	Nom
Bogomilstvo je totiž iba jednou z nepreberného množstva náuk , obsahujúcich prvky dualizmu .	prvky	11	Acc
Pokrútil hlavou .	hlavou	1	Ins
Vrátil som sa a znovu som si sadol k stolu .	stolu	9	Dat
Tie obleky mi poskytli kľúč k riešeniu .	riešeniu	6	Dat
Jabĺčko vypadlo dievčine z ruky .	dievčine	2	Dat
A ja som skľúčene odišiel z jeho kancelárie .	kancelárie	7	Gen
Bavilo ma písať kompozície a na vynikajúcom skalickom gymnáziu boli veľmi dobré podmienky pre kultúru .	gymnáziu	8	Loc
Nakukol pomedzi húštinu a uvidel troch tvorov v šatách namiesto kožušiny .	šatách	8	Loc
Ďalším dôkazom samosprávy týchto plemien bola paralelná existencia novgorodského a vodského daňového okruhu v Koporí .	existencia	7	Nom
Vláda bude i naďalej venovať sústredenú pozornosť podpore efektívnych programov boja proti drogám .	drogám	12	Dat
Čakal som v obývačke , mal som na sebe oblek s kravatou .	kravatou	11	Ins
Za to , že som neprehltol spomenutú návnadu , nevďačím nijakej inteligencii .	inteligencii	11	Dat
Všetci obyvatelia Makovej lúky sa zišli na čistine , kde Rudko poriadal letecké preteky .	čistine	7	Loc
A keď som nakoniec prišiel domov , hneď som upadol do mŕtvolného spánku .	spánku	12	Gen
Pri cieli sa skrýval osiak Boris a zrkadielkom oslňoval ostatných pretekárov , len aby pomohol svojmu zmrzačenému kamarátovi zvíťaziť .	cieli	1	Loc
“ To je krása ! “ povedala svojej sprievodkyni .	sprievodkyni	8	Dat
“ To je idiotský nápad ! “ zvolal , ale videla som , že sa mu to páči .	nápad	4	Nom
V súlade s európskym trendom budeme podporovať rozširovanie výmery ekologického poľnohospodárstva a výroby biopotravín .	poľnohospodárstva	10	Gen
Zrazu sa nad ňou ktosi tichučko zasmial a akýsi hlások sa jej spýtal : “ Prečo sa bavíte so bzdochou ? “	hlások	9	Nom
“ Počkaj , až ochutnáš Safiyinu špecialitu , “ nadšene vravel , keď sluhovia kládli na stôl ťažký strieborný podnos s polguľovitým vrchnákom .	stôl	16	Acc
Nezávislosť sudcov a záruky jej zabezpečenia sú jednou stranou mince .	zabezpečenia	5	Gen
Za okamih boli preč a na lúčke opäť zavládol mier .	lúčke	6	Loc
Odpoveď je zdanlivo jednoduchá .	Odpoveď	0	Nom
“ Často som brával Mauglího na potulky džungľou .	džungľou	7	Ins
“ Hrozne sa na tých hodinách nudím .	hodinách	5	Loc
Hľadel jej do tváre zo vzdialenosti niekoľkých krokov .	krokov	7	Gen
Tentoraz to však nebolo hlásenie o vojenskom víťazstve , ale iba oznámenie Ministerstva hojnosti .	hojnosti	13	Gen
Vyšiel som z obchodu .	obchodu	3	Gen
Neviditeľní jazdci na koňoch sú vyjadrením predstavy o zlých duchoch , schopných ubližovať človeku odnesením jeho duše do podsvetia .	odnesením	14	Ins
Winston i Syme postrčili svoje podnosy k okienku .	okienku	7	Dat
Potom si ukryla tvár do dlaní .	tvár	3	Acc
So zlovestným úškľabkom na tvári Uršuľa chrlila na Arielu hromy ‐ blesky .	tvári	4	Loc
Vláda zabezpečí implementáciu koncepcie integrácie zdravotne postihnutých do života , aby mohli pracovať a plnohodnotne sa zúčastňovať na živote spoločnosti .	integrácie	4	Gen
Mama sa pobrala do kuchyne , no na polceste zastala .	polceste	8	Loc
Netvor na ňu hľadel rovnakým pohľadom .	pohľadom	5	Ins
To je MOŽNO tá pozitívna stránka ROZDELENIA REPUBLIKY .	stránka	5	Nom
Našťastie sme zastali pri obrubníku pred pizzeriou Rajské slasti a všetci náhle stratili o nás záujem , keďže snívali o pizze .	obrubníku	4	Loc
Stiahol páku a pokračoval :	páku	1	Acc
Pozvala na ňu Blythe a Ricka a podávala moje obľúbené jedlá : zemiakovú kašu , pizzu , celozrnný chlieb , španielske chimichangas , makaróny so syrom a orechový koláč .	chimichangas	21	Acc
Medzi tieto nedovolené zamestnania patrilo i krčmárstvo , ktorého vykonávanie zakázali aj ostrihomskí synodálni otcovia .	krčmárstvo	6	Nom
Namiesto veľkého podnosu niesla malú tácku , na ktorej bola len jedna šálka s kávou a jeden pohár s rakijou .	kávou	14	Ins
Cieľom reformy je zastaviť demograficky podmienené zvyšovanie vnútorného dlhu priebežne financovaného dôchodkového systému a zvýšiť zaangažovanosť občanov na svojej životnej úrovni v dôchodkovom veku .	dlhu	8	Gen
Parsons to s hlúposťou zvieraťa zhltol ľahko .	hlúposťou	3	Ins
Okamžite jej padol zrak na televízor .	televízor	5	Acc
Sedel na stoličke neprirodzene vzpriamene a jeho mocné prsia sa nadúvali a zachvievali , akoby mal čeliť nárazu vlny .	stoličke	2	Loc
Dlho som býval v brečtane , ktorý rástol na záhradnom domčeku .	brečtane	4	Loc
“ Vidíš , Jago , “ povedal svojmu papagájovi .	papagájovi	8	Dat
Náhradné batérie a aspoň jedna rezervná žiarovka by mali byť samozrejmosťou .	samozrejmosťou	10	Ins
Winston vykročil po chodbe za ňou .	chodbe	3	Loc
Zároveň so svetlom som zapol televízor .	svetlom	2	Ins
Slávnostne , s nádejou v lepšiu budúcnosť .	nádejou	3	Ins
Newspeak nemá pre vedu výraz .	Newspeak	0	Nom
Vláda bude podporovať vývoj a šírenie výrobkov i služieb šetriacich životné prostredie a v rámci legitímnych trhových nástrojov hľadať možnosti podpory malým a stredným podnikateľom zvyšovať investície do „ čistej “ výroby a environmentálnych podnikateľských aktivít .	šírenie	5	Acc
Prehľadal ten kus lesa krížom ‐ krážom , ale niečo ho ustavične ťahalo späť k starej borovici .	borovici	16	Dat
Bála som sa , že keby som naznačila , po čom túžim , mama by si našla aj tretie zamestnanie .	zamestnanie	19	Acc
“ Neviem , “ vraví myška , “ ale možno ti poradia tamtie modré kvietky . “	myška	5	Nom
Aj reformný kánonista Anselm uvádza vo svojej zbierke viacero nariadení o konaní synod .	kánonista	2	Nom
Počul , ako sľubuje klamať , kradnúť , falšovať , vraždiť , rozširovať drogy , prostitúciu , a pohlavné choroby , liať deťom vitriol do tváre .	vitriol	23	Acc
V piaty deň každého mesiaca išla Irma na poštu s príslušným kódom a priniesla domov sto dolárov .	mesiaca	4	Gen
Prirodzeným dôsledkom takéhoto stretu je rozbíjanie vervi a úsilie o znevoľnenie smerdov .	znevoľnenie	10	Acc
Na takomto mieste prelínania sa dvoch kultúr sa ľahšie uchovávajú archaické prežitky .	prežitky	11	Nom
Vtedy mi pripadalo prirodzené vyhľadať v tme jej ruku .	ruku	8	Acc
Na dvore som hadicou napustila slnkom zohriatu vodu a začala som šampónovať auto .	hadicou	3	Ins
Natiahla sa k zásuvke na mojej strane a prehŕňala sa v nej , až kým nenašla škatuľku cigariet .	zásuvke	3	Dat
Na lúke pred stromom sa ozývalo funenie a nejasné hlasy .	lúke	1	Loc
Sexuálny pud vyklčujeme .	pud	1	Acc
Sviečky som vložila do mosadzných svietnikov a postavila ich na stôl .	Sviečky	0	Acc
Hodiny a hodiny zabíjam vylepovaním tých ich gebuzín po celom Londýne .	vylepovaním	4	Ins
Brúsil si na nás zubiská a najradšej by nás zhltol ako malinu .	malinu	11	Acc
Keď po prižmúrení vytlačil z očí slzy , náhle pocítil hlad .	prižmúrení	2	Loc
Tieto úvahy ma uvrhli do krízy , počas ktorej som si uvedomoval svoju vinu .	krízy	5	Gen
Irma nevedela , že Marga leží v nemocnici .	nemocnici	7	Loc
Vláda zabezpečí implementáciu koncepcie integrácie zdravotne postihnutých do života , aby mohli pracovať a plnohodnotne sa zúčastňovať na živote spoločnosti .	postihnutých	6	Gen
Ako prišiel krtko k nohavičkám	nohavičkám	4	Dat
Podišiel som k oknu .	oknu	3	Dat
Príležitosť na zmenu imidžu sa mi naskytla o tri týždne .	Príležitosť	0	Nom
“ Roku 1543 , “ odvetil Chris a opäť sa venoval kresbe .	kresbe	11	Dat
Lori ma nežiadala o schôdzku na konci sveta .	schôdzku	4	Acc
Pre svoju krátkosť a úryvkovitosť sa nedajú podrobiť podrobnejšej analýze .	analýze	9	Dat
Vo filiálke Petrovany sme mali koncom minulého roka dva milé zážitky .	filiálke	1	Loc
Nemajú čas ani myseľ na spory , ktoré by mohli vyplynúť z ich odlišných vyznaní .	myseľ	3	Acc
Potom sa návštevník obrátil k rámu , kde bol otec .	rámu	5	Dat
“ Nemaj strachy .	strachy	2	Acc
Legislatívnym základom bude vládou vypracovaný návrh moderného zákona o výchove a vzdelávaní .	vzdelávaní	11	Loc
“ Pán Shepherd , “ povedal profesor Tayerle a kývol rukou , “ nemyslite si , že som nevidel lístok , ktorý ste dali pred chvíľou slečne Wyseovej .	rukou	10	Ins
V Policajnom zbore sa zmení systém hodnotenia práce , ktorý bude akcentovať mieru spokojnosti občanov s činnosťou polície .	zbore	2	Loc
Preskúmal jej dlhé prsty , pekne vytvarované nechty , dlaň zatvrdnutú ťažkou prácou s množstvom mozoľov , hladkú pokožku pod zápästím .	prácou	12	Ins
Nejaký riaditeľ podniku alebo vedúci brigády na družstve , kde som absolvoval pravidelný mesiac fyzickej práce .	podniku	2	Gen
Aladin však strčil nohu do dverí .	dverí	5	Gen
“ Mám len dvadsiatku , “ povedala Jill , keď čiapka prišla až k nej .	čiapka	10	Nom
Spomenula si na ďatla , a tak zaletela poňho .	ďatla	3	Acc
Koberec , krištáľová guľa a niekoľko pomôcok na čarovanie .	Koberec	0	Nom
Šaty , ktoré šila Flóra , sa nevydarili .	Šaty	0	Acc
Žiaden z pápežov pred Gregorom VII . nešiel do priamej konfrontácie s najvyšším reprezentantom svetskej moci .	reprezentantom	13	Ins
Bola noc a biele tváre a šarlátové transparenty zalievalo zlovestné svetlo .	transparenty	7	Acc
Na rube je Dmitrij Solúnsky .	rube	1	Loc
Oznámime to slečne Kasandre a budeme žiadať náhradu škody .	slečne	2	Dat
“ Mrzí ma to , “ vyhlásil Vilko , “ ale Kurt nie je nijaká osa ! “	osa	15	Nom
Je to chronologicky prvá zbierka , ktorú zostavil neznámy autor z rímskych reformných kruhov .	autor	9	Nom
Keď sa našli uprostred mladiny , obrátila sa k nemu tvárou .	tvárou	10	Ins
Zefektívnime kontrolu a elimináciu stále rozšíreného zneužívania štátnej pomoci .	elimináciu	3	Acc
Odtrhol rožtek balíčka .	balíčka	2	Gen
Halogénové žiarovky sú výhodou .	výhodou	3	Ins
“ A nezabudnite na vrecká , kam zabalíte psom zvyšky . “	vrecká	4	Acc
Bol pri dievčati .	dievčati	2	Loc
Uprostred pretekov som prestala plávať a šliapala som vodu až k miestu , kde sa ponoril .	pretekov	1	Gen
Bála som sa to povedať mame , ktorá prišla na polhodinu domov , aby sa prezliekla , kým pôjde do ďalšej práce .	mame	5	Dat
V blízkej osade Poklony bola Velesova svätyňa , uctievaná pri veľkom dube .	dube	11	Loc
Nechal som u nej kľúč .	kľúč	4	Acc
Človek nikdy nevie , na čo natrafí .	Človek	0	Nom
Okrem chuti ma kuskus zaujal predovšetkým svojou univerzálnosťou .	univerzálnosťou	7	Ins
Vláda bude venovať pozornosť aj ďalším súčastiam slovenskej zahraničnej politiky , medzi ktoré patria viaceré oblasti dvojstrannej a mnohostrannej diplomacie , otázky ľudskej dimenzie , ekonomický rozmer diplomacie , optimalizácia zahraničnej služby .	rozmer	26	Nom
Budúcnosť patrí proletom .	proletom	2	Dat
Tatko sa hneval na deti , lebo ukrutne vyvádzali , a mamka sa hnevala na tatka , že je precitlivený .	tatka	15	Acc
V kapitole o Novgorode sme už rozobrali súvis tzv . Najstaršej Pravdy s protivarjažskými nepokojmi .	súvis	7	Acc
Mestské zastupiteľstvo schválilo umiestnenie menších sôch šiestich patrónov Európy na Nádvorie Európy , ktoré je vo výstavbe .	výstavbe	16	Loc
Uchopil ju za ruku .	ruku	3	Acc
Ak vojde dnu , bude pred nimi v bezpečí .	bezpečí	8	Loc
Vytvoríme kapitálotvornú vrstvu , ktorá bude zárukou blaha ľudu , presvedčivo hlásal tvorca blaha svojich prívržencov .	prívržencov	15	Gen
“ Chodí spať ako slniečko , “ povzdychol si motýľ Emanuel .	motýľ	9	Nom
Posledný krok urobí na Ministerstve lásky .	Ministerstve	4	Loc
Po špičkách som zišiel do salóna na prízemí , kde som na chvíľu zastal so zatajeným dychom .	chvíľu	12	Acc
Na pomoc nám prišiel Brucháč s niekoľkými chrobákmi a onedlho sme mali obydlie pre Chuchlíka pod strechou .	chrobákmi	7	Ins
Obrovský panter zdvihol košík a opatrne ho položil na breh .	panter	1	Nom
Pod gaštanom stálo niekoľko stolov a stoličiek a za živým plotom presvitala tehlová budova hostinca .	stolov	4	Gen
Potom som oči otvorila a ponorená v tme som smerovala k odrazu mesiaca .	odrazu	11	Dat
Baghíra nestrácal ani chvíľu , zdvihol košík a odniesol ho k jaskyni .	jaskyni	11	Dat
Jeden večer sme išli na pizzu , ďalší do kina na horor a potom zasa do obchodného centra na capuccino .	kina	9	Gen
Poďakovanie patrí aj posudzovateľom rukopisu – pánovi prof . PhDr . Richardovi Marsinovi , DrSc . a pánovi PhDr . Jánovi Steinhübelovi , CSc . , ktorí mi pomohli vylepšiť text svojimi cennými postrehmi .	pánovi	6	Dat
Chris sa držal vľavo , šiel v pruhu , ktorý rozhodne neviedol ku knižnici .	pruhu	7	Loc
Zámok sa zatriasol , keď dedinčania vrazili baranidlom do brány .	baranidlom	7	Ins
Väčšie zlá sústavne unikali ich pozornosti .	pozornosti	5	Dat
V ušiach mi zostala len ozvena jeho hlasu a v diaľke , na úpätí podstavca bez sochy , som uvidel Háda .	ušiach	1	Loc
Vytvoríme kapitálotvornú vrstvu , ktorá bude zárukou blaha ľudu , presvedčivo hlásal tvorca blaha svojich prívržencov .	blaha	7	Gen
Zlej víle ostávala posledná nádej — havran .	havran	6	Nom
V prvom variante som sa sústredil na epizódu s nohavičkami .	variante	2	Loc
Bola to vysoká plavovláska s rozpustenými vlasmi a modrými očami , pery mala trochu hrubé a namaľované na tmavočerveno .	očami	9	Ins
Lorine prsia ma zľahka tlačili na hrudníku , a o poschodie vyššie ležala v studenej izbe mŕtva Marga .	prsia	1	Nom
Bol som Faikiným rukojemníkom .	rukojemníkom	3	Ins
Ťarbavo sa pohyboval po javisku a nevedel sa naučiť úlohu .	javisku	4	Loc
Kerchak bránil rodinu proti zákernej mačke , zatiaľ čo ostatní členovia ho pozorovali zo stromov .	mačke	5	Dat
Ferdo z toho usúdil , že bývalí otrokári nevedia ani písať .	otrokári	7	Nom
Ekonomická i politická moc sa dostáva z rúk starej aristokracie do rúk novej buržoázie a literatúra sa usiluje vyhovieť potrebám novej vládnúcej vrstvy .	potrebám	19	Dat
Vláda podporí dosiahnutie kritérií európskej úrovne stavania , kvalifikácie firiem , úspor energie a energetickej certifikácie budov .	kvalifikácie	8	Gen
Vytvorí mechanizmy na získavanie a vyhodnocovanie informácií a odhaľovanie týchto prípadov .	získavanie	3	Acc
Chvíľu tam ležal akoby omráčený , pričom mu z úst a z nosa stekal pruh tmavej krvi .	nosa	12	Gen
S očividným uspokojením dokázal rozprávať o náletoch vrtuľníkov na nepriateľské dediny , o procesoch s ideozločincami , o ich priznaniach a o popravách v katakombách Ministerstva lásky .	ideozločincami	15	Ins
Konfirmáciou sa začína skutočný boj s hriechom , diablom a vlastným telom .	telom	11	Ins
“ Mauglí je v bezpečí , “ zakričal Dizzy Balúovi .	bezpečí	4	Loc
Tomuto cieľu bola podriadená aj metóda ich spracovania .	spracovania	7	Gen
Predkladaná publikácia je doplneným a čiastočne prepracovaným textom dizertačnej práce , ktorú som v odbore Všeobecné dejiny obhájil na jar roku 2000 na pôde Filozofickej fakulty Univerzity Komenského v Bratislave .	textom	7	Ins
Počul , ako sľubuje klamať , kradnúť , falšovať , vraždiť , rozširovať drogy , prostitúciu , a pohlavné choroby , liať deťom vitriol do tváre .	deťom	22	Dat
A strechu Džahijovej chatrče strhla púštna búrka .	chatrče	3	Gen
Za odchodom ženy s okuliarmi nasledoval príchod zvláštneho človeka .	odchodom	1	Ins
Jill a tri plavkyne z plaveckého oddielu Žralokov otvárali vo vode oči , keď som sa vyšvihla hore .	vode	10	Loc
Winstona bolestne bodlo pri srdci .	srdci	4	Loc
Ruská cirkev pozemkový majetok od panovníka nezískala .	panovníka	5	Gen
Aladin sa zatiaľ usadil so skríženými nohami pred krištáľovou guľou .	nohami	6	Ins
Omráčené murény princa napokon pustili .	murény	1	Nom
Oči mala červené .	Oči	0	Acc
Táto imunita ( nenarušiteľnosť ) sa potom vzťahovala aj na všetkých ľudí , ktorí sa v objekte zdržiavali .	objekte	16	Loc
Rád vidím , ako kopú nohami .	nohami	5	Ins
Rozzúrená sa zvrtla a kamennými schodmi zbehla do zámockej pivnice .	pivnice	9	Gen
“ V Aquitare jedia červíky , otec !	červíky	4	Acc
“ Prečo nie , “ zakričala som a zamierila k dverám .	dverám	10	Dat
To je lož !	lož	2	Nom
V tráve vyhrávala letná muzika .	tráve	1	Loc
Ocitla sa v spleti úzkych uličiek , ktoré sa ponášali ako vajce vajcu .	vajcu	12	Dat
Na chvíľu som sa započúval do ticha na schodišti .	schodišti	8	Loc
Keď sa telo spojilo s dušou , dievčina zažmurkala a otvorila oči .	dušou	5	Ins
Maja zaviedla hostí na slávnostne vyzdobenú lúku a ponúkla im vyhliadkový let s vážkou , medové guľôčky , cukrovú vatu a mnoho iných dobrôt .	hostí	2	Gen
A vládca sveta mŕtvych sa mi zjavil v čiernej peleríne .	peleríne	9	Loc
“ Ubezpečujem vás , že nič nehrozí , “ kričal žene sultánov hlavný vezír Džafar .	žene	10	Dat
Prúd mojej energie sa jej vylial na prsia .	Prúd	0	Nom
Hlúpy Gim sa obyčajne zdržiaval pred vchodom do predajne chleba .	predajne	8	Gen
Jill a tri plavkyne z plaveckého oddielu Žralokov otvárali vo vode oči , keď som sa vyšvihla hore .	oddielu	6	Gen
Ešte teraz cítil pach tej vlhkej lepenky .	lepenky	6	Gen
Teraz sa v noci budievam zo spánku a hrdlo mi zviera úzkosť : trápi ma nočná mora , že aj ja som v dave , ktorý ženie mamu v ústrety smrti .	hrdlo	8	Acc
Pozdvihol zrak nahor k tej obrovskej tvári .	tvári	6	Dat
Gazdinky vyložili do okien vankúše , Kasandra zasa medové guľôčky a slečna Hopka usporiadala na čistinke rannú rozcvičku .	Gazdinky	0	Nom
Kým som tam osamote sedel , začul som na chodbe kroky a hlasy .	chodbe	9	Loc
Vstal som a zamieril k pultu .	pultu	5	Dat
Každé ráno sme sa na mojom balkóne hrali hru na mačku a myš .	mačku	10	Acc
Vybudovanie environmentálnej infraštruktúry je nevyhnutnou podmienkou pre vstup do EÚ .	Vybudovanie	0	Nom
Pre novodobú vedu bola pamiatka objavená v roku 1773 v Archangeľsku V . V . Krestininom v zborníku z prvej polovice 16 storočia .	pamiatka	4	Nom
A plagát s akousi kubistickou maľbou .	maľbou	5	Ins
Potom oko zasa zatvorilo .	oko	1	Acc
Ten šíp bohu patrí	šíp	1	Nom
Aladin sa prehrabával v starej truhlici .	truhlici	5	Loc
Vláda bude pri všetkých reformách venovať osobitnú pozornosť tomu , do akej miery navrhované zmeny prispievajú k zníženiu nezamestnanosti a finančnej náročnosti pre daňovníkov a k posilňovaniu motivácie hľadať prácu .	reformách	4	Loc
“ Z očí mi vyhŕkli slzy .	očí	2	Gen
Na druhej strane jeho činy neupravuje nijaký zákon , ani nijaký jasne sformulovaný kódex správania .	kódex	13	Nom
“ Ďakujem , pani Hutchinsonová , “ odvetila som naradostene .	pani	3	Nom
Nepovažovalo sa za žiaduce , aby proleti mali silné politické cítenie .	cítenie	10	Acc
Toto pápežské privilégium bolo vlastne uznaním , že Cluny sú centrom okolo neho vytvorenej skupiny kláštorov , teda právnym podkladom existencie takéhoto spoločenstva rehoľných domov .	privilégium	2	Nom
Tá myšlienka mu v skutočnosti v mysli skrsla v podobe vidiny , skleného ťažidla , ktoré sa zrkadlilo na povrchu sklápacieho stola .	myšlienka	1	Nom
Zrazu som začula klopkanie na okno , no neposkočilo mi srdce ako inokedy .	srdce	10	Nom
Je to cenná a zaujímavá pamiatka o 20 . storočí .	pamiatka	5	Nom
Skupina kánonov I . ostrihomskej synody sa venuje stanoveniu obsahu bohoslužieb a príbuzným kultovým predpisom .	stanoveniu	8	Dat
Uma Thurman a jej priateľ Ethan Hawke očakávajú v júni narodenie dieťaťa .	dieťaťa	11	Gen
Na stoloch stáli všelijaké fľaštičky a v bankách bublali záhadné tekutiny .	bankách	7	Loc
Starého dobráckeho sultána zahalili kúdoly hmly .	hmly	5	Gen
Telový gel , šampón ?	šampón	3	Nom
Jeho zbierka totiž , podľa nás , predstavuje prechodný typ cirkevnoprávnej zbierky , ktorý stojí medzi cirkevnoprávnymi zbierkami vzniknuvšími v období dominancie germánskeho práva a zbierkami reformnými , ktoré sú predstupňom diel klasickej kánonistiky .	kánonistiky	33	Gen
Terk bežala k lagúne a vytiahla Tarzana , ktorý sa poriadne napil vody .	lagúne	3	Dat
Na hrebeni sa otočil a zaparkoval autom celkom pri okraji cesty .	autom	6	Ins
Vtedy mi utkveli v pamäti dátumy , mená i dôležité udalosti z minulosti , medzi ktoré bolo neskôr ľahšie dokladať nové dátumy , mená i vzťahy .	mená	7	Nom
Pri špecifikácii tohoto druhu pramenného materiálu budem vychádzať — na rozdiel od prameňov hmotných — z hľadiska časového , ohraničeného 11 storočím / bližšie pozri v kapitole „ Formulácia problému “ / .	kapitole	26	Loc
Takýmito duchmi môžu byť medvede , vlky , zajace , jelene , kačky , orly , sovy a vrany .	duchmi	1	Ins
Vhodná je paralela z čias môjho starého otca .	paralela	2	Nom
Kolega mi porozprával o tejto epizóde práve v čase , keď moja mama dostala ten slávny list .	epizóde	5	Loc
V nasledujúcej chvíli nastal obrovský rozruch .	rozruch	5	Nom
Dvojtvárnosť trickstera súvisí s celkovým dualizmom , prítomným v systéme prírodného polyteizmu .	dualizmom	5	Ins
Ale keď veľký vlk vopchal do košíka ňufák , bábätko sa zasmialo .	ňufák	7	Acc
Prišiel onedlho so stetoskopom v ruke .	ruke	5	Loc
Po večere v lunaparku sme išli zopár ráz po škole do knižnice .	večere	1	Loc
Potom nasledovala veselá hostina .	hostina	3	Nom
Schytilo dievčinku labkami a vraví : “ Ty moja krásna dievčinka , odnesiem si ťa do hniezda ! “	labkami	2	Ins
Zvuk : Zachráňte vojaka Ryana	vojaka	3	Acc
Ženy a deti sledovali z úkrytu , ako sa muži skrývajú za Jumbom .	úkrytu	5	Gen
To malo obrovský národnozáchovný význam v druhej polovici XIX . storočia , keď maďarizácia reálne ohrozovala samotnú existenciu slovenského národa .	maďarizácia	13	Nom
Spočiatku som mala nepríjemný pocit , že sa na mňa všetci dívajú , ale trvalo to len moment .	pocit	4	Acc
O nich , ako aj o charakteristike ranoarpádovských zákonníkov a synodálnych uznesení hovoríme konkrétnejšie v samostatných kapitolách .	charakteristike	6	Loc
Potom zdvihol hlavu a pozrel sa do okna , pri ktorom som bol ja .	okna	7	Gen
Ide o state č . 2 , 17 , 20 a 28 .	state	2	Acc
Vláda bude klásť dôraz na racionalizáciu nákladov spojených s realizáciou výkonov vo verejnom záujme v železničnej osobnej doprave a verejnej autobusovej doprave .	realizáciou	9	Ins
Chris síce prikývol , ale šibalsky mu sem ‐ tam myklo kútikmi úst .	kútikmi	11	Ins
Tvoj biceps by som obopol palcom a ukazovákom .	palcom	5	Ins
Ako bábky v tom divadle .	bábky	1	Nom
Celú noc som sa prevaľoval na posteli v hotelovej izbe a nemohol som sa zmieriť s realitou .	posteli	6	Loc
Výsady sice majú formu udeľovanej listiny , no v skutočnosti ide o zmluvný zápis , tvoriaci kostru tzv . najstaršej Pravdy .	kostru	16	Acc
Na Makovej lúke panovalo ticho .	lúke	2	Loc
Vyšla z kancelárií a zamierila rovno do Cerberovho brlohu .	kancelárií	2	Gen
Uvedené komplexy sa vyznačujú zmiešaným osídlením Slovanov s inými etnikami a tvrdošijným zachovávaním archaických prežitkov rodového zriadenia , kým mestá sú čisto slovanskými sídlami , určenými na pacifikáciu a christianizáciu kolonizovaných oblastí .	zachovávaním	12	Ins
V prvých troch kapitolách sa teda pokúsime o prieskum problematiky v celoruskom rámci , odhliadnuc od jemnejších miestnych odlišností .	prieskum	8	Acc
Sily sú vyrovnané — a tak sa začína „ mýtická súťaž “ .	Sily	0	Nom
Ku konfliktom a nedorozumeniam výrazne prispelo aj to , že sa maďarské „ nemzet “ dá používať v oboch týchto významoch .	konfliktom	1	Dat
Ako ju veverička Barka odniesla do hniezda	hniezda	6	Gen
Napla svaly na nohách , vystrela plecia , pozbierala odvahu a slabo sa na mňa usmiala .	svaly	1	Acc
A odišla , stratila sa v dave .	dave	6	Loc
“ Hej ! “ zvolala som a chytila volant .	volant	8	Acc
V tej chvíli som otvoril oči a začul som vzlykot .	vzlykot	9	Acc
Zrýchlil sa mi pulz a spomenula som si na sen , v ktorom ma bozkával .	sen	9	Acc
Ustráchaní sedeli na akejsi lúke a nevedeli , kadiaľ sa ide domov .	lúke	4	Loc
Vláda bude využívať štátne záruky iba v nevyhnutných prípadoch na prefinancovanie splatných úverov so štátnymi zárukami , ak to umožní zákon o štátnej pomoci a ak hrozí realizácia záruk z prostriedkov verejných financií .	úverov	12	Gen
Ordinácia je akt , ktorým kandidát svätenia ( ordinand ) získava istý stupeň svätenia .	kandidát	5	Nom
Potom otočil ktorýmsi vypínačom a hlasy zmĺkli .	vypínačom	3	Ins
Cieľom reforiem v sociálnom systéme je zníženie jeho zneužívania , odstraňovanie byrokracie a potláčanie korupcie .	systéme	4	Loc
Jej tvár vo mne vzbudzovala dôveru : bola to pokojná , vľúdna tvár .	tvár	12	Nom
Keď mama v ten deň dočítala list , neplakala .	mama	1	Nom
“ Daj pokoj môjmu mláďaťu ! “ zreval .	mláďaťu	4	Dat
Koleso sa krútilo a náš vozík pomaly stúpal na vrchol .	Koleso	0	Nom
Konkrétnym formám tohto boja za slobodu cirkvi počas reformy sa budeme venovať neskôr .	formám	1	Dat
Tri uvedené stupne výskumu nás vedú ku konštatovaniu , potvrdzujúcemu úvodnú tézu o tesnej prepletenosti oboch systémov , obohatenému však poznaním vnútornej dynamiky jej vývoja .	poznaním	20	Ins
Napokon , aké oprávnenie na existenciu má slovo , ktoré je len opakom iného slova ?	opakom	12	Ins
Všetci smutne hľadeli do prázdneho košíka , kde predtým ležali šteniatka .	košíka	5	Gen
Prvý raz mám príležitosť byť so spisovateľom a filmovým scenáristom , povedala .	scenáristom	9	Ins
Dane a odvody	odvody	2	Nom
Pred dvermi sa objavovali košíky s prekrásnymi plodmi od výmyslu sveta .	košíky	4	Nom
Okolo nej , nad ňou i pod ňou boli ďalšie davy pracovníkov s nepredstaviteľným množstvom úloh .	množstvom	14	Ins
Mnohí z nás s nimi nadviazali hlboké priateľstvá , spoznali sme ich krehučké duše prahnúce po láske , priateľstve a uznaní .	priateľstve	18	Loc
Obyvatelia lúky sa začali zbiehať pred jej domom a chválili Klotildin spev .	spev	11	Acc
“ Nehovor mi , že si mierumilovný netvor !	netvor	7	Nom
Vláda bude pri všetkých reformách venovať osobitnú pozornosť tomu , do akej miery navrhované zmeny prispievajú k zníženiu nezamestnanosti a finančnej náročnosti pre daňovníkov a k posilňovaniu motivácie hľadať prácu .	posilňovaniu	26	Dat
O chvíľu ich už viedli k najlepšiemu stolu v záhrade Amirovej slávnej reštaurácie Kebab .	stolu	7	Dat
Zaujímavý je v tejto súvislosti nález z vykopávok z roku 1960 z Iľjinej ulice .	nález	5	Nom
Medzi tieto nedovolené zamestnania patrilo i krčmárstvo , ktorého vykonávanie zakázali aj ostrihomskí synodálni otcovia .	vykonávanie	9	Acc
V oblasti manželského práva je teda uhorské ranoarpádovské zákonodarstvo , ak ho porovnávame s dobovým kánonickým právom , nejednoznačné .	právom	16	Ins
Jedlo zásadne mení človeka po každej stránke .	človeka	3	Acc
Bolo to to dievča s tmavými vlasmi .	vlasmi	6	Ins
Marketing je súborom disciplín , ktoré sa zaoberajú trhom a v trhovej ekonomike človek má cenu , ktorá sa vyjadruje len peniazmi .	ekonomike	12	Loc
Marginým svätcom bol taliansky spevák Gianni Morandi , mojím Angličan Tom Jones .	svätcom	1	Ins
V každom prípade aj text jeho úvodu dal Doležalovej gramatike punc najautoritatívnejšieho zdroja poznania vtedajšieho spisovného jazyka Čechov i Slovákov .	gramatike	9	Dat
Nakoniec , takisto môže aj Čech čítať slovenské , keby chcel , oni však tú potrebu V ROVNAKEJ MIERE nemajú . “	MIERE	18	Loc
Krútili hlavou .	hlavou	1	Ins
Sledoval som ju pohľadom , až kým sa nestratila v dave .	pohľadom	3	Ins
V šere som vybrala deku a pozakrývala ju .	šere	1	Loc
Blythe bola úžasná , odpustila mi , že som na ňu nakričala kvôli plesu .	plesu	13	Dat
Na rozdiel od iných stretnutí v ten večer nepila .	večer	7	Acc
Z televíznych obrazoviek zaznievala tuctová hudba .	obrazoviek	2	Gen
Mimoriadne príjemným spestrením je izolácia od terénnych nerovností .	spestrením	2	Ins
Potom Maja s kamarátmi pomáhala stroskotancom z vody na nové plavidlo .	kamarátmi	3	Ins
Prečo lovíme zelené kravičky ?	kravičky	3	Acc
Siahol mu do vrecka na šatách a keď vytiahol ruku , mal na dlani veľký červený rubín .	dlani	13	Loc
Najdôležitejšie informácie v marketingovej spoločnosti sú napísané na okraji a malými písmenami .	písmenami	11	Ins
Zbehom a pútnikom vo filmoch a knihách trvá návrat do rodnej obce neraz celé desaťročia .	pútnikom	2	Dat
Kolega mi porozprával o tejto epizóde práve v čase , keď moja mama dostala ten slávny list .	Kolega	0	Nom
Keďže ide o individuálnu záležitosť , škola v tomto dieťaťu veľmi nepomôže .	dieťaťu	9	Dat
Na stenách viseli zaprášené police s prastarými knihami zaklínadiel a čarov .	zaklínadiel	8	Gen
Naďalej som stál na slnku , pri policajtoch .	slnku	4	Loc
S námahou som pochopil , že má na mysli moju chlpatú hruď .	námahou	1	Ins
Vláda pripraví a realizuje systém ochrany slovenského spotrebiteľa a prostredníctvom legislatívy ho prispôsobí stavu , ktorý bude zodpovedať legislatíve EÚ .	legislatíve	18	Dat
Vlci súhlasne pokývali hlavami .	hlavami	3	Ins
V mysli mu mimovoľne naskočila ďalšia spomienka .	spomienka	6	Nom
Prehľadal som vrecká na všetkých sakách a vo vnútornom vrecku jedného z kabátov som našiel fotografiu ženy .	ženy	16	Gen
Bol som rozjarený , ohúrený od šťastia , ktoré vo mne vzbudzovalo obavy .	obavy	12	Acc
Oznamuje východ slnka a prebúdza zo spánku . .	spánku	6	Gen
V posledných mesiacoch žiletky patrili medzi nedostatkový tovar .	žiletky	3	Nom
Moji priatelia dúfali , že sudcovia a Lienka sfúknu zvyšok a ja nebudem potrestaný .	sudcovia	5	Nom
Čo iné im ostávalo , museli prestať s hašterením a začať odčerpávať vodu .	hašterením	8	Ins
Rutherford mal mohutnú postavu , hrivu mastných , sivých vlasov , zjazvenú tvár s vačkami pod očami a hrubé negroidné pery .	hrivu	5	Acc
Kráľ nebol v očiach súčasníkov obyčajným laikom .	laikom	6	Ins
Popri hlavnom hrdinovi Kuberovi je ona ďalšou hrdinkou .	hrdinkou	7	Ins
Bol mučiteľ , bol ochranca , bol inkvizítor , bol priateľ .	inkvizítor	7	Nom
A prišli naraz , mama do izby a prudký lejak do obloka .	izby	6	Gen
Táto správa ma omráčila a doktor ma odprevadil až dolu , k východu z budovy .	budovy	14	Gen
Obrázkovým telefónom som zavolal kováča Kováčika a ten bez dlhých rečí koníka okoval .	rečí	10	Gen
Nálože jeho nenávisti explodujú .	Nálože	0	Nom
Po chvíli Chris vyliezol na strechu .	strechu	5	Acc
Vláda bude klásť dôraz na racionalizáciu nákladov spojených s realizáciou výkonov vo verejnom záujme v železničnej osobnej doprave a verejnej autobusovej doprave .	doprave	17	Loc
Medzitým prišlo na plaváreň zopár deciek z oddielu a ich hlasy sa ozývali po vykachličkovanom priestore .	hlasy	10	Nom
Odraz sa , povedala som si na konci dráhy po prvej dĺžke a hladko som to zvládla .	dĺžke	11	Loc
Na tretí raz sa s ohlušujúcim rachotom rozletela dokorán .	rachotom	6	Ins
A obchody , ktoré chcú predávať zaručene čerstvý , v noci upečený a nezabalený chlieb , musia ho držať v osobitných zasklených policiach , takže skôr nebalenie chlieb zdražuje .	chlieb	14	Acc
Odporná extáza strachu a pomstychtivosti , túžba zabíjať , mučiť , drúzgať tváre kováčskym mlátom akoby preskočila sťa elektrický prúd na všetkých a premenila každého aj proti jeho vôli na vrieskajúceho pomätenca s pokrivenou tvárou .	tvárou	34	Ins
V jednom kuse táral o Týždni nenávisti .	Týždni	5	Loc
V útrobách pocítil zamrazenie .	útrobách	1	Loc
Mauglímu vystúpili do očí slzy .	očí	3	Gen
Popri hlavnom hrdinovi Kuberovi je ona ďalšou hrdinkou .	hrdinovi	2	Loc
Na chvíľu zavládlo trápne ticho , ale potom mu mama podala ruku .	chvíľu	1	Acc
Jedného letného popoludnia sa na Makovej lúke zjavila obluda , akú ešte nikto nevidel .	lúke	6	Loc
Zámerom je dostať všetkých záujemcov do blízkosti rómskej lokality .	záujemcov	4	Acc
Minule sa môj kolega Rado Ondřejíček fejtónovým perom pustil do problému hlupákov medzi nami .	perom	7	Ins
Mimoriadne príjemným spestrením je izolácia od terénnych nerovností .	izolácia	4	Nom
Lavdima Lavdoshaja zaraďovali k príslušníkom konzervatívneho krídla .	krídla	6	Gen
Miestnosť bola priveľmi stiesnená , lebo všetky steny dookola podopierali nespočítateľné množstvo zaprášených rámov naukladaných jeden na druhý .	steny	7	Nom
Biely vždy dáva mat .	mat	3	Acc
Mravce dovliekli celý kôš dobrôt , včielky priniesli ovocný medovník a Kasandra jazmínové želé .	kôš	3	Acc
Aby som sa dostal k vencu , musel som si vziať stoličku .	vencu	5	Dat
Ale keď veľký vlk vopchal do košíka ňufák , bábätko sa zasmialo .	vlk	3	Nom
Si euroázijský špión !	špión	2	Nom
“ To je legálne ? “ vykríkol ktosi a všetci sa pustili do rehotu .	rehotu	13	Gen
Vláda pripraví podmienky pre sústredenie kompetencií v oblasti regulácie a koordinácie elektronickej komunikácie a rozvoja informačnej spoločnosti z rôznych orgánov na jeden regulačný orgán .	regulácie	8	Gen
Bol to nádherný okamih : sedeli sme vedľa seba v prítmí autobusu a žlté pouličné osvetlenie ožiarilo Chrisovi tvár .	autobusu	11	Gen
Nebudete poznať kamarátstvo , nebude mať čo vás povzbudiť .	kamarátstvo	2	Acc
Na oslavu prišli všetci olympskí bohovia a priniesli množstvo nádherných darov .	darov	10	Gen
Makovica zatriasla hlavou .	hlavou	2	Ins
Zlej víle pohrával na červených perách zlovestný úsmev .	víle	1	Dat
Zostal som sedieť v kresle , aj keď sa dvere otvorili a do miestnosti vošli dvaja muži , nové tváre .	dvere	9	Nom
Jej bledosť a mlčanie stačili , aby som okamžite pochopil , že som urobil hlúposť .	hlúposť	14	Acc
Slúžil som u jednej kňažnej !	kňažnej	4	Gen
Keď Maja váhavo pokrútila hlavou , Petronila sa nahlas zasmiala .	hlavou	4	Ins
“ Nádherne ti pristane k vlasom , “ dodala Blythe .	vlasom	5	Dat
Ona odíde prvá a po polhodine ju Winston bude nasledovať .	polhodine	5	Loc
Nazlostený Flip sa jediným obrovským skokom preniesol k pavučine .	skokom	5	Ins
Stáli pred obrazovkou .	obrazovkou	2	Ins
Prítomnosť nálezov kačacích príveskov sa vysvetľuje tiež importom zo Škandinávie , prostredníctvom nápodoby laponských a karelských kovolejárov .	príveskov	3	Gen
Naši chirurgovia dokážu zmeniť ľudí na nepoznanie .	chirurgovia	1	Nom
Bolo významným strediskom na ceste do rostovsko ‐ suzdaľskej oblasti .	strediskom	2	Ins
Našťastie za prvým bukom stretli Truhlíka a zistili , že aj on má na otrokárov ťažké srdce .	srdce	16	Acc
Takto nevyzerá ani autorka článku , ani kamarátova babka .	babka	8	Nom
Čo spraví s dievčaťom , to rozhodne neskôr .	dievčaťom	3	Ins
Najspokojnejšie však boli pestúnky , lebo im vrátia ukradnuté vajíčka .	pestúnky	3	Nom
ŠULAJ PÍŠE ROZPRÁVKU	ROZPRÁVKU	2	Acc
Svedčí o tom podobnosť pečatí č . 4 a 5 s pečaťami č . 6 až 9 patriacimi Izjaslavovým bratom Svjatopolkovi a Vsevolodovi .	bratom	19	Dat
Chris sa zasmial a pomrvil sa na tvrdých hranatých škridlách .	škridlách	9	Loc
Správu aktív bude v tomto systéme zabezpečovať súkromný sektor , výber správcu bude v plnej kompetencii občana .	správcu	11	Gen
Vtom si spomenula na poštového poslíčka Pavla , ktorý okrem správ roznášal po lúke dobrú náladu .	náladu	15	Acc
Stiahol ju nadol , takže kľačali tvárou v tvár .	tvárou	6	Ins
Tri uvedené stupne výskumu nás vedú ku konštatovaniu , potvrdzujúcemu úvodnú tézu o tesnej prepletenosti oboch systémov , obohatenému však poznaním vnútornej dynamiky jej vývoja .	prepletenosti	14	Loc
Nastolíme po voľbách zmenu - odhalením zbohatlíkov , mafiánov , delikventov , korupčníkov a lobistov pri stálom sledovaní blaha občana .	blaha	18	Gen
Slovná zásoba A sa vôbec nedala použiť na literárne účely a na politické a filozofické dišputy .	účely	9	Acc
Tak je po Jaroslavovom víťazstve položený základ novgorodských výsad , ktorí Novgorodcom garantujú ochranu pred kniežacími družiníkmi a Varjagmi / no zároveň zabezpečujú kniežaciu družinu pred ľudom / .	výsad	8	Gen
Voš žijúca v lone vystúpi nahor , na krk , voš z vlasov sa spustí dolu , na líce .	lone	3	Loc
“ Mal som iba dvoch zákazníkov , ženu a muža .	zákazníkov	5	Acc
Len čo polícia odišla , dali si Barbie so Sandrou v kaviarni malinovku .	malinovku	12	Acc
Vytrhol sa z pavúčej priadze takou silou , že nič netušiaceho pavúka s ôsmimi nohami prevrátilo horeznačky .	priadze	4	Gen
Na rozdiel od svätoštefanskej legislácie sú tí , ktorí v nedeľu neprídu do kostola , potrestaní prísnejšie – telesným trestom .	trestom	19	Ins
Navyše nepriateľskú osu hral jeho kamarát hnojník Kurt .	osu	2	Acc
V období vzniku uhorskej cirkevnej organizácie problém , či si uhorský kráľ uzurpoval práva prináležiace Apoštolskému stolcu , ešte nehral rozhodujúcu úlohu .	stolcu	16	Dat
Už sme spomenuli , že za Ladislavovej vlády prichádza k postupnej konsolidácii pomerov v krajine .	konsolidácii	11	Dat
Chlapci sa smiali , keď mocný pirát napol svaly na ruke , až sa mu na ramene zachvel vytetovaný pirátsky znak ‐ lebka so skríženými hnátmi .	svaly	8	Acc
Súžitie etník tu teda fungovalo na princípe spoločenstiev v ktorých jednotlivé zložky popri sebe slobodne existovali a zároveň sa ovplyvňovali , miešali a splývali .	spoločenstiev	7	Gen
V podstate som nedúfala , že príde , no keď som ho zbadala na opačnom konci preplnenej a zadymenej telocvične , myslela som si , že sa mi marí .	telocvične	19	Gen
Bol to úder zasadený Strane .	Strane	4	Dat
Moje oči márne hľadali pri okne so železnými prútmi nejaký rám s oficiálnym portrétom .	prútmi	8	Ins
Takto nevyzerá ani autorka článku , ani kamarátova babka .	článku	4	Gen
Nechal som ho deň predtým na hotelovej recepcii .	recepcii	7	Loc
Piateho mája sa začalo Pražské povstanie a z rádia sa ozývala výzva o pomoc .	výzva	11	Nom
Bol to predsa jej nápad .	nápad	4	Nom
Pokým nevyprázdnili misky , ani jeden z nich už neprehovoril .	misky	2	Acc
V izbe podo mnou spával Profesor , oddeľovala nás iba tenká dosková podlaha .	podlaha	12	Nom
Nečakal na myšiakove ďalšie požiadavky a dvaapolmetrovým skokom sa vzdialil .	skokom	7	Ins
V tejto kapitole budeme hovoriť o cirkevnoprávnych normách , ktoré reglementujú podmienky pre vznik , obsah a zánik manželstva .	normách	7	Loc
A zobudilo lekno .	lekno	2	Acc
Kala pozrela do domu a zbadala stopy po zápase .	domu	3	Gen
Mladým som vyrozumel z tváre , že ani oni sa dobre nevyspali .	tváre	4	Gen
Väčšie zlá sústavne unikali ich pozornosti .	zlá	1	Nom
“ Pomôžem ti , “ povedala Chris , keď som sa snažila udržať rovnováhu na okennom parapete .	parapete	16	Loc
Najprv sme sa pomaly a opatrne zakrádali k ich domu , ale potom sme prebiehali od lampy k lampe .	domu	9	Dat
Poskladali sme vlhkú deku , napchali ju do koša , ktorý sme pomaly uväzovali o korman .	korman	15	Acc
Po večere v lunaparku sme išli zopár ráz po škole do knižnice .	lunaparku	3	Loc
Je isté , že v Ríme reformných pápežov žilo presvedčenie o podriadenosti Uhorska Rímu .	podriadenosti	11	Loc
Lori sa naklonila a natiahla ku mne tvár .	tvár	7	Acc
Podišli sme k pultu , kde som objednala tortillu so syrom .	pultu	3	Dat
Vráť sestričke jej čokoládu ! "	sestričke	1	Dat
Dôležitejším znakom oboch kategórií šamanov je , že úspech ich činov nezávisí od toho , akú obetu bohu prinesú , ale od toho v akom vzťahu sú oni sami s bohmi — tj . od ich schopností .	bohu	17	Dat
Niekedy s chabou nádejou myslel na O ' Briena a žiletku .	nádejou	3	Ins
Utiekla z paláca pred nekonečným zástupom nápadníkov .	nápadníkov	6	Gen
Regula metského biskupa podrobne ustanovuje i podmienky prijatia do spoločenstva kanonikov a v rámci nich predpisuje pre kandidáta povinnosť odovzdať všetok majetok kostolu , pri ktorom mieni pôsobiť .	kostolu	22	Dat
A tu i tam pre nejaký scenár .	scenár	6	Acc
Chutilo jedlo vždy takto ?	jedlo	1	Nom
Budúci pápež však podmienil svoj nástup do úradu – a to bolo v súdobých podmienkach niečím úplne novým – vykonaním regulárnej voľby klérom a ľudom Ríma .	vykonaním	19	Ins
Vláda pripraví transformáciu štátnych zdravotných ústavov na inštitúcie verejného zdravotníctva so zvýraznením opatrení zameraných na zníženie , resp . vylúčenie rizika poškodenia zdravia .	opatrení	12	Gen
Chytil ma za ruku a bežali sme dolu kopcom až k svetlám .	svetlám	11	Dat
Spomenul si , že sedí s drevenou bábkou , na ktorej zarobí milióny .	bábkou	7	Ins
Sadol som si k stolu , odkiaľ som mohol sledovať pohyb pred vchodom do televízie Sírius .	vchodom	12	Ins
Možno o vaše poučovanie nebude vôbec stáť .	poučovanie	3	Acc
“ Takto to vyzerá na Mesiaci , “ povedala som Cheryl Wagnerovej , maturantke , čo sedela vedľa mňa .	maturantke	13	Dat
Alebo si v pamäti vybavím knihu o arabskej kultúre ?	knihu	5	Acc
Tieto kulty a božstvá sú dedičstvom ich rasy , sú dôležitou súčasťou ich každodenného života na vidieku .	rasy	7	Gen
Stvoriteľ chcel , stvoril a riadi svoje stvorenie .	stvorenie	7	Acc
Možnože dievča je jeho členkou !	členkou	4	Ins
V dôsledku rímsko - centralistickej tendencie zbierok prevzali do nich zostavovatelia i viaceré úplne alebo čiastočne sfalšované texty , ktoré však svojím obsahom zodpovedali stanoviskám a snaženiam reformátorov .	snaženiam	26	Dat
V sledovaných cirkevnoprávnych zbierkach sme pendanty k uhorským úpravám nenašli .	úpravám	8	Dat
kríž zo štyrmi bodkami na prekrížení znamená zasiate pole , symbol plodnosti .	plodnosti	11	Gen
Pred okienkom do pivnice ležal lesklý tvor s červenými očami a nahlas funel .	okienkom	1	Ins
V procese obstarávania bude vláda dbať na transparentný systém nakladania s majetkom štátu .	procese	1	Loc
Čakal som celé dve hodiny , ale šéf nechodil .	hodiny	4	Acc
Tá myšlienka mu v skutočnosti v mysli skrsla v podobe vidiny , skleného ťažidla , ktoré sa zrkadlilo na povrchu sklápacieho stola .	stola	21	Gen
Vtedy bola zároveň jedným z hlavných nástrojov , vďaka ktorému udržiavali ľudské spoločnosti kontakt s hmotnou skutočnosťou .	nástrojov	6	Gen
Sprievod vyšiel z uličky za domom , čo znamená , že musel zomrieť niekto , kto býva v dome .	uličky	3	Gen
Noviny ste zabudli v kaviarni , letáky neznášate .	kaviarni	4	Loc
Tak je po Jaroslavovom víťazstve položený základ novgorodských výsad , ktorí Novgorodcom garantujú ochranu pred kniežacími družiníkmi a Varjagmi / no zároveň zabezpečujú kniežaciu družinu pred ľudom / .	družiníkmi	16	Ins
Zrazu začuli vystrašený krik .	krik	3	Acc
Napokon vstal , tackavo a hojdavo prešiel celou , hlboko ponoril ruku do vrecka na kombinéze a s rozpačitým výrazom podal mužovi s umrlčou tvárou ufúľaný kúsok chleba .	výrazom	19	Ins
Bratovi farárovi prajeme v tejto funkcii múdrosť , vytrvalosť a Božie vedenie .	farárovi	1	Dat
Zákon prispeje k stabilizácii príjmov územnej samosprávy .	samosprávy	6	Gen
Rovnakú spoluprácu so svetským sudcom predpokladajú v citovaných ustanoveniach aj sledované súdobé cirkevnoprávne príručky .	príručky	13	Nom
Okno bolo len zámienkou a ona to svojou ženskou intuíciou vytušila .	zámienkou	3	Ins
A mne zostali tóny otcových huslí .	tóny	3	Nom
Vyzliekol si košeľu a skočil za mnou .	košeľu	2	Acc
Vláda bude venovať pozornosť aj ďalším súčastiam slovenskej zahraničnej politiky , medzi ktoré patria viaceré oblasti dvojstrannej a mnohostrannej diplomacie , otázky ľudskej dimenzie , ekonomický rozmer diplomacie , optimalizácia zahraničnej služby .	súčastiam	6	Dat
Napokon preletel cez domček slimáka Oskara a skončil na baze .	baze	9	Loc
Nateraz sa uzavrel pred vzdialenejšími zvukmi a počúval len kvákanie , ktoré sa valilo z obrazovky .	obrazovky	15	Gen
Wilsher , blondiak s nasprostastým výrazom na tvári , ktorého takmer nepoznal , ho s úsmevom pozýval na voľné miesto pri svojom stole .	tvári	7	Loc
Pre chlad som za stolom nikdy nezaspal .	chlad	1	Acc
Mlčky mi podal obálku , čo sa podobala obálke , ktorú mi zverila Liza .	obálke	8	Dat
Uvedené komplexy sa vyznačujú zmiešaným osídlením Slovanov s inými etnikami a tvrdošijným zachovávaním archaických prežitkov rodového zriadenia , kým mestá sú čisto slovanskými sídlami , určenými na pacifikáciu a christianizáciu kolonizovaných oblastí .	osídlením	5	Ins
Nijaká dvojica nevstávala , že pôjde tancovať , plač toho dievčaťa pokazil atmosféru .	dievčaťa	10	Gen
Zakryte nádobu pokrievkou a nechajte vychladnúť na izbovú teplotu .	pokrievkou	2	Ins
“ Dúfam , že získam štipendium na niektorú vysokú školu , “ vyhlásila som , ale nespomenula som , že by som chcela ísť na menšiu , no o to prestížnejšiu univerzitu .	univerzitu	31	Acc
Mesto s ním späté sa stáva dejiskom podivných udalostí .	dejiskom	6	Ins
Svojím typickým gestom si O ' Brien upravil na nose okuliare .	gestom	2	Ins
Roztrhajte jej tvár , roztrhajte jej ju až na kosť .	tvár	2	Acc
Vo dverách sa objavila plavovláska , pripomínajúca plavovlasé dievčatá z výťahu .	plavovláska	4	Nom
Chlapec mu prebehol prstom po hrdle .	prstom	3	Ins
Vzdelanie sa stáva kľúčom k životnému úspechu , najlepšou investíciou do budúcnosti , účinnou prevenciou pred nezamestnanosťou , zločinnosťou , drogami .	nezamestnanosťou	16	Ins
Ochrannú funkciu mal krížik , zakončujúci ihlicu z mosadze .	mosadze	8	Gen
Niekto z mojich niekdajších šéfov , vedúcich kádrového oddelenia alebo veliteľov na vojenských cvičeniach .	oddelenia	8	Gen
Usilovne cvičila až to uši trhalo .	uši	4	Acc
Dal som mu takéto meno , keď som s akousi ľahkosťou presvedčil sám seba , že toto meno najlepšie pristane môjmu hrdinovi .	hrdinovi	21	Dat
Vláda bude pri všetkých reformách venovať osobitnú pozornosť tomu , do akej miery navrhované zmeny prispievajú k zníženiu nezamestnanosti a finančnej náročnosti pre daňovníkov a k posilňovaniu motivácie hľadať prácu .	zníženiu	17	Dat
" Nechápeš , že jediným cieľom newspeaku je zúžiť rozsah myslenia ?	newspeaku	6	Gen
Išli sme až k nášmu vchodu na zadnej strane domu a celou cestou sme mlčali .	vchodu	5	Dat
Vzdelanie sa stáva kľúčom k životnému úspechu , najlepšou investíciou do budúcnosti , účinnou prevenciou pred nezamestnanosťou , zločinnosťou , drogami .	investíciou	9	Ins
Fridolín bol malý hnedý chlapík so silným náprsným štítom a krátkymi krovkami .	krovkami	11	Ins
V niekoľkých sekundách po prebudení sen i spomienka , ktorá ho podnietila , splynuli v jeho mysli v jedno .	spomienka	7	Nom
Vláda pripraví stratégiu riadenia štátneho dlhu , ktorej realizáciou príde k zníženiu nákladov štátneho rozpočtu .	stratégiu	2	Acc
Kalich zvončeka , kde strávila noc , sa knísal vo vetre a bolo tam chladno .	vetre	10	Loc
Keď som ju začal ťahať k posteli , vymanila sa mi .	posteli	6	Dat
Väčšinou sedávame na okne za záclonou alebo v kúte izby a sledujeme ho .	kúte	8	Loc
" Vybudovať civilizáciu na strachu , nenávisti a krutosti nemožno .	civilizáciu	2	Acc
“ Snehulienka predsa leží mŕtva v lese , “ povedala a otvorila skrinku .	skrinku	12	Acc
Nemecký kráľ Henrich III . sa v lete nasledujúceho roku vydal do Ríma , aby sa dal korunovať za cisára .	lete	7	Loc
Ak sa raz oldspeak nahradí , posledné puto s minulosťou sa pretne .	minulosťou	9	Ins
Mama sedela na stoličke pri stole .	stole	5	Loc
Pochutnával si na hurkách kliešťaka Drakulu a pritom nahlas mľaskal .	kliešťaka	4	Gen
Trvalá pozornosť bude venovaná rozvoju vzťahov s Ukrajinou , ktorá je naším najväčším susedom .	rozvoju	4	Dat
Maja si zatiaľ hladkala boľavé plece .	plece	5	Acc
V reformnom hnutí v 10 . a 11 . storočí musíme zreteľne odlíšiť dve základné línie – staršiu reformu monastickú a mladšiu reformu rímsku , resp . pápežskú .	hnutí	2	Loc
Lenže leopard Kerchaka zranil a zakrátko mu bol vodca goríl vydaný na milosť a nemilosť .	nemilosť	14	Acc
Obyčajne majú väčší objem ako klasické karimatky .	objem	3	Acc
Začal písať o značkách aj seriál , pretože patria neodmysliteľne k našej civilizácii .	civilizácii	12	Dat
Istým spôsobom sa mi tam oddávala , v sále bábkového divadla .	divadla	10	Gen
Potom nechal portrét portrétom .	portrét	2	Acc
Zavrtela som hlavou , aby som tie myšlienky zahnala .	hlavou	2	Ins
V Piacenze sa stretol s novým pápežom ( Gregorom VI . ) a prijal ho s náležitými poctami .	poctami	17	Ins
Vo Zvedoch som robila vedúcu oddielu .	Zvedoch	1	Loc
Princezná vzala tigríča do svojej postele .	Princezná	0	Nom
Jedlo je na stole za necelú polhodinu .	Jedlo	0	Nom
Na líci sa nachádza ruža so štyrmi lupienkami , obkolesená zložitou dekoratívnou obrubou .	obrubou	12	Ins
Výsledkom bude , že v nijakej oblasti sa nespotrebuje viac zdrojov , ako na ňu bude vyčlenených v rozpočtoch , ktoré schváli NR SR , resp . jednotlivé samosprávne orgány .	rozpočtoch	18	Loc
Bolo sivé popoludnie s oblohou veštiacou sneh , keď sa človeka zmocňuje ubíjajúca otupnosť a uvoľnenie prináša len alkohol .	človeka	10	Gen
Keď Herkules počul tie slová , vrátila sa mu odvaha .	odvaha	9	Nom
Vláda pripraví stratégiu riadenia štátneho dlhu , ktorej realizáciou príde k zníženiu nákladov štátneho rozpočtu .	zníženiu	11	Dat
Počas výletu bolo ponechané dosť času na voľno a osobné rozhovory .	rozhovory	10	Acc
Niekedy jej rozprával o Oddelení záznamov a o nehanebných falzifikátoch , ktoré v ňom fabrikuje .	falzifikátoch	9	Loc
Vo svojej pokore ďakuje za požehnané dni služby a pestrý život v rodine i v cirkvi .	pokore	2	Loc
“ Musíme byť ticho , “ šepkal škriatok .	škriatok	7	Nom
Spev kohúta máva aj vo všednom , obyčajnom živote dvojaký význam .	Spev	0	Nom
Keď som mala bundu na sebe , zistila som , že ju nepotrebujem .	bundu	3	Acc
“ Ľudské mláďa musí v záujme bezpečia odísť . “	záujme	5	Loc
Voš žijúca v lone vystúpi nahor , na krk , voš z vlasov sa spustí dolu , na líce .	voš	10	Nom
Nikita sám , ako je v texte uvádzané , sa neskôr stáva novgorodským biskupom .	biskupom	13	Ins
Mauglí stál v pozore , keď plukovník pochodoval okolo neho na koniec radu a zasa späť .	pozore	3	Loc
Chcel vzlietnuť do vzduchu , ale zamotal sa do krídel fraku .	fraku	10	Gen
Požiadavka primeraného vzdelania klerika nepotrebuje obšírnejší komentár .	vzdelania	2	Gen
“ Ale keď kapitán Hook na tom trvá ! “ vysvetľoval John , starší z Wendiných bratov .	kapitán	3	Nom
Keď však Winston opravoval pôvodný plán , znížil číslo na 57 miliónov , aby vyhovel bežným požiadavkám na prekročenie kvóty .	požiadavkám	16	Dat
Sklo je prirodzene náchylné rozbiť sa a plech nezaručuje odolnosť voči vlhkosti .	plech	7	Nom
Utiekla z paláca pred nekonečným zástupom nápadníkov .	zástupom	5	Ins
Cieľom reformy je zastaviť demograficky podmienené zvyšovanie vnútorného dlhu priebežne financovaného dôchodkového systému a zvýšiť zaangažovanosť občanov na svojej životnej úrovni v dôchodkovom veku .	zaangažovanosť	15	Acc
Mladí nastúpili do Lorinho auta .	Mladí	0	Nom
Druhá Doležalova inovácia je v gramatickom popise tohto jazyka .	inovácia	2	Nom
V útrobách pocítil zamrazenie .	zamrazenie	3	Acc
Je mi fuk , čo jej urobíte .	fuk	2	Nom
Vláda pripraví transformáciu štátnych zdravotných ústavov na inštitúcie verejného zdravotníctva so zvýraznením opatrení zameraných na zníženie , resp . vylúčenie rizika poškodenia zdravia .	zvýraznením	11	Ins
Euroázia je spojenec .	spojenec	2	Nom
Keď prišli títo ľudia , bol som na vrchole nervového vyčerpania .	vyčerpania	10	Gen
Mamu som zbadala na rovine , keď sa na nebi zablyslo a rozľahol sa mocný hrom .	Mamu	0	Acc
A obchody , ktoré chcú predávať zaručene čerstvý , v noci upečený a nezabalený chlieb , musia ho držať v osobitných zasklených policiach , takže skôr nebalenie chlieb zdražuje .	obchody	1	Nom
Po hodine na mňa Chris čakal pred triedou .	triedou	7	Ins
Podľa nich klerici sa nielenže nesmeli opíjať , ale mali aj povinnosť brániť veriacim v prehnanom požívaní opojných nápojov .	veriacim	13	Dat
Čašníci ich obskakovali , akoby patrili do kráľovskej rodiny .	Čašníci	0	Nom
Predsa o krtkovi Gabkovi .	krtkovi	2	Loc
V škole bola kapitánkou hokejového družstva a dva roky po sebe získala trofej v gymnastike .	gymnastike	14	Loc
Na chodbe zadupotali ťažké čižmy .	chodbe	1	Loc
Ostatné decká mali prísť až o polhodinu , a tak som mala celý bazén pre seba .	bazén	13	Acc
Vláda pripraví legislatívny rámec inštitucionálneho vzdelávania zdravotníckych pracovníkov prostredníctvom rezortu školstva s možnosťou postgraduálnej prípravy pracovníkov v zdravotníctve v školách a inštitúciách , ktoré získajú akreditáciu pre príslušný typ vzdelávania .	inštitúciách	21	Loc
Z malabarského frontu sme práve dostali bleskovú správu .	frontu	2	Gen
Pravdepodobne to teda bol cudzinec .	cudzinec	4	Nom
Nechal som televízor zapnutý a privliekol som sa k dverám bytu .	dverám	9	Dat
Keď Maja začula žalostný nárek muchy , zabudla na strach pred žabami .	žabami	11	Ins
Šance na zachovanie výsledkov tunajších reforiem boli lepšie ako v Dolnom Lotrinsku , lebo tieto reformné strediská požívali citeľnú podporu svetskej aristokracie .	aristokracie	21	Gen
Herkules odniesol Meginho ducha k telu .	telu	5	Dat
Vzhľadom na vytrvalosť , akú prejavoval , som očakával , že takto zaboduje .	vytrvalosť	2	Acc
Symbolickú úlohu má i výzdoba koníka — krúžky s bodkou uprostred sú ďalšou z mnohých modifikácií solárnych znakov .	koníka	5	Gen
Vláda bude zabezpečovať realizáciu Stratégie rozvoja slovenského knihovníctva .	realizáciu	3	Acc
Pozvať ju do tanca .	tanca	3	Gen
Septembrové voľby potvrdili pevnosť demokratických základov Slovenskej republiky .	základov	5	Gen
Keď Shannon otvorila dvere , sprisahanecky ma objal okolo pliec a vliezol na zadné sedadlo .	pliec	9	Gen
“ Asi som ho zabudol u vás na streche ! “	streche	8	Loc
Skočili sme do bazéna Joea Favatu . “	bazéna	3	Gen
Aladin pokrčil plecami .	plecami	2	Ins
Nemohla som tú otázku zodpovedať ani pánu Tayerlemu , ani sebe .	pánu	6	Dat
Domáci pán mal zlatý oblek s čiernymi pásikmi .	pásikmi	7	Ins
“ Držím ti palce , Amy , “ povedal s úsmevom , ktorý by roztopil i ľad .	ľad	16	Acc
Viedli ma polámané vetvičky a udupaná tráva .	vetvičky	3	Nom
“ Vieš , minulé leto som mal fantastický džob .	džob	8	Acc
Princ Omar je z veľmi vznešenej rodiny .	Princ	0	Nom
V jednom kuse táral o Týždni nenávisti .	kuse	2	Loc
Asi verili svojim po zuby ozbrojeným bojovníkom , pred ktorými sa všetci trasú .	bojovníkom	6	Dat
“ Super , “ povedala som , keď sme kráčali ku kabrioletu .	kabrioletu	11	Dat
Vládol tu čulý ruch , no Chrisa nevyrušil zo sústredenia .	sústredenia	9	Gen
Rád by som v tomto poďakovaní spomenul všetkých , ktorí akoukoľvek radou či pomocou prispeli ku zrodu predkladanej publikácie .	poďakovaní	5	Loc
Tieto kulty a božstvá sú dedičstvom ich rasy , sú dôležitou súčasťou ich každodenného života na vidieku .	vidieku	16	Loc
Si drúk , povedal som tomu ksichtovi v zrkadle .	ksichtovi	6	Dat
Po skončení vlády prvého stredovekého západného cisára totiž v krajine ochabli štátne garancie dodržiavania zákonnosti .	garancie	12	Nom
“ Neviem si ťa v uniforme predstaviť , “ povedala som .	uniforme	5	Loc
Ja sa chcem oženiť z lásky .	lásky	5	Gen
V ušiach mi zostala len ozvena jeho hlasu a v diaľke , na úpätí podstavca bez sochy , som uvidel Háda .	podstavca	14	Gen
V prvom variante som sa sústredil na epizódu s nohavičkami .	nohavičkami	9	Ins
Keď vystúpila z pásma žltkastého svitu a na chvíľu zastala na rozhraní medzi svetlom a temnotou , nemyslel som na to , že ide priamo ku mne , aby napravila chybnú interpretáciu vecí , ktorú vyprodukoval môj mozog .	svetlom	13	Ins
Niekde blízko pri vás sa určite potuluje bezprizorná neter , synovec , sused či kolegyňa .	neter	8	Nom
Na tejto biblickej platforme stojí dnes mnoho významných svetových vedcov .	platforme	3	Loc
Cez obed som zavolala mame do práce .	mame	4	Dat
Jednu z epizód napísal spoločne s Chrisom Carterom i Stephen King !	epizód	2	Gen
Maja s Vilkom sa rozleteli za húsenicou a požiadali ju o pomoc .	húsenicou	6	Ins
S chrobákmi .	chrobákmi	1	Ins
Bola to vysoká plavovláska s rozpustenými vlasmi a modrými očami , pery mala trochu hrubé a namaľované na tmavočerveno .	vlasmi	6	Ins
Bežali do domu , aby zistili , či niečo nezmizlo .	domu	2	Gen
Priplietol sa tam iný blázon : Plné gate .	gate	7	Nom
V ten večer som štyri hodiny písala prácu o intimite .	večer	2	Acc
Raz vylepil svojej dcére Katke mľaskavé zaucho len preto , že sa nahlas smiala .	dcére	3	Dat
Zaujal výberom tém aj ich spracovaním .	tém	2	Gen
Potom moje potešenie vystriedala určitá zvedavosť .	zvedavosť	5	Nom
Vláda bude klásť dôraz na prehľadnosť , výkonnosť , spoľahlivosť a efektívnosť monitorovacieho a hodnotiaceho systému .	výkonnosť	7	Acc
Bratia Badunovci ustráchane prikývli .	Bratia	0	Nom
S veľkou námahou som si uvedomil , že som v ktorejsi triede .	námahou	2	Ins
Po putovaní rôznymi bratislavskými krčmami sa slovenské večery vrátili do Véčka .	večery	7	Nom
Igelitku s pivom položila na stôl .	pivom	2	Ins
Na hlavnej stránke v pravom menu je ikona určená pre registráciu nového používateľa .	registráciu	10	Acc
“ Mala som pocit , že sa vznášam ! “ vravela som mame , keď za mnou pribehla a objala ma .	mame	12	Dat
Odolné proti drsnému zaobchádzaniu a nejaká tá diera neuberie z ich dobrých vlastností .	zaobchádzaniu	3	Dat
Svoje fotografie odteraz nájdete vždy na adrese www . fotoindex . sk vo svojom súkromnom fotoalbume .	adrese	6	Loc
Neviditeľní jazdci na koňoch sú vyjadrením predstavy o zlých duchoch , schopných ubližovať človeku odnesením jeho duše do podsvetia .	duchoch	9	Loc
V uplynulých rokoch ukázalo silný vzťah k demokratickým hodnotám a silu riešiť mnohé problémy .	hodnotám	8	Dat
Tieto kritické postrehy Soni vyslovila pri našom poslednom prázdninovom stretnutí pred začiatkom tretieho ročníka .	ročníka	13	Gen
Vytvorí podmienky pre elektronický obchod a bude posilňovať dôveru verejnosti k elektronickému obchodovaniu .	obchodovaniu	12	Dat
Jednostaj prichádzali a odchádzali všakovakí väzni : distribútori drog , zlodeji , banditi , šmelinári , opilci , prostitútky .	zlodeji	10	Nom
Táto výsada pannonhalmského opáta mohla byť už súčasťou originálej listiny .	opáta	3	Gen
Pokrútil hlavou .	hlavou	1	Ins
Vysoko na nebi vyšiel mesiac .	nebi	2	Loc
Vedel dôvod . Šírila okolo seba atmosféru hokejového ihriska , studených kúpeľov , spoločného stopovania a akejsi všeobecnej čistoty mysle .	mysle	19	Gen
Hľadala som v zásuvke nejaký papier na poznámky , keď som zbadala formulár na udelenie finančnej podpory počas štúdia na vysokej , ktorý mi dal ešte pred niekoľkými týždňami výchovný poradca pán Hatch .	papier	5	Acc
“ Viete čo ? “ povedal Ferdo kamarátom .	kamarátom	7	Dat
Vláda pripraví legislatívny rámec inštitucionálneho vzdelávania zdravotníckych pracovníkov prostredníctvom rezortu školstva s možnosťou postgraduálnej prípravy pracovníkov v zdravotníctve v školách a inštitúciách , ktoré získajú akreditáciu pre príslušný typ vzdelávania .	školách	19	Loc
Podľa Irminých pokynov – samotná Irma vybavovala všelijaké formality – ma poprosili , aby som odišiel z domu a vrátil sa podľa možnosti až večer .	pokynov	2	Gen
Ukázalo sa , že v jednom stánku predávali plechové panvice .	stánku	6	Loc
Šéf sa zo všetkých síl pokúšal , aby som odišiel z jeho pracovne spokojný , aj keď mi tú poviedku neuverejní .	Šéf	0	Nom
Zebríčaťu sa nesmierne páčilo , keď mu prečesávala hrivu .	Zebríčaťu	0	Dat
v prioritných oblastiach verejného záujmu musí byť verejný sektor schopný konkurovať súkromnému sektoru pri získavaní a udržaní kvalitných ľudských zdrojov	sektoru	12	Dat
Deti sa budú matkám odnímať už pri pôrode , ako vajce sliepke .	sliepke	11	Dat
“ A reči o tvojom starkom neber vážne .	starkom	5	Loc
Uchopil Winstona za rameno a obrátil ho tak , aby si hľadeli tvárou v tvár .	rameno	3	Acc
Obyvatelia lúky sa začali zbiehať pred jej domom a chválili Klotildin spev .	domom	7	Ins
Zakrátko bol ako súdok .	súdok	3	Nom
Tieto kulty a božstvá sú dedičstvom ich rasy , sú dôležitou súčasťou ich každodenného života na vidieku .	dedičstvom	5	Ins
Konkrétnym príspevkom k prevencii konfliktov a k udržaniu mieru bude aj naďalej aktívna účasť v medzinárodných mierových operáciách .	udržaniu	7	Dat
Odhrnula som mokré plavky , prázdne kokakolové plechovice , ceruzky , listy vytrhnuté z notesa a knižku Kto chytá v žite so somárskymi ušami .	plechovice	7	Acc
Pacholkovia vládnucej triedy !	Pacholkovia	0	Nom
Pri cieli sa skrýval osiak Boris a zrkadielkom oslňoval ostatných pretekárov , len aby pomohol svojmu zmrzačenému kamarátovi zvíťaziť .	kamarátovi	17	Dat
Naším zámerom je odstrániť najmä deformácie , ktoré zakladajú neopodstatnené nerovnosti medzi občanmi alebo zavádzajú do sociálneho systému cudzorodé prvky , akým je napríklad nesystémové včlenenie kúpeľnej starostlivosti do sociálneho poistenia .	občanmi	12	Ins
Ona by mala policajtom všetko vysvetliť .	policajtom	3	Ins
Náhlivo som vypol televízor a ona roztiahla pery do úsmevu .	pery	7	Acc
Zavedieme stanovenie základných štandardov na financovanie a kvalitu sociálnych služieb , systém udeľovania licencií a kontroly , zrovnoprávnenie pre všetky inštitúcie poskytujúce sociálne služby .	štandardov	3	Gen
Ministerstvo mieru sa zaoberá vojnou , Ministerstvo pravdy lžami , Ministerstvo lásky mučením a Ministerstvo hojnosti hladomorom .	Ministerstvo	0	Nom
Tak je po Jaroslavovom víťazstve položený základ novgorodských výsad , ktorí Novgorodcom garantujú ochranu pred kniežacími družiníkmi a Varjagmi / no zároveň zabezpečujú kniežaciu družinu pred ľudom / .	družinu	24	Acc
Gaston sa obrátil k zástupu dedinčanov , ktorí sa medzitým zhromaždili okolo neho .	zástupu	4	Dat
" Niekedy , " poznamenala , " pohrozia človeku niečím -- niečím , čomu nedokáže vzdorovať , na čo nedokáže ani pomyslieť .	človeku	8	Dat
Dievčatko vstalo a vyšlo z miestnosti .	Dievčatko	0	Nom
Mušiakovi Pavlovi sa mušia slečna zapáčila na prvý pohľad .	Mušiakovi	0	Dat
Pavol , ktorý bol do Fridy zaľúbený až po uši , sa zľakol a začal ju hľadať .	uši	9	Acc
Potom leteli ponad lúkou , až sa dostali k topoľovej aleji .	aleji	10	Dat
Hlavnými aktérmi tohto procesu boli cisár Oto III . a pápež Silvester II .	aktérmi	1	Ins
Uprostred salóna bol jedálenský stôl .	salóna	1	Gen
Čierna tma ustupovala pred sivastým svetlom .	svetlom	5	Ins
Chcel som povedať tým civilistom , aby mi aspoň vysvetlili , čo odo mňa chcú .	civilistom	4	Dat
Tesnejšie sa pritisol k malinčiu a oko zavrel .	malinčiu	4	Dat
Pomyslel som si , že Soni by závidela Faike jej pleť .	pleť	10	Acc
Makové zrniečka v nej zašušťali , ako keď sa presýpajú myšlienky .	zrniečka	1	Nom
Základným prvkom reformy verejných financií bude zavedenie tvrdého rozpočtového obmedzenia v celom okruhu verejných financií .	prvkom	1	Ins
Namiesto toho som zašiel k predavačovi novín .	predavačovi	5	Dat
Z okienok v plástoch vykuli rozospaté včelie hlávky .	plástoch	3	Loc
„ Čas , v ktorom žijem , viem , že je Tvojím darom .	darom	12	Ins
V 19 . storočí dochádza v Bengálsku k úpadku feudalizmu .	úpadku	8	Dat
Mediácii bráni násilný zásah zvonku — Janova prítomnosť , narúšajúca tak prvotnú rovinu mýtu .	Mediácii	0	Dat
Nevyšiel som ku dverám .	dverám	3	Dat
Nakukol pomedzi húštinu a uvidel troch tvorov v šatách namiesto kožušiny .	tvorov	6	Acc
Titan Ľadovec dokončil jeho dielo a zmrazil lávu dychom .	dychom	8	Ins
Dňa 15 . 2 . 2004 sa v našom cirkevnom zbore konal výročný zborový konvent .	zbore	10	Loc
Vo všeobecnosti to boli dôchodcovia s plstenými klobúkmi alebo čiapkami , ktoré ich chránili pred slnkom .	slnkom	15	Ins
Reforma ozbrojených síl	Reforma	0	Nom
Nijaká dvojica nevstávala , že pôjde tancovať , plač toho dievčaťa pokazil atmosféru .	dvojica	1	Nom
Zhodil ma na trávu a veľmi dlho sme sa bozkávali .	trávu	3	Acc
Na letisko nás prišiel čakať Sergejov priateľ .	priateľ	6	Nom
Spevák skupiny sa s deťmi rozprával a pýtal sa ich na to , čo si myslia o Bohu .	deťmi	4	Ins
V utorok píšeme test z astronómie .	test	3	Acc
Vtom si Chris všimol model vesmíru , ktorý učiteľ vytiahol na ukážku , chytil sa za srdce a predstieral , že padá dozadu .	ukážku	11	Acc
V nemocnici sa naňho vrhlo desať mravcov .	nemocnici	1	Loc
Pocítil som jemný dotyk jej prstov .	dotyk	3	Acc
Už tretíkrát sme sa mohli stretnúť na neformálnej úrovni a prebrať pálčivé problémy , s ktorými sa stretávame na chodbách našej školy .	úrovni	8	Loc
Bronzová čaša , zdobená rúčkou s vtáčikom pripomína uctievanie vtákov u ugrofínskych národov — ak karelský poľovník zabil vtáka čakalo ho nešťastie .	vtáka	18	Acc
Odpočívala na kraji bazéna a hompáľala nohami .	kraji	2	Loc
M . N . Tichomirov fakt jednostranné vykladá len ako príčinu „ hladových vzbúr “ , Frojanov si všíma dôležitú okolnosť — volchovia sa zjavujú , aby zabezpečili blahobyt , hojnosť , úrodu .	vzbúr	13	Gen
Len čo stačil dobehnúť do úkrytu , z jaskyne vytrielila svorka vĺčat .	úkrytu	5	Gen
V sledovaných zbierkach kánonického práva nachádzame celý rad podobných ustanovení .	zbierkach	2	Loc
Brat a sestra !	Brat	0	Nom
Podľa Irminých pokynov – samotná Irma vybavovala všelijaké formality – ma poprosili , aby som odišiel z domu a vrátil sa podľa možnosti až večer .	formality	8	Acc
Odteraz sme jej rodičia , tak ju musíme niesť , “ povedala potom Vilkovi .	rodičia	3	Nom
Typickým príkladom sú lúčové náušnice — symboly slnka a svetla .	symboly	6	Nom
Myslím však , že vysoká škola má dve významné úlohy , ktoré so spomínanou rovnicou priamo nesúvisia .	škola	5	Nom
Postupne mu však ten príval hudby vyhnal z mysle všetky špekulácie .	mysle	8	Gen
Bojoval proti vykorisťovaniu v indickej spoločnosti , proti krviprelievaniu medzi hinduistami a moslimami , proti vojne , za politickú nezávislosť svojej krajiny .	vykorisťovaniu	2	Dat
Chvíľu leteli , až pristáli v spustnutej záhrade , kde bola pod obrovskou smutnou vŕbou hlbočizná studňa .	vŕbou	14	Ins
V estónskej rozprávke Hromovládcové gajdy je zasa zachovaný obraz starobylého dualizmu v postavách vládcu hromov Pikneho a vrchného čerta Vanatuhiho .	gajdy	4	Nom
Zastupiteľstvo súhlasilo s umiestnením vo vojenskom kostole .	umiestnením	3	Ins
Na festivale sa predstavia rómske aj nerómske hudobné zoskupenia z celého Slovenska .	festivale	1	Loc
Intenzívne sa pamätám na prístavbu javiska k cirkevnej sieni na evanjelickej fare .	sieni	8	Dat
Po celý čas som sa díval smerom k osvetlenému pásmu , kde sa zástup žien tlačil pred skleným priečelím obchodu .	pásmu	9	Dat
“ Musíte tam vletieť , “ radila Petronila s plnými ústami .	ústami	10	Ins
Starec zrejme zabudol na predsudky , ktoré mal proti celému litru .	litru	10	Dat
Sedel na stoličke neprirodzene vzpriamene a jeho mocné prsia sa nadúvali a zachvievali , akoby mal čeliť nárazu vlny .	nárazu	17	Dat
Zobudil ma zvonček pri dverách bytu .	dverách	4	Loc
Veľký panter pozorne nastražil uši .	panter	1	Nom
Posledný szabolcsský kánon , ktorý sa venuje kláštornému životu nariaďuje opátom a mníchom , aby sa nezúčastňovali na kalendových sedeniach , ale aby prijímali oblácie ich účastníkov v kláštoroch .	sedeniach	19	Loc
A predovšetkým , nedovoľujeme mŕtvym , aby povstali proti nám .	mŕtvym	4	Dat
V tieni stromu s veľkými listami bol príjemný chládok .	stromu	2	Gen
Najťažší trest postihuje opäť kňazov , ktorí sa dopustili bigamie .	kňazov	4	Acc
V jeden z tých dní som sa vrátil k svojmu pracovnému stolu .	stolu	11	Dat
Bol mučiteľ , bol ochranca , bol inkvizítor , bol priateľ .	ochranca	4	Nom
Keďže som neprišiel na nič lepšie , sedel som celý deň vo svojej izbe a v duchu som si predstavoval , že som ušiel z domu .	izbe	13	Loc
Iba pred piatimi dňami sa pohrával myšlienkou , že jej rozbije hlavu dlažobným kameňom , lenže čo tam teraz po tom ?	kameňom	13	Ins
Po zázraku s ostatkami Feodosija a pred vpádom Polovcov .	zázraku	1	Loc
Strana , samozrejme , vyhlasovala , že oslobodila proletov z jarma .	jarma	10	Gen
Od zatknutia nemal v ústach nič .	ústach	4	Loc
“ Ľudské mláďa nemôže ostať so svorkou . “	svorkou	6	Ins
Rovnako prirodzené bolo , že zablúdila očami k fľaši s vodkou značky Smirnoff na stole .	fľaši	8	Dat
Jedného dňa stretla na malinčí čudného tvora .	malinčí	4	Loc
Prvým stupňom boli archeologické vykopávky svojou uchopiteľnosťou zhmotňujúce rozplývavé symboly starých povier a zároveň ich presne lokalizujúce .	uchopiteľnosťou	6	Ins
Teším sa na Vaše odpovede a prajem príjemný týždeň ,	týždeň	8	Acc
PREČ S VEĽKÝM BRATOM !	BRATOM	3	Ins
Myslíte si , že sa strana dostatočne nevenovala ekonomike ?	ekonomike	8	Dat
Jednoznačne ide o účelovú mystifikáciu s cieľom zmanipulovať konanie bežného občana a obrať ho o posledné základné životné istoty .	konanie	8	Acc
Peklo ako peklo . . .	Peklo	0	Nom
Skvelý psychológ , vyvolávač hrôzy , zaklínač šialenstva .	vyvolávač	3	Nom
Listina je o šesťsto rokov staršia než iné zo známych písomných pamiatok v karelčine .	Listina	0	Nom
Alia mu ukázala dve ligotavé medené mince .	mince	6	Acc
Nikto z nich nevie nič o mojom ruskom dobrodružstve .	dobrodružstve	8	Loc
Skupina kánonov I . ostrihomskej synody sa venuje stanoveniu obsahu bohoslužieb a príbuzným kultovým predpisom .	predpisom	14	Dat
Na prvý pohľad je tu zrejmá podobnosť so znením kánonov , ktoré sa týkajú rehoľníkov .	kánonov	9	Gen
Zrazu Tayerle stratil prehľad , kde je , ale v triede bolo ticho .	triede	10	Loc
Vtom sa vo dverách zjavila aj neforemná Buchta .	dverách	3	Loc
Potom mu priložila ucho k jej srdcu .	srdcu	6	Dat
Zvláštnym , odzbrojujúco priateľským gestom , ktoré len on dokázal vyčarovať , si na nose upravil okuliare a pokračoval :	gestom	4	Ins
Spojil ruky a ja som sa na ne postavila .	ruky	1	Acc
Boli tam mravce , lykožrút Fridolín s Buchtou , aj rodinka ploštíc .	rodinka	10	Nom
V otrokárskom mravenisku	mravenisku	2	Loc
Takže teraz veľmi čakám , či niekto z mienkotvorných hláv Bútorovho elektorátu urobí sebakritickú analýzu tohto svojho fatálneho politického omylu .	elektorátu	11	Gen
Zajac mohol byť vykladaný v systéme predkresťanských názorov jednak ako symbol plodnosti / dodnes spájame na veľkú noc vyobrazenia zajacov s vajíčkami , Nemci počas tohto sviatku hľadajú v záhrade vajíčka ukryté veľkonočným zajacom / .	zajacom	33	Ins
Súčasťou reformy verejných financií bude aj zásadné sprísnenie poskytovania štátnych záruk .	Súčasťou	0	Ins
“ Videl som ťa v bazéne a mal som sa ti vyhnúť .	bazéne	5	Loc
Zaleteli k lesu , kde Svetlanka ukázala na uzučkú škárku v zemi .	zemi	11	Loc
Mravce dovliekli celý kôš dobrôt , včielky priniesli ovocný medovník a Kasandra jazmínové želé .	želé	13	Acc
Pochopil som to , keď som prišiel na koniec schodišťa a stretol som suseda z prízemia .	schodišťa	9	Gen
Takže nacionalisticko - sociálny populizmus Mečiarov je , povedal by som , prirodzeným plodom stáročného vývinu slovenskej spoločnosti .	plodom	13	Ins
Pocítil som na hrudi tlak jej pevných okrúhlych pŕs .	hrudi	3	Loc
V tej izbe bývalo predo mnou niekoľko brigádnikov z mesta , predstaviteľov robotníckej triedy .	brigádnikov	7	Gen
Formulácia „ Volumus , ut episcopi habeant potestatem . . . “ implikuje interpretáciu , že biskupi , vykonávali svoj úrad z vôle panovníka , že on im udeľoval mandát na reálne pôsobenie v ich úrade .	interpretáciu	13	Acc
Za finančnú podporu sa chcem poďakovať Ekumenickej rade cirkví , nášmu drahému zboru a „ staršej “ mládeži ECAV v Prešove , modlitebnému spoločenstvu , kamarátom z tréningu Rovesník a jednotlivcom .	mládeži	17	Dat
Hľadala som v zásuvke nejaký papier na poznámky , keď som zbadala formulár na udelenie finančnej podpory počas štúdia na vysokej , ktorý mi dal ešte pred niekoľkými týždňami výchovný poradca pán Hatch .	zásuvke	3	Loc
Vzniknutý kódex sa stáva základom tzv . Krátkej redakcie pravdy / kým kódex , vzniknutý roku 1037 v Kyjeve sa stáva základom pravdy priestrannej / .	kódex	1	Nom
Zlá víla sa princovi Filipovi posmievala , no prezradila mu , že iba on môže zrušiť Zorničkinu kliatbu , ak ju pobozká .	princovi	3	Dat
Chris pokrčil plecami .	plecami	2	Ins
Prirodzene , udalosti okolo Canossy boli len začiatkom úsilia o presadenie takéhoto usporiadania sveta .	udalosti	2	Nom
Mykla plecami .	plecami	1	Ins
Vtedy nás poslali na brigádu do Jonufëru pri Vlore , kde sme mesiac budovali terasové polia .	polia	15	Acc
Skúste siahnuť po nejakej knižnej novinke , zoznam nájdete v Knižnom katalógu .	katalógu	11	Loc
Smutné včielky sedeli pri raňakjách , na stole chýbal tanier s medom .	raňakjách	4	Loc
Nad fotografiou bol titulok Dvaja Albánci v putách ruského Interpolu .	putách	7	Loc
Ten šíp bohu patrí	bohu	2	Dat
Keďže mu nechceli odpovedať na otázku , Hádes sa uchýlil k lichôtkam .	lichôtkam	11	Dat
Opantal ho pocit únavy .	únavy	3	Gen
Právo na prístup ku kultúrnym hodnotám je jedným z dôležitých práv všetkých občanov .	hodnotám	5	Dat
Sergej , ktorému pohľad na zvieratá spôsoboval pôžitok , začal zo seba vyrážať akési výkriky .	pôžitok	7	Acc
„ Viera môže dávať človeku životnú istotu “ , mieni profesor Ďurovič .	človeku	4	Dat
Máme tu teda ďalší argument pre to , aby sme kánony o celibáte z druhej kolomanovskej synody nepovažovali za prejav úplného príklonu k normám reformného pápežstva .	normám	23	Dat
A svoje veľké zadosťučinenie strčil do záchodovej misy .	misy	7	Gen
Hneď na úvod som urobil niečo veľmi nerozumné : dal som si dvojitý koňak .	úvod	2	Acc
Vláda uplatní rovnaký postup pri priznávaní štátnej pomoci a zriadi register prijímateľov štátnej pomoci a register prijímateľov iných investičných stimulov .	priznávaní	5	Loc
Súviselo to jednak s už spomenutým rozvinutým fungovaním systému vlastníckych kostolov a kláštorov a jednak s existenciou otónsko - sálskeho ríšskeho cirkevného systému v Nemecku .	fungovaním	7	Ins
Niečo dopadlo na posteľ za Winstonovým chrbtom .	chrbtom	6	Ins
Prehľadal som vrecká na všetkých sakách a vo vnútornom vrecku jedného z kabátov som našiel fotografiu ženy .	vrecku	9	Loc
“ Zachránil som ťa pred riekou , ale čo si teraz s tebou počnem ?	riekou	5	Ins
Budete mať tri či štyri kontakty , ktoré príležitostne nahradíme novými .	kontakty	5	Acc
Prvý z apoštolov patril v celom kresťanskom svete k mimoriadne uctievaným svätcom .	svätcom	11	Dat
Niekedy jej rozprával o Oddelení záznamov a o nehanebných falzifikátoch , ktoré v ňom fabrikuje .	Oddelení	4	Loc
Na jeho základe sa bude financovať tzv . solidárny balík , ktorého súčasťou bude aj financovanie siete rýchlej zdravotnej pomoci .	základe	2	Loc
Tá správa ma zastihla na dovolenke .	dovolenke	5	Loc
Presne takúto podobu , teda jednoduché príkazy či predpisy , majú i príslušné nariadenia v sledovaných kánonickoprávnych zbierkach .	zbierkach	17	Loc
Poletíš ponad strieborné jazerá a zurčiace potoky , pod jasným nebom a vysokými zelenými stromami .	nebom	10	Ins
Začula ma a hneď na druhý deň mastila k hliadke .	hliadke	9	Dat
Platba je elegantne vyriešená internetbankingom najznámejších slovenských bánk .	Platba	0	Nom
“ Ty chceš ísť na túru ? “ spýtala som sa a pozrela na hodinky .	túru	5	Acc
