- A mój czas jest cenny .	cenny	5	Masc3
Jesteś ugotowany .	ugotowany	1	Masc1
Gdyby z takiego nierozsądnego myślenia wyrastało się jak z dziecięcych ubrań , nie było by większego problemu .	większego	15	Masc3
I wszystkim obalonym zwyczajom wrócono ich dobre imię .	obalonym	2	Masc3
- Najdalej za rok będzie się stawał coraz młodszy .	młodszy	8	Masc1
Teraz wylegitymowani na granicy , jeśli nie zapłacą , mogą nawet stracić samochód .	wylegitymowani	1	Masc1
Budynek Ratusza Staromiejskiego wymaga ogromnych nakładów inwestycyjnych .	ogromnych	4	Masc3
- Sami nie macie !	Sami	1	Masc1
Udzielam głosu pierwszemu mówcy , senatorowi Czai .	pierwszemu	2	Masc1
Krzyczy na mnie tylko trochę , kiedy się biję ze starszym bratem .	starszym	10	Masc1
Znalazł też Kwaśniewski niefortunnych obrońców .	niefortunnych	3	Masc1
W pańskim wieku , na pańskim stanowisku torturować kobietę !	pańskim	1	Masc3
Potem były one sumowane .	sumowane	3	Masc3
Są oni gorąco pozdrawiani przez zgromadzone na trasie tłumy .	zgromadzone	5	Masc3
Julek okazał się mniej drażliwy .	drażliwy	4	Masc1
Dzicy plakaciarze zaśmiecający miasto są bezkarni .	zaśmiecający	2	Masc1
- Jedna , samotna , żyje z ogromnego spadku .	ogromnego	7	Masc3
Zdyszany , wyprężył się przed Dziadoniem .	Zdyszany	0	Masc1
Ale oni są mi za drodzy , żeby m im to sprawiła .	drodzy	5	Masc1
Jesteś szczery , prostolinijny , ale prawdopodobnie swoje własne opinie będziesz zatrzymywać dla siebie .	szczery	1	Masc1
Największy dług to kilkanaście tysięcy z odsetkami .	Największy	0	Masc3
Luksusowego forda explorera nieznani sprawcy skradli wczoraj w Warszawie generałowi rosyjskiej milicji .	nieznani	3	Masc1
Przecież były zawalone dachy w Polsce , Niemczech , Rosji , były też ofiary .	zawalone	2	Masc3
IZABELLE ADJANl , gwiazda filmu francuskiego , wygrała precedensowy proces .	precedensowy	8	Masc3
Początkowo zapanował iście świąteczny nastrój .	świąteczny	3	Masc3
Oddech jego stał się krótki , przerywany , nierówny .	krótki	4	Masc3
Swojego domku obitego papą Wanda Kędzierska trochę się wstydzi .	obitego	2	Masc3
Starszego aspiranta w prowincjonalnym ośrodku skierowano na badania psychiatryczne .	Starszego	0	Masc1
- Ma bardzo napięty plan .	napięty	3	Masc3
Kobieta otworzyła drzwi , wpuściła do środka czarnowłosego mężczyznę .	czarnowłosego	7	Masc1
Zapraszamy do naszego sklepu internetowego ! ! !	internetowego	4	Masc3
Zaciągnął w kąt grubego , jowialnego Skwarskiego .	jowialnego	5	Masc1
Następnym mówcą będzie pan poseł Kazimierz Wilk .	Następnym	0	Masc1
Pogłębiły się zmarszczki , sczerniały sińce pod oczami ; był blady i jakby przygarbiony .	przygarbiony	13	Masc1
Alibi było , ale przy okazji sfotografowano tego wysokiego , przystojnego mężczyznę .	wysokiego	8	Masc1
Francuski akcent stanowi niewątpliwie muzyka .	Francuski	0	Masc3
Rośnie aktywność polityczna i sprzeciw wobec istniejącego porządku , a jednocześnie nasila się presja , by tę aktywność uciszyć .	istniejącego	6	Masc3
Przed drzwiami sali rozpraw siedzieli uzbrojeni antyterroryści .	uzbrojeni	5	Masc1
Leci z Milwaukee do Pekinu na chiński Nowy Rok .	chiński	6	Masc3
Był ujmujący w obejściu , bez przerwy się uśmiechał .	ujmujący	1	Masc1
Mora nie był urodziwy .	urodziwy	3	Masc1
Suchy polder jest łatwiejszy i bezpieczniejszy w eksploatacji .	łatwiejszy	3	Masc3
Czemu są nieruchliwi niczym drewniane posągi ?	nieruchliwi	2	Masc1
I ręka albo noga mają wyrobione gusta kulinarne ?	wyrobione	5	Masc3
Głosić takie wywrotowe poglądy przed takim audytorium !	wywrotowe	2	Masc3
- W obu partiach są hamulcowi .	hamulcowi	5	Masc1
Czy pieniędzy zabraknie dla wszystkich potrzebujących ?	potrzebujących	5	Masc1
Steve zaklina się , że po każdym dyżurze szykuje ekstra posiłek czworonożnemu ratownikowi .	ekstra	9	Masc3
Nowi ustne rozpoczęli od geografii .	ustne	1	Masc3
W sidła oszustów - pośredników oferujących pracę Polacy wpadają także w Hiszpanii .	oferujących	5	Masc1
Przygotowanie takiej paczki nie stanowi problemu finansowego dla wielu ludzi .	finansowego	6	Masc3
Jakiś chłopak postanowił wspiąć się na słup , by osobiście zdementować bzdury o magicznym prądzie elektrycznym .	magicznym	13	Masc3
W jednej z wsi w powiecie działdowskim 23-letni mężczyzna zgwałcił 44-letnią matkę .	działdowskim	6	Masc3
Stali się dwujęzyczni .	dwujęzyczni	2	Masc1
Brakowało jakiegoś rysu dawnego Jeffa .	dawnego	3	Masc1
one są przerażające niemalże .	przerażające	2	Masc3
Jest nietykalny .	nietykalny	1	Masc1
Z głębin morza dalekich a z bełku przepadłego powrócił , żeby u stopy braterskiej jasne czoło położyć .	przepadłego	7	Masc3
Kim jest strażnik łowiecki ?	łowiecki	3	Masc1
Który wyszedł usprawiedliwiony ?	usprawiedliwiony	2	Masc1
Nie sądź , a nie będziesz sądzony , uspokoiła się .	sądzony	6	Masc1
Nieznani sprawcy ostrzelali jego samochód zaparkowany przed sklepem .	Nieznani	0	Masc1
Kochamy Polskę , lecz fakty składające się na polską rzeczywistość działają nam na nerwy .	składające	5	Masc3
Obaj skrupulatnie przepisywali rezultaty kolejnych odcinków specjalnych , by w pokojach hotelowych dokładnie je przeanalizować .	kolejnych	4	Masc3
Gdy na miejscu zjawili się policjanci z komisariatu kolejowego policji , schronisko znajdowało się w opłakanym stanie .	opłakanym	15	Masc3
Przygwożdżonemu ich argumentacją Mister O'Gorckowi zawsze pozostawało się wycofać .	Przygwożdżonemu	0	Masc1
Później innego uczestnika spotkania znaleziono martwego w jego domu letniskowym pod Belgradem .	letniskowym	9	Masc3
W klasztorze mieścił się obóz przejściowy dla Niemców sprowadzonych z Rumunii .	sprowadzonych	8	Masc1
Na Podkarpaciu oficjalnie kampania żniwna zacznie się w przyszłym tygodniu .	przyszłym	8	Masc3
Niemieccy policjanci twierdzą , że w rachubę nie wchodzi kolizja z innym pojazdem .	Niemieccy	0	Masc1
- Czy nie zabrakło woli politycznej do osądzenia komunistycznych zbrodniarzy ?	komunistycznych	8	Masc1
Ukryty za maćkowymi plecami Łagiewka przytaknął .	Ukryty	0	Masc1
Taki czek nie może być bezpośrednio zamieniony na gotówkę .	zamieniony	6	Masc3
Milion konsumentów nieprzestrzegających zasad koszerności dokonało przełomu na rynku spożywczym .	nieprzestrzegających	2	Masc1
Zauważono też nagminne zaniżanie zarobków pracowników za dni urlopowe lub chorobowe .	urlopowe	8	Masc3
Zatrzymał się , zaskoczony .	zaskoczony	3	Masc1
Panuję nad negatywnymi nastrojami .	negatywnymi	2	Masc3
Policja po kilku godzinach odzyskała skradziony samochód , jeszcze przed oficjalnym zgłoszeniem przestępstwa .	skradziony	5	Masc3
Podczas nabożeństwa poświęcony został świeżo ufundowany sztandar szkoły .	ufundowany	5	Masc3
Ostatecznie ten przemysł został stworzony przez Europejczyków .	stworzony	4	Masc3
Wszystkie mówią o srebrnym terenowym samochodzie .	srebrnym	3	Masc3
Wszystkie mówią o srebrnym terenowym samochodzie .	terenowym	4	Masc3
W wypadku na miejscu zginęła 19-letnia dziewczyna kierująca toyotą corollą oraz 23-letni mężczyzna .	23-letni	11	Masc1
– i takie akordeony kupują zawodowi akordeoniści ?	zawodowi	5	Masc1
Sierpcem nie interesuje się zupełnie przemysł terenowy .	terenowy	6	Masc3
Jestem niepobożnym ministrantem z pazurami .	niepobożnym	1	Masc1
Po południu kościelna procesja wyrusza w drogę po bajecznie kolorowym kwietnym dywanie .	kwietnym	10	Masc3
Dziewczyna wysupłała zza dekoltu banknoty dziesięciomarkowe .	dziesięciomarkowe	5	Masc3
Szczekały przez długi czas wśród jasnej od księżyca nocy .	długi	2	Masc3
Pierwsze brawa zebrał Bugaj polemizujący z Rakowskim .	polemizujący	4	Masc1
Tym razem rzucił granat zaczepny , walcowaty .	zaczepny	4	Masc3
Ofiary następnej deportacji to rodziny represjonowanych .	represjonowanych	5	Masc1
Do domu przyjechał em zupełnie głodny .	głodny	5	Masc1
Jesteś normalny !	normalny	1	Masc1
Jechało im się dobrze , na szosie po przedpołudniowym deszczu nie było kurzu , ale jezdnia nie była już mokra .	przedpołudniowym	8	Masc3
Cały Boguszów trzęsie się z oburzenia .	Cały	0	Masc3
Szmigielski działa też w komisji ogródków działkowych , komisji mieszkaniowej i radzie osiedla ; ma biuro w piwnicy .	działkowych	6	Masc3
Do zbrodni przyznał się 22-letni mieszkaniec tego miasta .	22-letni	4	Masc1
W sezonie letnim w 2005 r. utonęło 325 osób .	2005	4	Masc3
– Płynie ogromny transport z demograficznym wyżem .	ogromny	2	Masc3
Zawsze wygrywał , bo był najszybszy .	najszybszy	5	Masc1
Zaciągam się papierosem i próbuję przypomnieć sobie dawnego Dziedziuszkę .	dawnego	7	Masc1
O godzinie dziewiątej rewiry były już zapchane .	zapchane	6	Masc3
Marysia mówi , że trzeba iść drugą bramą , tą pod murem kremlowskim .	kremlowskim	12	Masc3
Może należało zabrać ze sobą lekarza , może leki jakieś są nieodzownie potrzebne .	potrzebne	12	Masc3
O drugim mówi , że to była poprawka .	drugim	1	Masc3
Prowadzący śledztwo oskarżył o spowodowanie wypadku polskiego kierowcę .	Prowadzący	0	Masc1
Jestem przekonany , że już niedługo zawita do nas prawdziwie złota polska jesień .	przekonany	1	Masc1
A przynajmniej choćby na jakiś czas powstrzymać zalewający kraj rewolucyjny potop .	rewolucyjny	9	Masc3
Straszny ziąb w nawie , nawet anioł ze środkowego pilastru wydaje się drżeć z chłodu .	Straszny	0	Masc3
Używając pożyczonych magnetofonów szpulowych połączył em dźwięki suity z fragmentami poematu Wergilego .	szpulowych	3	Masc3
Czarny , wilgotny otwór jamy przerażał ich .	Czarny	0	Masc3
Po ukończeniu zakopiańskiej Szkoły Przemysłu Drzewnego i warszawskiej ASP osiadł w Zakopanem .	Drzewnego	5	Masc3
Nie było bezpośredniego kontaktu .	bezpośredniego	2	Masc3
Firma Connex świadczy usługi transportowe w Polsce od roku 1998 .	1998	9	Masc3
Wszystkie inne warunki miały być ustalone później , na konferencji pokojowej .	ustalone	5	Masc3
Mężczyźni są u pana dużo mniej interesujący .	interesujący	6	Masc1
Paul Dellapina skazany na dwadzieścia lat ucieka po raz ósmy z więzienia .	ósmy	9	Masc3
Przypomina mi się rysunek Andrzeja Mleczki jeszcze z lat 80 .	80	9	Masc3
Oklapł , opadły mu ramiona i tylko piwny brzuszek sterczał nad paskiem spodni .	piwny	7	Masc3
Spojrzał des Noyers na zegar gdański , stojący w rogu komnaty .	gdański	5	Masc3
- Będę musiał kupić nowe buty .	nowe	4	Masc3
Biedny ptak , z szeroko otwartym dziobem , zwisał głową w dół , niby ułamana z krzewu kiść .	otwartym	5	Masc3
Na diagramie Hertzsprunga - Russella olbrzymy znajdują się ponad ciągiem głównym .	głównym	10	Masc3
Do Warszawy dotarli już o gęstym zmroku .	gęstym	5	Masc3
Równocześnie , zdecydowana większość uważa , że w Polsce tylko nieliczni mogą się wzbogacić .	nieliczni	10	Masc1
Tyle lat minęło , a pamiętam słowa starego Żyda z getta .	starego	7	Masc1
Nad placem przeleciały myśliwce naddźwiękowe .	naddźwiękowe	4	Masc3
Zaciągnął w kąt grubego , jowialnego Skwarskiego .	grubego	3	Masc1
Na dziobie , bodącym niebo , przerzucony przez poręcz wisiał mister Dawid Lingslay .	bodącym	3	Masc3
Kolejne inwentaryzacje dowodzą , że na półkach biblioteki brakuje kolejnych tytułów .	kolejnych	9	Masc3
– ciemne włosy ma ?	ciemne	1	Masc3
Pomimo dokuczliwego zimna cieszyły się one dużym zainteresowaniem sportowców wiejskich .	wiejskich	9	Masc1
Polonia w ostatnim swoim występie mocno rozczarowała .	ostatnim	2	Masc3
Umarli o tym wiedzą i może dlatego sami przychodzą do nas .	sami	7	Masc1
( Michał krzywi się , wyraźnie zirytowany . )	zirytowany	6	Masc1
Warto zwrócić uwagę na to , by worek do śpiwora był ściągany na co najmniej dwóch wysokościach .	ściągany	11	Masc3
Sanitariusz wyciągnął ze skrzyni dwa gumowe fartuchy .	gumowe	5	Masc3
Byli zbyt zmęczeni , aby roztrząsać przestrogę pana Bazylego .	zmęczeni	2	Masc1
Także usługi ogólnobudowlane prowadzi drugi z odznaczonych , pan Marek Nosal .	odznaczonych	6	Masc1
Molekularnie jest piękny .	piękny	2	Masc3
Nad pozostałymi obszarami dominują układy wyżowe .	wyżowe	5	Masc3
Jest to aminokwas poprawiający pamięć starzejącej się komórki .	poprawiający	3	Masc3
Dziwnym trafem niezależne spółki węglowe zaproponowały bardzo podobne podwyżki .	Dziwnym	0	Masc3
I tym razem Gagarin zniósł ją ze stoickim spokojem .	stoickim	7	Masc3
Na tę okoliczność policja nie badała przygodnego pasażera .	przygodnego	6	Masc1
Ze ścian mrugają kolorowe neony świąteczne w kształcie choinek , bombek i dzwonków .	kolorowe	3	Masc3
Zmarłych żołnierzy francuskich i bawarskich pogrzebano na cmentarzu przykościelnym .	bawarskich	4	Masc1
Środek był ocenzurowany .	ocenzurowany	2	Masc3
Kościół prostuje mój kręgosłup moralny .	moralny	4	Masc3
W przypadku grożących gołoledzią opadów deszczu lub śniegu , komputer włącza ogrzewanie jezdni .	grożących	2	Masc3
Ja się nie czuję przegrany .	przegrany	4	Masc1
Teraz składamy paskowy patchwork , ocieplenie i podszewkę , zszywamy wzdłuż prostego brzegu i obszywamy lamówką .	paskowy	2	Masc3
Tym kobylim synom chodzi o to , by Francja dostała guzik .	kobylim	1	Masc1
- Kto jest sukcesorem prawnym pana naczelnika ?	prawnym	4	Masc1
To pierwszy sezon 11-letniego Jurka w amatorskiej lidze małopolskiej , a już wywalczył trzecie miejsce .	11-letniego	3	Masc1
Jednocześnie zapowiedział rozpoczęcie maratonu negocjacyjnego .	negocjacyjnego	4	Masc3
– Dziennikarze wmówili sądowi i ludziom , że Róża musi wrócić do biologicznych rodziców .	biologicznych	12	Masc1
A co w sercu nosił ten pan możny ? . . .	możny	7	Masc1
Cały ten materiał mam w małym palcu .	małym	5	Masc3
Zmarł w Livorno w roku 1846 .	1846	5	Masc3
Dobre imię dano ci na chrzcie , nasz drogi radco .	drogi	8	Masc1
Ponadto wykładano o spółdzielczości rolniczej i handlu rolniczym .	rolniczym	7	Masc3
Za oszczędności kupił em na bazarze tapczan higieniczny i prawie nowy materac .	higieniczny	7	Masc3
Antybiotyki to związki chemiczne wytwarzane w naturze przez same drobnoustroje .	wytwarzane	4	Masc3
czy był prościutki ?	prościutki	2	Masc3
Ustalili ponadto , że w przestępczym autobiznesie działa ponad 1500 osób .	przestępczym	5	Masc3
Otwiera to pole dla różnych szalbierzy .	różnych	4	Masc1
W zeszłym tygodniu wyprowadzili się .	zeszłym	1	Masc3
Partie polityczne oraz reprezentujący ich politycy stanęli w wyborcze szranki .	reprezentujący	3	Masc1
Z trudem dostrzegam siedzących pod oknem Stefana i Wiktora .	siedzących	3	Masc1
Alarmującym problemem jest narkomania wśród młodzieży .	Alarmującym	0	Masc3
Silny Sojusz na pewno będzie skrupulatnie punktował potknięcia koalicjantów .	Silny	0	Masc3
Andrzej Micewski zrobił to dopiero w roku 1956 .	1956	7	Masc3
W czwartkowe popołudnie gasili płonący śmietnik przy ul. Brodzińskiego w Proszowicach .	płonący	4	Masc3
Do przechodzącego ulicą 28-letniego mieszkańca Ostrowca Świętokrzyskiego oddał dwa strzały .	Świętokrzyskiego	6	Masc3
Tamtejsi przyrodnicy nie umieli jednak sklasyfikować olbrzyma .	Tamtejsi	0	Masc1
Dlatego językiem oficjalnym stał się arabski , a dąży się , by stał się językiem ogólnonarodowym .	ogólnonarodowym	15	Masc3
W inscenizację umiejętnie wkomponowano wspomnienia nauczycieli i byłych uczniów .	byłych	7	Masc1
Stary zegar stojący na komodzie tyka natrętnie .	stojący	2	Masc3
Streścił em jej dalszy ciąg i bardzo chichotała .	dalszy	3	Masc3
Dziś zgromadzili śmy się tu , zwabieni staropolską gościnnością twoją , ażeby uczcić dzień twego imienia .	zwabieni	6	Masc1
W dwie godziny później Ania i Norbert siedzieli w fotelach w pokoju gościnnym przy łóżku Karoliny .	gościnnym	12	Masc3
Wzburzony ojciec zawiadomił policję , ale z chciwą pedagog i tak się umówił .	Wzburzony	0	Masc1
- Wasza gazeta od dawna robi świetne przewodniki dla poszukujących pracy w Irlandii .	świetne	6	Masc3
Ale szybki zysk bywa celem nawet najpotężniejszych magnatów finansowych , bo rynki są wolatylne .	najpotężniejszych	6	Masc1
Najbliżsi rywale Orfe także nie rezygnują z przejęcia kolejnych mniejszych dystrybutorów .	kolejnych	8	Masc1
- Valoarna zmienia czerwony na biały !	biały	5	Masc3
W najbliższych dniach czeka nas plucha .	najbliższych	1	Masc3
Wśród tradycjonalistów muzułmańskich z państw Półwyspu Arabskiego wywołało ono szok .	muzułmańskich	2	Masc1
Musi mieć kogoś bliskiego przy sobie .	bliskiego	3	Masc1
Commercial Union od 1991 roku działa również na rynku naszych ubezpieczeń życiowych .	1991	3	Masc3
– miłe dowcipy zawsze mi mówi . .	miłe	1	Masc3
Ostatni król Polinezji , Pomare V , zmarł z powodu alkoholizmu .	V	5	Masc1
Członkowie nakielskiego stowarzyszenia podczas spotkania omówili główne cele swojej działalności .	główne	6	Masc3
W opisywanej już szczegółowo scenie przy stole każda mówi w innym języku . . .	innym	10	Masc3
Ostra sauna , potem pływa się w basenie okolonym drzewami .	okolonym	8	Masc3
Na jego opinię powołuje się amerykański dziennik .	amerykański	5	Masc3
Jeżeli rząd chce wprowadzać swoje reformatorskie projekty , musi porozumiewać się z prezydentem .	reformatorskie	5	Masc3
Te ostatnie dziewczyny zostawiły , ponieważ były za małe .	małe	8	Masc3
Trzydzieste piąte Targi zostały rozpoczęte .	piąte	1	Masc3
Był to ostatni ze zgłoszonych mówców .	zgłoszonych	4	Masc1
Mundurowi nie chcą zdradzać parametrów technicznych maszyn , by nie ułatwiać życia drogowym piratom .	drogowym	12	Masc1
- Jest uzbrojony po zęby .	uzbrojony	2	Masc1
- Są nierozerwalni jak dwie półkule mózgowe , stanowią najdoskonalsze małżeństwo świata .	nierozerwalni	2	Masc1
Taksówka czekała z zapalonym silnikiem , a ci od pomocy drogowej wkładali jeepa na podnośnik .	zapalonym	3	Masc3
Będzie kierował on towarzystwem do 2007 roku .	2007	5	Masc3
Po raz kolejny przeszłość rzuciła cień na jej życie .	kolejny	2	Masc3
Tekst ten jest zniszczony i w wielu miejscach nieczytelny .	nieczytelny	8	Masc3
Generał za swoje publikowane w prasie artykuły nie przyjmuje honorariów .	publikowane	3	Masc3
Majowe weekendy zapowiadają się naprawdę ładnie !	Majowe	0	Masc3
Powierzchnię morza pruły statki , oczekujące pojawienia się ostatniego członu rakiety .	oczekujące	5	Masc3
Koloryt portretu wydawał mu się za mało żywy .	żywy	7	Masc3
- W przyszłym roku będziemy na szczycie .	przyszłym	2	Masc3
Obaj byli wysocy , zwaliści , misiowato potężni .	zwaliści	4	Masc1
Kwiaty otrzymali nauczyciele , którzy przed laty kształcili kolejarskich specjalistów .	kolejarskich	8	Masc1
I montujemy z tego dziewięćdziesięciominutowy program .	dziewięćdziesięciominutowy	4	Masc3
Oszołomiony Jerzy rusza ku wyjściu .	Oszołomiony	0	Masc1
Uważają nas za moskalofilów , takich zaprzańców antyukraińskich , podczas gdy sami deklarują ukraiński patriotyzm .	ukraiński	13	Masc3
Antena powinna być skierowana na południowy wschód .	południowy	5	Masc3
23--letni rolnik jechał ciągnikiem z rozdrabniarką do gałęzi .	23--letni	0	Masc1
" Jestem inny , ale potrafię więcej , niż mogło by się wydawać .	inny	2	Masc1
Marszałek sejmowy zamilkł i spojrzał wyczekująco po obecnych .	obecnych	7	Masc1
Borys Conrad , syn znakomitego pisarza Józefa Conrada - Korzeniowskiego przybył do Warszawy .	znakomitego	4	Masc1
Ale zapytany , dlaczego lubi szachy , znudzony zsuwa się z kanapy .	znudzony	7	Masc1
Oddech jego stał się krótki , przerywany , nierówny .	nierówny	8	Masc3
– ale możesz być pracownikiem fizycznym . .	fizycznym	5	Masc1
Wówczas , w 1978 roku , wcale nie było to takie oczywiste .	1978	3	Masc3
A ten głupi Rzymianin powiedział , że go tam odeśle . . .	głupi	2	Masc1
Przy wspólnym stole jadają tu studenci izraelscy i palestyńscy .	palestyńscy	8	Masc1
Uratujcie wierzącego chrześcijanina Walerego Marczenkę !	wierzącego	1	Masc1
Przede wszystkim , bądź dla niej dobry , wyrozumiały , łagodny .	łagodny	10	Masc1
Skupieni operatorzy delikatnie manipulowali skomplikowanymi urządzeniami odbioru przekazywanej informacji .	Skupieni	0	Masc1
Wioślarzom AZS przybył nowy konkurent .	nowy	3	Masc1
Nowy dzierżawca wykonał niezbędne remonty i odnowienia .	Nowy	0	Masc1
- Przecież tu chodzi tym gudłajom o ulokowanie kapitału w śląskim przemyśle .	śląskim	10	Masc3
Samochód był w pełni ubezpieczony w Hestii .	ubezpieczony	4	Masc3
Wizyta ma charakter prywatny .	prywatny	3	Masc3
Jest to już drugi podobny kontrakt .	podobny	4	Masc3
To najgorszy wstrząs sejsmiczny zarejestrowany w Kolumbii .	zarejestrowany	4	Masc3
Następnym mówcą będzie pan poseł Jan Kulas .	Następnym	0	Masc1
Jak widzę procesy zachodzące w sztuce ostatniego stulecia ?	zachodzące	3	Masc3
Długo machali rękami zostającemu na peronie Staszkowi Kuli .	zostającemu	3	Masc1
Tam dokonał czynów lubieżnych na dziewczynce .	lubieżnych	3	Masc3
Mostek na strumieniu został przez gminę odbudowany po ostatniej powodzi .	odbudowany	6	Masc3
Koło urządziło również podczas wakacji obóz wędrowny po Pomorzu .	wędrowny	6	Masc3
Możliwych jest wiele scenariuszy .	Możliwych	0	Masc3
Znajdowała m się w jakimś dużym supermarkecie .	dużym	5	Masc3
Aż króla angielskiego z flotą wysuwa !	angielskiego	2	Masc1
Ledwie sformowany rząd ustąpił protestującej grupie zawodowej .	sformowany	1	Masc3
W ostatnim cyklu Schuberta znajduje się pewna pieśń .	ostatnim	1	Masc3
Gładki jest bardziej śliski .	Gładki	0	Masc3
Nad pozostałymi obszarami dominują układy wyżowe .	pozostałymi	1	Masc3
W ostatnich dniach klub został niemal sparaliżowany przez wewnętrzne konflikty .	wewnętrzne	8	Masc3
Przy uśmiechu Giocondy , dyskretnym i tajemniczym , nikt nie zauważy szczerby z lewej strony .	tajemniczym	6	Masc3
Nowe realia wymagają innego typu zachowań i pomysłów .	innego	3	Masc3
To jeden z najważniejszych postulatów protestujących rolników .	najważniejszych	3	Masc3
Na dziobie , bodącym niebo , przerzucony przez poręcz wisiał mister Dawid Lingslay .	przerzucony	6	Masc1
Usłużnym kierowcą okazał się 34-letni Rob Gatena .	Usłużnym	0	Masc1
Magister podreptał ukosem przez podwórzec , nikły , żałosny w swej czarnej sukni .	żałosny	8	Masc1
Zaangażowała się w Teatrze Dramatycznym kierowanym wówczas przez Gustawa Holoubka .	Dramatycznym	4	Masc3
Taka osoba ułatwiła by międzynarodowe kontakty .	międzynarodowe	4	Masc3
Wiemy , że Niemcy nasyłali na te tereny duchownych germanizujących tubylców .	germanizujących	9	Masc1
Nikt się nie lituje , nie pieści z przyjeżdżającymi na zarobek .	przyjeżdżającymi	8	Masc1
W ostatnich latach w Polsce nie powstał żaden klub hokejowy .	ostatnich	1	Masc3
Samoloty USA startowały z baz w Wietnamie południowym i lotniskowców Siódmej Floty .	południowym	7	Masc3
Jest legendarnym przywódcą związkowym .	legendarnym	1	Masc1
Podczas ceremonii otwarcia Spływu organizatorzy przyznali liczne odznaczenia zasłużonym kajakarzom .	zasłużonym	8	Masc1
– bo był pożyczony . .	pożyczony	3	Masc3
Już Pitagorejczycy znali podobno wszystkie najbardziej regularne wielościany nazywane foremnymi .	foremnymi	9	Masc3
Ktoś biegnie z głuchym tupotem bosych nóg .	głuchym	3	Masc3
Oni myślą o jutrzejszym dniu .	jutrzejszym	3	Masc3
Taki rachunek wystawił jej gdyński Szpital Miejski .	gdyński	4	Masc3
Od sześciu lat jest wiceprzewodniczącym czeskiego PEN Clubu .	czeskiego	5	Masc3
Początki Myszyńca sięgają 1650 .	1650	3	Masc3
Był by m siódmy lub ósmy w kolejce .	siódmy	3	Masc1
Przecież jest to fakt historyczny .	historyczny	4	Masc3
Gotujemy na małym ogniu 15 minut .	małym	2	Masc3
Był by znakomitym pedagogiem uwielbianym przez studentów .	znakomitym	2	Masc1
Przeżył , bo udał , że jest martwy .	martwy	7	Masc1
Rosjanie mają swój scenariusz czytelny .	czytelny	4	Masc3
W tym roku pojawiły się one w całym powiecie kwidzyńskim .	kwidzyńskim	9	Masc3
Cały nakład rozszedł się błyskawicznie .	Cały	0	Masc3
Może to biologiczny odruch samicy , godowy taniec jajników ?	biologiczny	2	Masc3
- Nie jestem typowym jazzmanem , choć tak bywam oceniany .	typowym	3	Masc1
Obecnie na stu Duńczyków przypada ponad 110 telefonów komórkowych .	komórkowych	8	Masc3
Rozpada się dawny czas , nic po nim nie pozostaje .	dawny	2	Masc3
U ludów słowiańskich rodzina miała charakter patriarchalny , a przewodził jej ojciec .	patriarchalny	6	Masc3
Przed obecnymi na spotkaniu wystąpili dzisiejsi uczniowie szkoły .	dzisiejsi	5	Masc1
Nasze apele ginęły w wiecowym zgiełku .	wiecowym	4	Masc3
W klasztorze mieścił się obóz przejściowy dla Niemców sprowadzonych z Rumunii .	przejściowy	5	Masc3
W czasie stosowania tabletek te apteczne mogą oszukiwać .	apteczne	5	Masc3
- Człowiek jest omylny , ale dusza jest nieomylna .	omylny	3	Masc1
Zaczyna się znów , nie minęło parę dni i już nadchodzi następny sztorm .	następny	11	Masc3
- Pani Marszałek , chcę zgłosić wniosek formalny .	formalny	7	Masc3
Zaczął się już najwcześniejszy letni ranek .	najwcześniejszy	3	Masc3
Naaman , naczelny wódz króla syryjskiego , był człowiekiem bogatym i możnym .	syryjskiego	5	Masc1
Był to szybki i emocjonujący mecz .	emocjonujący	4	Masc3
Kradli telefony komórkowe , sprzęt komputerowy i inne cenne przedmioty .	cenne	8	Masc3
Znaleziono go w grobowcu Ramzesa III .	III	5	Masc1
Nie mogą one zająć się w sposób szczególny dziećmi autystycznymi .	szczególny	7	Masc3
Wielka katastrofa przestawiła ludzki umysł na wyższe obroty .	wyższe	6	Masc3
W Gnieźnie w sylwestrowy wieczór zginęli podczas pożaru trzej chłopcy , a jadący do akcji samochód strażacki wpadł na dwie kobiety .	sylwestrowy	3	Masc3
W tegorocznym VIII turnieju wystartowało 18 drużyn podzielonych na 6 grup .	VIII	2	Masc3
Zeznał on , iż został pobity przez nieznanego osobnika .	pobity	5	Masc1
Amerykanie rzeczywiście zrobili śliczny manewr pancerny .	pancerny	5	Masc3
czy ty wierzysz w świat radykalnie wegetariański ?	wegetariański	6	Masc3
W ostatnim momencie chwytam w dłonie jakiś kabel .	ostatnim	1	Masc3
- Zrobimy pana landrata na szosie w podgórskim pejzażu .	podgórskim	7	Masc3
Całowała go drobnymi , szybkimi pocałunkami .	drobnymi	2	Masc3
Ranną przetransportowano śmigłowcem do zakopiańskiego szpitala .	zakopiańskiego	4	Masc3
Już mnie tu nie zastaną i będą bardzo zdziwieni .	zdziwieni	8	Masc1
Czuł się słaby i nędzny .	nędzny	4	Masc1
Dla niej był em jedynym chłopcem .	jedynym	4	Masc1
Po odsiadce nie zaprzestał złodziejskiego procederu .	złodziejskiego	4	Masc3
Dopiero po miesiącu mógł założyć specjalny procesor i uczyć się nowych dźwięków .	specjalny	5	Masc3
Ten ogromny magazyn przez całe wieki pozostawał niewykorzystany .	niewykorzystany	7	Masc3
W czasach uczelnianego wyścigu szczurów i masowego bezrobocia pełni często rolę bezpłatnej terapii .	uczelnianego	2	Masc3
Na pewno jest pan głodny ?	głodny	4	Masc1
W niedzielny wieczór premier Izraela Ariel Saron ogłosił wojnę z palestyńskim terroryzmem .	palestyńskim	10	Masc3
Myślę , że znajdzie się ktoś lepszy na to stanowisko .	lepszy	6	Masc1
Budynek Ratusza Staromiejskiego wymaga ogromnych nakładów inwestycyjnych .	inwestycyjnych	6	Masc3
A dzisiaj nie można nic poza aspiryną zażyć bez wiedzy sportowego lekarza .	sportowego	10	Masc1
Dopiero po paru minutach powiedziała m cichym głosem .	cichym	6	Masc3
Istotnie , oznakowanie było w języku rosyjskim .	rosyjskim	6	Masc3
Suchy polder jest łatwiejszy i bezpieczniejszy w eksploatacji .	Suchy	0	Masc3
Oskarżano nas , że w Bielicznej sprzedali śmy prywatnemu nabywcy kilkaset hektarów wraz z cmentarzem i cerkwią .	prywatnemu	8	Masc1
Za mną stał szczupły , niewysoki brunet .	niewysoki	5	Masc1
- Jest doskonały .	doskonały	2	Masc1
Taka sytuacja łatwo popycha do kroków desperackich .	desperackich	6	Masc3
Miała ciągłe kłopoty .	ciągłe	1	Masc3
Krakowskich melomanów czeka jeszcze jedna atrakcja .	Krakowskich	0	Masc1
Cały kraj był zdławiony tym okropnym cieniem .	okropnym	5	Masc3
Czyżby teraz przepuściła okazję , mając tuż obok przystojnego młodego mężczyznę ?	przystojnego	8	Masc1
Zbieranie dzieł twórców nieprofesjonalnych zapewnia światowy prestiż i międzynarodowe przyjaźnie .	światowy	5	Masc3
Stał zamyślony .	zamyślony	1	Masc1
Od kolebki , od małych lat jestem tu wychowany , na tym placu .	wychowany	8	Masc1
Przy dźwiękach marsza żałobnego rusza aleją cmentarza kondukt pogrzebowy .	pogrzebowy	8	Masc3
Bez przesady , nie jestem już tym , co wycierał się na Mazurach w pomarańczowy ręcznik .	pomarańczowy	14	Masc3
Nie pomyślał em o tym , że nie był on przytwierdzony do postumentu , zdejmowano go przecież rokrocznie .	przytwierdzony	10	Masc1
Za mną stał szczupły , niewysoki brunet .	szczupły	3	Masc1
Uparci i bezkompromisowi , jednych przerażali , innych zachwycali .	bezkompromisowi	2	Masc1
Wystarczy zwisający kabel od czajnika elektrycznego .	elektrycznego	5	Masc3
Na stole walały się puste butelki , w pokoju panował zupełny chaos .	zupełny	10	Masc3
Gdzie pisał em , że ma jakieś cudowne środki ?	cudowne	7	Masc3
Często karani kielczanie raz za razem grali w osłabieniu .	karani	1	Masc1
Wysiedli z samochodów , zaniepokojeni , szukają .	zaniepokojeni	4	Masc1
Do akcji plebiscytowej włączają się działy sportowe poszczególnych gazet .	sportowe	6	Masc3
Od początku swojego istnienia był to związek odpowiedzialny .	odpowiedzialny	7	Masc3
Obstawił się własnymi ochroniarzami i policjantami .	własnymi	2	Masc1
Coraz większym zainteresowaniem cieszą się fundusze inwestycyjne działające na terenie Szwecji .	inwestycyjne	6	Masc3
Kontrolerzy nie wzięli pogróżek poważnie , bo wiedzieli z doświadczenia , że w podobnej sytuacji prawie każdy podatnik powołuje się na możnego protektora . . .	możnego	21	Masc1
Kończy się kolejny odcinek zmagań współczesnego Piotra .	współczesnego	5	Masc1
Obok wspomnianych przedmiotów ścisłych lubi biologię , przykłada się do angielskiego .	wspomnianych	1	Masc3
Dlatego językiem oficjalnym stał się arabski , a dąży się , by stał się językiem ogólnonarodowym .	oficjalnym	2	Masc3
Henryk przystąpił do działalności rewolucyjnej z dużym rozmachem .	dużym	6	Masc3
Jakże naiwny był Józef , kolejny raz ufając obietnicom białych !	kolejny	5	Masc3
Na pewno masz jakiś specjalny , alarmowy numer .	specjalny	4	Masc3
Pan ma już przecież dorosłych wnuków .	dorosłych	4	Masc1
Użyto gazów łzawiących i ogłuszających granatów .	łzawiących	2	Masc3
Wysyłamy panu gratis lodowy dom . "	lodowy	3	Masc3
Wkrótce też natknęli się na mężczyzn ściągających skórę z zabitego kozła .	ściągających	6	Masc1
Po 100 latach były w dobrym stanie , bez widocznych zniszczeń zewnętrznych .	dobrym	5	Masc3
U ludów słowiańskich rodzina miała charakter patriarchalny , a przewodził jej ojciec .	słowiańskich	2	Masc3
Samoobrona i PSL znalazły się poniżej progu wyborczego .	wyborczego	7	Masc3
Na pozostałym oleju podsmażyć mięso z roztartym na miazgę czosnkiem .	pozostałym	1	Masc3
Po części oficjalnej przyszedł czas na popisy artystyczne .	artystyczne	7	Masc3
Ulice zajmą pojazdy napędzane siłą ludzkich mięśni .	ludzkich	5	Masc3
My jesteśmy za biedni !	biedni	3	Masc1
Dach przypomina fale morskie , które często zdobią japońskie drzeworyty .	japońskie	8	Masc3
Wycina się je tam dla celów rolniczych i hodowlanych A NIE PAPIERNICZYCH !	PAPIERNICZYCH	11	Masc3
- Była naprawdę zła , a rozzłoszczeni ludzie zwykle używają ojczystego języka .	rozzłoszczeni	6	Masc1
Na Zalewie Szczecińskim z trudem przedzieramy się przez gęstą krę lodową .	Szczecińskim	2	Masc3
Człowiek był nagi i nieruchomy .	nagi	2	Masc1
W środku był też ciężko poparzony inny mężczyzna .	poparzony	5	Masc1
Przede wszystkim , bądź dla niej dobry , wyrozumiały , łagodny .	wyrozumiały	8	Masc1
Uroczystego otwarcia imprezy dokonał wojewoda nowosądecki Marek Oleksiński .	nowosądecki	5	Masc1
Nie cały Izrael cieszy się z przybycia papieża .	cały	1	Masc3
Cóż znaczyło ośmiu ludzi wobec zbrojnych i groźnych tysięcy ?	groźnych	7	Masc3
Kiedy zaczniemy wreszcie kontrolować budynki mieszkalne i ich stan techniczny ?	mieszkalne	5	Masc3
Współczesne trendy cywilizacyjne sprzyjają siłom zła , lecz dobro nie odpuszcza .	Współczesne	0	Masc3
Tak zabawili się trzej tarnobrzescy gimnazjaliści .	tarnobrzescy	4	Masc1
Robimy następny duży krok do III ligi .	następny	1	Masc3
Naaman , naczelny wódz króla syryjskiego , był człowiekiem bogatym i możnym .	naczelny	2	Masc1
Żonaty , ma 20-letnią córkę .	Żonaty	0	Masc1
Wcześniej ktoś próbował wypożyczyć inny egzemplarz z Biblioteki Jagiellońskiej .	inny	4	Masc3
Nieżyczliwi twierdzą , że wojewoda chorował inaczej .	Nieżyczliwi	0	Masc1
Narconon to najskuteczniejszy program , jaki wymyślono .	najskuteczniejszy	2	Masc3
Uparci i bezkompromisowi , jednych przerażali , innych zachwycali .	jednych	4	Masc1
Zakaz nic nie mówi o tasakach lub półmetrowych nożach kuchennych . . .	półmetrowych	7	Masc3
Spod wody wyłaniały się nowe kontynenty .	nowe	4	Masc3
- To są wąsy Stalina na wyższym szczeblu .	wyższym	6	Masc3
Gdzieś daleko warczał motor niewidzialnego samolotu .	niewidzialnego	4	Masc3
Wybrał em wydział techniczny .	techniczny	3	Masc3
Czy prowadzi nas jeszcze Orfeusz , czy Hermes , a może od dawna już idziemy sami ?	sami	15	Masc1
Niespodziewana , nagła choroba zaściankowego Casanowy zmieniła sytuację .	zaściankowego	4	Masc1
Do 1995 roku francuscy przedsiębiorcy mogli legalnie dotować partie polityczne .	francuscy	3	Masc1
Od dwóch lat Truteń przewodzi wśród kabaretów wiejskich .	wiejskich	7	Masc3
Trzech sprytnych chłopców szukało nawet syrenki w przedszkolnym akwarium .	sprytnych	1	Masc1
Wędrował po Tatrach od 1914 r. , wspinał się od 1924 .	1914	4	Masc3
W hotelu pozostanie intendent , mały pochylony , skromny człowiek .	skromny	8	Masc1
Są nawet puderniczki z prasowanym pudrem i same wkłady .	prasowanym	4	Masc3
Doroczny Bal Mody w salonach Hotelu Europejskiego zgromadził najpiękniejsze panie stolicy .	Europejskiego	6	Masc3
Zza ciemniejących pni drzew wyłonił się strzelec .	ciemniejących	1	Masc3
Uważamy , że jesteśmy lepsi od wielu innych .	lepsi	4	Masc1
Ale nie lubię jubileuszy i nie czuję się zramolałym jubilatem .	zramolałym	8	Masc1
Kompromis na pewno zostanie szybko znaleziony .	znaleziony	5	Masc3
Oprócz Polaków odpływali na tę wyprawę także i cudzoziemcy , wszyscy spod znaku republikańskiego .	republikańskiego	13	Masc3
Świat jest wtedy znacznie ciekawszy . . .	ciekawszy	4	Masc3
– Stare wyrazy żyją ?	Stare	1	Masc3
Był to słuszny protest ?	słuszny	2	Masc3
Sornicy będą nosić tradycyjne kozackie mundury .	kozackie	4	Masc3
Sekreterę zrobił jakiś prowincjonalny ebenista .	prowincjonalny	3	Masc1
Aparaturę filmową obsługuje instruktor terenowy PDK Czesław Fudala .	terenowy	4	Masc1
Nietęgie miny mają strzelcy szwedzcy .	szwedzcy	4	Masc1
Ze zrozumieniem przyjmują lekkomyślny gest .	lekkomyślny	3	Masc3
W tym roku stołeczni stróże prawa odkryli na Mazowszu już osiem takich fabryk .	stołeczni	3	Masc1
Wycieczki będą odbywać się w dni przedświąteczne i świąteczne .	przedświąteczne	6	Masc3
Dostojny gość zwiedzi ponadto stolicę , Kraków oraz Gdańsk .	Dostojny	0	Masc1
Tytus czuł się samotny i opuszczony .	samotny	3	Masc1
List ten nie został jeszcze wysłany .	wysłany	5	Masc3
Ale zaprzyjaźnił em się z nim dopiero w 1956 .	1956	8	Masc3
Punkt konstrukcyjny wynosił wtedy 20 metrów .	konstrukcyjny	1	Masc3
Na krześle siedzi smutny , zrezygnowany człowiek .	smutny	3	Masc1
Czeka nas jeszcze kilka zimnych dni .	zimnych	4	Masc3
Ustawa ma własne przepisy karne .	karne	4	Masc3
Pomiaukując alarmująco , zaprowadził Adama do dużego pokoju .	dużego	6	Masc3
Steve zaklina się , że po każdym dyżurze szykuje ekstra posiłek czworonożnemu ratownikowi .	czworonożnemu	11	Masc1
Ze stara wyciekał olej i płyn chłodzący , a przyczepa miała zdemontowany hamulec awaryjny .	awaryjny	13	Masc3
Gabor został przydzielony do grupy sturmbannführera Zeliga .	przydzielony	2	Masc1
Jej wnuczka , dziesięcioletnia Marta , chodziła do klasy z zamordowanym Łukaszem .	zamordowanym	10	Masc1
Ciemne włosy , spięte w koczek , podtrzymywała złocista spinka .	Ciemne	0	Masc3
Następnym mówcą będzie pan poseł Andrzej Gołaś .	Następnym	0	Masc1
- Zgromadzili śmy tu najstarsze i najładniejsze kostiumy .	najładniejsze	6	Masc3
Pijak został zwolniony z pracy .	zwolniony	2	Masc1
Złoty medal w kategorii do 68 kilogramów zdobyła Kamila Zgolak .	Złoty	0	Masc3
Ich celem był sklep spożywczy w Niedalinie .	spożywczy	4	Masc3
Tworzymy silny zespół i to jest nasz największy atut .	silny	1	Masc3
Jednocześnie polecił zająć się milicjantem prowadzącym śledztwo .	prowadzącym	5	Masc1
Twardzi są ci starzy .	Twardzi	0	Masc1
On też miał słaby suwak .	słaby	3	Masc3
Po kilku miesiącach pracownicy stają się bierni , chorują na śpiączkę .	bierni	6	Masc1
- A jak głosowali inni sarajewscy Serbowie ?	sarajewscy	5	Masc1
Jakże naiwny był Józef , kolejny raz ufając obietnicom białych !	naiwny	1	Masc1
W przypadku BIG-u ostatni miesiąc roku obrachunkowego przyniósł wynik poniżej tegorocznej średniej .	ostatni	3	Masc3
Spiskowano wokół Saddama w sposób nieprawdopodobnie aktywny .	aktywny	6	Masc3
Wielu żałowało , że koncert nie był dłuższy .	dłuższy	7	Masc3
Kupiono za granicą oranżerie , marmurowe posągi .	marmurowe	5	Masc3
W październiku podczas pierwszych tegorocznych mrozów zamarzły cztery osoby .	tegorocznych	4	Masc3
Jej dochód był nieco wyższy niż średnia krajowa .	wyższy	4	Masc3
- Kapliczka przylegała do kościoła katolickiego , Łemkowie z niej od wielu lat nie korzystali .	katolickiego	5	Masc3
Został zbawiony bez swej woli .	zbawiony	1	Masc1
Chciał by być teraz w namiocie , oddzielony od wszystkiego .	oddzielony	7	Masc1
W drzwiach pojawił się sympatyczny mężczyzna , górnik z Borynii .	sympatyczny	4	Masc1
– Zajrzała jej w oczy spłowiałym błękitem tęczówek .	spłowiałym	5	Masc3
Umyte brokuły dzielimy na cząstki i układamy w naczyniu .	Umyte	0	Masc3
Kobieta obracała karty z cichym szelestem .	cichym	4	Masc3
Regina z ciekawością słuchała czytającego z kartki Bornsteina .	czytającego	4	Masc1
Książęta kijowscy tracili podstawy gospodarcze swej pozycji politycznej .	kijowscy	1	Masc1
Dlatego ukrył się i przedostał w środek nieprzyjacielskiego oddziału .	nieprzyjacielskiego	7	Masc3
- Nie układa się jej pod rynkowego konkurenta , ale warto wiedzieć , w co on gra .	rynkowego	6	Masc1
Marynarze niemieccy spostrzegli go .	niemieccy	1	Masc1
Wczoraj kolegium Instytutu usiłowało wyłonić nowego kandydata na prezesa .	nowego	5	Masc1
Jednym susem przeskoczył próg izby .	Jednym	0	Masc3
Spojrzał des Noyers na zegar gdański , stojący w rogu komnaty .	stojący	7	Masc3
Siedzimy naprzeciw siebie , pijemy herbatę , jemy piernik domowego wypieku .	domowego	9	Masc3
Pomnik , zniszczony przez hitlerowców , został odbudowany w 1984 r.	1984	9	Masc3
Żołnierze okopali się tam i celnymi strzałami odpierali atakujących .	celnymi	5	Masc3
Przy uśmiechu Giocondy , dyskretnym i tajemniczym , nikt nie zauważy szczerby z lewej strony .	dyskretnym	4	Masc3
Człowiek jest omylny .	omylny	2	Masc1
- Bał by m się popadania w nastroje mesjanistyczne .	mesjanistyczne	8	Masc3
Wszedł em do jego sterylnego gabinetu .	sterylnego	4	Masc3
Patrzyła biernie , nie widząc niczego , na mijające za oknem podmiejskie pejzaże .	podmiejskie	11	Masc3
Co się roi w twoim szalonym ruskim łbie ?	szalonym	5	Masc3
Mam najnowsze zestawy osób nagrodzonych .	najnowsze	1	Masc3
Stary Pancer , z rękami w kieszeniach spodni , stał oparty o biurko .	oparty	10	Masc1
Dzięki temu kaci mogą zostać skazani nawet na dożywocie !	skazani	5	Masc1
Zatopieni w pełnym kontakcie , przestali śmy zauważać resztę świata .	Zatopieni	0	Masc1
Twoje słowa trafiły na podatny grunt .	podatny	4	Masc3
Kupuje tu nie tylko brytyjska Polonia , ale i rodowici londyńczycy .	rodowici	9	Masc1
Ułatwi ona włączenie się do ruchu jadącym z Koziegłów do Poznania .	jadącym	6	Masc1
Wczoraj koło cmentarza w Sianowie znaleziono kilkuletniego chłopca .	kilkuletniego	6	Masc1
Małgorzata chodziła w letniej sukience na ciepłym wietrze .	ciepłym	6	Masc3
Wśród podhalańskich Cyganów z bezwzględności słynie jego współpracownik , współoskarżony w Oświęcimiu , Stanisław Kamiński z Czarnej Góry .	podhalańskich	1	Masc1
- Dali śmy Kwaśniewskiemu szansę , bo mówił dużo o prostych ludziach .	prostych	10	Masc1
Saudyjski ambasador w Londynie już zapowiedział , że jego rząd nie ugnie się pod presją i nie złagodzi kar .	Saudyjski	0	Masc1
Czy to może być port lotniczy ?	lotniczy	5	Masc3
W tegorocznym VIII turnieju wystartowało 18 drużyn podzielonych na 6 grup .	tegorocznym	1	Masc3
Kolejny pijany policjant straci pracę .	Kolejny	0	Masc1
- Z naszych danych wynika , że przybywa kontraktów denominowanych w złotych .	denominowanych	9	Masc3
To jest najkompletniejszy zbiór .	najkompletniejszy	2	Masc3
Co w takim razie robić z takimi nadliczbowymi zarodkami ?	nadliczbowymi	7	Masc3
W ubiegłym roku udało się tę pozycję zmieścić w budżecie .	ubiegłym	1	Masc3
Wanilii brak , ale cukry waniliowe znakomicie ją zastąpią .	waniliowe	5	Masc3
Kobietom odpowiadał uwodzicielsko nastrojony głos ukrytego w jakiejś dziupli wodzireja .	ukrytego	5	Masc1
Bił tak mocno , że złamał kij bejsbolowy .	bejsbolowy	7	Masc3
Przedostatni figuruje Artur Balazs , poseł i minister rolnictwa , a zamyka ją Stefan Oleszczuk z UPR-u , starosta kamieński .	Przedostatni	0	Masc1
Niosło wonią smoły i wodorostów , woda pluskała cicho o łódki przywiązane do omszałych pali .	omszałych	13	Masc3
Na torze pod Kielcami odbyty się pierwsze wyścigi samochodowe .	pierwsze	6	Masc3
Czy kolega czytuje wcześniejsze posty ?	wcześniejsze	3	Masc3
Poznali śmy też nowych drugoligowców .	nowych	3	Masc1
Z głośników popłyną rytmy soul i disco .	soul	4	Masc3
Oryginalne lampy zdobyto z zasobów niemieckich przeznaczonych dla Wehrmachtu .	niemieckich	5	Masc3
Ostatecznym celem był garnizon w Greifswaldzie na Pomorzu .	Ostatecznym	0	Masc3
- Jakie są Pańskim zdaniem cechy dobrego dyplomaty ?	dobrego	6	Masc1
– A ten nie był odpowiedni ?	odpowiedni	5	Masc3
Piątkowy program przewiduje także cztery mecze hokejowe .	hokejowe	6	Masc3
- To stary , rozpadający się budynek .	rozpadający	4	Masc3
Karl jest bardzo gościnny .	gościnny	3	Masc1
Zawsze zresztą twierdziła m , że jestem męskim typem .	męskim	7	Masc3
My jesteśmy gotowi .	gotowi	2	Masc1
Ciotka nie przysyłała dolarów , ciotka brodatego syna Cybucha rozwijała świadomość .	brodatego	6	Masc1
Z urzędów i różnych instytucji ginie nawet papier toaletowy .	toaletowy	8	Masc3
Na torze pod Kielcami odbyty się pierwsze wyścigi samochodowe .	samochodowe	8	Masc3
Naczelnik ulicznych rzeźników wykrzywił twarz .	ulicznych	1	Masc1
- Czy liście są jeszcze zielone ?	zielone	5	Masc3
- Był nieodzowny .	nieodzowny	2	Masc3
- Była naprawdę zła , a rozzłoszczeni ludzie zwykle używają ojczystego języka .	ojczystego	10	Masc3
Ale taki film został nakręcony .	nakręcony	4	Masc3
Pewien brytyjski rolnik leczył swą chorą krowę piwem .	brytyjski	1	Masc1
Oprócz dżenińskiego obozu , Izraelczycy dokonali także przeszukania w domach na terenie samego miasta .	dżenińskiego	1	Masc3
Dopiero następnego dnia wieczorem ruszył w powrotną drogę .	następnego	1	Masc3
Wiek XIX ma swoje lokomotywy , ale nie ma swoich katedr .	XIX	1	Masc3
Kwity wykłada sympatyczny i kulturalny pan po pięćdziesiątce .	sympatyczny	2	Masc1
W ostatnich dniach klub został niemal sparaliżowany przez wewnętrzne konflikty .	sparaliżowany	6	Masc3
Zwykłe też znikają .	Zwykłe	0	Masc3
Osadzony powtórnie na 15 lat , umiera w więzieniu .	Osadzony	0	Masc1
Grupa powstała we wczesnych latach 80 .	80	5	Masc3
Stali dłuższą chwilę niezdecydowani , nie ważąc się na ryzykowny krok .	ryzykowny	9	Masc3
Dante raczył zajmować się przede wszystkim potępionymi .	potępionymi	6	Masc1
Nauczyciel szybko uporał się z zakupami i , nie powracając już do poprzedniego tematu , z widoczną ulgą pożegnał chałupniczkę .	poprzedniego	12	Masc3
Poczuł em się wyróżniony ponad zasługę .	wyróżniony	3	Masc1
Cały czas grała m z tobą .	Cały	0	Masc3
U Bosmana rosły srebrzyste świerki , ale ktoś wykopał .	srebrzyste	3	Masc3
Radar należy do najnowocześniejszych na świecie .	najnowocześniejszych	3	Masc3
Mam pracę do czerwca , rozbieramy teraz czwarty piec .	czwarty	7	Masc3
– Jakie są Pani najbliższe plany zawodowe ?	zawodowe	6	Masc3
Spośród trzystu ochotników Polluks wybrał stu najlepiej znających się na morzu .	znających	7	Masc1
KTO PIERWSZY ZAPALIŁ OGIEŃ NA ROZEWIU ?	PIERWSZY	1	Masc1
- Mały czupurny kapral Patejuk gorącym szeptem dmuchał Marczakowi w ucho .	czupurny	2	Masc1
Może jakoś dogada się jeszcze z tym głupim bydlakiem .	głupim	7	Masc1
Ale nie pamiętam pierwszego seksu .	pierwszego	3	Masc3
Spała , Wałcz czy Cetniewo są od dawna ośrodkami na najwyższym europejskim poziomie .	najwyższym	10	Masc3
Dogonili go dopiero na pobliskim parkingu .	pobliskim	4	Masc3
Budapeszteńska giełda ma i inne poważne problemy .	poważne	5	Masc3
W ostatnich latach w Polsce nie powstał żaden klub hokejowy .	hokejowy	9	Masc3
A tak nazywały się serwowane tam alkohole .	serwowane	4	Masc3
Naszym wspólnym celem jest kultura , a kultura nie ma granic .	wspólnym	1	Masc3
Zwolnienia zostaną rozłożone na cały 2001 r.	2001	5	Masc3
Z kilku innych postów wynika , że to jednak nie regionalizm .	innych	2	Masc3
Budowa jest w stanie surowym .	surowym	4	Masc3
Z tak zlokalizowanym wrogiem łatwiej walczyć . . .	zlokalizowanym	2	Masc1
- Nasi żarłoczni przyjaciele ciągle są w amoku . . .	żarłoczni	2	Masc1
Spłonęły papiery , stare szmaty , niepotrzebne sprzęty .	niepotrzebne	6	Masc3
Był to straszliwy bląd polityczny .	straszliwy	2	Masc3
Czyżby teraz przepuściła okazję , mając tuż obok przystojnego młodego mężczyznę ?	młodego	9	Masc1
Przez tereny parku wiodą 44 szlaki turystyczne piesze i 10 narciarskich .	turystyczne	6	Masc3
Ze ścian mrugają kolorowe neony świąteczne w kształcie choinek , bombek i dzwonków .	świąteczne	5	Masc3
Czy nie obawia się pani odpływu dewiz z banków krajowych ?	krajowych	9	Masc3
Do wytworzenia pary i utrzymywania ognia we właściwej temperaturze służy oddzielny palnik gazowy .	gazowy	12	Masc3
W miniony piątek przegłosowano ten wniosek .	miniony	1	Masc3
Nie zapomnę tego pierwszego dnia .	pierwszego	3	Masc3
W jednej z wsi w powiecie działdowskim 23-letni mężczyzna zgwałcił 44-letnią matkę .	23-letni	7	Masc1
Gdy na miejscu zjawili się policjanci z komisariatu kolejowego policji , schronisko znajdowało się w opłakanym stanie .	kolejowego	8	Masc3
Lewy policjant pożyczył od niego na paliwo .	Lewy	0	Masc1
Żołnierze poznańskiego garnizonu pełnili honorową straż .	poznańskiego	1	Masc3
Rezultat wydaje się z góry przesądzony , ale każdy z autorów chciał by dorzucić własne argumenty .	przesądzony	5	Masc3
Naaman , naczelny wódz króla syryjskiego , był człowiekiem bogatym i możnym .	możnym	11	Masc1
Afgańczycy nie uznawali ani wiecznych wrogów , ani wiecznych przyjaciół .	wiecznych	8	Masc1
Przywołał żołnierza niosącego wiadro .	niosącego	2	Masc1
Od 1996 w Ekstraklasie gra drużyna miejscowej Odry .	1996	1	Masc3
Aktualnie nieczynny teleporter zostanie adaptowany na kolejny sklep spożywczy .	adaptowany	4	Masc3
Dla zdławienia partyzantów działających w górach rząd mobilizuje poważne siły zbrojne .	działających	3	Masc1
Od 1964 do Poznania docierają pociągi elektryczne z Warszawy .	elektryczne	6	Masc3
Agnieszka Strumiłowska opowiedziała mi historię z jej czasów studenckich .	studenckich	8	Masc3
Prócz akcji upowszechniania czytelnictwa wśród dzieci Warszawy , podjęła prace o charakterze ogólnym , często prekursorskim .	prekursorskim	15	Masc3
Amerykanie rzeczywiście zrobili śliczny manewr pancerny .	śliczny	3	Masc3
- Ten rozciągnięty szyk drogo nas kosztował .	rozciągnięty	2	Masc3
Dwa pozostałe budynki mają być gotowe we wrześniu .	gotowe	5	Masc3
Woda dokoła niej poróżowiała od zmytego kurzu .	zmytego	5	Masc3
To ich największy walor , umiejętność , to ich przeznaczenie .	największy	2	Masc3
Płaczącym wybacza się łatwiej i chętniej .	Płaczącym	0	Masc1
Po zdjęciu serwetki i położeniu jej na kolanach na małym talerzyku spożyjemy przekąskę .	małym	9	Masc3
Psychiatrzy orzekli , że nie był w pełni poczytalny .	poczytalny	8	Masc1
Polonia zagrała bez trzech piłkarzy z podstawowego składu .	podstawowego	6	Masc3
Aresztowanego na 48 godzin mistrza zwolniono po poręczeniu majątkowym .	Aresztowanego	0	Masc1
Sekretarz generalny KPZR Leonid Breżniew odwiedził Bułgarię , Jugosławię i Węgry .	generalny	1	Masc1
Będzie to film szerokoekranowy , składający się z dwóch części .	składający	5	Masc3
Mirosław Seta , miejscowy strażak , wchodzi meldując , że sytuacja wydaje się opanowana .	miejscowy	3	Masc1
Na poszczególnych lodowcach warunki lokalne modyfikują tę zależność .	poszczególnych	1	Masc3
Czy bez Marka Pola w rządzie miał by pan pełnomocnika do spraw kobiet albo pomysły autostradowo - winietowe ?	winietowe	17	Masc3
Cóż znaczyło ośmiu ludzi wobec zbrojnych i groźnych tysięcy ?	zbrojnych	5	Masc3
Fiokła spała w sąsiednim pokoju .	sąsiednim	3	Masc3
Zwłaszcza gimnazjum wydaje się nieudanym pomysłem .	nieudanym	4	Masc3
Świadczy o tym choćby ceremoniał religijny podczas zaprzysiężenia .	religijny	5	Masc3
Umyślił teraz opowiedzieć to zdarzenie choremu wnuczkowi .	choremu	5	Masc1
Przerwał na chwilę chwytając świszczący oddech .	świszczący	4	Masc3
Czy zdajesz sobie sprawę z tego , że nie jesteś ochrzczony ?	ochrzczony	10	Masc1
Tylko w tym celu został w kosmos zaproszony .	zaproszony	7	Masc1
Frenoplast , to inwestor produkujący okładziny hamulcowe .	produkujący	4	Masc1
Rozebrał się , wszedł do rzeki , zanurkował przy urwistym brzegu .	urwistym	9	Masc3
Po zetknięciu z ziemią maszyna wybuchła , a siła eksplozji wyrzuciła dwóch słowackich mechaników i Marka Panasia .	słowackich	12	Masc1
Odnalazł Jaskra , kibicującego łupiącym w gwinta krasnoludom .	łupiącym	4	Masc1
Podobny sprzęt otrzymywały od niego dzieci i w ten sposób kontaktował się z nimi .	Podobny	0	Masc3
Oddech jego stał się krótki , przerywany , nierówny .	przerywany	6	Masc3
Podeszła do samego brzegu .	samego	2	Masc3
W podobny sposób wzruszają go także niektóre stare pieśni kościelne .	podobny	1	Masc3
O ostatecznym wyniku decydowali nie jurorzy , a matematyka .	ostatecznym	1	Masc3
Koniec jego był bardzo smutny .	smutny	4	Masc3
Tymczasem smutny urzędnik konsulatu zajął się moim bagażem .	smutny	1	Masc1
Po sali krzątał się starszy mężczyzna w zielonym kitlu .	zielonym	7	Masc3
Leżeli śmy przez chwilę w milczeniu , wsłuchując się we własne oddechy .	własne	10	Masc3
W tych miastach znaczne wpływy zdobyła sobie wiara protestancka .	znaczne	3	Masc3
Całowała go drobnymi , szybkimi pocałunkami .	szybkimi	4	Masc3
Posiadał wszechstronny , uniwersalny umysł obejmujący szereg nauk specjalnych .	obejmujący	5	Masc3
Do niego , oczywiście , nawiązuje francuski barbier .	francuski	6	Masc1
- Raport o stanie państwa nie został ogłoszony przed Wigilią na osobisty wniosek premiera .	ogłoszony	7	Masc3
Wrócił na czołg po własnych śladach .	własnych	4	Masc3
W milczeniu spożywali zimną konsolację , szczękały sztućce , dworscy w ciemnych surdutach sprawnie zmieniali misy .	ciemnych	11	Masc3
Plan , jeśli ma się powieść , musi być przede wszystkim możliwy .	możliwy	11	Masc3
– i nie jestem sztywny no . .	sztywny	4	Masc1
Najbliżsi rywale Orfe także nie rezygnują z przejęcia kolejnych mniejszych dystrybutorów .	Najbliżsi	0	Masc1
Następnie Aleksander Zawadzki dokonał otwarcia muzeum w dziesiątym Pawilonie .	dziesiątym	7	Masc3
- Czy ma Pan sportowego idola ?	sportowego	4	Masc1
WITAM PANA , DROGI FIATOWCU ! ! !	DROGI	3	Masc1
Chłopiec przebywa w greckim przytułku prowadzonym przez organizację o złej reputacji .	prowadzonym	5	Masc3
Będę się starał o inne rozwiązanie , a jestem uparty .	uparty	9	Masc1
Zmarłych żołnierzy francuskich i bawarskich pogrzebano na cmentarzu przykościelnym .	przykościelnym	8	Masc3
Nie odpowiada ono na przykład prototypowi stalinowskiemu .	stalinowskiemu	6	Masc3
Piotr Aniołkiewicz i Paweł Sulikowski zginęli w 1997 r. koło Komorowa .	1997	7	Masc3
Chaim został stracony .	stracony	2	Masc1
- Jako człowiek próżny chętnie wracam do rzeczy przyjemnych .	próżny	3	Masc1
Ostatni , w 1822 , strawił większość drewnianej i murowanej zabudowy .	1822	3	Masc3
Jeden z uczestników rusza w las , licząc kroki .	Jeden	0	Masc1
Z Garbu Lubawskiego wypływają niewielkie rzeki .	Lubawskiego	2	Masc3
W niegłupich oczach był dziecinny tragizm .	dziecinny	4	Masc3
Budynek Ratusza Staromiejskiego wymaga ogromnych nakładów inwestycyjnych .	Staromiejskiego	2	Masc3
Ostatnio nie bywał delikatny .	delikatny	3	Masc1
Hiszpański wicekról Argentyny kazał wysłać znalezisko do Madrytu .	Hiszpański	0	Masc1
Rękaw pięknie wyszywanego fraka prędko nasiąkł krwią .	wyszywanego	2	Masc3
Popatrzyli śmy z Ludwikiem na siebie , zaskoczeni , bez słowa .	zaskoczeni	7	Masc1
Rozpoczyna się teraz emocjonujący wyścig ze zbliżającą się burzą .	emocjonujący	3	Masc3
Ten dialog został odtworzony w śledztwie bez trudu .	odtworzony	3	Masc3
Jak tchórzliwy jest Manifest Połaniecki Kościuszki !	Połaniecki	4	Masc3
- Czytał em , choć czuł em się coraz mocniej poniżony .	poniżony	10	Masc1
Rośnie pokolenie ludzi straconych , wyrzuconych . . .	wyrzuconych	5	Masc1
W tym roku pojawiły się one w całym powiecie kwidzyńskim .	całym	7	Masc3
Równie interesujące były programy przygotowane przez uczniów z pozostałych miejscowości .	przygotowane	4	Masc3
Głośno mówiły w niezrozumiałym dla mnie języku .	niezrozumiałym	3	Masc3
Stali dłuższą chwilę niezdecydowani , nie ważąc się na ryzykowny krok .	niezdecydowani	3	Masc1
Długiego stażu małżeńskiego gratulował poseł Tadeusz Cymański .	Długiego	0	Masc3
Stary Pancer , z rękami w kieszeniach spodni , stał oparty o biurko .	Stary	0	Masc1
Fałszywego księdza przewieziono do więzienia w Rawiczu .	Fałszywego	0	Masc1
Orkiestry murzyńskie grają ragtime'y , tłum cheerleaderek tworzy radosny , falujący szpaler .	falujący	10	Masc3
Ogromnym wzięciem cieszą się przed sezonem urlopowym jednorazowe nakładki toaletowe .	urlopowym	6	Masc3
Pragnę nadmienić , że nie wszystkie marzenia i oczekiwania wywołują sny odwrotne .	odwrotne	11	Masc3
- Po co wdzierał się do cudzego domu ? !	cudzego	6	Masc3
Głupiego samochodu na parę minut zostawić nie można , to się nazywa MO ?	Głupiego	0	Masc3
Skąd wiemy , że ten cmentarz jest zamknięty ?	zamknięty	7	Masc3
Zwierzętarnia , wciśnięta między gmach zakładu doświadczalnego a kotłownię , stanowiła całe odrębne królestwo .	doświadczalnego	6	Masc3
Sanki pomknęły po ubitym śniegu na Pohulankę .	ubitym	3	Masc3
W ten sposób Rumuni wystąpili w roli głównego mediatora pomiędzy Moskwą a Pekinem .	głównego	7	Masc1
Wieczorny mrok gęstniał coraz bardziej w drobnym i dokuczliwym deszczu .	Wieczorny	0	Masc3
- Jeśli lud przestanie słuchać naszych nauk , zostanie pożarty przez pogan !	pożarty	9	Masc3
Mój widok bardzo zaskoczył LPR-owskiego działacza .	LPR-owskiego	4	Masc1
Jakie są główne zarzuty rzecznika ?	główne	2	Masc3
Wyczuł em , że Shadrach nie jest w najbardziej rozmownym nastroju .	rozmownym	9	Masc3
Nie puszczamy w powietrze materiałów obciążających .	obciążających	5	Masc3
Dodatkowym zabezpieczeniem będzie unikanie kwiatowych deseni .	kwiatowych	4	Masc3
Kolejowi robotnicy prowadzili tam prace modernizacyjne .	Kolejowi	0	Masc1
Obowiązują tu także egzaminy teoretyczne .	teoretyczne	4	Masc3
Obrazy cyfrowe składają się z połączonych ze sobą pikseli o różnych barwach lub tonach .	cyfrowe	1	Masc3
W niedzielę w nocy anonimowy rozmówca zawiadomił dyżurnego policji , że w banku znajdują się ludzie .	anonimowy	4	Masc1
Niedługo zobaczymy Tomasza Adamka reklamującego piwo albo męską bieliznę ?	reklamującego	4	Masc1
Nie tylko we Włoszech przestępcy wykorzystują polskich pracowników .	polskich	6	Masc1
Bo koledzy starsi o rok , dwa mogli stracić dziewictwo jeszcze w komunizmie .	starsi	2	Masc1
Niech wejdzie lis Chmura w świetny stan , górników polskich stan .	polskich	9	Masc1
- Jutro drugi klucz będzie panu magistrowi oddany .	oddany	7	Masc3
Niespodziewanie triumfowali Niemcy , którzy mieli doskonale przygotowany sprzęt .	przygotowany	7	Masc3
Pamiętam , że podczas moich studiów w Rzymie w sklepach watykańskich pojawiło się piwo żywieckie .	watykańskich	10	Masc3
Nie kryją się z tym , chcą być widziani , rozpoznani ?	widziani	8	Masc1
Został em zmobilizowany do przemysłu .	zmobilizowany	2	Masc1
Ze wschodnim uporem i takąż wytrwałością badali każdą ewentualność sami , przez swych znajomych , przez znajomych , aż znaleźli .	sami	9	Masc1
Zasapany Mock zszedł ze stołu i włożył głowę do żeliwnego zlewu .	żeliwnego	9	Masc3
- W 1997 r. rozwiodł em się .	1997	2	Masc3
Dostała półroczny kontrakt w Ameryce Południowej .	półroczny	1	Masc3
Wszystkiego dowiem się we właściwym czasie .	właściwym	4	Masc3
Ale nawet najwięksi krytycy Rutkowskiego chwalą jego zdolności autoreklamiarskie .	najwięksi	2	Masc1
Wyrok znów był niekorzystny , ale emeryt się nie poddaje .	niekorzystny	3	Masc3
Projekty w kierunku zachodnim zostaną zrobione w przyszłym roku .	zrobione	5	Masc3
Nagle z ciemności wyłoniło się trzech mężczyzn kryjących twarze pod kominiarkami .	kryjących	7	Masc1
Na moście zatrzymują się kolejne samochody .	kolejne	4	Masc3
Przy jego pomocy można obrazować wpływ poszczególnych czynników absencji .	poszczególnych	6	Masc3
Teraz składamy paskowy patchwork , ocieplenie i podszewkę , zszywamy wzdłuż prostego brzegu i obszywamy lamówką .	prostego	11	Masc3
Dystychy , analizowane dotąd oddzielnie , złóżmy obecnie w całość , bo przecież w Dusiołku tworzą one taką całość .	analizowane	2	Masc3
Franciszek wychodząc z cmentarza dojrzał samotnego Wilhelma .	samotnego	5	Masc1
W 1979 utworzono tu Szkołę Mistrzów Pszczelarskich .	1979	1	Masc3
Kosmetyka jest tylko bardzo pożądanym dodatkiem .	pożądanym	4	Masc3
Janek Prosty uważał rude włosy za szczytowe osiągnięcie Pana Boga .	rude	3	Masc3
U sześciu pozostałych kandydatów dopatrzyła się nieprawidłowości .	pozostałych	2	Masc1
Wyobrażał sobie minę Każe-duba czytającego jego raport .	czytającego	4	Masc1
Śpiącego , zielem odurzonego zabiła m sztyletem .	odurzonego	3	Masc1
Chodziło o to , aby wyciągnąć z katastrofy mądre i dobre wnioski .	mądre	8	Masc3
Polacy jadący w autokarze spoglądają z nietajoną dumą na wielkiego rodaka .	jadący	1	Masc1
Bezpowrotnie stracił piękne synowskie uczucie i mocno poranił wrażliwą duszę młodego człowieka .	młodego	10	Masc1
Nie udźwignie już miecza krwawego ręka syna struchlała .	krwawego	4	Masc3
Z zaskoczeniem przeglądali śmy witrynę internetową Stołecznego Zakładu Energetycznego .	Stołecznego	6	Masc3
Rozdają publiczne pieniądze na rzecz Kościoła katolickiego , modlą się żarliwie przed kamerami , marzą o cenzurze obyczajowej .	publiczne	1	Masc3
Występ charytatywny zaproponowały artystce władze zakładu karnego .	karnego	6	Masc3
Maluch jest zdrowym chłopcem .	zdrowym	2	Masc1
Wszystkie pokoje wyposażone w szafy wnękowe są już gotowe .	gotowe	8	Masc3
Czyżby mniejszy mózg nie był wcale gorszy ? !	gorszy	6	Masc3
Zebranych powitał burmistrz Bogdan Małecki , on też wygłosił okolicznościowe przemówienie .	Zebranych	0	Masc1
Przywileje jednych utrzymują się dzięki mizerii innych .	jednych	1	Masc1
Brzęcząc pustymi kuflami , weszła do środka .	pustymi	1	Masc3
Jest unerwiona przez nerw trójdzielny .	trójdzielny	4	Masc3
Zmęczeni wysiadali śmy z ciasnej szoferki .	Zmęczeni	0	Masc1
Czy uważa Pan , że dzisiejsi studenci już się nie buntują ?	dzisiejsi	5	Masc1
Poszkodowanych jest pięciu właścicieli .	Poszkodowanych	0	Masc1
Z przodu oboma dłońmi chwytamy za przedramię zgięte w stawie łokciowym .	łokciowym	10	Masc3
W Urzędzie Wojewódzkim w Skierniewicach pracuje około 230 osób .	Wojewódzkim	2	Masc3
Nie budzi go huk przejeżdżającego pociągu ani blask słońca , kiedy odpływa kolejny obłok .	przejeżdżającego	4	Masc3
Warto by zażądać wojskowego konsultanta .	wojskowego	3	Masc1
Podczas prac leśnych przepadł mu też dowód osobisty .	osobisty	7	Masc3
Wyobraź sobie człowieka znajdującego się na ogromnej górze .	znajdującego	3	Masc1
W Nowym Tomyślu wiatr zerwał dach urzędu skarbowego i pasażu handlowego .	handlowego	10	Masc3
W 1972 r. wraz z kolegami wpadł podczas rozlepiania ulotek na mieście .	1972	1	Masc3
Pierwsza uczestniczka zaśpiewa o miłości przyprawianej różnymi smakami .	różnymi	6	Masc3
– Jeden z nich zaczął napierać na mnie ciałem .	Jeden	1	Masc1
Mechanizm okazał się bardziej trwały od człowieka .	trwały	4	Masc3
– domki ro jednorodzinne i ogródki działkowe tam są .	jednorodzinne	3	Masc3
Faceci wyglądają na prawdziwych twardzieli .	prawdziwych	3	Masc1
Powodem był ulatniający się z nieszczelnej instalacji gaz .	ulatniający	2	Masc3
- Michał nagle stał się natarczywy i to mnie zdziwiło .	natarczywy	5	Masc1
Zatrzymali samochód , bo wydał się podejrzany .	podejrzany	6	Masc3
Do oficjalnych transportów robotnicy dorzucali swoje ładunki .	oficjalnych	1	Masc3
Odcinali go z najmłodszym synem .	najmłodszym	3	Masc1
Zauważyła m , że człowiek ten jest nawet całkiem miły .	miły	9	Masc1
Byli chłopi zwiezieni autobusami .	zwiezieni	2	Masc1
Potem polski papież został by w Watykanie kanonizowany .	kanonizowany	7	Masc1
Czy po uchwaleniu Konstytucji zostanę zgładzony ?	zgładzony	5	Masc1
Normalny bilet sieciowy kosztuje w tym mieście 30 złotych .	Normalny	0	Masc3
Aktualnie nieczynny teleporter zostanie adaptowany na kolejny sklep spożywczy .	spożywczy	8	Masc3
- Normalnych klientów mi odstraszyli .	Normalnych	1	Masc1
Odnosił em literacki sukces .	literacki	2	Masc3
Rosyjscy eksperci uważają , że De Beers wzbogaca się nieuczciwie kosztem innych członków kartelu .	Rosyjscy	0	Masc1
Przywileje jednych utrzymują się dzięki mizerii innych .	innych	6	Masc1
Przeszedł budynek stacyjny .	stacyjny	2	Masc3
Który z ministrów może bez pytania wtargnąć w nocy do prywatnych apartamentów prezydenta ?	prywatnych	10	Masc3
- Szymon stawał się coraz grzeczniejszy .	grzeczniejszy	5	Masc1
Tylko częściowo można to wytłumaczyć względami historycznymi .	historycznymi	6	Masc3
Naoczny świadek stwierdził , że samolot leciał nisko .	Naoczny	0	Masc1
- Chłopaki z lubelskiego zespołu hiphopowego noszą takie krawaty .	hiphopowego	5	Masc3
Lekarze reanimowali ciężko rannego .	rannego	3	Masc1
Za granicą sprzedawane są nasiona w mieszankach i pojedynczych kolorach .	pojedynczych	8	Masc3
Jedziemy do Havru , ten stary kozioł płaci .	stary	5	Masc1
Nie jestem piratem drogowym .	drogowym	3	Masc1
Pisarz już był przytomniejszy .	przytomniejszy	3	Masc1
Zwykle są to mniejsze pojedyncze okazy .	pojedyncze	4	Masc3
– Mam syna starszego od ciebie . . .	starszego	3	Masc1
Wieczorny mrok gęstniał coraz bardziej w drobnym i dokuczliwym deszczu .	dokuczliwym	8	Masc3
Tam znajdują się dane o poszukiwanych przestępcach .	poszukiwanych	5	Masc1
Licznie przybyła publiczność zajęła miejsca przy stołach biesiadnych , na obszernym trawniku lub obok sceny .	biesiadnych	7	Masc3
Od dziś dnia cały 18-ty arrondissement jest zamknięty od 6-ej po południu .	18-ty	4	Masc3
Na pewno masz jakiś specjalny , alarmowy numer .	alarmowy	6	Masc3
Dotknięta wojennymi ciężarami buntowała się i odmawiała odrabiania pańszczyzny .	wojennymi	1	Masc3
W zasadzie absolutorium będzie dotyczyć poprzedniego zarządu .	poprzedniego	5	Masc3
Teraz zaczynał się najbardziej pokreślony fragment .	pokreślony	4	Masc3
W Netii taniej będzie jeszcze jutro przez cały dzień .	cały	7	Masc3
Liczb jeszcze nie ma , ale powinny pojawić się w najbliższym czasie .	najbliższym	10	Masc3
Warszawscy radiowcy okazali się trudnymi rywalami .	Warszawscy	0	Masc1
Ciągle też nie wiadomo , jaki będzie pełny skład rady PRKCh .	pełny	7	Masc3
Prezes Pieprzowski nie jest taki pewny .	pewny	5	Masc1
Pięciu pracowników przyjęto w ostatnich miesiącach .	ostatnich	4	Masc3
Miała swoiście wyrobiony smak .	wyrobiony	2	Masc3
- Obiecał em mojemu młodszemu , że przyniosę mu dzisiaj dwie kulki . . .	młodszemu	4	Masc1
Na wrocławski Rynek rzeczywiście przybyły tłumy .	wrocławski	1	Masc3
Pozostali ministranci postanowili dalej pełnić służbę ministrancką .	Pozostali	0	Masc1
Patrzył na firankę , lecz tak roztargnionym wzrokiem , że nie zauważył , jak wydyma się od wiatru .	roztargnionym	6	Masc3
W 18-ym okręgu wyleciał w powietrze burdel dla żołnierzy niemieckich .	niemieckich	9	Masc1
Pomnik , zniszczony przez hitlerowców , został odbudowany w 1984 r.	odbudowany	7	Masc3
W wspomnianych zestawach nie figurują te nazwiska .	wspomnianych	1	Masc3
Noc zamazała fantastyczne kolory i wszystkie klomby wyglądały teraz jednakowo .	fantastyczne	2	Masc3
Dlatego językiem oficjalnym stał się arabski , a dąży się , by stał się językiem ogólnonarodowym .	arabski	5	Masc3
W domu wspomniała o studniówce przy niedzielnym obiedzie .	niedzielnym	6	Masc3
Resztę dopowiedzą polityczni konkurenci .	polityczni	2	Masc1
Wódz rzymski podskoczył ku niemu i chwycił gwałtownie za szerokie bary .	rzymski	1	Masc1
on jest dos dosyć stary .	stary	4	Masc1
Nerwowy kupiec odruchowo wcisnął mu sakiewkę do ręki .	Nerwowy	0	Masc1
I chcę , aby świat cały począł służyć Jezusowi .	cały	5	Masc3
Biedny Drossos , sami analfabeci głosowali na niego …	sami	3	Masc1
Według dokumentów celnych miał przewozić wyroby czekoladowe .	czekoladowe	6	Masc3
Przez tereny parku wiodą 44 szlaki turystyczne piesze i 10 narciarskich .	narciarskich	10	Masc3
- Nyvarp zmienia kolor na zielony !	zielony	5	Masc3
W 18-ym okręgu wyleciał w powietrze burdel dla żołnierzy niemieckich .	18-ym	1	Masc3
Kłopoty z tym związane trwają do dziś .	związane	3	Masc3
Spirytus jest rozlewany do kartoników litrowych , półlitrowych i ćwiartek .	rozlewany	2	Masc3
Że się szydzi z personelu naziemnego .	naziemnego	5	Masc3
Pobity kijem bejsbolowym mężczyzna trafił z licznymi obrażeniami do szpitala .	bejsbolowym	2	Masc3
Biblioteka liczy około 950 tomów i ma charakter przeważnie naukowy .	naukowy	9	Masc3
Jaki jest kontekst religijny takiego poznawania ?	religijny	3	Masc3
Cały kraj był zdławiony tym okropnym cieniem .	Cały	0	Masc3
Orkiestry murzyńskie grają ragtime'y , tłum cheerleaderek tworzy radosny , falujący szpaler .	radosny	8	Masc3
Kontakty towarzyskie utrzymywali jednak przez cały czas .	towarzyskie	1	Masc3
Błyskotliwy wykładowca - matematyk o mrocznej urodzie zafascynował młodą studentkę .	Błyskotliwy	0	Masc1
Nie zląkł się pątnik cichy .	cichy	4	Masc1
Wystarczyło paru lat , aby konkret został wyklęty .	wyklęty	7	Masc3
Przy kościele spoczywają powstańcy z 1831 i 1848 .	1848	7	Masc3
Linia Jana kończy się na świętym Stanisławie Kostce .	świętym	5	Masc1
W milczeniu spożywali zimną konsolację , szczękały sztućce , dworscy w ciemnych surdutach sprawnie zmieniali misy .	dworscy	9	Masc1
Królową Mody wybrano na rok 1935 znaną pieśniarkę Werę Bobrowską .	1935	5	Masc3
Czarny , wilgotny otwór jamy przerażał ich .	wilgotny	2	Masc3
– Jasiu jest bardzo modny . .	modny	4	Masc1
Wikipedia , nasz siostrzany projekt , zawiera artykuł na temat nawozów zielonych .	siostrzany	3	Masc3
Jadwiga Melnyk przeszła w człuchowskim szpitalu dwa zabiegi .	człuchowskim	4	Masc3
Ranni żołnierze zostali przewiezieni do szpitala w Białogardzie .	przewiezieni	3	Masc1
Klub przeniósł się do osiedlowych garaży pod blokami .	osiedlowych	4	Masc3
Kłaniając się przepraszająco , opuścili śmy z panem Adamkiem zakład pogrzebowy .	pogrzebowy	10	Masc3
Piątkowy program przewiduje także cztery mecze hokejowe .	Piątkowy	0	Masc3
Religijny Żyd nie wejdzie do kościoła .	Religijny	0	Masc1
Twierdził , że jest nieśmiertelny i że zamierza zbawić świat .	nieśmiertelny	4	Masc1
- Nie jest dobrze , ale trzeba być dowcipnym .	dowcipnym	8	Masc1
Finansowo wspiera Trutnia Gminny Ośrodek Kultury w Rabie Wyżnej , a także skawiańscy biznesmeni z Polski i Chicago .	Gminny	3	Masc3
Był sparaliżowany , stracił mowę i pamięć .	sparaliżowany	1	Masc1
- Proszę posłów sekretarzy o zajęcie miejsc przy stole prezydialnym .	prezydialnym	9	Masc3
W Polsce przebywała delegacja parlamentarzystów tureckich .	tureckich	5	Masc1
Milion konsumentów nieprzestrzegających zasad koszerności dokonało przełomu na rynku spożywczym .	spożywczym	9	Masc3
Prowadźcie mnie do głównego .	głównego	3	Masc1
Owoc dojrzały nie wyda nasion , kiść uschnie .	dojrzały	1	Masc3
Kierowca , 29-letni Daniel Marciniak , odbiera telefon .	29-letni	2	Masc1
Był by znakomitym pedagogiem uwielbianym przez studentów .	uwielbianym	4	Masc1
Widzicie , lyrijski orzeł czarny i rivskie rauty czerwone .	rivskie	6	Masc3
Także on został uznany za winnego .	uznany	3	Masc1
W czwartek rano na terenie stoczni utonął 60-letni pracownik Gdańskiej Stoczni Remontowej .	60-letni	7	Masc1
Jakiś chłopak postanowił wspiąć się na słup , by osobiście zdementować bzdury o magicznym prądzie elektrycznym .	elektrycznym	15	Masc3
Nigdy nie starał się być odważnym .	odważnym	5	Masc1
Każdy duży sklep samoobsługowy lub mięsny wyposażono w krajalnice do wędlin .	samoobsługowy	3	Masc3
Dotychczas odwołujący się mogą pozostawać w Niemczech przez wiele miesięcy .	odwołujący	1	Masc1
Immonen , w czarnych dżinsach welwetowych i w zgniłozielonym golfie , nie zdążył jeszcze zrzucić kożucha .	zgniłozielonym	8	Masc3
Ranni żołnierze zostali przewiezieni do szpitala w Białogardzie .	Ranni	0	Masc1
Uważają nas za moskalofilów , takich zaprzańców antyukraińskich , podczas gdy sami deklarują ukraiński patriotyzm .	antyukraińskich	7	Masc1
Każdy z nich trzymał w ręku długi , płaski klucz .	płaski	8	Masc3
Wtedy zapytała m pierwszego z brzegu rajcę , czy pozwoli tak zmienić swój dom .	pierwszego	3	Masc1
Rozbity samochód trafił na policyjny parking .	policyjny	4	Masc3
Późny , głęboki zmierzch na przedmieściu , przez które biegnie do apteki żona umierającego .	Późny	0	Masc3
Wcześniejsze doniesienia mówiły , że był to zamach samobójczy .	samobójczy	8	Masc3
Podróżujący pierwszą klasą będą odtąd mogli wypoczywać podczas lotu na rozkładanych podwójnych siedzeniach .	Podróżujący	0	Masc1
Pojawiła się również wzmianka o niej w listach Leibniza z roku 1715 .	1715	11	Masc3
Sprowadzeni na miejsce strażacy i policjanci nie ukrywali zdziwienia .	Sprowadzeni	0	Masc1
Na ciepły kąt nie mają szans .	ciepły	1	Masc3
Rezultat wydaje się z góry przesądzony , ale każdy z autorów chciał by dorzucić własne argumenty .	własne	14	Masc3
Bardzo często , kiedy był em wściekły i napięty , wypijał em na rozluźnienie piwko czy setkę .	wściekły	6	Masc1
Wśród przyjezdnych jest młoda Jadzia Maślak .	przyjezdnych	1	Masc1
Także on został uznany za winnego .	winnego	5	Masc1
Oni nie są autentycznie indywidualni .	indywidualni	4	Masc1
Dziś Jacek kupił i zainstalował telefon bezprzewodowy .	bezprzewodowy	6	Masc3
– takie długie włosy ma . .	długie	2	Masc3
Fajny jest Pętal .	Fajny	0	Masc1
Też nie wyglądał na wyspanego .	wyspanego	4	Masc1
Zapada mrok , bierze lekki przymrozek .	lekki	4	Masc3
Okna przysłonięto żałobnym kirem .	żałobnym	2	Masc3
Przeżyła szok , którego nie złagodził nawet środek uspokajający .	uspokajający	8	Masc3
Zrobił się jakby lekko zadarty . . .	zadarty	4	Masc3
Jeżeli człowiek silnie reaguje na różne zjawiska , może być tak odbierany .	odbierany	11	Masc1
Sprawą zainteresował się referat I-szy i przez kontrolę korespondencji może uzyskamy dalsze miejsca zachowanych rzeczy .	I-szy	4	Masc3
Zapraszam do comiesięcznej lektury i do następnego konkursu .	następnego	6	Masc3
W dorożce siedział rozparty chirurg Tamten .	rozparty	3	Masc1
Odnalazł Jaskra , kibicującego łupiącym w gwinta krasnoludom .	kibicującego	3	Masc1
Oryginalne lampy zdobyto z zasobów niemieckich przeznaczonych dla Wehrmachtu .	przeznaczonych	6	Masc3
Dorożki i kabriolety turkotały po wyboistym bruku .	wyboistym	5	Masc3
Zmierzch stał się coraz ciemniejszy , na niebie ukazały się pierwsze gwiazdy .	ciemniejszy	4	Masc3
Przed obecnymi na spotkaniu wystąpili dzisiejsi uczniowie szkoły .	obecnymi	1	Masc1
Lekcja kończy się rozczarowaniem , ale mistrz wydaje się daleki od rezygnacji .	daleki	9	Masc1
Za najważniejszych nazistowskich zbrodniarzy powszechnie uznawano Hitlera , Himmlera i Goebbelsa .	nazistowskich	2	Masc1
31-letnia Karina Hoffman - Birkhead rozwiodła się w ubiegłym roku .	ubiegłym	8	Masc3
Zaniżają lub w ogóle nie wypłacają ekwiwalentów za niewykorzystane urlopy .	niewykorzystane	8	Masc3
Spirytus jest rozlewany do kartoników litrowych , półlitrowych i ćwiartek .	półlitrowych	7	Masc3
Architekci opracowujący rysunki robocze są zazwyczaj wieloletnimi praktykami .	robocze	3	Masc3
Czy kobiety biorą u was udział w ruchu związkowym ?	związkowym	8	Masc3
Kiedyś w Poznaniu spotkał em się z moimi polskimi krewnymi .	polskimi	8	Masc1
Nad wszystkim czuwać będzie trzech lekarzy i personel pielęgniarski .	pielęgniarski	8	Masc3
Był to ostatni ze zgłoszonych mówców .	ostatni	2	Masc1
Na tegorocznym inauguracyjnym balu tradycyjnego karnawału w Rio pracowały równolegle dwie komisje sędziowskie .	tradycyjnego	4	Masc3
- Wojna wzbudziła we mnie ogromny lęk .	ogromny	5	Masc3
W hotelu pozostanie intendent , mały pochylony , skromny człowiek .	pochylony	6	Masc1
Różnymi technikami były również nanoszone poszczególne rysunki .	nanoszone	4	Masc3
W ogólnym rozgardiaszu jedynie Kosiński i Gorczyca zachowywali się spokojnie .	ogólnym	1	Masc3
Jeden Chińczyk został zabity .	zabity	3	Masc1
Policja przypuszcza , że najnowszy ładunek został porzucony przez spłoszonego niedoświadczonego terrorystę .	spłoszonego	9	Masc1
Był by m bardziej autentyczny .	autentyczny	4	Masc1
Na drugi dzień poszukał go .	drugi	1	Masc3
- Ale czy ma on rzeczywisty wymiar ?	rzeczywisty	5	Masc3
Nie widzę chętnych .	chętnych	2	Masc1
Musiał em wyglądać na niezgorszego gwałciciela .	niezgorszego	4	Masc1
Zbiornik został niemal całkowicie zniszczony .	zniszczony	4	Masc3
Szwedzi , biedny naród , nie znają zapachu piekarni , świeżego , prawdziwego chlebka .	świeżego	10	Masc3
Podstawą każdego programu tłumaczącego jest słownik .	tłumaczącego	3	Masc3
– eee czy czujesz się dojrzały ?	dojrzały	5	Masc1
Policjanci z pobliskiego komisariatu przyznają , że docierają do nich sygnały o rozbojach .	pobliskiego	2	Masc3
Wejdą w świat zagubieni .	zagubieni	3	Masc1
- Dokumenty dotyczące wyroku białostockiego sądu jeszcze nie trafiły do ministerstwa .	dotyczące	2	Masc3
- Może nadejdą lepsze czasy i wróci do nas .	lepsze	3	Masc3
Ubrani w białe koszule uczniowie ustawiają się na zbiórce w parku naprzeciwko gimnazjum .	Ubrani	0	Masc1
Zacisnął em palce na szorstkim płótnie i wyczuł em obłe kształty pocisków .	obłe	9	Masc3
Leżał już ubrany w trumnie .	ubrany	2	Masc1
W 1905 roku Karl Braun zbudował detektor kryształkowy .	1905	1	Masc3
Pogłębiły się zmarszczki , sczerniały sińce pod oczami ; był blady i jakby przygarbiony .	blady	10	Masc1
Darowizny przekazane na jej rzecz podlegają odpisowi podatkowemu .	podatkowemu	7	Masc3
Był wzywany do Seneki . . .	wzywany	1	Masc1
Były już trzy kółka ze starszych robotników .	starszych	5	Masc1
Chociaż pamiętał ją , jak w ubiegłym roku jeszcze brała się za kosę .	ubiegłym	6	Masc3
- Przeanalizujmy kilka kluczowych elementów .	kluczowych	3	Masc3
Tam , gdzie byli prześladowani przez muzułmanów , musiał wystarczyć chaczkar .	prześladowani	4	Masc1
Z głośników popłyną rytmy soul i disco .	disco	6	Masc3
Całą sobą obrażać zasady , które wyznaje prosty tutejszy lud .	tutejszy	8	Masc3
Mówmy , że ktoś nieśmiały jest też bardziej wrażliwy , milszy .	wrażliwy	8	Masc1
Były drugi trener lubelskich szczypiornistek nie zdołał poprowadzić jeleniogórzanek do sukcesu .	Były	0	Masc1
Dołączył nawet bezpłatny krążek w tym formacie oraz firmowy , programowy odtwarzacz .	programowy	10	Masc3
Ranny został operator Jerzy Ernst .	Ranny	0	Masc1
Gładki jest bardziej śliski .	śliski	3	Masc3
Angażowały też prywatnych przewoźników .	prywatnych	2	Masc1
Siedział em w ciemnym barakowozie , wpatrując się w niewyraźny zarys półlitrówki .	niewyraźny	9	Masc3
Zbliżył się do nas , wydawał się zakłopotany .	zakłopotany	7	Masc1
W ciszy zapadającego wieczoru głos się roznosił i każde słowo słychać było z daleka .	zapadającego	2	Masc3
Rządowi eksperci z zachodniej Europy ostrzegają przed epidemią grypy .	Rządowi	0	Masc1
- Czy świadomie wybrała pani rzeźbę , przecież to taki niekobiecy zawód ?	niekobiecy	10	Masc3
Stwierdzono , że stosunkowo wysokie zarobki mają pielęgniarki bloku operacyjnego .	operacyjnego	9	Masc3
Nie czuje się premierem przegranym .	przegranym	4	Masc1
Od Annopola idę już trzeci dzień .	trzeci	4	Masc3
W przypadku BIG-u ostatni miesiąc roku obrachunkowego przyniósł wynik poniżej tegorocznej średniej .	obrachunkowego	6	Masc3
Czuł się słaby i nędzny .	słaby	2	Masc1
Rdzenni mieszkańcy wyspy stanowią rozpaczliwą mniejszość .	Rdzenni	0	Masc1
Z pociętego nożem brzucha kobiety sączyła się krew .	pociętego	1	Masc3
Płatki owsiane zalać wodą do napęcznienia .	owsiane	1	Masc3
Na czele stoi król - Ashantehene , otoczony radą starszych .	otoczony	7	Masc1
W ubiegłym roku w czerwcu okna w komunalnym mieszkaniu Salwockich wybijano trzy razy .	ubiegłym	1	Masc3
Prowadzi ich dowódca z obnażonym mieczem .	obnażonym	4	Masc3
W numerze wydanym przez Movex rzuca się w oczy kilkustronicowy wstępniak .	wydanym	2	Masc3
- Niektórzy są bardzo niezadowoleni z tych ograniczeń .	niezadowoleni	4	Masc1
Był wiarygodny .	wiarygodny	1	Masc1
Zaatakowano go bezpośrednim ogniem .	bezpośrednim	2	Masc3
Potem odwiedził kiełpiński cmentarz .	kiełpiński	2	Masc3
Przewrócił się w hotelowym hallu łamiąc żebra .	hotelowym	3	Masc3
Chłopiec przebywa w greckim przytułku prowadzonym przez organizację o złej reputacji .	greckim	3	Masc3
Postawił em samochód na podziemnym parkingu pod hotelem i wszedł em do windy .	podziemnym	4	Masc3
Czeka go powtórny proces .	powtórny	2	Masc3
Westchnienia Ruskina i Prousta trafiają na podatny grunt .	podatny	6	Masc3
Nawet kiedy sami tego żądają .	sami	2	Masc1
W innych spotkaniach towarzyskich uzyskano następujące wyniki .	następujące	5	Masc3
Dopiero w ubiegłym roku mieli pierwsze efekty .	ubiegłym	2	Masc3
Telewizor stoi na małym stoliczku .	małym	3	Masc3
Pan hrabia wie , że jesteśmy niewinni .	niewinni	6	Masc1
Chaos bezdźwięczny pokrył wreszcie harmonię .	bezdźwięczny	1	Masc3
Nowi ustne rozpoczęli od geografii .	Nowi	0	Masc1
Inni milczeli .	Inni	0	Masc1
Ptaki te chętnie korzystają z pokarmu wykładanego dla parkowych łabędzi .	wykładanego	6	Masc3
Przy bardzo silnych wiatrach zawodnicy zakładają na płozy specjalne obciążenia .	silnych	2	Masc3
Jest legendarnym przywódcą związkowym .	związkowym	3	Masc1
I te bilety uśmierzyły wzburzone umysły golibrody i wynalazcy .	wzburzone	4	Masc3
Następnym razem przyprowadzą kolegów i pomalutku piękny sport narciarski zainteresuje bardziej młodzież naszego miasta .	narciarski	8	Masc3
Dorota ma żółtą skórę i ostre łokcie .	ostre	5	Masc3
Mądrzej było by ominąć go szerokim łukiem .	szerokim	5	Masc3
Były napisane tak , jakby świadomość społeczna w ogóle nie istniała .	napisane	1	Masc3
Kadencja rady potrwa do 2007 r.	2007	4	Masc3
Sześć cebul kupiła na kiermaszu zorganizowanym w pobliskiej szkole .	zorganizowanym	5	Masc3
Bał się samego siebie .	samego	2	Masc1
Trzeci zapatrzy się gdzieś w przestrzeń .	Trzeci	0	Masc1
I innych dzieciatych też nie uwielbiam .	dzieciatych	2	Masc1
Na sali gimnastycznej panował przenikliwy ziąb .	przenikliwy	4	Masc3
- W spadku po odchodzącej ekipie nowy rząd otrzymuje olbrzymi deficyt w bilansie handlowym .	olbrzymi	9	Masc3
- Stefan z uznaniem przygląda się jej nowemu mundurkowi .	nowemu	7	Masc3
Po południu kościelna procesja wyrusza w drogę po bajecznie kolorowym kwietnym dywanie .	kolorowym	9	Masc3
Niezwyciężony lęk przed dziwem w każdym momencie serca przychodniów przeszywał .	Niezwyciężony	0	Masc3
Przygotowano też rozmaite zestawy upominkowe w estetycznych opakowaniach .	rozmaite	2	Masc3
- Witam mojego kochanego autora !	kochanego	3	Masc1
W 1935 roku brytyjski informatyk Alan Mathison Turing wymyślił abstrakcyjną maszynę .	brytyjski	3	Masc1
Dla trzeźwego jest to tylko bełkot .	trzeźwego	1	Masc1
Każdy upływający dzień przejmował go strachem .	upływający	1	Masc3
Rok bieżący był dla nich niezwykle pracowity .	bieżący	1	Masc3
stówę się dawało i był pełny zbiornik .	pełny	5	Masc3
Też dotyczył duchownego , choć był dużo mocniejszy i tam ofiara była całkowicie niewinna .	mocniejszy	7	Masc3
W poważnym stopniu przyczynił się do wysokich wyników wydziału .	wysokich	6	Masc3
Cała opera huczy od sprzecznych komentarzy .	sprzecznych	4	Masc3
Co to wszystko obchodzi polskich klientów firm ubezpieczeniowych ?	polskich	4	Masc1
Tylko w minioną sobotę w atakach terrorystycznych w Bagdadzie zginęło ponad 40 osób .	terrorystycznych	6	Masc3
Rozdają publiczne pieniądze na rzecz Kościoła katolickiego , modlą się żarliwie przed kamerami , marzą o cenzurze obyczajowej .	katolickiego	6	Masc3
Zbieranie dzieł twórców nieprofesjonalnych zapewnia światowy prestiż i międzynarodowe przyjaźnie .	nieprofesjonalnych	3	Masc1
Ale później , w latach sześćdziesiątych , wywiązała się intensywna publiczna debata na temat stosunków polsko - niemieckich . . .	sześćdziesiątych	5	Masc3
Świadek zeznawał by w procesach pozostałych członków gangu .	pozostałych	5	Masc1
Dwa duże statki zostały zatopione przez powstańców .	zatopione	4	Masc3
Na kontynencie afrykańskim dominują ssaki .	afrykańskim	2	Masc3
Ale po pierwsze czuł się głęboko skompromitowany , a po drugie wydawało się wątpliwe , żeby mógł jeszcze coś w tamtym środowisku osiągnąć .	skompromitowany	6	Masc1
W lesie zające występują raczej na pobrzeżach , w głąb idą tylko w silne mrozy .	silne	13	Masc3
Najstarszy prawnuk ma 21 lat ; gdyby założył rodzinę , jubilaci zostali by prapradziadkami .	Najstarszy	0	Masc1
Chodzę w czarnych okularach nawet w pochmurne dni .	pochmurne	6	Masc3
Nie mogę powiedzieć , że byli uprzejmi , ale nie byli niegrzeczni .	uprzejmi	6	Masc1
Niedługo kasa popłynie jeszcze większym strumieniem .	większym	4	Masc3
IZABELLE ADJANl , gwiazda filmu francuskiego , wygrała precedensowy proces .	francuskiego	5	Masc3
Bądź wdzięczny , okazuj wdzięczność wszystkiemu , co żyje .	wdzięczny	1	Masc1
Ja nie uważam się za nieomylnego .	nieomylnego	5	Masc1
Tymczasem komandor zatrzaśnięty w samochodzie wydzwaniał z telefonu komórkowego do znajomych .	komórkowego	8	Masc3
Magister podreptał ukosem przez podwórzec , nikły , żałosny w swej czarnej sukni .	nikły	6	Masc1
Ale zapytany , dlaczego lubi szachy , znudzony zsuwa się z kanapy .	zapytany	1	Masc1
Pozostali pacjenci przebywają na oddziale ginekologicznym , wewnętrznym i kardiologicznym .	Pozostali	0	Masc1
Ale umiarkowani zmądrzeli .	umiarkowani	1	Masc1
Pan musi być nieszczęśliwy .	nieszczęśliwy	3	Masc1
– a dużo osób ma odrobiony piątek . .	odrobiony	5	Masc3
Posiada ok. 150 ciekawych i zróżnicowanych egzemplarzy .	ciekawych	3	Masc3
Omawiali sprawę przez dłuższy czas .	dłuższy	3	Masc3
Tak pesymistyczni Francuzi byli w kwietniu , a przedtem aż przed czterema laty .	pesymistyczni	1	Masc1
Wciąż drożeją zboża , głównie żyto , a ceny pszenicy ustabilizowały się na wysokim poziomie .	wysokim	13	Masc3
- Nie trza , damy se sami radę !	sami	6	Masc1
Usta głowy drgnęły , po czym popłynął z nich chrapliwy głos .	chrapliwy	9	Masc3
Świat nie jest na nią przygotowany psychicznie .	przygotowany	5	Masc3
Musiał by być politycznie wyrazisty .	wyrazisty	4	Masc1
Na terenie przyległym do Kolonii Wierzbicy znajdują się dwie garbarnie .	przyległym	2	Masc3
Gwyneth przyznaje , że przez tych ostatnich kilka lat dojrzewała na zdwojonych obrotach .	ostatnich	6	Masc3
Sprawa została pomyślnie rozstrzygnięta dopiero w ostatnim czasie .	ostatnim	6	Masc3
Przebiegające pod miastem chodniki kopalni zalano wodą , a wzgórze zgniło i zapadło się w ziemię jak przydeptane .	Przebiegające	0	Masc3
Ty przecież też zasnął eś , oglądając w telewizji mecze polskich orłów .	polskich	10	Masc1
Mimo że na koncie ma już osiem wyroków , nadal okrada turystów odwiedzających Kraków .	odwiedzających	12	Masc1
Bawi mnie to w jakiś ponury sposób .	ponury	5	Masc3
43-letni młodszy brygadier dmuchnął w alkomat .	młodszy	1	Masc1
Angażują się w niezwykłym stopniu .	niezwykłym	3	Masc3
- To nie jest program drugorzędny .	drugorzędny	5	Masc3
Może to falsyfikat namalowany specjalnie pod prasowe ogłoszenie ?	namalowany	3	Masc3
Wiatry słabe z kierunków zmiennych .	słabe	1	Masc3
Marta nie potrafiła odpowiedzieć na pytania córki , gdyż sama do dnia dzisiejszego nie znała odpowiedzi .	dzisiejszego	12	Masc3
U małych pacjentów lekarze stwierdzali najczęściej anginę i nieżyt górnych dróg oddechowych .	małych	1	Masc1
Do 1995 roku francuscy przedsiębiorcy mogli legalnie dotować partie polityczne .	1995	1	Masc3
Pozostali pacjenci przebywają na oddziale ginekologicznym , wewnętrznym i kardiologicznym .	kardiologicznym	9	Masc3
A kiedy tak się stało , powstał problem ze zdobyciem odpowiednich dowodów .	odpowiednich	10	Masc3
W Wiśle pod koniec lat 70 . grał krótko czarnoskóry Anthony Freeman .	czarnoskóry	9	Masc1
Ceną za to opóźnienie okazał się udział w rynku francuskim .	francuskim	9	Masc3
Jak zwykle pedantyczny Andrzej misternie układał fryzurę .	pedantyczny	2	Masc1
Nie wyobrażam sobie wprowadzania w życie indywidualnych planów .	indywidualnych	6	Masc3
- Każdy z liderów partyjnych musi rozliczać się wobec swojego zaplecza politycznego .	partyjnych	4	Masc1
Zasięg prac był dokładnie określony .	określony	4	Masc3
Lech Kaczyński nie żałuje , że jego filmowa kariera się nie rozwinęła , a do swojego aktorskiego talentu podchodzi z rezerwą .	aktorskiego	16	Masc3
Zakładamy , że pomiędzy archiwizacją pełną będziemy przeprowadzać cztery backupy przyrostowe .	przyrostowe	10	Masc3
Haszkowy Szwejk lepiej się prezentował .	Haszkowy	0	Masc1
Nie kryją się z tym , chcą być widziani , rozpoznani ?	rozpoznani	10	Masc1
Na pewno nie miało to żadnego dalszego ciągu .	dalszego	6	Masc3
Proszowiccy strażacy wyjeżdżali w ostatnim czasie do dwóch pożarów , spowodowanych prawdopodobnie przez podpalaczy .	spowodowanych	10	Masc3
Uległ wzruszeniu stary pedagog i zajął się wdowim synem z całą życzliwością .	wdowim	7	Masc1
Jest samodzielny , codziennie dojeżdża na zajęcia 12 km z Koszalina .	samodzielny	1	Masc1
Proszowiccy strażacy wyjeżdżali w ostatnim czasie do dwóch pożarów , spowodowanych prawdopodobnie przez podpalaczy .	Proszowiccy	0	Masc1
Uhonorowani zostali także inni muzycy .	Uhonorowani	0	Masc1
Sławny pianista utracił dłonie w wypadku , ale przeszczepiono mu ręce straconego mordercy .	straconego	11	Masc1
Nieznani sprawcy w nocy z wtorku na środę zbezcześcili cmentarz w Akwizgranie .	Nieznani	0	Masc1
Tymczasem ten istniejący był gruntownie remontowany kilka lat temu .	remontowany	5	Masc3
Uczniowie są tym przedsięwzięciem bardzo zainteresowani .	zainteresowani	5	Masc1
Wypowiadamy je w różnych sytuacjach i z różnych powodów .	różnych	7	Masc3
Żołnierze okopali się tam i celnymi strzałami odpierali atakujących .	atakujących	8	Masc1
W aptekach prawdziwe oblężenie zapanowało jeszcze w ostatnich dniach starego roku .	ostatnich	7	Masc3
- Zgromadzili śmy tu najstarsze i najładniejsze kostiumy .	najstarsze	4	Masc3
Wściekłość pokrył pobłażliwym uśmiechem .	pobłażliwym	2	Masc3
Czy sędziowie w programie są stronniczy ?	stronniczy	5	Masc1
- Na stole rozłożył odbitki kserograficzne stron Rocznika Statystycznego .	Statystycznego	8	Masc3
Obwieszony policyjnymi kamerami i mikrofonami spotkał się z nią w jadłodajni w centrum Kielc .	Obwieszony	0	Masc1
Poszkodowany do dnia dzisiejszego nie otrzymał zakupionego telefonu .	zakupionego	6	Masc3
Rannymi cywilami zaopiekowali się najpierw amerykańscy sanitariusze z personelu naziemnego .	Rannymi	0	Masc1
W Laskach w liturgii uczestniczyło się przez cały dzień i modliło się wszędzie .	cały	7	Masc3
Ma , bo poszczególne akty mogą być lepsze lub gorsze .	lepsze	7	Masc3
Żeby skutecznie leczyć żywych , trzeba się uczyć na martwych .	żywych	3	Masc1
- Brak nam jeszcze wielu umów z gospodarzami indywidualnymi . . .	indywidualnymi	8	Masc1
Biedny Drossos , sami analfabeci głosowali na niego …	Biedny	0	Masc1
Do sześciu głodujących w Poznaniu dołączyło w piątek trzech związkowców ze Śremu .	głodujących	2	Masc1
Dzicy plakaciarze zaśmiecający miasto są bezkarni .	Dzicy	0	Masc1
Mężczyźni byli pijani i zaraz po wypadku zwyczajnie zasnęli .	pijani	2	Masc1
Nieuchronne podziały pogłębił niski poziom politycznych dyskusji .	niski	3	Masc3
- Dlatego nie mogł em rozmawiać z interesującymi mnie bokserami .	interesującymi	7	Masc1
Ujawnił się jej pragmatyzm kobiecy ?	kobiecy	4	Masc3
Opchał em się na całą pojemność skurczonego żołądka .	skurczonego	6	Masc3
Z tych najgorsi byli ci od Kota .	najgorsi	2	Masc1
Auto z czterema młodymi mężczyznami wpadło do Wisły .	młodymi	3	Masc1
Zapytany przez nas radiotelegrafista zdradził treść oddanej depeszy .	Zapytany	0	Masc1
Rozmawiają o tamilskich i hinduskich filmach .	hinduskich	4	Masc3
Potem roztworem chemicznym starannie spryskano bezcenne posągi i stare mozaiki .	chemicznym	2	Masc3
Zebrali śmy się u Nocnego Śpiewaka .	Nocnego	4	Masc1
Mamy wysokie standardy .	wysokie	1	Masc3
Adres niech dobrodziej spisze z dowodu osobistego .	osobistego	6	Masc3
I są dobrymi gospodarzami .	dobrymi	2	Masc1
Normalny bilet sieciowy kosztuje w tym mieście 30 złotych .	sieciowy	2	Masc3
Po badaniach w szpitalu został wypuszczony do domu .	wypuszczony	5	Masc1
W uroczystości uczestniczyli wierni w kolorowych łowickich wełniakach .	łowickich	6	Masc3
gdyby ście byli słowni .	słowni	3	Masc1
Wiatry słabe z kierunków zmiennych .	zmiennych	4	Masc3
czy czynnik czasowy jest znaczący ?	czasowy	2	Masc3
Miała za sobą ciężki dzień .	ciężki	3	Masc3
Od XVIII w. Serbowie już nie byli tam absolutną większością .	XVIII	1	Masc3
Świeżo upieczony hejnalista ma już swoją trąbkę .	upieczony	1	Masc1
Architekci opracowujący rysunki robocze są zazwyczaj wieloletnimi praktykami .	opracowujący	1	Masc1
Potem zostaną ulokowani w hotelach i ośrodkach wypoczynkowych .	ulokowani	2	Masc1
Cały prawy błotnik wraz ze światłami został na haku .	prawy	1	Masc3
W XVII wieku hikyaku , czyli kurierzy , doręczali przesyłki feudalnym władcom .	XVII	1	Masc3
To będzie najpewniejszy dowód .	najpewniejszy	2	Masc3
Do przechodzącego ulicą 28-letniego mieszkańca Ostrowca Świętokrzyskiego oddał dwa strzały .	przechodzącego	1	Masc1
Można mówić o politycznym fenomenie .	politycznym	3	Masc3
Księżyc wznosi się , tak pełny , jakby miał się przelać .	pełny	5	Masc3
Szewardnadze stwierdził w poniedziałek , że dogadał się z kaukaskimi przywódcami .	kaukaskimi	9	Masc1
Inni też obiecywali .	Inni	0	Masc1
Chwilę manipulował przełącznikami i nagle w głośniku odezwał się wysoki , dźwięczny ton .	dźwięczny	11	Masc3
Pod stołem bawił się granatem mały chłopiec , nazywany Osęką .	nazywany	8	Masc1
Robię się czerwony i zeskakuję z okna .	czerwony	2	Masc1
Skomplikowany zabieg przeprowadzono w jednej z klinik w Szanghaju .	Skomplikowany	0	Masc3
Nieuchronne podziały pogłębił niski poziom politycznych dyskusji .	Nieuchronne	0	Masc3
Tak działa ich instynkt samozachowawczy .	samozachowawczy	4	Masc3
- Szósty rok prowadzę kadrę .	Szósty	1	Masc3
Późny , głęboki zmierzch na przedmieściu , przez które biegnie do apteki żona umierającego .	głęboki	2	Masc3
Ale to był węgiel , brunatny węgiel .	brunatny	5	Masc3
Wolała puszczać w kinach filmy kung-fu licząc , że dzięki temu ludzie przestaną myśleć o polityce .	kung-fu	5	Masc3
Pierwszym zapisanym mówcą jest senator Zbigniew Kulak .	zapisanym	1	Masc1
Zaczęło się od tego , że kupili śmy koledze na urodziny tarczę i sami zaczęli śmy grać .	sami	13	Masc1
Ja wszelako nie piszę w imieniu przegranych polityków .	przegranych	6	Masc1
To był naprawdę rockowy boom .	rockowy	3	Masc3
Uwodzić zapładniającego skutecznie mężczyznę .	zapładniającego	1	Masc1
Nad ranem z soboty na niedzielę z pędzącego pociągu wyskoczyła 17-letnia dziewczyna .	pędzącego	7	Masc3
Obaj 23-letni starogardzianie trafili do policyjnego aresztu .	23-letni	1	Masc1
- Nadszedł główny księgowy .	główny	2	Masc1
Stwierdzono , że stosunkowo wysokie zarobki mają pielęgniarki bloku operacyjnego .	wysokie	4	Masc3
Sąsiadka opiekuje się mocno starszym panem .	starszym	4	Masc1
Został potraktowany łagodnie .	potraktowany	1	Masc1
Pięcioletnia dziewczynka , porwana wczoraj przez 65-letniego mężczyznę w Chorzowie na Śląsku , odzyskała wieczorem przytomność .	65-letniego	6	Masc1
Kolega Jamrozik został zaproszony na pogrzeb .	zaproszony	3	Masc1
Po spotkaniu w magistracie faktycznie ją wynajął za własne pieniądze .	własne	8	Masc3
Dobry Allach uratował honor naszego państwa !	Dobry	0	Masc1
- Zapłacił pani za cały miesiąc ?	cały	4	Masc3
Za co tak Semaka nie lubią partyjni towarzysze ?	partyjni	6	Masc1
Przy końcu alei stał świeżo wkopany słup , pomalowany na jasnoniebieski kolor .	pomalowany	8	Masc3
Zostały one przetransportowane helikopterami .	przetransportowane	2	Masc3
Współpracownicy uważają go za artystę niezwykle wrażliwego na krytykę .	wrażliwego	6	Masc1
Dlaczego chrześcijanie mają być popierani przez państwo ?	popierani	4	Masc1
W załzawionym świecie jeden diabeł posiadał kontury ostre i wyraźne .	załzawionym	1	Masc3
Zdaje się , że wpatrywała się we mnie od dłuższego czasu .	dłuższego	9	Masc3
- Popełnili by śmy ciężki grzech twierdząc , że te obrazy nas nie interesują .	ciężki	4	Masc3
Gdy goście opuścili jego dom i pozostał jedynie 63-letni emeryt , doszło między nimi do sprzeczki .	63-letni	8	Masc1
Dodany został nowy § 3 .	nowy	2	Masc3
Mężczyzna z sumiastymi wąsami nazwany kawalerem wyraźnie się speszył .	nazwany	4	Masc1
– Ale mecz przesunęli ście na następny dzień . . .	następny	6	Masc3
- Nie możemy mówić o czarnym scenariuszu .	czarnym	5	Masc3
Ja stoję w bruździe i w uniesionej ręce trzymam zapalony fanarek .	zapalony	9	Masc3
Nie uważał siebie nigdy za lepszego od obu tych kolegów .	lepszego	5	Masc1
W innych przypadkach będą całkowicie bezużyteczne .	innych	1	Masc3
Po długo obowiązującym zakazie , znowu do Japonii przybyli katoliccy misjonarze .	katoliccy	9	Masc1
Teraz nie mam nikogo innego na jego miejsce .	innego	4	Masc1
Wszystko było przysypane żółtoszarym pyłem .	żółtoszarym	3	Masc3
Robotnik spadł na leżący pod drabiną gruz .	leżący	3	Masc3
- To stary , rozpadający się budynek .	stary	2	Masc3
Na wyróżnienie trenera zasłużył także Mathias Sammer , który pełnił funkcję motoru napędowego reprezentacji .	napędowego	12	Masc3
Czuł em jego mięśnie napięte pod skórą , twarde jak drewno .	twarde	8	Masc3
Twardzi są ci starzy .	starzy	3	Masc1
Szedł w pełnym słońcu , skronie przygniatał piekący ciężar .	piekący	7	Masc3
Trudne warunki pozwolą co najwyżej wymyśleć cieplejszy korzuch .	cieplejszy	6	Masc3
Podczas nabożeństwa poświęcony został świeżo ufundowany sztandar szkoły .	poświęcony	2	Masc3
Przekonywał o tym wojewoda pomorski Roman Zaborowski w Kwidzynie .	pomorski	4	Masc1
Nie czuję się przekonany .	przekonany	3	Masc1
Żeby skutecznie leczyć żywych , trzeba się uczyć na martwych .	martwych	9	Masc1
Ten Murzyn to sekretarz generalny ONZ , Kofi Annan .	generalny	4	Masc1
Wilk patrzył zafascynowany .	zafascynowany	2	Masc1
- Ma pani rację , jestem rzeczywiście bardzo skrupulatny .	skrupulatny	8	Masc1
Faceci są dyskryminowani !	dyskryminowani	2	Masc1
Młodzi zostali sami .	sami	2	Masc1
- Jesteśmy krajem katolickim !	katolickim	3	Masc3
Na zegarze kościelnym wybiła północ .	kościelnym	2	Masc3
Może sanepid na ich terenie był bardziej zdyscyplinowany .	zdyscyplinowany	7	Masc3
Trzymający ją mężczyzna roześmiał się .	Trzymający	0	Masc1
Zatrzymali podejrzanego człowieka w niekompletnym stroju .	niekompletnym	4	Masc3
Wycina się je tam dla celów rolniczych i hodowlanych A NIE PAPIERNICZYCH !	rolniczych	6	Masc3
Resa pośpieszyła do Ab-Rama , czekającego niecierpliwie w swoim namiocie .	czekającego	5	Masc1
Udało się niestety uratować tylko Marię Fryc , zaś dwudziestotrzyletni jej mąż utonął .	dwudziestotrzyletni	9	Masc1
Polska i Izrael podpisały wczoraj umowę o zniesieniu obowiązku wizowego .	wizowego	9	Masc3
Był by to trzeci z rzędu rok , kiedy Francja nie sprostała wymaganiom UE .	trzeci	3	Masc3
Spadł deszcz wiosenny .	wiosenny	2	Masc3
Inni nie wytrzymywali i popełniali samobójstwo .	Inni	0	Masc1
Związek taki łączą nie tylko wspólni praprzodkowie .	wspólni	5	Masc1
Każdy z zespołów otrzymał również pamiątkowy dyplom oraz nagrody .	pamiątkowy	5	Masc3
Na krześle siedzi smutny , zrezygnowany człowiek .	zrezygnowany	5	Masc1
Czy malował je kiedyś dla sprawdzenia samego siebie ?	samego	6	Masc1
Przedostatni figuruje Artur Balazs , poseł i minister rolnictwa , a zamyka ją Stefan Oleszczuk z UPR-u , starosta kamieński .	kamieński	19	Masc1
Różnymi technikami były również nanoszone poszczególne rysunki .	poszczególne	5	Masc3
A Rychtarski i Ziemiak uzyskali rezultaty lepsze niż trzeci senior .	trzeci	8	Masc1
Byli następni w kolejce .	następni	1	Masc1
Odzyskano ukradzione przedmioty .	ukradzione	1	Masc3
Polacy jadący w autokarze spoglądają z nietajoną dumą na wielkiego rodaka .	wielkiego	9	Masc1
Pan zanotuje sobie prywatny numer posła . . .	prywatny	3	Masc3
Od 1964 do Poznania docierają pociągi elektryczne z Warszawy .	1964	1	Masc3
Na szybko pokonywanych zakrętach pojazd wykazuje delikatną nadsterowność .	pokonywanych	2	Masc3
Truchtali spokojnie , bez pośpiechu , z przodu dostrzegli sylwetkę w zielonym mundurze , zbliżyli się powoli .	zielonym	11	Masc3
Zażerała się orzechami w czekoladzie i kasztanami mrożonymi , oblizując swoim obyczajem czubki palców .	mrożonymi	7	Masc3
Dość powiedzieć , że włoscy copywriterzy należą do najlepszych na świecie .	włoscy	4	Masc1
Może być attache kulturalny na Hawajach .	kulturalny	3	Masc1
Wyróżniały się głosy dyrektora Suchanka , byłego wojewody oraz lekarza dyżurnego .	byłego	6	Masc1
Szwedzi , biedny naród , nie znają zapachu piekarni , świeżego , prawdziwego chlebka .	prawdziwego	12	Masc3
Przygotowane składniki wymieszać z serkiem i przyprawami .	Przygotowane	0	Masc3
Wszyscy byli trzeźwi .	trzeźwi	2	Masc1
to jest bardzo ciekawy składnik .	ciekawy	3	Masc3
Dante miał wzrok utkwiony w jego usta .	utkwiony	3	Masc3
I czy muszą być potwierdzone korpusowo ?	potwierdzone	4	Masc3
To jest ciągły proces .	ciągły	2	Masc3
Czykier został ukarany za niesportowy tryb życia , zaś Gierejkiewicz stracił zaufanie szkoleniowca .	ukarany	2	Masc1
Nie sądzę , żeby Aleksandra Jakubowska była jakimś głównym problemem .	głównym	8	Masc3
Też były szorstkie .	szorstkie	2	Masc3
W samolocie myślała m o tych dniach spędzonych z Kowerskim .	spędzonych	7	Masc3
Program muzyczny prowadzi Kamil Durczok .	muzyczny	1	Masc3
Obaj byli wysocy , zwaliści , misiowato potężni .	wysocy	2	Masc1
Usłużnym kierowcą okazał się 34-letni Rob Gatena .	34-letni	4	Masc1
Mówić on będzie dzisiaj o sytuacji religijnej i nowych ruchach w Europie .	nowych	8	Masc3
Wtajemniczeni hipnotyzerzy nie przekazują zresztą swej wiedzy niepewnym osobom .	Wtajemniczeni	0	Masc1
Dzicy plakaciarze zaśmiecający miasto są bezkarni .	bezkarni	5	Masc1
Dzięki filmowi album sprzedał się w milionowym nakładzie w Ameryce i w Niemczech , miał szanse na złoto także w Polsce .	milionowym	6	Masc3
Każdy z nich trzymał w ręku długi , płaski klucz .	długi	6	Masc3
Projekt był omawiany dwukrotnie .	omawiany	2	Masc3
Mam wieeeeeeelki problem .	wieeeeeeelki	1	Masc3
Mężczyzna był cały i zdrowy .	cały	2	Masc1
Ogarnięci paniką mieszkańcy porzucili swe mieszkania wybiegając na ulicę .	Ogarnięci	0	Masc1
Zeznał on , iż został pobity przez nieznanego osobnika .	nieznanego	7	Masc1
W półfinałach rozegrano mecze systemem pucharowym , a zwycięzcy awansowali do finałów .	pucharowym	5	Masc3
Transportowany do szpitala zakopiańskiego zmarł w drodze .	Transportowany	0	Masc1
Megane oddał synowi , pracownikowi dydaktycznemu warszawskiej uczelni .	dydaktycznemu	5	Masc1
To pleban kawęczyński jechał dwukonnym wózkiem do miasta .	dwukonnym	4	Masc3
Masz im dać najlepsze dwa pokoje .	najlepsze	3	Masc3
Zresztą nazwa ta nigdy nie funkcjonowała na terenach górskich .	górskich	8	Masc3
To były z filcu utoczone dzwony .	utoczone	4	Masc3
Trudno też spotkać krajalnice do serów twardych .	twardych	6	Masc3
Zawsze chciał stałego związku .	stałego	2	Masc3
Obiecali mu , że wygra kolejny przetarg .	kolejny	5	Masc3
Ściany skalne zbliżają się w tym miejscu i dalsza droga prowadzi w ciasnym wąwozie .	ciasnym	12	Masc3
Usiedli śmy , zamówili śmy do picia napoje chłodzące .	chłodzące	8	Masc3
Taboret upadł z dramatycznym łoskotem , a on , wierzgając nogami , zawisł niczym gotowy do wypatroszenia wieprz .	dramatycznym	3	Masc3
Chcemy , by byli wybierani przez radnych .	wybierani	4	Masc1
Piękno w przyrodzie wydaje się ewolucyjnym luksusem .	ewolucyjnym	5	Masc3
Wyszedł em od nich pod wieczór zupełnie wybity z czasu i z epoki .	wybity	7	Masc1
Obu szwedzkim dyplomatom zarzucono też działalność wykraczającą poza ich oficjalny status .	oficjalny	9	Masc3
- Żeby być przyjętym na Uniwersytet w Cambridge , trzeba mieć 45 punktów .	przyjętym	3	Masc1
My , spadochroniarze , jesteśmy twardymi ludźmi .	twardymi	5	Masc1
- Kapitan zniknął w mrocznym korytarzu .	mrocznym	4	Masc3
Lekarze walczą usilnie o uratowanie życia ciężko rannym .	rannym	7	Masc1
Na parę minut przedtem Roman przyszedł do bufetu z pustym koszykiem do bułek .	pustym	9	Masc3
A tu osobisty kontakt mógł zaważyć . . .	osobisty	2	Masc3
Grupa powstała we wczesnych latach 80 .	wczesnych	3	Masc3
- Na tym wyczerpali śmy listę posłów zapisanych do zabrania głosu .	zapisanych	7	Masc1
Tracę wolny czas .	wolny	1	Masc3
Przeciętny Polak musiał by na nią pracować sto lat .	Przeciętny	0	Masc1
Zatrzymali podejrzanego człowieka w niekompletnym stroju .	podejrzanego	1	Masc1
Tekst ten jest zniszczony i w wielu miejscach nieczytelny .	zniszczony	3	Masc3
Cofnął się jak oparzony , gdy fala obmyła mu łapy .	oparzony	3	Masc1
Leżeli później zlani potem .	zlani	2	Masc1
Rozmawiali odwróceni plecami .	odwróceni	1	Masc1
Wszystko rozegra się w zaciszu ministerialnych gabinetów .	ministerialnych	5	Masc3
Ale mogą służyć do celów rekreacyjnych .	rekreacyjnych	5	Masc3
Nie ukrywam , że mój kalendarz jest raczej zapełniony .	zapełniony	8	Masc3
Nowy dzierżawca wykonał niezbędne remonty i odnowienia .	niezbędne	3	Masc3
Co się roi w twoim szalonym ruskim łbie ?	ruskim	6	Masc3
Na atramentowej powierzchni wody chybotał się samotny biały żagiel .	samotny	6	Masc3
Budynek ma być niebawem remontowany , dlatego lokatorzy go opuścili .	remontowany	4	Masc3
Idę na przystanek autobusowy .	autobusowy	3	Masc3
I to jest największa bariera dla cyfrowego domu .	cyfrowego	6	Masc3
Serwal to rzadko spotykany w polskich ogrodach drapieżnik z rodziny kotów .	polskich	5	Masc3
Matka - niematka wzięła urlop macierzyński .	macierzyński	5	Masc3
Suchy polder jest łatwiejszy i bezpieczniejszy w eksploatacji .	bezpieczniejszy	5	Masc3
Zatrzymany jest przesłuchiwany .	przesłuchiwany	2	Masc1
Proszowiccy strażacy wyjeżdżali w ostatnim czasie do dwóch pożarów , spowodowanych prawdopodobnie przez podpalaczy .	ostatnim	4	Masc3
Numer drugi mrugał zachęcająco .	drugi	1	Masc3
Halina i ja byli śmy zdecydowani .	zdecydowani	5	Masc1
Miał 43 lata , żonaty , dwóch synów .	żonaty	4	Masc1
Wędrował po Tatrach od 1914 r. , wspinał się od 1924 .	1924	10	Masc3
Czy potrafię być silniejszy od jej rozpaczy i gniewu ?	silniejszy	3	Masc1
Jeżeli jednak coś wylicytowali śmy , czeka nas rozliczenie się z domem aukcyjnym .	aukcyjnym	12	Masc3
W tym miejscu skarpa załamywała się pod kątem prostym .	prostym	8	Masc3
Godzinami , chmurni , łazili po mieście , ciągała go po galeriach , muzeach , teatrach .	chmurni	2	Masc1
A ogrzewania wyłączyć nie możemy , bo to zaszkodzi świeżo zakonserwowanym freskom w obu synagogach .	zakonserwowanym	10	Masc3
Afgańczycy nie uznawali ani wiecznych wrogów , ani wiecznych przyjaciół .	wiecznych	4	Masc1
Jeszcze w 1576 , jak wspominają akta wizytacyjne , mieszkali tu wolni Prusowie .	wolni	11	Masc1
to jest robione dłuższym obiektywem . .	dłuższym	3	Masc3
Po parku z miniaturowym ogrodem zoologicznym snują się gromadnie dzieci .	miniaturowym	3	Masc3
Meseńczycy , odwieczni wrogowie Sparty , zgodzili się przepuścić ich przez swoje terytorium .	odwieczni	2	Masc1
Uderzył w biurokratyzm partyjny .	partyjny	3	Masc3
W związku małżeńskim trwają do dziś .	małżeńskim	2	Masc3
Mam dwustronicowy artukuł , z którego muszę napisać recenzję .	dwustronicowy	1	Masc3
Karykaturzysta Gulbransson miał małżonkę tak małomówną , że milczała całymi miesiącami .	całymi	9	Masc3
Jak tchórzliwy jest Manifest Połaniecki Kościuszki !	tchórzliwy	1	Masc3
Białe policyjne motocykle są doskonale oznakowane .	Białe	0	Masc3
Wierni poczuli się zawiedzieni .	zawiedzieni	3	Masc1
Spytała m o niego mężczyznę siedzącego obok .	siedzącego	5	Masc1
W XVII wieku hikyaku , czyli kurierzy , doręczali przesyłki feudalnym władcom .	feudalnym	10	Masc1
Jest to jeden ciągnący się taras kwietny .	kwietny	6	Masc3
Potem rozległy się jeszcze inne równie przerażające odgłosy .	przerażające	6	Masc3
Kielich stał się obmierzły dla wargi .	obmierzły	3	Masc3
Do tego dochodzą rachunki za telefon , wydatki na materiały piśmienne , na znaczki .	piśmienne	10	Masc3
Nie potrafili śmy zdobyć sobie praw w inny sposób .	inny	7	Masc3
Jeden z mężczyzn przystąpił do majstrowania przy kablach telefonicznych .	telefonicznych	8	Masc3
Aktualnie nieczynny teleporter zostanie adaptowany na kolejny sklep spożywczy .	kolejny	6	Masc3
Zdjąć te cholerne obrazki po właścicielu .	cholerne	2	Masc3
Dostał oklaski od zebranych , ale odpowiedzi oficjalnej nie otrzymał .	zebranych	3	Masc1
Są to rurki szklane cylindryczne o zwężonym końcu .	zwężonym	6	Masc3
Dziewczynka jest w coraz gorszym stanie .	gorszym	4	Masc3
Był ledwo żywy ze strachu .	żywy	2	Masc1
Wiele domów w sąsiedztwie Nikitycza stało już pustych .	pustych	7	Masc3
- Na płycie gra wielu znakomitych muzyków . . .	znakomitych	5	Masc1
Wikipedia , nasz siostrzany projekt , zawiera artykuł na temat nawozów zielonych .	zielonych	11	Masc3
Spała , Wałcz czy Cetniewo są od dawna ośrodkami na najwyższym europejskim poziomie .	europejskim	11	Masc3
Nie zatamujesz krwi fałszywym bandażem .	fałszywym	3	Masc3
Świeczka na stole migotała nikłym płomykiem .	nikłym	4	Masc3
Tam czekał już pluton egzekucyjny , dowodzony przez podoficera .	egzekucyjny	4	Masc3
Okazał się pan Wielkim Człowiekiem w tym szambie .	Wielkim	3	Masc1
20-letni żołnierz z jednej z kołobrzeskich jednostek wojskowych zastrzelił się na warcie w nocy z soboty na niedzielę .	20-letni	0	Masc1
Według dokumentów celnych miał przewozić wyroby czekoladowe .	celnych	2	Masc3
Czuł się wypoczęty .	wypoczęty	2	Masc1
Przyleciał rejsowym samolotem .	rejsowym	1	Masc3
Konkurs składał się z etapu ustnego i pisemnego .	pisemnego	7	Masc3
Smarkaci mężczyźni gonią tylko za ładną buzią i modną sukienką .	Smarkaci	0	Masc1
Wymaga to zainstalowania odpowiednich zbiorników .	odpowiednich	3	Masc3
Na tegorocznym inauguracyjnym balu tradycyjnego karnawału w Rio pracowały równolegle dwie komisje sędziowskie .	inauguracyjnym	2	Masc3
Doniesienie o możliwych nieprawidłowościach wpłynęło do tucholskiej prokuratury w gorącym przedwyborczym okresie na początku października .	przedwyborczym	10	Masc3
Współczesne trendy cywilizacyjne sprzyjają siłom zła , lecz dobro nie odpuszcza .	cywilizacyjne	2	Masc3
W ogrodzie tego domu wznosiły się kiedyś pawilony obserwacyjne .	obserwacyjne	8	Masc3
Obrazy cyfrowe składają się z połączonych ze sobą pikseli o różnych barwach lub tonach .	połączonych	5	Masc3
Jesienią zeszłego roku odwołać dyrektora Ziarkowskiego usiłowała Rada Kasy .	zeszłego	1	Masc3
Kupmy jej srebrne .	srebrne	2	Masc3
Odczuł em zaraz lekki niepokój .	lekki	3	Masc3
A stopy mocno stoją na twardym , świętym gruncie .	twardym	5	Masc3
Listy leżały przed nim zamknięte , zżółkłe , stare .	zamknięte	4	Masc3
Potem roztworem chemicznym starannie spryskano bezcenne posągi i stare mozaiki .	bezcenne	5	Masc3
„ No powiedz , to był jednak niesłychanie przystojny mężczyzna ! "	przystojny	8	Masc1
otworzę kanały elektryczne i niech wlezie tam . .	elektryczne	2	Masc3
Czy senator rzuci rękawicę wszechwładnemu przewodniczącemu ?	wszechwładnemu	4	Masc1
Kobietom odpowiadał uwodzicielsko nastrojony głos ukrytego w jakiejś dziupli wodzireja .	nastrojony	3	Masc3
Przyznał , że spodziewał się nieco lepszej postawy po młodszych od siebie zawodnikach .	młodszych	9	Masc1
Może zostaniesz kiedyś kierowcą rajdowym .	rajdowym	4	Masc1
Używając pożyczonych magnetofonów szpulowych połączył em dźwięki suity z fragmentami poematu Wergilego .	pożyczonych	1	Masc3
Zazwyczaj pojawiający się problem zajmuje twoje myśli przez cały dzień .	pojawiający	1	Masc3
- Nie pozwolił jej skończyć , pocałował w usta , ale w tej chwili za oknem rozległ się dźwięk klaksonu , niespodziewany i głośny .	głośny	23	Masc3
Była w deszczowym płaszczu i w obcisłej , skórzanej czapeczce .	deszczowym	2	Masc3
Wcale nie jest dla mnie pewne , czy należy być takim świętym .	świętym	11	Masc1
– Robisz się religijny , kiedy mówisz o piłce nożnej .	religijny	3	Masc1
Może ja piszę sonety prorocze ?	prorocze	4	Masc3
Wyrok ten uchylił sąd apelacyjny .	apelacyjny	4	Masc3
Ta grupa w części pewnie będzie się składać z dawnego elektoratu SLD .	dawnego	9	Masc3
To ostatecznie przesądziło o południowym kierunku japońskiej ekspansji .	południowym	4	Masc3
Wiatr przynosił ostry alkoholowy zapach traw .	alkoholowy	3	Masc3
Nie licz na udany romans .	udany	3	Masc3
Satelita miał badać promienie kosmiczne i mikrometeoryty .	kosmiczne	4	Masc3
Po chwili do jej pokoju wbiegł zaniepokojony akuszer .	zaniepokojony	6	Masc1
Powracali tam ci dawno pożegnani .	pożegnani	4	Masc1
Do przechodzącego ulicą 28-letniego mieszkańca Ostrowca Świętokrzyskiego oddał dwa strzały .	28-letniego	3	Masc1
Jej długi cień zrównał się z jego cieniem .	długi	1	Masc3
Do podlewania sadzonek wyśmienicie nadają się filtrowane ścieki .	filtrowane	6	Masc3
- Człowieku , ten nowy też już zdążył się zestarzeć .	nowy	4	Masc1
- Mój ojciec był chciwy .	chciwy	4	Masc1
Gagosian nadal milczał , siedząc za biurkiem na swój sztywny sposób .	sztywny	9	Masc3
Potem polski papież został by w Watykanie kanonizowany .	polski	1	Masc1
Potrawy były oceniane przez 110 niezależnych sędziów .	niezależnych	5	Masc1
Mówmy , że ktoś nieśmiały jest też bardziej wrażliwy , milszy .	milszy	10	Masc1
W kościele mariackim w Radomiu o północy mszę święto odprawił biskup senior Edward Materski .	mariackim	2	Masc3
Pomnik , zniszczony przez hitlerowców , został odbudowany w 1984 r.	zniszczony	2	Masc3
Wstęp jest wolny .	wolny	2	Masc3
Bo niby premier coś mówi , ale przecież wiadomo , że on jest w coś uwikłany .	uwikłany	15	Masc1
Blady strach na wieś padał , kiedy Hanke pojawiał się z tym aparatem .	Blady	0	Masc3
Za chwilę w ciemnościach rozlega się łoskot zasuwającego się opornie betonu .	zasuwającego	7	Masc3
Roszczenia , jak się zakłada , były by załatwiane w trybie administracyjnym .	administracyjnym	11	Masc3
Już po raz drugi oglądam tę chorobę w działaniu .	drugi	3	Masc3
Jesteś szczery , prostolinijny , ale prawdopodobnie swoje własne opinie będziesz zatrzymywać dla siebie .	prostolinijny	3	Masc1
Młodego dja , pochodzącego z Głogowa , wylansował dj Adamus .	pochodzącego	3	Masc1
Nadchodził schyłek lat trzydziestych .	trzydziestych	3	Masc3
Gdyby Celina Szulc pozostała na stanowisku , związkowcy zamierzali ogłosić wczoraj strajk okupacyjny w łomżyńskich wodociągach .	łomżyńskich	14	Masc3
Techniki układali w zamknięty występ .	zamknięty	3	Masc3
- Następni są już w kolejce .	Następni	1	Masc1
Dwunastościan foremny miał symbolizować ład kosmiczny .	foremny	1	Masc3
Poniedziałkowa prasa londyńska pisze o odsłonięciu pomnika oświęcimskiego .	oświęcimskiego	7	Masc3
Początek był bardzo udany .	udany	3	Masc3
Kwity wykłada sympatyczny i kulturalny pan po pięćdziesiątce .	kulturalny	4	Masc1
A nerwowe ruchy nikomu nie wyszły by na dobre .	nerwowe	1	Masc3
Rząd zamierza pomóc rolnikom dotkniętym przez suszę .	dotkniętym	4	Masc1
Balkon był pusty .	pusty	2	Masc3
Oprócz słuchania Steczkowskiej delegaci zajmowali się dyskusją o strajku generalnym .	generalnym	9	Masc3
Lońka był w coraz lepszym humorze .	lepszym	4	Masc3
W październiku zeszłego roku w Warszawie odzyskano skradzionego opla .	zeszłego	2	Masc3
Po wstępnych kieliszkach było przyjemnie .	wstępnych	1	Masc3
Właśnie zakończył się trzeci , diecezjalny etap konkursu .	trzeci	3	Masc3
Odziedziczyła ona po bracie majątek w Galicji , uprzemysłowiony i dający duże profity .	dający	10	Masc3
We włosach rudych widział boży ogień .	boży	4	Masc3
Głosy radnych są podzielone .	podzielone	3	Masc3
Użyto gazów łzawiących i ogłuszających granatów .	ogłuszających	4	Masc3
Słabszym doradza się wczołgiwanie .	Słabszym	0	Masc1
Opracowuje się w tej sprawie szczegółowy program dla województwa .	szczegółowy	5	Masc3
W niedzielę po południu turysta schodzący z Zawratu usłyszał głosy we mgle .	schodzący	5	Masc1
Świadkowie twierdzą , że spod siedziby SdRP odjechało w ostatnich kilkunastu miesiącach kilka takich grup .	ostatnich	9	Masc3
Szwedzi , biedny naród , nie znają zapachu piekarni , świeżego , prawdziwego chlebka .	biedny	2	Masc3
Skrzykują te , które wzbiły się za wysoko na wschodzący księżyc .	wschodzący	9	Masc3
Sornicy będą nosić tradycyjne kozackie mundury .	tradycyjne	3	Masc3
Była to Angielka w średnim wieku .	średnim	4	Masc3
Paul Dellapina skazany na dwadzieścia lat ucieka po raz ósmy z więzienia .	skazany	2	Masc1
Rośnie pokolenie ludzi straconych , wyrzuconych . . .	straconych	3	Masc1
Starszy kiwnął głową .	Starszy	0	Masc1
Nie sądzę , by był w waszym czarnym strumyku .	czarnym	7	Masc3
- Nie jestem typowym jazzmanem , choć tak bywam oceniany .	oceniany	9	Masc1
Do poradni chirurgicznej i pogotowia ratunkowego napływali poszkodowani piesi .	poszkodowani	7	Masc1
Motywy jego tragicznego wypadku nie są znane .	znane	6	Masc3
Partia opozycyjna nie powinna bać się przedterminowych wyborców .	przedterminowych	6	Masc1
Biznesmeni pakistańscy to ciągle pendżabscy latyfundyści .	pakistańscy	1	Masc1
Ale byli śmy o parę klas lepsi i wygrali śmy zdecydowanie .	lepsi	6	Masc1
W tym czasie moim serdecznym przyjacielem stał się koń .	serdecznym	4	Masc1
Spirytus jest rozlewany do kartoników litrowych , półlitrowych i ćwiartek .	litrowych	5	Masc3
Trzydzieste piąte Targi zostały rozpoczęte .	Trzydzieste	0	Masc3
Jerzy Gruza wydaje się nieubłagany w swoim perfekcjonizmie .	nieubłagany	4	Masc1
Spodziewa się Pan , że wyższy wzrost gospodarczy przyniesie wyższe dochody z podatków ?	gospodarczy	7	Masc3
Zapowiada nieoczekiwane zgony , ciężkie choroby , katastrofy , śmierć .	nieoczekiwane	1	Masc3
Sami urządzą sobie rzeź .	Sami	0	Masc1
Nie pamiętam tych dwóch córek niemieckiego majstra .	niemieckiego	5	Masc1
Zasypiam , ssąc chrupką skórkę przy migoczącym w telewizji Człowieku z żelaza .	migoczącym	6	Masc1
Wróbel był zaskoczony wiedzą posła Grzesika .	zaskoczony	2	Masc1
Tak już chyba na serio nie mówimy , a nasz cyniczny wiek jakąś aurę śmieszności wokół słowa zbudował .	cyniczny	10	Masc3
Cały Babel na to patrzył !	Cały	0	Masc3
- Poprawka druga ma czysto legislacyjny charakter .	legislacyjny	5	Masc3
Przez wiele lat uchodził za radykalnego antykomunistę .	radykalnego	5	Masc1
Stracił cały swój początkowy tupet .	początkowy	3	Masc3
Mniejsze rosły jeszcze w doniczkach .	Mniejsze	0	Masc3
Przy końcu alei stał świeżo wkopany słup , pomalowany na jasnoniebieski kolor .	jasnoniebieski	10	Masc3
- Wiedzieli , że muszą sami sobie pomóc .	sami	5	Masc1
- Nabywca był podstawiony przez nas .	podstawiony	3	Masc1
O drugiej rozpoczął się dramat jak z kadrów sensacyjnego filmu .	sensacyjnego	8	Masc3
Na koniec kokieteryjnie usprawiedliwiła się , że mówi bez ładu i składu , bo jest już w zaawansowanym wieku .	zaawansowanym	17	Masc3
Od lat siedemdziesiątych coraz większą popularność zdobywa nurt neuroteologiczny .	siedemdziesiątych	2	Masc3
Rekordowy mróz minus osiemnaście stopni Celsjusza zanotowano w podgórskiej miejscowości Przibyslavi .	minus	2	Masc3
Każdy chce być jak najlepszym rodzicem .	najlepszym	4	Masc1
Zastawał em Janka w ciemnym pokoju .	ciemnym	4	Masc3
NIP nadaje urząd skarbowy .	skarbowy	3	Masc3
Jednak nawet wtedy eksperci zgodnie twierdzili , że boom internetowy kiedyś wróci .	internetowy	9	Masc3
Miś Holender przysłał mu czerwone anemony i hiacynty na ostatek .	czerwone	4	Masc3
czy czynnik czasowy jest znaczący ?	znaczący	4	Masc3
Już nie nosi starych butów z pourywanymi sznurówkami .	starych	3	Masc3
Staram się być dobrym .	dobrym	3	Masc1
Widzę sterczące w górę żurawie studzienne .	sterczące	1	Masc3
Ze sklepu Wedla wyszedł ciemno ubrany mężczyzna z kilkoma paczuszkami w rękach .	ubrany	5	Masc1
Za nim podreptał wiotki młodzieniec z magnetofonem na ramieniu .	wiotki	3	Masc1
Pozostali pacjenci przebywają na oddziale ginekologicznym , wewnętrznym i kardiologicznym .	ginekologicznym	5	Masc3
Najciekawiej zapowiada się w Moskwie , gdzie miejscowy Spartak podejmuje Ajax Amsterdam .	miejscowy	7	Masc3
Żydzi w Izraelu podlegają także innym czynnikom .	innym	5	Masc3
A Bóg jest Prawdomówny .	Prawdomówny	3	Masc1
– trzecia musi być już na czas stały . .	stały	7	Masc3
Wrzucony do grobu , nie mógł stanąć nad grobem .	Wrzucony	0	Masc1
Wyznaczeni posłowie zajęli miejsca .	Wyznaczeni	0	Masc1
Rok temu okazało się , że mieszka w lokalu należącym do sąsiadki .	należącym	9	Masc3
Ona poprzez lasy przerąbała pierwszą drogę dla cichego apostolstwa synów bożych .	bożych	10	Masc1
Nowego najęli .	Nowego	0	Masc1
Powołujesz się na intelektualnego i emocjonalneog kastrata , ale czego innego mogł em się po Tobie spodziewać ?	emocjonalneog	5	Masc1
Perski czador czy afgańska burka stawały się politycznym manifestem .	politycznym	7	Masc3
Była zniszczona również przez żołnierzy napoleońskich .	napoleońskich	5	Masc1
Marszałek sejmowy zamilkł i spojrzał wyczekująco po obecnych .	sejmowy	1	Masc1
W tle widać zarys bawarskiego tronu z atrybutami władzy królewskiej .	bawarskiego	4	Masc3
Już na schodach usłyszała dźwięki dobiegające z komnaty dziadka .	dobiegające	5	Masc3
Poczta zmniejsza swój deficyt i już w 1997 r. powinna zacząć przynosić zyski .	1997	7	Masc3
Obecni byli posłowie Pękała i Witaszczyk , ale nie przemawiali .	Obecni	0	Masc1
Do naszej salki wszedł teraz łysy facet w ciemnooprawnych okularach .	łysy	5	Masc1
Po oblodzonych schodach wspinamy się na pokład szalupowy .	szalupowy	7	Masc3
Wróciła dynamika , dawny zapał .	dawny	3	Masc3
Nie był stary .	stary	2	Masc1
Po drodze , lekko podchmieleni , prowadzili ożywioną rozmowę .	podchmieleni	4	Masc1
Najbliżsi rywale Orfe także nie rezygnują z przejęcia kolejnych mniejszych dystrybutorów .	mniejszych	9	Masc1
I doczekać z antykaczyńskim rządem do jesiennych wyborów .	antykaczyńskim	3	Masc3
Szli szosą warszawską , skąpo oświetloną latarniami , wzdłuż nowego cmentarza .	nowego	9	Masc3
Wtedy wyciąga zawieruszony w pomiętej pościeli telefon komórkowy , by wszystkie je po kolei załatwić .	zawieruszony	2	Masc3
Poirytowani posłowie - projektodawcy sprawdzili te informacje .	Poirytowani	0	Masc1
Biedny Wojtek wysługuje się .	Biedny	0	Masc1
- Przez ostatnie miesiące zasuwała m na pełnych obrotach .	pełnych	7	Masc3
W przeciwnym wypadku należy je rozrzedzić wodą .	przeciwnym	1	Masc3
- Sądy podchodzą do tajnych współpracowników bardzo liberalnie , nie eliminują z życia społecznego agentów .	tajnych	4	Masc1
Jakiś kulawy facet zaszedł mu drogę .	kulawy	1	Masc1
Odpowiedział eś posługując się sztandarowym obok Białorusi argumentem .	sztandarowym	4	Masc3
Już bez nadziei rozglądał em się , gdy wtem zobaczył em w lunecie czarny punkt .	czarny	13	Masc3
- Chłopaki z lubelskiego zespołu hiphopowego noszą takie krawaty .	lubelskiego	3	Masc3
Marks był by przerażony efektami .	przerażony	3	Masc1
Przez chwilę stał osłupiały .	osłupiały	3	Masc1
Hotel posiadać będzie trzydzieści stylowo umeblowanych pokojów .	umeblowanych	5	Masc3
Tam w końcu jestem najlepszy .	najlepszy	4	Masc1
Przy kościele spoczywają powstańcy z 1831 i 1848 .	1831	5	Masc3
Wczepiony w worki , ściąga je na podłogę .	Wczepiony	0	Masc1
- Czy byli śmy inwigilowani ?	inwigilowani	4	Masc1
Kiedyś uduszono jej jedynego syna Amadeusza .	jedynego	3	Masc1
Ciężki , kleisty lęk wypełnił jej serce .	Ciężki	0	Masc3
– Lekarz ogólny nie był by już nam wtedy potrzebny ?	ogólny	2	Masc1
( Ilustruje to zamieszczony aneks ) .	zamieszczony	3	Masc3
Miejscowy , brodaty duchowny czekał już przy ołtarzu .	brodaty	2	Masc1
Stary wiadukt przy ulicy Oświęcimskiej stanowił ogromną uciążliwość dla kierowców .	Stary	0	Masc3
Funkcjonariusze apelują do mieszkanek Kwidzyna , aby w najbliższym czasie unikały ciemnych miejsc .	najbliższym	8	Masc3
Pobladłą twarz pilota rozjaśnia triumfalny uśmiech .	triumfalny	4	Masc3
W Zwieczycy koło Rzeszowa autobus PKS wpadł do głębokiego rowu .	głębokiego	8	Masc3
Następuje przewartościowanie z wymiaru duchowego na materialny .	materialny	6	Masc3
- Są lepsze pomysły ?	lepsze	2	Masc3
Nie cenzuruje nas wrogi urzędnik , ale towarzysz partyjny " .	partyjny	8	Masc1
Rekordowy mróz minus osiemnaście stopni Celsjusza zanotowano w podgórskiej miejscowości Przibyslavi .	Rekordowy	0	Masc3
Obok wspomnianych przedmiotów ścisłych lubi biologię , przykłada się do angielskiego .	angielskiego	10	Masc3
W prańskich koncertach wystąpi jeszcze parokrotnie .	prańskich	1	Masc3
Nie mogę powiedzieć , że byli uprzejmi , ale nie byli niegrzeczni .	niegrzeczni	11	Masc1
A to pewnie był akurat chwyt zamierzony przez autora i głęboko uzasadniony .	uzasadniony	11	Masc3
Pod Wisłą buduje się wielki tunel ciepłowniczy .	ciepłowniczy	6	Masc3
Bardzo dobrze rozpoczął się także dla Towarzystwa 1999 rok .	1999	7	Masc3
Nie cenzuruje nas wrogi urzędnik , ale towarzysz partyjny " .	wrogi	3	Masc1
Nie składają donosów do prokuratury , nie przejmują się całodobowym uśmiercaniem poczętych ?	poczętych	11	Masc1
Księgarnia mieści się na 350 metrach kwadratowych .	kwadratowych	6	Masc3
Po tym orzeczeniu na scenę wkroczył Ogólnopolski Związek Zawodowy Lekarzy .	Ogólnopolski	6	Masc3
Z zestawienia sporządzanego przez starostwo wynika , że podmioty gospodarcze działające w powiecie działdowskim dokonują rocznie ponad 6000 odpraw celnych .	gospodarcze	9	Masc3
Kto jest lewicowy ?	lewicowy	2	Masc1
A320 jest prekursorem wśród odrzutowców liniowych .	liniowych	5	Masc3
Człowiek był nagi i nieruchomy .	nieruchomy	4	Masc1
I szedł em przez te stygnące odchody coraz bardziej markotny , a przygnębienia przybywało mi z każdym krokiem .	markotny	9	Masc1
100-tysięcznym Grudziądzem rządzi lewica .	100-tysięcznym	0	Masc3
Jesteś wyższy od wicepremiera Romana Giertycha ?	wyższy	1	Masc1
- Staszek był trudnym człowiekiem , bardzo rozdwojonym .	rozdwojonym	7	Masc1
- I zupełnym przypadkiem trafił eś na Jacka Kuronia .	zupełnym	2	Masc3
Przyglądali śmy się różnym kształtom bakterii , glonów , pierwotniaków .	różnym	3	Masc3
Czuł em jego mięśnie napięte pod skórą , twarde jak drewno .	napięte	4	Masc3
- Następni zdezerterowali ?	Następni	1	Masc1
Ewakuowano 200 gości hotelowych .	hotelowych	3	Masc1
Wykop i południowe baraki są w jednej linii .	południowe	2	Masc3
Analogiczny obraz zróżnicowań społecznych ukazują dane o wieku menarchy dziewcząt .	Analogiczny	0	Masc3
We wtorek w Annopolu , gdzie Wisła przekroczyła stan alarmowy o 34 cm , ogłoszono alarm przeciwpowodziowy .	przeciwpowodziowy	16	Masc3
- A nie zapomnij wypisać mnie z czytelni , abonament zapłacony do dwudziestego .	dwudziestego	12	Masc3
Kolejny pijany policjant straci pracę .	pijany	1	Masc1
Obaj byli wysocy , zwaliści , misiowato potężni .	potężni	7	Masc1
Był em tym zachwycony i chodził em po Akademii dumny jak paw .	zachwycony	3	Masc1
Inne stolemy wyniosły się dawno do zamorskich krajów i ludzie przestali się już bać , że padną ofiarą ich psot .	zamorskich	6	Masc3
Śniegi leżały głębokie , rozsierdziła się zima w tym roku .	głębokie	2	Masc3
Normalny obywatel nie chodzi z takim radiotelefonem .	Normalny	0	Masc1
Praca pedagogiczna na uniwersytecie japońskim różni się znacznie od pracy na uniwersytecie europejskim .	europejskim	12	Masc3
Daniel dobrze pamiętał najstarszego .	najstarszego	3	Masc1
Jest bardzo silny fizycznie , chociaż mierzy tylko metr sześćdziesiąt osiem .	silny	2	Masc1
Działacze liczą , że związek nie będzie ścigany z całą surowością .	ścigany	7	Masc3
W kuchni unoszą się smakowite zapachy , pani Grażyna wyciąga z szuflady sztućce .	smakowite	4	Masc3
Innego dowodu nie było .	Innego	0	Masc3
Dużym zainteresowaniem cieszą się barwne szklane witraże jako prace ozdobne .	barwne	4	Masc3
Hotel został otoczony .	otoczony	2	Masc3
Jestem posłuszny i staram się nie sprzeciwiać .	posłuszny	1	Masc1
A któż z Was nie czuje się pokrzywdzony ?	pokrzywdzony	7	Masc1
Wyemigrował w 1984 r.	1984	2	Masc3
Niestety , słabiutki wokal pojawiał się we wszystkich utworach tej trójki .	słabiutki	2	Masc3
Jego stałym zastępcą jest oficer G3 .	stałym	1	Masc1
Kradli telefony komórkowe , sprzęt komputerowy i inne cenne przedmioty .	komórkowe	2	Masc3
Andrew wolał by , aby Elizabeth pożegnali tylko najbliżsi .	najbliżsi	8	Masc1
KTO PIERWSZY znajdzie się w Kosmosie ?	PIERWSZY	1	Masc1
W 1979 utworzono tu Szkołę Mistrzów Pszczelarskich .	Pszczelarskich	6	Masc1
- Zrobiła ręką gest zapraszający do środka .	zapraszający	4	Masc3
Osobiście poznała m swojego zaciekłego wroga .	zaciekłego	4	Masc1
Poza tym , spotykam się z nimi na gruncie zawodowym .	zawodowym	9	Masc3
Potem zostaną ulokowani w hotelach i ośrodkach wypoczynkowych .	wypoczynkowych	7	Masc3
Moczarskiego znał em sprzed wojny , byli śmy razem w Wyższej Szkole Dziennikarskiej , dość zaprzyjaźnieni .	zaprzyjaźnieni	15	Masc1
Idąc do butiku Stefaniakowej , wstąpił em na pocztę i zadzwonił em do Regionalnego Banku Gospodarczego .	Gospodarczego	15	Masc3
Rannymi cywilami zaopiekowali się najpierw amerykańscy sanitariusze z personelu naziemnego .	amerykańscy	5	Masc1
Na progu stał wysoki , zarośnięty mężczyzna .	zarośnięty	5	Masc1
Od lat siedemdziesiątych coraz większą popularność zdobywa nurt neuroteologiczny .	neuroteologiczny	8	Masc3
Jubel będzie ekstra .	ekstra	2	Masc3
Wszystkie klasztory i najznakomitsze rody pozostają naszymi klientami .	najznakomitsze	3	Masc3
– Nie zostanie pan jednak całkiem odsunięty od śledztwa .	odsunięty	6	Masc1
Mówmy , że ktoś nieśmiały jest też bardziej wrażliwy , milszy .	nieśmiały	4	Masc1
Zapach kawy przeważał nad odorem spalonego tłuszczu z kuchni i chloraminy z toalet .	spalonego	5	Masc3
W załzawionym świecie jeden diabeł posiadał kontury ostre i wyraźne .	wyraźne	9	Masc3
Wiele zarzutów ma powierzchowny charakter .	powierzchowny	3	Masc3
W całym kraju ścięto jeszcze niewiele .	całym	1	Masc3
Wreszcie Lem z wyjątkowym krytycyzmem oceniał sprawy polskie .	wyjątkowym	3	Masc3
W Gnieźnie w sylwestrowy wieczór zginęli podczas pożaru trzej chłopcy , a jadący do akcji samochód strażacki wpadł na dwie kobiety .	jadący	12	Masc3
Od trzeciego rozbioru Polski do odzyskania niepodległości minęły 123 lata .	trzeciego	1	Masc3
Usłyszała m kilka taktów renesansowych .	renesansowych	4	Masc3
Patrzy , a tu we włosach łonowych roi się od weszek .	łonowych	6	Masc3
Dziś , patrząc na Koło Polskie w Dumie , jesteśmy raczej bezradni .	bezradni	11	Masc1
Owa niezapomniana chwila zawierała nieprawdopodobny ładunek patosu .	nieprawdopodobny	4	Masc3
Pomaga w sprzątaniu i wszelkich kłopotach zdrowotnych .	zdrowotnych	6	Masc3
Będzie to film szerokoekranowy , składający się z dwóch części .	szerokoekranowy	3	Masc3
Później innego uczestnika spotkania znaleziono martwego w jego domu letniskowym pod Belgradem .	martwego	5	Masc1
Za najważniejszych nazistowskich zbrodniarzy powszechnie uznawano Hitlera , Himmlera i Goebbelsa .	najważniejszych	1	Masc1
Antybiotyki to związki chemiczne wytwarzane w naturze przez same drobnoustroje .	chemiczne	3	Masc3
48 zakładów mięsnych z całego kraju zgłosiło do konkursu 213 swoich produktów .	mięsnych	2	Masc3
W drugiej części czytelnik będzie mógł lepiej poznać cały pluton rotacyjny szeregowca Leńczyka .	cały	8	Masc3
- A te szacunki były publikowane ?	publikowane	5	Masc3
Pomysł wynalazcy został opatentowany .	opatentowany	3	Masc3
Leżał żółty , patrzył na nich , nic nie mówił .	żółty	1	Masc1
Miał 28 lat , żonaty , córka .	żonaty	4	Masc1
- Nie sprawiał żadnych problemów wychowawczych .	wychowawczych	5	Masc3
Do dziś w sądownictwie pracują osoby , które rozpoczynały swoją karierę w latach stalinowskich .	stalinowskich	13	Masc3
Przede wszystkim wywozili ruchomy majątek i żywność .	ruchomy	3	Masc3
Byli ożywieni .	ożywieni	1	Masc1
Trzecioligowcy strzelili kontaktowego gola , ale w ostatnim kwadransie dwie bramki dla Lecha wypracował Remień .	ostatnim	7	Masc3
Prokuratura orzekła , że jest niepoczytalny .	niepoczytalny	5	Masc1
Po wakacjach planujemy też kilka spektakli wieczornych .	wieczornych	6	Masc3
Zabieram ze skarbca tylko wczorajszy obrót .	wczorajszy	4	Masc3
- Czuje się Pan dostatecznie silny , żeby takie decyzje podejmować ?	silny	5	Masc1
- Jesteś uparty .	uparty	2	Masc1
Czy monde jest jeszcze urażony ?	urażony	4	Masc3
Nie chcąc zaskoczyć krywów , starał się wywołać jak największy hałas .	największy	9	Masc3
Fabrykę zaplombowano , konfiskując także podejrzane materiały .	podejrzane	5	Masc3
My , grubi , musimy się bronić .	grubi	2	Masc1
Zwycięski zespół uzyska awans .	Zwycięski	0	Masc3
Przygotowano też rozmaite zestawy upominkowe w estetycznych opakowaniach .	upominkowe	4	Masc3
Przez całą niedzielę sprawdzano każdy wątek i potencjalnych sprawców .	potencjalnych	7	Masc1
Cały kurs nadany będzie w Łodzi .	nadany	2	Masc3
lekko młotkiem gumowym chlapnąć .	gumowym	2	Masc3
W dusznej od papierosowego dymu izbie tłoczono się okropnie .	papierosowego	3	Masc3
Wojewoda doda jej dla splendoru nieszczupły taborek .	nieszczupły	5	Masc3
Potem ból stał się tak silny , że przesłonił wszystko ciemnością pozbawioną woni i dźwięków .	silny	5	Masc3
Te wszystkie rogi zostały zdemontowane i wywiezione do Szczecina .	zdemontowane	4	Masc3
Tu jest strefa przygraniczna , sami rozumiecie .	sami	5	Masc1
Odwróciwszy się omal nie uderzył w brzuch starego Pancera .	starego	7	Masc1
Następnym mówcą będzie senator Marian Żenkiewicz .	Następnym	0	Masc1
To najgorszy wstrząs sejsmiczny zarejestrowany w Kolumbii .	najgorszy	1	Masc3
Ich czołgi w tym czasie były wielokrotnie lepsze od rosyjskich .	lepsze	7	Masc3
Białe policyjne motocykle są doskonale oznakowane .	oznakowane	5	Masc3
Porosła by gęstym lasem , jak cała okolica , gdyż chudy piasek nie dał by życia .	gęstym	2	Masc3
Przechodził on długą ewolucję , stając się najpopularniejszym tanim zegarkiem .	najpopularniejszym	7	Masc3
- Może spotkasz swojego starego znajomego , Szmidta .	starego	4	Masc1
Śpiącego , zielem odurzonego zabiła m sztyletem .	Śpiącego	0	Masc1
Kocham polskich chłopów hodujących polską brukselkę . . .	polskich	1	Masc1
- Mamy duże rezerwy i długi zagraniczne .	zagraniczne	6	Masc3
Od małego bardzo lubiła ś herbatę .	małego	1	Masc1
– ale teraz brzydki jest ten śnieg . .	brzydki	3	Masc3
- W iluż miastach w okresie letnim odbywa się tyle bezpłatnych występów artystycznych .	letnim	6	Masc3
Rozbity samochód trafił na policyjny parking .	Rozbity	0	Masc3
Trzeba ocenić system i ukarać konkretnych winnych .	konkretnych	5	Masc1
Reszta tonie w nieprzeniknionym zmroku .	nieprzeniknionym	3	Masc3
Następnym razem przyprowadzą kolegów i pomalutku piękny sport narciarski zainteresuje bardziej młodzież naszego miasta .	Następnym	0	Masc3
Nikt nie jest doskonały .	doskonały	3	Masc1
Wczoraj minister finansów i pięciu innych szefów resortów zrezygnowali ze swoich stanowisk .	innych	5	Masc1
Chce , by powstał na nich ośrodek sportów wodnych .	wodnych	8	Masc3
Był by m siódmy lub ósmy w kolejce .	ósmy	5	Masc1
W 1932 r. wyjechał do Palestyny .	1932	1	Masc3
Byli śmy bezradni .	bezradni	2	Masc1
Kobieta w fartuchu sprzedaje jej papierowy bilet .	papierowy	5	Masc3
Tytus czuł się samotny i opuszczony .	opuszczony	5	Masc1
Przedstawiony przez was budynek to prosta forma ze szkła .	Przedstawiony	0	Masc3
Widział em rano , jak rozmawiała ś z tym sympatycznym młodzieńcem , Abibem Denisem .	sympatycznym	9	Masc1
cały czas mieli śmy Rafała ten tapczan .	cały	0	Masc3
Przy wspólnym stole jadają tu studenci izraelscy i palestyńscy .	izraelscy	6	Masc1
Według stołecznych policjantów , udało mu się zgromadzić wokół siebie młodych przestępców z Pragi .	stołecznych	1	Masc1
Latem ubiegłego roku Kubańczyk przybył do kliniki wrocławskiej .	ubiegłego	1	Masc3
Złoty instrument sprezentowało mu bractwo kurkowe .	Złoty	0	Masc3
- Masz dobrych rodziców .	dobrych	2	Masc1
Wczoraj , po zamknięciu lokali wyborczych , niemieckie media zapowiedziały , że pani minister ustąpi ze stanowiska .	wyborczych	5	Masc3
Prototypy powinny odznaczać się światowym standardem .	światowym	4	Masc3
W ich miejsce wchodzi na ogół religia , często w formie takiego czy innego fundamentalizmu .	innego	13	Masc3
Wojskowy kandydat nie rozdawał ulotek ze swoim programem wyborczym .	Wojskowy	0	Masc1
no przecież on jest bardzo aktywny .	aktywny	5	Masc1
- Mój ojciec pracuje w BRH , biurze radcy handlowego .	handlowego	9	Masc1
Do obserwatorium waszyngtońskiego ściągały tłumy ciekawych .	ciekawych	5	Masc1
Wtedy wyciąga zawieruszony w pomiętej pościeli telefon komórkowy , by wszystkie je po kolei załatwić .	komórkowy	7	Masc3
Sporządzono także portrety pamięciowe napastników .	pamięciowe	3	Masc3
Mój autobus nie nadjeżdżał , poszli śmy do następnego przystanku .	następnego	8	Masc3
Siedział ponury na przedzie tramwaju , pod plastykowym dachem .	plastykowym	7	Masc3
W Czarnem umieszczono go w celi o zaostrzonym rygorze .	zaostrzonym	7	Masc3
Te wątki pojawiają się też w poselskim projekcie .	poselskim	6	Masc3
Spojrzał na mnie zaskoczony .	zaskoczony	3	Masc1
Dlatego jest jasny .	jasny	2	Masc3
Ze stara wyciekał olej i płyn chłodzący , a przyczepa miała zdemontowany hamulec awaryjny .	zdemontowany	11	Masc3
Do tej pory w Polsce około tysiąc aut ma zamontowany system tej amerykańskiej firmy .	zamontowany	9	Masc3
Potem zaraz z świętym Piotrem zniknął .	świętym	3	Masc1
Czy sędziowie w programie są stronniczy ?	stronniczy	5	Masc1
Nieoczekiwanie i bardzo mocno uderzył w piersi łysego , wąsatego mężczyznę .	wąsatego	9	Masc1
Położyli na drabiniastym wozie .	drabiniastym	2	Masc3
Aneta pochodzi z domu byłych gospodarzy .	byłych	4	Masc1
Głównym jego prześladowcą był malarz , majster Gileta .	Głównym	0	Masc1
Miejsce każdego dobrego Polaka jest teraz w Polsce .	dobrego	2	Masc1
Widzicie , lyrijski orzeł czarny i rivskie rauty czerwone .	czerwone	8	Masc3
W ubiegłym roku bracia Lunelli osiągnęli kolejny pułap .	ubiegłym	1	Masc3
Siedemdziesięciu chorych leżało na słomianych barłogach we własnym kale .	własnym	7	Masc3
- Jeżeli ćwiczący źle dobiorą rakiety , piloci nie zniszczą przeciwnika .	ćwiczący	2	Masc1
Wilczyński nadal był zdziwiony , ale pokiwał głową .	zdziwiony	3	Masc1
Przy wspólnym stole jadają tu studenci izraelscy i palestyńscy .	wspólnym	1	Masc3
Dwunastościan foremny miał symbolizować ład kosmiczny .	kosmiczny	5	Masc3
Jej mąż stał bezradny w kącie , tulił synka .	bezradny	3	Masc1
Podobną akcję przeprowadzono w czasie wojny w Zatoce Perskiej w 1990 r.	1990	10	Masc3
Polskie Ministerstwo Gospodarki uznaje te zarzuty za bezpodstawne .	bezpodstawne	7	Masc3
Zerkała na czarno - biały obraz i pogryzała słone paluszki .	biały	4	Masc3
Pobity kijem bejsbolowym mężczyzna trafił z licznymi obrażeniami do szpitala .	Pobity	0	Masc1
Zalało perony na dworcu kolejowym .	kolejowym	4	Masc3
Paweł jest zdenerwowany .	zdenerwowany	2	Masc1
Pokoje stanowią wyłączną własność poszczególnych lokatorów .	poszczególnych	4	Masc1
Niepalący żyją dłużej .	Niepalący	0	Masc1
Dostała 500-złotowy mandat .	500-złotowy	1	Masc3
- Niektóre wydatki były nieuzasadnione .	nieuzasadnione	4	Masc3
W demokratycznym państwie powinny one stanowić kanony niepodważalne .	niepodważalne	7	Masc3
- Mam wolny wieczór .	wolny	2	Masc3
Czy Szanowni grupowicze mogli by mi pomóc .	Szanowni	1	Masc1
— Mówi , że nie jest żonaty .	żonaty	6	Masc1
A to może uratować od śmierci , bo początek choroby zostanie w porę wykryty .	wykryty	13	Masc3
Niedługo po tym apelu Kamiński , Wołek i Jurek spotkali się na podwieczorku u krzywdzonego Pinocheta .	krzywdzonego	14	Masc1
Wszelkie informacje podane poniżej dotyczą jedynie wypadków sprawdzonych .	sprawdzonych	7	Masc3
Były najdłuższe dni roku .	najdłuższe	1	Masc3
Uparci i bezkompromisowi , jednych przerażali , innych zachwycali .	Uparci	0	Masc1
Policja przypuszcza , że najnowszy ładunek został porzucony przez spłoszonego niedoświadczonego terrorystę .	porzucony	7	Masc3
- Wydziela kwas salicylowy .	salicylowy	3	Masc3
Z piętra wyżej zszedł dystyngowany sąsiad z chartem na białej smyczy .	dystyngowany	4	Masc1
Mieszkał em w domu polskich księży , niedaleko osobliwej piramidy , grobowca Cestiusza .	polskich	4	Masc1
Trzy strzały trafiły przebywających w wartowni żołnierzy .	przebywających	3	Masc1
Nie pamiętała ona już domu swego zamożnym .	zamożnym	6	Masc3
Mocne łuki brwi jakby nastroszyły się .	Mocne	0	Masc3
Może wprowadzić bilet całodzienny ?	całodzienny	3	Masc3
Następnie Aleksander Zawadzki dokonał otwarcia muzeum w dziesiątym Pawilonie .	dziesiątym	7	Masc3
Około 15 km za Nag–czu , boczną , terenową drogą dojechali śmy do pasterskich namiotów .	pasterskich	13	Masc3
Facet był skruszony .	skruszony	2	Masc1
Ma , bo poszczególne akty mogą być lepsze lub gorsze .	gorsze	9	Masc3
Warszawscy radiowcy okazali się trudnymi rywalami .	trudnymi	4	Masc1
Idąc do butiku Stefaniakowej , wstąpił em na pocztę i zadzwonił em do Regionalnego Banku Gospodarczego .	Regionalnego	13	Masc3
To były fajne czasy .	fajne	2	Masc3
- Polacy cenią polityków sytuujących się ponad podziałami .	sytuujących	4	Masc1
Pokazano jej lichą zagrodę , naprzeciw wiejskiego cmentarza .	wiejskiego	6	Masc3
Jego usuwaniem zajęli się strażacy ze specjalistycznym sprzętem .	specjalistycznym	6	Masc3
Trafi do szpitala psychiatrycznego .	psychiatrycznego	3	Masc3
Od zbłąkanych misjonarzy uchroń nas , Panie .	zbłąkanych	1	Masc1
I mnie o waszych spotkaniach powiedzieli uczynni sąsiedzi .	uczynni	6	Masc1
Na pewno też wywołał by protesty spowodowane dalszym naruszaniem stabilności sytuacji podatników .	spowodowane	6	Masc3
Nowość polegała na tym , że nauczyciele chrześcijańscy wykazywali , iż w osobie Jezusa Chrystusa wypełniły się wszystkie przepowiednie proroków .	chrześcijańscy	7	Masc1
Kiedyś poziom był dużo większy .	większy	4	Masc3
Czy nie mógł by m okazać się pomocny ?	pomocny	7	Masc1
Nieoficjalnie wiadomo , że Krzysztof Jagiełło , znany w środowisku SLD jako doskonały organizator , był w tej sprawie w sobotę w Warszawie .	doskonały	12	Masc1
Ciastoń odpowiada teraz sam , bo Płatek jest chory .	chory	8	Masc1
Następnie chcieli przejechać interweniujących policjantów .	interweniujących	3	Masc1
Z zestawienia sporządzanego przez starostwo wynika , że podmioty gospodarcze działające w powiecie działdowskim dokonują rocznie ponad 6000 odpraw celnych .	działdowskim	13	Masc3
Rosyjscy eksperci uważają , że De Beers wzbogaca się nieuczciwie kosztem innych członków kartelu .	innych	11	Masc1
Oni z kolei odkryli Związek Radziecki .	Radziecki	5	Masc3
Po incydentach w meczu derbowym ukarali ście Cracovię zamknięciem stadionu na dwa mecze .	derbowym	4	Masc3
Głos nikł i stawał się coraz cichszy .	cichszy	6	Masc3
W najbliższych dniach Warszawy nie zasypią śmieci .	najbliższych	1	Masc3
Aktualnie nieczynny teleporter zostanie adaptowany na kolejny sklep spożywczy .	nieczynny	1	Masc3
Mariola odstawiła torebkę na malutki stołeczek .	malutki	4	Masc3
W kinie , na ostatnim filmie Allena , zasnęła m .	ostatnim	4	Masc3
Straszny ziąb w nawie , nawet anioł ze środkowego pilastru wydaje się drżeć z chłodu .	środkowego	8	Masc3
Jął przeciskać się przez zaporę , czołgał się przez rumowisko , zmiażdżone wózki .	zmiażdżone	11	Masc3
Bo zawsze nowy papież to sięgnięcie po nową talię .	nowy	2	Masc1
Dyna nie wydawał się obrażony .	obrażony	4	Masc1
Owinięty w zwiewne szaty , zasiadał na schodach świątyń , medytując godzinami .	Owinięty	0	Masc1
Ten ogromny magazyn przez całe wieki pozostawał niewykorzystany .	ogromny	1	Masc3
Związany z kapistami , wielokrotnie jednak przekraczał wyznaczone przez nich malarskie granice .	Związany	0	Masc1
Zrealizował go Polak , wykorzystując literaturę rosyjską i japońskich wykonawców .	japońskich	8	Masc1
Po spełnieniu toastu świeżo upieczeni małżonkowie rzucają za siebie kieliszki .	upieczeni	4	Masc1
Mundurowi nie chcą zdradzać parametrów technicznych maszyn , by nie ułatwiać życia drogowym piratom .	technicznych	5	Masc3
Czemu są nieruchliwi niczym drewniane posągi ?	drewniane	4	Masc3
Następuje przewartościowanie z wymiaru duchowego na materialny .	duchowego	4	Masc3
— Aktualnie ta ściana jest w bardzo złym stanie .	złym	7	Masc3
Prezes SSN deklaruje , że w kolejnych etapach zatrudni niemal wszystkich pracowników produkcyjnych .	produkcyjnych	12	Masc1
Toni był już trochę wstawiony .	wstawiony	4	Masc1
Rozpoczął się kolejny rok akademicki .	kolejny	2	Masc3
Konflikt dojrzewa też w spokojnym dotąd Kazachstanie .	spokojnym	4	Masc3
Ciągnąc go za rękaw , zmusiła do obrócenia się wśród otaczającego ich korowodu .	otaczającego	10	Masc3
Durny przodem idzie .	Durny	0	Masc1
Jeszcze w 1576 , jak wspominają akta wizytacyjne , mieszkali tu wolni Prusowie .	wizytacyjne	7	Masc3
Biznesmeni pakistańscy to ciągle pendżabscy latyfundyści .	pendżabscy	4	Masc1
Nigdy nie umiał być konsekwentny .	konsekwentny	4	Masc1
jesteś strasznie szybki . . .	szybki	2	Masc1
Star Trek jest serialem legendarnym , ale do Polski dotarł dopiero kilka lat temu .	legendarnym	4	Masc3
Przed światłami kierujący ruchem zatrzymał tira , a za nim stanęła skoda .	kierujący	2	Masc1
Na atramentowej powierzchni wody chybotał się samotny biały żagiel .	biały	7	Masc3
Opary porannej mgły nad jeziorem znikały w złotych promieniach słońca .	złotych	7	Masc3
Cały czas sprawdzana jest ich skuteczność .	Cały	0	Masc3
Dzieci zaczepiali na katowickim dworcu PKP .	katowickim	3	Masc3
Aż tu dobiegał potężny głos dziedzica .	potężny	3	Masc3
W Berchtesgaden specjalnością jest tor saneczkowy , na którym osiąga się niebywałe prędkości .	saneczkowy	5	Masc3
Ma charakter bardzo utylitarny .	utylitarny	3	Masc3
Może ich zgubić choćby zapach palącego papierosy .	palącego	5	Masc1
Wszystko wskazuje na to , że zostanie uchwalony .	uchwalony	7	Masc3
Dołączył nawet bezpłatny krążek w tym formacie oraz firmowy , programowy odtwarzacz .	bezpłatny	2	Masc3
- Odezwał się po chwili zmartwionym głosem Tomaszewski .	zmartwionym	5	Masc3
- Staszek był trudnym człowiekiem , bardzo rozdwojonym .	trudnym	3	Masc1
W poważnym stopniu przyczynił się do wysokich wyników wydziału .	poważnym	1	Masc3
Zrobiła to , bo skazany jest wzorowym więźniem .	wzorowym	6	Masc1
Skandynawowie nie należą do wielomównych .	wielomównych	4	Masc1
Myślę , że są to po prostu dobre kompozycje i świetne teksty .	świetne	10	Masc3
Sprawdzamy wyrostki kolczyste i łuki kręgów .	kolczyste	2	Masc3
Powinna wierzyć , że jej mąż żyje , a te biedne zwłoki należą do kogoś innego . . .	innego	15	Masc1
Nic nie wynika z faktu dosłownego ożywiania tekstu , skoro papier jest jego ostatnim powiernikiem .	ostatnim	13	Masc1
- Wasza gazeta od dawna robi świetne przewodniki dla poszukujących pracy w Irlandii .	poszukujących	9	Masc1
Od tego czasu gnębiony przez feudałów lud rumuński niejednokrotnie chwytał za broń .	gnębiony	3	Masc3
Przyjaciele mówią , że towarzysko jest miły , ale bywa bardzo złośliwy .	złośliwy	11	Masc1
Jak urządzony jest Wasz dom ?	urządzony	1	Masc3
W rozbite pojazdy uderzyła jeszcze jedna ciężarówka .	rozbite	1	Masc3
Ale ona tylko skinęła na okrwawionego fenomulata .	okrwawionego	5	Masc1
Tworzymy silny zespół i to jest nasz największy atut .	największy	7	Masc3
Obok liryków warszawskich będą to Kraina poezji , Piosenka o końcu świata , Dzień tworzenia .	warszawskich	2	Masc3
Zaangażowała się w Teatrze Dramatycznym kierowanym wówczas przez Gustawa Holoubka .	kierowanym	5	Masc3
- Był cichym patriotą ?	cichym	2	Masc1
Bóg nigdy nie karał sam występujących przeciwko niemu .	występujących	5	Masc1
Człowiek czuje się jak niewidzialny . . .	niewidzialny	4	Masc1
Ciemne włosy , spięte w koczek , podtrzymywała złocista spinka .	spięte	3	Masc3
Kelnerka miała narzucony płaszcz .	narzucony	2	Masc3
Od tego czasu gnębiony przez feudałów lud rumuński niejednokrotnie chwytał za broń .	rumuński	7	Masc3
Samozwańczy gliniarz posługuje się oryginalną legitymacją .	Samozwańczy	0	Masc1
Odpowiednio do tego , łóżka także miały kształt łukowaty .	łukowaty	8	Masc3
Betonowe fundamenty zostały wykonane już wcześniej .	wykonane	3	Masc3
Gwyneth przyznaje , że przez tych ostatnich kilka lat dojrzewała na zdwojonych obrotach .	zdwojonych	11	Masc3
Został obezwładniony przez policjantów .	obezwładniony	1	Masc1
Konkurs składał się z etapu ustnego i pisemnego .	ustnego	5	Masc3
Przeklęty widok przed oczy wystawił .	Przeklęty	0	Masc3
ZSRR zgodził się zwolnić zatrzymanych marynarzy .	zatrzymanych	4	Masc1
Ze stara wyciekał olej i płyn chłodzący , a przyczepa miała zdemontowany hamulec awaryjny .	chłodzący	6	Masc3
W opowieści biblijnej uderza ścisłość historyczna w odtwarzaniu obyczajów egipskich .	egipskich	9	Masc3
Zawsze i wszędzie jestem bezpieczny , w dzień i w nocy , w domu i poza domem , na ulicy i w samochodzie .	bezpieczny	4	Masc1
Sławny pianista utracił dłonie w wypadku , ale przeszczepiono mu ręce straconego mordercy .	Sławny	0	Masc1
Zarządca komisaryczny przestał pełnić ją dopiero po ostatnich wyborach samorządowych .	komisaryczny	1	Masc1
Krótko mówiąc , mam odpowiedniego człowieka .	odpowiedniego	4	Masc1
Wisła w Toruniu przekroczyła stan alarmowy o 80 cm , a wody wciąż przybywa .	alarmowy	5	Masc3
Przyjaciele mówią , że towarzysko jest miły , ale bywa bardzo złośliwy .	miły	6	Masc1
Jej niewinny wygląd nie zmylił policjantów .	niewinny	1	Masc3
I drugi go zastrzelił .	drugi	1	Masc1
Później innego uczestnika spotkania znaleziono martwego w jego domu letniskowym pod Belgradem .	innego	1	Masc1
Wybuch poważnie uszkodził luksusowe auto , ucierpiały też cztery inne samochody stojące na placu .	stojące	11	Masc3
Ostatnim punktem ćwiczeń było gaszenie pożaru .	Ostatnim	0	Masc3
Niestety , Sąd Rejonowy w Kutnie nie jest w stanie takowego uzasadnienia wydać .	Rejonowy	3	Masc3
W wózku wiozła 13-miesięcznego synka .	13-miesięcznego	3	Masc1
- Był to trójnożny garnek z brązu .	trójnożny	3	Masc3
– pokryte mają wszystkie języki . .	pokryte	1	Masc3
TWARDZIEL 1 pokazuje legitymację służb specjalnych .	1	1	Masc1
Ekolodzy zaopatrzyli młodszych kolegów w worki na śmieci i rękawiczki .	młodszych	2	Masc1
43-letni młodszy brygadier dmuchnął w alkomat .	43-letni	0	Masc1
Trzeba też dodać , że wkraczali śmy do Francji w czasie dość trudnym dla wzajemnych stosunków .	trudnym	12	Masc3
Przed wejściem do parku wszyscy zostali wyposażeni w lornetki .	wyposażeni	6	Masc1
Pod koniec roku 1977 chór liczył już 32 osoby .	1977	3	Masc3
Starym kawalerem zostanie i następcy zabraknie , tradycja garncarska w rodzinie Kraszewskich zaginie . . .	Starym	0	Masc1
Czy czujesz się samodzielnym człowiekiem ?	samodzielnym	3	Masc1
I tą karminową kredką nakreśliła trzeci werset , pod tamtymi .	trzeci	5	Masc3
Ale szybki zysk bywa celem nawet najpotężniejszych magnatów finansowych , bo rynki są wolatylne .	finansowych	8	Masc1
Nie jest z tych strachliwych .	strachliwych	4	Masc1
Oszołomiony znalazł się na ulicy .	Oszołomiony	0	Masc1
Patrzyła biernie , nie widząc niczego , na mijające za oknem podmiejskie pejzaże .	mijające	8	Masc3
Powodem były jego publiczne wypowiedzi na temat ludzi upośledzonych fizycznie .	upośledzonych	8	Masc1
Skontaktuję się z mamą trojaczków w najbliższych dniach .	najbliższych	6	Masc3
Przechodził on długą ewolucję , stając się najpopularniejszym tanim zegarkiem .	tanim	8	Masc3
Klasztor fundacji Gaszynów posiada sklepione cele i korytarze komunikacyjne .	komunikacyjne	8	Masc3
– ten krem jest taki margarynowy . .	margarynowy	5	Masc3
W tym roku zakres targów został rozszerzony o telekomunikację .	rozszerzony	6	Masc3
Przyjęcie odbywało się w starym pałacu cesarza .	starym	4	Masc3
Finansowo wspiera Trutnia Gminny Ośrodek Kultury w Rabie Wyżnej , a także skawiańscy biznesmeni z Polski i Chicago .	skawiańscy	12	Masc1
Siedział ponury na przedzie tramwaju , pod plastykowym dachem .	ponury	1	Masc1
Oczom Andrew ukazał się nieprawdopodobny widok .	nieprawdopodobny	4	Masc3
Przez godzinę z boiska wiało nudą , a piłkarze prezentowali futbol plażowy .	plażowy	11	Masc3
Czynią tak wspomniani starościna i starosta .	wspomniani	2	Masc1
Wysunął spomiędzy karminowych warg długi język i oblizał łakomie usta .	długi	4	Masc3
Do wytworzenia pary i utrzymywania ognia we właściwej temperaturze służy oddzielny palnik gazowy .	oddzielny	10	Masc3
Cela była wesoła , to byli komuniści przyzwyczajeni do defensywy .	przyzwyczajeni	7	Masc1
Długiego stażu małżeńskiego gratulował poseł Tadeusz Cymański .	małżeńskiego	2	Masc3
Zmarłych żołnierzy francuskich i bawarskich pogrzebano na cmentarzu przykościelnym .	Zmarłych	0	Masc1
Leżącego na trawie obok drogi mężczyznę zauważyły przejeżdżające tamtędy przypadkowe osoby .	Leżącego	0	Masc1
Most w Kuligach na rzece Jegrzni znajduje się w fatalnym stanie i grozi zawaleniem .	fatalnym	9	Masc3
– Musiał by m być szalony , żeby ci powiedzieć .	szalony	5	Masc1
Pierwsze gwiazdy toną w duszy młodego człowieka jak w górskim jeziorze .	młodego	5	Masc1
Nie do was jednych towar wożę .	jednych	3	Masc1
Uważano , że są one w dużym stopniu dziedziczne .	dużym	6	Masc3
Na tegorocznym inauguracyjnym balu tradycyjnego karnawału w Rio pracowały równolegle dwie komisje sędziowskie .	tegorocznym	1	Masc3
Pomyślano również o indywidualnych turnusach .	indywidualnych	3	Masc3
Miejscowy , brodaty duchowny czekał już przy ołtarzu .	Miejscowy	0	Masc1
Pieściła m się z chłopakiem w czasie moich dni płodnych .	płodnych	9	Masc3
Rozbiegli się Kaszubi , pod przymusem do tej walki pędzeni .	pędzeni	9	Masc1
Powołujesz się na intelektualnego i emocjonalneog kastrata , ale czego innego mogł em się po Tobie spodziewać ?	intelektualnego	3	Masc1
Komputery podłączone do Sieci mogą skorzystać z okna zadań badawczych .	podłączone	1	Masc3
Kocham polskich chłopów hodujących polską brukselkę . . .	hodujących	3	Masc1
O jej życie lekarze szpitala bielańskiego walczyli w nocy .	bielańskiego	5	Masc3
Następnym mówcą będzie pan poseł Alojzy Gąsiorczyk .	Następnym	0	Masc1
Miał je obezwładnić strzałem z pociskiem usypiającym .	usypiającym	6	Masc3
" Planowo postępuje dalsze ograniczanie arsenałów atomowych " . . .	atomowych	6	Masc3
Miejscowi Polacy zapowiadają zaskarżenie decyzji do sądu .	Miejscowi	0	Masc1
Po mszy świętej wyruszyła z bazyliki katedralnej i okrążyła Stary Rynek .	Stary	9	Masc3
Każdy duży sklep samoobsługowy lub mięsny wyposażono w krajalnice do wędlin .	mięsny	5	Masc3
Jednocześnie brakuje im czasu na zabiegi pielęgnacyjne .	pielęgnacyjne	6	Masc3
Detektyw precyzyjnym sztychem przeszył jego prawe ramię .	precyzyjnym	1	Masc3
Czy my żyjemy w jakimś kompletnie dzikim kraju ?	dzikim	6	Masc3
Wydawało się nieprawdopodobne , by po tylu godzinach wydostać malca żywego z pułapki .	żywego	10	Masc1
– no ukradł mi ten zbój ruski . .	ruski	6	Masc1
Bardzo często , kiedy był em wściekły i napięty , wypijał em na rozluźnienie piwko czy setkę .	napięty	8	Masc1
To pleban kawęczyński jechał dwukonnym wózkiem do miasta .	kawęczyński	2	Masc1
Wśród tradycjonalistów muzułmańskich z państw Półwyspu Arabskiego wywołało ono szok .	Arabskiego	6	Masc3
Internetowego pirata złapała łódzka policja .	Internetowego	0	Masc1
- Miły jesteś .	Miły	1	Masc1
Policja przypuszcza , że najnowszy ładunek został porzucony przez spłoszonego niedoświadczonego terrorystę .	niedoświadczonego	10	Masc1
Ciężki , kleisty lęk wypełnił jej serce .	kleisty	2	Masc3
Nie ma mocnych .	mocnych	2	Masc1
W pewnej chwili otworzył em oczy , wyrwany z gorączkowej drzemki jakimś ruchem .	wyrwany	7	Masc1
Najtragiczniejszy był czwartek .	Najtragiczniejszy	0	Masc3
Czykier został ukarany za niesportowy tryb życia , zaś Gierejkiewicz stracił zaufanie szkoleniowca .	niesportowy	4	Masc3
Zaraz wszedł podniecony Zdzisio .	podniecony	2	Masc1
Nieoczekiwanie i bardzo mocno uderzył w piersi łysego , wąsatego mężczyznę .	łysego	7	Masc1
Jeńcy wojenni listy piszą . . .	wojenni	1	Masc1
Czasy są takie niepewne .	niepewne	3	Masc3
my byli śmy pod to podpinani . .	podpinani	5	Masc1
Cały kraj był zdławiony tym okropnym cieniem .	zdławiony	3	Masc3
Nieuchwytny pozostał też poeta rywal Willa .	Nieuchwytny	0	Masc1
Być lojalnym .	lojalnym	1	Masc1
Cały świat czekał na tę decyzję .	Cały	0	Masc3
- Dokumenty dotyczące wyroku białostockiego sądu jeszcze nie trafiły do ministerstwa .	białostockiego	4	Masc3
Alibi było , ale przy okazji sfotografowano tego wysokiego , przystojnego mężczyznę .	przystojnego	10	Masc1
Z wolna milkły także widmowe instrumenty .	widmowe	4	Masc3
Jednocześnie jedynie co dziesiąty katolik uczestniczy regularnie w niedzielnej mszy , a co drugi wyjawia , że nie znajduje w Kościele odpowiedzi na nurtujące go pytania .	drugi	13	Masc1
Związkowcy , z którymi negocjuje od kilku dni , są nieugięci .	nieugięci	10	Masc1
Tam przejął mnie wywiad angielsko - amerykański .	amerykański	6	Masc3
Podobno seryjni mordercy różnią się od innych ludzi chromosomalnie ?	seryjni	1	Masc1
Naaman , naczelny wódz króla syryjskiego , był człowiekiem bogatym i możnym .	bogatym	9	Masc1
Wieczorny mrok gęstniał coraz bardziej w drobnym i dokuczliwym deszczu .	drobnym	6	Masc3
Tylko ulewa huczała nieprzerwanym , mokrym hukiem .	nieprzerwanym	3	Masc3
Na cóż pogłębiać straszliwy kryzys ?	straszliwy	3	Masc3
Praca w okupowanych szpitalach przebiega normalnie .	okupowanych	2	Masc3
Papier wydaje mi się ciepły .	ciepły	4	Masc3
Drugi zaplanowano na 2006 r.	Drugi	0	Masc3
Trzej pasażerowie byli pijani . . .	pijani	3	Masc1
Księżyc staje się jakby natrętnym partnerem .	natrętnym	4	Masc1
Rzecz dotyczy berlińskiej olimpiady w 1936 roku i przynależności państwowej triumfatora .	1936	5	Masc3
Odziedziczyła ona po bracie majątek w Galicji , uprzemysłowiony i dający duże profity .	duże	11	Masc3
Potem , gdy próbowali je sprzedać w Szanghaju , zostali zauważeni przez policję .	zauważeni	10	Masc1
Piękny Lolo z trudem dźwignął się na nogi .	Piękny	0	Masc1
Praca pedagogiczna na uniwersytecie japońskim różni się znacznie od pracy na uniwersytecie europejskim .	japońskim	4	Masc3
Urzędy skarbowe nie chcą nas zrozumieć .	skarbowe	1	Masc3
Ten niekorzystny stan pogłębia się .	niekorzystny	1	Masc3
Następnie Aleksander Zawadzki dokonał otwarcia muzeum w dziesiątym Pawilonie .	dziesiątym	7	Masc3
Ale trzeba na niego zapracować , zwłaszcza przed stresującym dniem .	stresującym	8	Masc3
Kradli telefony komórkowe , sprzęt komputerowy i inne cenne przedmioty .	komputerowy	5	Masc3
Tysiące zwiedzających oblegało stoiska .	zwiedzających	1	Masc1
W środku był też ciężko poparzony inny mężczyzna .	inny	6	Masc1
Myśli Pani , że jestem odosobnionym egzemplarzem ?	odosobnionym	5	Masc3
Posiadał wszechstronny , uniwersalny umysł obejmujący szereg nauk specjalnych .	uniwersalny	3	Masc3
Zasapany Mock zszedł ze stołu i włożył głowę do żeliwnego zlewu .	Zasapany	0	Masc1
Możesz z nim pójść do dowolnego obwodu .	dowolnego	5	Masc3
Nad falami sterczał jeszcze tylko wystrzelający pionowo dziób .	wystrzelający	5	Masc3
Tak jak w ubiegłym roku może nie starczyć pieniędzy na grudniowe pensje dla nauczycieli .	ubiegłym	3	Masc3
Dynamiczny spektakl przyciągnął uwagę przechodniów .	Dynamiczny	0	Masc3
Obu szwedzkim dyplomatom zarzucono też działalność wykraczającą poza ich oficjalny status .	szwedzkim	1	Masc1
Przemawiał głosem miękkim i melodyjnym .	melodyjnym	4	Masc3
- Słyszę silny szum i tętnienie .	silny	2	Masc3
W odpowiednim sklepie za 350 zł sprzedadzą każdemu .	odpowiednim	1	Masc3
W ostatnich dniach klub został niemal sparaliżowany przez wewnętrzne konflikty .	ostatnich	1	Masc3
Są oni gorąco pozdrawiani przez zgromadzone na trasie tłumy .	pozdrawiani	3	Masc1
Pei Fan nie odzywał się , pogrążony we własnych myślach .	pogrążony	6	Masc1
Był zmieszany .	zmieszany	1	Masc1
Pokazuje nam odpowiedni dokument panamski i dwa zaświadczenia .	odpowiedni	2	Masc3
Zmieniały się tylko nazwiska i wielkość zdeprawowanych pieniędzy .	zdeprawowanych	6	Masc3
Mój czcigodny ojciec wielce poważał tego mistrza .	czcigodny	1	Masc1
Stary zegar stojący na komodzie tyka natrętnie .	Stary	0	Masc3
Jesteś nieskomplikowany .	nieskomplikowany	1	Masc1
Wczoraj dopiął swego , chociaż musiał sporo dołożyć do umówionych wcześniej 300 tysięcy .	umówionych	9	Masc3
Znał Andrzeja Zawadę i innych polskich himalaistów .	polskich	5	Masc1
Na wdrożenie całego systemu Wapark ma osiem miesięcy .	całego	2	Masc3
W kraju nad Wisłą dominującym gatunkiem jest Polakatolik .	dominującym	4	Masc3
Wśród oceniających zasiadły trzy blondynki .	oceniających	1	Masc1
Najbardziej narażone na skargi niezadowolonych klientów są placówki handlowe .	niezadowolonych	4	Masc1
Jest usłużny i poręczny .	usłużny	1	Masc1
Dzień wstał szary i niemrawy .	niemrawy	4	Masc3
- Wystarczą gumowe .	gumowe	2	Masc3
Przekazuj zasady prostym językiem .	prostym	2	Masc3
Zapomnij też o wszelkich środkach uśmierzających ból .	uśmierzających	5	Masc3
Zakaz nic nie mówi o tasakach lub półmetrowych nożach kuchennych . . .	kuchennych	9	Masc3
Architekci opracowujący rysunki robocze są zazwyczaj wieloletnimi praktykami .	wieloletnimi	6	Masc1
A teraz , przez tę ciążę , jesteśmy uziemieni .	uziemieni	8	Masc1
Jeszcze w 1576 , jak wspominają akta wizytacyjne , mieszkali tu wolni Prusowie .	1576	2	Masc3
Na ekranie TV , na zatrzymanej stop-klatce Jurka Kilera idą napisy końcowe programu .	końcowe	11	Masc3
Milicjant , krostowaty młokos , długo spisywał jej zeznanie .	krostowaty	2	Masc1
Zachęcany , aby również w czasie Wielkiego Tygodnia zrezygnować z oglądania telewizji .	Wielkiego	6	Masc3
Młodego dja , pochodzącego z Głogowa , wylansował dj Adamus .	Młodego	0	Masc1
Kwaśniewski znów okaże się sympatycznym facetem .	sympatycznym	4	Masc1
To był pierwszy od dwóch tygodni gorący posiłek .	gorący	6	Masc3
Jest usłużny i poręczny .	poręczny	3	Masc1
Wtedy jest szczęśliwy , odprężony .	odprężony	4	Masc1
Dzisiaj jeszcze nie może , niestety , zaproponować kontraktu , ale następnym razem będę miał pełną jasność .	następnym	11	Masc3
Następne mają się już pojawiać co miesiąc .	Następne	0	Masc3
Jednocześnie jedynie co dziesiąty katolik uczestniczy regularnie w niedzielnej mszy , a co drugi wyjawia , że nie znajduje w Kościele odpowiedzi na nurtujące go pytania .	dziesiąty	3	Masc1
Przy ośrodkach będzie się prowadzić także punkty apteczne .	apteczne	7	Masc3
Pierwsze rzeźby wykonał w latach dwudziestych .	dwudziestych	5	Masc3
– Zakładamy klub muzyczny .	muzyczny	3	Masc3
Drzwi uchyliły się z lekkim skrzypieniem nie naoliwionych zawiasów .	naoliwionych	7	Masc3
Teraz do kontrakcji przystąpili wszyscy ludzie przegranego Rybnika .	przegranego	6	Masc3
Do spraw o pobicia i gwałty doszedł pozew rozwodowy żony .	rozwodowy	8	Masc3
Całe starostwo spiskie od 1591 do 1745 roku należało do Lubomirskich .	1591	4	Masc3
Siedemdziesięciu chorych leżało na słomianych barłogach we własnym kale .	słomianych	4	Masc3
Najwyższe sięgały nawet 180 cm .	Najwyższe	0	Masc3
To były jakieś bardzo ożywione dni .	ożywione	4	Masc3
Jeszcze inne sądziły , że to zwykły zabieg .	zwykły	6	Masc3
Wśród przywiezionych jest jeden noworodek .	przywiezionych	1	Masc1
Chcą nam obciąć 200 ton i dać gorszy .	gorszy	7	Masc3
A przynajmniej choćby na jakiś czas powstrzymać zalewający kraj rewolucyjny potop .	zalewający	7	Masc3
Deser zostanie podany po sprzątnięciu talerza głównego .	głównego	6	Masc3
Sprawić , że będą niepotrzebne .	niepotrzebne	4	Masc3
Tymczasem komandor zatrzaśnięty w samochodzie wydzwaniał z telefonu komórkowego do znajomych .	zatrzaśnięty	2	Masc1
Urodę stołu znakomicie podniosą antyczne lichtarze ze świecami , kryształy i srebra .	antyczne	4	Masc3
Dzieci i niektórzy renciści byli by zwolnieni z opłaty .	zwolnieni	6	Masc1
– Płynie ogromny transport z demograficznym wyżem .	demograficznym	5	Masc3
Poderwali się z ziemi i skoczyli ku leżącym Niemcom .	leżącym	7	Masc1
Port gazowy to dla nas żadne rozwiązanie .	gazowy	1	Masc3
Spodziewa się Pan , że wyższy wzrost gospodarczy przyniesie wyższe dochody z podatków ?	wyższe	9	Masc3
- Pan jest nieszczęśliwy .	nieszczęśliwy	3	Masc1
Jako pierwszy zabierze się do ciebie honorowo obłędny rycerz Eyck z Denesle !	obłędny	7	Masc1
To jest ważny moment .	ważny	2	Masc3
Będą potrzebne ?	potrzebne	1	Masc3
Rozmawiają o tamilskich i hinduskich filmach .	tamilskich	2	Masc3
- Jakie były założenia na 2005 rok ?	2005	5	Masc3
Reagował jak ideowy socjalista .	ideowy	2	Masc1
Tam czekał już pluton egzekucyjny , dowodzony przez podoficera .	dowodzony	6	Masc3
Przyjechali popołudniowym pociągiem .	popołudniowym	1	Masc3
Można też utworzyć na takie pliki specjalny folder na pulpicie .	specjalny	6	Masc3
Staruszkowie skwapliwie wyściskali Pindla , a on stał oszołomiony .	oszołomiony	8	Masc1
Jeżeli jesteś za granicą , głosuj z ważnym polskim paszportem .	ważnym	7	Masc3
Czy czynniki religijne nie ograniczają wolności wyborów politycznych obecnego rządu ?	politycznych	7	Masc3
W młodości stuprocentowy reakcjonista , antysemita , obecnie uważa się za liberała .	stuprocentowy	2	Masc1
Z konarów i pni wyczarowywał dziwne figury przywołujące na myśl słowiańskich bogów .	słowiańskich	10	Masc1
Był em tym zachwycony i chodził em po Akademii dumny jak paw .	dumny	9	Masc1
Berliński adwokat miał pracować w telekomunikacji .	Berliński	0	Masc1
Już Pitagorejczycy znali podobno wszystkie najbardziej regularne wielościany nazywane foremnymi .	regularne	6	Masc3
Franka , czterdziestoletniego chłopa , te rzeczy nie obchodzą wcale .	czterdziestoletniego	2	Masc1
Podobny spis już istnieje .	Podobny	0	Masc3
