W środku był też ciężko poparzony inny mężczyzna .	poparzony	5	Masc
Takie parlamentarne metody nie odpowiadają mi , rozumiecie ?	parlamentarne	1	Fem
W innych miejscach znaleziono wyszlifowane i porysowane przedkarbońskie skały podłoża .	porysowane	6	Fem
Zbierał te suche rozstajne krótkie drogi , wiązał w pokaźne drapadła o ściśniętym kierunku .	pokaźne	9	Neut
Przed tygodniem wicestarosta Hrycyna podczas wyjazdu do Gdańska uzyskał przychylność tamtejszych środowisk żydowskich .	żydowskich	12	Neut
Kilka par tańczyło w przyćmionym świetle , które zdawało się być substancją podobną do mgły z tiulu .	przyćmionym	4	Neut
– Jakie są Pani najbliższe plany zawodowe ?	zawodowe	6	Masc
Zauważono też nagminne zaniżanie zarobków pracowników za dni urlopowe lub chorobowe .	urlopowe	8	Masc
Po rzucie rożnym obrońcy Vardaru zbyt wolno wychodzili spod swojej bramki , podanie z linii pola karnego dotarło do Kucharskiego , a ten strzelił , stojąc tyłem do bramki .	karnego	16	Neut
Rada Nadzorcza towarzystwa na wczorajszym posiedzeniu pominęła sprawy personalne .	personalne	8	Fem
Doświadczenia z dzieciństwa spędzonego w rodzinie alkoholowej u wielu mężczyzn i kobiet owocują w dorosłym życiu utrwalonymi schematami odczuwania , zachowania i myślenia .	spędzonego	3	Neut
Pierwsza uczestniczka zaśpiewa o miłości przyprawianej różnymi smakami .	przyprawianej	5	Fem
Wilk odprowadzał go wzrokiem , aż ciemna sylwetka rozpłynęła się w mroku korytarza .	ciemna	6	Fem
Mówmy , że ktoś nieśmiały jest też bardziej wrażliwy , milszy .	milszy	10	Masc
Bardzo dobrze rozpoczął się także dla Towarzystwa 1999 rok .	1999	7	Masc
Przedostatni figuruje Artur Balazs , poseł i minister rolnictwa , a zamyka ją Stefan Oleszczuk z UPR-u , starosta kamieński .	Przedostatni	0	Masc
Potrząsnął em głową ; połączenie zostało zerwane .	zerwane	6	Neut
Zanieczyszczenia cytoplazmatyczne i błonowe są również groźne , stanowiąc prawdopodobne źródło zarówno aktywności proteolitycznej , jak i białek cytoplazmatycznych w puli niehistonowej .	cytoplazmatycznych	18	Neut
Upragnioną miłość zanurzył eś w najpodlejszym , cuchnącym bagnie .	najpodlejszym	5	Neut
Zdesperowany doktor wlał płyn do dezynfekowania narzędzi chirurgicznych do dużego naczynia , włożył w płyn zaganiacza , zamieszał .	chirurgicznych	7	Neut
Pana podpis jest nieważny ?	nieważny	3	Masc
Za każdy samochód zabierali się od razu mechanicy , zmieniali koła , usuwali uszkodzenia powstałe w czasie forsownego treningu , wymieniali zdarte nakładki hamulcowe , regulowali silniki .	zdarte	21	Fem
Na razie jest kicha , bo spółki samorządowe i prywatne mają tylko 5 proc . łóżek .	samorządowe	7	Fem
Odtąd była dla mnie znaczącym nazwiskiem i wiele się po niej spodziewałem .	znaczącym	4	Neut
Kołdra i ściągnięte z materaca prześcieradło dziwaczną draperią zwisało z łóżka .	dziwaczną	6	Fem
Sesja była jawna .	jawna	2	Fem
– Zidentyfikował z uśmiechem suknię , kupioną w salonie Coco Chanel .	kupioną	6	Fem
Akceptacja wyraża obiektywną prawdę o człowieku , a nie tylko subiektywne przeżycia jednostki .	subiektywne	10	Neut
Ewentualna ratyfikacja Konkordatu przed przyjęciem nowej konstytucji zaważyłaby zapewne na jej ostatecznym brzmieniu , odbierając Konstytucji RP charakter nowoczesnej ustawy zasadniczej demokratycznego państwa .	demokratycznego	21	Neut
Trzymiesięczne owczarki niemieckie pochodzą z wyspecjalizowanej hodowli ze Słowacji .	niemieckie	2	Masc
Załogi z niepokojem śledzą ciche chmury nadchodzące z południa .	ciche	4	Fem
Siedział ponury na przedzie tramwaju , pod plastykowym dachem .	plastykowym	7	Masc
Najbardziej alergogennym składnikiem kosmetyków są środki zapachowe .	zapachowe	6	Masc
Także usługi ogólnobudowlane prowadzi drugi z odznaczonych , pan Marek Nosal .	odznaczonych	6	Masc
Zdjąć te cholerne obrazki po właścicielu .	cholerne	2	Masc
Zakup tego urządzenia pozwoli wykonywać podstawowe analizy na miejscu w Brzeziu , bez konieczności wyjazdu chorego do Gminnego Ośrodka w Kłaju .	podstawowe	5	Fem
Piłsudczycy nie dopuścili do dyskusji w Sejmie , który zresztą został rozwiązany 30 sierpnia 1930 r . , w połowie kadencji .	1930	14	Masc
Informuję , że zgłosili się posłowie w celu wygłoszenia oświadczeń poselskich .	poselskich	10	Neut
Rybka powędrowała do akwarium ustawionego przez asystentkę na stoliku .	ustawionego	4	Neut
Jednocześnie następują dynamiczne , ale dostosowane do realiów społecznych i kapitałowych przekształcenia własnościowe .	własnościowe	12	Neut
No kto , na przykład , zbudował radziecką bombę atomową ?	atomową	9	Fem
Pierwej im się te chabazie świeżym kwieciem pokryją .	świeżym	5	Neut
Potrząsnąłem głową ; połączenie zostało zerwane .	zerwane	5	Neut
Syn pana Bogdana raz sam się przekonał , jak wygląda opieka nad niepełnosprawnymi na porządnym zachodnioeuropejskim poziomie .	porządnym	14	Masc
Spostrzegł , że opuściła głowę i zaciskała poruszające się nerwowo usta .	poruszające	7	Neut
Prześcieradło było częściowo z materaca ściągnięte .	ściągnięte	5	Neut
Kolejny pijany policjant straci pracę .	Kolejny	0	Masc
Pierwsze gwiazdy toną w duszy młodego człowieka jak w górskim jeziorze .	górskim	9	Neut
Było jeszcze wtedy w granicach typowych dla Tadzia .	typowych	5	Fem
W piątek życzenia od przedstawicieli władz miejskich , kolejowych i zaproszonych gości odebrał dyrektor ZSET Kazimierz Maćkowiak .	zaproszonych	10	Masc
Posługując się nim z szermierczą precyzją i taneczną lekkością , można grać na barwnych strunach duszy .	szermierczą	4	Fem
Władza jest mocna .	mocna	2	Fem
Nie narzeka na brak pomysłów twórczych .	twórczych	5	Masc
Co kwartał wysokość tych kwot może się zmienić w związku ze zmianą ceny metra kwadratowego ogłaszaną przez GUS .	ogłaszaną	15	Fem
Zdyszany , wyprężył się przed Dziadoniem .	Zdyszany	0	Masc
Nawiązano współpracę z kołami gospodyń wiejskich w Domatkowie , Kolbuszowej Górnej , Nowej Wsi , Weryni i Widełce .	Górnej	10	Fem
Należy przeprowadzić żmudne badania techniczne .	techniczne	4	Neut
Węże są zwierzętami mało poznanymi , niezwykłymi i fascynującymi .	fascynującymi	8	Neut
Wybielona światłem twarz nie miała żadnego wyrazu .	Wybielona	0	Fem
Dodaje , że prace rozbiórkowe rozpoczną się prawdopodobnie już dziś .	rozbiórkowe	4	Neut
Trzech innych wytoczyło księdzu oddzielny proces .	oddzielny	4	Masc
Wybuch poważnie uszkodził luksusowe auto , ucierpiały też cztery inne samochody stojące na placu .	stojące	11	Masc
- Obrzuciła go karcącym spojrzeniem .	karcącym	3	Neut
Nie mogła się mylić , bo odbite od łez światło dawało wyraźny błysk .	odbite	6	Neut
To trudne przyglądanie się sobie było ważne .	trudne	1	Neut
Z trudem dostrzegam siedzących pod oknem Stefana i Wiktora .	siedzących	3	Masc
Popierają regionalne środowiska twórcze .	twórcze	3	Neut
Ale ramy , instytucje i aspiracje Cesarstwa narzuciły się apostołom , biskupom , kapłanom i wiernym jako odniesienie oczywiste i nieuniknione .	oczywiste	18	Neut
Nadmieniamy , że w pierwszą niedzielę lutego br . przeprowadzono zbiórkę pieniędzy na zakup niezbędnego urządzenia medycznego do pracowni analitycznej w Wiejskim Ośrodku Zdrowia w Brzeziu .	Wiejskim	21	Masc
Przekształcenie osad rolniczych w osady przemysłowe wprowadziło do nich kapitalistyczne stosunki .	kapitalistyczne	9	Neut
Strzelił palcami i obok niego pojawiła się puchata chmura .	puchata	7	Fem
Wzrost gospodarczy się utrzymuje .	gospodarczy	1	Masc
Spotkanie w urzędzie wywarło na wszystkich jego uczestnikach niesamowite wrażenie .	niesamowite	8	Neut
A zatem światło jest zawsze wewnętrzne .	wewnętrzne	5	Neut
Pierwsza udana synteza nowego pierwiastka przeprowadzona została w 1940 roku .	1940	8	Masc
Budapeszteńska giełda ma i inne poważne problemy .	Budapeszteńska	0	Fem
Kolejna dokonała kradzieży w sklepie .	Kolejna	0	Fem
Dzisiejsza konfrontacja z łódzkimi zespołami , które mają pierwszoligowe aspiracje , zapowiada się niezwykle ciekawie .	Dzisiejsza	0	Fem
Ale później , w latach sześćdziesiątych , wywiązała się intensywna publiczna debata na temat stosunków polsko - niemieckich . . .	intensywna	9	Fem
Już sama wiadomość o jego śmierci była spóźniona .	spóźniona	7	Fem
Wczoraj dopiął swego , chociaż musiał sporo dołożyć do umówionych wcześniej 300 tysięcy .	umówionych	9	Masc
Ameryka nie marzy o czymś jeszcze trudniejszym niż Irak i Afganistan .	trudniejszym	6	Neut
- To jest willa bliźniacza , prawda ?	bliźniacza	4	Fem
- Nie widzę dalszych pytań .	dalszych	3	Neut
W tym dniu życzenia owocnych obrad przekazali zjazdowi przewodniczący delegacji partii komunistycznych i robotniczych z krajów socjalistycznych .	socjalistycznych	16	Masc
Na ostateczną cenę kredytu wpływ mają opłaty dodatkowe , których banki żądają od klientów .	ostateczną	1	Fem
Postanowienie może być wydane na posiedzeniu niejawnym .	wydane	3	Neut
Akredytacja państwowa jest obowiązkowa i powszechna .	państwowa	1	Fem
Oceniając strajk , Gawin oświadczył , że ruch towarowy praktycznie się nie odbywał , a na Śląsku stanęło wiele pociągów pasażerskich .	towarowy	8	Masc
Rozpędzonej karuzeli stanowisk nie zatrzymała minister Piwnik , choć przez pierwsze pół roku urzędowania wstrzymywała się ona z ruchami kadrowymi .	Rozpędzonej	0	Fem
W miniony czwartek w referendum ratyfikacyjnym Irlandia odrzuciła ten Traktat , otwierający drogę do rozszerzenia Unii .	ratyfikacyjnym	5	Neut
Jak planował , pojechał do Jurka wczesnym popołudniem .	wczesnym	6	Neut
Kiedy w Banja Luce skończył się ostatni , decydujący o medalu mecz , Halina leżała na parkiecie , a na niej kłębiła się góra ciał .	decydujący	8	Masc
Jak odróżnić kuropatwę młodą od starej ?	starej	5	Fem
Spora część delegatów , reprezentujących zwłaszcza środowiska młodzieżowe , zaprezentowała alternatywny wobec projektu kierownictwa program .	Spora	0	Fem
Znaleziono przy nich skradzione zegarki oraz pistolet - straszak .	skradzione	3	Masc
W mieście zainstalowana jest starego typu centrala elektromechaniczna .	zainstalowana	2	Fem
Niebo było pokryte białymi barankami .	pokryte	2	Neut
Dziwnym trafem niezależne spółki węglowe zaproponowały bardzo podobne podwyżki .	węglowe	4	Fem
Manifestanci próbowali uniemożliwić policji zamykanie biur zdelegalizowanego ugrupowania .	zdelegalizowanego	6	Neut
Nie możemy płacić więcej , kiedy fabryka jest nierentowna .	nierentowna	8	Fem
Nadal jednak będzie PSL przeciwnikiem gospodarki wolnorynkowej , partią w podejściu do gospodarki lewicową .	lewicową	13	Fem
Nad ranem cała trójka zostaje wyciągnięta ze swych domów i trafia do aresztu .	wyciągnięta	5	Fem
Stary wiadukt przy ulicy Oświęcimskiej stanowił ogromną uciążliwość dla kierowców .	Oświęcimskiej	4	Fem
Cena wywoławcza czarnego watermana ze złotą stalówką wynosiła 300 zł .	wywoławcza	1	Fem
Kwity wykłada sympatyczny i kulturalny pan po pięćdziesiątce .	sympatyczny	2	Masc
Lubi dobrą muzykę i piesze górskie wycieczki .	piesze	4	Fem
Doznał poważnych obrażeń ciała i przebywa w szpitalu .	poważnych	1	Neut
A na czym polega wasza działalność gospodarcza ?	gospodarcza	6	Fem
Tom Spencer posiadał przy sobie pisma pornograficzne i kasety video dla homoseksualistów oraz marihuanę .	pornograficzne	6	Neut
- Musimy zebrać ludzi , którzy chcą dokończyć rozpoczęte w 1981 roku dzieło .	1981	10	Masc
Papieski gest odnotowała wczoraj włoska prasa .	Papieski	0	Masc
Nie wstąpi jego stopa junacka w strzemiona ojcowe .	ojcowe	7	Neut
Później były aresztowania brzeskie i w listopadzie wybory parlamentarne w atmosferze terroru , które dały BBWR większość w nowym Sejmie .	nowym	18	Masc
Gdy odbywa służbę wojskową w Maroku , wielkie wrażenie robi na nim głęboka religijność wyznawców Islamu .	głęboka	12	Fem
Inny facet postanowił , że postawi stację z gazem do samochodów przy ul. Warszawskiej .	Warszawskiej	13	Fem
- Nie ma idealnego systemu .	idealnego	3	Masc
Tym razem zapowiada się liczniejsze grono .	liczniejsze	4	Neut
Partyjni stratedzy planują więc przedsięwzięcia z myślą o wyborach dalszych , tych pojutrze .	dalszych	9	Neut
Podejmowane są zobowiązania indywidualne i zespołowe .	zespołowe	5	Neut
Austria i carska Rosja niszczyły je dalej systematycznie .	carska	2	Fem
Trzecie miejsce przypadło Zakładowi Poprawczemu z Kcyni .	Poprawczemu	4	Masc
Samo uznanie jej istnienia wymaga niemal religijnej wiary .	religijnej	6	Fem
Ta grupa została wymieniona na pierwszym miejscu .	wymieniona	3	Fem
Wrześniowe wybory zmieniły polityczny układ parlamentu .	Wrześniowe	0	Neut
A co w sercu nosił ten pan możny ? . . .	możny	7	Masc
– Niech się pani nie martwi , ta pani Marysia to niezwykle urocze dziecko .	urocze	12	Neut
Sprawa wywołała wielkie emocje .	wielkie	2	Fem
Wcześniej za największe osiągniecie uważał dwukrotne zwycięstwo w Memoriale Zakrzewskiego w Kędzierzynie-Koźlu .	dwukrotne	5	Neut
Wystarczy zwisający kabel od czajnika elektrycznego .	elektrycznego	5	Masc
Przy podniesieniu w czasie mszy używa się według Antegnatiego solowego rejestru pryncypalnego o bardzo delikatnym brzmieniu .	solowego	9	Masc
Trudne warunki pozwolą co najwyżej wymyśleć cieplejszy korzuch .	Trudne	0	Neut
Te wątki pojawiają się też w poselskim projekcie .	poselskim	6	Masc
Nagranie wykazało , że w przestępstwie pomagali ochroniarzowi dwaj inni młodzi mężczyźni .	młodzi	10	Masc
Pomysł powstał podczas uzupełniania ksiąg parafialnych , które były skrupulatnie sprawdzane podczas duszpasterskich wizytacji .	duszpasterskich	12	Fem
Od 1998 roku funkcjonuje w FSB wydział bezpieczeństwa komputerowego i informacyjnego .	komputerowego	8	Neut
Śniegi leżały głębokie , rozsierdziła się zima w tym roku .	głębokie	2	Masc
Armia izraelska odwołała ćwiczenia i manewry .	izraelska	1	Fem
Powstały wówczas Prusy Zakonne .	Zakonne	3	Neut
Telewizor stoi na małym stoliczku .	małym	3	Masc
- Mimo stacjonujących w Groznym wojsk i patroli Rosjanie nie będą się tam czuli bezpiecznie .	stacjonujących	2	Neut
Przez pierwszy tydzień leżą ukryte w wysokiej trawie , a następnie zaczynają wędrować za matką .	ukryte	4	Neut
Zarzuca mu pranie brudnych pieniędzy , płatną protekcję i udział w zorganizowanej grupie przestępczej .	brudnych	3	Masc
- Może zwrócę się o pomoc finansową do Wojewódzkiego Funduszu Ochrony Środowiska .	Wojewódzkiego	8	Masc
Planiści wypracowali już koncepcję drogi , na której przeobrażenie to winno się odbyć kosztem możliwie minimalnych ofiar .	winno	10	Neut
Silny Sojusz na pewno będzie skrupulatnie punktował potknięcia koalicjantów .	Silny	0	Masc
Po zawarciu nowego pokoju w połowie trzynastego stulecia Swiętopełk nową , piątą z rzędu wojnę rozpoczął .	trzynastego	6	Neut
I są dobrymi gospodarzami .	dobrymi	2	Masc
Kołdra i ściągnięte z materaca prześcieradło dziwaczną draperią zwisało z łóżka .	ściągnięte	2	Neut
- Lubimy zaglądać do takich dużych centrów .	dużych	5	Neut
Dziś w biznesowej działalności wspiera młodzieńca mamusia .	biznesowej	2	Fem
Wycina się je tam dla celów rolniczych i hodowlanych A NIE PAPIERNICZYCH !	hodowlanych	8	Masc
Tam weterynarz przeprowadził sekcję , z której jasno wynika , że pies padł z powodu wysokiej temperatury .	wysokiej	15	Fem
- Zgromadziliśmy tu najstarsze i najładniejsze kostiumy .	najładniejsze	5	Masc
W takich warunkach niczego dobrego nie napiszę .	dobrego	4	Neut
Rudowłosa pani Hania błyskawicznie wydawała karty drogowe , tablice rajdowe , plakietki , oficjalne itinerery .	rajdowe	9	Fem
Przedstawione powyżej podejścia , koncepcje i metody dają duży wybór w określeniu docelowego modelu alokacji .	Przedstawione	0	Neut
Stare gmachy , dostojne i omszałe , coraz bardziej upodobniają się do mamutów , wchłanianych w błoto epoki polodowcowej .	Stare	0	Masc
– Ja w każdym razie wybieram chłodny prysznic .	chłodny	6	Masc
W przypadku kręgowców naszej strefy klimatycznej były by to zależności zbyt uproszczone .	klimatycznej	5	Fem
To bardzo miłe hobby .	miłe	2	Neut
Dostrzegł pędzącego byka .	pędzącego	1	Masc
Służy do tego oddzielne naczynko o chropowatym dnie , pozwalającym ptakowi w kąpieli pewnie stać na nóżkach .	oddzielne	3	Neut
- W spadku po odchodzącej ekipie nowy rząd otrzymuje olbrzymi deficyt w bilansie handlowym .	odchodzącej	4	Fem
Chwalili , a sala była spokojna .	spokojna	5	Fem
Po miesiącu zdałam egzamin i przeniesiono mnie do drugiej klasy , do innej szkoły .	drugiej	8	Fem
Traktuje Beatę jak córkę , służy radą i wsparciem psychicznym .	psychicznym	9	Neut
Wykop i południowe baraki są w jednej linii .	południowe	2	Masc
Po 6,5-godzinnej burzliwej dyskusji sejmowa komisja kultury przyjęła wczoraj projekt budżetu kultury i budżetu radia i telewizji .	sejmowa	4	Fem
Chwilę manipulował przełącznikami i nagle w głośniku odezwał się wysoki , dźwięczny ton .	dźwięczny	11	Masc
W listopadzie 1946 r . powróciła do Olkusza , by nadal uczyć rysunków .	1946	2	Masc
Osadza się na odzieży oraz trwałych nieprzepuszczalnych powierzchniach takich jak beton czy asfalt .	nieprzepuszczalnych	6	Fem
Dlatego językiem oficjalnym stał się arabski , a dąży się , by stał się językiem ogólnonarodowym .	arabski	5	Masc
Dotknął wilgotnego ręcznika w łazience , pogładził mięsistą połę szlafroka , powąchał mydło w cedrowej kasetce .	wilgotnego	1	Masc
Widzę na tej rycinie stojącą po lewej stronie grupkę ludzi ubranych w proste , długie szaty , którzy wskazują palcem na człowieka pogrążonego w przyjacielskiej pogawędce z diabłem .	stojącą	4	Fem
To wstrząs anafilaktyczny .	anafilaktyczny	2	Masc
Czy produkty żywnościowe są u was w wystarczającej ilości ?	wystarczającej	7	Fem
Twierdził , że jest nieśmiertelny i że zamierza zbawić świat .	nieśmiertelny	4	Masc
Listę tę prezydent Stanów Zjednoczonych przekazał w poniedziałek innym państwom .	Zjednoczonych	4	Neut
Małe szare oczka wpatrywały się we mnie drwiąco , wyraźnie triumfowała .	Małe	0	Neut
Uważają nas za moskalofilów , takich zaprzańców antyukraińskich , podczas gdy sami deklarują ukraiński patriotyzm .	sami	11	Masc
Komara wyprodukowała brytyjska firma Compound Security .	brytyjska	2	Fem
Biała plama zniknęła , cały glob był opasany siecią wspólnot .	opasany	7	Masc
A oni wyglądają na kompletnie nieprzytomnych . . .	nieprzytomnych	5	Masc
Nadal będą funkcjonować w mediach dzięki swemu wiecznie odrębnemu zdaniu .	odrębnemu	8	Neut
Ciągnąc go za rękaw , zmusiła do obrócenia się wśród otaczającego ich korowodu .	otaczającego	10	Masc
Gwyneth przyznaje , że przez tych ostatnich kilka lat dojrzewała na zdwojonych obrotach .	zdwojonych	11	Masc
- Czy nie zabrakło woli politycznej do osądzenia komunistycznych zbrodniarzy ?	komunistycznych	8	Masc
20-letni żołnierz z jednej z kołobrzeskich jednostek wojskowych zastrzelił się na warcie w nocy z soboty na niedzielę .	kołobrzeskich	5	Fem
Całowała go drobnymi , szybkimi pocałunkami .	szybkimi	4	Masc
Były najdłuższe dni roku .	najdłuższe	1	Masc
Bo nie przemija miłość do słów wypowiadających prawdę stałą , wieczną .	wypowiadających	6	Neut
Jedną rękę trzymał na pniu .	Jedną	0	Fem
Ugryzienia osy , pszczoły , trzmiela i szerszenia mogą być niebezpieczne .	niebezpieczne	10	Neut
Rany odniosła także jeszcze jedna bawiąca wówczas w lokalu ukraińska niewiasta .	ukraińska	9	Fem
Większość ugrupowań postanowiła wyciszyć swe kampanijne działania .	kampanijne	5	Neut
Powoduje wysokie bezrobocie i sprawia , że państwo zadłuża się na bardzo wysoki procent .	wysokie	1	Neut
Okaz ten jest chroniony przez Konwencję Waszyngtońską .	chroniony	3	Masc
W nadchodzącym tygodniu wyznaczone zostały posiedzenia czterech komisji sejmowych .	nadchodzącym	1	Masc
Miał całkowitą rację .	całkowitą	1	Fem
Nie kieruję się przy tym ideologią wegetariańską , choć z nią sympatyzuję .	wegetariańską	6	Fem
Spojrzał na mnie zaskoczony .	zaskoczony	3	Masc
Taki czek nie może być bezpośrednio zamieniony na gotówkę .	zamieniony	6	Masc
Tymczasem w liceach prowadzonych przez Społeczne Towarzystwo Oświatowe zdanie egzaminu dojrzałości nie należy do najłatwiejszych .	Społeczne	5	Neut
Orzechowe oczy garncarza wpatrzyły się badawczo w twarz Kaliasa .	Orzechowe	0	Neut
Słońce prażyło niemiłosiernie , a na domiar złego wykończyły się zapasy żywności i wody .	złego	7	Neut
Niewielkie zmiany odczują osoby oddające krew .	Niewielkie	0	Fem
W siedzibie kłodzkiego starostwa powiatowego dowiaduję się , że Średzińskiego nie lubią tu , bo to postkomuch , a powiatem rządzi egzotyczna koalicja złożona z platformersów i byłych pisowców .	egzotyczna	21	Fem
Ponad 20 ulic będzie wyłączonych z ruchu w związku ze Świętem Zmarłych .	wyłączonych	4	Fem
Członkowie nakielskiego stowarzyszenia podczas spotkania omówili główne cele swojej działalności .	nakielskiego	1	Neut
To również efekt poddawania takich produktów szybkiej obróbce termicznej .	termicznej	8	Fem
Porastają ją wiekowe akacje , lipy i inne drzewa liściaste .	wiekowe	2	Fem
Irga rozkrzewiona to jeden z najpiękniejszych gatunków o wspaniałym jesiennym przebarwieniu liści , również obficie owocujący .	jesiennym	9	Neut
W ludzkich osiedlach słonie szukają pożywienia .	ludzkich	1	Neut
Potrawy były oceniane przez 110 niezależnych sędziów .	niezależnych	5	Masc
Na muzeum przeznaczono część parteru drewnianego budynku .	przeznaczono	2	Neut
Kamienny młot człowieka uderzał w furii we włochatą pierś zwierzęcą .	włochatą	7	Fem
Po jego obu bokach zwisają nawleczone na sznur perły nazywane Paternoster .	nawleczone	5	Fem
W miniony czwartek w referendum ratyfikacyjnym Irlandia odrzuciła ten Traktat , otwierający drogę do rozszerzenia Unii .	miniony	1	Masc
Mamy nadzieję , że Państwowa Komisja Wyborcza zainteresuje się tym trikiem .	Państwowa	4	Fem
W tym czasie moim serdecznym przyjacielem stał się koń .	serdecznym	4	Masc
Nowe realia wymagają innego typu zachowań i pomysłów .	innego	3	Masc
Nikt tego nie lubi i to jest zrozumiałe .	zrozumiałe	7	Neut
Bez niego cisza staje się martwa , sieroca .	martwa	5	Fem
Po parku z miniaturowym ogrodem zoologicznym snują się gromadnie dzieci .	miniaturowym	3	Masc
Chyba to nieprecyzyjnie powiedziane .	powiedziane	3	Neut
Na inwestycję przyznano 28 milionów marek kredytu , który przyznano na 15 lat z pięcioletnią karencją spłaty odsetek .	przyznano	9	Neut
Kwiaty otrzymali nauczyciele , którzy przed laty kształcili kolejarskich specjalistów .	kolejarskich	8	Masc
Romantycznym bohaterom odpowiada szatańska wersja pieśni .	Romantycznym	0	Masc
Dla mnie kwestia aborcji powinna być oddzielona i rozpatrywana oddzielnie od spraw religijnych .	oddzielona	6	Fem
Funkcjonariusze apelują do mieszkanek Kwidzyna , aby w najbliższym czasie unikały ciemnych miejsc .	ciemnych	11	Neut
Pomimo smutnej wymowy , sztuka obfituje w sceny humorystyczne , można również posłuchać piosenek Wasowskiego i Przybory .	smutnej	1	Fem
Wyrok znów był niekorzystny , ale emeryt się nie poddaje .	niekorzystny	3	Masc
Kazio M . jest ciekawym przypadkiem .	ciekawym	4	Masc
Podczas ceremonii otwarcia Spływu organizatorzy przyznali liczne odznaczenia zasłużonym kajakarzom .	zasłużonym	8	Masc
W poważnym stopniu przyczynił się do wysokich wyników wydziału .	poważnym	1	Masc
Całe starostwo spiskie od 1591 do 1745 roku należało do Lubomirskich .	spiskie	2	Neut
Największe zainteresowanie budzi jednak specjalne seminarium poświęcone ustaleniu budowy ludzkiego DNA .	ludzkiego	9	Neut
Polacy jadący w autokarze spoglądają z nietajoną dumą na wielkiego rodaka .	jadący	1	Masc
Społeczeństwo wychowywano w ślepym posłuszeństwie wobec Cesarstwa .	ślepym	3	Neut
O klasztornym piekle , zgotowanym przez trzy potwory w habitach , pisaliśmy w kwietniu br .	zgotowanym	4	Neut
Z jego przepalonego i odsłaniającego rusztowanie kręgów gardła wydobył się syk .	przepalonego	2	Neut
Oczywiście SLD mogło by być ugrupowaniem ateistycznym albo umiarkowanie areligijnym .	areligijnym	9	Neut
A tak nazywały się serwowane tam alkohole .	serwowane	4	Masc
Gdyby Celina Szulc pozostała na stanowisku , związkowcy zamierzali ogłosić wczoraj strajk okupacyjny w łomżyńskich wodociągach .	okupacyjny	12	Masc
Mimo tak dużych możliwości EMG , czasem nie udaje się na jej podstawie postawić trafnej diagnozy .	trafnej	14	Fem
Zwycięskie drużyny otrzymają nagrody pieniężne .	pieniężne	4	Fem
W 1831 pod Komorzem A . Mickiewicz próbował przekroczyć granicę zaborów biegnącą na Prośnie , aby wziąć udział w powstaniu listopadowym .	1831	1	Masc
Jeżeli jeszcze przed dwudziestu laty w zasadzie obowiązywała surowa formalna wykładnia przepisów kanonicznego prawa małżeńskiego , to obecnie stosuje się wykładnię rozszerzającą , a więc łagodną .	surowa	8	Fem
Przeprowadził wówczas kilka niebłahych akcji , tu zrelacjonowanych z detalami . . .	zrelacjonowanych	7	Fem
W 1991 dokonano kolejnych zmian administracyjnych .	administracyjnych	5	Fem
Pies musi być podwórzowy , zły , w budzie na łańcuchu siedzący .	podwórzowy	3	Masc
Niewytłumaczalna zbrodnia wstrząsnęła Polską .	Niewytłumaczalna	0	Fem
Wycieczki będą odbywać się w dni przedświąteczne i świąteczne .	przedświąteczne	6	Masc
Sprawdź dokumenty osoby zbierającej datki .	zbierającej	3	Fem
Grupa ponad 30 działaczy samorządowych , spółdzielców i bankierów na czterech pięciodniowych sesjach ma poznać francuskie rozwiązania dotyczące budownictwa czynszowego .	czynszowego	19	Neut
Ojciec ofiary uważa , że w sprawę zamieszani są policjanci i dlatego śledztwo prowadzone było tak niemrawo .	zamieszani	7	Masc
Najpierw zajmie się nadawcami programów regionalnych , więc prawdopodobnie pierwsi z nich będą mogli dostać koncesje w sierpniu - wrześniu .	pierwsi	9	Masc
Nie składają donosów do prokuratury , nie przejmują się całodobowym uśmiercaniem poczętych ?	całodobowym	9	Neut
Po prostu uważam , że ciało eteryczne nie załatwia sprawy .	eteryczne	6	Neut
Mężczyźni są u pana dużo mniej interesujący .	interesujący	6	Masc
Ja chodziła m do bezpłatnej szkoły na Krakowskiej i była m zadowolona .	bezpłatnej	4	Fem
Politycy mają takie przekonanie , że można coś sprzedać ludziom w innym , lepszym opakowaniu .	lepszym	13	Neut
W 1935 roku brytyjski informatyk Alan Mathison Turing wymyślił abstrakcyjną maszynę .	brytyjski	3	Masc
Pobity kijem bejsbolowym mężczyzna trafił z licznymi obrażeniami do szpitala .	Pobity	0	Masc
A ty jesteś ładna , zgrabna , wysoka , miła i mądra . . .	mądra	11	Fem
Brigitte Bardot zaczęła bronić zwierząt histerycznie , szlachetne intencje popsuły się i pogniły jak robaczywe jabłka .	robaczywe	14	Neut
Szerzyła się filozofia w najszerszym znaczeniu .	najszerszym	4	Neut
Książka Jarosława Gowina nie szczędzi gorzkich słów wszystkim stronom .	gorzkich	5	Neut
Kobieta z rozciętą głową i wstrząśnieniem mózgu trafiła do szpitala .	rozciętą	2	Fem
W prańskich koncertach wystąpi jeszcze parokrotnie .	prańskich	1	Masc
Na tegorocznym inauguracyjnym balu tradycyjnego karnawału w Rio pracowały równolegle dwie komisje sędziowskie .	tegorocznym	1	Masc
Sygnał dźwięku wielokanałowego możemy wyprowadzić tylko przez cyfrowe złącze optyczne , ale kabla , niestety , nie znajdziemy w pudełku .	wielokanałowego	2	Masc
Oparła się na wypiętych za plecami rękach i z lekka wyprężyła przy tym tułów .	wypiętych	3	Fem
Później zauważył , że lewe oko krwawi .	lewe	4	Neut
Ale armia niemiecka nie została stworzona przez Hitlera .	stworzona	5	Fem
Uniwersytet ten , założony w 1949 r . i prowadzony przez werbistów , nie posiada zbyt długiej tradycji akademickiej .	akademickiej	18	Fem
Proboszcz parafii wyjaśniał podczas świątecznych kazań , że w tym roku parafię czekają dwie duże uroczystości .	świątecznych	4	Neut
- W Moryniu czeka na nas wspaniałe jezioro .	wspaniałe	6	Neut
Dlatego językiem oficjalnym stał się arabski , a dąży się , by stał się językiem ogólnonarodowym .	oficjalnym	2	Masc
Oczywiście , ważny jest program , ważne są jednak także zbiorowe emocje , poczucie sprawiedliwości , historyczna pamięć .	zbiorowe	10	Fem
Musisz cofnąć się o 2 pola do tyłu , by pozbyć się lepkich nici z twarzy .	lepkich	12	Fem
Bo znacznie mniejszy grzyb jest .	mniejszy	2	Masc
Niezwłocznie wezwano pogotowie ratunkowe .	ratunkowe	3	Neut
Dwa tygodnie temu prezydent podpisał znowelizowaną ustawę .	znowelizowaną	5	Fem
Następnym razem przyprowadzą kolegów i pomalutku piękny sport narciarski zainteresuje bardziej młodzież naszego miasta .	piękny	6	Masc
W załzawionym świecie jeden diabeł posiadał kontury ostre i wyraźne .	wyraźne	9	Masc
Nowi ustne rozpoczęli od geografii .	Nowi	0	Masc
W intymną narrację wdzierają się echa bośniackiej tragedii .	bośniackiej	6	Fem
Nadal będzie dodatnia temperatura , na wybrzeżu około 5 stopni .	dodatnia	2	Fem
Już mnie tu nie zastaną i będą bardzo zdziwieni .	zdziwieni	8	Masc
Jak podały miejscowe rozgłośnie radiowe , wykoleiły się dwa wagoniki podziemnej kolejki .	miejscowe	2	Fem
Źródło ognia znajdowało się przy drzwiach wejściowych .	wejściowych	6	Neut
Dziwnej kompanii , ośmielę się zauważyć .	Dziwnej	0	Fem
Do poradni chirurgicznej i pogotowia ratunkowego napływali poszkodowani piesi .	ratunkowego	5	Neut
Z pociętego nożem brzucha kobiety sączyła się krew .	pociętego	1	Masc
- Nadszedł główny księgowy .	główny	2	Masc
Kozubek wysyła Anglikom koronkową bieliznę .	koronkową	3	Fem
Steve zaklina się , że po każdym dyżurze szykuje ekstra posiłek czworonożnemu ratownikowi .	ekstra	9	Masc
W kraju działa kilka grup partyzanckich utworzonych przez patriotów Dominikany .	utworzonych	6	Fem
Nieleczona choroba przerodziła się w złośliwego chłoniaka .	złośliwego	5	Masc
W Wojewódzkim Szpitalu Zespolonym odbyła się pierwsza w Poznaniu udana operacja przeszczepienia rogówki .	udana	9	Fem
Również uwłaszczenia dotyczyła jedyna zaakceptowana poprawka .	jedyna	3	Fem
TP SA chce złagodzić planowane redukcje .	planowane	4	Fem
- Prokuratura stołeczna równolegle z UOP wszczęła śledztwo w sprawie przecieków .	stołeczna	2	Fem
Trzech sprytnych chłopców szukało nawet syrenki w przedszkolnym akwarium .	przedszkolnym	7	Neut
Skulona , ze spuszczoną głową , zniknęła na schodach .	Skulona	0	Fem
Zazwyczaj młodym kobietom z zagranicy , zwabionym i przymuszanym do nierządu , sutenerzy odbierają paszporty .	młodym	1	Fem
Stanowią one razem z rzodkiewką potrawę pełnowartościową , dając jednocześnie ciekawy efekt dekoracyjny .	dekoracyjny	12	Masc
Mock przytulił się do hrabiny i objął jej kruche ramiona .	kruche	8	Neut
A przyjrzyj się treści katechezy w Polsce międzywojennej .	międzywojennej	7	Fem
Zakończyły się ligowe rozgrywki drużynowych mistrzostw Polski w zapasach .	drużynowych	4	Neut
Nie było to lekkie zadraśnięcie .	lekkie	3	Neut
Często wykorzystujemy znajomości i dojścia zaprzyjaźnionych osób .	zaprzyjaźnionych	5	Fem
To się jakoś splata w jedno .	jedno	5	Neut
Uważa ona , że błaha w gruncie rzeczy sprawa jest wyolbrzymiana przez media .	błaha	4	Fem
Wysyłam je najczęściej za pośrednictwem konduktorów autobusowych .	autobusowych	6	Masc
Tutaj także zostały podmyte piwnice domów .	podmyte	3	Fem
Komendanta wojewódzkiego powoła więc ostatecznie szef MSWiA .	wojewódzkiego	1	Masc
Członkowie nakielskiego stowarzyszenia podczas spotkania omówili główne cele swojej działalności .	nakielskiego	1	Neut
W ciemnym miejscu chodnika do samotnie idącej dziewczyny podbiegł mężczyzna i zgwałcił ją .	idącej	6	Fem
To karygodne zaniedbanie .	karygodne	1	Neut
Pędzę do pokojówki z tą hiobową wieścią .	hiobową	5	Fem
Po ponad dwóch tygodniach brak mi będzie telewizyjnej , turyńskiej zimy .	turyńskiej	9	Fem
Wino białe pije się inaczej .	białe	1	Neut
W tym domu rola korepetytora była bardzo delikatna .	delikatna	7	Fem
Wartownik zapukał trzykrotnie i otworzył żelazne drzwi .	żelazne	5	Neut
W jego moskiewskim salonie bywała śmietanka przedrewolucyjnej Rosji .	przedrewolucyjnej	6	Fem
Trwa akcja poszukiwawcza .	poszukiwawcza	2	Fem
Poinformował w nim , że około godz . 19 . 30 w poniedziałek wartownik wojskowy zauważył zerwane plomby i kłódki do garnizonowego składu amunicji .	19	8	Fem
Teraz wszystko jest świetliste jak łabędź .	świetliste	3	Neut
Rozpoczęli zwożenie kamiennych płyt .	kamiennych	2	Fem
Podstawowe problemy przemysłowej produkcji i masowych zastosowań półprzewodnikowych źródeł światła niebieskiego wydają się już rozwiązane .	rozwiązane	14	Masc
Z 13 do 27 zwiększa się w Łodzi liczba opiekunów , przeprowadzających dzieci idące na lekcje przez najruchliwsze jezdnie i skrzyżowania .	idące	13	Neut
Partia przegrała wielką kampanię antykościelną .	antykościelną	4	Fem
By wdrożyć projektowany przez rząd nowy system taniego budownictwa mieszkaniowego , konieczne jest szybkie wyszkolenie kadr .	projektowany	2	Masc
Czternastoletni chłopiec cierpiał z powodu ciężkiej alergii wielonarządowej , której objawami były atopowe zapalenie skóry , astma oskrzelowa oraz całoroczny katar .	ciężkiej	5	Fem
Największe zainteresowanie budzi jednak specjalne seminarium poświęcone ustaleniu budowy ludzkiego DNA .	poświęcone	6	Neut
Transmisja z jego strony szła przez dwa serwery anonimizujące , mógł przebywać w dowolnym miejscu na Ziemi .	anonimizujące	8	Masc
Wojska etiopskie kontynuują ofensywę w Erytrei .	etiopskie	1	Neut
Nie można w ekspresowym tempie kształtować podstawowych zasad prawnych .	podstawowych	6	Fem
Wczoraj świdnicka WSK zorganizowała konferencję prasową .	świdnicka	1	Fem
Malarstwo Rubensa odegrało zasadniczą rolę w historii kultury europejskiej .	zasadniczą	3	Fem
Ewentualna ratyfikacja Konkordatu przed przyjęciem nowej konstytucji zaważyłaby zapewne na jej ostatecznym brzmieniu , odbierając Konstytucji RP charakter nowoczesnej ustawy zasadniczej demokratycznego państwa .	nowoczesnej	18	Fem
Chodź do kuchni , zrobimy sobie coś dobrego , kupiłem to hiszpańskie wino , które lubisz , wypijemy po kieliszku .	hiszpańskie	11	Neut
Stwierdzono , że stosunkowo wysokie zarobki mają pielęgniarki bloku operacyjnego .	Stwierdzono	0	Neut
Chowa się w małej wioskowej świątyni .	wioskowej	4	Fem
Rozmaite padliny wieszano na Sienkiewiczu , ale ja w jego obronie zawsze staję .	wieszano	2	Neut
Analogiczny obraz zróżnicowań społecznych ukazują dane o wieku menarchy dziewcząt .	społecznych	3	Neut
Plecy Dobrskiego zdradzały tak wielkie rozgoryczenie .	wielkie	4	Neut
Pogładził łaskawą pieszczotą wyślizgane drewienka .	łaskawą	1	Fem
Wystarczyło paru lat , aby konkret został wyklęty .	wyklęty	7	Masc
Kosmetyka jest tylko bardzo pożądanym dodatkiem .	pożądanym	4	Masc
Doświadczenia z dzieciństwa spędzonego w rodzinie alkoholowej u wielu mężczyzn i kobiet owocują w dorosłym życiu utrwalonymi schematami odczuwania , zachowania i myślenia .	dorosłym	14	Neut
Ale to nie tylko zadanie związku , bo kolosalne znaczenie ma też jakość hal .	kolosalne	8	Neut
Już prawie jesteś wybudzona .	wybudzona	3	Fem
Migotliwe światło zniekształca jego twarz .	Migotliwe	0	Neut
Przechodnie patrzyli obojętnie na nieszczęśliwe zwierzę .	nieszczęśliwe	4	Neut
Olimpijskie szaleństwo na dobre opanowało media .	Olimpijskie	0	Neut
Biała prawica w RPA zarzucała Treurnichtowi nadmierną ugodowość wobec rządzącej Partii Narodowej , a także pasywność .	nadmierną	6	Fem
Fascynująca jest też rola badań kosmicznych w tej dyscyplinie .	kosmicznych	5	Neut
Wobec powyższego Angus uznał obecny wykład za głupi , wprost śmieszny absurd .	powyższego	1	Neut
Klub Przyjaciół Życia Ludzkiego działa w Nakle od 1996 roku .	Ludzkiego	3	Neut
Zacisnął em palce na szorstkim płótnie i wyczuł em obłe kształty pocisków .	szorstkim	4	Neut
Na inwestycję przyznano 28 milionów marek kredytu , który przyznano na 15 lat z pięcioletnią karencją spłaty odsetek .	pięcioletnią	14	Fem
Gdy zrozumiał , że Zachód mylnie pojmuje religię hinduską jako politeizm , zaczął szukać głębszych warstw i analogii .	głębszych	14	Fem
Lubuscy policjanci rozbili grupę zajmującą się włamaniami do kościołów i kradzieżami figur oraz przedmiotów kultu religijnego .	zajmującą	4	Fem
Będzie to film szerokoekranowy , składający się z dwóch części .	szerokoekranowy	3	Masc
Był wzywany do Seneki . . .	wzywany	1	Masc
Po pewnym czasie pojawiła się też mniejsza grupa , zmierzająca w odwrotną stronę .	mniejsza	6	Fem
Maturzyści zakładają , że podczas tegorocznej matury nie będzie tematów , wymagających znajomości twórczości tylko jednego pisarza .	tegorocznej	5	Fem
Leczenie podtrzymujące za pomocą steroidów jest oczywiście gorszym rozwiązaniem niż leczenie polegające na usunięciu przyczyny .	podtrzymujące	1	Neut
Oczywiście , ważny jest program , ważne są jednak także zbiorowe emocje , poczucie sprawiedliwości , historyczna pamięć .	historyczna	16	Fem
Przy bezpośrednim wprowadzaniu danych dowody księgowe są indywidualnie przekazywane do przetwarzania .	bezpośrednim	1	Neut
Iluż poważnych obecnie pisarzy czytało swe pierwsze próby literackie w sali przy Krupniczej , siedząc wokół dębowych stołów zsuniętych pośrodku .	poważnych	1	Masc
To ostatecznie przesądziło o południowym kierunku japońskiej ekspansji .	południowym	4	Masc
Wiedźma odwróciła się ku niemu z mozołem , wkładając w ten drobny ruch wszystkie swoje siły .	drobny	11	Masc
Żydzi w Izraelu podlegają także innym czynnikom .	innym	5	Masc
Ta opinia jest utworzona z chorego uogólniania .	utworzona	3	Fem
Na pewno jest pan głodny ?	głodny	4	Masc
Jesteś normalny !	normalny	1	Masc
Sprzęt nie był ubezpieczony .	ubezpieczony	3	Masc
Do spa udają się osoby świadome , dla których dbanie o siebie to przyjemność .	świadome	5	Fem
Zawsze wygrywał , bo był najszybszy .	najszybszy	5	Masc
Strawione jedzenie krąży po organizmie , odżywiając komórki .	Strawione	0	Neut
Do zdarzenia doszło na dość oblodzonej ulicy .	oblodzonej	5	Fem
Kudłatemu znowu coś popieprzyło się w obliczeniach finansowych .	finansowych	7	Neut
Mężczyzna dotykał ciała dziewczynki w miejscach intymnych .	intymnych	6	Neut
Czynią tak wspomniani starościna i starosta .	wspomniani	2	Masc
Opracował program dydaktyczny wychowania seksualnego , którego realizacja została ostatnio wstrzymana .	seksualnego	4	Neut
Klasztor na Jasnej Górze przeżywa prawdziwe oblężenie .	Jasnej	2	Fem
Tępe łby zamieszczają zdjęcia .	Tępe	0	Masc
Poinformował w nim , że około godz . 19 . 30 w poniedziałek wartownik wojskowy zauważył zerwane plomby i kłódki do garnizonowego składu amunicji .	garnizonowego	21	Masc
W niedzielny wieczór premier Izraela Ariel Saron ogłosił wojnę z palestyńskim terroryzmem .	niedzielny	1	Masc
Bardzo podobał mu się plac Centralny , wszechobecna symetria i wolne przestrzenie .	wolne	10	Fem
To jest zabawne ?	zabawne	2	Neut
Chodzi o to , aby uczniowie w odpowiednich warunkach mogli realizować cele w ramach poszczególnych przedmiotów , zajęć pozalekcyjnych czy pozaszkolnych .	pozalekcyjnych	18	Neut
Gorące spojrzenia towarzyszyły kandydatkom do korony podczas całego rejsu .	Gorące	0	Neut
Poszłam do drugiej .	drugiej	2	Fem
- Wiedzieli , że muszą sami sobie pomóc .	sami	5	Masc
Ranni żołnierze zostali przewiezieni do szpitala w Białogardzie .	Ranni	0	Masc
Księżyc wznosi się , tak pełny , jakby miał się przelać .	pełny	5	Masc
Trzej pasażerowie byli pijani . . .	pijani	3	Masc
Powołano sejmową komisję śledczą do wyjaśnienia tej sprawy .	Powołano	0	Neut
Posiadał wszechstronny , uniwersalny umysł obejmujący szereg nauk specjalnych .	wszechstronny	1	Masc
- Tomek był pogodnym , uśmiechniętym dzieckiem .	pogodnym	3	Neut
Jej mąż nigdzie nie pracował , ale nie mieli materialnych kłopotów .	materialnych	9	Masc
Mieli przymierzać im te drewniane serce .	drewniane	4	Neut
Z ich opinią liczono się nie tylko w redakcji , ale również w środowiskach literackich i teatralnych .	teatralnych	16	Neut
Węże są zwierzętami mało poznanymi , niezwykłymi i fascynującymi .	niezwykłymi	6	Neut
Najpierw złapali śmy trzy dzikie delfiny .	dzikie	4	Masc
Posłużono się amerykańską zastawką doktora Starra .	amerykańską	2	Fem
Według islamu świnia jest uznawana za zwierzę nieczyste .	uznawana	4	Fem
Wielu obawia się , że będzie skazany na typowe pieskie życie .	typowe	8	Neut
Tam dyżurna kosmetyczka obejrzy pani cerę , udzieli porady i wskaże , jakie mleczko będzie najwłaściwsze , a może jeszcze doradzi jakiś krem .	dyżurna	1	Fem
W tych ramach wspierało także hierarchicznie gorszą pozycję kobiet .	gorszą	6	Fem
Rozmieszczeni ogrodów działkowych w Polsce jest nierównomierne .	działkowych	2	Masc
Kilka osób spytało mnie , czy jestem dzięki feminizmowi szczęśliwsza .	szczęśliwsza	9	Fem
Mimo tak dużych możliwości EMG , czasem nie udaje się na jej podstawie postawić trafnej diagnozy .	dużych	2	Fem
Zaangażowała się w Teatrze Dramatycznym kierowanym wówczas przez Gustawa Holoubka .	Dramatycznym	4	Masc
Nagie , surowe ściany tchnęły mroźną wilgocią .	Nagie	0	Fem
Na szczęście pościel , którą na nich położono , była miękka i ciepła .	miękka	10	Fem
Radni Malborka podjęli uchwałę w sprawie nowych stawek za wodę i odprowadzane ścieki .	odprowadzane	11	Masc
Zawiadomiono policję i prokuraturę .	Zawiadomiono	0	Neut
Dużo od nas starszy , miał więcej doświadczenia , ogromną charyzmę i dystans do siebie .	ogromną	9	Fem
Podkreśla się , ze był on najlepszym rozgrywającym ligi i ojcem dominacji Chicago Fire w rozgrywkach grupowych .	najlepszym	6	Masc
W Raciborzu odbywa się wiele imprez kulturalnych .	kulturalnych	6	Fem
Definitywnych ustaleń jeszcze nie ma , ale strony osiągnęły znaczne zbliżenie .	Definitywnych	0	Neut
Weszła do gabinetu i bezgranicznie puste spojrzenie zawiesiła na fotelu .	puste	5	Neut
Złoty instrument sprezentowało mu bractwo kurkowe .	kurkowe	5	Neut
Widelczyk leżący nad talerzami jest widelczykiem deserowym .	deserowym	6	Masc
Reformy ograniczono do totalnej prywatyzacji , która przyjęła raczej ramy wyprzedaży majątku narodowego .	narodowego	12	Masc
Po drugiej stronie też nie ma nic .	drugiej	1	Fem
W czwartkowe popołudnie gasili płonący śmietnik przy ul. Brodzińskiego w Proszowicach .	czwartkowe	1	Neut
Od 1998 roku funkcjonuje w FSB wydział bezpieczeństwa komputerowego i informacyjnego .	informacyjnego	10	Neut
Festiwal zorganizował WOAK i Podlaskie Kuratorium Oświaty w Białymstoku .	Podlaskie	4	Neut
Jest tu 16 jezior , łącznie z 4 jeziorami na obrzeżu , znajdującymi się już poza administracyjną granicą WPN .	znajdującymi	12	Neut
Wyróżniał się licznymi szybami górniczymi , kryjącymi w swych wnętrzach wieże wyciągowe i windy do przewozu ludzi i węgla .	kryjącymi	6	Masc
Należy tutaj zaznaczyć , iż w wielu przedsięwzięciach doradczych występuje konieczność współudziału kilku wymienionych typów doradztwa .	doradczych	8	Neut
Po feriach zimowych do nowej szkoły wprowadzili się uczniowie Liceum Ogólnokształcącego w Drohiczynie .	zimowych	2	Neut
Nakielska straż miejska odbiera sporo podobnych zgłoszeń .	Nakielska	0	Fem
Niektóre sale pałacyku w Karolinie przeznaczono na małe muzeum .	przeznaczono	5	Neut
Wtedy będzie mogła z radością oddać się rowerowym szaleństwom .	rowerowym	7	Neut
Jest szczęśliwy , zauważa moją nową fryzurę .	nową	5	Fem
Niemiecki sąd konstytucyjny zabronił stosowania go na terenie tego kraju .	Niemiecki	0	Masc
Immonen , w czarnych dżinsach welwetowych i w zgniłozielonym golfie , nie zdążył jeszcze zrzucić kożucha .	welwetowych	5	Neut
Od samotności niepoczytalnej i obłędu uchroń nas , Panie .	niepoczytalnej	2	Fem
Komentatorzy powszechnie uważają , że zaszkodziła ona jednemu z głównych kandydatów na prezydenta Arturasowi Paulauskasowi .	głównych	9	Masc
Kontrolę prywatyzacji jednoosobowych spółek Agencji WRSP Izba przeprowadziła na zlecenie sejmowej Komisji Rolnictwa i Rozwoju Wsi .	jednoosobowych	2	Fem
Z tych samych środków , które zasiliły konto Hufca ZHP , dofinansowanie zdobyło także Stowarzyszenie Na Rzecz Szkolnictwa Specjalnego .	Specjalnego	18	Neut
Uroczystości weselne zaczynały się od wtorku .	weselne	1	Fem
Szybkie jedzenie szybko tuczy .	Szybkie	0	Neut
Ziemia jest naga .	naga	2	Fem
- Czy polscy kierowcy zawodowi rzeczywiście są profesjonalistami ?	zawodowi	4	Masc
Oczywiście , to było konstruktywne myślenie .	konstruktywne	4	Neut
Zgłoszenia przyjmowane są do 1 października 2007 roku .	przyjmowane	1	Neut
W forcie więziono również Rosjan , Francuzów i Jugosłowian i niemieckich antyfaszystów .	niemieckich	10	Masc
– może robił by m coś innego wtedy . .	innego	6	Neut
W podobny sposób wzruszają go także niektóre stare pieśni kościelne .	kościelne	9	Fem
Prawdopodobnie niesprawna instalacja elektryczna była przyczyną tragicznego pożaru w mieszkaniu przy ulicy Słupeckiej w Gdyni .	Słupeckiej	12	Fem
Szedłem niskim i wąskim korytarzykiem , oświetlając sobie drogę uniesioną ku górze latarką .	wąskim	3	Masc
Uchwała rady powinna być podjęta w ciągu miesiąca od dnia doręczenia wniosku Naczelnej Rady Aptekarskiej .	podjęta	4	Fem
Tak długo zwracaj wolność , aż poczujesz , że jest to całkowicie szczere i autentyczne .	autentyczne	14	Neut
- Oto walczę na froncie Kościoła i tam dbam o prawdziwą wiarę .	prawdziwą	10	Fem
To bardzo denerwujące , bo nie wiesz , o czym mówisz .	denerwujące	2	Neut
Wysokich drabin warszawska straż rzeczywiście nie ma .	warszawska	2	Fem
" Skrupulatnie przestrzegane zasady od dziesiątków lat współtworzą jej autorytet i wyjątkową pozycję na rynkach całego świata " .	przestrzegane	2	Fem
- Hasła pacyfistyczne i ekologiczne mają niejedno imię .	pacyfistyczne	2	Neut
Przypomnijmy , że przed laty Jelcyn nie wysiadł na spotkanie z irlandzkimi władzami .	irlandzkimi	11	Fem
Jest ciekawa i starannie opracowana .	opracowana	4	Fem
– Czy jest osiągalna , słuchaj . . .	osiągalna	3	Fem
Aubigne nienawidzi Paryża , choć stolica Francji jest dla niego zarazem miastem świętym .	świętym	12	Neut
Wtedy stosowano materiały niskiej jakości .	niskiej	3	Fem
Zadanie komisji okazało się bardzo trudne .	trudne	5	Neut
Gdyby nie było przemocy , porozumienie zostałoby już dawno zawarte .	zawarte	9	Neut
Nagle wzrok funkcjonariusza padł na pudło z płytami kompaktowymi bez hologramów .	kompaktowymi	8	Fem
Spotkanie w urzędzie wywarło na wszystkich jego uczestnikach niesamowite wrażenie .	niesamowite	8	Neut
Konstruuje jakieś sprzęty do badań meteorologicznych .	meteorologicznych	5	Neut
Wtedy moje życie będzie potwierdzone .	potwierdzone	4	Neut
Ich niski status społeczny sprawia , że poza czasem widowisk obrzędowych nie odgrywają oni istotnej roli w lokalnym życiu publicznym .	lokalnym	17	Neut
Jego konspiracyjna działalność się zaczynała .	konspiracyjna	1	Fem
Z przodu oboma dłońmi chwytamy za przedramię zgięte w stawie łokciowym .	łokciowym	10	Masc
Zrobiono to poza moimi plecami .	Zrobiono	0	Neut
Wtedy też powiadomiono straż pożarną .	powiadomiono	2	Neut
W naszym przedziale walały się nawet dwa piękne wolne miejsca siedzące .	wolne	8	Neut
Wczoraj , po zamknięciu lokali wyborczych , niemieckie media zapowiedziały , że pani minister ustąpi ze stanowiska .	niemieckie	7	Neut
Twardzi są ci starzy .	Twardzi	0	Masc
Marta opuściła mury Kliniki przedwcześnie , na własną prośbę .	własną	7	Fem
Niedzielny mecz rozgrywany był przy ciągle padającym deszczu .	Niedzielny	0	Masc
Prokuratura Apelacyjna współpracuje w tej sprawie z oddziałami CBŚ we wspomnianych miastach i Urzędami Kontroli Skarbowej .	Skarbowej	15	Fem
- Nie układa się jej pod rynkowego konkurenta , ale warto wiedzieć , w co on gra .	rynkowego	6	Masc
Serduszka czekoladowe będą rozdawane w autobusach dla par .	czekoladowe	1	Neut
Sprytny oszust jest przekonujący , swym ofiarom proponuje pozostawienie obrączki lub innej bezwartościowej rzeczy w zastaw i zwrot gotówki za kilkadziesiąt minut .	przekonujący	3	Masc
Śmieszy mnie ta zabawa w barbarzyńcę , bezmyślne opróżnianie butelek pod krzyżówkę Mickiewicza z amerykańskim hamburgerem .	bezmyślne	7	Neut
Prokuratura orzekła , że jest niepoczytalny .	niepoczytalny	5	Masc
Przewaga któregokolwiek układu skurczowego lub niedowład któregokolwiek układu rozkurczowego powoduje skurcz mięśni gładkich oskrzeli .	rozkurczowego	8	Masc
- Jakie znaczenie dla śledztwa ma odkrycie dokonane w archiwach w Łomży , o którym niedawno poinformowała prof . Daria Nałęcz ?	dokonane	7	Neut
ona chce nową kurtkę .	nową	2	Fem
To bardzo trudne .	trudne	2	Neut
Samo pojęcie wywodzi się ze średniowiecznej filozofii .	Samo	0	Neut
Skupieni operatorzy delikatnie manipulowali skomplikowanymi urządzeniami odbioru przekazywanej informacji .	skomplikowanymi	4	Neut
Kryzys zaufania zawsze ma negatywne i długofalowe konsekwencje wychowawcze .	wychowawcze	8	Fem
Prowadzi to do nietolerancji laktozy i poważnych zaburzeń w trawieniu .	poważnych	6	Neut
Przebrzmiała już wiadomość zaczęła powracać , jakby m cofał taśmę magnetofonową i wysłuchiwał fatalnego technicznie nagrania .	magnetofonową	10	Fem
Pierwszym zapisanym mówcą jest senator Zbigniew Kulak .	zapisanym	1	Masc
Oni myślą o jutrzejszym dniu .	jutrzejszym	3	Masc
Całej imprezie groziła katastrofa , mimo że istniała możliwość otrzymania odszkodowania z towarzystwa ubezpieczeniowego .	ubezpieczeniowego	13	Neut
Od tego też dnia czynna jest już wypożyczalnia sprzętu wodnego .	czynna	4	Fem
Podobne zdanie wyraził przed chwilą mój przedmówca .	Podobne	0	Neut
Jest wesolutki , chętny do spędzania czasu przy kolacji .	wesolutki	1	Masc
Za krótka kołdra pokazywała jak nigdzie swoją małpią złośliwość .	małpią	7	Fem
- Po co wdzierał się do cudzego domu ? !	cudzego	6	Masc
W tym pieprzonym rejonie zawsze wieje .	pieprzonym	2	Masc
Środki pochodzą z Państwowego Funduszu Rehabilitacji Osób Niepełnosprawnych .	Niepełnosprawnych	7	Fem
Jeżeli jeszcze przed dwudziestu laty w zasadzie obowiązywała surowa formalna wykładnia przepisów kanonicznego prawa małżeńskiego , to obecnie stosuje się wykładnię rozszerzającą , a więc łagodną .	małżeńskiego	14	Neut
W Tczewie w Radzie Miejskiej zasiada 23 radnych .	Miejskiej	4	Fem
To niemal już standardowe zajęcie policji latem .	standardowe	3	Neut
Iluż poważnych obecnie pisarzy czytało swe pierwsze próby literackie w sali przy Krupniczej , siedząc wokół dębowych stołów zsuniętych pośrodku .	zsuniętych	18	Masc
W krem wcisnąć osączone i pokrojone ananasy .	pokrojone	5	Masc
Oczy powlekła biaława szklistość , co wzmogło tajemnicę spojrzenia .	biaława	2	Fem
Dobroczynne działanie wina potwierdzają plantatorzy .	Dobroczynne	0	Neut
Gdyby udało się skompletować księgę obdarowanych , zawierałaby ona listę nazwisk tworzących znaczną część żelaznego elektoratu SLD .	znaczną	12	Fem
Wiedzą o tym dziesiątki właścicieli małych elektrowni wodnych .	małych	5	Fem
Drugi pod względem kapitalizacji giełdowej Wielkopolski Bank Kredytowy osiągnął bardzo dobrą miesięczną dynamikę zysków wynoszącą 81,4 proc .	wynoszącą	14	Fem
Pokój , do którego zaprowadzono gości , miał zaokrąglone wszystkie ściany .	zaprowadzono	4	Neut
Obecne życie Marty jest absurdalne i patologiczne !	patologiczne	6	Neut
Celników wspomagały specjalnie szkolone psy oraz sprzęt techniczny .	techniczny	7	Masc
W przyległej sali grała orkiestra .	przyległej	1	Fem
Starym kawalerem zostanie i następcy zabraknie , tradycja garncarska w rodzinie Kraszewskich zaginie . . .	garncarska	8	Fem
Porozumienie zostało podpisane pod koniec 1997 roku w Waszyngtonie .	podpisane	2	Neut
Towarzyszyli mu polscy policjanci ze specjalnego wydziału zajmującego się deportacją z Komendy Głównej Policji .	specjalnego	5	Masc
Także w ubiegłym roku zniszczono nagrobki na cmentarzach w Gdyni i Kielcach .	zniszczono	4	Neut
Tarot Marsylski powstał prawdopodobnie w końcu średniowiecza , gdy świeże były jeszcze skojarzenia Czyśćca z refrigerum .	Marsylski	1	Masc
- Wysłaliśmy ponad 500 zapytań , systematycznie przeglądamy odpowiedzi i nie natrafiliśmy jeszcze na urzędnika , na którym ciąży prawomocny wyrok sądowy .	sądowy	21	Masc
Mógł być nadawany pośmiertnie .	nadawany	2	Masc
W czasie pozorowanych działań bojowych jednostki z pozycji obronnych dokonają przegrupowania , aby po sforsowaniu szerokiej przeszkody wodnej wyjść na nowe rubieże aktywnych działań zaczepnych .	obronnych	8	Fem
Dzieci zgodnym chórem twierdzą , że nawet mama nigdy nie gotowała lepiej .	zgodnym	1	Masc
Na ganek wyszła starsza pani , ubrana w niemodną sukienkę z koronkowym kołnierzykiem i mankietami .	niemodną	8	Fem
Badania wielkości sił naciągu strun na torze przeprowadzono przez bezpośredni pomiar sił w poszczególnych strunach za pomocą przyrządu VOGT .	bezpośredni	9	Masc
Brytyjczycy są więc dominującym udziałowcem w największym polskim towarzystwie emerytalnym .	emerytalnym	9	Neut
Udzielając poparcia świętej wojnie , mogli poprawić swoją nadszarpniętą reputację .	świętej	2	Fem
Jesienią 1937 Stroop wchodzi w skład wyższej elity SS-owskiej .	1937	1	Masc
Serwisy , które go oferują , często zawierają wiele odnośników prowadzących do przykładowych , działających już stron .	prowadzących	10	Masc
Przebrzmiała już wiadomość zaczęła powracać , jakby m cofał taśmę magnetofonową i wysłuchiwał fatalnego technicznie nagrania .	Przebrzmiała	0	Fem
Odpowiadam ogólnie na Twoją radosną twórczość .	radosną	4	Fem
Rządowi eksperci z zachodniej Europy ostrzegają przed epidemią grypy .	zachodniej	3	Fem
Doznały jedynie stłuczeń kończyn i po opatrzeniu ran w szpitalu w Broumovie zostały zwolnione .	zwolnione	13	Fem
Bo chcą sobie zrekompensować samotne dzieciństwo .	samotne	4	Neut
I wróżą dobrą pogodę do inwestowania w akcje .	dobrą	2	Fem
Nie potrzeba do niego wąglika , sarinu ani nawet walizkowej bomby atomowej .	walizkowej	9	Fem
Zimna woda tryskała na głowę , szyję i płonące uszy .	płonące	8	Neut
Najpierw operatorzy będą mieli miesiąc na poinformowanie klientów o nadchodzących zmianach i zadanie im rutynowego pytania , czy chcą obniżki opłat roamingowych .	rutynowego	14	Neut
Do naszej salki wszedł teraz łysy facet w ciemnooprawnych okularach .	ciemnooprawnych	8	Neut
W wypadku na miejscu zginęła 19-letnia dziewczyna kierująca toyotą corollą oraz 23-letni mężczyzna .	23-letni	11	Masc
Projekt zakończył się uroczystym śniadaniem wielkanocnym .	uroczystym	3	Neut
Dlatego ceni się sumienność , odpowiedzialność , perspektywiczne myślenie .	perspektywiczne	7	Neut
Podejmowane są zobowiązania indywidualne i zespołowe .	Podejmowane	0	Neut
To jest druga z niepodważalnych prawd węglowych .	niepodważalnych	4	Fem
Grupa powstała we wczesnych latach 80 .	wczesnych	3	Masc
– Leżał na rękawicach ochronnych i też był popaprany ziemią .	popaprany	8	Masc
W najbliższym czasie rynek prawdopodobnie ochłonie i dojdzie do korekty .	najbliższym	1	Masc
- Ludzie starsi gubią się w technicznych problemach z tym związanych , a takie ciągłe zabawy ze zmianą pasma nadawania to brak szacunku dla abonentów .	starsi	2	Masc
Nasz artykuł o zakupie przez wojsko kurtek dla pilotów od firmy kierowanej przez Bogusława Bagsika spowodował kontrolę Najwyższej Izby Kontroli .	kierowanej	11	Fem
Jemiołuszka na przykład w ciepłych porach roku jest amatorką much łapiącą w locie owady .	łapiącą	10	Fem
Statut może przewidywać , że członkowi przysługuje prawo do działki przyzagrodowej .	przyzagrodowej	10	Fem
Posiadanie własności prywatnej sprzyja pokojowi .	prywatnej	2	Fem
W roku 2001 został powołany na stanowisko kierownika Zakładu Filozofii Współczesnej Instytutu Filozofii UŁ .	powołany	4	Masc
Na Ziemi Lubuskiej prace przedsiewne , zwłaszcza na glebach lekkich przybierają na sile .	Lubuskiej	2	Fem
A cena jest zabójcza .	zabójcza	3	Fem
Janusz O . przyznał się do stawianych mu zarzutów i bez poręczenia majątkowego dziś wyszedł na wolność .	majątkowego	12	Neut
O wrocławskim spotkaniu prezydentów Kwaśniewskiego i Chiraca oraz kanclerza Schrödera informowały wszystkie media .	wrocławskim	1	Neut
Przy czwartym zerwali obrady i ustawili się w kolejce , by podpisać listę obecności .	czwartym	1	Masc
Poza pracą zawodową inżynier Tadeusz Wróblewski zasłużył się również w organizowaniu życia sportowego .	sportowego	12	Neut
Powołano sejmową komisję śledczą do wyjaśnienia tej sprawy .	śledczą	3	Fem
To właśnie nasza Polska , nowa Rzeczpospolita , Coraz bardziej podzielona , coraz bardziej rozbita .	podzielona	10	Fem
w głębi duszy tłumisz pragnienie ucieczki od samej siebie .	samej	7	Fem
Ewentualna ratyfikacja Konkordatu przed przyjęciem nowej konstytucji zaważyłaby zapewne na jej ostatecznym brzmieniu , odbierając Konstytucji RP charakter nowoczesnej ustawy zasadniczej demokratycznego państwa .	zasadniczej	20	Fem
Oprócz słuchania Steczkowskiej delegaci zajmowali się dyskusją o strajku generalnym .	generalnym	9	Masc
Rodzina i przyjaciele powitali w sobotę uwolnione przez rosyjskie służby specjalne Polki .	uwolnione	6	Fem
Twoje inicjatywy , konkretne , praktyczne i pożyteczne , zyskają uznanie i poparcie .	pożyteczne	7	Fem
Musimy pracować , wziąć się do uczciwej pracy . . .	uczciwej	6	Fem
Wiecie także , iż w wielu miejscach toczą się walki z siłami , które w imię swych egoistycznych interesów chcą powstrzymać pochód postępu na świecie .	egoistycznych	17	Masc
Prawdopodobnie część sprzętu rozkradziono .	rozkradziono	3	Neut
Wódz Samoobrony ma być umoczony w molestowanie seksualne .	umoczony	4	Masc
Regina z ciekawością słuchała czytającego z kartki Bornsteina .	czytającego	4	Masc
To są poważne pytania .	poważne	2	Neut
Dostał oklaski od zebranych , ale odpowiedzi oficjalnej nie otrzymał .	oficjalnej	7	Fem
Trzecim , równie istotnym , podzbiorem są zasoby środowiska lokalnego .	lokalnego	9	Neut
Gładkie oblicze strzygonia stężało , alabastrowa skóra napięła się , jakby miała zaraz pęknąć .	Gładkie	0	Neut
Jednocześnie z budową fundamentów prowadzone są prace instalacyjne .	instalacyjne	7	Fem
W kilka godzin później wyjechałem z ciężkim sercem i obietnicą szybkiego spotkania .	szybkiego	10	Neut
Jest to duża armia , łącznie z oddziałami policji licząca 100 tysięcy ludzi .	licząca	9	Fem
Była tam nagrana jakaś muzyka .	nagrana	2	Fem
Odkrycie jest ważnym głosem w dyskusji dotyczącej bezpieczeństwa przeszczepów pochodzących od zwierząt .	dotyczącej	6	Fem
Przyzwoitość każe szanować gości i ja właśnie w ten elegancki sposób uszanuję Jagodowe wakacje .	Jagodowe	12	Neut
To naturalna rzecz a nie promocja osobista .	osobista	6	Fem
Projekty w kierunku zachodnim zostaną zrobione w przyszłym roku .	zrobione	5	Masc
Przerwali terapię we Mstowie i w krótkim czasie zmarli z powodu narkotycznego przedawkowania .	narkotycznego	11	Neut
Świat jest chaotyczny , procesy rozwojowe nie układają się w logiczne ciągi i trzeba się z tym pogodzić .	chaotyczny	2	Masc
W 2000 r . na światowych giełdach nastąpił krach , a zawyżone kursy akcji spółek internetowych spadły na łeb .	internetowych	15	Fem
Niemal wszystkie nici myśli kwestionującej prowadzą do Kartezjusza .	kwestionującej	4	Fem
Skazał go na wiele niepotrzebnych cierpień .	niepotrzebnych	4	Neut
Głubczycka PSS rozpoczynała swoją działalność od jednego sklepu .	Głubczycka	0	Fem
to jest robione dłuższym obiektywem . .	robione	2	Neut
Przepisuję im leki uspokajające , herbatki nasenne i zapewniam , że Amerykanie strzegą naszego bezpieczeństwa .	nasenne	6	Fem
Uszanowanie i respekt przed Bogiem są bardzo mocno zaakcentowane w doświadczeniu proroków .	zaakcentowane	8	Masc
W czasie weekendu dorodny lampart spacerował ulicami stolicy Indii , Delhi .	dorodny	3	Masc
Przecież widzisz , że jest zmęczona .	zmęczona	5	Fem
Zamki przemycała kobieta handlująca na bazarze Różyckiego w Warszawie .	handlująca	3	Fem
Do domu przyjechał em zupełnie głodny .	głodny	5	Masc
Ochmistrz ma otwartą kabinę , dla przyzwoitości pukam w uchylone drzwi .	uchylone	9	Neut
I doczekać z antykaczyńskim rządem do jesiennych wyborów .	antykaczyńskim	3	Masc
Niedawno premier Pawlak sformułował publicznie , w specjalnym wystąpieniu telewizyjnym , swoje własne zastrzeżenia .	telewizyjnym	9	Neut
Ma Pan olimpijską tremę ?	olimpijską	2	Fem
Przed światłami kierujący ruchem zatrzymał tira , a za nim stanęła skoda .	kierujący	2	Masc
Tymczasem komandor zatrzaśnięty w samochodzie wydzwaniał z telefonu komórkowego do znajomych .	komórkowego	8	Masc
Już nie nosi starych butów z pourywanymi sznurówkami .	starych	3	Masc
Zastrzeżenia wojewody dotyczyły tylko Polaków na stanowiskach kierowniczych .	kierowniczych	7	Neut
WDT jest państwową jednostką organizacyjną nieposiadającą osobowości prawnej .	nieposiadającą	5	Fem
Już trzykrotnie odwoływali się do Samorządowego Kolegium Odwoławczego , by unieważnić decyzję o warunkach zabudowy wydaną przez Wydział Architektury .	Samorządowego	5	Neut
Odnosił em literacki sukces .	literacki	2	Masc
Nie wiemy jeszcze , na ile uniwersalny jest przedstawiony model .	przedstawiony	8	Masc
Był to bowiem chłopak mądry i bardzo przenikliwy .	mądry	4	Masc
Policja przypuszcza , że najnowszy ładunek został porzucony przez spłoszonego niedoświadczonego terrorystę .	spłoszonego	9	Masc
Sześć cebul kupiła na kiermaszu zorganizowanym w pobliskiej szkole .	zorganizowanym	5	Masc
Zostały one przewiezione do szpitala .	przewiezione	2	Fem
Z oficjalnym żądaniem wobec MKOl , złożonym na piśmie , wystąpił Narodowy Komitet Olimpijski KRLD , domagając się od naczelnej władzy sportowej rewizji listy triumfatorów olimpijskich .	Olimpijski	13	Masc
Z obu stron drogi zaczęto strzelać do nich z granatników i broni maszynowej .	zaczęto	4	Neut
- Widzę siebie w przyszłej Radzie .	przyszłej	4	Fem
Rannymi cywilami zaopiekowali się najpierw amerykańscy sanitariusze z personelu naziemnego .	amerykańscy	5	Masc
Najpierw były występy rockowego zespołu muzycznego oraz pokazy tańca nowoczesnego grupy z tczewskiego Centrum Kultury i Sztuki i karaoke .	rockowego	3	Masc
Ledwo widać drogę , u Gontarczyków całe okno zawiało .	całe	6	Neut
Wszystkim udało się wydostać na powierzchnię , mimo że woda dostała się już do wnętrza i otwarcie drzwi było bardzo trudne .	trudne	20	Neut
Reformy ograniczono do totalnej prywatyzacji , która przyjęła raczej ramy wyprzedaży majątku narodowego .	totalnej	3	Fem
Chciał em zrobić ośrodek zimowy z prawdziwego zdarzenia .	zimowy	4	Masc
Jej mąż stał bezradny w kącie , tulił synka .	bezradny	3	Masc
Ma ono jakieś specjalne znaczenie ?	specjalne	3	Neut
W okresie międzywojennym pałac w Kadynach nie był zamieszkały .	międzywojennym	2	Masc
Bywa to jednak z reguły niewystarczające .	niewystarczające	5	Neut
Z oficjalnym żądaniem wobec MKOl , złożonym na piśmie , wystąpił Narodowy Komitet Olimpijski KRLD , domagając się od naczelnej władzy sportowej rewizji listy triumfatorów olimpijskich .	oficjalnym	1	Neut
Kasprowicz opuścił Wrocław i wyjechał do rodzinnego Szymborza .	rodzinnego	6	Neut
Prezentowano gospodarstwa agroturystyczne i przetwórstwo rolno - spożywcze .	spożywcze	7	Neut
Ale zapytany , dlaczego lubi szachy , znudzony zsuwa się z kanapy .	znudzony	7	Masc
Ilość plam pulsujących w jego oczach mnożyła się w zastraszającym tempie .	zastraszającym	9	Neut
Położono na niej nową nawierzchnię asfaltową .	nową	3	Fem
Nie miała m wtedy żadnych doświadczeń seksualnych .	seksualnych	6	Neut
Czy kolega czytuje wcześniejsze posty ?	wcześniejsze	3	Masc
Oczywiście , nie znaczy to , że tolerancja równa się bezczynnej akceptacji .	bezczynnej	10	Fem
Teraz to wszystko staje się naprawdę , doczekał się Stefan Chmura Piaskowej Góry .	Piaskowej	11	Fem
Czy to może być port lotniczy ?	lotniczy	5	Masc
Chłopiec przebywa w greckim przytułku prowadzonym przez organizację o złej reputacji .	złej	9	Fem
I jej przytułkowe dziecko było rude .	przytułkowe	2	Neut
Dziecko niespodziewanie wsiadło do czekającej na piętrze windy .	czekającej	4	Fem
Brakuje również sportowego sukcesu , zgodnego z oczekiwaniami kibiców i sympatyków Klubu .	zgodnego	5	Masc
W nadchodzącym tygodniu wyznaczone zostały posiedzenia czterech komisji sejmowych .	sejmowych	8	Fem
Fenometys wciąż kręcił głową , światło lamp odbijało się na bezwłosej skórze idealnymi refleksami .	idealnymi	12	Masc
Kiedyś poziom był dużo większy .	większy	4	Masc
Jest to więc najdłuższy pontyfikat XX wieku .	XX	5	Masc
Codziennie nakładam nawilżający krem na całe ciało .	całe	5	Neut
Za chwilę zjawią się kapłanki , a ja , jako bezbożnica , zostanę zelżona i wyrzucona stąd na zbity pysk .	wyrzucona	15	Fem
Podstawowe nazewnictwo łacińskie zostało przetłumaczone na język polski .	łacińskie	2	Neut
I niestety , gdy w pewnej chwili znów się wspiął na palce , nagle zachwiał się .	pewnej	5	Fem
Wyobraź sobie człowieka znajdującego się na ogromnej górze .	ogromnej	6	Fem
Uniemożliwiła mu to bardzo ofensywna postawa Raftera .	ofensywna	4	Fem
W tych pierwszych związkach nastolatki doświadczają smaku ludzkiej miłości , odkrywają siłę fascynacji i wzajemnego przyciągania siebie .	ludzkiej	7	Fem
Urzędniczka przysunęła mi telefon mimo tych niedołężnych wyjaśnień .	niedołężnych	6	Neut
Wojna i okupacja były tylko finałem , nieuchronnie wynikającym z samej istoty faszyzmu .	samej	10	Fem
Rebelianci z tak zwanej Wyzwoleńczej Armii Kosowa zajęli Belacewacz tydzień temu .	Wyzwoleńczej	4	Fem
Staruszkę ze zmiażdżoną prawą stopą przewieziono do szpitala przy ulicy Cegłowskiej .	prawą	3	Fem
Pseudokibicom ze Stalowej Woli upiekło się , choć nieźle w sobotę nabroili .	Stalowej	2	Fem
- Lokata nie jest istotna , choć oczywiście miło , gdy ma się niezły wynik .	istotna	4	Fem
Według dokumentów celnych miał przewozić wyroby czekoladowe .	celnych	2	Masc
Ale później , w latach sześćdziesiątych , wywiązała się intensywna publiczna debata na temat stosunków polsko - niemieckich . . .	intensywna	9	Fem
Patrzyła biernie , nie widząc niczego , na mijające za oknem podmiejskie pejzaże .	mijające	8	Masc
Ze ścian mrugają kolorowe neony świąteczne w kształcie choinek , bombek i dzwonków .	kolorowe	3	Masc
Rada Nadzorcza PZU zebrała się wczoraj rano .	Nadzorcza	1	Fem
Wiem , że Duda cholernie jest pani wdzięczna za Draba .	wdzięczna	7	Fem
Seniorska reprezentacja Polski zbliża się do zgrupowania we Wronkach .	Seniorska	0	Fem
Jednak ewentualne załamanie koniunktury przy obecnych cenach będzie oznaczać dla inwestorów upadek z wysokiego konia .	ewentualne	1	Neut
Był to bowiem chłopak mądry i bardzo przenikliwy .	przenikliwy	7	Masc
Wtedy głos zabrali solidni krytycy .	solidni	3	Masc
Użyto gazów łzawiących i ogłuszających granatów .	Użyto	0	Neut
Książęta kijowscy tracili podstawy gospodarcze swej pozycji politycznej .	kijowscy	1	Masc
Niezwyciężony lęk przed dziwem w każdym momencie serca przychodniów przeszywał .	Niezwyciężony	0	Masc
- Jednostki budżetowe nie są osobami prawnymi , Panie Senatorze .	budżetowe	2	Fem
Łódź odnaleziono porzuconą i ogołoconą z silnika i kosztownego wyposażenia .	ogołoconą	4	Fem
Najtrudniejsze zadanie stało przed Mercedesem .	Najtrudniejsze	0	Neut
Mówiły one o uniezależnieniu się Prus Książęcych od Polski .	Książęcych	6	Neut
Jednocześnie tacy ludzie chcą się dalej kształcić i rozwijać , żeby potem móc zmienić pracę na lepszą .	lepszą	16	Fem
Dodawał też , że korzystał z jawnych źródeł .	jawnych	6	Neut
Gdy na miejscu zjawili się policjanci z komisariatu kolejowego policji , schronisko znajdowało się w opłakanym stanie .	opłakanym	15	Masc
Po dwóch miesiącach przyprowadzono kotce jej własne dzieci .	własne	6	Neut
Obstępują solenizanta , śpiewają sto lat , a maluchy wręczają kolorowe paczki .	kolorowe	10	Fem
Tymczasem polska motoryzacja nie ma żadnej przyszłości poza prostym składaniem zestawów samochodowych , a planowana operacja ma zabezpieczyć interesy banków .	prostym	8	Neut
Coraz częściej kobiety próbują robić coś dla siebie , swojego zdrowia i lepszego samopoczucia .	lepszego	12	Neut
Stało się oczywiste , że porozumienia są możliwe i owocne .	oczywiste	2	Neut
ale takie miejsce jest potrzebne .	potrzebne	4	Neut
Funkcjonariusze inspekcji celnej przy pomocy biegłych ustalili , że przy próbie wywozu najprawdopodobniej naruszone zostały przepisy Kodeksu celnego .	celnego	17	Masc
Pierwsze krople deszczu zadudniły o trumnę i zmieszały się ze święconą wodą , którą ksiądz rozpryskiwał z kropidła podobnego do królewskiego berła .	królewskiego	20	Neut
Pomimo dokuczliwego zimna cieszyły się one dużym zainteresowaniem sportowców wiejskich .	dokuczliwego	1	Neut
Dołączył nawet bezpłatny krążek w tym formacie oraz firmowy , programowy odtwarzacz .	bezpłatny	2	Masc
Tym kobylim synom chodzi o to , by Francja dostała guzik .	kobylim	1	Masc
W zamian kuria proboszczem tego kościoła uczyniła jego starszego brata , ks . Zdzisława Struzika .	starszego	8	Masc
To byłoby śmieszne , groteskowe .	groteskowe	4	Neut
- Czytała ś dzisiejsze Życie ?	dzisiejsze	3	Neut
Polscy producenci nie dają za wygraną , dotrzymując kroku modzie i zachodnim nowinkom .	zachodnim	11	Fem
Wczoraj koło cmentarza w Sianowie znaleziono kilkuletniego chłopca .	kilkuletniego	6	Masc
A powiem ci , że to czeskie bydlę jest wyjątkowo nieapetyczne .	czeskie	6	Neut
W cywilizowanym świecie sprzedaż tytułu nie jest prosta .	prosta	7	Fem
Żegnamy się nowo poznaną piosenką i okolicznościowym hasłem .	okolicznościowym	6	Neut
Mówi monotonnie , bez składniowych harców , przeskoków , dygresji .	składniowych	4	Neut
Commercial Union od 1991 roku działa również na rynku naszych ubezpieczeń życiowych .	życiowych	11	Neut
Po części oficjalnej przyszedł czas na popisy artystyczne .	oficjalnej	2	Fem
21 sierpnia 1944 roku rozegrała się w tym miejscu pierwsza po 1939 roku regularna bitwa pomiędzy oddziałami Armii Krajowej i Armii Czerwonej .	Czerwonej	21	Fem
Udzielenie bowiem pracownikowi urlopu bezpłatnego nie oznacza rozwiązania umowy o pracę z danym zakładem .	bezpłatnego	4	Masc
Zdawał się zbierać myśli i szukać odpowiednich słów .	odpowiednich	6	Neut
Po chwili przyjechał fotograf i wszystko stało się jasne .	jasne	8	Neut
Do wytworzenia pary i utrzymywania ognia we właściwej temperaturze służy oddzielny palnik gazowy .	oddzielny	10	Masc
Z wolna milkły także widmowe instrumenty .	widmowe	4	Masc
Przyjęcie było bardzo serdeczne .	serdeczne	3	Neut
Bordowe volvo jest zarejestrowane na nazwisko Jana Burackiego .	Bordowe	0	Neut
W większości są to tylko gołe ściany .	gołe	5	Fem
Pamiętam swego pierwszego dużego bolenia .	dużego	3	Masc
Leczenie ataków padaczkowych polega na podawaniu leków przerywających drgawki niezależnie od ich przyczyny .	przerywających	7	Masc
Trupy wrzucono do Gopła .	wrzucono	1	Neut
Rzecznik Praw Obywatelskich wystąpił w obronie inwalidów wojennych i wojskowych , którym wprowadzono obowiązek płacenia za pobyt w sanatoriach uzdrowiskowych .	uzdrowiskowych	19	Neut
- Liczne przykłady coraz bardziej wyrafinowanych działań terrorystycznych na świecie uświadamiają społeczeństwu potrzebę ochrony przed tego typu zagrożeniami .	wyrafinowanych	5	Neut
Popierają regionalne środowiska twórcze .	regionalne	1	Neut
Inna sprawa , to szkolnictwo .	Inna	0	Fem
Ostatnim wysiłkiem naprowadza płonący samolot wprost na wieżyczkę u-boota .	płonący	3	Masc
– widziała ś gdzieś ogródki działkowe .	działkowe	5	Masc
— Dlaczego nie osądzono komunistów ?	osądzono	3	Neut
Trzech sprytnych chłopców szukało nawet syrenki w przedszkolnym akwarium .	przedszkolnym	7	Neut
Chciał by m poznać osobiście człowieka o tak niesamowitej wyobraźni .	niesamowitej	8	Fem
Reszta tonie w nieprzeniknionym zmroku .	nieprzeniknionym	3	Masc
Opaski przeglądamy w lipcu i niszczymy znajdujące się tam gąsienice .	znajdujące	6	Fem
Zakończono już inwentaryzację majątku w warszawskiej centrali .	Zakończono	0	Neut
Rozrywka jest kołem zamachowym telefonii komórkowej , a MMS bardzo ją uatrakcyjnią .	zamachowym	3	Neut
W tej sytuacji prokuratura wysłała do magistratu pismo ponaglające .	ponaglające	8	Neut
W przyległej sali grała orkiestra .	przyległej	1	Fem
Orzecznictwo jest niejawne i zaoczne .	zaoczne	4	Neut
Numer jego samochodu nie został odnotowany .	odnotowany	5	Masc
Nagle z ciemności wyłoniło się trzech mężczyzn kryjących twarze pod kominiarkami .	kryjących	7	Masc
W polskich warunkach , w których aspiracje polityczne hierarchii Kościoła katolickiego są tak jawne i wygórowane , groziłoby to szybkim regresem demokracji .	szybkim	19	Masc
Frenoplast , to inwestor produkujący okładziny hamulcowe .	produkujący	4	Masc
Analiza spektrometryczna wykazała , że jego skład izotopowy jest typowy dla procesów reaktorowych , a nie wybuchu jądrowego .	reaktorowych	12	Masc
Mock przytulił się do hrabiny i objął jej kruche ramiona .	kruche	8	Neut
Miejmy nadzieję , że ich nowa redakcja zawierać będzie wnioski autorów omawianej publikacji .	omawianej	11	Fem
Lepiej mieć czyste sumienie .	czyste	2	Neut
Sporo pisała o hinduizmie , islamie , Trzecim Świecie .	Trzecim	7	Masc
Prace polowe szybko postępują naprzód .	polowe	1	Fem
Ze wschodnim uporem i takąż wytrwałością badali każdą ewentualność sami , przez swych znajomych , przez znajomych , aż znaleźli .	wschodnim	1	Masc
Z jego przepalonego i odsłaniającego rusztowanie kręgów gardła wydobył się syk .	odsłaniającego	4	Neut
Marta opuściła mury Kliniki przedwcześnie , na własną prośbę .	własną	7	Fem
Cóż , dobrze wychowany człowiek po prostu nie zadaje takich pytań .	wychowany	3	Masc
Ja wszelako nie piszę w imieniu przegranych polityków .	przegranych	6	Masc
Temu sukcesowi w znacznej mierze przysłużył się również Szymon , który wywalczył 10 z 18 zdobytych przez Polaków punktów .	znacznej	3	Fem
Wybierz dowolny chat , umów się z przyjacielem na określoną godzinę i rozmawiaj do woli .	dowolny	1	Masc
Inaczej mogą zostać pobite .	pobite	3	Fem
Przygotowana na najgorsze Małgorzata dziwi się , że list jest aż tak jałowy .	Przygotowana	0	Fem
nie jesteśmy państwem granicznym jak Turcja .	granicznym	3	Neut
– zajęte jest . .	zajęte	1	Neut
- Stefan z uznaniem przygląda się jej nowemu mundurkowi .	nowemu	7	Masc
Do przechodzącego ulicą 28-letniego mieszkańca Ostrowca Świętokrzyskiego oddał dwa strzały .	przechodzącego	1	Masc
Po latach dowie się , że zostali rozstrzelani jeszcze przed jego aresztowaniem .	rozstrzelani	7	Masc
Do Warszawy dotarli już o gęstym zmroku .	gęstym	5	Masc
Wystawa w Tel Awiwie przyciągnęła ponad 5 tysięcy zwiedzających , pokazano ją we wszystkich izraelskich telewizjach , pisały o niej wszystkie gazety .	pokazano	10	Neut
Koncern nadal ma umowy licencyjne z producentami w Japonii , Włoszech , Afryce Południowej i na Filipinach .	Południowej	13	Fem
KPN chce zaproponować własne rozwiązania tego problemu i dlatego żąda od resortu danych o imporcie .	własne	3	Neut
Nawiedzony dom w Rajsach znają wszyscy , zarówno mieszkańcy Miejsca Piastowego , jak i krośnianie .	Nawiedzony	0	Masc
W Wielkopolsce na nową maturę zdecydowało się 522 abiturientów .	nową	3	Fem
Organem prowadzącym przychodnię jest gmina Kcynia .	prowadzącym	1	Masc
Dzieci były zachwycone prezentami od Michała .	zachwycone	2	Neut
Wylądował by na czwartym . . .	czwartym	3	Masc
Rozumiem , są to szczególne złotówki .	szczególne	4	Fem
Chodzi o 35-letnią Małgorzatę T . , mieszkankę jednej z pobliskich gmin .	pobliskich	10	Fem
Istotne jest , aby cele edukacji ekologicznej zostały przełożone na język konkretów mających zastosowanie w codziennych działaniach ucznia .	ekologicznej	6	Fem
Ważnym elementem samowychowującym jest nauka szkolna .	szkolna	5	Fem
Barok ambony , kiedyś dla niej naturalny , płynący dzielnie przez wieki , sprawiał teraz wrażenie kłopotliwego dodatku , fanaberii artysty , był nieznośnie kiczowaty , jarmarczny .	kiczowaty	24	Masc
— W sprawie wywiadu moja sekretarka skontaktuje się z pańską sekretarką .	pańską	9	Fem
- To stary , rozpadający się budynek .	rozpadający	4	Masc
Poza tym powinna być bardziej dostępna dla zainteresowanych osób , które zechcą przechować w nim ważne osobiste dokumenty .	dostępna	5	Fem
Dla zdobywców pięciu pierwszych miejsc przewidziano regulaminowe nagrody .	regulaminowe	6	Fem
Mówmy , że ktoś nieśmiały jest też bardziej wrażliwy , milszy .	nieśmiały	4	Masc
Teraz trwają intensywne przygotowania organizacyjne , sporządzane są ekspertyzy i bilanse .	sporządzane	6	Fem
Wyjaśnił w niej , że został wychowany w bardzo purytańskim domu , w którym wpojono mu szacunek dla takich cnót jak skromność i oszczędność .	purytańskim	9	Masc
- Powiewy bliskich gór przyniosły mu buntownicze słowa chłopskiej pieśni , zasłyszanej w dzieciństwie .	chłopskiej	8	Fem
Niestety , dalszy ciąg też nie ma pokrycia .	dalszy	2	Masc
Półwysep Jukatan to kilkadziesiąt obszarów archeologicznych .	archeologicznych	5	Masc
Szybkie obniżanie się tego ciężaru następuje zwykle w późniejszych stadiach rozwojowych i działalności metabolicznej grzybów .	rozwojowych	10	Neut
Należy podkreślić , że gaźnik jest ważnym elementem samochodu , gdyż oprócz ekonomicznego zużycia paliwa w znacznym stopniu wpływa również na niezawodność jazdy i stałą gotowość techniczną pojazdu .	techniczną	26	Fem
– W HSW SA trwa obecnie wielkie liczenie .	wielkie	6	Neut
Wówczas koła łowieckie będą dbały , aby populacja nie rozrastała się ponad dopuszczalną .	łowieckie	2	Neut
Przy wspólnym stole jadają tu studenci izraelscy i palestyńscy .	izraelscy	6	Masc
Źródło ognia znajdowało się przy drzwiach wejściowych .	wejściowych	6	Neut
Nic mądrzejszego ten naród nie potrafi wymyślić .	mądrzejszego	1	Neut
Przenosi obojętne spojrzenie na stronę z nekrologami , którą Gabriela przygważdża do stołu kościstym palcem .	obojętne	1	Neut
Zdaniem włoskich ekspertów , jest to słabe tłumaczenie , ponieważ wszyscy wiedzą , że region Molise leży w strefie silnej aktywności sejsmicznej .	silnej	19	Fem
Ale dla Serbów Kosowo ma olbrzymią wartość emocjonalną , to kolebka ich państwowości .	emocjonalną	7	Fem
Zazwyczaj młodym kobietom z zagranicy , zwabionym i przymuszanym do nierządu , sutenerzy odbierają paszporty .	przymuszanym	8	Fem
Początkowo zapanował iście świąteczny nastrój .	świąteczny	3	Masc
PiS okazało się osamotnione w swojej argumentacji .	osamotnione	3	Neut
Wypada być chudą , bladą , melancholijną .	bladą	4	Fem
Nad falami sterczał jeszcze tylko wystrzelający pionowo dziób .	wystrzelający	5	Masc
Michnik jest czwartym laureatem ustanowionej w 1996 r . nagrody .	czwartym	2	Masc
Bezpowrotnie stracił piękne synowskie uczucie i mocno poranił wrażliwą duszę młodego człowieka .	piękne	2	Neut
Głosowali śmy za powołaniem komisji śledczej .	śledczej	5	Fem
Będzie musiał kupić na bazarze jakieś najprawdziwsze świadectwo maturalne .	maturalne	8	Neut
Pod koniec roku 1977 chór liczył już 32 osoby .	1977	3	Masc
- Kto jest sukcesorem prawnym pana naczelnika ?	prawnym	4	Masc
Rezultat wydaje się z góry przesądzony , ale każdy z autorów chciał by dorzucić własne argumenty .	przesądzony	5	Masc
Bo nie przemija miłość do słów wypowiadających prawdę stałą , wieczną .	wieczną	10	Fem
Nadleśnictwa z terenu powiatu tucholskiego odwołały zakaz wstępu do lasu .	tucholskiego	4	Masc
Żonaty , ma 20-letnią córkę .	Żonaty	0	Masc
Jest nietykalny .	nietykalny	1	Masc
– Mieliśmy listę Wildsteina , teraz wypłynęła tak zwana lista 500 , o której istnieniu poinformował prezes IPN Janusz Kurtyka .	zwana	8	Fem
Osiedla się w Kafarnaum nad jeziorem i zaczyna swoją publiczną działalność .	publiczną	9	Fem
Zacisnąłem palce na szorstkim płótnie i wyczułem obłe kształty pocisków .	obłe	7	Masc
Nigdy nie wykroczył poza zasady wiary chrześcijańskiej .	chrześcijańskiej	6	Fem
21 sierpnia 1944 roku rozegrała się w tym miejscu pierwsza po 1939 roku regularna bitwa pomiędzy oddziałami Armii Krajowej i Armii Czerwonej .	1939	11	Masc
Poprzedziła go jednak półtoragodzinna przerwa .	półtoragodzinna	3	Fem
Szwagier pana Korzeniowskiego toporem rozrąbał świński łeb i wydobył mózg .	świński	5	Masc
to jest borówka amerykańska tylko większa .	amerykańska	3	Fem
Osuch przeszył go nieprzyjemnym , badawczym spojrzeniem .	nieprzyjemnym	3	Neut
Ich niski status społeczny sprawia , że poza czasem widowisk obrzędowych nie odgrywają oni istotnej roli w lokalnym życiu publicznym .	społeczny	3	Masc
Dotychczas lokatorzy budynków , w których zainstalowane są gazomierze , płacili za gaz co dwa miesiące .	zainstalowane	6	Masc
Trzydzieste piąte Targi zostały rozpoczęte .	rozpoczęte	4	Masc
Dlaczego ugrupowanie , które będzie rozliczane przez wyborców z efektów rządzenia , ma sobie utrudniać pracę ?	rozliczane	5	Neut
Wszyscy mieli przypięte kolorowe identyfikatory Orkiestry oraz specjalne puszki .	kolorowe	3	Masc
Oświadczył też , że idą z polecenia organizacji z bardzo ważnym zadaniem .	ważnym	10	Neut
Zmarł w Livorno w roku 1846 .	1846	5	Masc
Leczenie podtrzymujące za pomocą steroidów jest oczywiście gorszym rozwiązaniem niż leczenie polegające na usunięciu przyczyny .	gorszym	7	Neut
Czy to pierwszy taki wypadek przy ważnym politycznym głosowaniu ?	ważnym	6	Neut
Publiczność uprasza się o wcześniejsze zajmowanie miejsc .	wcześniejsze	4	Neut
W czasie pozorowanych działań bojowych jednostki z pozycji obronnych dokonają przegrupowania , aby po sforsowaniu szerokiej przeszkody wodnej wyjść na nowe rubieże aktywnych działań zaczepnych .	bojowych	4	Neut
Pięcioletnia dziewczynka , porwana wczoraj przez 65-letniego mężczyznę w Chorzowie na Śląsku , odzyskała wieczorem przytomność .	porwana	3	Fem
Zbierał te suche rozstajne krótkie drogi , wiązał w pokaźne drapadła o ściśniętym kierunku .	ściśniętym	12	Masc
Aktorstwo bardzo pochłania i to przenosi się na życie prywatne .	prywatne	9	Neut
Orzecznictwo jest niejawne i zaoczne .	niejawne	2	Neut
Klepał Jazończyka po ramieniu , ciągle ze śmiechem , mimo że twarz tamtego wyrażała surową powagę .	surową	14	Fem
Świadczenia były by mniej spłaszczone .	spłaszczone	4	Neut
Ostatecznym celem był garnizon w Greifswaldzie na Pomorzu .	Ostatecznym	0	Masc
Dziś od 19 . 27 ta pani działa nielegalnie !	19	2	Fem
IZABELLE ADJANl , gwiazda filmu francuskiego , wygrała precedensowy proces .	francuskiego	5	Masc
Coraz większym zainteresowaniem cieszą się fundusze inwestycyjne działające na terenie Szwecji .	inwestycyjne	6	Masc
Uczestnicy zjazdu wypili wodę święconą z kościoła Najświętszego Zbawiciela .	święconą	4	Fem
- A jak głosowali inni sarajewscy Serbowie ?	sarajewscy	5	Masc
Słońce , rozgrzewające żołądek Gregora Smidda , rozgrzało i granat .	rozgrzewające	2	Neut
Na jego otwarcie zjechali się przedstawiciele PSP w Warszawie , władze gminne , powiatowe oraz państwowe .	państwowe	15	Fem
Jedynie sierżant Jendruszko , w radosnym oczekiwaniu zwycięstwa , patrzył na wszystkich z politowaniem i wyższością .	radosnym	5	Neut
Był by to trzeci z rzędu rok , kiedy Francja nie sprostała wymaganiom UE .	trzeci	3	Masc
Podczas poprzedniej wojny dowodził własnym batalionem i , jak zapewniał , miał jeńców na tuziny .	własnym	4	Masc
- To twój dzisiejszy zarobek ?	dzisiejszy	3	Masc
Do dziś dziękuję Bogu , że trafiłem na takich porządnych ludzi , którzy dali nam dach nad głową i przysłowiowy talerz zupy .	porządnych	9	Masc
Ogromne znaczenie ma leczenie farmakologiczne .	farmakologiczne	4	Neut
Władze miasta zapewniają , że remont kapitalny torowiska na ulicy Pomorskiej rozpocznie się w pierwszej połowie bieżącego roku .	kapitalny	6	Masc
W sposób bardzo oczywisty demonstrował to przy spełnianiu swych zadań w mesie .	oczywisty	3	Masc
W akcji ratunkowej uczestniczyło ok. 20 ratowników .	ratunkowej	2	Fem
Powołujesz się na intelektualnego i emocjonalneog kastrata , ale czego innego mogł em się po Tobie spodziewać ?	innego	10	Neut
Z informacji lekarskiej o stanie zdrowia Havla , która została opublikowana w połowie grudnia , wynikało , że prezydent ma skłonności do zapadania na wirusowe schorzenia górnych dróg oddechowych .	górnych	26	Neut
Zamiast trzystu dwudziestu ośmiu obiektów elektryfikacyjnych , załoga wybudowała trzysta sześćdziesiąt cztery .	elektryfikacyjnych	5	Masc
Chętnie zatrudniłby w ministerstwie doświadczonych ludzi z organizacji ekologicznych .	doświadczonych	4	Masc
Z pozostałymi członkami dawnego kierownictwa związanymi z Gomułką plenum obeszło się bezceremonialnie , usuwając ich w większości ze składu KC .	dawnego	3	Neut
Smażyli ryby złowione w strumieniu .	złowione	2	Fem
Na zielonym płótnie okładki połyskiwały złote litery .	zielonym	1	Neut
Cebulę i zasmażkę dodać do gotowanej wody i gotować razem 15 minut .	gotowanej	5	Fem
Tymczasem polska motoryzacja nie ma żadnej przyszłości poza prostym składaniem zestawów samochodowych , a planowana operacja ma zabezpieczyć interesy banków .	planowana	14	Fem
Są to bardzo spóźnione rewelacje .	spóźnione	3	Fem
Jednocześnie następują dynamiczne , ale dostosowane do realiów społecznych i kapitałowych przekształcenia własnościowe .	społecznych	8	Neut
Jeden z mężczyzn przystąpił do majstrowania przy kablach telefonicznych .	Jeden	0	Masc
Z domu wyniosłam zamiłowanie do pracy , moja rodzina była rodziną pracowitych ludzi .	pracowitych	11	Masc
Jak tchórzliwy jest Manifest Połaniecki Kościuszki !	tchórzliwy	1	Masc
Ambona była wyjałowiona .	wyjałowiona	2	Fem
Dla trzeźwego jest to tylko bełkot .	trzeźwego	1	Masc
W sprawach zawodowych masz bardzo pomyślne perspektywy .	zawodowych	2	Fem
- Nie twierdzę , że jesteśmy bez winy , ale w zasadzie zarzut ten mógł by dotyczyć strony państwowej .	państwowej	18	Fem
Rzuca się na podłogę w hipermarkecie , bo nie dostało kolejnej zabawki .	kolejnej	10	Fem
To było przypadkowe uderzenie .	przypadkowe	2	Neut
Powrót odbywa się w tempie przyspieszonym .	przyspieszonym	5	Neut
Kochamy Polskę , lecz fakty składające się na polską rzeczywistość działają nam na nerwy .	składające	5	Masc
Zawodowe uprawianie miłości bywa w Polsce ganione .	ganione	6	Neut
W związku z wyrażonym wotum nieufności , Ponikowski w imieniu całego gabinetu poprosił o dymisję , która została przyjęta .	wyrażonym	3	Neut
Świadek ten był wezwany na wniosek Rzecznika Interesu Publicznego .	wezwany	3	Masc
Potem zaraz z świętym Piotrem zniknął .	świętym	3	Masc
Jak poinformował Cesar Fraga z Uniwersytetu w Buenos Aires , przeprowadzone tam badania wykazały , że czekolada wzmacnia antyutleniacze znajdujące się we krwi , zwiększając odporność na zaburzenia serca i naczyń wieńcowych .	wieńcowych	31	Neut
Widać też wpływy malarstwa starogreckiego i bizantyjskiego .	starogreckiego	4	Neut
Wędrował po Tatrach od 1914 r. , wspinał się od 1924 .	1924	10	Masc
A towarzyszą temu okrzyki i gesty wyrażające pogardę , wrogość , zawziętość .	wyrażające	6	Masc
- Ta oazowa pieśń prowadziła mnie z Ojczyzny przed 23 laty .	oazowa	2	Fem
Nowa kamera Canona automatycznie ustawia wszystkie parametry nagrywania , bardziej ambitnym użytkownikom pozwala jednak samodzielnie kontrolować ostrość obrazu i ekspozycję .	ambitnym	10	Masc
Prace regulacyjne doprowadziły by do zniszczenia siedliska bobrów i do przepędzenia ich w nieznane .	regulacyjne	1	Fem
Odnotowano ponadto kilkanaście zachorowań .	Odnotowano	0	Neut
Podczas świąt we wszystkich kościołach diecezji radomskiej odczytano list biskupa Zygmunta Zimowskiego .	radomskiej	6	Fem
Czemu godzę się na tortury pod obojętnym światłem wielkiej lampy ?	wielkiej	8	Fem
Z oficjalnym żądaniem wobec MKOl , złożonym na piśmie , wystąpił Narodowy Komitet Olimpijski KRLD , domagając się od naczelnej władzy sportowej rewizji listy triumfatorów olimpijskich .	sportowej	21	Fem
W lutym skradziono ją prawdziwemu funkcjonariuszowi w Warszawie .	skradziono	2	Neut
Równocześnie wznoszono nowoczesne dzielnice mieszkaniowe .	mieszkaniowe	4	Fem
Myślałem zrazu , że szkło jest zabrudzone .	zabrudzone	6	Neut
Tak jakby ludzie z kręgów kulturalnych bali się Szuwara , jakby mając nieczyste sumienie , chcieli jednak go wysłuchać , dopuścić do głosu .	kulturalnych	5	Masc
Sprawę poruszono na ostatniej sesji rady powiatu .	poruszono	1	Neut
Tytus czuł się samotny i opuszczony .	opuszczony	5	Masc
Jeśli zostanie on zrealizowany , to za pięć lat będziemy mieli w kraju ok . półtora miliona rodzin pszczelich .	pszczelich	18	Fem
Ten Murzyn to sekretarz generalny ONZ , Kofi Annan .	generalny	4	Masc
Czy Dominik , broniąc się , mógł przewidzieć aż tak dramatyczne skutki ? !	dramatyczne	10	Masc
21 sierpnia 1944 roku rozegrała się w tym miejscu pierwsza po 1939 roku regularna bitwa pomiędzy oddziałami Armii Krajowej i Armii Czerwonej .	1944	2	Masc
Po śląskich miastach grasuje zboczeniec , który atakuje młode dziewczyny !	śląskich	1	Neut
Za pomocą kamer przemysłowych inżynierowie obserwowali próby przekazu prowadzone na parkiecie w dyskotece .	przemysłowych	3	Fem
– antykoncepcje też jest zabroniona ?	zabroniona	4	Fem
Rada Nadzorcza towarzystwa na wczorajszym posiedzeniu pominęła sprawy personalne .	Nadzorcza	1	Fem
Wydaje się , że powrót do pracy jest swoistym lekarstwem .	swoistym	8	Neut
Sprawdzamy wyrostki kolczyste i łuki kręgów .	kolczyste	2	Masc
Zwycięzcą biegu maratońskiego został 87-letni dziś Koreańczyk Ki - jung Son .	87-letni	4	Masc
Już trzykrotnie odwoływali się do Samorządowego Kolegium Odwoławczego , by unieważnić decyzję o warunkach zabudowy wydaną przez Wydział Architektury .	Odwoławczego	7	Neut
W jego koszyku znalazło się aż 125 dorodnych prawdziwków .	dorodnych	7	Masc
Przypomnijmy , że na budowę centrum hurtowego nie zgadzają się mieszkańcy Osowej .	hurtowego	6	Neut
- My tu o wzniosłych rzeczach mówimy .	wzniosłych	4	Fem
Po ich koncercie ludzie przychodzili do mnie i dziękowali , że zaprosiłem tak widowiskową grupę .	widowiskową	13	Fem
Na środku kolejnego ronda wyrósł murek z roślinami na szczycie .	kolejnego	2	Neut
- Kapitan zniknął w mrocznym korytarzu .	mrocznym	4	Masc
- Nie sprawiał żadnych problemów wychowawczych .	wychowawczych	5	Masc
Czasem wraca jakieś niezłe szyderstwo Wojtasa .	niezłe	3	Neut
Sam Misztal nie ukrywa , że chce zamknięcia dyskoteki .	Sam	0	Masc
Ostatnia wizyta we Włoszech miała przede wszystkim charakter gospodarczy .	Ostatnia	0	Fem
Tamta patrzyła zaskoczona .	zaskoczona	2	Fem
Oddanie do użytku domków w Połańcu w październiku 1997 r . było wyjątkowo uroczyste .	uroczyste	13	Neut
I mnie o waszych spotkaniach powiedzieli uczynni sąsiedzi .	uczynni	6	Masc
Wśród 65-tysięcznej publiczności oglądającej uroczyste otwarcie igrzysk będzie 40 najwyższych dostojników różnych państw .	uroczyste	4	Neut
Nad placem przeleciały myśliwce naddźwiękowe .	naddźwiękowe	4	Masc
Badania wielkości sił naciągu strun na torze przeprowadzono przez bezpośredni pomiar sił w poszczególnych strunach za pomocą przyrządu VOGT .	przeprowadzono	7	Neut
- Normalnych klientów mi odstraszyli .	Normalnych	1	Masc
Będzie musiał kupić na bazarze jakieś najprawdziwsze świadectwo maturalne .	najprawdziwsze	6	Neut
W Konstancinie-Jeziornie i Spale przygotowują się piłkarskie reprezentacje do nadzwyczaj ważnych spotkań .	ważnych	10	Neut
Słuchacze poznają wiele elementów prawa , psychologii , socjologii , polityki społecznej , informatyki .	społecznej	11	Fem
Gdy zrozumiał , że Zachód mylnie pojmuje religię hinduską jako politeizm , zaczął szukać głębszych warstw i analogii .	hinduską	8	Fem
Panowie w cylindrach i w melonikach tkwili bokiem na przednich ławeczkach .	przednich	9	Fem
- Komar to żywa istota .	żywa	3	Fem
Pierwsze i drugie miejsce zajęły słowackie dziewczęta , ubrane w getry i krótkie falbankowe spódniczki .	ubrane	8	Neut
Zarzucał nas wiadomościami o długiej zimie .	długiej	4	Fem
Był brytyjski lotniskowiec , amerykańskie fregaty , hiszpańska piechota morska , portugalscy komandosi , polscy lotnicy .	brytyjski	1	Masc
W niżej położonych Puławach przekroczyła stan ostrzegawczy o 30 cm .	położonych	2	Neut
Umożliwiają one niestosowanie się do niektórych znaków drogowych .	drogowych	7	Masc
Inwestycję wznowiono w połowie 2004 roku , a wartość zadania wynosi 5,6 miliona złotych .	2004	4	Masc
Wypowiedział wojnę wielu bardzo różnym środowiskom .	różnym	4	Neut
Przejazd we wrocławskich Świniarach nie jest strzeżony .	wrocławskich	2	Neut
Ani mu się śniło opowiadać o słonecznej wiośnie .	słonecznej	6	Fem
Zdenerwowani są także kierowcy .	Zdenerwowani	0	Masc
Pod jej nosem błyszczał pot , musiała biec , widocznie firma pilnująca mieszkania nie zawiadomiła jej o wyłączeniu alarmu .	pilnująca	11	Fem
Wesołe były jego oczy .	Wesołe	0	Neut
Odbędzie się on w Sali Kongresowej w Warszawie .	Kongresowej	5	Fem
Poranione potłuczoną butelką zwierzę trafiło do weterynarza .	potłuczoną	1	Fem
Jeśli to jest absolutnie niemożliwe , znaczy to , że twój charakter jest czymś pośrednim pomiędzy dwoma opisanymi w rozwiązaniu przy odpowiednich numerach .	odpowiednich	21	Masc
Na seminarium historycznym występowały wszystkie wielkie walory uczonego i nauczyciela .	wielkie	5	Masc
Biała prawica w RPA zarzucała Treurnichtowi nadmierną ugodowość wobec rządzącej Partii Narodowej , a także pasywność .	Biała	0	Fem
Przy ośrodkach będzie się prowadzić także punkty apteczne .	apteczne	7	Masc
Od wolnej woli wybaw nas , Panie .	wolnej	1	Fem
Ponieważ ciągle nie została ujawniona publicznie statystyka represji poczerwcowych , trudno powiedzieć cokolwiek na temat ich zasięgu .	ujawniona	4	Fem
Dante raczył zajmować się przede wszystkim potępionymi .	potępionymi	6	Masc
Wobec wniosku o uznanie tej odpowiedzi za wystarczającą zgłoszono sprzeciw .	zgłoszono	8	Neut
Mimo ciepłego dnia pani domu przyjęła ją otulona w brązowy blezer , spod ciemnej spódnicy wystawały chude łydki .	ciepłego	1	Masc
Zapomniała pani poseł jeszcze o jednej rzeczy , chyba najważniejszej .	najważniejszej	9	Fem
– Pokazał ręką przeszklone okna penthausu .	przeszklone	3	Neut
Wino białe pije się inaczej .	białe	1	Neut
Zwolnienia zostaną rozłożone na cały 2001 r .	2001	5	Masc
Z ogromną prędkością przejechały przez nie dwa samochody osobowe .	ogromną	1	Fem
Wychowawczyni była rada .	rada	2	Fem
Za granicą sprzedawane są nasiona w mieszankach i pojedynczych kolorach .	sprzedawane	2	Neut
Stali się dwujęzyczni .	dwujęzyczni	2	Masc
Wydarzeniu patronował marszałek województwa mazowieckiego Adam Struzik .	mazowieckiego	4	Neut
Wybiła trzecia .	trzecia	1	Fem
Sekretarz Łapa społecznie działa w poradni małżeńskiej , ale z podobnym postępowaniem kobiety nie spotkał się .	małżeńskiej	6	Fem
Wilk zastanowił się chwilę , po czym z lekkim drżeniem w sercu zadał najważniejsze pytanie .	lekkim	8	Neut
KTO PIERWSZY ZAPALIŁ OGIEŃ NA ROZEWIU ?	PIERWSZY	1	Masc
Nim Marcin odejdzie , dzieje się coś dziwnego .	dziwnego	7	Neut
Widział eś kiedyś nienawidzącego swej ofiary drapieżnika ?	nienawidzącego	3	Masc
Straszny ziąb w nawie , nawet anioł ze środkowego pilastru wydaje się drżeć z chłodu .	Straszny	0	Masc
Od 1993 r . jest kierownikiem Zakładu Współczesnych Teorii Ekonomicznych , a od 1999 r . pełni funkcję dziekana Wydziału Ekonomiczno - Socjologicznego Uniwersytetu Łódzkiego .	Ekonomicznych	9	Fem
Nie sprzyja to oczywiście bezusterkowemu oddawaniu obiektów .	bezusterkowemu	4	Neut
Są one bezsporne .	bezsporne	2	Masc
Czy prowadzi nas jeszcze Orfeusz , czy Hermes , a może od dawna już idziemy sami ?	sami	15	Masc
Lata dziewięćdziesiąte to również okres rozwoju przestrzennego Uniwersytetu .	przestrzennego	6	Masc
Przy wypełnianiu zeznania podatnik powinien się trzymać ustawy i rozporządzeń wykonawczych .	wykonawczych	10	Neut
Jego dyrektor tłumaczy , że to za sprawą długów zostawionych przez poprzedników .	zostawionych	9	Masc
I nie myśl , że mam Ci to za złe .	złe	9	Neut
Wtorkowa nominacja wywołała gwałtowne protesty całej opozycji .	Wtorkowa	0	Fem
Później zauważył , że lewe oko krwawi .	lewe	4	Neut
Czy w różnych stadiach ewolucji Wszechświata aktywne jądra galaktyk były identyczne ?	aktywne	6	Neut
Książka zniknęła natychmiast z półek księgarskich .	księgarskich	5	Fem
Generalnie znacznie lepiej wypadły kąpieliska w województwie zachodniopomorskim .	zachodniopomorskim	7	Neut
Na plebanii przy obecnej katedrze trwają ostatnie ustalenia .	obecnej	3	Fem
Otworzyłam go na pierwszej stronie i natknęłam się na pożółkły wycinek z gazety .	pożółkły	9	Masc
Na bezdomne po Powstaniu Warszawskim dwie głośne pisarki czekały w Łodzi zarezerwowane dla nich mieszkania .	zarezerwowane	11	Neut
Sztandar bojowy podniosły także narody podbite i uciemiężone przez carat .	bojowy	1	Masc
Księdza zatrzymano w ubiegłym tygodniu na polsko - ukraińskim przejściu granicznym w Dorohusku przy wjeździe do Polski .	zatrzymano	1	Neut
Z zasady oglądam trzecią próbę generalną .	generalną	5	Fem
Cały kraj był zdławiony tym okropnym cieniem .	okropnym	5	Masc
Z ciał potopionych stryjów wylęgły się tysiące myszy i wyruszyły wszystkie do Kruszwicy , prosto na dwór zbrodniarza .	potopionych	2	Masc
Oto wybiera się sierota z całą gromadą kopać na hrabiowskich redlinach .	hrabiowskich	9	Fem
Agnieszka jest odurzona szczęściem .	odurzona	2	Fem
Do akcji ratunkowej wezwano prawie wszystkich strażaków z zakopiańskiej Jednostki Ratowniczo - Gaśniczej .	Gaśniczej	12	Fem
Ostatnie pytanie wydaje się Kleinowi retoryczne .	retoryczne	5	Neut
W kościele mariackim w Radomiu o północy mszę święto odprawił biskup senior Edward Materski .	święto	8	Fem
Spojrzała m na jej męża , ale oczy miał zasłonięte kapeluszem .	zasłonięte	9	Neut
Zatrzymani wczoraj przestępcy od roku działali na własną rękę .	własną	7	Fem
Po ofiarach tylko czasem zawyje wierny pies .	wierny	5	Masc
" Życie jest zbyt krótkie , żeby pić liche wina " .	liche	8	Neut
W ostatnich latach w Polsce nie powstał żaden klub hokejowy .	hokejowy	9	Masc
Nowe realia wymagają innego typu zachowań i pomysłów .	Nowe	0	Neut
Rada Nadzorcza towarzystwa na wczorajszym posiedzeniu pominęła sprawy personalne .	Nadzorcza	1	Fem
Policja po kilku godzinach odzyskała skradziony samochód , jeszcze przed oficjalnym zgłoszeniem przestępstwa .	skradziony	5	Masc
Położenie geopolityczne i ropa sprawiają , że tu krzyżują się interesy wielu państw , w tym Rosji , USA i Turcji .	geopolityczne	1	Neut
Szkodliwie też działają tutaj obfite kolacyje " .	obfite	4	Fem
Czym się bawi dziecko na wycieczce autokarowej ?	autokarowej	6	Fem
Faceci wyglądają na prawdziwych twardzieli .	prawdziwych	3	Masc
Słuszne pytania i odpowiedzi mieszają się z podłymi .	Słuszne	0	Neut
Operację na lotnisku przeprowadzono na 10 godzin przed upływem ultimatum postawionego przez porywaczy .	postawionego	10	Neut
Przypuszczam , że akurat to pytanie jest , Panie Senatorze , trochę przedwczesne .	przedwczesne	12	Neut
– i nie jestem sztywny no . .	sztywny	4	Masc
Podczas niemieckiej okupacji spotykaliśmy się , należąc do podziemnej literackiej Warszawy .	podziemnej	8	Fem
Nie zważali na żar , ogień i surowe wojenne prawa . . .	surowe	7	Neut
Na skrzyżowaniach wyrastają rośli policjanci , gazeciarze wciskają przechodniom papierowe płachty i przekrzykują się nowościami z wczorajszego dnia i nocy , która właśnie minęła .	rośli	3	Masc
- Z biegiem lat pańska gniewność ustąpiła ?	pańska	4	Fem
Stara to jest historia sprzed japońskiej wojny .	Stara	0	Fem
Nie mogą one zająć się w sposób szczególny dziećmi autystycznymi .	autystycznymi	9	Neut
Układy ACC technologiczne stosuje się przede wszystkim do obróbki zgrubnej w celu maksymalizacji wydajności obróbki .	zgrubnej	9	Fem
Artyści z trzech akademii sztuk pięknych oglądali wczoraj budynki przy ulicy Zamkowej .	Zamkowej	11	Fem
Rzecz dotyczy berlińskiej olimpiady w 1936 roku i przynależności państwowej triumfatora .	państwowej	9	Fem
Po długiej chwili wynurzył się , dostrzegł łódkę .	długiej	1	Fem
U małych pacjentów lekarze stwierdzali najczęściej anginę i nieżyt górnych dróg oddechowych .	górnych	9	Fem
Większa liczba emerytów oznacza przecież , że ludzie aktywni zawodowo będą musieli wydajniej pracować , wzrośnie również obciążenie służby zdrowia i służb socjalnych .	aktywni	8	Masc
Ale cięższą przeprawę mieli ci dziennikarze , którzy szli do centrum prasowego , by stamtąd jechać dalej autokarami .	prasowego	11	Neut
Na muzeum przeznaczono część parteru drewnianego budynku .	drewnianego	5	Masc
- Szokująca jest wysoka śmiertelność z powodu raka szyjki macicy .	Szokująca	1	Fem
Tymczasem w liceach prowadzonych przez Społeczne Towarzystwo Oświatowe zdanie egzaminu dojrzałości nie należy do najłatwiejszych .	Oświatowe	7	Neut
Wstępną odpowiedź firma ma dać w ciągu dwóch tygodni .	Wstępną	0	Fem
Oburzenie autorów listu na wulgaryzację języka i kultury współczesnej jest słuszne .	słuszne	10	Neut
Zaczynam odczuwać tęsknotę za utworami o głębszej treści i większym sensie .	większym	9	Masc
Pies musi być podwórzowy , zły , w budzie na łańcuchu siedzący .	siedzący	11	Masc
Natomiast zdjęcia eksponowane w MDK ukazują nowe spojrzenie na fotografię , którego dominantą jest wykonywanie makrofotograficznych ujęć z bardzo bliskiej odległości przy małej głębi ostrości .	eksponowane	2	Neut
Milczeli przez dłuższą chwilę .	dłuższą	2	Fem
Po zakończeniu prac zapomniano o ponownym ich umieszczeniu .	ponownym	5	Neut
Była w deszczowym płaszczu i w obcisłej , skórzanej czapeczce .	skórzanej	8	Fem
Z ważnych powodów sąd może na żądanie poszkodowanego przyznać mu zamiast renty lub jej części odszkodowanie jednorazowe .	jednorazowe	16	Neut
Robimy następny duży krok do III ligi .	następny	1	Masc
Polskich komunistów nie łączyły nigdy żadne specjalne więzy z przywódcami ludowych Chin .	specjalne	6	Neut
Raport podkreśla , że w wielu krajach najpoważniejszym problemem jest wysokie bezrobocie .	najpoważniejszym	7	Masc
Szeroko otwierał szkarłatne oczy , drgały mu wrażliwe nozdrza .	szkarłatne	2	Neut
Zaprojektowano specjalną okazałą szafę z 205 boksami .	Zaprojektowano	0	Neut
Nowoczesną motorówkę do patrolowania Wisły ukradziono policjantom z Torunia .	Nowoczesną	0	Fem
Jeden z architektów przybija na ocalałej bramie kartkę wyrwaną z notesu .	wyrwaną	8	Fem
Wszyscy byli trzeźwi .	trzeźwi	2	Masc
Związkowcy podkreślili jednak , że mają gwarancje ministra w sprawie modelu PKP i przyszłych przekształceń kolei oraz dalszych rozmów z nimi .	dalszych	17	Fem
- Nie ma ludzi zdrowych , są tylko źle zdiagnozowani .	zdiagnozowani	9	Masc
Dolną część garderoby osłaniamy papierowymi ręcznikami , aby nie pobrudzić jej później jajkami .	papierowymi	4	Masc
W 2007 roku neurolodzy amerykańscy wyciągnęli je z muzeum i poddali badaniu rezonansem magnetycznym .	magnetycznym	13	Masc
Przebiegające pod miastem chodniki kopalni zalano wodą , a wzgórze zgniło i zapadło się w ziemię jak przydeptane .	Przebiegające	0	Masc
Walkom rewolucyjnym towarzyszyły klęski rosyjskie na Dalekim Wschodzie w wojnie z Japonią .	rewolucyjnym	1	Fem
W oddzielnych grupach ćwiczą panie i panowie , później znów spotykają się i odbywają wspólnie zajęcia choreograficzno - taneczne .	oddzielnych	1	Fem
Siedział już w oknie , z nogami wystawionymi na zewnątrz , ale w porę obezwładnili go i ściągnęli z okna strażnicy miejscy .	miejscy	21	Masc
Często śniło się jej , że biegnie za oderwaną ręką i nie może jej dogonić .	oderwaną	8	Fem
- W iluż miastach w okresie letnim odbywa się tyle bezpłatnych występów artystycznych .	artystycznych	12	Masc
Wysiadł więc i piknął pilotem , blokując centralny zamek .	centralny	7	Masc
- Czas koronowanych głów minął .	koronowanych	2	Fem
Angelina Jolie jest bezgranicznie zakochana w swoim adoptowanym synku , który niedawno urodził się w Kambodży .	adoptowanym	7	Masc
Pozostałoby do rozstrzygnięcia pytanie , dlaczego paradoks , występujący w odniesieniu do przenoszenia masy i energii w przeszłość , nie obowiązuje w stosunku do przyszłości .	występujący	8	Masc
W naszej kantynie fabrycznej zmniejszono nam obiad o jedno danie .	fabrycznej	3	Fem
Budynek podpalono .	podpalono	1	Neut
Dziś już wiadomo , że powszechnie akceptowany na świecie jest model bazujący na podejściu bilansowym , koncepcji pełnej alokacji i metodzie zobowiązań .	akceptowany	6	Masc
Tragiczny wypadek zdarzył się na trasie kolejowej z Piły do Chojnic .	kolejowej	6	Fem
Jednak po dokładnych oględzinach straż pożarna odkryła ofiarę pożaru .	dokładnych	2	Neut
Jestem niepobożnym ministrantem z pazurami .	niepobożnym	1	Masc
Za sobą mieli martwą rzekę , która leżała wśród piasków jak rozbity dzban .	rozbity	11	Masc
Jednocześnie prezydent Egiptu Hosni Mubarak ogłosił , że jest możliwy kompromis .	możliwy	9	Masc
Od tego czasu rząd francuski trzykrotnie występował o opuszczenie budynku .	francuski	4	Masc
Czy naprawdę seks jest taki długowieczny ?	długowieczny	5	Masc
Związkowcy nie mają łatwego życia w policji .	łatwego	3	Neut
Jego spojrzenie , przed chwilą spłoszone , było teraz śmiałe i podstępne .	podstępne	11	Neut
Żeby wrogów zwabić w zakreślone koło .	zakreślone	4	Neut
Służby ratownicze w Stalowej Woli toczyły dziś walkę z oleistą plamą na Sanie .	Stalowej	3	Fem
Tęsknota była silniejsza niż głód .	silniejsza	2	Fem
Miał oczy przymknięte , blada twarz była bez wyrazu , jakby zabierał się do wysłuchania banalnej spowiedzi .	przymknięte	2	Neut
Ale nie lubię jubileuszy i nie czuję się zramolałym jubilatem .	zramolałym	8	Masc
Za mną stał szczupły , niewysoki brunet .	szczupły	3	Masc
Mały Marcel lubi oglądać kościoły .	Mały	0	Masc
A ten głupi Rzymianin powiedział , że go tam odeśle . . .	głupi	2	Masc
Powołujesz się na intelektualnego i emocjonalneog kastrata , ale czego innego mogł em się po Tobie spodziewać ?	emocjonalneog	5	Masc
Poldek trąca mnie w ramię i wzrokiem wskazuje na niemieckie stanowisko .	niemieckie	9	Neut
Zwykły mieszkaniec kraju ma się leczyć ziołami , które zaleca tradycyjna medycyna koreańska .	tradycyjna	10	Fem
- To wypracowuje się na codziennych , mozolnych próbach .	mozolnych	7	Fem
Rosyjsko - niemiecka inwestycja ominie Polskę i inne państwa Europy Środkowej .	niemiecka	2	Fem
– Najpierw chciałbym sprawdzić jakość tego francuskiego łóżka .	francuskiego	6	Neut
Załamała się tradycja zbiorowych wystąpień i manifestacji .	zbiorowych	3	Neut
Za każdy samochód zabierali się od razu mechanicy , zmieniali koła , usuwali uszkodzenia powstałe w czasie forsownego treningu , wymieniali zdarte nakładki hamulcowe , regulowali silniki .	hamulcowe	23	Fem
Białe policyjne motocykle są doskonale oznakowane .	oznakowane	5	Masc
To jeden z najbardziej newralgicznych punktów komunikacyjnych miasta .	komunikacyjnych	6	Masc
W ogólnym rozgardiaszu jedynie Kosiński i Gorczyca zachowywali się spokojnie .	ogólnym	1	Masc
( Przypomnę tutaj , że w Komisji Trójstronnej trwają intensywne prace nad przygotowaniem nowelizacji tejże ustawy ) .	intensywne	9	Fem
Niosła się w obłoku , zakurzona .	zakurzona	5	Fem
Zakończyły się ligowe rozgrywki drużynowych mistrzostw Polski w zapasach .	ligowe	2	Fem
Porozumienie to podpisano bez wstępnego konsultowania się z rządem .	wstępnego	4	Neut
Wszedł do wagonu , w przejściu natknął się na konduktora - służbistę , który zrobił mu wykład o niebezpieczeństwie związanym ze wskakiwaniem do pociągu w biegu .	związanym	19	Neut
Pod uniesionymi zasłonami rozległego łoża z trudem udało mu się dostrzec ginącą w powodzi koronek , pomarszczoną twarz pani Lamaire .	rozległego	3	Neut
Powierzchnię morza pruły statki , oczekujące pojawienia się ostatniego członu rakiety .	oczekujące	5	Masc
Ojczyźnie naszej grozi śmiertelne niebezpieczeństwo .	śmiertelne	3	Neut
Księdza zatrzymano w ubiegłym tygodniu na polsko - ukraińskim przejściu granicznym w Dorohusku przy wjeździe do Polski .	ukraińskim	8	Neut
Jeszcze dozwolono ci wybrać . . .	dozwolono	1	Neut
Dodatkowe połączenia D dopełniają charakter układu .	Dodatkowe	0	Neut
W poniedziałek ustalony został ostateczny podział funkcji w radzie nadzorczej tucholskiej Spółdzielni Mieszkaniowej .	nadzorczej	9	Fem
Brzegi chodników były zastawione ławkami .	zastawione	3	Masc
Stwierdziła , że wszystko jest niemodne .	niemodne	5	Neut
Ostatni , w 1822 , strawił większość drewnianej i murowanej zabudowy .	1822	3	Masc
Deszcze spowodowały znaczne zakłócenia w komunikacji kolejowej i lotniczej na południu kraju .	znaczne	2	Neut
Szofer niecierpliwił się przy załadowanej ciężarówce .	załadowanej	4	Fem
We wrocławskim zoo trzymamy je w kilku grupach .	wrocławskim	1	Neut
Spotkał Brońcię z białą kózką .	białą	3	Fem
Życie ojca , surowe i ciężkie , całkowicie poświęcone rodzinie i opiece nad innymi ludźmi , budzi dziś zdumienie nieprawdopodobną obowiązkowością , odpowiedzialnością i pogodą ducha .	poświęcone	8	Neut
Pobladłą twarz pilota rozjaśnia triumfalny uśmiech .	Pobladłą	0	Fem
Na zakupy zabierajmy ze sobą koszyk lub płócienną torbę .	płócienną	7	Fem
Ich przedstawiciele , służąc w Gwardii Szlacheckiej , dodawali splendoru Stolicy Piotrowej , a jednocześnie znajdowali tam niejednokrotnie środki dla wygodnego życia , ponieważ za swą służbę otrzymywali pensje .	wygodnego	20	Neut
Dla zdrowia psychicznego i fizycznego trzeba wówczas chwilowo panią uśpić .	fizycznego	4	Neut
Do zbrodni przyznał się 22-letni mieszkaniec tego miasta .	22-letni	4	Masc
Partyjni stratedzy planują więc przedsięwzięcia z myślą o wyborach dalszych , tych pojutrze .	Partyjni	0	Masc
Przesadził em tu z ofensywnym tonem .	ofensywnym	4	Masc
Rannymi cywilami zaopiekowali się najpierw amerykańscy sanitariusze z personelu naziemnego .	naziemnego	9	Masc
Zbyt szybkie tempo życia doprowadza zwykle do zmęczenia i bałaganu .	szybkie	1	Neut
Skałki Kroczyckie są miejscem treningów członków śląskich klubów wysokogórskich .	Kroczyckie	1	Fem
Po ślubie wynajęli mieszkanie w starej kamienicy .	starej	5	Fem
Dochodzenie w sprawie wypadku wszczęła Prokuratura Rejonowa w Szczytnie .	Rejonowa	6	Fem
Podróżujący pierwszą klasą będą odtąd mogli wypoczywać podczas lotu na rozkładanych podwójnych siedzeniach .	podwójnych	11	Neut
Na bezdomne po Powstaniu Warszawskim dwie głośne pisarki czekały w Łodzi zarezerwowane dla nich mieszkania .	głośne	6	Fem
Opary porannej mgły nad jeziorem znikały w złotych promieniach słońca .	porannej	1	Fem
Pisarz już był przytomniejszy .	przytomniejszy	3	Masc
Są chętne , jak Lilka .	chętne	1	Fem
Podczas śledztwa , na podstawie skąpej dokumentacji granicznej , udało się ujawnić personalia polskiego kierowcy .	granicznej	7	Fem
Aby właściwie odebrać myśli autora , wskazane jest odpowiednie przygotowanie matematyczne .	matematyczne	10	Neut
Ojciec był zapalonym myśliwym i często wybierał się na polowania , zasilając w ten sposób naszą spiżarnię .	zapalonym	2	Masc
Za chwilę kardynałowie i biskupi wyniosą obraz Matki Bożej Jasnogórskiej na ołtarz przed kościołem .	Bożej	8	Fem
Juniorską reprezentację w najbliższym czasie czekają półfinały ME w Essen .	najbliższym	3	Masc
Ale to tylko moje skromne zdanie . . .	skromne	4	Neut
Do Sieradza jest tylko kilka bezpośrednich połączeń dziennie .	bezpośrednich	5	Neut
Niedawno zapytał darłowskie dzieci , kim był król Eryk .	darłowskie	2	Neut
Pomiaukując alarmująco , zaprowadził Adama do dużego pokoju .	dużego	6	Masc
Drużyna polska będzie walczyła w następującym zestawieniu .	następującym	5	Neut
W jej twarzy , mokrej od łez rozmazanych i czerwonej , tężały w osłupieniu szkliste , bladoniebieskie oczy .	szkliste	14	Neut
Poczuli lodowate zimno .	lodowate	1	Neut
Koniec jego był bardzo smutny .	smutny	4	Masc
Na klatce schodowej domu u zbiegu Alei Jerozolimskich i Nowego Światu skoczył z wysokości trzeciego piętra .	schodowej	2	Fem
Zgodnie z podjętymi na wtorkowym spotkaniu ustaleniami , targi eksporterów oraz wystawy turystyczne odbędą się w przyszłym roku .	wtorkowym	4	Neut
Oczywiście , ważny jest program , ważne są jednak także zbiorowe emocje , poczucie sprawiedliwości , historyczna pamięć .	ważny	2	Masc
I zapewne AWS jeszcze może się poszerzać o jakieś ugrupowania prawicowe .	prawicowe	10	Neut
Za rakietami przeciwpancernymi suną majestatycznie olbrzymie srebrzyste cygara .	srebrzyste	6	Neut
W umówionym miejscu ciągle jeszcze nie widział em Lilka .	umówionym	1	Neut
Piękny Lolo z trudem dźwignął się na nogi .	Piękny	0	Masc
Zarzucał nas wiadomościami o długiej zimie .	długiej	4	Fem
Ściany skalne zbliżają się w tym miejscu i dalsza droga prowadzi w ciasnym wąwozie .	dalsza	8	Fem
Z ich domu wychodzi młoda kobieta .	młoda	4	Fem
Towarzystwo Naukowe KUL pełni w Polsce rolę zbliżoną do Katolickiej Akademii Nauk .	Katolickiej	9	Fem
Dziwnym trafem niezależne spółki węglowe zaproponowały bardzo podobne podwyżki .	niezależne	2	Fem
Urząd , nawet na podstawie wadliwej decyzji , mógł ściągnąć niesłusznie naliczony podatek .	naliczony	11	Masc
Policja prowadzi w tej sprawie intensywne śledztwo .	intensywne	5	Neut
Sprawą zainteresował się referat I-szy i przez kontrolę korespondencji może uzyskamy dalsze miejsca zachowanych rzeczy .	I-szy	4	Masc
Witały ich entuzjastyczne oklaski .	entuzjastyczne	2	Neut
Zdaniem Kwaśniewskiego jest to wystarczająca kara i Siwiec nie musi ustępować ze stanowiska .	wystarczająca	4	Fem
Spod czerni i płomieni zaczynały już wyglądać żółtawe żebra trupa .	żółtawe	7	Neut
Na jego otwarcie zjechali się przedstawiciele PSP w Warszawie , władze gminne , powiatowe oraz państwowe .	powiatowe	13	Fem
Warunki wolnego rynku okazały się silniejsze od rabinackich zakazów .	rabinackich	7	Masc
Każde spotkanie z przyjacielem sprawia mi ogromną radość .	ogromną	6	Fem
Potem zostaną ulokowani w hotelach i ośrodkach wypoczynkowych .	ulokowani	2	Masc
Na obszarach łąk zielonych wstają białe smugi , a poprzez ich długie przędziwa wesoło trzepie się rzeka .	długie	11	Neut
W ubiegłym roku w czerwcu okna w komunalnym mieszkaniu Salwockich wybijano trzy razy .	komunalnym	7	Neut
Na szczęście voyagerom wyznaczono cele .	wyznaczono	3	Neut
Opolscy ciepłownicy obawiają się , że ich straty w pierwszych miesiącach nowego roku mogą się okazać horrendalne , bo na podwyżkę ceny węgla nałożyła się także wyjątkowo łagodna zima , która zmniejszyła zapotrzebowanie na ciepło .	Opolscy	0	Masc
I ostatecznie załoga została wyznaczona .	wyznaczona	4	Fem
Cela była wesoła , to byli komuniści przyzwyczajeni do defensywy .	wesoła	2	Fem
Zabezpieczone zostały też ścięte już rośliny , przygotowane do dalszej obróbki .	Zabezpieczone	0	Fem
Mam ogromną prośbę .	ogromną	1	Fem
Gdyby z takiego nierozsądnego myślenia wyrastało się jak z dziecięcych ubrań , nie było by większego problemu .	dziecięcych	9	Neut
W tym miejscu skarpa załamywała się pod kątem prostym .	prostym	8	Masc
Człowiek czuje się jak niewidzialny . . .	niewidzialny	4	Masc
Symbolizują zmienną fortunę i uzasadniają nawoływania do stoickiego znoszenia dopustów losu albo chrześcijańskiej ufności w Bogu .	stoickiego	7	Neut
Suger Land jest najdynamiczniej rozwijającym się teksańskim miastem .	teksańskim	6	Neut
Rozdają publiczne pieniądze na rzecz Kościoła katolickiego , modlą się żarliwie przed kamerami , marzą o cenzurze obyczajowej .	katolickiego	6	Masc
Romantycznym bohaterom odpowiada szatańska wersja pieśni .	szatańska	3	Fem
Co to jest wstawka antyspamowa ?	antyspamowa	4	Fem
Cały prawy błotnik wraz ze światłami został na haku .	prawy	1	Masc
Obaj uznali je za wspaniałą lekcję historii .	wspaniałą	4	Fem
Z głębin morza dalekich a z bełku przepadłego powrócił , żeby u stopy braterskiej jasne czoło położyć .	jasne	14	Neut
W czasach uczelnianego wyścigu szczurów i masowego bezrobocia pełni często rolę bezpłatnej terapii .	bezpłatnej	11	Fem
Związane ciała poruszyły się słabo .	Związane	0	Neut
– takie długie włosy ma . .	długie	2	Masc
Planiści wypracowali już koncepcję drogi , na której przeobrażenie to winno się odbyć kosztem możliwie minimalnych ofiar .	minimalnych	15	Fem
W jego siedzibie znajdowało się centrum festiwalowe , tam grane były najważniejsze spektakle .	festiwalowe	6	Neut
Rozformowanie ma być zakończone do końca roku .	zakończone	3	Neut
Kompletnie pijany zjechał na lewe pobocze drogi i uderzył w drzewo .	lewe	4	Neut
Nietypowa kapliczka stoi od kilku dni na ulicy Filtrowej .	Nietypowa	0	Fem
Trwa akcja protestacyjna .	protestacyjna	2	Fem
Normalny bilet sieciowy kosztuje w tym mieście 30 złotych .	Normalny	0	Masc
– Lekarz ogólny nie był by już nam wtedy potrzebny ?	ogólny	2	Masc
W USA rozpyla się na przykład streptomycynę i tetracyklinę na drzewa owocowe i pola ziemniaków .	owocowe	11	Neut
Wypada być chudą , bladą , melancholijną .	chudą	2	Fem
- A my mówimy , że jesteśmy w zupełnem porządku .	zupełnem	8	Masc
Dzieci są okaleczone na całe życie .	okaleczone	2	Neut
Obudziło mnie zimne dotknięcie .	zimne	2	Neut
Obaj chorążowie zostali natychmiast zatrzymani i osadzeni w areszcie .	osadzeni	6	Masc
– nie jest fajne ?	fajne	3	Neut
W Denver można znaleźć ogród zoologiczny , który jest najchętniej w tym mieście odwiedzaną atrakcją .	zoologiczny	5	Masc
To jedyne logiczne wyjaśnienie , o ile tu można mówić tu o logice .	logiczne	2	Neut
Ściany skalne zbliżają się w tym miejscu i dalsza droga prowadzi w ciasnym wąwozie .	skalne	1	Fem
Nie było bezpośredniego kontaktu .	bezpośredniego	2	Masc
Gładki jest bardziej śliski .	Gładki	0	Masc
Trzy lata temu rozstał się z górniczą spółką mieszkaniową w Nikiszowcu .	górniczą	6	Fem
Michnik jest czwartym laureatem ustanowionej w 1996 r . nagrody .	ustanowionej	4	Fem
– macie coś ważnego ?	ważnego	3	Neut
Nocą słyszymy skrzypienie , jakby ktoś przechadzał się po niebie ułożonym ze starych , drewnianych desek .	starych	12	Fem
Poproszę o jakieś fajne stanowisko .	fajne	3	Neut
Tata ukrywał się na Żoliborzu u Zosi , mojej przyszłej wspaniałej macochy , jako Pan Nikt .	przyszłej	9	Fem
Slezinger korzysta w swej pracy z wielu formuł matematycznych i cybernetycznych .	matematycznych	8	Fem
Przy kościele spoczywają powstańcy z 1831 i 1848 .	1831	5	Masc
W klasztorze mieścił się obóz przejściowy dla Niemców sprowadzonych z Rumunii .	sprowadzonych	8	Masc
- Nie ma ludzi zdrowych , są tylko źle zdiagnozowani .	zdrowych	4	Masc
Ja aksjologiczne jest radykalnie indywidualne .	aksjologiczne	1	Neut
Obaj byli wysocy , zwaliści , misiowato potężni .	potężni	7	Masc
Dla cięższej gramatury gastronomicznej trzykrotnie polskości się wyparłem .	gastronomicznej	3	Fem
Kolejne inwentaryzacje dowodzą , że na półkach biblioteki brakuje kolejnych tytułów .	Kolejne	0	Fem
Kaźmierz oddał stryjowi latarnię ; na ziemi położył podłużny wąski przedmiot .	wąski	9	Masc
Do obserwatorium waszyngtońskiego ściągały tłumy ciekawych .	ciekawych	5	Masc
TWARDZIEL 1 pokazuje legitymację służb specjalnych .	specjalnych	5	Fem
Prowadził też agencję reklamową .	reklamową	3	Fem
Mogła sobie w nim utłuc rokokowym samojebem dziecko z krwi , spermy i chromosomów śliny .	rokokowym	5	Masc
Na rozwieszonej chustce do nosa ujrzał em film .	rozwieszonej	1	Fem
Od 1993 r . jest kierownikiem Zakładu Współczesnych Teorii Ekonomicznych , a od 1999 r . pełni funkcję dziekana Wydziału Ekonomiczno - Socjologicznego Uniwersytetu Łódzkiego .	1999	13	Masc
Komisja rewizyjna rady powiatowej zawnioskowała o udzielenie absolutorium i przesłała stosowny wniosek do Regionalnej Izby Obrachunkowej w Bydgoszczy .	Obrachunkowej	15	Fem
Jest najwyższym mężczyzną w oddziałach Agencji Restrukturyzacji i Modernizacji Rolnictwa w Polsce .	najwyższym	1	Masc
W Polsce przedwrześniowej mieli śmy jedynie 600 zelektryfikowanych wsi .	zelektryfikowanych	7	Fem
Kiedy mówi się o cudach w Lourdes , kiedy ktoś dostąpił cudownego uzdrowienia , Kościół prosi lekarzy , aby wypowiedzieli się na ten temat .	cudownego	11	Neut
To jest ciągły proces .	ciągły	2	Masc
WDT jest państwową jednostką organizacyjną nieposiadającą osobowości prawnej .	państwową	2	Fem
Niestety , podobnie jest w krajach Unii Europejskiej .	Europejskiej	7	Fem
Zarząd uznał dowcip za wysoce niestosowny i zareagował śmiertelnie poważnym pismem .	poważnym	9	Neut
Swoboda w tej dziedzinie umożliwia zakładanie spółek , prowadzenie przedsiębiorstw , uprawianie wolnych zawodów .	wolnych	12	Masc
Ale o fali emigracyjnej PiS już nie wspomina . . .	emigracyjnej	3	Fem
Na tym wyczerpaliśmy porządek dzienny 113 . posiedzenia Sejmu .	113	5	Neut
Teraz ma sztuczne .	sztuczne	2	Neut
Panuję nad negatywnymi nastrojami .	negatywnymi	2	Masc
Lech Kaczyński nie żałuje , że jego filmowa kariera się nie rozwinęła , a do swojego aktorskiego talentu podchodzi z rezerwą .	filmowa	7	Fem
- Staszek był trudnym człowiekiem , bardzo rozdwojonym .	trudnym	3	Masc
Jadący motorem 22-letni mężczyzna na łuku drogi stracił panowanie nad pojazdem i uderzył w betonowe ogrodzenie .	Jadący	0	Masc
Mówi monotonnie , bez składniowych harców , przeskoków , dygresji .	składniowych	4	Neut
Dzięki temu przekonano się , że galaktyki aktywne nie tworzą jednolitej grupy , ale mają dość zróżnicowane własności .	przekonano	2	Neut
Na posłanie z ziół i kwiatów ułożono kości i pokryto je szczątkami sztandaru .	ułożono	6	Neut
Od marca Barbara Piwnik zdążyła już jednak wymienić 3 prokuratorów apelacyjnych i 9 okręgowych .	apelacyjnych	10	Masc
Specjalne brygady w maskach i odzieży ochronnej nadzorowały rzeź ptactwa i dezynfekcję bazarów , targowisk , sklepów i środków transportu .	ochronnej	6	Fem
Maciej Gielecki , wojewoda warszawski , obiecał im , że Łubna II nie zostanie wybudowana .	warszawski	4	Masc
Ustawa ma własne przepisy karne .	karne	4	Masc
Posiadał wszechstronny , uniwersalny umysł obejmujący szereg nauk specjalnych .	wszechstronny	1	Masc
Prócz akcji upowszechniania czytelnictwa wśród dzieci Warszawy , podjęła prace o charakterze ogólnym , często prekursorskim .	prekursorskim	15	Masc
Od tego czasu gnębiony przez feudałów lud rumuński niejednokrotnie chwytał za broń .	gnębiony	3	Masc
Jako członek komisji śledczej , który cały czas dążył do zniesławienia lewicy , zaszkodził nam najbardziej .	śledczej	3	Fem
Życie ojca , surowe i ciężkie , całkowicie poświęcone rodzinie i opiece nad innymi ludźmi , budzi dziś zdumienie nieprawdopodobną obowiązkowością , odpowiedzialnością i pogodą ducha .	surowe	3	Neut
Czwarty kwartał 1932 roku przywlókł chmurę na czoło Wotana - Hitlera .	Czwarty	0	Masc
Moneta długo szukał odpowiedniego znaku .	odpowiedniego	3	Masc
Z konarów i pni wyczarowywał dziwne figury przywołujące na myśl słowiańskich bogów .	przywołujące	7	Fem
Na ekranie TV , na zatrzymanej stop-klatce Jurka Kilera idą napisy końcowe programu .	końcowe	11	Masc
Zgodnie ocenili , że będzie to świetne miejsce do utworzenia centrum wzornictwa przemysłowego .	przemysłowego	12	Neut
Kuśtykając ruszyli wolno pod górę , w stronę prześwitującego między drzewami kościoła .	prześwitującego	8	Masc
Drugim ważnym wydarzeniem był run na giełdę firm poszukujących kapitału .	ważnym	1	Neut
Pierwszą czynnością po uruchomieniu programu jest wybór zestawu .	Pierwszą	0	Fem
Był ujmujący w obejściu , bez przerwy się uśmiechał .	ujmujący	1	Masc
Samolot kołuje w smugach burego śniegu z deszczem .	burego	4	Masc
Czym się różni wyznanie polsko - katolickie ?	katolickie	6	Neut
Dyżurna siostra niemiłosiernie długo sprawdzała w rejestrach .	Dyżurna	0	Fem
Orkiestry murzyńskie grają ragtime'y , tłum cheerleaderek tworzy radosny , falujący szpaler .	radosny	8	Masc
Narażenie rozgrzanego psa na przeciągi grozi poważnymi komplikacjami ze zdrowiem .	poważnymi	6	Fem
Zwierzętarnia , wciśnięta między gmach zakładu doświadczalnego a kotłownię , stanowiła całe odrębne królestwo .	wciśnięta	2	Fem
Kupuje tu nie tylko brytyjska Polonia , ale i rodowici londyńczycy .	brytyjska	4	Fem
Opchał em się na całą pojemność skurczonego żołądka .	skurczonego	6	Masc
Taki rachunek wystawił jej gdyński Szpital Miejski .	Miejski	6	Masc
Do tej pory wyroby spółdzielni nigdy nie były eksportowane poza kraje europejskie .	europejskie	11	Masc
Banał wywoła krwawe powstanie ?	krwawe	2	Neut
Wcale nie jest dla mnie pewne , czy należy być takim świętym .	świętym	11	Masc
Parówki gotowane we wrzątku i podawane wprost z rondla bierze się na talerz i usuwa błonę , w której były gotowane .	gotowane	20	Fem
Po mszy świętej wyruszyła z bazyliki katedralnej i okrążyła Stary Rynek .	świętej	2	Fem
Poinformował w nim , że około godz . 19 . 30 w poniedziałek wartownik wojskowy zauważył zerwane plomby i kłódki do garnizonowego składu amunicji .	wojskowy	14	Masc
Klasztor na Jasnej Górze przeżywa prawdziwe oblężenie .	prawdziwe	5	Neut
W gościnnym pokoju u Czapków zasiadają często naukowcy .	gościnnym	1	Masc
Ja stoję w bruździe i w uniesionej ręce trzymam zapalony fanarek .	zapalony	9	Masc
Śmierć na miejscu poniosła 36-letnia kobieta , która z mężem przechodziła przez Małą Fatrę w rejonie Niskich Tatr .	36-letnia	4	Fem
Czy kobiety biorą u was udział w ruchu związkowym ?	związkowym	8	Masc
Rozpoczął się kolejny rok akademicki .	akademicki	4	Masc
Właścicielom wystarcza kino domowe , a bogate panie nie potrafią docenić kunsztu Anny Jaxy - Chamiec .	domowe	3	Neut
Takie opinie są mocno nieaktualne .	nieaktualne	4	Fem
Religie monoteistyczne takie są .	monoteistyczne	1	Fem
Dziewczyna obracająca się kusząco na parkiecie wydała mu się wyjątkowo wyjątkowa .	wyjątkowa	10	Fem
Nowe tablice rejestracyjne będą białe z czarnymi napisami i znakiem legalizacyjnym .	Nowe	0	Fem
Pan hrabia wie , że jesteśmy niewinni .	niewinni	6	Masc
Te wszystkie rogi zostały zdemontowane i wywiezione do Szczecina .	zdemontowane	4	Masc
– ciemne włosy ma ?	ciemne	1	Masc
Dzieje się to zazwyczaj w pionowo rozbudowanych , konwekcyjnych chmurach kłębiastych .	kłębiastych	10	Fem
W egzekucjach przeprowadzonych w Miednoje , Charkowie i Katyniu zabito 15 tys . polskich oficerów .	zabito	9	Neut
Zajęcia teatralne i plastyczne , konkursy , zabawy , filmy i wycieczki przyciągnęły nowych uczestników .	plastyczne	3	Neut
KTO PIERWSZY znajdzie się w Kosmosie ?	PIERWSZY	1	Masc
Została ona zachwiana po październikowych wyborach .	październikowych	4	Neut
Złoty instrument sprezentowało mu bractwo kurkowe .	Złoty	0	Masc
Upragnioną miłość zanurzyłeś w najpodlejszym , cuchnącym bagnie .	najpodlejszym	4	Neut
Wazopresyna jest szybko unieczynniana przez peptydy osocza .	unieczynniana	3	Fem
Obecnie dzierżawi ponad 8 tys . km łączy cyfrowych .	cyfrowych	8	Neut
W kraju nieprawdopodobnej konkurencji chcą być także piękne , coraz piękniejsze , najpiękniejsze .	najpiękniejsze	12	Fem
Woda zalała zasiewy i drogi lądowe .	lądowe	5	Fem
Lokal ten otrzymał nowe pomieszczenia dla kuchni i podręcznych magazynów , oraz szatnię .	podręcznych	8	Masc
Są świetne .	świetne	1	Neut
Najbardziej popularne są mercedesy , audi , golfy i BMW .	popularne	1	Masc
Wspieramy bezpieczną aborcję .	bezpieczną	1	Fem
Prezydent Bush zapewniał w środowym przemówieniu telewizyjnym , że siły koalicji będą maksymalnie oszczędzały ludność cywilną .	środowym	4	Neut
Potem odwiedził kiełpiński cmentarz .	kiełpiński	2	Masc
Zostało zapakowane w paczkę , wysłane w przeszłość .	wysłane	5	Neut
Duże urozmaicenie wprowadzają do tegorocznej wystawy fotomontaże .	Duże	0	Neut
Potwierdził to prezydent Jiang podczas niedawnego spotkania z prezydentem Clintonem .	niedawnego	5	Neut
Możliwy jest także import dodatkowych baz .	Możliwy	0	Masc
jest zatruta woda .	zatruta	1	Fem
Załadowano się na pięć barek i o zmierzchu wyruszono .	Załadowano	0	Neut
Początek przedstawienia to bardzo delikatny moment wchodzenia w fikcję .	delikatny	4	Masc
Spodziewa się Pan , że wyższy wzrost gospodarczy przyniesie wyższe dochody z podatków ?	gospodarczy	7	Masc
– co tu jest napisane ?	napisane	4	Neut
Pewien brytyjski rolnik leczył swą chorą krowę piwem .	brytyjski	1	Masc
W demokratycznym państwie powinny one stanowić kanony niepodważalne .	demokratycznym	1	Neut
Tymczasem miednice wypełnione podrobami przenoszono do kuchni .	wypełnione	2	Fem
Nawet duże lustro na staroświeckiej komodzie służyło z pewnością do różnych celów .	staroświeckiej	4	Fem
Ze stara wyciekał olej i płyn chłodzący , a przyczepa miała zdemontowany hamulec awaryjny .	zdemontowany	11	Masc
Nie wiem , czy Putin to Piotr II , który chciałby przywiązać Rosję do Zachodu , by uczynić ją silną .	silną	19	Fem
Dzieci zaczepiali na katowickim dworcu PKP .	katowickim	3	Masc
Jeśli jednak różnice te nie pozwalają wam zbudować takiego formalnego porozumienia , dajcie zielone światło do współdziałania ludziom tworzącym wasze ugrupowania .	tworzącym	18	Masc
Nigdy nie starał się być odważnym .	odważnym	5	Masc
Ograniczenie szybkości obowiązuje tutaj od soboty z powodu rutynowych prac konserwatorskich .	konserwatorskich	10	Fem
O napadzie i kradzieży zawiadomił policję sam poszkodowany , pracownik jednej z katowickich firm dealerskich .	katowickich	12	Fem
Główne dowództwo niemieckie musi objąć kierownictwo operacji wojennych we Włoszech .	wojennych	7	Fem
Grają muzykę będącą unikalnym mariażem form i stylów , zachwycają jurorów na wszelkich konkursach .	unikalnym	3	Masc
Jego usuwaniem zajęli się strażacy ze specjalistycznym sprzętem .	specjalistycznym	6	Masc
Pierwszy cios , który później okazał się śmiertelny , został zadany metalowym krzesłem w tył głowy .	metalowym	11	Neut
Mój widok bardzo zaskoczył LPR-owskiego działacza .	LPR-owskiego	4	Masc
- W iluż miastach w okresie letnim odbywa się tyle bezpłatnych występów artystycznych .	bezpłatnych	10	Masc
Le Pen straszy zjednoczoną Europą .	zjednoczoną	3	Fem
Najpierw samodzielność uzyskał Zakład Naprawy Autobusów w Biskupicach , wcześniej stanowiący integralną część MPK .	stanowiący	10	Masc
Streścił em jej dalszy ciąg i bardzo chichotała .	dalszy	3	Masc
- W iluż miastach w okresie letnim odbywa się tyle bezpłatnych występów artystycznych .	artystycznych	12	Masc
Nakielska straż miejska odbiera sporo podobnych zgłoszeń .	miejska	2	Fem
Celników z rzepińskiej Izby Celnej wspierali funkcjonariusze z Poznania i Krakowa .	rzepińskiej	2	Fem
Z tak zlokalizowanym wrogiem łatwiej walczyć . . .	zlokalizowanym	2	Masc
Ponadmiesięczna wyprawa zakończyła się sukcesem .	Ponadmiesięczna	0	Fem
To pierwszy sezon 11-letniego Jurka w amatorskiej lidze małopolskiej , a już wywalczył trzecie miejsce .	amatorskiej	6	Fem
Jest to duże urządzenie , ale dzięki wprowadzonym ostatnio znacznym usprawnieniom łatwe jest jego obsługiwanie .	łatwe	11	Neut
Rzymska kopia starożytnego reliefu wciąż spoczywa na swoim miejscu .	starożytnego	2	Masc
W pierwszych wiekach jego wyznawcy doznali okrutnych prześladowań .	okrutnych	6	Neut
Rodzice są właścicielami gospodarstwa rolnego , liczącego około 7 ha powierzchni .	liczącego	6	Neut
– nie wszystkie są zawężone równocześnie .	zawężone	4	Neut
Medykamenty współczesne dostępne są na czarnym rynku .	współczesne	1	Masc
Zwolennicy Mossadegha , ministrowie , podejrzani oficerowie , działacze Tudeh są przesłuchiwani i torturowani .	przesłuchiwani	11	Masc
Projekt przewiduje postawienie 7-kondygnacyjnego biurowca z dwupoziomowym garażem podziemnym na 450 samochodów oraz częścią handlową i usługową .	handlową	14	Fem
W jej twarzy , mokrej od łez rozmazanych i czerwonej , tężały w osłupieniu szkliste , bladoniebieskie oczy .	rozmazanych	7	Fem
Czeka go powtórny proces .	powtórny	2	Masc
Przyzwoitość każe szanować gości i ja właśnie w ten elegancki sposób uszanuję Jagodowe wakacje .	Jagodowe	12	Neut
Podobno były nawet pokazywane na wystawie przemysłowej , która odbyła się tu w zeszłym roku .	pokazywane	3	Masc
Drzymałowie mieszkali w bocznej , zacisznej uliczce , w nowo zbudowanym domu .	zbudowanym	10	Masc
Jest tu 16 jezior , łącznie z 4 jeziorami na obrzeżu , znajdującymi się już poza administracyjną granicą WPN .	administracyjną	16	Fem
Oprócz dżenińskiego obozu , Izraelczycy dokonali także przeszukania w domach na terenie samego miasta .	dżenińskiego	1	Masc
W ręce izraelskich żołnierzy dostali się palestyńscy politycy związani z Hamasem .	związani	8	Masc
Miejsca rozgrywania spotkań zostały ustalone w drodze losowania w siedzibie Polskiego Związku Tenisa Stołowego w Warszawie .	Stołowego	13	Masc
Mężczyzna doznał licznych obrażeń .	licznych	2	Neut
Zaproponowano więc Krystynie , która skwapliwie skorzystała .	Zaproponowano	0	Neut
- W naszej drużynie nie ma gwiazd , potrzebni są ludzie nieprawdopodobnie zaangażowani w grę .	zaangażowani	12	Masc
Tam zamiast deski klozetowej ma na muszli specjalną gumową poduszkę w kształcie podkowy .	gumową	8	Fem
Biedny ptak , z szeroko otwartym dziobem , zwisał głową w dół , niby ułamana z krzewu kiść .	ułamana	14	Fem
– chyba jestem głodna .	głodna	3	Fem
Tutaj wyraźnie widać wrażliwe , skłonne do ufności i entuzjazmu oblicze eseisty .	skłonne	5	Neut
Dowódca sił amerykańskich w Afganistanie generał Tommy Franks zapowiedział kolejne operacje lądowe .	lądowe	11	Fem
Czyżby teraz przepuściła okazję , mając tuż obok przystojnego młodego mężczyznę ?	młodego	9	Masc
Życie w tej wersji jest bogatsze .	bogatsze	5	Neut
Chodzi o przedsiębiorstwo z tradycjami , założone jeszcze przez ojca pana Piotra .	założone	6	Neut
Tylko w minioną sobotę w atakach terrorystycznych w Bagdadzie zginęło ponad 40 osób .	terrorystycznych	6	Masc
Zatrzymali samochód , bo wydał się podejrzany .	podejrzany	6	Masc
Położyli na drabiniastym wozie .	drabiniastym	2	Masc
Taki zapis spowoduje obligatoryjność podjęcia przez rzecznika praw obywatelskich spraw skierowanych przez rzecznika praw dziecka .	obywatelskich	8	Neut
Otworzył usta i siedział w najwyższym osłupieniu .	najwyższym	5	Neut
Wybudowano świątynie greckie i rzymskie .	greckie	2	Fem
Kiedy wczoraj szperałem sobie w archiwum domowym , odnalazłem ten artykuł .	domowym	6	Neut
Zatrzymanym przedstawiano zarzuty udziału w zorganizowanej grupie przestępczej i wprowadzenia na rynek narkotyków .	przedstawiano	1	Neut
- Na wiosenną wodę puszczał okręciki , żeby się popisać czymś niezwykłym .	wiosenną	2	Fem
Ona poprzez lasy przerąbała pierwszą drogę dla cichego apostolstwa synów bożych .	cichego	7	Neut
Potem polski papież zostałby w Watykanie kanonizowany .	kanonizowany	6	Masc
Ograniczenie szybkości obowiązuje tutaj od soboty z powodu rutynowych prac konserwatorskich .	rutynowych	8	Fem
Bardzo często , kiedy był em wściekły i napięty , wypijał em na rozluźnienie piwko czy setkę .	napięty	8	Masc
Postęp techniczny dosięgnął także brytyjskich amatorów herbaty .	brytyjskich	4	Masc
to jest borówka amerykańska tylko większa .	większa	5	Fem
Bandytów nie złapano .	złapano	2	Neut
Całą energię i myśli oddaję pracy .	Całą	0	Fem
Jest unerwiona przez nerw trójdzielny .	unerwiona	1	Fem
- Nie wyobrażam sobie piękniejszej śmierci .	piękniejszej	4	Fem
W schronisku tym przebywają bezdomne dzieci ze swoimi matkami .	bezdomne	4	Neut
Dostojny gość zwiedzi ponadto stolicę , Kraków oraz Gdańsk .	Dostojny	0	Masc
Temu sukcesowi w znacznej mierze przysłużył się również Szymon , który wywalczył 10 z 18 zdobytych przez Polaków punktów .	zdobytych	15	Masc
Leżał już ubrany w trumnie .	ubrany	2	Masc
Są ponadto zależni od społeczności wyższych , które mają zwyczajowe prawo ingerowania w życie tych ludzi .	zwyczajowe	9	Neut
Ważnym zadaniem jest zapewnienie warunków dla niezakłóconego funkcjonowania gospodarki i pracy urzędów .	Ważnym	0	Neut
Znajdą się tam także pomieszczenia rehabilitacyjne z basenem , salami gimnastycznymi i salami masażu .	rehabilitacyjne	5	Neut
Gotujemy na małym ogniu 15 minut .	małym	2	Masc
Żołnierze poznańskiego garnizonu pełnili honorową straż .	honorową	4	Fem
I doczekać z antykaczyńskim rządem do jesiennych wyborów .	jesiennych	6	Neut
- Średni udział czynników genetycznych w osobowości ocenia się na 40 proc .	genetycznych	4	Masc
Napisałaby więc z pewnością o Bali , co się stało w Kucie , tuż przy głównym deptaku .	głównym	15	Masc
33-letniemu mężczyźnie przedstawiono zarzut usiłowania zabójstwa ochroniarza .	przedstawiono	2	Neut
W 1831 pod Komorzem A . Mickiewicz próbował przekroczyć granicę zaborów biegnącą na Prośnie , aby wziąć udział w powstaniu listopadowym .	listopadowym	20	Neut
Z nowym rokiem weszło w życie nowe prawo dewizowe .	dewizowe	8	Neut
- Seneszal Guthlaf wypełni każde twoje odnośne polecenie .	odnośne	6	Neut
Podróżujący pierwszą klasą będą odtąd mogli wypoczywać podczas lotu na rozkładanych podwójnych siedzeniach .	podwójnych	11	Neut
Akceptacja wyraża obiektywną prawdę o człowieku , a nie tylko subiektywne przeżycia jednostki .	obiektywną	2	Fem
Na placach poczęły gromadzić się grupy przechodniów z zadartymi do góry głowami .	zadartymi	8	Fem
W aptekach prawdziwe oblężenie zapanowało jeszcze w ostatnich dniach starego roku .	prawdziwe	2	Neut
Jest to przydatne , gdy na jednej stronie umieszczamy kilka formularzy .	przydatne	2	Neut
Środek był ocenzurowany .	ocenzurowany	2	Masc
Elektromagnetyczne promieniowanie każdego rodzaju sprzętu elektronicznego ma z reguły odmienny , tylko jemu przypisywany charakter .	Elektromagnetyczne	0	Neut
Ofiary następnej deportacji to rodziny represjonowanych .	represjonowanych	5	Masc
Skupieni operatorzy delikatnie manipulowali skomplikowanymi urządzeniami odbioru przekazywanej informacji .	przekazywanej	7	Fem
Miał przekrwione oczy i nabrzmiałą twarz .	przekrwione	1	Neut
Od dziś dnia cały 18-ty arrondissement jest zamknięty od 6-ej po południu .	18-ty	4	Masc
Dodawał też , że korzystał z jawnych źródeł .	jawnych	6	Neut
Cały czas sprawdzana jest ich skuteczność .	Cały	0	Masc
Ponadto prezes powiadomił o przestępstwie tutejszą prokuraturę .	tutejszą	5	Fem
Licznie przybyła publiczność zajęła miejsca przy stołach biesiadnych , na obszernym trawniku lub obok sceny .	przybyła	1	Fem
Na czas akcji z kamienicy ewakuowano 10 osób , które nad ranem wróciły do swoich mieszkań .	ewakuowano	5	Neut
Nie czekając na decyzję Akcji , Unia Wolności zaczęła lansować na prezesa Karola Modzelewskiego , historyka i polityka związanego z Unią Pracy .	związanego	18	Masc
Deszcz podzwaniał o szyby , a wiatr zdzierał z drzew pożółkłe , zwiędłe liście .	pożółkłe	10	Masc
Było ciche niedzielne popołudnie .	niedzielne	2	Neut
Pogardzono wartościami życia zbiorowego , on zniechęcił się do gminnego prostactwa .	gminnego	9	Neut
Przedstawiono też realistyczną wizję postaci z Całunu Turyńskiego .	realistyczną	2	Fem
To było prawdziwie bajkowe uczucie .	bajkowe	3	Neut
Zdaniem obrońców polecenie osadzenia Chodorkowskiego w pojedynczej celi przyszło z samego Kremla , który chce złamać byłego szefa koncernu naftowego .	byłego	16	Masc
Kontrakty te są nowym instrumentem polityki rozwoju regionalnego .	regionalnego	7	Masc
Kazimierz Pytko napisał na naszych łamach , że nerwowe odruchy prawosławnych biorą się z ich poczucia słabości .	nerwowe	8	Masc
Powtarzaj je tak często , jak to jest potrzebne .	potrzebne	8	Neut
Policja przypuszcza , że najnowszy ładunek został porzucony przez spłoszonego niedoświadczonego terrorystę .	najnowszy	4	Masc
Nie są przeprowadzane bezpośrednio na ludziach .	przeprowadzane	2	Neut
Spirytus jest rozlewany do kartoników litrowych , półlitrowych i ćwiartek .	półlitrowych	7	Masc
Ambasada amerykańska w Moskwie kategorycznie odmówiła komentarzy do tej sprawy .	amerykańska	1	Fem
Jutro czy pojutrze mamy przekroczyć koło polarne .	polarne	6	Neut
Było jeszcze w tym grubym tomie wiele uczonych spekulacji .	uczonych	7	Fem
Sądząc po sztućcach , może nią być danie rybne .	rybne	8	Neut
Dziecko krzywdzone potrzebuje wszechstronnej pomocy .	krzywdzone	1	Neut
Wczoraj wszystko prysło jak bańka mydlana !	mydlana	5	Fem
Nie czekał długo , po kilku minutach wybiegła , wyraźnie spłoszona .	spłoszona	10	Fem
Są razem osadzone w istnieniu .	osadzone	2	Neut
Czekała mnie długa noc .	długa	2	Fem
Miał równie pokraczną głowę , krótki tułów .	krótki	5	Masc
Pędzę do pokojówki z tą hiobową wieścią .	hiobową	5	Fem
Na drugich drzwiach widnieje Samson , herb Wattów .	drugich	1	Neut
Fabrykę zaplombowano , konfiskując także podejrzane materiały .	zaplombowano	1	Neut
Będzie ona z pewnością dobrą podstawą dalszych specjalistycznych studiów nad historią muzyki .	dobrą	4	Fem
Klasztor na Jasnej Górze przeżywa prawdziwe oblężenie .	prawdziwe	5	Neut
Jest to choroba wzrostowa zwana także bolesną kifozą młodzieńczą .	zwana	4	Fem
Zapadł książę w dumanie posępne .	posępne	4	Neut
O klasztornym piekle , zgotowanym przez trzy potwory w habitach , pisaliśmy w kwietniu br .	klasztornym	1	Neut
Ciągnęła monolog , w którym celnie uwypukliła nieludzkie cechy jego matki .	nieludzkie	7	Fem
Czeka nas jeszcze kilka zimnych dni .	zimnych	4	Masc
Na diagramie Hertzsprunga - Russella olbrzymy znajdują się ponad ciągiem głównym .	głównym	10	Masc
Surowy , suchy klimat , huraganowe wiatry oraz nieurodzajność gleb spowodowały , że odkryta w 1520 roku przez Magellana Patagonia długo nie była kolonizowana przez Europejczyków .	1520	15	Masc
W ten sposób samorząd chce odzyskać od skarbu państwa pieniądze na niedoszacowaną subwencję na ubiegły rok .	niedoszacowaną	11	Fem
Chwycił walizkę i pędem dopadł drzwi wyjściowych .	wyjściowych	6	Neut
Odbył jedynie krótką telefoniczną pogawędkę z prezydentem ZSRR Gromowem .	krótką	2	Fem
VIII Zjazd Inżynierów Mechaników Polskich obradował w Katowicach pod hasłem zbiorowego wysiłku myśli i pracy nad aktualnymi zagadnieniami technicznymi , mającego na celu rozwój techniki polskiej .	Polskich	4	Masc
Z głośników popłyną rytmy soul i disco .	disco	6	Masc
Według badań Unii Europejskiej jesteśmy najmniej aktywnym społeczeństwem w Europie .	aktywnym	6	Neut
I dostał prawą pięścią w zęby , tak , że ujrzał wielką jasność .	prawą	2	Fem
Z dziwnym uczuciem brałam go do ręki .	dziwnym	1	Neut
Dostała 500-złotowy mandat .	500-złotowy	1	Masc
W tegorocznym VIII turnieju wystartowało 18 drużyn podzielonych na 6 grup .	VIII	2	Masc
Pojawił się milicjant i kierował samochody w boczne ulice .	boczne	7	Fem
Jeśli zostanie uzdrowiona dusza , szybko do zdrowia powróci i ciało .	uzdrowiona	2	Fem
Bała się , aby nie ponieść kolejnej porażki .	kolejnej	6	Fem
Rozbiegli się Kaszubi , pod przymusem do tej walki pędzeni .	pędzeni	9	Masc
Stamtąd te dane przekazuje do wojewódzkich stacji epidemiologicznych .	wojewódzkich	5	Fem
Sex Pistols gramy od paru ładnych lat na specjalne okazje .	specjalne	8	Fem
W samym tylko Katyniu rozstrzelano prawie 4,5 tys . osób .	rozstrzelano	4	Neut
Prace metaloplastyczne w kościele wykonywał Władysław Gąsienica Makowski .	metaloplastyczne	1	Fem
W takich warunkach wielu duchownych decydowało się na organizowanie katakumbowego życia religijnego .	katakumbowego	9	Neut
Niezależnie od przedstawionych wyników , kontrolę przeprowadzą jeszcze policjanci z Komendy Wojewódzkiej Policji w Katowicach .	przedstawionych	2	Masc
Niektóre rzeczy zwyczajnie nie mogą się wydarzyć bez udziału osób trzecich .	trzecich	10	Fem
Są pożyteczne , zbliżają ludzi i umacniają przyjaźnie , a artystom garmażerni , barmanom , kelnerom i sprzątaczkom płaci kasjer ambasady .	pożyteczne	1	Neut
Istotnie to kolosalna różnica .	kolosalna	2	Fem
Dla zdrowia psychicznego i fizycznego trzeba wówczas chwilowo panią uśpić .	psychicznego	2	Neut
Kaczyńscy i ich główni zausznicy są postrzegani jako politycy niebezpieczni , nieobliczalni .	postrzegani	6	Masc
W słowackich Tatrach piorun uderzył w parę polskich turystów .	słowackich	1	Neut
Od 1996 w Ekstraklasie gra drużyna miejscowej Odry .	1996	1	Masc
Wezwane pogotowie ratunkowe odwiozło go do szpitala .	Wezwane	0	Neut
Wszelkie informacje podane poniżej dotyczą jedynie wypadków sprawdzonych .	sprawdzonych	7	Masc
Cały świat czekał na tę decyzję .	Cały	0	Masc
Świat z coraz większym trudem akceptuje trwającą na drogach hekatombę i związane z tym straty ekonomiczne .	trwającą	6	Fem
Tu jest strefa przygraniczna , sami rozumiecie .	sami	5	Masc
Stąd też Jego narodzenie powinno przypadać 25 grudnia .	powinno	4	Neut
Tymczasem korki paraliżują okolice ul . Saskiej , bo kierowcy , aby dostać się na Wał , muszą dojechać na niego wąskimi ulicami Saskiej Kępy .	wąskimi	21	Fem
Tak przynajmniej wynika z zachowanych dokumentów i relacji .	zachowanych	4	Masc
- Wierzę , że kandydaci do członkostwa w NATO powinni spełniać generalne kryteria demokratycznych rządów i gospodarki wolnorynkowej , włączając w to poszanowanie dla praw człowieka oraz cywilną kontrolę nad wojskiem .	generalne	11	Neut
Na pastwisku w Uniszkach Gumowskich rolnik załadował na dwukółkę krowę .	Gumowskich	4	Neut
Może to tylko takie zabawy językowe , lingwistyka dla naiwnych ?	językowe	5	Fem
Spotkał się ze stanowczą odmową .	stanowczą	3	Fem
Najlepszy księgowy województwa śląskiego to rybniczanin .	śląskiego	3	Neut
Widelczyk leżący nad talerzami jest widelczykiem deserowym .	leżący	1	Masc
A ten głupi Rzymianin powiedział , że go tam odeśle . . .	głupi	2	Masc
Delfina w herbie ma Szkoła Policealna Pracowników Służb Socjalnych w Poznaniu .	Socjalnych	8	Fem
Szli szosą warszawską , skąpo oświetloną latarniami , wzdłuż nowego cmentarza .	oświetloną	5	Fem
Cały Boguszów trzęsie się z oburzenia .	Cały	0	Masc
On też miał we Lwowie kancelarię prawniczą .	prawniczą	6	Fem
Jadący z nadmierną szybkością wartburgiem Marek Ch . , będąc pod wpływem alkoholu , został wyrzucony na łuku jezdni na pobocze , a następnie przekoziołkował i uderzył w drzewo .	Jadący	0	Masc
Szybsze topnienie brzegów lodowca kompensowane jest przez zwiększone opady w środku kontynentu .	kompensowane	4	Neut
Tam nawiązuje kontakt z grupą partyzancką o zabarwieniu skrajnym , likwidującą komunistów i uciekinierów z gett .	skrajnym	8	Neut
Zmumifikowaniu uległy tkanki miękkie .	miękkie	3	Fem
Dlatego problem ten musi zostać wnikliwie rozpatrzony , a większość obiektów powinna być bezwzględnie zwrócona społeczeństwu , bo za jego pieniądze zostały wzniesione .	zwrócona	14	Fem
A dobra rzadsze są tym cenniejsze .	cenniejsze	5	Neut
Kryteria do odstrzału selekcyjnego są zróżnicowane w zależności od rejonu siedliska .	zróżnicowane	5	Neut
Pozostali ministranci postanowili dalej pełnić służbę ministrancką .	ministrancką	6	Fem
One potrzebują równego traktowania .	równego	2	Neut
Akcję sprawozdawczo - wyborczą w pracowniczych ogrodach działkowych zakończy ogólnopolska konferencja delegatów wybranych na zjazdach wojewódzkich POD , która będzie obradowała w maju w Warszawie .	ogólnopolska	9	Fem
Gdyby z takiego nierozsądnego myślenia wyrastało się jak z dziecięcych ubrań , nie było by większego problemu .	nierozsądnego	3	Neut
Wojskowy kandydat nie rozdawał ulotek ze swoim programem wyborczym .	wyborczym	8	Masc
To spółka , która na zlecenie klientów wykorzystuje najkorzystniejsze oferty na kupno poszukiwanych produktów .	poszukiwanych	12	Masc
Michał poprosił tylko o gorącą herbatę z cytryną , nie chciał częstować się wigilijnymi potrawami .	wigilijnymi	13	Fem
Przez zwały gruzów ulicami miasta przebija się z trudem wojskowy Willys .	wojskowy	9	Masc
Oprócz Polaków odpływali na tę wyprawę także i cudzoziemcy , wszyscy spod znaku republikańskiego .	republikańskiego	13	Masc
Analogiczny obraz zróżnicowań społecznych ukazują dane o wieku menarchy dziewcząt .	Analogiczny	0	Masc
Należy przeprowadzić żmudne badania techniczne .	żmudne	2	Neut
Niestety był to wpływ negatywny , pogłębiający istotniejące już uprzedzenia .	negatywny	4	Masc
Prokuratura Apelacyjna współpracuje w tej sprawie z oddziałami CBŚ we wspomnianych miastach i Urzędami Kontroli Skarbowej .	wspomnianych	10	Neut
Marchewki obrać i zetrzeć na tarce o dużych oczkach .	dużych	7	Neut
Niepostrzeżenie wracamy do domu i nad ranem obwieszczamy światu odkrycie niecodziennego zjawiska .	niecodziennego	10	Neut
Niechlubny ranking województwa wielkopolskiego otwiera Wojewódzki Szpital Zespolony w Lesznie .	wielkopolskiego	3	Neut
Stary wiadukt przy ulicy Oświęcimskiej stanowił ogromną uciążliwość dla kierowców .	ogromną	6	Fem
Został potraktowany łagodnie .	potraktowany	1	Masc
Pełniący obecnie obowiązki szefa rosyjskiego państwa Putin był jeszcze niedawno szefem służb specjalnych .	rosyjskiego	4	Neut
Niechętnie przecież opuszczali Legnicę i inne bazy wojskowe .	wojskowe	7	Fem
Interesująco wypadła sala wystawiennicza na poddaszu , chociaż widać , że w budynku jest jeszcze parę rzeczy do robienia .	wystawiennicza	3	Fem
Infrastruktura teleinformacyjna nie może działać bez prądu .	teleinformacyjna	1	Fem
Wiedziałem , że nie mogę spodziewać się pomocy pana Kleksa , gdyż jego wszechwiedzące oko znajdowało się na księżycu , a na nikogo innego liczyć nie mogłem .	wszechwiedzące	13	Neut
Przebieg incydentu został sfilmowany przez reportera rosyjskiej prywatnej telewizji NTV .	prywatnej	7	Fem
Kaczyńscy i ich główni zausznicy są postrzegani jako politycy niebezpieczni , nieobliczalni .	niebezpieczni	9	Masc
Ewa ma 50 lat , krótką sukienkę w kwiatki i złote serce .	krótką	5	Fem
Lecz protektor w niebieskiej bluzie poklepał go po ramieniu .	niebieskiej	3	Fem
Nad pozostałymi obszarami dominują układy wyżowe .	wyżowe	5	Masc
Głos nikł i stawał się coraz cichszy .	cichszy	6	Masc
- Nie mam niebieskich oczu .	niebieskich	3	Neut
Obecnie mają oni najwyższe pensje w całym województwie pomorskim .	najwyższe	3	Fem
Zakończył się VIII Raciborski Rajd Rowerowy Środowisk Trzeźwościowych Dookoła Polski .	Rowerowy	5	Masc
To śmierć polityczna czołówki AWS i zwolenników Unii Wolności w Akcji .	polityczna	2	Fem
Niemieccy policjanci twierdzą , że w rachubę nie wchodzi kolizja z innym pojazdem .	Niemieccy	0	Masc
Początki Myszyńca sięgają 1650 .	1650	3	Masc
– jedno jest pewne .	jedno	1	Neut
Życie rodzinne , domowe , schodzi na dalszy plan .	dalszy	7	Masc
Wysunął spomiędzy karminowych warg długi język i oblizał łakomie usta .	karminowych	2	Fem
Wykorzystując przerwę w popołudniowych grach , Agassi i Graf zrobili sobie małą sesję treningową .	małą	11	Fem
Oburzenie autorów listu na wulgaryzację języka i kultury współczesnej jest słuszne .	współczesnej	8	Fem
Niewątpliwie jest to jedyna użytkowa wartość porozumienia sprzed lat .	użytkowa	4	Fem
Przyjechali saperzy , zabrali granat i zdetonowali go w bezpiecznym miejscu .	bezpiecznym	9	Neut
W grudniu 1996 roku Havlovi wraz z górnym płatem prawego płuca usunięto niewielki nowotwór złośliwy .	usunięto	11	Neut
Ten okres minnesangu zakończył się w ostatniej dekadzie XII wieku , gdy naśladownictwa ustąpiły nowym tematom i formom wypracowanym przez miejscowych poetów .	miejscowych	20	Masc
Owocuje to eksplozją pomysłów i niespożytą energią niezbędną do ich realizacji .	niespożytą	5	Fem
Zdesperowany doktor wlał płyn do dezynfekowania narzędzi chirurgicznych do dużego naczynia , włożył w płyn zaganiacza , zamieszał .	dużego	9	Neut
Ale opinia jest tutaj zawsze bardzo ostrożna .	ostrożna	6	Fem
W I lidze piłkarskiej rozpoczyna się runda wiosenna .	piłkarskiej	3	Fem
Szczekały przez długi czas wśród jasnej od księżyca nocy .	długi	2	Masc
Czy sędziowie w programie są stronniczy ?	stronniczy	5	Masc
Na tych przejazdach woda była płytka , ale dno piaszczyste nie groziło uszkodzeniem łodzi .	piaszczyste	9	Neut
Sprawą włamania do domu wokalistki Blue Cafe zajęli się policjanci z komisariatu przy ul . Ciesielskiej .	Ciesielskiej	15	Fem
Zachichotała do własnych erotycznych skojarzeń .	erotycznych	3	Neut
Zaangażowano mnie w celu udowodnienia , że Mojka miał wspólników w Banku Prowincjonalnym .	Zaangażowano	0	Neut
Pod pachą trzymała jakąś paczkę zawiniętą w gazetę .	zawiniętą	5	Fem
Natrafiły na ń dzieci zbierające zioła dla starej Felakowej .	zbierające	4	Neut
Innej alternatywy nie ma , a wszelkie marzenia o samodzielnej roli quasi-mocarstwowej Polski są tylko rojeniami fantastów .	Innej	0	Fem
- Czy wspólnoty są misyjne ?	misyjne	4	Fem
Szybsze topnienie brzegów lodowca kompensowane jest przez zwiększone opady w środku kontynentu .	Szybsze	0	Neut
Wśród 65-tysięcznej publiczności oglądającej uroczyste otwarcie igrzysk będzie 40 najwyższych dostojników różnych państw .	65-tysięcznej	1	Fem
Zmarłych żołnierzy francuskich i bawarskich pogrzebano na cmentarzu przykościelnym .	przykościelnym	8	Masc
Zatrzymali się na rogu Włodarzewskiej .	Włodarzewskiej	4	Fem
Nowe rady gminne będą mniej liczne od obecnych .	Nowe	0	Fem
W 1935 roku brytyjski informatyk Alan Mathison Turing wymyślił abstrakcyjną maszynę .	abstrakcyjną	9	Fem
Biblioteki kościelne zostały także obdarowane kolekcjami .	obdarowane	4	Fem
Ranny będzie wymagał natychmiastowej pomocy .	natychmiastowej	3	Fem
Przeciętny Polak musiał by na nią pracować sto lat .	Przeciętny	0	Masc
Do Tczewa przyjechały głównie najbardziej popularne koty rasowe .	popularne	5	Masc
Dwa duże statki zostały zatopione przez powstańców .	zatopione	4	Masc
Młyny kupują mąkę żytnią w Niemczech .	żytnią	3	Fem
Dłużej żyjący Polacy będą oczywiście mieli wpływ na wiele procesów gospodarczych .	gospodarczych	10	Masc
Nie wprowadzono prywatnej własności ziemi , nie zniszczono feudalnego imperium dyrektorów kołchozów .	feudalnego	8	Neut
- Dlatego nie mogę się doczekać pięknej słonecznej pogody .	pięknej	6	Fem
A powiem ci , że to czeskie bydlę jest wyjątkowo nieapetyczne .	nieapetyczne	10	Neut
W innych spotkaniach towarzyskich uzyskano następujące wyniki .	towarzyskich	3	Neut
Gdy goście opuścili jego dom i pozostał jedynie 63-letni emeryt , doszło między nimi do sprzeczki .	63-letni	8	Masc
Dla cięższej gramatury gastronomicznej trzykrotnie polskości się wyparł em .	cięższej	1	Fem
Główne dowództwo niemieckie musi objąć kierownictwo operacji wojennych we Włoszech .	niemieckie	2	Neut
Uchwała rady powinna być podjęta w ciągu miesiąca od dnia doręczenia wniosku Naczelnej Rady Aptekarskiej .	Naczelnej	12	Fem
W województwie świętokrzyskim znajdują się 323 obiekty sakralne .	sakralne	7	Masc
Ale to wstłętne !	wstłętne	2	Neut
Jednocześnie polecił zająć się milicjantem prowadzącym śledztwo .	prowadzącym	5	Masc
Mamy do wyremontowania wiele instalacji wodno - kanalizacyjnych w gimnazjach .	kanalizacyjnych	7	Fem
Ucierpi niezawisłość sędziowska ?	sędziowska	2	Fem
I ciężko usiadł na sąsiednim krzesełku .	sąsiednim	4	Neut
„ No powiedz , to był jednak niesłychanie przystojny mężczyzna ! "	przystojny	8	Masc
Posiadał wszechstronny , uniwersalny umysł obejmujący szereg nauk specjalnych .	obejmujący	5	Masc
Zdenerwowany długo nie mógł wydobyć ż kieszeni klucza do swego pokoju , gdy tymczasem zza drzwi dobiegał natarczywy dzwonek telefonu .	natarczywy	17	Masc
Zagraniczne agencje informacyjne i prasa obszernie zrelacjonowały sobotnią konferencję prasową wicepremiera Janusza Obodowskiego .	sobotnią	7	Fem
Ta specjednostka nosi bowiem imię legendarnych skoczków spadochronowych Armii Krajowej .	spadochronowych	7	Masc
Ale dwa razy do roku kumulują się we mnie smutki , niezrealizowane sprawy i ogarnia mnie przygnębienie .	niezrealizowane	11	Fem
O tych wątpliwościach pisała regionalna prasa .	regionalna	4	Fem
Czy dożyje podobnej chwili ?	podobnej	2	Fem
Użyto gazów łzawiących i ogłuszających granatów .	ogłuszających	4	Masc
Szkoła ma dwie kondygnacje , 9 izb lekcyjnych , kuchnię i kotłownię .	lekcyjnych	7	Fem
Na nocleg zatrzymali się przy małej kępie drzew akacjowych .	akacjowych	8	Neut
Od 1993 r . jest kierownikiem Zakładu Współczesnych Teorii Ekonomicznych , a od 1999 r . pełni funkcję dziekana Wydziału Ekonomiczno - Socjologicznego Uniwersytetu Łódzkiego .	Współczesnych	7	Fem
Nie wierzę w magiczne technologie w najbliższym czasie .	magiczne	3	Fem
Rada Nadzorcza towarzystwa na wczorajszym posiedzeniu pominęła sprawy personalne .	wczorajszym	4	Neut
Potem rozległy się jeszcze inne równie przerażające odgłosy .	przerażające	6	Masc
Zauważył em , że po raz pierwszy powieki nie zakrywały jego źrenić , żółtych i okrągłych .	żółtych	13	Fem
Załamała się tradycja zbiorowych wystąpień i manifestacji .	zbiorowych	3	Neut
Choinka mieni się różnobarwnie , z bożonarodzeniowego bierwiona w kominku bije przytulne ciepło .	bożonarodzeniowego	6	Neut
Upragnioną miłość zanurzył eś w najpodlejszym , cuchnącym bagnie .	cuchnącym	7	Neut
- Ludzie starsi gubią się w technicznych problemach z tym związanych , a takie ciągłe zabawy ze zmianą pasma nadawania to brak szacunku dla abonentów .	związanych	10	Masc
Zawody będą rozgrywane na Dunajcu na odcinku od Krościenka do mostu w Gołkowicach .	rozgrywane	2	Neut
Książkę wydrukowano w Polsce na zlecenie paryskiej Edition Cercle d'Arts .	paryskiej	6	Fem
W 1972 r . wraz z kolegami wpadł podczas rozlepiania ulotek na mieście .	1972	1	Masc
Pięcioletnia dziewczynka , porwana wczoraj przez 65-letniego mężczyznę w Chorzowie na Śląsku , odzyskała wieczorem przytomność .	65-letniego	6	Masc
Zza kulis wychodzi aktorka grająca Magdalenkę .	grająca	4	Fem
Podchodzi do głównych drzwi wejściowych , by wpuścić dwie kobiety .	głównych	2	Neut
Może to jest za wielkie słowo , ale ja tak naprawdę czuję .	wielkie	4	Neut
Groźni faszyści są bezkarni , bo stronę założyli na amerykańskim serwerze .	amerykańskim	9	Masc
Pod stołem bawił się granatem mały chłopiec , nazywany Osęką .	nazywany	8	Masc
Funkcjonariusze inspekcji celnej przy pomocy biegłych ustalili , że przy próbie wywozu najprawdopodobniej naruszone zostały przepisy Kodeksu celnego .	naruszone	13	Masc
Czy gdzieś było gniazdko elektryczne ?	elektryczne	4	Neut
VIII Zjazd Inżynierów Mechaników Polskich obradował w Katowicach pod hasłem zbiorowego wysiłku myśli i pracy nad aktualnymi zagadnieniami technicznymi , mającego na celu rozwój techniki polskiej .	technicznymi	18	Neut
Najpierw były występy rockowego zespołu muzycznego oraz pokazy tańca nowoczesnego grupy z tczewskiego Centrum Kultury i Sztuki i karaoke .	tczewskiego	12	Neut
Wewnętrznej klapy nie otworzy pan , kiedy otwarta jest zewnętrzna .	zewnętrzna	9	Fem
Tam przez prawie dwa miesiące będą trwały badania dna morskiego .	morskiego	9	Neut
Takie stanowisko może się jednak słusznie wydawać nazbyt łatwą dymisją rozumu .	łatwą	8	Fem
Niestety , niektórzy czytelnicy wierzą , że mogła m takie głupawe wierszydło napisać .	głupawe	10	Neut
Obecne życie Marty jest absurdalne i patologiczne !	Obecne	0	Neut
Wspieramy bezpieczną aborcję .	bezpieczną	1	Fem
Pod koniec gotowania dodajemy sos sojowy i na kilka minut pozostawiamy pod przykryciem .	sojowy	5	Masc
Zasapany Mock zszedł ze stołu i włożył głowę do żeliwnego zlewu .	żeliwnego	9	Masc
Udało się dopiero wtedy , gdy zorientowałem się , co jest grane .	grane	11	Neut
Ale oni są mi za drodzy , żeby m im to sprawiła .	drodzy	5	Masc
Wtedy stosowano materiały niskiej jakości .	stosowano	1	Neut
Sto gazet ukazuje się obecnie w przedsiębiorstwach przemysłowych i usługowych .	przemysłowych	7	Neut
To jest złe myślenie .	złe	2	Neut
Od kolebki , od małych lat jestem tu wychowany , na tym placu .	wychowany	8	Masc
Panowała zupełna cisza .	zupełna	1	Fem
Czy czynniki religijne nie ograniczają wolności wyborów politycznych obecnego rządu ?	obecnego	8	Masc
Nie wprowadzono prywatnej własności ziemi , nie zniszczono feudalnego imperium dyrektorów kołchozów .	zniszczono	7	Neut
Zaczynałem rozumieć , że radość z własnego rozumu też może być ograniczona .	ograniczona	11	Fem
- Nie bądź krnąbrna , to grzech .	krnąbrna	3	Fem
Władze bały się tam zaglądać , a jedyne prawo wyznaczał pistolet czy karabin .	jedyne	7	Neut
- Średni udział czynników genetycznych w osobowości ocenia się na 40 proc .	Średni	1	Masc
Ludzie uważają , że do kłopotów z uzyskaniem zgody przyczynili się inwestorzy starający się o pozwolenie na budowę małego osiedla na działce sąsiadującej z ogródkami mieszkańców .	małego	18	Neut
- Wasza gazeta od dawna robi świetne przewodniki dla poszukujących pracy w Irlandii .	poszukujących	9	Masc
Dlatego część historyków fińskich kwestionuje badania Silvennoinena , zarzucając mu pogoń za sensacją .	fińskich	3	Masc
Likwidacja okazuje się dla wielu wyborców bolesna .	bolesna	6	Fem
Zerkała na czarno - biały obraz i pogryzała słone paluszki .	słone	8	Masc
No kto , na przykład , zbudował radziecką bombę atomową ?	radziecką	7	Fem
Detektyw precyzyjnym sztychem przeszył jego prawe ramię .	prawe	5	Neut
Tymczasem korki paraliżują okolice ul . Saskiej , bo kierowcy , aby dostać się na Wał , muszą dojechać na niego wąskimi ulicami Saskiej Kępy .	Saskiej	6	Fem
Rozpoczęła się ogólnopolska akcja protestacyjna Państwowej Straży Pożarnej .	Pożarnej	7	Fem
Kochają go za tę doskonałą bezinteresowność .	doskonałą	4	Fem
Pokazuje nam odpowiedni dokument panamski i dwa zaświadczenia .	panamski	4	Masc
Pięcioletnia dziewczynka , porwana wczoraj przez 65-letniego mężczyznę w Chorzowie na Śląsku , odzyskała wieczorem przytomność .	Pięcioletnia	0	Fem
Ale Moja Wdowa uważała , że zupy te czynią żołądek gładkim i młodym .	młodym	12	Masc
Dobry Allach uratował honor naszego państwa !	Dobry	0	Masc
Odrzucił płaszcz , czoło miał zroszone potem .	zroszone	5	Neut
Chłopiec wynurza się spod stołu , trzymając na dłoni rozbite jajko , strzaskaną skorupkę , rozlane żółtko i oślizłe białko .	oślizłe	18	Neut
Skomplikowany zabieg przeprowadzono w jednej z klinik w Szanghaju .	Skomplikowany	0	Masc
Później innego uczestnika spotkania znaleziono martwego w jego domu letniskowym pod Belgradem .	letniskowym	9	Masc
Tu też przyrządzał wspaniałe słodkości .	wspaniałe	3	Fem
Tak to przynamniej wynika z danych statystycznych zebranych przez Komendę Wojewódzką Policji w Szczecinie .	Wojewódzką	10	Fem
I czy muszą być potwierdzone korpusowo ?	potwierdzone	4	Masc
Projekt przewiduje postawienie 7-kondygnacyjnego biurowca z dwupoziomowym garażem podziemnym na 450 samochodów oraz częścią handlową i usługową .	7-kondygnacyjnego	3	Masc
Gorące spojrzenia towarzyszyły kandydatkom do korony podczas całego rejsu .	Gorące	0	Neut
- Po wojnie będzie nosiło się cywilne .	cywilne	6	Fem
Z zaskoczeniem przeglądali śmy witrynę internetową Stołecznego Zakładu Energetycznego .	internetową	5	Fem
Faceci wyglądają na prawdziwych twardzieli .	prawdziwych	3	Masc
Dobrze znosi warunki miejskie .	miejskie	3	Neut
Młodzież z Mełgwi otrzymała pełnowymiarową halę sportową .	sportową	6	Fem
W czasie pozorowanych działań bojowych jednostki z pozycji obronnych dokonają przegrupowania , aby po sforsowaniu szerokiej przeszkody wodnej wyjść na nowe rubieże aktywnych działań zaczepnych .	zaczepnych	24	Neut
Rozumowanie Angusa nie było więc pozbawione podstaw , ale jeszcze zbyt daleko biegło w przyszłość .	pozbawione	5	Neut
Nie miała innego wyjścia .	innego	2	Neut
Zaczynałem rozumieć , że radość z własnego rozumu też może być ograniczona .	własnego	6	Masc
Różnica między tymi ugrupowaniami jest niewielka .	niewielka	5	Fem
Interpressowska organizacja okazała się dobrze pomyślana . . .	pomyślana	5	Fem
Powinna ona również być akredytowana , gwarantowana .	gwarantowana	6	Fem
- Nie układa się jej pod rynkowego konkurenta , ale warto wiedzieć , w co on gra .	rynkowego	6	Masc
W jej twarzy , mokrej od łez rozmazanych i czerwonej , tężały w osłupieniu szkliste , bladoniebieskie oczy .	szkliste	14	Neut
Tenisiści stołowi Energetyka Opoki Trzebinia znają już terminy spotkań barażowych o I ligę , w których ich rywalem będzie zwycięzca II ligi łódzko - świętokrzyskiej Start Brzezina .	barażowych	9	Neut
Pierwsze brawa zebrał Bugaj polemizujący z Rakowskim .	Pierwsze	0	Neut
Braliśmy udział w walkach o niepodległość Stanów Zjednoczonych Ameryki Południowej .	Zjednoczonych	7	Neut
W 2000 r . na światowych giełdach nastąpił krach , a zawyżone kursy akcji spółek internetowych spadły na łeb .	zawyżone	11	Masc
W pierwszych dniach maja rozpocznie się piętnasta wyprawa badawcza dna Oceanu Spokojnego .	Spokojnego	11	Masc
Nowa firma trafi również do pierwszej piątki europejskich ubezpieczycieli .	Nowa	0	Fem
Naaman , naczelny wódz króla syryjskiego , był człowiekiem bogatym i możnym .	naczelny	2	Masc
Czy był oralny i analny ?	oralny	2	Masc
Hempel umarł prawdopodobnie dość szybko , to był człowiek chory , słabowity i prawdopodobnie nie wytrzymał .	słabowity	11	Masc
Opanowało ją swoiste zniewolenie , niemoc przeciwstawienia się .	swoiste	2	Neut
Definitywnych ustaleń jeszcze nie ma , ale strony osiągnęły znaczne zbliżenie .	znaczne	9	Neut
W całym województwie odbywają się liczne imprezy artystyczne i sportowe .	sportowe	9	Fem
15 naukowców uczestniczących w sesji otrzymało pamiątkowe medale wybite z okazji jubileuszu .	wybite	8	Masc
Są to w przeważającej większości lasy sosnowe .	przeważającej	3	Fem
Śmierć na miejscu poniosła 36-letnia kobieta , która z mężem przechodziła przez Małą Fatrę w rejonie Niskich Tatr .	Niskich	16	Neut
Nie często zdarza się uczestniczyć w wydarzeniu artystycznym , a takim na pewno był koncert u Chrystusa Króla .	artystycznym	7	Neut
Sprytna Wenus oznacza romantyczne kolacje z nim na deser .	Sprytna	0	Fem
Następnie podgrzewamy i przesączamy przez gęste sito .	gęste	5	Neut
Zdesperowany doktor wlał płyn do dezynfekowania narzędzi chirurgicznych do dużego naczynia , włożył w płyn zaganiacza , zamieszał .	Zdesperowany	0	Masc
Akcję sprawozdawczo - wyborczą w pracowniczych ogrodach działkowych zakończy ogólnopolska konferencja delegatów wybranych na zjazdach wojewódzkich POD , która będzie obradowała w maju w Warszawie .	wybranych	12	Masc
Rannymi cywilami zaopiekowali się najpierw amerykańscy sanitariusze z personelu naziemnego .	amerykańscy	5	Masc
- Czy równie powszechne obecnie torebki plastykowe także mogą trafić do spalarni śmieci ?	plastykowe	6	Fem
Dzielnicy centralnej nie powstydziła by się żadna ze stolic europejskich .	centralnej	1	Fem
Społeczność ludzka funkcjonuje w strukturach zapewniających formę organizacyjną .	zapewniających	5	Fem
Na desperacki krok zdecydowała się 19-letnia mieszkanka Radymna .	19-letnia	5	Fem
( Przypomnę tutaj , że w Komisji Trójstronnej trwają intensywne prace nad przygotowaniem nowelizacji tejże ustawy ) .	Trójstronnej	7	Fem
W kwietniu tegoż 1981 r . w naszych zachodnich okręgach wojskowych przeprowadzona została nadzwyczaj długa sztabowa gra wojenna .	tegoż	2	Masc
Nad nim stał Vilo w słonecznej aureoli .	słonecznej	5	Fem
Funkcję tę pełnił przez 35 lat i wywarł ogromne piętno na prawodawstwie amerykańskim .	amerykańskim	12	Neut
Przy kościele spoczywają powstańcy z 1831 i 1848 .	1848	7	Masc
Ostateczni , po zażartej dyskusji zwyciężyła propozycja kierownictwa ZKP .	zażartej	3	Fem
Po co w ogóle kastrować wolno żyjące koty ?	żyjące	6	Masc
Ponieważ nie posiadała pozwolenia na jej przewóz , muszlę zatrzymano w depozycie .	zatrzymano	9	Neut
Powiększona kuchnia stała się obszernym pomieszczeniem mieszczącym duży stół .	Powiększona	0	Fem
W wyposażeniu podstawowym znajduje się również ABS .	podstawowym	2	Neut
Ubrani w białe koszule uczniowie ustawiają się na zbiórce w parku naprzeciwko gimnazjum .	białe	2	Fem
nie mamy takiej sytuacji militarnej .	militarnej	4	Fem
W 1990 r . Smolański brał czynny udział w napaści na afrykańskich studentów manifestujących na wrocławskim rynku .	manifestujących	13	Masc
Wrócił do Polski w październiku 1918 r .	1918	5	Masc
Trafił do Pogotowia Opiekuńczego w Polanowie .	Opiekuńczego	3	Neut
Balkon był pusty .	pusty	2	Masc
– i te stosunki sąsiedzkie są zażyłe .	sąsiedzkie	4	Neut
Przedstawiono też realistyczną wizję postaci z Całunu Turyńskiego .	Przedstawiono	0	Neut
Sto gazet ukazuje się obecnie w przedsiębiorstwach przemysłowych i usługowych .	usługowych	9	Neut
Każde nowo przyniesione kartonowe pudło natychmiast któryś zajmuje .	przyniesione	2	Neut
Powoduje bowiem utratę białka ze skóry i krwi , podczas jej stosowania maleje masa serca i spada wskaźnik podstawowej przemiany materii .	podstawowej	18	Fem
Jego wiarygodność sprawdzono poprzez Krajową Izbę Gospodarczą .	sprawdzono	2	Neut
W ogrodzie tego domu wznosiły się kiedyś pawilony obserwacyjne .	obserwacyjne	8	Masc
W sidła oszustów - pośredników oferujących pracę Polacy wpadają także w Hiszpanii .	oferujących	5	Masc
- Zatem po raz pierwszy w Pańskim życiu kompozytorskim spotkały się obie Pańskie osobowości ?	kompozytorskim	8	Neut
Żeby opłacić dziennikarza , przeciętne warszawskie osiedle musiało by się złożyć po 10 groszy .	warszawskie	5	Neut
Zbiornik został niemal całkowicie zniszczony .	zniszczony	4	Masc
Unijni przetwórcy mogą kupować owoce gdzie indziej .	Unijni	0	Masc
Commercial Union od 1991 roku działa również na rynku naszych ubezpieczeń życiowych .	1991	3	Masc
Może to oznaczać kolejny wzrost stóp procentowych , droższego dolara i spadek zaufania inwestorów zagranicznych .	droższego	8	Masc
Czy to ta niemoc grzybowa zwiastowała ?	grzybowa	4	Fem
Stara jestem .	Stara	0	Fem
Odsłonili jednak tyły i kolejną bramkę zdobyli lechici .	kolejną	4	Fem
Wyrok jest nieprawomocny .	nieprawomocny	2	Masc
Wielu obawia się , że będzie skazany na typowe pieskie życie .	pieskie	9	Neut
Ostatnio nie bywał delikatny .	delikatny	3	Masc
To byłoby śmieszne , groteskowe .	śmieszne	2	Neut
Na tym zapleczu też w istocie opiera się jednostkowa , personalna władza generała de Gaulle'a .	jednostkowa	8	Fem
Ładną mamy jesień .	Ładną	0	Fem
Akcję sprawozdawczo - wyborczą w pracowniczych ogrodach działkowych zakończy ogólnopolska konferencja delegatów wybranych na zjazdach wojewódzkich POD , która będzie obradowała w maju w Warszawie .	wyborczą	3	Fem
Przy ulicy Kawęczyńskiej w Warszawie , w Wyższej Szkole Menedżerskiej , trwają prace remontowe w budynku zaadaptowanym na nowy dziekanat i rektorat .	Wyższej	7	Fem
Minęli jakąś suterenę z maleńkimi okienkami .	maleńkimi	4	Neut
Tym razem atrakcyjność potyczki podniesie fakt , że Hoop i Zepter reprezentują mocno zmienione oblicza .	zmienione	13	Neut
Trafia na oddział intensywnej terapii .	intensywnej	3	Fem
Zmęczeni wysiadali śmy z ciasnej szoferki .	Zmęczeni	0	Masc
W załzawionym świecie jeden diabeł posiadał kontury ostre i wyraźne .	wyraźne	9	Masc
Wróciła dwucyfrowa inflacja .	dwucyfrowa	1	Fem
Warszawscy radiowcy okazali się trudnymi rywalami .	Warszawscy	0	Masc
Było to bardzo pracochłonne .	pracochłonne	3	Neut
Każdy zbombardowany , okaleczony , nieszczęśliwy dom stawał się teraz ich celem .	nieszczęśliwy	5	Masc
Kochamy Polskę , lecz fakty składające się na polską rzeczywistość działają nam na nerwy .	polską	8	Fem
Sam nie wiesz . . .	Sam	0	Masc
Fenometys wciąż kręcił głową , światło lamp odbijało się na bezwłosej skórze idealnymi refleksami .	bezwłosej	10	Fem
Tutaj wyraźnie widać wrażliwe , skłonne do ufności i entuzjazmu oblicze eseisty .	wrażliwe	3	Neut
Stało się oczywiste , że porozumienia są możliwe i owocne .	owocne	9	Neut
Z niepokojem spoglądają oni na pochmurne niebo i termometr , śledząc przy tym pilnie prognozy meteorologiczne .	pochmurne	5	Neut
Ten z pozoru kosmetyczny zabieg spowodował sporo zamieszania .	kosmetyczny	3	Masc
Potem proszono ich o wykonanie odwrotnego zadania .	odwrotnego	5	Neut
W piątek , sobotę i niedzielę będziemy wspólnie świętować 1000-lecie Biskupstwa Wrocławskiego i 1000-lecie Wrocławia .	Wrocławskiego	11	Neut
Jego odejście od lewaków do religijnych ortodoksów spowodowało , rzecz jasna , szyderstwa i krytykę , ale wbrew powszechnym oczekiwaniom nie został odrzucony przez media .	powszechnym	18	Neut
Pokaże także adresy różnych instytucji , wyświetli kolorowy rozkład jazdy i poda repertuar kin czy teatrów .	kolorowy	7	Masc
Jego zadaniem jest ponowne wylansowanie pojazdów tej marki w największym segmencie w Europie .	ponowne	3	Neut
Czy w prywatnym życiu spotkała pani swojego mistrza ?	prywatnym	2	Neut
WYKORZYSTAJMY EUROPEJSKĄ SZANSĘ !	EUROPEJSKĄ	1	Fem
Rano obudził się z obolałą głową .	obolałą	4	Fem
Wszystkie pokoje wyposażone w szafy wnękowe są już gotowe .	wnękowe	5	Fem
– A ten nie był odpowiedni ?	odpowiedni	5	Masc
- Złożę też za chwilę na ręce pana marszałka ową poprawkę formalną , uzgodnioną z Biurem Legislacyjnym .	Legislacyjnym	16	Neut
Współczesne trendy cywilizacyjne sprzyjają siłom zła , lecz dobro nie odpuszcza .	Współczesne	0	Masc
Ponoszę porażki , niepowodzenia wychowawcze .	wychowawcze	4	Neut
O siódmej rano , kiedy wszyscy byli już od dawna w polu , przystępowali śmy do młocki .	siódmej	1	Fem
Wtem jakby uśmiechnął się do nas spod przymkniętych powiek .	przymkniętych	7	Fem
To było najpopularniejsze śniadanie .	najpopularniejsze	2	Neut
Dzięki temu pracownicy bardzo szybko ustalili , kto może być odpowiedzialny za zdarzające się coraz częściej w firmie tajemnicze manka .	zdarzające	12	Neut
Mężczyzna śmiał się głośno pokazując górną lewą złotą trójkę .	złotą	7	Fem
- Prowadzi edukację humanitarną , pomaga uchodźcom , powodzianom .	humanitarną	3	Fem
Nieoczekiwanie i bardzo mocno uderzył w piersi łysego , wąsatego mężczyznę .	łysego	7	Masc
Sprawa została pomyślnie rozstrzygnięta dopiero w ostatnim czasie .	rozstrzygnięta	3	Fem
Bronił eksmitowanych na bruk , naprawiając błędy przyjętej przez koalicję SLD­PSL ustawy , grzmiał na globalistów i świeżych krajowych , drapieżnych kapitalistów .	eksmitowanych	1	Masc
Dzicy plakaciarze zaśmiecający miasto są bezkarni .	zaśmiecający	2	Masc
Karolowi głowa pęka z bólu , całe ciało płonie .	całe	6	Neut
Przylgnął do niej z całych sił .	całych	4	Fem
Ich niski status społeczny sprawia , że poza czasem widowisk obrzędowych nie odgrywają oni istotnej roli w lokalnym życiu publicznym .	publicznym	19	Neut
Radykalnie negując ład istniejący na ziemiach ukraińskich w Polsce i ZSRR , nacjonalizm odrzucał każdą próbę prowadzenia polityki w ramach realnego układu sił .	istniejący	3	Masc
W grupie finałowej rozegrano mecze każdy z każdym i wyłoniono zwycięzcę , którym został zespół Warka Tuchola .	finałowej	2	Fem
Zanieczyszczenia cytoplazmatyczne i błonowe są również groźne , stanowiąc prawdopodobne źródło zarówno aktywności proteolitycznej , jak i białek cytoplazmatycznych w puli niehistonowej .	groźne	6	Neut
Następnie rozłożyła wysoki statyw , zawiesiła na nim pudełko , przeprowadziła od niego przezroczysty przewód do igły , którą wcześniej automatyczny iniektor umieścił w żyle na przedramieniu Irka .	przezroczysty	13	Masc
Otulił zestarzałe ciało w kiereję futrzaną .	zestarzałe	1	Neut
Jest to więc najdłuższy pontyfikat XX wieku .	najdłuższy	3	Masc
Związany z kapistami , wielokrotnie jednak przekraczał wyznaczone przez nich malarskie granice .	wyznaczone	7	Fem
Przygryzając wargi z bezsilnej złości , Chmura wołał Adasia .	bezsilnej	3	Fem
Choć dziecko złożyło na policji zeznania , sprawców nie zatrzymano .	zatrzymano	9	Neut
Mówimy o sytuacji , w której budżet musi jednocześnie wytrzymać skutki rosyjskiego kryzysu i koszty tegorocznych reform .	tegorocznych	15	Fem
W pewnej chwili otworzył em oczy , wyrwany z gorączkowej drzemki jakimś ruchem .	gorączkowej	9	Fem
Małachowski zarzuca Kościołowi milczenie wobec wystąpień nacjonalistycznych i antysemickich .	antysemickich	8	Neut
Jest ona znacznie trudniejsza i bardziej skomplikowana .	skomplikowana	6	Fem
Pozostali pacjenci przebywają na oddziale ginekologicznym , wewnętrznym i kardiologicznym .	kardiologicznym	9	Masc
Masz mieszkanie komunalne ?	komunalne	2	Neut
43-letni młodszy brygadier dmuchnął w alkomat .	43-letni	0	Masc
Zwycięski zespół uzyska awans .	Zwycięski	0	Masc
- W 1299-tym nadał Nakłu prawa miejskie mały drobny Król Łokietek , a Dzielny Krzywousty w 12-tym wieku narobił w Nakle kapusty !	1299-tym	2	Masc
Bardziej znamienne są liczby w poszczególnych gałęziach przemysłu .	poszczególnych	5	Fem
Jakże naiwny był Józef , kolejny raz ufając obietnicom białych !	naiwny	1	Masc
Do mieszkania Desselbergerów trafiają ptaki z połamanymi skrzydłami , przemarznięte , wyczerpane .	połamanymi	6	Neut
Obecnie powstała niecka wysypiskowa wraz z infrastrukturą techniczną .	wysypiskowa	3	Fem
Przebiegające pod miastem chodniki kopalni zalano wodą , a wzgórze zgniło i zapadło się w ziemię jak przydeptane .	Przebiegające	0	Masc
Jego wiarygodność sprawdzono poprzez Krajową Izbę Gospodarczą .	Krajową	4	Fem
Po chwili odsłonił głowę i uważnie lustrował zaniepokojone twarze .	zaniepokojone	7	Fem
Najważniejszą zaletą będzie koordynacja wszystkich podsystemów komunikacyjnych z koleją podmiejska , a także motoryzacją indywidualną oraz komunikacją rowerową .	komunikacyjnych	6	Masc
Tymczasem korki paraliżują okolice ul . Saskiej , bo kierowcy , aby dostać się na Wał , muszą dojechać na niego wąskimi ulicami Saskiej Kępy .	Saskiej	23	Fem
Po odparciu ataku i ujęciu 10 terrorystów zawrócono konwój do bazy w Al Kut .	zawrócono	7	Neut
Sprawą włamania do domu wokalistki Blue Cafe zajęli się policjanci z komisariatu przy ul . Ciesielskiej .	Blue	5	Neut
- Czy grozi nam czarny scenariusz rozwoju sytuacji gospodarczej ?	gospodarczej	8	Fem
Znalezisko to posiada sporą wartość historyczną .	sporą	3	Fem
Nawóz zielony to zielona masa roślinna pozostawiona w glebie .	pozostawiona	6	Fem
Udawał wesołość , aby dodać odwagi zatrwożonemu mizeractwu .	zatrwożonemu	6	Neut
Przedstawiamy dziś rasę niezwykle rzadką , niehodowaną w Polsce .	niehodowaną	6	Fem
Po czwartkowej wizycie w ratuszu zmienił jednak zdanie .	czwartkowej	1	Fem
Na piątym był ostatni etap .	piątym	1	Neut
A to jest najważniejsze .	najważniejsze	3	Neut
Gdyby producenci podpatrywali świat oczami artystów , mieli by ciekawą ofertę handlową .	ciekawą	9	Fem
- Musimy zebrać ludzi , którzy chcą dokończyć rozpoczęte w 1981 roku dzieło .	rozpoczęte	8	Neut
Ojciec Tadeusz Rydzyk po emisji poświęconego mu filmu mówił na antenie swego radia , że to zemsta TVP za jego plany stworzenia telewizji .	poświęconego	5	Masc
Mam najnowsze zestawy osób nagrodzonych .	najnowsze	1	Masc
Zawsze chciał stałego związku .	stałego	2	Masc
Witraże projektował Jerzy Skąpski , a wykonali w 1991 r . Anna i Ireneusz Zarzyccy .	1991	8	Masc
Właściwie tylko Białostockie Przedsiębiorstwo Budownictwa Przemysłowego posiada laboratorium z prawdziwego zdarzenia .	Białostockie	2	Neut
Potem roztworem chemicznym starannie spryskano bezcenne posągi i stare mozaiki .	bezcenne	5	Masc
Sanki pomknęły po ubitym śniegu na Pohulankę .	ubitym	3	Masc
W Zborowie powstał obiekt o powierzchni użytkowej 3364 metrów kwadratowych , w którym zamieszka 50 osób .	użytkowej	6	Fem
Każdy z nich trzymał w ręku długi , płaski klucz .	płaski	8	Masc
Pierwsze krople deszczu zadudniły o trumnę i zmieszały się ze święconą wodą , którą ksiądz rozpryskiwał z kropidła podobnego do królewskiego berła .	podobnego	18	Neut
Liczyli zdobyte łupy , oglądali własne i nieprzyjacielskie straty .	nieprzyjacielskie	7	Fem
Sprawy budżetowe zajmą więc zapewne sporo czasu na czwartkowej sesji .	czwartkowej	8	Fem
Według jego oceny niezbędne będą dalsze spotkania przed podpisaniem porozumienia .	niezbędne	3	Neut
Komputery szachowe nie będą umiały honorowo przegrywać i zaczną seryjnie wzniecać burdy .	szachowe	1	Masc
Nie udźwignie już miecza krwawego ręka syna struchlała .	krwawego	4	Masc
Nowi ustne rozpoczęli od geografii .	Nowi	0	Masc
Obowiązują wizy , odprawa paszportowa , a przy wyjeździe celnik gruntownie przeszukuje rzeczy w poszukiwaniu skarbów , których tak wiele stąd ukradziono .	ukradziono	21	Neut
Na dole jest moja prywatna plaża .	prywatna	4	Fem
Spada koniunktura dla brunatnych koszul .	brunatnych	3	Fem
Śledztwo przeciwko świadkowi koronnemu zostanie umorzone dopiero , gdy bez zarzutu wypełni swoją rolę .	koronnemu	3	Masc
Przewidywał to i myślał , że jest gotowy , ale skwierczący żar w piersi uświadomił mu , że nigdy nie byłby na to gotowy .	skwierczący	10	Masc
- Przez niemiecką żeglugę śródlądową jakaś dzikuska nie będzie miała frajdy .	śródlądową	4	Fem
Zatrzepotała gęstymi rzęsami .	gęstymi	1	Fem
I Pan Jezus krzyż nad nimi uczynił , a oni się zamienili w trzy drzewa jabłonne .	jabłonne	15	Neut
Zdaniem Marka Markiewicza , polityczną dojrzałość polityk osiąga dopiero po czterdziestce .	polityczną	4	Fem
Z pewnością młodemu człowiekowi nie pomagają zainteresowania seksualne , które koncentrują się na doznaniach fizycznych .	młodemu	2	Masc
Łukasz zatrzymał przejeżdżającą taksówkę .	przejeżdżającą	2	Fem
Wczesnym popołudniem polska delegacja udała się do Warny .	Wczesnym	0	Neut
Są bardzo niebezpieczne , ich wybuch spowodowałby falę uderzeniową o promieniu do jednego kilometra .	niebezpieczne	2	Masc
- Nietypowe , to znaczy bez pieniędzy ?	Nietypowe	1	Neut
Jego spojrzenie , przed chwilą spłoszone , było teraz śmiałe i podstępne .	spłoszone	5	Neut
Przez następne stulecia przylgnęła do niej raczej sława rozpustnicy i zdrajczyni .	następne	1	Neut
Maszynista nie miał szans na zatrzymanie rozpędzonego elektrowozu .	rozpędzonego	6	Masc
- Napił by m się grzanego piwa .	grzanego	5	Neut
Za najważniejszych nazistowskich zbrodniarzy powszechnie uznawano Hitlera , Himmlera i Goebbelsa .	nazistowskich	2	Masc
Podczas zajęć rękodzielniczych , mimo początkowego wątpienia we własne możliwości , młodzież tworzyła ozdoby wielkanocne .	początkowego	5	Neut
Nie mają oni atrakcyjnej oferty dla ludzi XXI wieku , więc boją się konkurencji katolicyzmu .	XXI	7	Masc
- Zakłady i instytucje państwowe działają na podstawie decyzji urzędniczych .	państwowe	4	Fem
Gładkie oblicze strzygonia stężało , alabastrowa skóra napięła się , jakby miała zaraz pęknąć .	alabastrowa	5	Fem
Tym razem straciła życie moja starsza siostra .	starsza	5	Fem
Czy wszystkie galaktyki Seyferta typu 2 mają pierścień pyłowy i ukryty obszar szybkich obłoków gazowych ?	ukryty	10	Masc
Wysyła się ich do najgorszej roboty .	najgorszej	4	Fem
Istotne jest , aby cele edukacji ekologicznej zostały przełożone na język konkretów mających zastosowanie w codziennych działaniach ucznia .	Istotne	0	Neut
Czy nowa białoruska elita intelektualna jest już ukształtowana ?	ukształtowana	7	Fem
Wirują mu musztardowe księżyce i słońca , a na samym dole żagla zjawia się łeb wieloryba o mikroskopijnych , czerwonych oczach .	mikroskopijnych	17	Neut
Powołano sejmową komisję śledczą do wyjaśnienia tej sprawy .	sejmową	1	Fem
W kilka godzin później wyjechałem z ciężkim sercem i obietnicą szybkiego spotkania .	ciężkim	6	Neut
a ona słodkie lubi tak . .	słodkie	2	Neut
Siedział ponury na przedzie tramwaju , pod plastykowym dachem .	ponury	1	Masc
Na wschodzie , za fioletową smugą lasu , strzela w górę wieża olkuskiej Fary .	fioletową	4	Fem
- Skoro pani minister już podniosła kwestię wpływów podatkowych z rozmaitych województw i ich proporcji , myślę , że warto się nad nimi zastanowić , gdyż są one czasami dziwne i nie wiadomo , z czego wynikają .	rozmaitych	10	Neut
Pierwsze pytania z sali dotyczyły opieki lekarskiej w UE .	lekarskiej	6	Fem
I Pan Jezus krzyż nad nimi uczynił , a oni się zamienili w trzy drzewa jabłonne .	jabłonne	15	Neut
Małe oczki króla zamigotały złowrogo .	Małe	0	Neut
W niegłupich oczach był dziecinny tragizm .	niegłupich	1	Neut
Tematem prelekcji i dyskusji był problem uzależnienia alkoholowego .	alkoholowego	7	Neut
Przy uśmiechu Giocondy , dyskretnym i tajemniczym , nikt nie zauważy szczerby z lewej strony .	tajemniczym	6	Masc
Do niego , oczywiście , nawiązuje francuski barbier .	francuski	6	Masc
Wykonany z asferycznych soczewek ze szkła fluorytowego , pozwala na uzyskanie bardzo dobrej jakości obrazu .	fluorytowego	6	Neut
Dratewkę pani Joasia wyrwała z bestialskich łap pewnego szewca , którego niech piekło pochłonie .	bestialskich	5	Fem
Na morskiej jednostce mogą być zatrudnione tylko te osoby , które posiadają aktualne świadectwo zdrowia .	aktualne	12	Neut
Białe policyjne motocykle są doskonale oznakowane .	policyjne	1	Masc
Nerwy ludziom puszczają , często dochodzi do utarczek słownych .	słownych	8	Fem
Jeżeli ciasto troszeczkę rozlatuje się w oleju , oznacza to , że zostało prawidłowo przyrządzone .	przyrządzone	14	Neut
- Weź sobie , Madziu , kochankę , zobaczysz wtedy , jakie to cudowne uczucie .	cudowne	13	Neut
Teraz jest asfaltowa o każdej porze roku .	asfaltowa	2	Fem
On siedział za nowoczesnym biurkiem .	nowoczesnym	3	Neut
Przewaga któregokolwiek układu skurczowego lub niedowład któregokolwiek układu rozkurczowego powoduje skurcz mięśni gładkich oskrzeli .	skurczowego	3	Masc
Rzecznik Praw Obywatelskich wystąpił w obronie inwalidów wojennych i wojskowych , którym wprowadzono obowiązek płacenia za pobyt w sanatoriach uzdrowiskowych .	Obywatelskich	2	Neut
Jeśli jednak różnice te nie pozwalają wam zbudować takiego formalnego porozumienia , dajcie zielone światło do współdziałania ludziom tworzącym wasze ugrupowania .	zielone	13	Neut
W krem wcisnąć osączone i pokrojone ananasy .	osączone	3	Masc
Według KPN budżet państwa traci na [import]cie paliw , a zasady koncesjonowania są niejasne .	niejasne	13	Fem
Do tego dochodzą rachunki za telefon , wydatki na materiały piśmienne , na znaczki .	piśmienne	10	Masc
Nie orientował się też , że popełnia przestępstwo dewizowe .	dewizowe	8	Neut
Czy nasze indywidualne cele pokrywają się z celem grupy jako całości ?	indywidualne	2	Masc
Na konferencji mówiono też o stanie gospodarki europejskiej .	mówiono	2	Neut
Adam szukał do nowego domu parkietu .	nowego	3	Masc
– za jedne pół godziny wydała m pięć .	jedne	2	Fem
My , spadochroniarze , jesteśmy twardymi ludźmi .	twardymi	5	Masc
Na nasz rozum z Polmosu najzwyczajniej wyprowadzono 2 mln euro .	wyprowadzono	6	Neut
Oklapł , opadły mu ramiona i tylko piwny brzuszek sterczał nad paskiem spodni .	piwny	7	Masc
Spotkał się ze stanowczą odmową .	stanowczą	3	Fem
To najgorszy wstrząs sejsmiczny zarejestrowany w Kolumbii .	sejsmiczny	3	Masc
Dystychy , analizowane dotąd oddzielnie , złóżmy obecnie w całość , bo przecież w Dusiołku tworzą one taką całość .	analizowane	2	Masc
W przypadku BIG-u ostatni miesiąc roku obrachunkowego przyniósł wynik poniżej tegorocznej średniej .	obrachunkowego	6	Masc
Była to sprawa górna i patetyczna .	górna	3	Fem
Obrazy cyfrowe składają się z połączonych ze sobą pikseli o różnych barwach lub tonach .	połączonych	5	Masc
Na tegorocznym inauguracyjnym balu tradycyjnego karnawału w Rio pracowały równolegle dwie komisje sędziowskie .	tradycyjnego	4	Masc
A w takim wypadku , zwykle polega się na instynktownym własnym przekonaniu .	instynktownym	9	Neut
Drugim ważnym wydarzeniem był run na giełdę firm poszukujących kapitału .	poszukujących	8	Fem
Od kilku lat w górnej szufladzie mojego biurka leży biały zeszyt .	biały	9	Masc
Po rozwodzie zwykle pozbawiano ich prawa do opieki nad dziećmi .	pozbawiano	3	Neut
Coś jest dowodem czyjejś głupoty .	czyjejś	3	Fem
Taki stosunek nie może sprzyjać należytemu rozwojowi myśli twórczej wśród pracowników Stoczni , a tym samym przynosi straty państwu .	należytemu	5	Masc
Uroczystego otwarcia imprezy dokonał wojewoda nowosądecki Marek Oleksiński .	Uroczystego	0	Neut
- Minister Kulesza uważa , że nieprzeprowadzenie tej reformy spowoduje wyborczą porażkę .	wyborczą	10	Fem
Ogonowski i Latusek tłumaczyli , że właśnie znaleźli zastrzelone zwierzę .	zastrzelone	8	Neut
Rzecznik praw obywatelskich poprosił o wyjaśnienia Ministerstwo Zdrowia .	obywatelskich	2	Neut
To było urocze .	urocze	2	Neut
Tam czekały już na nich armatki wodne , podstawione przez władze .	podstawione	8	Fem
- Stara ogrodnicza prawda mówi , że każdemu drzewu i krzewowi przycięcie zrobi dobrze .	ogrodnicza	2	Fem
Czuł się słaby i nędzny .	słaby	2	Masc
Przebiegała między najwyższą topolą na brzegu a kominem mleczarni .	najwyższą	2	Fem
Jest to duże urządzenie , ale dzięki wprowadzonym ostatnio znacznym usprawnieniom łatwe jest jego obsługiwanie .	wprowadzonym	7	Neut
Wzorem większości producentów przeczytał wyłącznie krótkie streszczenie zawarte na pierwszej stronie , ale po jego minie można było wyczytać , że sama koncepcja go urzekła .	zawarte	7	Neut
Rzecz dotyczy berlińskiej olimpiady w 1936 roku i przynależności państwowej triumfatora .	1936	5	Masc
Droga do Falsztyna prowadzi przez łagodne wzgórza Pienin Spiskich .	Spiskich	8	Neut
Tam przygarnęła nas bardzo zacna rodzina .	zacna	4	Fem
Tematem tegorocznego Forum była fotografia otworkowa .	tegorocznego	1	Neut
Tego nie wiemy na pewno , mimo że zacytowane wyżej zdanie stało się znakiem rozpoznawczym .	zacytowane	8	Neut
- Co robicie , by w tak świetnej kondycji dotańczyć do finału ?	świetnej	7	Fem
Donald Tusk umiejętnie punktował ogólnikowe wypowiedzi swych konkurentów .	ogólnikowe	4	Fem
Powołujesz się na intelektualnego i emocjonalneog kastrata , ale czego innego mogł em się po Tobie spodziewać ?	intelektualnego	3	Masc
Profesor z dużym sceptycyzmem spogląda w przyszłość .	dużym	2	Masc
Obu szwedzkim dyplomatom zarzucono też działalność wykraczającą poza ich oficjalny status .	oficjalny	9	Masc
Włoski rząd na nadzwyczajnym posiedzeniu przeznaczył wczoraj 50 milionów euro dla dotkniętego trzęsieniem ziemi regionu .	nadzwyczajnym	3	Neut
– Kucharki chyba nie miały wysokich stołków . . .	wysokich	5	Masc
Od 1993 r . jest kierownikiem Zakładu Współczesnych Teorii Ekonomicznych , a od 1999 r . pełni funkcję dziekana Wydziału Ekonomiczno - Socjologicznego Uniwersytetu Łódzkiego .	Socjologicznego	22	Masc
Commercial Union od 1991 roku działa również na rynku naszych ubezpieczeń życiowych .	życiowych	11	Neut
Tak pesymistyczni Francuzi byli w kwietniu , a przedtem aż przed czterema laty .	pesymistyczni	1	Masc
Stare by może uciekły , ale małe dorosły i zostały .	Stare	0	Fem
- Lubimy zaglądać do takich dużych centrów .	dużych	5	Neut
Wściekłość pokrył pobłażliwym uśmiechem .	pobłażliwym	2	Masc
Podążał wytrwale , polną drogę mając za przewodnika .	polną	3	Fem
Nigdy wcześniej w tak wielkiej imprezie sportowej , i tak prestiżowej , nie startowali śmy .	prestiżowej	10	Fem
Do dziś dziękuję Bogu , że trafiłem na takich porządnych ludzi , którzy dali nam dach nad głową i przysłowiowy talerz zupy .	przysłowiowy	19	Masc
Spódnica może być za krótka albo za długa . . .	długa	7	Fem
Czy senator rzuci rękawicę wszechwładnemu przewodniczącemu ?	wszechwładnemu	4	Masc
Wśród zarejestrowanych bezrobotnych kobiety stanowią prawie 55 proc .	zarejestrowanych	1	Masc
W Tczewie w Radzie Miejskiej zasiada 23 radnych .	Miejskiej	4	Fem
Co takiego stało się w ostatnią sobotę ?	ostatnią	5	Fem
W początkach następnego tysiąclecia jej ruiny pokrył śmietnik .	następnego	2	Neut
Może ja piszę sonety prorocze ?	prorocze	4	Masc
- Nasze działania są coraz skuteczniejsze .	skuteczniejsze	5	Neut
Osoba przypadkowa zorientuje się , że powinna odejść .	przypadkowa	1	Fem
Nie pamiętam tych dwóch córek niemieckiego majstra .	niemieckiego	5	Masc
Dzięki temu pracownicy bardzo szybko ustalili , kto może być odpowiedzialny za zdarzające się coraz częściej w firmie tajemnicze manka .	tajemnicze	18	Neut
Było tak zmasakrowane , że myśliwi z trudem ustalili jego płeć .	zmasakrowane	2	Neut
Żołnierze okopali się tam i celnymi strzałami odpierali atakujących .	atakujących	8	Masc
Można wracać , zadanie jest już wykonane .	wykonane	6	Neut
Przy wspólnym stole jadają tu studenci izraelscy i palestyńscy .	palestyńscy	8	Masc
Między miniaturowym arcydziełem a banalną grafomanią wyrasta obszar kompletnej pustki .	miniaturowym	1	Neut
W Czarnem umieszczono go w celi o zaostrzonym rygorze .	zaostrzonym	7	Masc
W niedzielę po południu turysta schodzący z Zawratu usłyszał głosy we mgle .	schodzący	5	Masc
Wystawa w Tel Awiwie przyciągnęła ponad 5 tysięcy zwiedzających , pokazano ją we wszystkich izraelskich telewizjach , pisały o niej wszystkie gazety .	izraelskich	14	Fem
Dziecko się zrobiło nerwowe po tych przejściach .	nerwowe	3	Neut
Zabierają jedynie najważniejsze akta i dokumenty .	najważniejsze	2	Neut
On tylko dopisał do tej rzeczywistości gigantyczną fobię .	gigantyczną	6	Fem
Stwierdzam , że Sejm wobec nieuzyskania bezwzględnej większości głosów poprawkę Senatu przyjął .	bezwzględnej	6	Fem
Ksiądz zajął fotel dyrektora , oparł o brzeg biurka splecione dłonie , czekał .	splecione	9	Fem
– Masz takie męskie dłonie , January .	męskie	3	Fem
Policja przypuszcza , że najnowszy ładunek został porzucony przez spłoszonego niedoświadczonego terrorystę .	niedoświadczonego	10	Masc
Do obserwatorium waszyngtońskiego ściągały tłumy ciekawych .	waszyngtońskiego	2	Neut
Jak ta Mirta miała wszystko uporządkowane i przemyślane !	uporządkowane	5	Neut
Do nowotarskiej tradycji weszły organizowane przez burmistrza spotkania noworoczne .	organizowane	4	Neut
W ten sposób zaaprobowane zostało wstępne porozumienie , osiągnięte w ubiegłym roku przez ministrów zdrowia Piętnastki .	ubiegłym	10	Masc
Mądrzej było by ominąć go szerokim łukiem .	szerokim	5	Masc
Przeszkodą w nadmiernym zwiększaniu prędkości skrawania jest okres trwałości .	nadmiernym	2	Neut
Podstawowe nazewnictwo łacińskie zostało przetłumaczone na język polski .	Podstawowe	0	Neut
Sylwetki mechaników wchłonęło po chwili czarne wnętrze hangaru .	czarne	5	Neut
Potwierdził to prezydent Jiang podczas niedawnego spotkania z prezydentem Clintonem .	niedawnego	5	Neut
Otwierają się tylne drzwi .	tylne	2	Neut
W tym przypadku również zalano odcinek asfaltem .	zalano	4	Neut
