Kuba , zbliż no się do mnie , niech cię pocałuję .	zbliż	2	Imp
Zgodnie z oczekiwaniami po złoto sięgnęły ekipy gospodarzy .	sięgnęły	5	Ind
Trzydniową konferencję zorganizował Interpol .	zorganizował	2	Ind
Pierwszy zalążek muzeum przyrody tatrzańskiej utworzyli w Kuźnicach Homolacsowie – właściciele huty i dóbr zakopiańskich .	utworzyli	5	Ind
Patrz przed siebie i czytaj w brodzie .	czytaj	4	Imp
Pomachaj jak ładna dziewczyna , która wypłynęła na przejażdżkę .	Pomachaj	0	Imp
I dlatego ich potępiamy .	potępiamy	3	Ind
Straszliwie mnie to swędzi .	swędzi	3	Ind
- Uciekaj .	Uciekaj	1	Imp
Radykalnie negując ład istniejący na ziemiach ukraińskich w Polsce i ZSRR , nacjonalizm odrzucał każdą próbę prowadzenia polityki w ramach realnego układu sił .	odrzucał	13	Ind
- Podtrzymaj mnie , bo jeszcze nie czuję nóg .	Podtrzymaj	1	Imp
Utwórz chociaż parę szybkich oddziałów dywersyjnych , bierność jest najgorszą z możliwych form walki .	Utwórz	0	Imp
Wyglądasz , jakbyś zjadł trującego robala .	Wyglądasz	0	Ind
Wracając z obchodu ku domowi , skręcił Rosomak na mogiłę Chorążego , i odśpiewali mu pieśni narodowe , a potem , milcząc , skierowali się do chaty .	odśpiewali	13	Ind
Dwa osły obładowane bagażami i człowiek w kapeluszu przemierzają górski teren .	przemierzają	8	Ind
Zdewastowane pawilony Qufu , noszące niegdyś wyrafinowane nazwy : Sali Wielkiej Doskonałości , Sali Świętych Dokumentów , nawiedzały zjawy .	nawiedzały	17	Ind
Pędź ile sił !	Pędź	0	Imp
- Wysiadaj , Kaśka .	Wysiadaj	1	Imp
Przyzwoitość każe szanować gości i ja właśnie w ten elegancki sposób uszanuję Jagodowe wakacje .	każe	1	Ind
Do 1939 miasto leżało po niemieckiej stronie granicy .	leżało	3	Ind
Ubierał się z wyszukaną , nieco staromodną elegancją .	Ubierał	0	Ind
Od tego zależą losy SLD .	zależą	2	Ind
Migotliwe światło zniekształca jego twarz .	zniekształca	2	Ind
W 1917 r. przeprowadza się wraz z matką do Bolesławia .	przeprowadza	3	Ind
Zwracajmy szczególną uwagę na bezpieczeństwo dzieci .	Zwracajmy	0	Imp
W premierowym przedstawieniu w roli Nabucca wystąpił Zbigniew Macias , a jako Abigail - Jordanka Derilova .	wystąpił	6	Ind
Wzburzony ojciec zawiadomił policję , ale z chciwą pedagog i tak się umówił .	umówił	12	Ind
Przyczyni się on do ochrony zdrowia naszych obywateli i z tego powodu z zadowoleniem przyjmuję jego przyjęcie .	Przyczyni	0	Ind
Gdy Dominika przyjechała po matkę , Babel dożywał swych dni .	dożywał	7	Ind
Pomyśl też o innej możliwości .	Pomyśl	0	Imp
- Kolega namawia Cię na wódkę : " Nie zaprzeczaj , nie zaprzeczaj , przecież widzę po twoich oczach , że marzysz po prostu o jednym głębszym , a twoje oczy nigdy nie kłamią .	zaprzeczaj	9	Imp
- Moje biedactwo , pokaż .	pokaż	4	Imp
6 . Nie pobiera się opłat portowych , na zasadzie wzajemności , od jednostek pływających sił zbrojnych Państw - Stron Traktatu Północnoatlantyckiego .	pobiera	3	Ind
Odwróć go trochę na bok , już dosyć cię opaskudził .	Odwróć	0	Imp
Nie strasz klientów .	strasz	1	Imp
Reagując na stan zaspokojenia tych potrzeb , przeżywa emocje .	przeżywa	7	Ind
- Nie gniewaj się , pomyśl , zrobili śmy im taką przyjemność .	pomyśl	5	Imp
Oskarżano nas , że w Bielicznej sprzedali śmy prywatnemu nabywcy kilkaset hektarów wraz z cmentarzem i cerkwią .	sprzedali	6	Ind
- Z tą młodością pan chyba przesadza .	przesadza	6	Ind
" No , po kim jak po kim , ale po nim to się nie spodziewałam " , pomyśli .	pomyśli	18	Ind
Gdy Starowieyski ujrzał obraz , krzyknął : - Nikt się na to nie nabierze !	nabierze	13	Ind
Wolała puszczać w kinach filmy kung-fu licząc , że dzięki temu ludzie przestaną myśleć o polityce .	Wolała	0	Ind
Małżonka krewnego przezornie schowała się do skrzyni i to ją uratowało .	schowała	3	Ind
Naprawdę zbliżam się do śmierci .	zbliżam	1	Ind
Wasielewski wyprowadził wóz z parkingu i włączył się do ruchu .	wyprowadził	1	Ind
Przybyli śmy tu z własnej woli .	Przybyli	0	Ind
I ponad wszystko , prześlij pszczołom miłość .	prześlij	4	Imp
Tak długo zwracaj wolność , aż poczujesz , że jest to całkowicie szczere i autentyczne .	zwracaj	2	Imp
Zwycięzcy grup awansowali do półfinałów .	awansowali	2	Ind
Popatrz , jak inni poruszają ustami .	Popatrz	0	Imp
Nie odwódźcie . . .	odwódźcie	1	Imp
- Pij jabcok .	Pij	1	Imp
Klaudio , rozumiem cię , ale wystarczy , że my dwoje zostaniemy .	zostaniemy	11	Ind
Ale też nie przytula .	przytula	3	Ind
Osobiście radziła by m panu iść do domu .	radziła	1	Ind
Może w dużych ośrodkach miejskich ludzie zagłosują na Juszczenkę , ale we wsiach poparcie dla Janukowicza będzie ogromne .	zagłosują	6	Ind
- O mnie się nie martw - zadeklarowałam ochryple .	martw	5	Imp
Sytuację komplikował wrogi , nieprzejednany stosunek , który rząd niemiecki nadal przejawiał wobec Polski .	komplikował	1	Ind
Prezentowano gospodarstwa agroturystyczne i przetwórstwo rolno - spożywcze .	Prezentowano	0	Ind
Żadne nie wiedziało .	wiedziało	2	Ind
Zawsze wybierajmy produkty , które będą służyć jak najdłużej .	wybierajmy	1	Imp
– Pozwólmy Michałowi Karnowskiemu .	Pozwólmy	1	Imp
Mieszkańcy grożą , że zablokują ulice .	grożą	1	Ind
Moja żona wybiera się do Tunezji , strzeżcie się , Tunezyjczycy .	strzeżcie	7	Imp
Tamten lirę do lewego boku przycisnął , nastroił , zakręcił korbę drewnianą i jął palcami po ośmiu trzpieniach przebiegać .	nastroił	7	Ind
- Biegnij ! - krzyknął .	krzyknął	4	Ind
Poszły nad Ślęzę .	Poszły	0	Ind
Wal z dużych flaszek !	Wal	0	Imp
Na witrynie umieścili też nazwiska ponad 500 znanych ludzi , którzy podpisali się pod protestem przeciwko zakazowi Marszu Równości .	umieścili	2	Ind
Kreślił , poprawiał zapisane strony , wyrzucał i zaczynał od nowa .	Kreślił	0	Ind
Chcę dzwonić po taksówkę , żeby mnie zabrała z łóżka do łazienki .	zabrała	7	Ind
Dlatego też bez zwracania większej uwagi wypiorą i wysuszą cienkie jak mgiełka majteczki , schnące mniej więcej trzy minuty , a wtedy szukaj wiatru w polu , głupi zazdrośniku .	szukaj	22	Imp
U małych pacjentów lekarze stwierdzali najczęściej anginę i nieżyt górnych dróg oddechowych .	stwierdzali	4	Ind
Często karani kielczanie raz za razem grali w osłabieniu .	grali	6	Ind
Zmuś ziemię , by wykarmiła swoje nędzne dzieci .	Zmuś	0	Imp
– nienawidzę . .	nienawidzę	1	Ind
- Rozbierajcie się i chodźcie do środka .	chodźcie	4	Imp
Zwracajmy szczególną uwagę na bezpieczeństwo dzieci .	Zwracajmy	0	Imp
I nie próbujcie nawet , zabierać stąd swojego majdanu . . .	próbujcie	2	Imp
— Nie kłam , nie kłam — ripostował Potockiemu stojący z tyłu Mariusz Kamiński z PiS .	kłam	5	Imp
Agnieszka chrząka znacząco , dzieci chwytają ciastka i wybiegają z pokoju .	chwytają	5	Ind
Wejdźcie więc do podziemnych lochów pełnych zasadzek i niespodzianek .	Wejdźcie	0	Imp
Instytucje Wspólnoty szczegółowo zbadały powyższe argumenty i doszły do następujących wniosków :	doszły	7	Ind
Kupili śmy sobie granity .	Kupili	0	Ind
Na płytkiej wodzie chwyć deskę oburącz ( jak " kozła " na szkolnej lekcji WF ) i powoli się podciągaj .	chwyć	3	Imp
przyda się .	przyda	0	Ind
- Piotrze , uwierz mi , to nagłaśnianie przez Zachód opozycji to naprawdę przesada .	uwierz	3	Imp
Ujawnił się jej pragmatyzm kobiecy ?	Ujawnił	0	Ind
Radujmy się z nimi , bo żyją !	Radujmy	0	Imp
Powstał by wtedy jedyny prawdziwy Kościół ojca Rydzyka .	Powstał	0	Ind
Zdziwiła się i nic nie odrzekła .	Zdziwiła	0	Ind
Czyżby prawdą było , co sami zbyt chętnie przyznajemy , że jesteśmy narodem niemuzykalnym ?	przyznajemy	8	Ind
- Ten werset jest źle przetłumaczony jako " bijcie je " , a w oryginale i dobrych tłumaczeniach brzmi on " przywołujcie je do porządku " .	przywołujcie	21	Imp
To coś jak puszczanie oka ; żeby się młodym zbuntowanym wydawało , że dostają towar zakazany .	dostają	13	Ind
Człowiek klęczy na chodniku obok psa leżącego na kurtce , na którym stoi szczur .	klęczy	1	Ind
Np . gracze wydębili od niego jakąś informację i potem dowiadują się , że ten chlapnął każdemu o tym , że odwiedzili go znamienici bohaterowie ( a graczom akurat zależy na skrytości działań ) .	wydębili	3	Ind
Ale uważaj .	uważaj	1	Imp
- Zadzwoniła m i pokojówka mi przyniosła .	Zadzwoniła	1	Ind
Klawisz [ Enter ] naciskaj tylko wtedy , gdy chcesz rozpocząć nowy akapit .	naciskaj	4	Imp
Do osoby która zrujnowała swoją przyszłość żeniąc się .	zrujnowała	3	Ind
- Coś ty powiedział ? ! - krzyknął chrapliwie .	krzyknął	7	Ind
Myślę , że każdy kraj , w którym znajdziemy gotowane mięsa i piękne ciasta i pieczywo takie , jak w Polsce , musi się spodobać .	znajdziemy	8	Ind
Jeśli ci się to nie podoba , to się na mnie nie patrz .	patrz	12	Imp
Amerykanie podejrzewając , że aspartam alergizuje , od kilku lat wprowadzają ograniczenia dotyczące stosowania tego składnika w produkcji żywności .	alergizuje	5	Ind
Dziadek zatrzymał jednak konie i powiedział : - Zamiast kłócić się , to idźcie się gdzieś spytać .	idźcie	13	Imp
Utnij na dwie dulki i schodź , bo palić się strasznie chce .	schodź	5	Imp
Poprawcie mnie , jeśli się mylę .	Poprawcie	0	Imp
Front w nocy przesunął się .	przesunął	3	Ind
Kupili jakieś zmiotki w ruskiej hurtowni i zbijają na mnie kasę .	Kupili	0	Ind
Między drzewami pokazało się trochę słońca i tylko daleko , jak w sennym przywidzeniu , rozległ się głuchy pomruk burzy .	rozległ	15	Ind
Pozwól , że opowiem ci inną zabawną historię , Nowy Jacku .	Pozwól	0	Imp
Nie odwódźcie . . .	odwódźcie	1	Imp
W prańskich koncertach wystąpi jeszcze parokrotnie .	wystąpi	3	Ind
Przedtem włóczyli się po mieście , topniał śnieg , szumiało w rynnach , czuć było powiewy ciepła i zgnilizny , nad dachami tłukły się kłębiaste chmury .	tłukły	22	Ind
Wcześniej szefował ZOZ-owi w Piasecznie .	szefował	1	Ind
- Zameldował Leonardo .	Zameldował	1	Ind
Doktor Kamiński podał podporucznikowi Ziembie zapalonego papierosa , wziął go mokrymi palcami , zaciągnął się łapczywie i zakaszlał .	zaciągnął	13	Ind
Policja od razu wszczęła dochodzenie .	wszczęła	3	Ind
Skrytykował władze , że zamiast budować drogi , nakazują wolną jazdę i stawiają fotoradary .	nakazują	8	Ind
I lepiej nie pytaj , co robię zimą .	pytaj	3	Imp
- My nie knujemy - oświadczyłem .	knujemy	3	Ind
- Broń Boże - stwierdza .	Broń	1	Imp
- Przyszedłem , bo lubię spacerować - zdradza Kazimierz Marcinkiewicz .	zdradza	7	Ind
Na Siemiradzkiego wybrzydzali krytycy , ale publiczność uwielbiała jego obrazy .	uwielbiała	7	Ind
Milcząco przywitał się z teściem i szorstko odprawił syna do odrabiania lekcji .	odprawił	7	Ind
Na czas hakafot policja zamyka ulice , żeby było gdzie tańczyć .	zamyka	4	Ind
- Nie jedź do Jerozolimy !	jedź	2	Imp
– Ufasz miejscowym ?	Ufasz	1	Ind
– no zrób .	zrób	2	Imp
Od zbłąkanych misjonarzy uchroń nas , Panie .	uchroń	3	Imp
Przyznał się do morderstwa , ale współpracuje .	Przyznał	0	Ind
No to usiądź swobodnie przed komputerem , zrelaksuj się , uruchom TAGa i napisz : Miota mną ogromny niepokój .	usiądź	2	Imp
Zranił jednego z nich , ale bandyci uciekli .	Zranił	0	Ind
W kontaktach z nimi potwierdziły się nasze przypuszczenia , że im są starsze , a zatem i większe , tym łatwiej aklimatyzują się w warunkach sztucznych .	aklimatyzują	21	Ind
Siostrzyczki emanowały szlachetnością i pobożnością .	emanowały	1	Ind
Zróbmy powtórkę . . .	Zróbmy	0	Imp
Abonował w obu teatrach dwa miejsca , dla siebie i żony .	Abonował	0	Ind
Weźmiemy to pod uwagę , przygotowując zmiany .	Weźmiemy	0	Ind
Dzieci się uczą na pamięć długości rzek , głębokości jezior . . .	uczą	2	Ind
Potem instaluje się w telefonie darmową aplikację , uaktywnia kodem i aparat jest gotów do przyjmowania wirtualnego biletu .	instaluje	1	Ind
Stwierdziła , że wszystko jest niemodne .	Stwierdziła	0	Ind
Zastanówmy się , jak można je zwalczać w sklepie ?	Zastanówmy	0	Imp
- Ha ! zresztą rób , jak chcesz , ale prędko decyduj się co do Stawskiej , bo czuję , że Mraczewski nie zaśpi gruszek w popiele .	zaśpi	23	Ind
Dlatego powiedziałam Elce , żeby się pilnowała , nie chodziła na zwolnienia , nie spóźniała - opowiada koleżanka Janickiej .	spóźniała	14	Ind
Żołnierze okopali się tam i celnymi strzałami odpierali atakujących .	okopali	1	Ind
W Zborowie powstał obiekt o powierzchni użytkowej 3364 metrów kwadratowych , w którym zamieszka 50 osób .	zamieszka	13	Ind
To poskutkowało .	poskutkowało	1	Ind
Po utworzeniu Towarzystwa Tatrzańskiego jego działacze , wespół z nowym właścicielem Kuźnic Ludwigiem Eichbornem założyli muzeum , w którym zgromadzono kilkaset okazów flory , parę przykładów fauny i kolekcję minerałów .	zgromadzono	19	Ind
Od samotności niepoczytalnej i obłędu uchroń nas , Panie .	uchroń	5	Imp
A . M . : Natomiast ja uważałem się wtedy za prawdziwego marksistę i było mi w to graj , że ci marksiści udawani zaczynają się kłócić .	graj	18	Imp
Wprowadźmy do tego trupiego świata poprawkę .	Wprowadźmy	0	Imp
Podczas ceremonii otwarcia Spływu organizatorzy przyznali liczne odznaczenia zasłużonym kajakarzom .	przyznali	5	Ind
Ciała te noszą ślady tortur .	noszą	2	Ind
Nie odwódźcie mnie . . .	odwódźcie	1	Imp
- Ten werset jest źle przetłumaczony jako " bijcie je " , a w oryginale i dobrych tłumaczeniach brzmi on " przywołujcie je do porządku " .	bijcie	8	Imp
- Zatrzymaj się , bo strzelę !	Zatrzymaj	1	Imp
Może chłopiec zasłucha się i zaśnie ? . . .	zaśnie	5	Ind
Nie gniewaj się . . .	gniewaj	1	Imp
Witamy , witamy . . .	Witamy	0	Ind
Składa się na ń obecnie pięć pierwszych ksiąg Biblii .	Składa	0	Ind
Powiedział em , że uczą , uśmiechnął em się do Rogera i wychylił em kieliszek .	wychylił	12	Ind
Komisja oceniła , że Milczanowski i funkcjonariusze urzędu popełnili przestępstwo .	oceniła	1	Ind
Naczelnik ulicznych rzeźników wykrzywił twarz .	wykrzywił	3	Ind
Z iego kontusza potem Marszałkowa sobie uszyła serdako-suknię .	uszyła	6	Ind
Przygrywały kapele , występowały zespoły i soliści .	występowały	3	Ind
Marcin Piątek : - Czy często panią pytają , po co tak ryzykować ?	pytają	7	Ind
- Ha ! zresztą rób , jak chcesz , ale prędko decyduj się co do Stawskiej , bo czuję , że Mraczewski nie zaśpi gruszek w popiele .	rób	4	Imp
Nie jesteś sierotą - mówimy .	mówimy	4	Ind
Zassał em powietrze .	Zassał	0	Ind
Ponoć cierpią na nią ludożercy .	cierpią	1	Ind
Zrób kolację .	Zrób	0	Imp
– słuchaj .	słuchaj	1	Imp
Tak , posłuchaj . . . nie zrobiłem tego z dobroci serca , Tom .	posłuchaj	2	Imp
Wracajcie do Polski !	Wracajcie	0	Imp
Wessie je mózg , wątroba , rurką pępowiny popłyną do Poli .	Wessie	0	Ind
Dopóty , dopóki nauczyciel nie udowodni , że jest dobry w swoim zawodzie , powinien być na kontrakcie .	udowodni	5	Ind
- Zamykaj buzię , bo ci świecący ptak do niej wleci .	Zamykaj	1	Imp
Wybierzmy tych , którym chcemy pomóc .	Wybierzmy	0	Imp
Bał em się , że pożar przejdzie też na moją stodołę .	przejdzie	6	Ind
- Tylko nie strzelajcie , swoi idą .	strzelajcie	3	Imp
Składa się ono z 61 punktów i jest wyczerpujące , ale moim zdaniem bardzo niejasne .	Składa	0	Ind
Za nic nie zrobię z siebie pajaca .	zrobię	3	Ind
Zabierają jedynie najważniejsze akta i dokumenty .	Zabierają	0	Ind
Furorę robili sygnaliści z Tucholi .	robili	1	Ind
Szef mówił , że Niemcy zebrali tam co najlepsze swoje dywizje , okrutnie umocnili sia , obwarowali i przygotowali do długiej obrony .	umocnili	13	Ind
Tylko mięczak sobie nie poradzi .	poradzi	4	Ind
Zostawmy na boku homoseksualistów , ale z pewnością prawo może decydować , kto dopuszczony jest do danego zawodu .	Zostawmy	0	Imp
- Wyśpijcie się i przyjdźcie rano .	przyjdźcie	4	Imp
Twierdzi , że ci , którzy najgłośniej protestowali przeciwko prawdzie , stanowią tutaj mniejszość , ale to na podstawie ich głosów Jedwabne jest oceniane , bo większość jak zwykle milczy .	milczy	29	Ind
Apeluję do " GW " : nie pozywajcie do sądu Wassermanna !	pozywajcie	7	Imp
Kierujemy przeciw byłej dyrektor i jednej z pracownic sprawę do prokuratury , rzecznika dyscypliny finansów publicznych i być może Regionalnej Izby Obrachunkowej oraz Najwyższej Izby Kontroli - zapowiedział Kaim .	Kierujemy	0	Ind
A potem zgłoś się do księcia po nagrodę .	zgłoś	2	Imp
Trzeba też dodać , że wkraczali śmy do Francji w czasie dość trudnym dla wzajemnych stosunków .	wkraczali	5	Ind
nie wdawaj się w żadną kłótnię z nią .	wdawaj	1	Imp
Jarle Halsnes z Norwegii niepostrzeżenie wyrósł na świetnego slalomistę .	wyrósł	5	Ind
Kiedy Anna Maria poznała swojego przyszłego męża , niewiele wiedział o Generale .	poznała	3	Ind
Nie odwrócą się .	odwrócą	1	Ind
Przekazuj zasady prostym językiem .	Przekazuj	0	Imp
- Wygrywa ?	Wygrywa	1	Ind
Witaj , witaj .	witaj	2	Imp
Objechał świat .	Objechał	0	Ind
- I uratowała - mówią w Pionkach .	uratowała	2	Ind
Tom Spencer posiadał przy sobie pisma pornograficzne i kasety video dla homoseksualistów oraz marihuanę .	posiadał	2	Ind
Zastanawiał się .	Zastanawiał	0	Ind
Stań prosto , ze stopami rozstawionymi na szerokość ramion , wyprostuj plecy i wciągnij brzuch .	wyprostuj	10	Imp
Do tego dochodzą godziny spędzone na oglądaniu video i grach komputerowych szczególnie przez dzieci i młodzież .	dochodzą	2	Ind
- Idźcie na dół .	Idźcie	1	Imp
Chmury rozsunęły się na moment , odsłaniając wytarty miedziak słońca .	rozsunęły	1	Ind
Zauważyła m , że człowiek ten jest nawet całkiem miły .	Zauważyła	0	Ind
– Edek wydął z pogardą wargi , a ja natychmiast pożałował em , że to tylko kuzyn .	wydął	2	Ind
Ale cieszę się , że przyszedłeś .	cieszę	1	Ind
Jeśli ktoś spróbuje pogodzić skłócone małżeństwo , mówiąc : ja zdecyduję za was , jak macie ze sobą żyć - zostanie wyśmiany .	zdecyduję	10	Ind
A ogrzewania wyłączyć nie możemy , bo to zaszkodzi świeżo zakonserwowanym freskom w obu synagogach .	zaszkodzi	8	Ind
Porozmawiajmy o ludziach .	Porozmawiajmy	0	Imp
– Zagrajmy w pokera .	Zagrajmy	1	Imp
Jeśli odczuwasz zbyt silną potrzebę izolacji , samotności , nie pozwól na zamknięcie się w swoich myślach , obawach i wyobrażeniach .	pozwól	10	Imp
Polska się naprawdę dusi w pętli zadłużenia .	dusi	3	Ind
Najbardziej ucierpiał Maciej Z . , który został ranny w głowę .	ucierpiał	1	Ind
Ekspertyza potwierdziła podpalenie .	potwierdziła	1	Ind
Błagam , nie chorujcie i żadnych kłopotów nie miejcie !	chorujcie	3	Imp
Musi więc udawać , że on wcale nie oparł policzka na jej ramieniu , że jego dłoń tymczasem nie obmacuje jej ciała .	oparł	8	Ind
Oferuje również pomoc w załatwianiu spraw urzędowych z prawnikiem , policją i pracownikiem socjalnym .	Oferuje	0	Ind
Jak ją bardziej przycisnęłam , okazało się , że nie miała nigdy solowego numeru , tylko fikała nogami w tle , ale i tak było to czymś egzotycznym w stosunku do obecnej sytuacji .	fikała	16	Ind
Nie patrz poza siebie .	patrz	1	Imp
Progi , poniżej których można przyjąć , iż korzyści zapewnione przez porozumienia wertykalne przeważają nad ich ograniczającymi skutkami , powinny zmieniać się w zależności od cech różnych rodzajów porozumień wertykalnych .	przeważają	13	Ind
Pseudokibicom ze Stalowej Woli upiekło się , choć nieźle w sobotę nabroili .	nabroili	11	Ind
- Robisz twarożek ?	Robisz	1	Ind
Gdy odzyskam pudełko , udaj się na skraj lasu .	udaj	4	Imp
Wizytator przeprosił kierownika i udał się z powrotem do klasy szóstej .	przeprosił	1	Ind
Zostaw go zanim zleje się w spodnie .	Zostaw	0	Imp
Ale , Yennefer , wydaj te polecenia szybko .	wydaj	4	Imp
Kłamstwo było przykre i onieśmielało .	onieśmielało	4	Ind
W czasie każdej wigilii odczuwałam wielką ulgę , kiedy Mama oznajmiała , że wybacza mnie i siostrze wszelkie przewinienia ( np . stłuczony talerz , czy wagary w szkole ) .	oznajmiała	10	Ind
Wrócili na prawą jezdnię ; Antek wyprzedził malucha , za którym snuli się przez ostatni kilometr , i dodał gazu , jakby chciał nadgonić stracony czas .	snuli	11	Ind
Starym kawalerem zostanie i następcy zabraknie , tradycja garncarska w rodzinie Kraszewskich zaginie . . .	zaginie	12	Ind
może se cofasz licznik .	cofasz	2	Ind
Mężczyzna w czapce , kombinezonie i ochraniaczach na uszy rzeźbi piłą łańcuchową figurkę postaci w drewnie .	rzeźbi	9	Ind
- Kolega namawia Cię na wódkę : " Nie zaprzeczaj , nie zaprzeczaj , przecież widzę po twoich oczach , że marzysz po prostu o jednym głębszym , a twoje oczy nigdy nie kłamią .	zaprzeczaj	12	Imp
Bądź wdzięczny , okazuj wdzięczność wszystkiemu , co żyje .	okazuj	3	Imp
Mijały lata i część pisarzy mongolskich pojęła jak zafałszowany jest kreślony przez nich obraz szczęśliwego jutra kiedy go skonfrontować z powszednią rzeczywistością .	Mijały	0	Ind
Ale w Niemczech wrze .	wrze	3	Ind
Nie zapominajmy , że do wyrobu produktów cukierniczych ( ciasteczek , herbatników itp . ) dodaje się tłuszczów cukierniczych , które mają podobne wady jak margaryna .	zapominajmy	1	Imp
- Zapewnia mi samorealizację i rozwój .	Zapewnia	1	Ind
Powołanie Semaka wzburzyło pracowników opolskiej rozgłośni .	wzburzyło	2	Ind
Kochaj siebie !	Kochaj	0	Imp
Wczoraj już od piątej rano kupcy wyprowadzali się .	wyprowadzali	6	Ind
Paweł oprzytomniał nieco .	oprzytomniał	1	Ind
Nic nie zmieniamy .	zmieniamy	2	Ind
Ten pocałunek parzy mi dłoń .	parzy	2	Ind
Wyprowadzają one małe koźlęta na płaty śniegu i uczą je zjeżdżać na racicach .	uczą	8	Ind
- Nic się nie martw - odparł drugi cień .	martw	4	Imp
W roku 1912 Olga w związku z kolejną przygotowującą się pod jej nieobecność wystawą zasięgnęła rady Sainsèrea przy wyborze obrazów .	zasięgnęła	14	Ind
Padają nazwiska Zbigniewa Romaszewskiego i Jana Olszewskiego .	Padają	0	Ind
W chwili kiedy Julia wypowiedziała te słowa , dla Andrew zatrzymał się czas .	wypowiedziała	4	Ind
– co chesz ?	chesz	2	Ind
Rozbawił go bezsens sytuacji , tym bardziej że za drzwiami na drugim piętrze , niczym odpowiedź , rozległ się płacz dziecka .	Rozbawił	0	Ind
Jachty pływają po wodzie , skąd rozpościera się widok na wysokie wieżowce miejskie .	rozpościera	6	Ind
- Nie patrz tak .	patrz	2	Imp
Urosły ogromnie .	Urosły	0	Ind
Upiła łyk i sięgnęła po torebkę z bułką .	sięgnęła	3	Ind
Jeśli ludzie i instytucje , zajmujące się tymi sprawami , uznają , że teczki trzeba ujawnić - należy zaufać ich mądrości .	uznają	10	Ind
Na zegarze kościelnym wybiła północ .	wybiła	3	Ind
Weźmy Siedlce .	Weźmy	0	Imp
Przeszkadza ci .	Przeszkadza	0	Ind
Wodzowie ich przybrali wszystkie zewnętrzne atrybuty faraonów i utrzymali się w podbitym Egipcie około 150 lat , tłumiąc ogniem i mieczem wszelkie objawy buntu .	przybrali	2	Ind
- To weź ich sobie do domu i mieszkaj z nimi - zacietrzewia się jej kolega .	mieszkaj	8	Imp
Prezydent z oburzeniem dementował zarzuty o pazerność i zaprzeczał , jakoby pobierał apanaże z tytułu prezesowania spółce Aqua .	zaprzeczał	8	Ind
To najpierw zmontuj sobie taki " na niby " . . . . . .	zmontuj	2	Imp
Manipulujesz pod hasłem " zajmijcie się mną " , a potem się wyłączasz .	zajmijcie	4	Imp
Spustoszył potem Kujawy i zabrał wielkie łupy , które jednak mistrz prowincji mu wydarł .	Spustoszył	0	Ind
Odbudujmy porozumienie ponad różnicami , tak mało istotnymi wobec rzeczywistych problemów !	Odbudujmy	0	Imp
Lecz łza starości raz wraz zalewała przekrwioną źrenicę .	zalewała	5	Ind
Odsłania się rzecz ciekawa : okazują się skrajnie różne systemy oceny rzeczywistości .	Odsłania	0	Ind
Uczył em się .	Uczył	0	Ind
on zje .	zje	1	Ind
To nie przedszkole , nie mazgaj się .	mazgaj	5	Imp
Jak ja za wami tęskniła m !	tęskniła	4	Ind
Pokręciła głową i usiadła na krześle .	Pokręciła	0	Ind
3 listopada ok . godz . 12.00 przy ul . Młodzieżowej w Wodzisławiu nieznany sprawca skradł 150 litrów oleju napędowego z ciężarowego volvo .	skradł	15	Ind
Niemalże całość tych notatek dołączamy w Aneksie .	dołączamy	4	Ind
Błagam , nie chorujcie i żadnych kłopotów nie miejcie !	chorujcie	3	Imp
Policjanci przywieźli pijanego radiowozem do szpitala .	przywieźli	1	Ind
Giną więc wozy , których właściciele nie ubezpieczają ze względu na wysokie stawki .	Giną	0	Ind
Wszystkie zresztą cukiernie i kawiarnie zmodernizowały się , restauracje także .	zmodernizowały	5	Ind
Unia Europejska ponawia swoje zobowiązanie do wspierania narodu Wybrzeża Kości Słoniowej w wysiłkach mających na celu wyjście z obecnego kryzysu na drodze pogłębionego dialogu politycznego .	ponawia	2	Ind
Podążał wytrwale , polną drogę mając za przewodnika .	Podążał	0	Ind
Teraz jednak swoje zapowiedzi przekuła w czyn - i pozew trafił już do londyńskiego sądu .	przekuła	4	Ind
Bo we własnym aucie strach się teraz odezwać ? - dowcipkowali dziennikarze .	dowcipkowali	10	Ind
W latach studenckich zaopatrywała w swetry własnego pomysłu i roboty pół akademika .	zaopatrywała	3	Ind
Wracają i pracują solidnie .	pracują	2	Ind
Nie ruszaj się .	ruszaj	1	Imp
Z dumą przypomina sobie , że gdy Anglicy spytali Polaków , dlaczego lubią latać z Mackenziem - odpowiedzieli : - Bo on jest tak samo szalony jak my .	odpowiedzieli	17	Ind
Podzieli ona Twoje nadzieje i zaproponuje wspólne plany .	Podzieli	0	Ind
Za linią lasu błysnęła w słońcu blacha na wieży kościoła .	błysnęła	3	Ind
Przez cały czas trwania ćwiczenia oddychaj , zwracając szczególną uwagę na wydech .	oddychaj	5	Imp
- Pawle , nie jedź do Jerozolimy !	jedź	4	Imp
– Zgubił się przed dwoma dniami .	Zgubił	1	Ind
Każdy sąd rzetelnie dokumentuje .	dokumentuje	3	Ind
Jednakże Sołżenicyn , wspomniawszy o " surowym doświadczeniu " rosyjskiego przedrewolucyjnego parlamentaryzmu , zwrócił się do deputowanych jako " przedstawicieli piątej Dumy " , którzy oby kontynuowali tylko te dobre państwowotwórcze tradycje demokratyczne .	kontynuowali	26	Ind
Naurańczycy utrzymywali się głównie z kokosów , owoców Pandanus tectorius , oraz ryby chanos , którą zaaklimatyzowali do słodkowodnych warunków Buada Lagoon .	zaaklimatyzowali	16	Ind
Zaprosimy cię na otwarcie , przysięgam .	przysięgam	5	Ind
Wyszedł i wyprostował się .	wyprostował	2	Ind
Niektóre z nich , pamiętając , jak wcześniej nieludzko traktowano je w czasie rozwiązania , dopiero po wprowadzeniu zmian zdecydowały się na drugie dziecko .	traktowano	9	Ind
Człowiek asekuruje na linie mężczyznę wspinającego się po stromej skale .	asekuruje	1	Ind
- Przykryj go .	Przykryj	1	Imp
- Przeanalizujmy kilka kluczowych elementów .	Przeanalizujmy	1	Imp
W piątek wieczorem odwiedziły ją w domu i namówiły na spacer .	namówiły	8	Ind
Obserwuję dużo młodszych kolegów , którzy ze zdziwieniem patrzą , co ja tu jeszcze robię .	Obserwuję	0	Ind
Omówmy ten schemat na przykładzie .	Omówmy	0	Imp
Wybierz sobie jakiś cel i podaruj pieniądze .	podaruj	5	Imp
Zarzuca Mariannie : Przejmujesz się tylko wtedy , gdy sprawa dotyczy ciebie .	Zarzuca	0	Ind
Próchno schodów skrzypiało znacznie bardziej niż wtedy , mimo że starał się stąpać równie lekko .	skrzypiało	2	Ind
- Zanurz się we mnie , a będziesz wiedzieć - zaszumiały fale .	Zanurz	1	Imp
Postrzelili go , ale jakoś dowlókł się do tego krzyża .	Postrzelili	0	Ind
Nazwijmy ją Lady Iks .	Nazwijmy	0	Imp
Mucha wypoczywała na jego dłoni .	wypoczywała	1	Ind
Siły faszystowskie zaatakowały . . . budynki publiczne i policję .	zaatakowały	2	Ind
Jest istotne , aby rozwiązania , które opracowujemy i nad którymi państwo pracują w celu wydobycia nas z tego kryzysu gospodarczego wzmocniły naszą społeczną gospodarkę rynkową .	wzmocniły	21	Ind
Czarno - biały ptak z pomarańczowym dziobem pluszcze się w wodzie wśród kamieni .	pluszcze	7	Ind
Zresztą nie obrażaj mnie !	obrażaj	2	Imp
Prosiła mnie : pomóż mi , bo coś złego się ze mną dzieje ” .	pomóż	3	Imp
Wydało mi się , że to mi przywróci równowagę .	przywróci	7	Ind
A gdzież to panowie tak podróżują ?	podróżują	5	Ind
– Próbował em teraz w lecie na jachcie .	Próbował	1	Ind
Jakby się nie liczyli w tym spotkaniu .	liczyli	3	Ind
Spoglądam na Ignaca .	Spoglądam	0	Ind
1 . Załóż bieliznę , a potem wykonaj dla niego striptiz , kołysząc biodrami jak mieszkanka Karaibów .	Załóż	2	Imp
Niemcy mający w tej kwestii spore doświadczenie będą doradzali makowskim i pułtuskim samorządowcom jak sobie z tym problemem radzić .	doradzali	8	Ind
Kobieta zaufała oszustowi i podała numery z 28 kart .	zaufała	1	Ind
Wśród internautów przeważają mężczyźni .	przeważają	2	Ind
- I jeszcze odciski stopy weźmiemy - przypomniał Karlik .	przypomniał	7	Ind
Wikary Pudło odprawia je żując gumę .	odprawia	2	Ind
Trzymaj , włóż to do tego swojego plecaczka .	Trzymaj	0	Imp
Lecz tu znów wyjaśniło się , że poleci z nimi doktor Pnin .	poleci	7	Ind
- Ugniataj coraz mocniej , a sam zobaczysz .	Ugniataj	1	Imp
Wynajmujemy pokój prywatny w biurze obsługi turystów .	Wynajmujemy	0	Ind
Wrócił i sięgnął po papierosa .	Wrócił	0	Ind
Tymczasem kolegium odroczyło swoją decyzję .	odroczyło	2	Ind
- A jakie przylatują , żeby spędzić z nami zimę ?	przylatują	3	Ind
- Nie wciskaj mi kitu .	wciskaj	2	Imp
Demografowie biją na alarm - w Polsce rodzi się coraz mniej dzieci .	biją	1	Ind
- Do jasnej cholery , nie ruszaj się !	ruszaj	6	Imp
Tak ich zastał ksiądz Grozd .	zastał	2	Ind
Wszystko razem urzekało .	urzekało	2	Ind
Przytul się mocno I podnieś głowę Patrząc w ich oczy Moim spokojem .	Przytul	0	Imp
Kiedy wdychasz powietrze , czuj to .	czuj	4	Imp
Ponieważ skóra w tym miejscu wiotczeje najszybciej , zacznij używać kremu pod oczy , który działa trochę silniej .	zacznij	8	Imp
Na północy i wschodzie strzelano .	strzelano	4	Ind
Chodźcie za mną .	Chodźcie	0	Imp
– Po co go tu przysłali ?	przysłali	5	Ind
Słońce , ciepły piasek i piegowate plecy Moniki Nonas , córki sąsiadów , sprawiły , że przyjął pocałunek w policzek jako rzecz przynależną ciepłu i słońcu .	sprawiły	13	Ind
Kwestię zakupów napojów alkoholowych omówmy na przykładzie 15 - 16-latków .	omówmy	4	Imp
- Przewrócili na drugą stronę .	Przewrócili	1	Ind
W tej chwili Francuz westchnął ciężko i boleśnie .	westchnął	4	Ind
Gdy policjanci się zbliżają , małżonkowie lojalnie ostrzegają : – Odejdźcie , dobrzy ludzie , bo przewrócimy auto !	przewrócimy	16	Ind
Ty : " Czy uważasz , że coś z nim jest nie w porządku ?	uważasz	4	Ind
Ponad 40-letni kierowca , po wypiciu sporej dawki alkoholu , zakradł się do zajezdni i zasiadł za kierownicą autobusu , w stacyjce którego pozostawiono kluczyki .	zasiadł	15	Ind
Nie chcę go podejrzewać , że osobiście inispirował takie metody zohydzania mojej osoby , gdyż zdyskredytował by się jako człowiek .	zdyskredytował	15	Ind
Lęka się widocznie , że ktoś przedstawienia nie zauważył .	Lęka	0	Ind
Byli w wielu innych związkach , które się jednak rozsypały .	rozsypały	9	Ind
Wiece , o których pisał Helmold , odbywały się częściej : nie co poniedziałek wprawdzie , jak mniemał kronikarz , ale zapewne co miesiąc ( księżycowy ) .	mniemał	17	Ind
W filmie Dawida Lyncha " Prosta historia " młody mężczyzna , od którego aż bucha witalnością , pyta nieco kpiącym głosem starego człowieka : " Powiedz , co jest najgorszego w starości ? "	bucha	14	Ind
Ale minister kultury zdecydował się , żeby do Sejmu wiosną skierować część nowelizacji ustawy o prawie autorskim , tylko tą , która przystosowuje polskie prawo do prawa Unii Europejskiej .	przystosowuje	22	Ind
Niedawno wywiadu udzielił nam Bogusław Wołoszański .	udzielił	2	Ind
" Następnym razem nie dzwoń z domu " - rzuciła .	dzwoń	4	Imp
Ta propozycja , która została złożona - nazwijmy to propozycją w cudzysłowie - zakładam oczywiście jej prawdziwość , zastrzegam się , bo to jest informacja prasowa . . .	zastrzegam	18	Ind
Nie banalizujmy tej dyskusji zarzucaniem artystom tego , że chcą zarabiać .	banalizujmy	1	Imp
Myśli kapitana poszybowały na moment do odległych Alp Julijskich i zawisły nad stylowym pensjonatem ze świerkowych bali .	zawisły	10	Ind
- Myślałem , że poczujesz tamto uczucie , tamten gniew i złość , gdy zobaczysz go ponownie .	poczujesz	4	Ind
Francuzi nadal atakowali w tradycyjny sposób i wystawiali się na rzeź , nie zbliżywszy się nawet do angielskich szeregów .	wystawiali	7	Ind
Bracie Gęgaczu , rozchmurz swą fizys !	rozchmurz	3	Imp
Ściągnijcie wódkę ze stołu i postawcie kilka dzbanków herbaty , żeby ta cała banda zaczęła powoli trzeźwieć .	Ściągnijcie	0	Imp
Wpakował się na sanie .	Wpakował	0	Ind
Kiedy oglądamy filmy europejskich reżyserów , którzy osiedli w Stanach Zjednoczonych , widzimy wyraźnie , że oni zupełnie zatracili własny " charakter pisma " - produkują jak reszta wytwórców z Hollywood .	osiedli	7	Ind
Jeśli zaczekasz aż położę Smyka , zawiozę cię do domu .	zawiozę	6	Ind
Wiedza nabyta w szkole dezaktualizuje się w ciągu zaledwie kilku lat .	dezaktualizuje	4	Ind
Czy senator rzuci rękawicę wszechwładnemu przewodniczącemu ?	rzuci	2	Ind
Nacisnął klamkę i wszedł do mieszkania .	Nacisnął	0	Ind
Ochmistrz ma otwartą kabinę , dla przyzwoitości pukam w uchylone drzwi .	pukam	7	Ind
Posiadanie pełnych praw akademickich oznacza , że uczelnia nadaje stopień naukowy doktora , przeprowadza przewody habilitacyjne oraz występuje z wnioskiem o nadanie tytułu naukowego profesora .	przeprowadza	13	Ind
Od wolnej woli wybaw nas , Panie .	wybaw	3	Imp
Seniorska reprezentacja Polski zbliża się do zgrupowania we Wronkach .	zbliża	3	Ind
Zatrzymaj całkowicie proces oddychania .	Zatrzymaj	0	Imp
Wniosek zmienia art . 2 ust . 2 , rozszerzając zakres rekompensat dla inwestorów z tytułu roszczeń związanych z upadłością przedsiębiorstwa dotyczących zwrotu należnych instrumentów finansowych , aby obejmowały upadłość powiernika będącego osobą trzecią .	obejmowały	28	Ind
Miało to istotny wpływ na unaukowienie badań literackich i emancypację nauki o literaturze jako dyscypliny autonomicznej .	Miało	0	Ind
Pamiętam o tym bardzo dobrze , bo wówczas utkwiła mi w głowie jak jakaś zagadka " .	utkwiła	8	Ind
Przemkowi już kilka razy nauczycielka zabierała telefon , bo bawił się nim podczas lekcji .	zabierała	5	Ind
Zmuś ziemię , by wykarmiła swoje nędzne dzieci .	Zmuś	0	Imp
– sprał się . .	sprał	1	Ind
- A nas zapudłują za zepsucie takiej ładnej zabawki - Witek wzruszył ramionami - dobra , idziemy do nich .	zapudłują	3	Ind
Wolny rynek zamordował francuski przemysł , rozszerzenie Unii o kraje Europy Środkowo - Wschodniej unicestwi francuskie rolnictwo .	zamordował	2	Ind
On jej wyrywa .	wyrywa	2	Ind
Rada Nadzorcza towarzystwa na wczorajszym posiedzeniu pominęła sprawy personalne .	pominęła	6	Ind
Prezydent Starogardu Gd . Edmund Stachowicz wręczył nagrody laureatom eliminacji miejskich X edycji Ogólnopolskiego Konkursu Plastycznego dla dzieci i młodzieży pod hasłem " 112 w trudnej sprawie - nie używaj przy zabawie " .	używaj	29	Imp
Bywa też tak , że dzieci nie wiedzą , czego chcą , i to też nas rozczarowuje .	rozczarowuje	16	Ind
- Teraz ubieraj się już , Simonne .	ubieraj	2	Imp
- Ja też brał em panią pod uwagę .	brał	3	Ind
Gdy przybili , koło chaty nie było śladu szału , tylko znak widomy został : rozdarta gromem od szczytu do korzeni brzoza u krynicy .	przybili	1	Ind
Nie było jej zawsze , czaiła się po swej stronie , by niespodziewanie wybuchnąć , ujawnić jako ruchome niczym piaski miejsce i wciągnąć w siebie .	czaiła	5	Ind
A tragarzy nie słuchaj .	słuchaj	3	Imp
– pokaż !	pokaż	1	Imp
W przypadku pozyskiwania produktów we Wspólnocie , zapraszane przedsiębiorstwa wybiera się spośród tych , które uczestniczyły w zaproszeniach do składania ofert określonych w ust . 2 .	uczestniczyły	15	Ind
Ty patrz , co ty widzisz .	patrz	1	Imp
- Powróćmy do reformy podatkowej .	Powróćmy	1	Imp
Obaj skrupulatnie przepisywali rezultaty kolejnych odcinków specjalnych , by w pokojach hotelowych dokładnie je przeanalizować .	przepisywali	2	Ind
W dodatku , gdy zaczęto oczyszczać go z mułu , okazało się , że na kamieniu wyryty jest napis : " Zmiłuj się , jeżeli masz serce ludzkie , i obróć mnie ! "	Zmiłuj	21	Imp
Prezes OSP Stanisław Kocot wyjaśniał , że będą to nowoczesne , otwierane za pomocą pilota bramy , które znacznie ułatwią strażakom wyjazdy do akcji .	ułatwią	19	Ind
Prokuratorzy kazali mu przyjść kiedy indziej .	kazali	1	Ind
Uwierz mi .	Uwierz	0	Imp
Oznacza ona , że ten Sejm nie zdąży przyjąć ustawy budżetowej .	zdąży	7	Ind
Otwiera to pole dla różnych szalbierzy .	Otwiera	0	Ind
W ziemi ziały ogromne dziury .	ziały	2	Ind
Bywa , że dzieci ulegają nam , podporządkowują się naszej woli .	podporządkowują	7	Ind
Oczywiście prawnie będziesz wciąż sobą , . . . ale pomyśl o tym jako chudszym i bardziej atrakcyjnym sobie . . . co nie miałoby miejsca bez nas .	pomyśl	10	Imp
Za najlepszą książkę popularnonaukową o Łodzi jury uznało książkę Krzysztofa Stefańskiego " Jak zbudowano przemysłową Łódź . Architektura i urbanistyka miasta w latach 1821 - 1914 " .	uznało	7	Ind
Czysta energia teraz ! - zaapelowali do Waldemara Pawlaka działacze Greenpeace na transparencie , który rozwiesili w zeszły piątek na budynku resortu gospodarki .	rozwiesili	15	Ind
Postawicie nam ćwiartkę , a my już damy facetowi radę .	Postawicie	0	Ind
Niedzielny eksperyment z " nielegalnym handlowaniem " był pełnym sukcesem dla sprzedawców : klienci głosowali w tym dniu nogami , oblegając sklepy i przysparzając handlowcom rekordowych obrotów .	głosowali	14	Ind
Nika , nie gap się .	gap	3	Imp
Od instynktu samozachowania wybaw nas , Panie .	wybaw	3	Imp
- Apteka zachowała się niedobrze .	zachowała	2	Ind
Za wprowadzenie czytelników w błąd przepraszamy .	przepraszamy	5	Ind
Ale niech się pan tym zbytnio nie przejmuje .	przejmuje	7	Ind
- Wyciągnij go spod ziemi , ale muszę go mieć dzisiaj .	Wyciągnij	1	Imp
Padają Zakłady Cegielskiego w Poznaniu , a dialog przenosi się na ulice .	Padają	0	Ind
Popierają regionalne środowiska twórcze .	Popierają	0	Ind
Lubią sadowić się na zamkniętym pojemniku na chleb , na frytkownicy , mimo że jest nieduża , a nawet czasem na pokrywce dużego garnka .	Lubią	0	Ind
Niania dokarmiała go smakołykami , do domu przychodziła nauczycielka języka niemieckiego .	dokarmiała	1	Ind
Wracajcie pod szyb po ludzi , siekiery i kilofy .	Wracajcie	0	Imp
A : Ty i tak chyba zbytnio się nie przemęczasz , bo wszędzie wozisz się autem .	przemęczasz	9	Ind
Wtedy nikt nas nie zauważy .	zauważy	4	Ind
Usmaż jeszcze kiedyś faworki , błagam .	Usmaż	0	Imp
W niedziele , wtorki i czwartki jadła bowiem tylko ryby oraz potrawy mleczne , w soboty i poniedziałki - tylko jarzyny , a we środy i piątki poprzestawała na chlebie i wodzie .	poprzestawała	27	Ind
- Akcje , które posiadają BCP i Eureko , należały do podmiotów zależnych od BIG i znajdowały się w gestii zarządu - powiedział ŻYCIU Jedamski .	należały	9	Ind
Klaskał mu prezydent Kwaśniewski oraz zgodnie prawa i lewa strona .	Klaskał	0	Ind
Obecnie powiedzmy jednak , że właśnie ze względu na tę rolę papieża jego wybór oceniany jest powszechnie w Kościele katolickim jako proroczy , opatrznościowy .	powiedzmy	1	Imp
Aksinia nie złorzeczyła koniowi , że padł w środku jesiennej orki .	złorzeczyła	2	Ind
Usłyszał : Hedwiga , nie wtrącaj się .	wtrącaj	5	Imp
Weźmy na przykład pomnik w centrum wsi .	Weźmy	0	Imp
Czy uważa Pan , że dzisiejsi studenci już się nie buntują ?	buntują	10	Ind
Przynieś swoje rzeczy i też się wprowadź .	wprowadź	6	Imp
Mimo że prostowała m to w prasie , wiersz w pewnych kręgach nadal cieszy się powodzeniem .	prostowała	2	Ind
Broń cię , Panie Boże .	Broń	0	Imp
Zdaniem dyrekcji Centrum Kształcenia Ustawicznego w Krakowie , przestępstwa dopuścił się uczeń , który w wypracowaniu na temat : " Opisz w dowolnej formie swoją pasję " opisał siebie i nauczycielkę .	Opisz	20	Imp
- Niebawem wyruszymy .	wyruszymy	2	Ind
Na czele Kierownictwo Budowy sprawował pełnomocnik Ministerstwa Przemysłu i Handlu inż . Miszułowicz .	sprawował	4	Ind
- Biegnij , Jaskier !	Biegnij	1	Imp
- Ledwo się na nogach trzymasz !	trzymasz	5	Ind
- Kilka godzin spędziła m przed lustrem zastanawiając się , co włożyć .	spędziła	3	Ind
I szukaj korka w polu !	szukaj	1	Imp
- Zgadza się .	Zgadza	1	Ind
Więc zaczynam , on przerywa : - Co ty mówisz ?	przerywa	4	Ind
Pamiętał teraz także , że Rychezę polecili mu poniekąd margrabiowie .	Pamiętał	0	Ind
Czeka nas jeszcze kilka zimnych dni .	Czeka	0	Ind
- Ale - spojrzał się , zachichotał , szturchnął - nieraz coś się chlapnie , niby że tak się wymknie , a potem , tego , są świadkowie .	chlapnie	13	Ind
– jedziemy . .	jedziemy	1	Ind
Decyzja zapadnie dzisiaj rano .	zapadnie	1	Ind
Zapisał to wszystko po niemiecku i przeczytał mi na głos .	Zapisał	0	Ind
Dwóch zaabsorbowało jubilera rozmową o biżuterii , a w tym czasie pozostała dwójka zagarnęła z szuflady banknoty o łącznej wartości ok . 70 tys . zł .	zaabsorbowało	1	Ind
Nie puszczała mnie .	puszczała	1	Ind
Polska powoli suszyła się po wielkiej powodzi , a uwaga Czytelników kierowała się na politykę .	kierowała	11	Ind
Dwie trzecie badanych spodziewają się , że " zaleją nas tańsze artykuły spożywcze , a rolnictwo padnie " .	zaleją	8	Ind
Nie kochał , skoro zaufania nie miał .	kochał	1	Ind
15 lat temu cosa nostra zgładziła swoich największych wrogów - dwóch sędziów z Palermo , którzy ośmielili się wypowiedzieć jej wojnę .	ośmielili	16	Ind
I mruczę sobie pobożnie : - Skubże , skub , Piotrusiu , bo wieczór przyjdą cię podoić ! . . .	skub	8	Imp
Chłopcy zrobili swoje .	zrobili	1	Ind
Pech chciał , że w czasie skoku ukruszył się kamień , na którym stał , przez co stracił równowagę .	ukruszył	7	Ind
Nabraliśmy charakteru , hartu ducha i tempa - obwieścił premier , podsumowując 100 dni rządu .	obwieścił	8	Ind
Wilhelm wygrzebywał brud zza paznokci .	wygrzebywał	1	Ind
Żyjemy w XXI wieku – klientów nie widzę na oczy , kontaktujemy się mailami , przez gadu - gadu i esemesami .	Żyjemy	0	Ind
Ogień trzaskał w ciszy , dzieci wybiegły na dwór przestraszone .	trzaskał	1	Ind
Często mdlała i padała na podłogę , płacząc histerycznie .	mdlała	1	Ind
Pod żadnym pozorem nie zgadzaj się na pozostanie w domu w przyszły weekend .	zgadzaj	4	Imp
Uważałem za stosowne wtrącić się do rozmowy : - Iwona , zapominasz , że ja mogę cię wyrzucić .	zapominasz	11	Ind
Wpełzł przez tunel do plastykowego kombinezonu i nachylił się nad pacjentem .	nachylił	7	Ind
Wolała by wszywkę .	Wolała	0	Ind
- Wyśpijcie się i przyjdźcie rano .	Wyśpijcie	1	Imp
Z różnych względów obiekty te często stoją bezużytecznie , niszczeją , a przecież tak niewiele trzeba , ażeby temu zapobiec - powiedział prezes Zarządu Rejonowego LOK w Węgrowie , Leszek Knap .	niszczeją	9	Ind
Owinął em się w koce i zasnął em .	Owinął	0	Ind
Inni wolą kasę - chlapną białą farbą po ścianach , włączą ultrafiolet w kiblu i wynajmują panienkę do gięcia się na rurze .	włączą	10	Ind
Groził , że się podpali .	podpali	4	Ind
– Zawrzyj pokój z samą sobą .	Zawrzyj	1	Imp
- Życie ci obrzydło ? !	obrzydło	3	Ind
Tu jest strefa przygraniczna , sami rozumiecie .	rozumiecie	6	Ind
Grozi , że odbierze nam część pieniędzy .	odbierze	3	Ind
No , bywaj .	bywaj	2	Imp
W miarę jak przybywa nam lat , zaczynamy doceniać w przyjaciołach nieco inne cechy - z tolerancją i akceptacją nas samych , z wszystkimi wadami , przywarami i dziwactwami , jakimi obdarzył nas los .	zaczynamy	7	Ind
Nie psuj im humorów .	psuj	1	Imp
Pomyślał em , że nie chciał by m być w skórze jej męża .	Pomyślał	0	Ind
Weźmy na przykład pomnik w centrum wsi .	Weźmy	0	Imp
- Spodziewał em się , że tak odpowiesz , Sarai !	Spodziewał	1	Ind
Wozili się trochę po mieście .	Wozili	0	Ind
Zaprzestań dążenia .	Zaprzestań	0	Imp
W czasie pozorowanych działań bojowych jednostki z pozycji obronnych dokonają przegrupowania , aby po sforsowaniu szerokiej przeszkody wodnej wyjść na nowe rubieże aktywnych działań zaczepnych .	dokonają	9	Ind
Ponadto już sama informacja , że Nomura będzie skupował akcje na giełdzie , może wpływać na ich kurs .	skupował	8	Ind
Ale się rozmyśliła .	rozmyśliła	2	Ind
Zastanówmy się nad tym jeszcze przez chwilę .	Zastanówmy	0	Imp
Przepraszam , ale pan wygłasza za długie przemówienie .	wygłasza	4	Ind
- Myślisz , że pomagam Millerowi ?	Myślisz	1	Ind
Ja mówię : bójmy się , bo to tworzy pewien klimat , że coś jest nie w porządku , że to dziwne , podejrzane środowisko te media .	bójmy	3	Imp
Przywitajmy ją serdecznie .	Przywitajmy	0	Imp
Rozmawiam , dyscyplinuję .	dyscyplinuję	2	Ind
Przekonaj się , jak niektóre olejki wpływają na organizm i jakie dolegliwości leczą .	Przekonaj	0	Imp
Pana to irytuje ?	irytuje	2	Ind
Schmidt skinął na towarzysza .	skinął	1	Ind
Dziennik " Süddeutsche Zeitung '' opublikował wyniki ankiety , jaką wypełnili uczniowie szkoły realnej z Neusterlitz w Meklemburgii - Przedpomorzu .	opublikował	5	Ind
Te uczucia - znaki ostrzegawcze powinny uczulić was na sytuacje , w których potrzebujecie wyznaczenia granic między sobą a otoczeniem .	potrzebujecie	13	Ind
Dziewczynka podtrzymuje chłopca , nurkując z nim pod wodą .	podtrzymuje	1	Ind
Chodź , poszukamy czegoś na Trzynachę .	poszukamy	2	Ind
Skąd się wzięło Halloween ?	wzięło	2	Ind
– Tato , to ci się nie uda . – Córka syknęła konspiracyjnie zza kamery . – Daj sobie spokój , kup może inną paczkę albo co .	kup	21	Imp
Takie parlamentarne metody nie odpowiadają mi , rozumiecie ?	rozumiecie	7	Ind
Myślę , że jeśli zastosujemy te przepisy prawidłowo , nie będziemy skazani na warunki w stylu amerykańskim .	zastosujemy	4	Ind
Porównajmy cyfry skupu I kwartału 1949 roku oraz I kwartału 1950 r .	Porównajmy	0	Imp
A jeśli przypadkowo będzie wiedział , to będzie rok repetował .	repetował	9	Ind
Skoncentruj się na przestrzeni pomiędzy dwoma profilami .	Skoncentruj	0	Imp
Patrzy , a tu we włosach łonowych roi się od weszek .	Patrzy	0	Ind
Przypominam jeszcze , że za parę minut przejedzie dwóch rowerzystów .	Przypominam	0	Ind
Zapisał to wszystko po niemiecku i przeczytał mi na głos .	przeczytał	6	Ind
Sędziował Paweł Ochab z Dębicy .	Sędziował	0	Ind
W tym roku Zagłębie też nie płaci .	płaci	6	Ind
Słuchajcie - w książce o kotach rasowych znalazłam kotka o identycznym umaszczeniu .	Słuchajcie	0	Imp
- Nie przesadzaj z tym zaufaniem .	przesadzaj	2	Imp
Przypomnij sobie .	Przypomnij	0	Imp
Sytuacja prawdopodobnie pozostanie zła – o ile nie pogorszy się – w roku 2009 , uderzając nie tylko w producentów samochodów , ale także w cały łańcuch dostaw przemysłu motoryzacyjnego .	pogorszy	8	Ind
Jeżeli jesteś za granicą , głosuj z ważnym polskim paszportem .	głosuj	5	Imp
Ani mu się śniło opowiadać o słonecznej wiośnie .	śniło	3	Ind
Później Dąbrowska podobno się na mnie obraziła , bo porównał em ją gdzieś z Orzeszkową .	porównał	9	Ind
W imieniu mojej grupy , wzywam wszystkie zainteresowane strony , aby okazały otwartość i spokój , aby stonowały swoje wypowiedzi i przystąpiły bezzwłocznie do konstruktywnego dialogu .	stonowały	17	Ind
Uciszcie się !	Uciszcie	0	Imp
Pomyślano również o indywidualnych turnusach .	Pomyślano	0	Ind
Idąc czuł , że wzbudza ciekawość , ludzie stawali , patrzyli za nim .	wzbudza	4	Ind
- Ja pana ojcu wręczała m kwiaty !	wręczała	4	Ind
- Wolała by m usłyszeć obietnicę .	Wolała	1	Ind
Dzieci zdrowe nauczą się tolerancji i zdobędą nowe doświadczenia , a sprawne inaczej poczują się potrzebne - mówi Helena Rogucka , dyrektor SP nr 35 w Białymstoku .	zdobędą	6	Ind
Wbrew zastojowi gospodarczemu Galicji i powszechnemu kryzysowi wartości pragnął rzucić , jak mówił Feldman , " granit pod tęczę " .	pragnął	8	Ind
– Wycelowała kluczami w koronkową bieliznę .	Wycelowała	1	Ind
Ludzie na trybunach obserwują trzy skaczące nad wodą orki .	obserwują	3	Ind
W Pikardii ewakuowano 700 osób , woda zalała ponad 1800 domów .	ewakuowano	2	Ind
W swoim Zeszycie wpisz tytuł " Jestem słoniem - skala zadowolenia z siebie " przerysuj skalę i po każdym etapie przypisz sobie odpowiednią ocenę .	przypisz	20	Imp
- Pisz , pisz .	Pisz	1	Imp
Tylko spróbuj !	spróbuj	1	Imp
- Piszcie zgodnie z sumieniem .	Piszcie	1	Imp
Zamiast trzystu dwudziestu ośmiu obiektów elektryfikacyjnych , załoga wybudowała trzysta sześćdziesiąt cztery .	wybudowała	8	Ind
Skądś zeskoczył .	zeskoczył	1	Ind
A , pozostali przy życiu osadnicy karczowali sobie ile popadło , zagarniali też coraz to większe obszary .	popadło	9	Ind
Przeanalizuj w ten sam sposób trudne dla ciebie momenty z dzieckiem .	Przeanalizuj	0	Imp
" Od razu widać , że byłeś w angielskim internacie " - chichotała Andrea , a on krzywił się , jakby naprawdę ukruszył mu się ząb .	chichotała	12	Ind
Stań prosto , ze stopami rozstawionymi na szerokość ramion , wyprostuj plecy i wciągnij brzuch .	wciągnij	13	Imp
Swoim stwierdzeniem - " jeśli są Rządy w Europie , które wspierają swój przemysł motoryzacyjny czy banki , to my musimy mieć prawo do ratowania Polskich Stoczni " - pan Bielan bardzo się spóźnił .	spóźnił	33	Ind
Zanurz się we mnie . . .	Zanurz	0	Imp
W lutym skradziono ją prawdziwemu funkcjonariuszowi w Warszawie .	skradziono	2	Ind
- Chcę , żebyśmy wpoili dzieciom zasadę Małego Księcia o tym , że kiedy się rano obudzisz , posprzątaj swoją planetę - mówi Zyrianow .	posprzątaj	18	Imp
W ciągu następnych czterech lat konsulowie europejscy depeszowali z Kairu niedokładne wiadomości o rzeziach , jakich oddziały muzułmańskie dokonywały na ciemnoskórej ludności Sudanu .	depeszowali	7	Ind
Wyciera twarz , otwiera apteczkę , szuka , " Nie ma plastra " , myśli .	Wyciera	0	Ind
Bywało bardzo różnie .	Bywało	0	Ind
Wszystkich , którzy będą wodę chłeptać językiem , podobnie jak pies , pozostawisz po jednej stronie , a tych wszystkich , którzy przy piciu uklękną , pozostawisz po drugiej stronie .	pozostawisz	26	Ind
Załóżmy , że nie mamy pewności , że prawdopodobieństwo wdychania toksycznych oparów przez osoby wynosi 5 % .	Załóżmy	0	Imp
Przede wszystkim tekst ustanawia wspólny zbiór praw dla wszystkich pracowników z państw trzecich , którzy legalnie przebywają i pracują na obszarze Unii Europejskiej .	ustanawia	3	Ind
Ta propozycja , która została złożona - nazwijmy to propozycją w cudzysłowie - zakładam oczywiście jej prawdziwość , zastrzegam się , bo to jest informacja prasowa . . .	nazwijmy	7	Imp
I taki poczciwy Władek odmawia jej inteligencji , bo takich jak ona są przecie tysiące i setki tysięcy , a wykształceniem grubo przewyższa wielu mężczyzn , uważających się za skarbnicę mądrości .	przewyższa	22	Ind
Uważajcie , czy nie zmienia koloru .	Uważajcie	0	Imp
Tyle tylko , że chorujemy mniej , żyjemy dłużej i ta starość nie jest na ogół taka " bolesna " jak mięsożernych .	chorujemy	4	Ind
- Potrzebuję pracy - wyjaśniam mu - nawet tej najgorszej .	wyjaśniam	4	Ind
- Mógł by ś obrać ?	Mógł	1	Ind
Tato , pozwól mi !	pozwól	2	Imp
Niektórzy nawet płakali .	płakali	2	Ind
Powiedzieli mi , że ojciec popełnił samobójstwo .	Powiedzieli	0	Ind
- Nalej po kieliszku .	Nalej	1	Imp
Nikt z ludzi nie ucierpiał podczas wichury .	ucierpiał	4	Ind
Rada Nadzorcza towarzystwa na wczorajszym posiedzeniu pominęła sprawy personalne .	pominęła	6	Ind
Zakończył się VIII Raciborski Rajd Rowerowy Środowisk Trzeźwościowych Dookoła Polski .	Zakończył	0	Ind
Andrzej : Wojtku , co robisz w tej szczęśliwej chwili , gdy żona wraz z dzieckiem wyjeżdża na urlop , zostawiając cię samego w domu ?	wyjeżdża	16	Ind
Pyta , czy długo będziemy czekać .	Pyta	0	Ind
Losem tej matki i jej dziecka zainteresowały się nawet władze USA .	zainteresowały	6	Ind
Nie czekajcie na mnie i nie oglądajcie się .	czekajcie	1	Imp
Pokrzepiła mnie tym na duchu .	Pokrzepiła	0	Ind
Pozmywaj i ogarnij kuchnię .	Pozmywaj	0	Imp
Wcześniej zarówno SLD , jak i PSL wysuwały istotne zastrzeżenia wobec zbliżenia Polski z NATO .	wysuwały	7	Ind
A teraz posłuchaj , co ci powiem .	posłuchaj	2	Imp
W gabinecie sadza na fotelu , siada obok i w obecności rodziców streszcza mu , co jej opowiedzieli .	streszcza	12	Ind
Nagle zauważam , że balkon chwieje się i pęka .	zauważam	1	Ind
- Nie odchodź !	odchodź	2	Imp
Przeziębicie się !	Przeziębicie	0	Ind
Stań prosto , ze stopami rozstawionymi na szerokość ramion , wyprostuj plecy i wciągnij brzuch .	wciągnij	13	Imp
Podzielcie się z nami swoimi smutkami i radościami .	Podzielcie	0	Imp
Kto wygrał wybory samorządowe ?	wygrał	1	Ind
Kto , gdzie i jaką komunię wyprawia , zależy od zasobności portfela , ale pod kościołem sąsiedzi też składają życzenia dzieciakom i dają im komunijne pamiątki .	dają	22	Ind
– Zachowywał em się spokojnie .	Zachowywał	1	Ind
Orzechowe oczy garncarza wpatrzyły się badawczo w twarz Kaliasa .	wpatrzyły	3	Ind
Kupowano i rozdawano maski , warszawskie ślicznotki spacerowały z maskami przytroczonymi do torebek , amanci komplementowali panienki : - Ach , jak ci w tej maseczce do twarzy . . .	komplementowali	15	Ind
" Odczytaj " .	Odczytaj	1	Imp
- Żegnaj , Alicjo ! - usłyszała , a potem już tylko dobiegały ją chrzęsty i świsty , jakby ktoś dmuchał z bliska do mikrofonu .	Żegnaj	1	Imp
Kochanie , wyśmiała by m takiego faceta . . .	wyśmiała	2	Ind
Pomódlcie się ze mną .	Pomódlcie	0	Imp
Służby prasowe prezydenta poinformowały jednocześnie , że odwołano wszystkie spotkania prezydenta , zaplanowane na przyszły tydzień .	odwołano	7	Ind
Tamten obruszył się .	obruszył	1	Ind
Ciągnął je ukryty wewnątrz drewnianego pudła muł .	Ciągnął	0	Ind
Cukier fermentuje nie w alkohol , lecz w kwasy glukonowe .	fermentuje	1	Ind
Wystawa w Tel Awiwie przyciągnęła ponad 5 tysięcy zwiedzających , pokazano ją we wszystkich izraelskich telewizjach , pisały o niej wszystkie gazety .	pisały	17	Ind
Kamienna płyta wyrwała się z podłogi , wśród trzasków i zgrzytów zmieniła w chmurę żwiru i pomknęła ku mnie niczym ładunek śrutu .	pomknęła	16	Ind
- Wstydź się , Zuzanno , tak kłamać , zapłacił ci za Jadzię .	Wstydź	1	Imp
Nie popisywała się przecież .	popisywała	1	Ind
Otyński jeszcze raz przebiegł wzrokiem pokój .	przebiegł	3	Ind
Na Siemiradzkiego wybrzydzali krytycy , ale publiczność uwielbiała jego obrazy .	wybrzydzali	2	Ind
Dzisiaj telefon mnie wyprzedził , zaczął terkotać głośno .	wyprzedził	3	Ind
Linda sprawnie nakrywała do stołu , a Blondyn nie spuszczał z oczu jej wąskich stóp opatulonych w grube skarpety .	spuszczał	9	Ind
General Motors wprowadza Chevroleta , a francuskie Renault reaktywuje na europejskich rynkach markę Dacia .	reaktywuje	8	Ind
Patrzył em , jak zasnuwały horyzont .	zasnuwały	4	Ind
I nie ma co się na to obrażać , albowiem Sejm również może utajnić swe obrady , zdarzało się tak już zresztą .	zdarzało	17	Ind
Teraz powiedział tak normalnie : “ pij na zdrowie ” , a potem sam wypił .	pij	6	Imp
Przyjrzyj się fotografiom i rysunkom w podręczniku przedstawiającym przykład krajobrazu śródziemnomorskiego .	Przyjrzyj	0	Imp
Zagrzebali się w słomę .	Zagrzebali	0	Ind
Weźmiemy się za to , ale trzeba zacząć od niego . . .	Weźmiemy	0	Ind
Przy pomocy inwestora firma uniezależniła się od dostawców drutu .	uniezależniła	4	Ind
No to usiądź swobodnie przed komputerem , zrelaksuj się , uruchom TAGa i napisz : Miota mną ogromny niepokój .	uruchom	10	Imp
Pytanie : Panie Prezydencie , ponieważ będzie to rozmowa , której nie było , więc porozmawiajmy może nieszczerze ?	porozmawiajmy	15	Imp
Rzym ulegał druzgocącym najazdom , tracił znaczenie gospodarcze , tracił swój dawny blask i bogactwa , zamierał jako centrum świata antycznego .	zamierał	16	Ind
Odpowiedź osoby B brzmi : - Też tak myślę o sobie .	brzmi	3	Ind
Co rusz musiał przerywać , cucić omdlałą z duchoty i kolejkowego wysiłku kandydatkę .	rusz	1	Imp
Robią to dziewiarze na dziewiarskich maszynach .	Robią	0	Ind
Zaniżają lub w ogóle nie wypłacają ekwiwalentów za niewykorzystane urlopy .	Zaniżają	0	Ind
- Świeżo dostałem wyniki kontroli w jednej z dużych spółek skarbu państwa - informował prezes NIK Janusz Wojciechowski .	informował	13	Ind
Zwielokrotniało to o taki czynnik prędkość dostępu do pamięci RAM karty , bez konieczności stosowania bardzo drogich dwuportowych układów VRAM .	Zwielokrotniało	0	Ind
Siedział odchylony za swoim biurkiem z taką miną , jakby dowodził całą policją , Interpolem i FBI na dodatek i delektował się kawą .	dowodził	10	Ind
Nie martw się , już przechodzę .	martw	1	Imp
Trzech sprytnych chłopców szukało nawet syrenki w przedszkolnym akwarium .	szukało	3	Ind
Jeśli nie chcesz biegać , pływać czy grać w piłkę - umyj okna , skoś trawę na działce , posprzątaj piwnicę .	umyj	11	Imp
Ale nie obawiaj się .	obawiaj	2	Imp
Krótki płomyk radości rozjaśnił szare myśli Tumiłowa , ale zaraz przygasł .	przygasł	10	Ind
Gizela do Tomka : - Nie kop , synku , tak jak ciebie kopano .	kop	6	Imp
Skończ już z tymi wspomnieniami , Siostro !	Skończ	0	Imp
No to usiądź swobodnie przed komputerem , zrelaksuj się , uruchom TAGa i napisz : Miota mną ogromny niepokój .	napisz	13	Imp
Naucz się czytać albo skończ " dyskutować " .	Naucz	0	Imp
De Berle wątpił .	wątpił	2	Ind
Tylko nie skacz .	skacz	2	Imp
Urządzimy też prywatny gabinet .	Urządzimy	0	Ind
Kaczka bez brata nikogo nie ugryzie w łydkę .	ugryzie	5	Ind
Funkcjonariusze apelują do mieszkanek Kwidzyna , aby w najbliższym czasie unikały ciemnych miejsc .	unikały	10	Ind
Uczepił się wśród tobołków Żuraw , przysiadł na drążku Pantera - woźnica , parsknęła ochoczo klacz , zabamboliła Hatora , i tabor ruszył .	przysiadł	6	Ind
Podczas pogrzebów nie biją dzwony .	biją	3	Ind
Brzmi nieźle .	Brzmi	0	Ind
Spodziewa się Pan , że wyższy wzrost gospodarczy przyniesie wyższe dochody z podatków ?	Spodziewa	0	Ind
W ciągu ostatnich pięciu lat liczba studiujących podwoiła się , niegdyś kameralne placówki akademickie napęczniały , zmieniła się też mentalność i oczekiwania studiujących .	podwoiła	7	Ind
Przywiózł różności potrzebne ( pasty do zębów , kremy do golenia , mydła ) i niby całkiem zbędne , przyjemne drobiazgi ( to , co lubię , papeterię , ładne koperty ) .	Przywiózł	0	Ind
- Uspokój się , Rex , do nogi pies ! - zawołała Alina .	Uspokój	1	Imp
Zanim wiązanki kwiatów przykryły mogiłę , słowa modlitwy prowadzonej przez ks . Pawła Dorucha splatały się z wyrazami bólu i wspomnieniami przyjaciół .	splatały	14	Ind
- Nie poślubię mężczyzny , o którym wiem , że nigdy go nie pokocham , wszystko jedno czy będzie to śmieciarz , czy król Anglii - wyznała w jednym z wywiadów .	wyznała	26	Ind
Dominika krzyczy , zatrzymaj się , Edyta wymiotuje na tylnym siedzeniu , a Jagienka śpiewa , wyrwij murom zęby krat .	wyrwij	16	Imp
Radni poruszyli problem złych nawierzchni dróg , domagając się ich remontu .	poruszyli	1	Ind
Zrób kolację .	Zrób	0	Imp
„ Powtórz wszystko ” .	Powtórz	1	Imp
Załóżmy , że jesteś złośnik i awanturnik .	Załóżmy	0	Imp
Od tego czasu gnębiony przez feudałów lud rumuński niejednokrotnie chwytał za broń .	chwytał	9	Ind
W ostateczności wyjdę na taras .	wyjdę	2	Ind
Bułgaria podejmuje natychmiastowe środki w celu zastosowania się do niniejszej decyzji , a następnie podaje je do wiadomości publicznej .	podejmuje	1	Ind
Jak to skończysz , spróbuj Stendhala i Buddenbrooków Tomasza Manna . . .	spróbuj	4	Imp
Stań prosto , ze stopami rozstawionymi na szerokość ramion , wyprostuj plecy i wciągnij brzuch .	wyprostuj	10	Imp
Kiedy uznaje , że za głęboko wchodzi w temat , sam gani się słowami : " Nie teoretyzuj , docent " .	teoretyzuj	17	Imp
- Uspokój się , Władeczku .	Uspokój	1	Imp
Wyemigrował w 1984 r.	Wyemigrował	0	Ind
Jest ona społeczną gospodarką rynkową , co oznacza , że łączymy kwestie społeczne z konkurencyjnością gospodarczą .	łączymy	10	Ind
" Obok bezspornych zalet miał jeszcze jedną przykrą wadę , której - ani rusz - pozbyć się nie potrafił : podejrzliwość " - napisał Edward Kozikowski .	rusz	13	Imp
U pacjentów z grupy leczonej produktem leczniczym Myozyme wykazano wydłużony czas przeżycia w porównaniu z pacjentami z nieleczonej kohorty historycznej ( patrz Tabela 2 ) .	patrz	21	Imp
Pokój , do którego zaprowadzono gości , miał zaokrąglone wszystkie ściany .	zaprowadzono	4	Ind
Zawierała kilka wycinków , ale podawały jedynie jej życiorys i dokonania jako agentki angielskich służb specjalnych .	Zawierała	0	Ind
– Przestańcie !	Przestańcie	1	Imp
- Pamiętamy o niej , darzymy zaufaniem i sympatią - mówi burmistrz Lidia Grabowska .	darzymy	5	Ind
– dlaczego tego już nie produkują ?	produkują	5	Ind
Grace zerwała się , zgarnęła ręką włosy .	zerwała	1	Ind
Od zbłąkanych misjonarzy uchroń nas , Panie .	uchroń	3	Imp
Przerażeni , pytamy : " Dlaczego to zrobili ?	zrobili	7	Ind
Dziwi się , że ludzie ustępują mu z drogi , że go widzą . . .	ustępują	5	Ind
i ta mała Asia się pochorowała .	pochorowała	5	Ind
Podlewajcie kwiaty .	Podlewajcie	0	Imp
śmiej się jeśli chcesz , ale to jest cały film , scena po scenie .	śmiej	0	Imp
Myślę , że praktykuję jakiś świecki katolicyzm , który wymaga uświęcania pewnych aspektów codziennego życia	praktykuję	3	Ind
W wózku wiozła 13-miesięcznego synka .	wiozła	2	Ind
To ona zdecydowała za bohaterów o tym , gdzie rzuci ich los i jak wyglądać będzie ich dalsze życie .	rzuci	9	Ind
Arcybiskup Ochrydy przypisuje Borysowi także i inne cechy , które wzbogacają jego wizerunek .	przypisuje	2	Ind
– mącili śmy w bierki . .	mącili	1	Ind
Ognista łapa przejechała po głowie Liścia , ledwie zdołał jej umknąć .	przejechała	2	Ind
I upewnij się że jest wystarczająco dużo jedzenia dla wszystkich .	upewnij	1	Imp
Borowski : Jerzy Urban jest człowiekiem , który przecież nigdy nie rozstał się z polityką .	rozstał	11	Ind
Dwóch rudych chłopaków w okularach siłuje się , trzymając kije .	siłuje	5	Ind
- Połóżmy się tu i odpocznijmy .	odpocznijmy	5	Imp
To pleban kawęczyński jechał dwukonnym wózkiem do miasta .	jechał	3	Ind
Napijmy się .	Napijmy	0	Imp
Zapytaj Andrzeja .	Zapytaj	0	Imp
- Przykryj go .	Przykryj	1	Imp
Czy my żyjemy w jakimś kompletnie dzikim kraju ?	żyjemy	2	Ind
- Siadaj - zwrócił się do niego Pablo .	Siadaj	1	Imp
Wiem , co zrobię .	zrobię	3	Ind
Gwarantuje ona bardziej sprawiedliwe warunki dla muzyków sesyjnych w porównaniu z solistami .	Gwarantuje	0	Ind
Jeśli nie chcesz biegać , pływać czy grać w piłkę - umyj okna , skoś trawę na działce , posprzątaj piwnicę .	skoś	14	Imp
Ze zrozumieniem przyjmują lekkomyślny gest .	przyjmują	2	Ind
PiS z udziałem prezydenta , który przemawiał jak zdyscyplinowany członek partii swego brata , urządził nowy seans wyborczego strachu , aby poniżyć swoich sojuszników w LPR i Samoobronie .	przemawiał	6	Ind
Proponując Leppera na stanowisko wicepremiera , mogli się spodziewać , że sąd utrzyma wyrok skazujący , a mimo to go powołali - mówi prof . Jacek Wódz , socjolog .	powołali	20	Ind
Gadaj zaraz !	Gadaj	0	Imp
Rodzina Chmurów zręcznie z niej wybrnęła .	wybrnęła	5	Ind
Błagam , nie chorujcie i żadnych kłopotów nie miejcie !	miejcie	8	Imp
Za każdy samochód zabierali się od razu mechanicy , zmieniali koła , usuwali uszkodzenia powstałe w czasie forsownego treningu , wymieniali zdarte nakładki hamulcowe , regulowali silniki .	zabierali	3	Ind
Panią Minkiewiczową , która żyrowała za mnie weksel , bandyci zabili na Saskiej Kępie .	żyrowała	4	Ind
Także sklepy płytowe stają się gabinetami spoglądających na nas i na siebie nawzajem luster , z których każde szepcze : " zwierciadełko powiedz przecie . . . "	szepcze	18	Ind
- Spalą nas z pewnością - pomyślał Stokalski , zbliżając się ostrożnie do okna .	Spalą	1	Ind
Na tegorocznym inauguracyjnym balu tradycyjnego karnawału w Rio pracowały równolegle dwie komisje sędziowskie .	pracowały	8	Ind
Premier Jerzy Buzek zapewniał rolników : - Ochraniamy polski rynek przed nadmiernym importem , skupujemy płody rolne , bo chcemy , żeby wasza produkcja była opłacalna .	skupujemy	14	Ind
Kobiety milczały .	milczały	1	Ind
Dlaczego z tego nie skorzystał ?	skorzystał	4	Ind
Dodatkowo - wiedząc o wadze relacji ekonomicznych pomiędzy rodzicami a dziećmi - przyjrzyjmy się częstości występowania poszczególnych form pomocy finansowej , ofiarowywanej przez rodziców swym dzieciom .	przyjrzyjmy	12	Imp
Skoro jednak przeczytałem , że Instagram to ulubione miejsce nastolatków , którzy porzucili Facebooka i tam dzielą się swoim światem , a ja ten świat bardzo chciałem poznać , musiałem się dowiedzieć więcej .	dzielą	16	Ind
Gromadka wlokła się ospale jak niedobitki Konrada Wallenroda z wyprawy lub jak szczątki cesarskiej armii po przebrnięciu przez czarne topiele Berezyny .	wlokła	1	Ind
Bez swobodnego przepływu powietrza pod pokryciem akumuluje się wilgoć , powstająca wewnątrz budynku na przykład podczas gotowania .	akumuluje	6	Ind
Po wyjściu udręczonego chłopca uśmiech odleciał z oczów Adasia jak motyl , co przysiadł na nich tylko na chwilę .	przysiadł	13	Ind
I lepiej nie pytaj , co robię zimą .	pytaj	3	Imp
Piszemy potem w stukocie remontów , jakby szewcy Witkacego mnie odwiedzili .	Piszemy	0	Ind
W ogrodzie tego domu wznosiły się kiedyś pawilony obserwacyjne .	wznosiły	4	Ind
To dla niej , niby-pies , aportuje ulubioną myszkę , to na jej kolana gramoli się , kiedy nadchodzi godzina pieszczot .	gramoli	14	Ind
Przekazuj zasady prostym językiem .	Przekazuj	0	Imp
Nie ciekaj , latawcu , powtarza , chociaż wie , że córka nie lubi , gdy mówi z wiejska .	ciekaj	1	Imp
Pomodlę się za Polskę .	Pomodlę	0	Ind
W inscenizację umiejętnie wkomponowano wspomnienia nauczycieli i byłych uczniów .	wkomponowano	3	Ind
Wierzę , że wiersz potrafi skruszyć najbardziej kamienne serca – zaznaczyła .	zaznaczyła	10	Ind
- Krzaklewski - tłumaczy - zajęty polityką , wyizolował się z międzynarodowej działalności związkowej .	wyizolował	8	Ind
zaraz się ruszę . .	ruszę	2	Ind
Zajrzał do środka budynku i w rogu zauważył zwęglone zwłoki .	Zajrzał	0	Ind
- Wiara chomikowała rolki w tapczanach , szafach , w pawlaczach .	chomikowała	2	Ind
– nie dała ci ?	dała	2	Ind
Rano Odra nasyca niebieskawą mgłą ulice obu miast .	nasyca	2	Ind
Ta pozycja Neptuna może czynić cię wybuchowym w przypadku , gdy inni nie zgadzają się z twoimi nieugiętymi przekonaniami .	zgadzają	13	Ind
Przynajmniej teraz jest bliżej syna - dodaje Raja , pielęgniarka , która osobiście po zawale udzielała pomocy matce Juszczenki .	udzielała	15	Ind
Przed obiadem jego nastrój zmienił się o sto osiemdziesiąt stopni , a w brzuchu zalęgło się nieprzyjemne uczucie .	zalęgło	14	Ind
Łapcie się za portfele !	Łapcie	0	Imp
Coraz częściej ludzi trapi poczucie małej wartości , obawa , że nie uda się im zrobić odpowiedniego wrażenia na rzadko widywanych bliskich .	trapi	3	Ind
- Zagrajmy ! - Jacek nagle ożywił się i wyciągnął z kieszeni karty .	Zagrajmy	1	Imp
- Dostała m twój list , przyjedź , jeśli chcesz . . .	przyjedź	6	Imp
Nieustające relacje i komentarze dekonstruują brutalną fizyczność aktu terroru , przepuszczają ją przez kod kultury i wprowadzają do powszechnego obiegu symbolicznego .	dekonstruują	4	Ind
Nie opal sobie skrzydeł , zbyt wysoko wylatując pod słońce .	opal	1	Imp
Zakresy S oblicza się w taki sposób , że przyjmuje się jedynie występowanie tłuszczu obcego , jeżeli wartości graniczne wzoru indywidualnego są przekroczone ( patrz tabela 4 ) .	patrz	24	Imp
Hrabia przysiadł , bezmyślnie patrząc przed siebie .	przysiadł	1	Ind
Pracuje rzeczywiście tak ciężko , jak mówi Lamar ?	Pracuje	0	Ind
Biskup cofnął darowiznę i postanowiono zbudować domek , taki sam jak te , w jakich mieszkają tubylcy .	postanowiono	4	Ind
Komtur nachylił się niżej i słuchał .	słuchał	5	Ind
Zaprzeczył ruchem głowy .	Zaprzeczył	0	Ind
I szukaj korka w polu !	szukaj	1	Imp
- Nie powtarzaj mi tego , bo jeszcze zmienię zdanie .	powtarzaj	2	Imp
Nie chcemy , by ktokolwiek kwestionował twoją wartość jako pracownika z zupełnie innych powodów niż zawodowe .	kwestionował	5	Ind
Jeśli około dziesiątego ulegniesz wpływowi Urana i postawisz na eklektyczną mieszankę stylów , postąpisz rozważnie .	postawisz	7	Ind
To był inteligentny gość , wrażliwy , na zewnątrz wesoły i pogodny , ale w środku rozgrywał się w nim dramat - dodaje .	rozgrywał	16	Ind
Od wolnej woli wybaw nas , Panie .	wybaw	3	Imp
- Zdjęli śmy sztukę .	Zdjęli	1	Ind
Kiedy uśmiechnąłem się z ulgą i zaskoczeniem , człowieczek rozpromienił się z tą idealną szczerością , której się boimy i którą nazywamy prostotą .	boimy	18	Ind
Wy dwaj idziecie do Armington Road , schowajcie się na skrzyżowaniu z Stratford .	schowajcie	7	Imp
I opętał go !	opętał	1	Ind
Odzyskał je w 1919 .	Odzyskał	0	Ind
Cwałowali więc , a konie chrapały coraz silniej .	Cwałowali	0	Ind
Państwa Członkowskie powiadamiają Komisję przed dniem 1 kwietnia 1993 r . o środkach przyjętych w celu zastosowania niniejszego rozporządzenia .	powiadamiają	2	Ind
Nie chodzi o to , byś zrezygnowała z ambicji , marzeń i aktywnego życia , rzuciła wszystko i resztę życia spędziła w komie przed telewizorem .	spędziła	20	Ind
Realizuj je stopniowo w chwilach , gdy możesz się skupić na sobie .	Realizuj	0	Imp
Adam wygrał ostatni etap , w lutym .	wygrał	1	Ind
– czekaj .	czekaj	1	Imp
Niemal przez godzinę omawiał sytuację wojenną : odpowiedzialność za klęskę zrzucał na dowódców wojskowych .	zrzucał	10	Ind
Jannie , nie wtrącaj się do tego .	wtrącaj	3	Imp
Popieram wnioski sprawozdawcy dotyczące reorganizacji Parlamentu Europejskiego i mam nadzieję , że ustalenia grupy roboczej do spraw reformy parlamentarnej odzwierciedlą rozszerzoną rolę Parlamentu , jaką przewidziano w traktacie .	odzwierciedlą	19	Ind
Murawa była śliska i sprawiała dużo kłopotów zawodnikom .	sprawiała	4	Ind
Powycinajmy im nerki , sprzedajmy je na czarnym rynku	Powycinajmy	0	Imp
Za najważniejszych nazistowskich zbrodniarzy powszechnie uznawano Hitlera , Himmlera i Goebbelsa .	uznawano	5	Ind
Brzdąknij trochę bliżej , w tym miejscu .	Brzdąknij	0	Imp
Dawniej uczyliśmy dzieci , że szlachta rozpijała chłopów samogonem .	rozpijała	6	Ind
- Jeszcze nigdy na msze nie przychodziło tyle ludzi - z płaczem w oczach oznajmiali księża .	przychodziło	6	Ind
Ludzie spędzają czas na plaży w słoneczny dzień .	spędzają	1	Ind
W sprasowanych autach zginęły cztery osoby .	zginęły	3	Ind
Teraz umocnią się na rynku .	umocnią	1	Ind
Wzdłuż marszruty placówki angielskie podawały sobie z rąk do rąk Krystynę , owianą sławą węgierskich dokonań ; Andrzeja zaś traktowano jako " księcia małżonka " .	traktowano	19	Ind
Weźmy dzieje sztuki tego okresu .	Weźmy	0	Imp
Przyjdzie chwila gdy de Gaulle'a zabraknie .	Przyjdzie	0	Ind
Trillian obdarzyła go chłodnym uśmiechem i odwróciła głowę do drzwi .	obdarzyła	1	Ind
Podeszły do lady i zaczęły zabierać kosmetyki i odzież .	Podeszły	0	Ind
Rozładował ją na brzegu , a ona cisnęła naboje do wody .	cisnęła	7	Ind
Kiedy poczuła pod palcami włosy , wpiła się w nie mocno i szarpnęła .	poczuła	1	Ind
- Weźmiesz mu szczyptę , jeżeli usnął .	Weźmiesz	1	Ind
A przyjrzyj się treści katechezy w Polsce międzywojennej .	przyjrzyj	1	Imp
Zastanów się nad tym !	Zastanów	0	Imp
Pora rozstać się z Hehem i chłopakami .	Pora	0	Ind
– Kochasz kogoś ? – usłyszał ostry niczym brzytwa głos Lisiego Kołnierza .	Kochasz	1	Ind
Choć dziecko złożyło na policji zeznania , sprawców nie zatrzymano .	zatrzymano	9	Ind
Ostatnie tony koncertu umilkły .	umilkły	3	Ind
Ucierpi niezawisłość sędziowska ?	Ucierpi	0	Ind
Ministerstwo Finansów zaproponowało w założeniach do przyszłorocznego budżetu radykalne oszczędności , aby zmniejszyć jego deficyt do 35 mld zł .	zaproponowało	2	Ind
Następnie podgrzewamy i przesączamy przez gęste sito .	przesączamy	3	Ind
nie uświadomili kurde . .	uświadomili	1	Ind
Proszę was , zachęcajcie innych , by go obejrzeli - prosił nowotarżan Krzysztof Zanussi .	zachęcajcie	3	Imp
Nie pozwolę ci na to !	pozwolę	1	Ind
Kupmy jej srebrne .	Kupmy	0	Imp
Próbowano je reanimować wyścigami długodystansowymi na torze , ale okazało się , że bez takich Pucharów jak niegdyś Fiata Cinquecento , Renaulta Megane czy ostatnio Alfy Romeo 156 trudno utrzymać popularność .	Próbowano	0	Ind
Nawet od kiedy w 1990 roku zaczęły się mną interesować zagraniczne kluby zawodowe , moje ambicje sięgały najwyżej ligi niemieckiej .	sięgały	16	Ind
Zamiast gdakać , również sprawdź czy owi cokolwiek dostali .	sprawdź	4	Imp
Dobrze wróży na przyszłość również i to , że do partnerstwa przymierzają się kolejne banki i towarzystwa zarówno majątkowe , jak i życiowe .	wróży	1	Ind
Podajemy w miseczkach lub na talerzach .	Podajemy	0	Ind
zynajmniej starajmy się by ten nastrój pogodowy nie udzielał się , dlatego należy go celebrować sporą dawką radości .	starajmy	1	Imp
Na szczęście w piecu już wygasło .	wygasło	5	Ind
Jeżeli się uprę , będzie płakać .	uprę	2	Ind
Zerkała na czarno - biały obraz i pogryzała słone paluszki .	pogryzała	7	Ind
Podaje kartę .	Podaje	0	Ind
Scharakteryzuj je dokładnie " oraz " Opisz , jakimi mechanizmami obronnymi : a ) posługiwałeś się pijąc alkohol , b ) posługujesz się teraz ( będąc tu w oddziale ) " .	Scharakteryzuj	0	Imp
Baron ocknął się z zamyślenia - jego czarne , niespokojne oczy na krótko spoczęły na twarzy Romana .	ocknął	1	Ind
Nasze apele ginęły w wiecowym zgiełku .	ginęły	2	Ind
Oj durna ty , durna - przywołała się do porządku i potruchtała do pokoju ordynatora .	potruchtała	11	Ind
Zerknęła w lustro , obciągnęła na sobie sweter w czerwone skrzydła . . .	obciągnęła	4	Ind
A on by podglądał i podsłuchiwał ?	podsłuchiwał	5	Ind
Ty przejrzyj na oczy .	przejrzyj	1	Imp
Bóg zesłał Anioła , by go zatrzymać w ostatniej minucie .	zesłał	1	Ind
Otwierały się przed nami największe tajemnice wszechświata .	Otwierały	0	Ind
Następuje ciąg dalszy Mszy świętej .	Następuje	0	Ind
Kandia , bo tak nazywali to miasto , przez całe wieki uchodziła za perłę weneckiego berła .	nazywali	4	Ind
- To wypracowuje się na codziennych , mozolnych próbach .	wypracowuje	2	Ind
Może mu zazdrościł .	zazdrościł	2	Ind
Bank przeznacza na stypendia w wysokości do 100000 euro rocznie przez okres do trzech lat w wymienionych kategoriach .	przeznacza	1	Ind
A jak wyjeżdżają na weekend . . . nastawiają setki alarmów .	wyjeżdżają	2	Ind
- Za jakąś kuszą się lepiej rozejrzyj .	rozejrzyj	6	Imp
Obecnie mówimy czasem , że są to bryły platońskie .	mówimy	1	Ind
Przypomnę , że skecz Tuwima i Słonimskiego o Einsteinie , zaczynający się od : " Bolszewizujący żydek z Pragi czeskiej . . . " całkiem dokładnie przywołuje podstawy teorii względności .	przywołuje	26	Ind
- Z naszych danych wynika , że przybywa kontraktów denominowanych w złotych .	przybywa	7	Ind
Uczepił się wśród tobołków Żuraw , przysiadł na drążku Pantera - woźnica , parsknęła ochoczo klacz , zabamboliła Hatora , i tabor ruszył .	zabamboliła	17	Ind
- Obierz kilka kartofli .	Obierz	1	Imp
W Olsztynie pod drzwiami szpitalnymi zmarły ostatnio dwie osoby .	zmarły	5	Ind
Wygłodzona , śmiertelnie wystraszona kobieta godziła się na wszystko .	godziła	5	Ind
– pokaż . .	pokaż	1	Imp
Trzymajcie się !	Trzymajcie	0	Imp
Ratuj się , kto może .	Ratuj	0	Imp
Popatrz , jak inni poruszają ustami .	Popatrz	0	Imp
Przychodziła do mnie , żeby od niego uciec .	Przychodziła	0	Ind
Nie dostrzegł jej za pierwszym razem .	dostrzegł	1	Ind
- Pawle , nie jedź do Jerozolimy !	jedź	4	Imp
Prokuratorzy kazali mu przyjść kiedy indziej .	kazali	1	Ind
Nigdy nie wystąpił w reprezentacji Rumunii .	wystąpił	2	Ind
Uczył się w Liceum Technik Plastycznych w Zakopanem prowadzonym przez Antoniego Kenara .	Uczył	0	Ind
Gładkie oblicze strzygonia stężało , alabastrowa skóra napięła się , jakby miała zaraz pęknąć .	stężało	3	Ind
Czyżby jakieś złe moce zawisły nie tylko nad publicznymi mediami , ale również nad Warszawiakami ?	zawisły	4	Ind
Sterylizator dezynfekuje butelki parą , niszcząc zarazki i bakterie , może dzięki niemu sterylizować także małe zabawki .	dezynfekuje	1	Ind
Doświadczenie zawodowe zdobyła pracując w teatrze i telewizji w Polsce i na Ukrainie .	zdobyła	2	Ind
Poczujesz się fantastycznie i przyciągniesz do siebie sojuszników równie odważnych jak ty sama .	Poczujesz	0	Ind
- Zostaw babcię w spokoju , nie widzisz , że to jeszcze panna .	Zostaw	1	Imp
Przypuśćmy , że zgodziłabym się przeprowadzić do Indii .	Przypuśćmy	0	Imp
- Mam - odpowiedziała z radosną gotowością , która aż go dławiła .	odpowiedziała	3	Ind
- To mi wygląda na prawdziwą operację wojskową - mruknął Daniel i zerknął pytająco na Wrońskiego .	zerknął	12	Ind
Jej wypowiedź brzmi w jego uszach oskarżycielsko , krytycznie , pretensjonalnie .	brzmi	2	Ind
Za taniochę ludek chętnie drogo płaci .	płaci	5	Ind
Weźmy jednak sprawę autoreklamy : Johnson zwraca uwagę na tak pozornie nieważne akcesorium jak strój poniektórych " nauczycieli ludzkości " .	Weźmy	0	Imp
- Pozwólmy mu trochę pomyśleć nad swoimi manierami .	Pozwólmy	1	Imp
Przytul się mocno I podnieś głowę Patrząc w ich oczy Moim spokojem .	podnieś	4	Imp
Jest istotne , aby rozwiązania , które opracowujemy i nad którymi państwo pracują w celu wydobycia nas z tego kryzysu gospodarczego wzmocniły naszą społeczną gospodarkę rynkową .	opracowujemy	7	Ind
Działajmy nocą , najlepiej na kolanach .	Działajmy	0	Imp
I podobno wcale ich nie dogonili .	dogonili	5	Ind
Przyznaję , że i ja od czasu do czasu zazdrościłam przyjaciółkom , które wieczorami oglądały melodramaty .	Przyznaję	0	Ind
Zobaczcie , jakiego ja mam zawsze koło siebie .	Zobaczcie	0	Imp
Nazirejczycy nie pili wina , nie strzygli włosów , nie spożywali rytualnie nieczystych potraw i nie mogli dotykać zmarłych .	spożywali	10	Ind
Klara umilkł? . . .	umilkł?	1	Ind
Po przewrocie władzę w Algierii objęła Rada Rewolucyjna .	objęła	5	Ind
- Chodźmy tam !	Chodźmy	1	Imp
Sukcesywnie dyskredytujesz się jako adwersarz , ale jak chcesz , twój wybór .	dyskredytujesz	1	Ind
Stała tak długą chwilę , silnik głośno pracował , jakby samochód już się bardzo zmęczył .	zmęczył	14	Ind
Oferował swoje usługi .	Oferował	0	Ind
Poinformuj służbę , że jeśli nie przestaną rozpowiadać ludziom , co tu się przydarzyło , nie będą musieli starać się o zwolnienie .	Poinformuj	0	Imp
słuchaj a masz tą książkę tu może ?	słuchaj	0	Imp
Jak długo Szczuka zabawi w Ostrowcu ?	zabawi	3	Ind
Ale nosimy także nasze nadzieje i marzenia . . .	nosimy	1	Ind
O tym , że PKP jest twórczą instytucją , przekonała mnie informacja przekazana przez głośniki w pociągu relacji Warszawa - Berlin .	przekonała	9	Ind
- Ha ! zresztą rób , jak chcesz , ale prędko decyduj się co do Stawskiej , bo czuję , że Mraczewski nie zaśpi gruszek w popiele .	decyduj	11	Imp
Róża wchodzi do łóżka , przytula się uwodzicielsko , odwraca uwagę Pana Męża i sięga po telefon , po czym siada na łóżku i próbuje go odblokować .	przytula	5	Ind
Szlaki turystyczne szczegółowo omawiają przewodniki ( J . Nyka " Tatry Polskie '' , M . Pinkwart " Zakopane i Tatry '' ) .	omawiają	3	Ind
Trzeba niestety przyznać , że wielu ludzi nabiera się na takie chwyty .	nabiera	7	Ind
Naszym zdaniem wyrok w sprawie Laval nie osłabia szwedzkiego modelu , ale z pewnością podnosi wiele kwestii dotyczących ustawodawstwa szwedzkiego .	osłabia	7	Ind
Kochamy Polskę , lecz fakty składające się na polską rzeczywistość działają nam na nerwy .	Kochamy	0	Ind
Cieszę się , że nic nie posłała m .	posłała	6	Ind
- Zatrzymaj się , bo strzelę !	Zatrzymaj	1	Imp
Nie odwódźcie mnie . . .	odwódźcie	1	Imp
Olek zawiadamia posępnie : - Władka już nie ma .	zawiadamia	1	Ind
Nie przewidywały , że na własnej piersi wyhodują sobie takiego gada .	wyhodują	7	Ind
Prace o charakterze pielęgnacyjnym , opiekuńczym , wychowawczym , edukacyjnym winny być właściwie ocenione .	winny	10	Ind
W Betlejem zupełnie utracili ducha dociekliwości , z punktu widzenia intelektualisty zachowali się nadzwyczaj pokornie .	utracili	3	Ind
Przypuśćmy , że zostałeś uprowadzony z jej sypialni , sprzed jej przyglądających się oczu .	Przypuśćmy	0	Imp
Ucałuj jeszcze mamusię !	Ucałuj	0	Imp
Pluj i jedz , wymagała .	Pluj	0	Imp
– Nie piernicz .	piernicz	2	Imp
Co wolisz ?	wolisz	1	Ind
Dwie dziewczynki podskakują z rozpostartymi rękami i nogami , obok nich podskakuje chłopiec , a mężczyzna siedzi nieopodal na krzesełku .	podskakują	2	Ind
Nakazał też wypłatę wynagrodzenia , które by otrzymywały , gdyby świadczyły pracę w poradni .	otrzymywały	7	Ind
Kobieta i dwóch małych chłopców bawią się na huśtawce na placu zabaw , a trzeci chłopiec oddala się od nich , biegnąc .	oddala	16	Ind
Nigdy nie był wysoki , ale teraz jakby się jeszcze skurczył , plecy mu się pochyliły , głowa uciekła w ramiona .	skurczył	10	Ind
- Wykopię ten dół .	Wykopię	1	Ind
Nie trzeba wielkiej przenikliwości , aby się domyślić , że Anglicy przeprowadzają rewizję .	przeprowadzają	11	Ind
Dlatego solidnie się zmęcz .	zmęcz	3	Imp
Starsze osoby ( często po wyjściu z pobliskiego szpitala ) po kwadransie oczekiwania na autobus kwalifikują się do kolejnej wizyty u lekarza .	kwalifikują	15	Ind
Oryginalne lampy zdobyto z zasobów niemieckich przeznaczonych dla Wehrmachtu .	zdobyto	2	Ind
Pospiesz się .	Pospiesz	0	Imp
Kochajcie się , bądźcie parą w pytkę .	Kochajcie	0	Imp
– dej spokój .	dej	1	Imp
Kobieta przestudiowała ją , potem otworzyła drzwi .	przestudiowała	1	Ind
- Wyjdź - prosiła .	Wyjdź	1	Imp
- Przyzwyczajajmy dzieci do picia mleka !	Przyzwyczajajmy	1	Imp
Wytoczę ten proces i mnie nie powstrzymasz .	powstrzymasz	6	Ind
Tak toczy się światek .	toczy	1	Ind
Nie psuj im humorów .	psuj	1	Imp
Zobaczymy , co zwiozą nam do młodni .	zwiozą	3	Ind
Z dumą przypomina sobie , że gdy Anglicy spytali Polaków , dlaczego lubią latać z Mackenziem - odpowiedzieli : - Bo on jest tak samo szalony jak my .	spytali	8	Ind
Ostatecznie rany mu opatrzyli .	opatrzyli	3	Ind
Uczymy ich na kursach ogólnych i specjalistycznych .	Uczymy	0	Ind
Nocami przychodziły do mojego łóżka , kochały mnie .	kochały	6	Ind
Polska wieś nie zaznała po II wojnie światowej działań na podobną skalę .	zaznała	3	Ind
Wilk nie zadawał już pytań , ale ona wcale ich nie potrzebowała .	zadawał	2	Ind
Czyżby oni wszyscy ulegli zbiorowej halucynacji , skoro po powrocie z kina mówią , że im się podobało ?	ulegli	3	Ind
Henryk informował , że Jenny przespała granicę i nikt jej nawet nie budził .	budził	12	Ind
– ależ nie przesadzaj . .	przesadzaj	3	Imp
Używaj zawsze tych samych słów i określeń .	Używaj	0	Imp
Zamierzał ją zawieść do inseminatora .	Zamierzał	0	Ind
Przez chwilę jeszcze posłuchajmy , co mówią o Kwaśniewskim jego zwolennicy .	posłuchajmy	3	Imp
- Zastanów że się .	Zastanów	1	Imp
Zapisał nuty , przemówił do mnie szyfrem .	Zapisał	0	Ind
Nie wspominajcie o ojczyźnie , jej mitach i tradycjach .	wspominajcie	1	Imp
Witold poszedł w jego ślady i również poświęcił się dziennikarstwu .	poświęcił	7	Ind
Od lat realizuje kolejną pasję , którą jest fotografia .	realizuje	2	Ind
Stała oparta o balustradę i patrzyła na wodę .	patrzyła	5	Ind
Jeśli dręczą cię złe myśli , spróbuj się odprężyć .	spróbuj	6	Imp
Na szczęście moja żona wolała pójść na bożonarodzeniowy koncert w limeńskiej katedrze .	wolała	4	Ind
Pozwoliło to załatwić ostatecznie sprawę Czechowicza .	Pozwoliło	0	Ind
Ucałuj jeszcze mamusię !	Ucałuj	0	Imp
- Ewa , posłuchaj , to na pewno minie . . .	posłuchaj	3	Imp
Nie słuchaj ich wszystkich , nie czytaj żadnych książek .	słuchaj	1	Imp
- Patrz !	Patrz	1	Imp
Dziewczynka w fioletowo - niebieskim kostiumie ze skrzydłami stoi , trzymając w górze rękę z różdżką , a inna osoba celuje w nią cienkim przedmiotem .	celuje	20	Ind
Czyżby oni wszyscy ulegli zbiorowej halucynacji , skoro po powrocie z kina mówią , że im się podobało ?	ulegli	3	Ind
Stali i trzymali się w objęciach .	trzymali	2	Ind
W dusznej od papierosowego dymu izbie tłoczono się okropnie .	tłoczono	6	Ind
Zarejestrował w urzędzie skarbowym fikcyjną pożyczkę na kwotę 500 tys . zł .	Zarejestrował	0	Ind
I przeczytaj coś o Simone de Beauvoir .	przeczytaj	1	Imp
Niemieckiej publiczności pokazane zostaną : " Głośniej od bomb " Przemysława Wojcieszka , " Zmruż oczy " Andrzeja Jakimowskiego i " Wtorek " Witolda Adamka .	Zmruż	14	Imp
- Ulegam przemocy .	Ulegam	1	Ind
- Niech pani to skieruje do siebie .	skieruje	4	Ind
W dzielnicy zawrzało .	zawrzało	2	Ind
– zrób jeszcze herbatę .	zrób	1	Imp
Do programu zgłosiły się cztery powiaty .	zgłosiły	2	Ind
A ty , Adam , nic nie kombinuj .	kombinuj	7	Imp
Dawaj opończę .	Dawaj	0	Imp
Nie pozostawiajmy ich bez opieki .	pozostawiajmy	1	Imp
Straż Miejska już od soboty pilnuje , aby na plac targowy nie wchodzili klienci .	wchodzili	12	Ind
— Odpocznie od tego nieszczęścia .	Odpocznie	1	Ind
Jeszcze inni proponują analogiczną technikę , jak w przypadku odzwyczajenia od palenia papierosów .	proponują	2	Ind
Korupcja osiąga punkt zenitalny .	osiąga	1	Ind
Jak się wywiążą ?	wywiążą	2	Ind
Polonii aura nie przeszkadzała w odniesieniu wysokiego zwycięstwa .	przeszkadzała	3	Ind
Miasto otuliła mgła .	otuliła	1	Ind
Popatrz na tych młodych KZT .	Popatrz	0	Imp
Odsuwa się daleko .	Odsuwa	0	Ind
Kiedy RS AWS się wzmocni , ja też zrezygnuję z pewnych funkcji .	zrezygnuję	8	Ind
Zbłądzili śmy .	Zbłądzili	0	Ind
Tłumacz zachował przecież zarówno znaczenie wizualne , jak i sensy metaforyczne , obecne w tekście angielskim .	zachował	1	Ind
Na polach Domatowa i Polchowa usypano wysokie mogiły .	usypano	5	Ind
Kilka dni temu ktoś załatwił się pod ich oknem .	załatwił	4	Ind
Dobrze spisała się młodzież w Sterdyni , Ceranowie , Skrzeszynie , Czerwonce i Wężach .	spisała	1	Ind
Sytuacja prawna ponad 700 osób oskarżonych o powiązania z mafią , które dotąd traktowano dość liberalnie zadowalając się formalnym dozorem policyjnym , ma być ponownie zbadana .	traktowano	13	Ind
Nazwał to nawet stalinizmem XXI wieku .	Nazwał	0	Ind
Jak się okazało , potrafimy to robić , za co - powiem nieskromnie - pochwalono nas , ale jakże wiele jeszcze przed nami .	pochwalono	14	Ind
Nie czekajcie na mnie i nie oglądajcie się .	oglądajcie	6	Imp
Po czym rozwarł dłonie w powietrzu , jak gdyby trzymał w nich przenośną kulę ziemską .	rozwarł	2	Ind
Mijała minuta za minutą , czas wlókł się w nieskończoność , a nie pojawiał się nikt .	Mijała	0	Ind
Szczep nie zazieleni się więcej .	zazieleni	2	Ind
Jak AWS zachowa się w głosowaniu nad wotum zaufania dla rządu premiera Buzka ? - zapytaliśmy wczoraj kilku posłów Akcji .	zachowa	2	Ind
Pozbył się balastu , nim ten balast odebrała mu zamieć historii .	Pozbył	0	Ind
Roboty finansowało w całości uzdrowisko .	finansowało	1	Ind
Wstał i wezwał kobiety , by przygotowały ciało Jiang-qing do kremacji .	przygotowały	6	Ind
Prezentuje na zdjęciach : bawoły , żyrafy , słonie , hipopotamy .	Prezentuje	0	Ind
Miejmy nadzieję , że ich nowa redakcja zawierać będzie wnioski autorów omawianej publikacji .	Miejmy	0	Imp
Przynieś swoje rzeczy i też się wprowadź .	Przynieś	0	Imp
- Zrobiono mi tym wielkie świństwo , bo po waszym artykule ludzie się ze mnie śmieją .	śmieją	15	Ind
Nie próbuj go oświecać .	próbuj	1	Imp
Kierowca wrzuca wsteczny i na pełnym gazie taranuje pieszych .	wrzuca	1	Ind
Ale czasza szamocze się , nie ulega .	szamocze	2	Ind
Pomyliła się .	Pomyliła	0	Ind
W wydanym wczoraj oświadczeniu Rada podkreśliła , że wstrzymanie wykonania koncesji , gdy jednocześnie toleruje się działalność piratów , niszczy podstawy ładu w eterze .	toleruje	14	Ind
– co jedli ście ?	jedli	2	Ind
O tym szefostwo nigdy się nie dowie , już on się o to postara .	postara	13	Ind
Ale matka próbuje nieporadnie zmienić atmosferę i rzuca dość bezsensowną w tej sytuacji propozycję : - Zaśpiewajmy coś wspólnie . . . jak dawniej . . .	Zaśpiewajmy	16	Imp
Niektórzy moi palący koledzy zjadliwie mi dokuczają : „ Nie pal , nie pij i … a umrzesz zdrowszy ! ”	pij	13	Imp
Lech Kaczyński - prezydent RP , znany miłośnik kotów , jako prezydent Warszawy realizował program opieki nad bezdomnymi zwierzętami , utworzył w stolicy stanowisko pełnomocnika do spraw zwierząt .	realizował	13	Ind
" Zostań Spidermanem w swoim mieście " - brzmiało hasło ogólnopolskiego programu edukacyjnego , którego bohaterem jest komiksowy człowiek - pająk , walczący z przestępcami i złem .	Zostań	1	Imp
Bez słowa wyminął mnie i zatrzymał się przed dzieckiem .	wyminął	2	Ind
Za dawno przywykł do posłuchu .	przywykł	2	Ind
przywiezła tyn samochód i dzieci .	przywiezła	0	Ind
Sprzęt należał do Stacji Doświadczalnej w Łopusznej .	należał	1	Ind
Wywołał on wielkie zainteresowanie .	Wywołał	0	Ind
Eisenhowera pod koniec rządów obarczano winą za to , że ZSRR doganiał Amerykę w wyścigu zbrojeń rakietowych , ale dziś mało kto o tym pamięta .	doganiał	11	Ind
Wkrótce nadeszło drugie zdjęcie w czarnej obwódce .	nadeszło	1	Ind
Śpiewała także na dworze szacha , w czasie przyjęcia dyplomatycznego .	Śpiewała	0	Ind
Aby złagodzić szok , politycy obiecali , że część różnicy pomiędzy starym a nowym podatkiem będzie można odzyskać .	obiecali	5	Ind
Pisarz wysłuchał uważnie , zapytał , o które drzewo chodzi i spojrzawszy na zegarek napełnił oba kieliszki .	napełnił	14	Ind
Popatrzyła z niedowierzaniem na mój kciuk .	Popatrzyła	0	Ind
Zjednoczenie Chrześcijańsko - Narodowe obiecało w tym roku kolonie dla 15 tys . dzieci z najuboższych rodzin .	obiecało	4	Ind
Te słowa powstały po to , by je ze sobą połączyć .	powstały	2	Ind
Wystawa uświadamia nie to , jak wiele nas łączy , ale jak wiele - głównie za sprawą polityki - może dzielić kultury narodów , które żyją obok siebie .	uświadamia	1	Ind
Chętnie nawiążę znajomość z taką osobą .	nawiążę	1	Ind
Justyna staje się " terapeutką " - wypytuje innych , interpretuje ich zachowanie , podsumowuje to , co się dzieje , rzuca propozycje .	wypytuje	7	Ind
Saszce rzeczywiście odeszła chętka do dalszej rozmowy .	odeszła	2	Ind
ubrudził eś sobie rączki ?	ubrudził	0	Ind
Dalej za płotem ciągnął się sad .	ciągnął	3	Ind
W odpowiednim sklepie za 350 zł sprzedadzą każdemu .	sprzedadzą	6	Ind
Wiatr zmęczył się także .	zmęczył	1	Ind
1a. Zakazuje się unieszkodliwiania zakaźnych odpadów medycznych i zakaźnych odpadów weterynaryjnych w inny sposób niż spalanie w spalarniach odpadów .	Zakazuje	1	Ind
- Obejrzyj go sobie dokładnie .	Obejrzyj	1	Imp
- O mnie się nie martwcie .	martwcie	5	Imp
Za każdy samochód zabierali się od razu mechanicy , zmieniali koła , usuwali uszkodzenia powstałe w czasie forsownego treningu , wymieniali zdarte nakładki hamulcowe , regulowali silniki .	zmieniali	9	Ind
Nie przyda mi się teraz to mieszkanie , a nie chcę go sprzedawać .	przyda	1	Ind
Użyto gazów łzawiących i ogłuszających granatów .	Użyto	0	Ind
Zainspirowało przy tym reformy i umocniło wspólne zasady wolności , demokracji , poszanowania praw człowieka i podstawowych wolności , praworządności i gospodarki rynkowej .	umocniło	5	Ind
Może ci w tym pomóc : Jeżeli chcesz się dowiedzieć , w jakich sytuacjach potrafisz zadbać o siebie , a co sprawia ci trudność , wykonaj poniższe zadania .	wykonaj	25	Imp
Niech spełnią się wszystkie jej marzenia !	spełnią	1	Ind
Chodź tam i z powrotem i śpiewaj .	śpiewaj	6	Imp
Rok 2007 zamknięto liczbą 238400 pasażerów .	zamknięto	2	Ind
Ściągnijcie wódkę ze stołu i postawcie kilka dzbanków herbaty , żeby ta cała banda zaczęła powoli trzeźwieć .	postawcie	5	Imp
Celowo wyrażał em także inne wątpliwości .	wyrażał	1	Ind
Chart nie raczył nawet mnie obwąchać .	raczył	2	Ind
W przeglądarce Netscape Navigator , analogicznie jak w IE , możemy wprowadzić zmiany konfiguracyjne , które zoptymalizują nam połączenie z Internetem .	zoptymalizują	16	Ind
Przedostatni figuruje Artur Balazs , poseł i minister rolnictwa , a zamyka ją Stefan Oleszczuk z UPR-u , starosta kamieński .	zamyka	11	Ind
Witamy drogiego kolegę ! - huknął , aż echo odebrzmiało , Deluge .	Witamy	0	Ind
Uważam , że byłoby to bardzo nieodpowiedzialne z punktu widzenia polityki europejskiej , i ufam , że austriacki szef rządu wycofa się z swojego oświadczenia w tym zakresie .	wycofa	20	Ind
Nad Halberdą nie rozpiął parasola .	rozpiął	3	Ind
W Olsztynie pod drzwiami szpitalnymi zmarły ostatnio dwie osoby .	zmarły	5	Ind
Autorzy witryn podzielili to wszystko na tematy .	podzielili	2	Ind
Gdy Cahirowi czupryna nieco mocniej przyschnie do czerepu , powędrujemy ku Toussaint .	powędrujemy	9	Ind
- Pływał em tam w ubraniu ?	Pływał	1	Ind
Milicja ujęła napastników .	ujęła	1	Ind
Bił tak mocno , że złamał kij bejsbolowy .	złamał	5	Ind
To , czy i jakie włosy wyrosną na głowie człowieka , decyduje się już we wczesnym stadium rozwoju embrionalnego .	wyrosną	6	Ind
- Mam - odpowiedziała z radosną gotowością , która aż go dławiła .	dławiła	11	Ind
Moja żona wybiera się do Tunezji , strzeżcie się , Tunezyjczycy .	strzeżcie	7	Imp
Ideą przyświecającą powstaniu Kolonii , jak się domyślacie , jest stworzenie niezależnej , trwałej grupy o własnych artystycznych tradycjach .	domyślacie	7	Ind
- Nie stójmy bezczynnie ! - wołali jedni .	stójmy	2	Imp
Kontakty towarzyskie utrzymywali jednak przez cały czas .	utrzymywali	2	Ind
Powinna m urządzić podobnie mieszkanie .	Powinna	0	Ind
Koloryt portretu wydawał mu się za mało żywy .	wydawał	2	Ind
Ponad 1600 osób wzięło wczoraj udział w 24 . maratonie ulicznym we Wrocławiu .	wzięło	3	Ind
- Zostańcie z nami .	Zostańcie	1	Imp
Wydaje się być w nieco lepszej formie , niż był w więzieniu Chaobai .	Wydaje	0	Ind
- W pierwszym etapie egzaminatorzy sprawdzą posłuszeństwo czworonogów oraz przetestują je na specjalnym torze przeszkód .	sprawdzą	5	Ind
Następnie podgrzewamy i przesączamy przez gęste sito .	podgrzewamy	1	Ind
Zapytał mnie w pewnym momencie , czy do niego pójdę .	Zapytał	0	Ind
Upływały tygodnie .	Upływały	0	Ind
Kilkudziesięciu specjalistów z całego kraju - meliorantów , hydrologów i inżynierów - zastanawiało się w piątek w Urzędzie Miasta w Opolu nad sposobami zapobiegania zagrożeniom powodziowym na Opolszczyźnie .	zastanawiało	12	Ind
Staruszkę ze zmiażdżoną prawą stopą przewieziono do szpitala przy ulicy Cegłowskiej .	przewieziono	5	Ind
A Marlena Dietrich zagrała tak przekonująco , że wylansowała na cały świat kobietę - wampa .	wylansowała	8	Ind
Dratewkę pani Joasia wyrwała z bestialskich łap pewnego szewca , którego niech piekło pochłonie .	wyrwała	3	Ind
- Tak , gość z Mergers zaprowadził mnie do swojego krawca .	zaprowadził	6	Ind
Duże urozmaicenie wprowadzają do tegorocznej wystawy fotomontaże .	wprowadzają	2	Ind
Pewną ręką zamyka książkę .	zamyka	2	Ind
Naradzali się długo , a potem poszli do Spartakusa .	Naradzali	0	Ind
- 5 dni obradowała w Warszawie konferencja Stowarzyszenia Prawa Międzynarodowego .	obradowała	3	Ind
Ojciec zdmuchnął świece w latarniach , przykucnął za plecami syna .	zdmuchnął	1	Ind
Prezydent z oburzeniem dementował zarzuty o pazerność i zaprzeczał , jakoby pobierał apanaże z tytułu prezesowania spółce Aqua .	pobierał	11	Ind
chwalmy pana przez Maryję .	chwalmy	0	Imp
Powoli powracał rozsądek .	powracał	1	Ind
Gdy policjanci się zbliżają , małżonkowie lojalnie ostrzegają : – Odejdźcie , dobrzy ludzie , bo przewrócimy auto !	Odejdźcie	10	Imp
Ma im ono gwarantować , że po przekazaniu funduszu odszkodowawczego nie będą się już musiały martwić pozwami o odszkodowania za pracę przymusową na rzecz III Rzeszy .	musiały	14	Ind
Na miejscu specjalna ekipa zbadała pozostałości po eksplozji .	zbadała	4	Ind
Telewizyjna " Panorama " podała wczoraj , że zatrzymano 6 osób .	zatrzymano	8	Ind
Ojca wzburzało , że jego żołnierze muszą pokazywać jakieś zaświadczenia , żeby mieć za co wyżywić rodzinę .	wzburzało	1	Ind
Młode kudowianki z reguły są jeszcze na utrzymaniu rodziców , którzy ledwie wiążą koniec z końcem .	wiążą	12	Ind
Zbiegł em .	Zbiegł	0	Ind
Podporucznik Słodziak przebiegał korytarze z obłędem w oczach , podporucznik Kawiarz chrypiał z wysiłkiem do słuchawki telefonu , podporucznik Kowalik pojechał z kolejnym transportem na stację .	chrypiał	11	Ind
Na kolację , oprócz gulaszu , był chleb i masło , a do masła dodano nóż .	dodano	14	Ind
Emeryci kimają w ciągu dnia niemal wszędzie tam , gdzie przysiądą i trudno się dziwić , że nocą nie są złaknieni snu .	przysiądą	10	Ind
dom odpada z kilku względów .	odpada	1	Ind
Pozwól mi wrócić jutro .	Pozwól	0	Imp
Wybaczcie , teraz doczołgam się do telefonu i wezwę policję .	wezwę	8	Ind
" Myślę , że koty i psy wyczuwają rzeczy niedostępne naszym zmysłom " - dodaje .	wyczuwają	7	Ind
Znajdź sobie na pierwsze dni jakieś absorbujące zajęcie .	Znajdź	0	Imp
– Przyjedź szybko do Nowolipska .	Przyjedź	1	Imp
Automatycznie pobierz informacje o czasie wolnym i zajętym innych osób	pobierz	1	Imp
Okazało się , że był nią pies .	Okazało	0	Ind
Usmaż jeszcze kiedyś faworki , błagam .	Usmaż	0	Imp
Zdaje się , że konduktor grasuje w wagonie .	Zdaje	0	Ind
– Puśćcie !	Puśćcie	1	Imp
Tymczasem mój organizm zaaklimatyzował się do chłodu i odnosi z tego konkretne korzyści .	zaaklimatyzował	3	Ind
Zaproponowali , że przerobią telefon tak , by można było z niego bezpłatnie rozmawiać .	przerobią	3	Ind
Wyglądało to tak , jakby ci ludzie czekali aż pociąg sobie pojedzie , ale kiedy nie ruszał , postanowili kontynuować drogę .	Wyglądało	0	Ind
Drżące dłonie opadły .	opadły	2	Ind
Ze stara wyciekał olej i płyn chłodzący , a przyczepa miała zdemontowany hamulec awaryjny .	wyciekał	2	Ind
Ukończyła tylko drugą klasę podstawówki .	Ukończyła	0	Ind
Wypowiedź kończyło dobitne : " Niech żyje Socjalistyczna Eurazja !	kończyło	1	Ind
Zapisał nuty , przemówił do mnie szyfrem .	Zapisał	0	Ind
WYKORZYSTAJMY EUROPEJSKĄ SZANSĘ !	WYKORZYSTAJMY	0	Imp
Nadział em je na haczyk i zarzucił em .	Nadział	0	Ind
Koniecznie zadzwoń i przeproś za zwłokę .	zadzwoń	1	Imp
- Czekaj , czekaj - powiedziała do tatusia - chcę ci jeszcze coś pokazać !	czekaj	3	Imp
Mówię o tych czasach , które pamiętam , że mnie egzaltowały .	egzaltowały	10	Ind
Nakazał też wypłatę wynagrodzenia , które by otrzymywały , gdyby świadczyły pracę w poradni .	świadczyły	10	Ind
Kukufat szybko opanował zamieszanie , nawołując zgromadzonych do zachowania spokoju .	opanował	2	Ind
Lamentują , jakby śpiewali .	śpiewali	3	Ind
Koniecznie zadzwoń i przeproś za zwłokę .	zadzwoń	1	Imp
Trafia na oddział intensywnej terapii .	Trafia	0	Ind
Wydaje się , że o decyzji przesądziły trzy czynniki .	przesądziły	6	Ind
Być może , że proces ten trwać będzie lata , być może przesilenie przybierze formę światowego konfliktu zbrojnego , być może już niebawem zajdą wydarzenia , których nikt z nas nie przewiduje .	przybierze	13	Ind
Po urodzeniu odżywia się mlekiem matki .	odżywia	2	Ind
- Oto - gorączkował się - dane o opadach .	gorączkował	3	Ind
W środę około godz . 23 , gdy był już w łóżku , nagle zgasło światło .	zgasło	14	Ind
- Jajo przywiózł do nas osobiście dyrektor płockiego zoo .	przywiózł	2	Ind
6 . Rozpalaj ogniska tylko wówczas , gdy jest to naprawdę potrzebne i rób to w sposób jak najmniej szkodliwy dla otaczającej przyrody .	rób	13	Imp
Odczekali aż w pomieszczeniu nie będzie innych klientów i poprosili sprzedawczynię o zważenie jabłek .	Odczekali	0	Ind
Patrzą na panią , jak na przedmiot .	Patrzą	0	Ind
Tylko uważaj , żeby Ci maszynka do golenia nie odmówiła posłuszeństwa , no bo jak tak wejść nieogolonym w rok 2000 - toż to katastrofa !	uważaj	1	Imp
Żołnierze poznańskiego garnizonu pełnili honorową straż .	pełnili	3	Ind
Zgromadzeni w stołecznej archikatedrze duchowni odebrali to jako " wezwanie , by nie być surowymi sędziami wobec księży , którzy jako donosiciele współpracowali z reżimem komunistycznym " .	odebrali	5	Ind
- Przyzwyczajajmy dzieci do picia mleka !	Przyzwyczajajmy	1	Imp
Niosły teczki , rozprawiały ze sobą hałaśliwie , miały na głowach przekrzywione berety , pod ich nogami skrzypiał śnieg .	rozprawiały	3	Ind
Zerknęła w lustro , obciągnęła na sobie sweter w czerwone skrzydła . . .	Zerknęła	0	Ind
Zapominasz o sobie ; wasze usposobienia różnią się zdecydowanie , to przyznaję .	Zapominasz	0	Ind
Niektórzy pytają , po co to robię ?	pytają	1	Ind
Drgania cewki , która umieszczona jest między biegunami magnesu , wzbudzają w niej przemienny prąd elektryczny o częstotliwości odpowiadającej częstości drgań fal dźwiękowych .	wzbudzają	10	Ind
Wracaj jak najszybciej , ale - oczywiście - po pełnej rekonwalescencji .	Wracaj	0	Imp
Tamtejsi przyrodnicy nie umieli jednak sklasyfikować olbrzyma .	umieli	3	Ind
- Synu , otwórz - prosi .	otwórz	3	Imp
Zasiedział się Lisiewicz do późna za biurkiem .	Zasiedział	0	Ind
Śpią w noclegowni koło lokomotyw .	Śpią	0	Ind
No to usiądź swobodnie przed komputerem , zrelaksuj się , uruchom TAGa i napisz : Miota mną ogromny niepokój .	zrelaksuj	7	Imp
Pani Kowalska ubrała się w kufajkę .	ubrała	2	Ind
Wspólne działania dały efekty .	dały	2	Ind
Dominika krzyczy , zatrzymaj się , Edyta wymiotuje na tylnym siedzeniu , a Jagienka śpiewa , wyrwij murom zęby krat .	wymiotuje	7	Ind
Oni się dyskredytują takimi stwierdzeniami .	dyskredytują	2	Ind
To może pani przegrzewa mieszkanie ?	przegrzewa	3	Ind
Spotykaliśmy się wszyscy , robiliśmy ognisko , piekliśmy kartofle i próbowaliśmy jak smakują papierosy .	smakują	12	Ind
Trzymajcie się !	Trzymajcie	0	Imp
Kręciła m wtedy film .	Kręciła	0	Ind
- A ty , koleś - zawołał - do Warszawy lepiej nie zaglądaj !	zaglądaj	12	Imp
No , nie mitręż , dziewczyno .	mitręż	3	Imp
W kwietniu skończyli kurs .	skończyli	2	Ind
6 . Rozpalaj ogniska tylko wówczas , gdy jest to naprawdę potrzebne i rób to w sposób jak najmniej szkodliwy dla otaczającej przyrody .	Rozpalaj	2	Imp
Gonią mnie potwory .	Gonią	0	Ind
Wielkie podmioty wywierają znaczący wpływ na rynki , na których działają .	działają	10	Ind
Niektórzy moi palący koledzy zjadliwie mi dokuczają : „ Nie pal , nie pij i … a umrzesz zdrowszy ! ”	pal	10	Imp
- Może kupisz coś ode mnie , mam wieczór kawalerski i sprzedanie przedmiotów z koszyka jest moim zadaniem - tak 28-letni Jacek Jarosz , który jutro będzie mężem , zaczepia przechodzącą obok brunetkę .	kupisz	2	Ind
Przyzwoitość każe szanować gości i ja właśnie w ten elegancki sposób uszanuję Jagodowe wakacje .	uszanuję	11	Ind
Amerykański dziennik " Washington Post " napisał wczoraj , że aresztowanie Saddama " symbolizuje zasadniczy postęp w przezwyciężaniu przeszłości Iraku " .	symbolizuje	13	Ind
Siedzimy naprzeciw siebie , pijemy herbatę , jemy piernik domowego wypieku .	pijemy	4	Ind
Po służbie nie wrócił em do domu , zaczął em pracować w Łodzi , na stałe tam zamieszkał em .	zamieszkał	17	Ind
Wprowadzając karę śmierci " przestraszysz " zabójców ( nie mówię o seryjnych mordercach ) , którzy 2 x zastanowią się zanim zabiją .	przestraszysz	4	Ind
Jej wina , nie dopilnowała !	dopilnowała	4	Ind
Sprawność podczas akcji i umiejętności ratowników oceniali sędziowie .	oceniali	6	Ind
Jędrusia przysiadła na brzegu .	przysiadła	1	Ind
- Internet wzbudza wielkie nadzieje wśród inwestorów .	wzbudza	2	Ind
W wspomnianych zestawach nie figurują te nazwiska .	figurują	4	Ind
Przy maszynie do pisania siedzi młody jeszcze mężczyzna , ubrany bardzo starannie , pali angielskie " Black Caty " ( obłowili się po Anglikach ) , wita mnie uśmiechem .	obłowili	20	Ind
Łaskarzewo przygotowano do obrony , barykadując wszystkie drogi wylotowe miasteczka , ale o poważniejszych działaniach obronnych nie mogło być mowy .	przygotowano	1	Ind
Dunaj stał nieruchomo przed krzakiem leszczyny , którego rozłożyste , zwisające do ziemi gałęzie tworzyły zieloną kopułę i który załoga uważała za swój namiot .	uważała	20	Ind
Spróbuj też wynająć maga , który rzuci na taran czar impotencji .	Spróbuj	0	Imp
Olejnik : Dodam tylko , że pułkownik Konstanty Miodowicz też uważa , że pan Nowek powinien się podać do dymisji i zakończmy już tę sprawę .	zakończmy	21	Imp
Na wczorajszej rozprawie zeznania składali kolejni świadkowie w procesie , który niedawno został rozpoczęty ponownie .	składali	4	Ind
Pod koniec br . ukaże się w Moskwie tom studiów przygotowanych przez autorów polskich i radzieckich , poświęcony polskiej literaturze rewolucyjnej .	ukaże	4	Ind
Lekarze zalecili mu odpoczynek przed rywalizacją sztafet .	zalecili	1	Ind
Kobieta i mężczyzna schodzą po wąskich schodach , trzymając się poręczy wykonanej z liny .	schodzą	3	Ind
Wsunąwszy ją w ramy , położył na niej obrazek i zaczął skrupulatnie wbijać ćwieczki .	położył	5	Ind
Nie dostawał przepustek .	dostawał	1	Ind
Wśród ludzi wybranych na najwyższe urzędy zjawiają się bandyci , gangsterzy , szpiedzy .	zjawiają	6	Ind
- Czego stękasz ?	stękasz	2	Ind
Ruch regulowali policjanci .	regulowali	1	Ind
Zachęcany , aby również w czasie Wielkiego Tygodnia zrezygnować z oglądania telewizji .	Zachęcany	0	Ind
Będą pracowali tak długo , aż wyjaśnią przyczyny konfliktu .	wyjaśnią	6	Ind
Na szczęście to właśnie on wskazywał jej zarezerwowany stolik i podawał aperitif , nie szczędząc przy tym zalotnych słówek i żarcików ; ognisty Włoch , a takich dziewczynie najłatwiej zbajerować .	podawał	10	Ind
20 . Na konferencji jesiennej 1960 roku strona słowacka przedstawi , o ile to będzie możliwe , program badań fitosocjologicznych w obszarze tatrzańskim .	przedstawi	9	Ind
Nasze piłkarki w grupie zmierzą się z Niemcami , Szwecją i Szwajcarią .	zmierzą	4	Ind
Z nieba leje się żar .	leje	2	Ind
Nie wiem co piję , ale jeśli to jest miłość . . . dolej mi jeszcze .	dolej	13	Imp
Okradałem człowieka , który zaprzedał się dla paru dolarów .	zaprzedał	4	Ind
Dostrzegają je twoje oczy , słyszą je twoje uszy .	Dostrzegają	0	Ind
– nie opisuj tylko zjedz . .	opisuj	2	Imp
Nie jest normalny ktoś , kto zamiast popływać z dziewczyną kajakiem po stawie , ustrzelić jej na strzelnicy misia i wypić parę piwek - szlaja się po jakiś Mekongach !	szlaja	24	Ind
Nie niszcz mojego dzieła !	niszcz	1	Imp
3 . Dopuszcza się używanie bębenka tylko w przypadku , gdy wiertacz znajduje się przy pulpicie sterowniczym wiertnicy .	Dopuszcza	2	Ind
Proboszcz klepnął się dłońmi w kolana .	klepnął	1	Ind
Wybaczcie , teraz doczołgam się do telefonu i wezwę policję .	Wybaczcie	0	Imp
W okresie oczekiwania na przeniesienie linia powinna być zarezerwowana , jednak w systemie rozliczeniowym figurowała jako czynna .	figurowała	14	Ind
Spędź godzinę z piękną dziewczyną , a wyda ci się minutą .	Spędź	0	Imp
Siedzimy naprzeciw siebie , pijemy herbatę , jemy piernik domowego wypieku .	Siedzimy	0	Ind
Czy nie brzmi nazbyt trywialnie ?	brzmi	2	Ind
Mniejsze rosły jeszcze w doniczkach .	rosły	1	Ind
Wykonano ją chałupniczo , ale nie powstydził by się ich żaden fachowiec .	Wykonano	0	Ind
Niemcy słuchają .	słuchają	1	Ind
- Uklęknijcie . . .	Uklęknijcie	1	Imp
Przyjechali saperzy , zabrali granat i zdetonowali go w bezpiecznym miejscu .	zdetonowali	6	Ind
Staję koło stołu i czekam .	Staję	0	Ind
Jak podkreślono we wspólnej deklaracji delegacji ITER , uczestnictwo Indii oznacza , że w projekcie jest teraz reprezentowana połowa ludności świata .	podkreślono	1	Ind
- Mam ci wywróżyć , czym odmowę przypłacisz ? - domyśliła się .	domyśliła	10	Ind
Porastają ją wiekowe akacje , lipy i inne drzewa liściaste .	Porastają	0	Ind
– ty czytasz Jackowi bajki do snu tak na fotelu ?	czytasz	2	Ind
Nakładamy rękawice ochronne , zapinamy swetry i wychodzimy na pokład .	zapinamy	4	Ind
Kiedy wyciągnęli Wandzię na brzeg , z ust wypłynęła jej piana . . .	wypłynęła	8	Ind
Czyli oszukujesz prawowitą władzę .	oszukujesz	1	Ind
Dwaj chłopcy w czapkach z daszkiem pokazują zabarwione języki .	pokazują	6	Ind
- Mnie już nic nie zdziwi .	zdziwi	5	Ind
No teraz często płaci .	płaci	3	Ind
Ogrzał em się , dostał em nagan .	Ogrzał	0	Ind
Nieco częściej czyniły to kobiety .	czyniły	2	Ind
Jeżeli inspekcja lub inspekcje , wskazane w akapicie pierwszym , wykażą , że stan higieny nie jest odpowiedni , właściwy organ podejmie właściwe kroki .	wykażą	10	Ind
Dunlong zamachał rękoma .	zamachał	1	Ind
Teraz uświadomił sobie , że nie zna hasła na ten dzień .	uświadomił	1	Ind
- ROZMAWIAM , ZAWIERAM ZNAJOMOŚCI .	ZAWIERAM	3	Ind
W badaniach na zwierzętach ( szczury i króliki ) wykazano toksyczny wpływ na reprodukcje , w tym wady rozwojowe ( patrz punkty 4.3 i 5.3 ) .	patrz	20	Imp
– My mieszkamy na samej górze .	mieszkamy	2	Ind
Po trzech latach wyrośnie górka i dzieci będą miały skąd zbiegać .	wyrośnie	3	Ind
Wodzi oczyma po stojących postaciach .	Wodzi	0	Ind
Wyczerpał czas .	Wyczerpał	0	Ind
Spróbuję teraz uzasadnić swoje stanowisko .	Spróbuję	0	Ind
Wyborów jednak tu nie doczekała - na wieść , że jej syna próbowano otruć , dostała zawału serca .	próbowano	12	Ind
No , nie mitręż , dziewczyno .	mitręż	3	Imp
- Nie powtarzaj mi tego , bo jeszcze zmienię zdanie .	powtarzaj	2	Imp
- Zaśniesz sam .	Zaśniesz	1	Ind
Odeszli , choć mogli zapytać o to i owo w samym Betlejem .	Odeszli	0	Ind
– Przyjedź szybko do Nowolipska .	Przyjedź	1	Imp
Jego sąsiedzi dobudowali sobie taras , najprawdopodobniej bezprawnie i od lat zalewają mu sufit .	zalewają	11	Ind
Tiry wyjechały z Warszawy tydzień temu .	wyjechały	1	Ind
- No to . . . zamieniam się - mruknęła .	mruknęła	9	Ind
Odsuńcie się , ludzie !	Odsuńcie	0	Imp
Do tej pory jednak nie ustalono , czy polowały na nie , czy oswajały je i dojadały po nich resztki .	dojadały	16	Ind
Czeka na nią na dworcu .	Czeka	0	Ind
A potem zgłoś się do księcia po nagrodę .	zgłoś	2	Imp
– Wyglądasz pięknie .	Wyglądasz	1	Ind
Przy maszynie do pisania siedzi młody jeszcze mężczyzna , ubrany bardzo starannie , pali angielskie " Black Caty " ( obłowili się po Anglikach ) , wita mnie uśmiechem .	wita	26	Ind
Niosła się w obłoku , zakurzona .	Niosła	0	Ind
Szlocha , jest załamana .	Szlocha	0	Ind
Sięgnęła po buteleczkę Neocardiny , odmierzyła około czterdziestu kropli do szklaneczki z wodą , popiła tym tabletki od nadciśnienia , a na koniec , prosto z butelki łyk Neospasminy .	odmierzyła	5	Ind
Z czego mam się cieszyć , że kości rozsiejemy po świecie ?	rozsiejemy	8	Ind
Doznały jedynie stłuczeń kończyn i po opatrzeniu ran w szpitalu w Broumovie zostały zwolnione .	Doznały	0	Ind
Życie w rezydencji różniło się zdecydowanie od poprzedniego .	różniło	3	Ind
Siemkowicz prostuje : - To było 25 listopada , w piątym dniu mojej pracy na stanowisku komendanta .	prostuje	1	Ind
Kobieta w różowym kostiumie kąpielowym opala się na leżaku .	opala	5	Ind
Jeśli resort zaakceptuje programy , będzie je finansować .	zaakceptuje	2	Ind
NIENAWIDZĘ ! ! !	NIENAWIDZĘ	0	Ind
- Głównie z kofeiny - odrzekła - ale i z reszty balastu .	odrzekła	5	Ind
Potem rozległy się jeszcze inne równie przerażające odgłosy .	rozległy	1	Ind
Przyjrzyjmy się mu dokładniej .	Przyjrzyjmy	0	Imp
Przypuśćmy , że stoi ono w związku z postępującą chorobą .	Przypuśćmy	0	Imp
Celuj dobrze . . .	Celuj	0	Imp
Wynoście się stąd !	Wynoście	0	Imp
Myślisz , że ktoś na coś czeka , a on już uciekł . . .	Myślisz	0	Ind
Oczy powoli przyzwyczajały się do mroku .	przyzwyczajały	2	Ind
Zwierzenia Ani poruszyły mnie do głębi .	poruszyły	2	Ind
Rozmawiała m z nim przez telefon .	Rozmawiała	0	Ind
- Lepiej popływajmy .	popływajmy	2	Imp
Przedstawili się : inspektor Jesse Paterson i protokolantka Sue Minh .	Przedstawili	0	Ind
nie zapytał em . .	zapytał	1	Ind
Nie sądź , a nie będziesz sądzony , uspokoiła się .	uspokoiła	8	Ind
Mimo ciepłego dnia pani domu przyjęła ją otulona w brązowy blezer , spod ciemnej spódnicy wystawały chude łydki .	wystawały	15	Ind
Dorota z trudem przepchnęła słowa przez zaciśnięte gardło .	przepchnęła	3	Ind
Zwodujcie Wałęsę .	Zwodujcie	0	Imp
Zanim skończyłem mówić , zaatakował mnie z dwunastu stron naraz .	zaatakował	4	Ind
Zapewne władze partyjne jakoś przebolały , że nie będą mieć w Olkuszu tak efektownego pomniku , a ludzie zatroskani wyglądem naszego miasta odetchnęli z ulgą .	odetchnęli	22	Ind
Gdy Putin obiecywał rekompensaty za utracone mieszkanie , Zula nie wierzyła .	obiecywał	2	Ind
Wycofali się .	Wycofali	0	Ind
Tylko dziadek i żebraczka nie odzywali się .	odzywali	5	Ind
Przyłączyła się do mnie .	Przyłączyła	0	Ind
Szosa zwężała się i wydłużała , drzewa uciekały .	uciekały	7	Ind
Przeczytaj o tym w książkach i odłóż książki .	Przeczytaj	0	Imp
Rozbieram się do snu .	Rozbieram	0	Ind
Wychodząc z mieszkania numer cztery , powstrzymywała się do ostatniej chwili , by nie pójść do sąsiada , zameldować się , zeznać , że wróci później niż zwykle .	powstrzymywała	6	Ind
Leavitt przejechał przez bramę i zaparkował koło drewnianego budynku .	zaparkował	5	Ind
Mignęła mu jakaś głowa , wyrastająca nad chaszcze , i tyle .	Mignęła	0	Ind
Przygotuj się na to , że będziesz tylko dodatkiem do jego licznych obowiązków , postaraj się więc pogodzić z jego miłością numer jeden - pracą .	postaraj	14	Imp
Szczególnie podoba mi się to ostatnie zdanko : „ Nikt mi niczego nie załatwił po znajomości ” !	załatwił	13	Ind
Kto panu , jako premierowi , najwięcej pomógł , a kto najwięcej zaszkodził ?	zaszkodził	12	Ind
Wystraszona niewiasta nie protestowała .	protestowała	3	Ind
Wznowią je w styczniu przyszłego roku .	Wznowią	0	Ind
Popijaj , ilekroć ciągnie cię do papierosa .	Popijaj	0	Imp
Dochodzi 5-ta i zaległa cisza .	Dochodzi	0	Ind
W milczeniu spożywali zimną konsolację , szczękały sztućce , dworscy w ciemnych surdutach sprawnie zmieniali misy .	szczękały	6	Ind
- Chłopy mający ponad 30 lat płakały jak dzieci , gdy nie mogły zadzwonić do domu - dodaje kapelan z II zmiany .	płakały	6	Ind
Popatrz , Mike !	Popatrz	0	Imp
W Typinie , małej wiosce pod Tomaszowem Lubelskim , wrze .	wrze	9	Ind
Łapcie się za portfele !	Łapcie	0	Imp
Kiedy zjawili się w sali jadalnej , uwolniła rękę i pozwoliła Leto zaprowadzić się na miejsce .	pozwoliła	10	Ind
- Zejdźcie mi z oczu - wyszeptał .	Zejdźcie	1	Imp
Nie jedzmy margaryny .	jedzmy	1	Imp
- Pogaaaniaaaj !	Pogaaaniaaaj	1	Imp
Pełny wykaz substancji pomocniczych , patrz punkt 6.1 .	patrz	5	Imp
Zdaniem konkurentów , wyznaczył kanon radiowej prowokacji w warunkach polskich .	wyznaczył	3	Ind
Coś dławiło mnie w gardle , ale powiedziałem sobie , że nie będę przecież kota opłakiwał , więc z kamienną miną wyciągnąłem odkurzacz i zacząłem sprzątać .	opłakiwał	15	Ind
Jakąś łzę pani uroniła ?	uroniła	3	Ind
Nawet moje złe duchy odwróciły się do mnie plecami .	odwróciły	4	Ind
Postaraj się mnie zrozumieć .	Postaraj	0	Imp
- Nie ucz dziada , jak charchać !	ucz	2	Imp
- Zostaw Izaaka .	Zostaw	1	Imp
- Nie przesadzaj .	przesadzaj	2	Imp
W piwnicy za zakrętem korytarza wartownik błysnął światłem ręcznej latarki .	błysnął	6	Ind
Biała prawica w RPA zarzucała Treurnichtowi nadmierną ugodowość wobec rządzącej Partii Narodowej , a także pasywność .	zarzucała	4	Ind
klasa 22 jest stosowana tylko w krajach , które nie rejestrują drzew z uszkodzeniami korony powyżej 50 %	rejestrują	10	Ind
Chciało jej się płakać .	Chciało	0	Ind
Rozpoczął się kolejny rok akademicki .	Rozpoczął	0	Ind
W 1991 dokonano kolejnych zmian administracyjnych .	dokonano	2	Ind
- Nie nudź .	nudź	2	Imp
Oznacz wszystkie pola ze skarbami .	Oznacz	0	Imp
Dyrektor zapoznał Grodzickiego z katechetą , potem pożegnał się i wyszedł .	zapoznał	1	Ind
Nie aprobował jej i miał poczucie , że naród jej nie aprobuje .	aprobuje	11	Ind
Nie było " przebacz " : poczułem parę razy mocną , silną rękę ojcowską .	przebacz	3	Imp
Trzymaj , włóż to do tego swojego plecaczka .	włóż	2	Imp
Nie ruszaj się .	ruszaj	1	Imp
Zabudowywali mi też rury w łazience i ubikacji , gdzie dodatkowo zamontowali w ścianie zbiornik rezerwuaru .	Zabudowywali	0	Ind
Ministrowie , rzecznik praw obywatelskich , prezes PAN zarobią 6473,20 zł , a nie przewidywane 7398 zł .	zarobią	8	Ind
Zajmuję się zabytkami , inwentaryzuję je , niekiedy oprowadzam wycieczki - odparłem z powagą .	oprowadzam	8	Ind
Przybywały tabunami .	Przybywały	0	Ind
Uśpijcie mnie .	Uśpijcie	0	Imp
Saszka , mistrz ognia i marynat , nakupił dobrej wołowiny , bejcował ją przez cały dzień w wypełnionym miksturą plastikowym worku , po czym nad płomieniem odpowiednio dobranych polan piekł fantastyczne szaszłyki .	bejcował	11	Ind
Cyganiła go , że przyniosła mu książkę , żeby tylko na moment uchylił drzwi .	Cyganiła	0	Ind
Kiedy nosisz mundur , nie możesz się niczym przejmować .	nosisz	1	Ind
Kiedy w Banja Luce skończył się ostatni , decydujący o medalu mecz , Halina leżała na parkiecie , a na niej kłębiła się góra ciał .	kłębiła	21	Ind
W dodatku , gdy zaczęto oczyszczać go z mułu , okazało się , że na kamieniu wyryty jest napis : " Zmiłuj się , jeżeli masz serce ludzkie , i obróć mnie ! "	obróć	30	Imp
- Zbądź obawy , ojcze .	Zbądź	1	Imp
Najlepiej jak umiesz , oddajesz się licznym i trochę nudnym obowiązkom , jakie nakłada na ciebie ta sytuacja , ale czasem czujesz się zmęczona swą rolą .	oddajesz	4	Ind
Ale nie tylko same ulice irytują .	irytują	5	Ind
Katarzyna Janowska i Jacek Bomba dialogują o cielesności , niepokojach pierwszych doświadczeń , lęku przed związkiem , rozmaitych kryzysach i zdradach .	dialogują	5	Ind
Gwiazda przemieniła się w inkwizytora .	przemieniła	1	Ind
Zabierz mnie . . . i zakończ to wszystko !	zakończ	6	Imp
- Spojrzał triumfalnie po obecnych , jakby przypuszczał , że ktoś mógł by nie znać tego cytatu .	przypuszczał	7	Ind
Nie martw się - dodała na widok zrozpaczonej miny Andrzeja - ja ci pomogę .	martw	1	Imp
Uśmiechnij się do nich i zejdź im z oczu .	zejdź	5	Imp
Dziennik " Süddeutsche Zeitung '' opublikował wyniki ankiety , jaką wypełnili uczniowie szkoły realnej z Neusterlitz w Meklemburgii - Przedpomorzu .	wypełnili	10	Ind
Po obu stronach rosły drzewa .	rosły	3	Ind
Kierowano pod moim adresem bezpośrednie groźby pozbawienia życia mnie i mojej rodziny ” .	Kierowano	0	Ind
Potrwa on dwa dni .	Potrwa	0	Ind
Powstała nawet nauka o snach , nazywana onejrologią .	Powstała	0	Ind
A a propos kwestii Boga , polecam artykuł w ostatnim " Przekroju " .	polecam	6	Ind
Poczujesz się fantastycznie i przyciągniesz do siebie sojuszników równie odważnych jak ty sama .	przyciągniesz	4	Ind
Wahał em się jeszcze chwilę .	Wahał	0	Ind
Słuchali śmy chciwie tej nocy otaczającej nas ciasno .	Słuchali	0	Ind
Przy obecnych upałach takie opady wyparowują w kilkanaście minut .	wyparowują	5	Ind
- Namierzyli ciebie , odsłuchają treść rozmowy .	Namierzyli	1	Ind
I panna Wanda zaledwie rzuciła na nie okiem .	rzuciła	4	Ind
Idę płakać nad moim losem .	Idę	0	Ind
W okolicach Ełku i Giżycka nie pracują 3 linie .	pracują	6	Ind
Ja widział em ich niewiele , ale wciąż i wciąż mnie przed nimi ostrzegano .	ostrzegano	13	Ind
Witaj , witaj .	Witaj	0	Imp
Zlitujcie się nad sędziami .	Zlitujcie	0	Imp
Nie licz na udany romans .	licz	1	Imp
- A jak on skoczy mu do gardła ? - niepokoił się Janusz .	niepokoił	10	Ind
- Czy twój bóg zapewnił cię o tym ?	zapewnił	4	Ind
A może w grę też wchodził rak ?	wchodził	5	Ind
Odpowiedź przyniosą najbliższe tygodnie i wówczas możemy spodziewać się weryfikacji wartości tych spółek .	przyniosą	1	Ind
Mając jednak zarazem nadzieję , że wybierzecie tych , którzy przybliżą nas , choćby o maleńki krok , do chwili , gdy razem wybierali będziemy parlament całej Europy .	przybliżą	10	Ind
- A ja wam mówię , że jesteście na bańce .	jesteście	7	Ind
Przewidywał to i myślał , że jest gotowy , ale skwierczący żar w piersi uświadomił mu , że nigdy nie byłby na to gotowy .	uświadomił	14	Ind
3 . Unikaj dudniących , hałaśliwych kolumn .	Unikaj	2	Imp
- Zależy mi na tym , by stronnictwo miało zdolność - nie wolę polityczną , ale zdolność - samodzielnego udziału w wyborach parlamentarnych - postraszył liderów Akcji nowy prezes .	postraszył	24	Ind
Potraktuj to , jako kolejną z jej przygód .	Potraktuj	0	Imp
Weronika wytężyła wzrok i ze zdumieniem poznała Krzysztofa .	poznała	6	Ind
Koniecznie zadzwoń i przeproś za zwłokę .	przeproś	3	Imp
Pragniemy , aby powrócili do stołu negocjacyjnego , kierując się względami moralnymi .	powrócili	3	Ind
– Oni się douczą .	douczą	3	Ind
Postaw na nogi wszystkich naszych ludzi od Panama City do Mobile .	Postaw	0	Imp
Nawet porządnie nie poczuła m .	poczuła	3	Ind
Zatrudnił specjalnych doradców , którzy decydowali za niego , jak ma budować swój image .	decydowali	5	Ind
- Ależ wybacz .	wybacz	2	Imp
Kiedy wdychasz powietrze , czuj to .	czuj	4	Imp
Dzieciak wymazał litery .	wymazał	1	Ind
- Jak się będziesz chciał odlać , to lej do pieprzonej szklanki .	lej	8	Imp
Podziękował i wstał .	Podziękował	0	Ind
Tu latają cyklony , podejdą wyżej , będzie wiało od wyżu .	latają	1	Ind
Tomek zsunął się ze skały i podbiegł do nich .	zsunął	1	Ind
Gdy myśleli ście o swoim rodzicielstwie , obiecywali ście sobie nie popełnić ich błędów .	myśleli	1	Ind
– Robisz się religijny , kiedy mówisz o piłce nożnej .	Robisz	1	Ind
– Zróbmy próbę w taką pogodę …	Zróbmy	1	Imp
Nie orientował się też , że popełnia przestępstwo dewizowe .	orientował	1	Ind
Zaproponowane odszkodowanie pokazuje , że pan minister dotrzymał słowa .	dotrzymał	7	Ind
Stoi i patrzy .	Stoi	0	Ind
Przestali bić , kiedy znieruchomiał .	Przestali	0	Ind
Nie pozostawiajmy ich bez opieki .	pozostawiajmy	1	Imp
Niby krzywdy nie robił , bo nie gryzł nigdy , ale wrzasku i wymyślań bywało zawsze co niemiara .	gryzł	7	Ind
Wykręcił się na pięcie i wybiegł na dwór z rozpaloną głową .	Wykręcił	0	Ind
Sprawy przybrały zły obrót , gdy spłonęła rodzinna firma .	przybrały	1	Ind
Nie sprzeciwiaj mi się , dobrze ? . . .	sprzeciwiaj	1	Imp
Nie zapominajmy nigdy o śmierci i o wieczności , - tak jak nam to doradza Pismo święte .	zapominajmy	1	Imp
Nie wiem , czy dożyjemy tego , że przewożone zwierzęta rzeźne , nie będą jeszcze dodatkowo cierpiały - powiedziała nam Anna Baranowska , sekretarz KTonZ .	cierpiały	16	Ind
Usiądź wygodnie , bo chcę przedstawić ci pewien pomysł . . .	Usiądź	0	Imp
- Do środka weszły cztery panie - opowiada Helena Bednarek , właścicielka placówki .	weszły	3	Ind
Kelner ucieszył się .	ucieszył	1	Ind
Dlatego nie wymuszaj na siłę żadnych konkretnych rozwiązań , dbaj o własny wizerunek zawodowy , staraj się poznawać nowych ludzi w branży i czekaj na swój czas .	dbaj	9	Imp
- Rozbierajcie się i chodźcie do środka .	Rozbierajcie	1	Imp
Wytarł szkło do sucha i wymalował pierwsze zdanie .	Wytarł	0	Ind
- Musiała być jakaś akcja - zawyrokował Pawełek .	zawyrokował	6	Ind
Ćwiczyli wojacy z 25 krajów .	Ćwiczyli	0	Ind
Rodzina wyznaczyła mu zadanie - odnaleźć brata , dowieźć na policję .	wyznaczyła	1	Ind
Na stole walały się puste butelki , w pokoju panował zupełny chaos .	walały	2	Ind
- Nie śpiesz z tym .	śpiesz	2	Imp
Pośpiesz się i odłóż to zanim szef wróci .	Pośpiesz	0	Imp
Łamią się piersi , trzeszczy kość , próchnieją dłonie , twarze bledną . . .	Łamią	0	Ind
Odwołał się .	Odwołał	0	Ind
Niestety , lekarz po przybyciu na miejsce orzekł , że ten już nie żyje .	orzekł	7	Ind
16 proc . ankietowanych upiło się w ostatnim miesiącu więcej niż trzy razy .	upiło	4	Ind
Zdenerwowany długo nie mógł wydobyć z kieszeni klucza do swego pokoju , gdy tymczasem zza drzwi dobiegał natarczywy dzwonek telefonu .	dobiegał	16	Ind
- Pomyślał em o tym .	Pomyślał	1	Ind
- Może nie mają broni , ale kto później będzie kontrolował towary , które do Gazy przybędą morzem ?	przybędą	16	Ind
WYKORZYSTAJMY EUROPEJSKĄ SZANSĘ !	WYKORZYSTAJMY	0	Imp
Opiekę sprawuje opiekun .	sprawuje	1	Ind
- Kto wie , czy konsekwencją opowiedzenia się Świerzawy za Jelenią Górą nie byłby wniosek o kolejne referendum , tym razem o włączenie Nowego Kościoła do gminy wiejskiej Złotoryja - zgaduje wicestarosta Adam Zdaniuk .	zgaduje	30	Ind
Nie wspominajcie o ojczyźnie , jej mitach i tradycjach .	wspominajcie	1	Imp
Specjalne brygady w maskach i odzieży ochronnej nadzorowały rzeź ptactwa i dezynfekcję bazarów , targowisk , sklepów i środków transportu .	nadzorowały	7	Ind
Rząd w Ułan Bator w lutym zaapelował o pomoc międzynarodową .	zaapelował	6	Ind
Dobiegł do pierwszych drzew i zniknął w gęstwinie .	Dobiegł	0	Ind
Otóż trzy szczurki w animowanym filmie , przykro mi to mówić z trybuny sejmowej , dokonują egzekucji na żmii , z komentarzem : zabijmy ją , a wszyscy będą się nas bali .	zabijmy	23	Imp
– Wątpię .	Wątpię	1	Ind
Zbiera się za kilka dni .	Zbiera	0	Ind
Sputnik zawirował po raz ostatni , zatrzymał się i zgasł .	zawirował	1	Ind
Wysiadła na zakręcie przed Hagen .	Wysiadła	0	Ind
Nie wymagaj od naszych czegoś więcej .	wymagaj	1	Imp
Trzeba było przekonać prokuratora , aby wniósł sprawę z urzędu .	wniósł	6	Ind
Napiszcie , co robić .	Napiszcie	0	Imp
Zaliczmy banana do żywotnych i nie będzie wyjątku . . .	Zaliczmy	0	Imp
Jedno ucho kopnął niechcący w kąt .	kopnął	2	Ind
20 osób ewakuowano w nocy z czwartku na piątek z domu przy ul. Wawrzyniaka .	ewakuowano	2	Ind
Potem szli na romantyczny spacer , przytulali się i całowali .	całowali	9	Ind
Dorobił on do niej akompaniament gitarowy .	Dorobił	0	Ind
" W przededniu święta Wyzwolenia Stolicy – gdakał spiker postawionym głosem filmowego amanta – całe społeczeństwo i władze Autonomicznej Republiki Nadwiślańskiej oddają hołd radzieckim wyzwolicielom Warszawy z pęt faszyzmu , imperializmu i nacjonalizmu " .	oddają	21	Ind
Wódz zacisnął sine wargi .	zacisnął	1	Ind
Chorąży Nałęcz - Komornicki wydawał swoim moździerzystom komendy spokojnie i prawie beznamiętnie .	wydawał	4	Ind
Ale już nie zdążyli , na pozostałym kawałku lądowały niemieckie dywizje pancerne .	lądowały	8	Ind
Po drugie : - Pieniądze płynęły od albańskich biznesmenów - wylicza Arben Majal - którzy zamiast inwestować w przemysł , w rozwój swych własnych firm , cały zysk pakowali do piramid .	pakowali	28	Ind
Proszę ułożyć mi coś , żeby ludzie zębami zgrzytali , włosy darli , płakali , ale i równocześnie wroga szukali . . .	szukali	19	Ind
Dojadła z pudełka zapomniany kwadracik ptasiego mleczka , nalała sobie francuskiego strzemiennego i po prawie suchych posadzkach ruszyła ku wyjściu .	ruszyła	17	Ind
tak się kroi go i tak się macza w tym sosie .	macza	7	Ind
Bała m się , że już nic mi w życiu nie wyjdzie .	Bała	0	Ind
Opadał kurz w uliczce i cuchnęły w upale spaliny pracujących silników .	cuchnęły	5	Ind
Przede wszystkim wywozili ruchomy majątek i żywność .	wywozili	2	Ind
Zadzwonimy do Patrycji . . .	Zadzwonimy	0	Ind
Podlewajcie kwiaty .	Podlewajcie	0	Imp
Policja od razu wszczęła dochodzenie .	wszczęła	3	Ind
Ale nie chciała chodzić , udawała , że nic nie rozumie .	udawała	5	Ind
15 . Nawet gdy nie jestem wystarczająco przygotowany do egzaminu lub rozmowy z szefem , po prostu wchodzę i zdaję lub rozmawiam .	wchodzę	17	Ind
Raz zrobili wyłom w murze cmentarnym , kiedy indziej wymusili sobie przejście przez cmentarz do przyklasztornego ogrodu " - przypomniał mi się fragment z opisu Majera Bałabana .	zrobili	1	Ind
- Z czym się państwu kojarzy Pamela Anderson i Kasia Figura - krzyczał do publiczności Artur Orzech - piersi , oczywiście !	kojarzy	5	Ind
Podobnie jest ze świeczkami , ustawmy je tak , by kot nie mógł ich strącić .	ustawmy	5	Imp
W najbliższych dniach Warszawy nie zasypią śmieci .	zasypią	5	Ind
To stawcie im czoło i zabierzcie kilku ze sobą .	stawcie	1	Imp
Działajmy nocą , najlepiej na kolanach .	Działajmy	0	Imp
Może nawet zdecydujecie czy też nie , że zależy wam na powrocie .	zdecydujecie	2	Ind
W Rumunii pilnowały go trzy służby : policja polityczna rumuńska , gestapo i ludzie Stanisława Kota .	pilnowały	2	Ind
12 . 5 . Tulipany rosnące wprost przed moim oknem ( mieszkam przy Bradmore Road w suterenie ) zauważyłem dopiero wówczas , kiedy jednemu z nich opadł płatek .	opadł	26	Ind
Podniosła m się .	Podniosła	0	Ind
Mieszkańcy grożą , że zablokują ulice .	zablokują	4	Ind
Przyjechał tu na Milkowszczyznę już jako doktor .	Przyjechał	0	Ind
Ale i to nie pomogło .	pomogło	4	Ind
Obieram szparagi , bardzo krótko blanszuję we wrzącej wodzie , studzę , pakuję w woreczki i zamrażam na kamień w zamrażarce .	studzę	10	Ind
Aspirant przerzucił kilka kartek w notesie .	przerzucił	1	Ind
Wymień jedną rzecz , którą republikanie uczynili dla czarnych .	Wymień	0	Imp
Popełniasz błąd .	Popełniasz	0	Ind
W siedzibie kłodzkiego starostwa powiatowego dowiaduję się , że Średzińskiego nie lubią tu , bo to postkomuch , a powiatem rządzi egzotyczna koalicja złożona z platformersów i byłych pisowców .	rządzi	20	Ind
- Chodźmy , siostry .	Chodźmy	1	Imp
Nie przeszkadzaj , póki nie będzie piętro nad nami .	przeszkadzaj	1	Imp
– Robię to tylko z nudów .	Robię	1	Ind
Sanepid nakazał zamknięcie basenu .	nakazał	1	Ind
Posłuchajcie , prześmiewa się z naszej drogi , chichocze .	Posłuchajcie	0	Imp
Przyjmijmy tu zdrowe minimum tego pojęcia : pewne cechy i talenty występują u jednych narodów częściej niż u innych , Niemiec lubi piwo , Francuz wino i tak dalej .	Przyjmijmy	0	Imp
Na wojnę odpowiedzmy wojną .	odpowiedzmy	2	Imp
- Dostałam twój list , przyjedź , jeśli chcesz . . .	przyjedź	5	Imp
– Widownia ze zrozumieniem pokiwała głowami .	pokiwała	4	Ind
- Zanim nauczył się czytać i pisać , umiał już obsługiwać komputer - śmieje się dyrektor .	nauczył	2	Ind
Program ten nie jest standardowo instalowany wraz z systemem , należy go zainstalować używając modułu Panelu Sterowania " Dodaj / Usuń programy " .	Dodaj	18	Imp
grasz no .	grasz	0	Ind
- Szoruj , no !	Szoruj	1	Imp
POMÓŻCIE ! ! ! ! ! ! ! ! ! ! ! ! ! ! ! ! ! ! ! ! !	POMÓŻCIE	0	Imp
Czy ja powiedziała m , że nie ufam Jezusowi ?	ufam	7	Ind
– Powieś hamak i połóż się w nim .	Powieś	1	Imp
A poza tym , w kwestiach kuchni w szkołach i sprzątania szkół , dobrem dzieci zasłania się przede wszystkim chęć utrzymania własnego stołka .	zasłania	15	Ind
Dystychy , analizowane dotąd oddzielnie , złóżmy obecnie w całość , bo przecież w Dusiołku tworzą one taką całość .	złóżmy	6	Imp
1 . Naciśnij klawisze [ Alt + O ] - na ekranie pojawią się puste matryce dla litery " Ó " .	Naciśnij	2	Imp
Każ opuścić włócznie !	Każ	0	Imp
- Wytłumaczysz .	Wytłumaczysz	1	Ind
Wynajmujemy pokój prywatny w biurze obsługi turystów .	Wynajmujemy	0	Ind
- Wyznaczyli nas na działon przeciwpancerny .	Wyznaczyli	1	Ind
Nie pobudziła m .	pobudziła	1	Ind
Rodzina Chmurów zręcznie z niej wybrnęła .	wybrnęła	5	Ind
- Urwał , machnął ręką , pochylił się do mnie .	Urwał	1	Ind
To pochlebia facetom .	pochlebia	1	Ind
Nie wiem , więc powiedz mi i pozwół mi zrzucić kamień z serca	pozwół	7	Imp
- Zagroził , że mnie przeklnie , rzuci na mnie urok i zaszkodzi mi na zdrowiu - żaliła się przed sądem na bioenergoterapeutę poszkodowana Zofia Ż .	rzuci	7	Ind
Gdy jest wystarczająco gorąca , ale nie parzy , rozsypujemy ją na łóżku i nakrywamy kocem , na którym kładziemy chorego .	rozsypujemy	9	Ind
I jak opowiadał nieżyjący już pan Czesław Masztalerz - najpierw zastrzelono dzieci , a potem śmiertelnie raniono matkę , która dogorywała w kałuży krwi .	dogorywała	20	Ind
Szacki wytarł usta serwetką .	wytarł	1	Ind
Dyrektor denerwuje się : - Bombardujemy ministerstwo o zmianę ustawy z 1982 roku o postępowaniu w sprawach nieletnich .	Bombardujemy	5	Ind
Milczący Europaci , ściskając między nogami aktówki , wypijają kolejne puszki piwa i miażdżą je w dłoniach .	miażdżą	13	Ind
Aresy umacniaja Cię w poczuciu , że NASA swietnie kosztorysuje swoje przedsięwzięcia , oraz dotrzymuje harmonogramów .	kosztorysuje	9	Ind
Na razie bowiem sprawa ta przedstawiała jej się jako tragiczne , oszałamiające bogactwo życia , od którego czuła się odrzuconą i to odrzuconą nie tylko sama .	przedstawiała	5	Ind
Ślęczy więc w londyńskich księgozbiorach , bada ślady , analizuje , przepisuje i kseruje co ciekawsze materiały .	Ślęczy	0	Ind
Niech pan mu się jeszcze raz przyjrzy !	przyjrzy	6	Ind
Scharakteryzuj je dokładnie " oraz " Opisz , jakimi mechanizmami obronnymi : a ) posługiwałeś się pijąc alkohol , b ) posługujesz się teraz ( będąc tu w oddziale ) " .	Opisz	6	Imp
Przed drzwiami sali rozpraw siedzieli uzbrojeni antyterroryści .	siedzieli	4	Ind
Kup ją , a przekonasz się , że odmieni także twoje .	Kup	0	Imp
- Idźcie na dół .	Idźcie	1	Imp
Prowadźcie mnie do głównego .	Prowadźcie	0	Imp
- Zakop obok coś żelaznego - poradziłem , zastanawiając się , czy dobrze robię .	Zakop	1	Imp
Przejrzyj akta pracowników banku i dojdź do odcisków faceta nazwiskiem Ipkiss . . .	Przejrzyj	0	Imp
Ten zaś wywodził się z rycerzy , którzy byli towarzyszami króla Bolesława Krzywoustego .	wywodził	2	Ind
Obstępują solenizanta , śpiewają sto lat , a maluchy wręczają kolorowe paczki .	Obstępują	0	Ind
Papieros sparzył mi palce , rzuciłem go w śnieg .	sparzył	1	Ind
Gwarantuje ona , że fundusze strukturalne nie zastąpią publicznych ani równoważnych wydatków strukturalnych danego państwa członkowskiego .	Gwarantuje	0	Ind
Policja identyfikowała ofiary na podstawie znalezionych przy nich przedmiotów osobistych .	identyfikowała	1	Ind
Górnośląska dziurawi się jak ser , a zaklejanie rozsypującego się asfaltu jest jak walka z wiatrakami .	dziurawi	1	Ind
Człowiek zeskakuje na snowboardzie z ośnieżonej skały .	zeskakuje	1	Ind
4 . Postaraj się , aby w rozmowie uczestniczył współmałżonek - rozmowa ma dotyczyć spraw całej rodziny , a umowy powinny być respektowane przez wszystkich jej członków .	Postaraj	2	Imp
Jednak herculesy będą stacjonowały w Powidzu i obecnie szkolą się do ich obsługi eksperci wojskowi .	szkolą	8	Ind
W niedzielę świątynia jest pełna i wszyscy wierzą , że znowu będzie tutaj diecezja .	wierzą	7	Ind
Raz na cztery lata wybieramy swoich przedstawicieli do rad gmin .	wybieramy	4	Ind
Na zakupy zabierajmy ze sobą koszyk lub płócienną torbę .	zabierajmy	2	Imp
Zrozumiesz , że mimo odwagi i ambicji " nie sposób iść przez życie wieloma drogami jednocześnie " ( Pitagoras ) .	Zrozumiesz	0	Ind
Pozbył się balastu , nim ten balast odebrała mu zamieć historii .	odebrała	7	Ind
Coś knuł , a ja nie potrafiłam określić co .	knuł	1	Ind
Im więcej maku przyklei się do sufitu , tym więcej szczęścia będzie w nadchodzącym roku .	przyklei	3	Ind
Jakiś Geoge Stevenson wynalazł czajnik na kółkach ,	wynalazł	3	Ind
Teraz wynajmuje mieszkanie w Rzeszowie .	wynajmuje	1	Ind
Mężczyzna w słuchawkach ochronnych na uszach wycina z drewna figurę , używając piły .	wycina	6	Ind
Uśmiechnęła się do córki ze swej błogiej dali .	Uśmiechnęła	0	Ind
Wlazło mu sekundował .	sekundował	2	Ind
Niebacznie stanął pod nawisem , oberwało się i przywaliło .	oberwało	5	Ind
- Gadaj .	Gadaj	1	Imp
- Mówiąc to Leon witał się z matką .	witał	4	Ind
Weź Lolkę i idźcie na górę .	idźcie	3	Imp
Ze strony zakonów odpowiadano sloganem : " Ile wina w brzuchu , tyle mocy w duchu " .	odpowiadano	3	Ind
Na groblach wybudowano jedenaście betonowych śluz wałowych .	wybudowano	2	Ind
Leżymy na łóżku i oglądamy film .	oglądamy	4	Ind
Alex niby rozluźniony , a jednak trochę nerwowo podnosi pokrywki , zagląda do jednego garnka , do drugiego .	zagląda	11	Ind
Znajdź i natychmiast mnie z nim połącz .	Znajdź	0	Imp
Kochaj siebie !	Kochaj	0	Imp
Le Pen straszy zjednoczoną Europą .	straszy	2	Ind
Mężczyznę uwolnił dopiero inny pracownik , który zszedł do piwnicy , w której znajdują się pomieszczenia magazynowe .	uwolnił	1	Ind
Potem opłukała naczynia i ustawiła na drucianej kratce , by obeschły .	obeschły	10	Ind
W numerze wydanym przez Movex rzuca się w oczy kilkustronicowy wstępniak .	rzuca	5	Ind
No idź już , wracaj do powozu .	wracaj	4	Imp
Edytuj listę zmiennych środowiskowych i związanych z nimi wartości	Edytuj	0	Imp
Pokochał em włoską dziewczynę .	Pokochał	0	Ind
Konstruuje jakieś sprzęty do badań meteorologicznych .	Konstruuje	0	Ind
Choć i wtedy potrafiła go zaskoczyć – wracała niespodziewanie dzień wcześniej lub wpadała do znajomego , gdzie grali w karty i rozkazywała mu powrót do domu .	rozkazywała	21	Ind
Poczuła swą kobiecość i było z tym cudownie .	Poczuła	0	Ind
Belgijskie MSZ potwierdziło , że wśród ofiar śmiertelnych zamachu zidentyfikowano obywatelkę Belgii .	potwierdziło	2	Ind
Produkty na bieżąco sortują się według tych parametrów , jakie wybrał klient – dlatego tak ważne jest szczegółowe sprecyzowanie własnych potrzeb .	sortują	3	Ind
Od roku 1994 ( gdy śmierć poniosło 103 przedstawicieli mediów ) liczba mordowanych podczas pracy dziennikarzy z roku na rok maleje .	poniosło	6	Ind
Dlatego nie wymuszaj na siłę żadnych konkretnych rozwiązań , dbaj o własny wizerunek zawodowy , staraj się poznawać nowych ludzi w branży i czekaj na swój czas .	staraj	15	Imp
– ja by m dopowiedział do tego .	dopowiedział	4	Ind
Kiedy wrócisz do domu , napisz jego imię na kartce 7 razy .	napisz	5	Imp
Definitywnych ustaleń jeszcze nie ma , ale strony osiągnęły znaczne zbliżenie .	osiągnęły	8	Ind
Ale ujęli sporo .	ujęli	1	Ind
Niemniej jednak chcielibyśmy podkreślić , że konsumenci nabywają także wiele towarów w krajach i regionach spoza UE , takich jak Stany Zjednoczone lub Azja .	nabywają	7	Ind
Około północy nadciągnął sztorm i śnieżyca .	nadciągnął	2	Ind
Tassilo de Tresckow zajechał go i ciął mieczem .	ciął	6	Ind
Ale przedtem wyceń mnie .	wyceń	2	Imp
Tuli się do wychowawczyni i nie daje się ukoić nawet za pomocą najładniejszego pluszaka .	Tuli	0	Ind
1 . Przywitaj się z gospodarzem ; on pomoże ci poczuć się jak u siebie .	Przywitaj	2	Imp
Powtarzaj je tak często , jak to jest potrzebne .	Powtarzaj	0	Imp
Jeśli zatem jeszcze kiedyś natkniesz się na promocję gminy czy miasta w stylu : " Inwestujcie u nas ! Tu pieniądze leżą na ulicy ! " to już wiesz o co chodzi .	Inwestujcie	15	Imp
Patrz rozdziały „ Integralność psychiczna ” i „ Tortury ” .	Patrz	0	Imp
Witam wszystkich klubowiczów ! ! !	Witam	0	Ind
Znaleziono przy nich skradzione zegarki oraz pistolet - straszak .	Znaleziono	0	Ind
Polska i Izrael podpisały wczoraj umowę o zniesieniu obowiązku wizowego .	podpisały	3	Ind
Obie części składamy podszewką do środka , zszywamy po brzegach , obszywamy lamówką .	zszywamy	7	Ind
Poślij po niego , niech przyjdzie i zaświadczy .	Poślij	0	Imp
Truchtali spokojnie , bez pośpiechu , z przodu dostrzegli sylwetkę w zielonym mundurze , zbliżyli się powoli .	zbliżyli	14	Ind
Jeżeli Golędzinów nadjedzie , wygra wielką stawkę .	nadjedzie	2	Ind
Bardzo zależy nam na tym , by wokół uniwersytetu budowała się społeczność nie tylko naukowa , ale również taka , która ułatwi naszym absolwentom poruszanie się w ich dalszym zawodowym życiu .	budowała	9	Ind
Skinęła głową .	Skinęła	0	Ind
Puszczaj , bo zabiję !	Puszczaj	0	Imp
Jak pani zareagowała ?	zareagowała	2	Ind
Ja klękam , uklęknijcie ze mną . . .	uklęknijcie	3	Imp
Hill startował z pole position , ale już na pierwszych metrach wyprzedził go kolega z zespołu David Coulthard .	wyprzedził	11	Ind
Odpowiedz na nie też .	Odpowiedz	0	Imp
Utnij na dwie dulki i schodź , bo palić się strasznie chce .	Utnij	0	Imp
- To ja , mamusia - słychać znowu - zapomniałam kluczy , otwórz !	otwórz	12	Imp
Nie pozwól , by ścigali cię na oko .	pozwól	1	Imp
I uważaj , co mówisz !	uważaj	1	Imp
– Nie piernicz .	piernicz	2	Imp
" Podatki za Hitlera były dwa razy niższe niż obecnie i Adolf Hitler wyzyskiwał Polaków dwa razy mniej niż nasi obecni okupanci z Unii Wolności , SLD , PSL i AWS .	wyzyskiwał	13	Ind
W milczeniu uścisnęli sobie ręce .	uścisnęli	2	Ind
Jeśli chcesz byc miły znajdź kogoś do naprawy kapania spod zlewu kuchennego .	znajdź	4	Imp
Wielokrotnie groził Cyganom zemstą za oskarżenia .	groził	1	Ind
zadzwoń o dwunastej .	zadzwoń	0	Imp
- Wsiadaj - usłyszałem głos Leszka .	Wsiadaj	1	Imp
Nie słuchaj ich wszystkich , nie czytaj żadnych książek .	czytaj	6	Imp
Oddały ster rządów lewicy .	Oddały	0	Ind
Niewytłumaczalna zbrodnia wstrząsnęła Polską .	wstrząsnęła	2	Ind
Maruderów dziarsko pochlastał eś . . .	pochlastał	2	Ind
Przeżył , bo udał , że jest martwy .	Przeżył	0	Ind
Mój plecak i torbę podróżną wciągnięto na dach i wrzucono na stertę bagaży z precyzyjną i nonszalancką brutalnością ; widziałem to i postanowiłem nie rozstawać się z gitarą .	wciągnięto	5	Ind
Nie martw się o niego , Cindy .	martw	1	Imp
Więc po jaką cholerę skarżysz mi się tutaj , kto co zaczął ?	skarżysz	4	Ind
Angażowały też prywatnych przewoźników .	Angażowały	0	Ind
Radny Krzysztof Krzeszowski wylicza podobne przypadki także w innych szkołach .	wylicza	3	Ind
Odbył jedynie krótką telefoniczną pogawędkę z prezydentem ZSRR Gromowem .	Odbył	0	Ind
Wyprowadzają one małe koźlęta na płaty śniegu i uczą je zjeżdżać na racicach .	Wyprowadzają	0	Ind
Jeśli w sercu pojawi się niepewność , nie dramatyzuj .	dramatyzuj	8	Imp
Wikary Pudło odprawia je żując gumę .	odprawia	2	Ind
Rodzice nie będą już mogli wmawiać swoim pociechom , że przynosi je bocian bądź znaleziono je w kapuście .	przynosi	10	Ind
spojrzała na tablicę odlotów , wybrała miejsce i poleciała .	wybrała	5	Ind
- Legnij !	Legnij	1	Imp
W treści oskarżenia rysuje się droga tożsamości .	rysuje	3	Ind
Do godziny drugiej po południu wszystko toczyło się normalnie .	toczyło	6	Ind
Drzwi otwierają się i zatrzaskują za nimi .	zatrzaskują	4	Ind
Ktoś nawet przeraźliwie zagwizdał na palcach .	zagwizdał	3	Ind
Przyjdź do kawiarni Conga na alei Suzuran o 9:00 .	Przyjdź	0	Imp
Zbliżają się ferie , już niedługo pociągi z Warszawy do Zakopanego zapełnią się młodzieżą .	Zbliżają	0	Ind
Jacques niecierpliwie strzepuje pyłek z klapy marynarki .	strzepuje	2	Ind
I mimo chciwości cieszyli się w miasteczku dużym szacunkiem .	cieszyli	3	Ind
Pseudokibicom ze Stalowej Woli upiekło się , choć nieźle w sobotę nabroili .	nabroili	11	Ind
Komisja publikuje odpowiednie ogłoszenie w Dzienniku Urzędowym Unii Europejskiej serii C .	publikuje	1	Ind
Wchodzę do środka i natykam się na dozorcę .	natykam	4	Ind
Teraz to wszystko staje się naprawdę , doczekał się Stefan Chmura Piaskowej Góry .	doczekał	7	Ind
Uśmiechnij się do nich i zejdź im z oczu .	Uśmiechnij	0	Imp
– Ubierz się jakoś , do ludzi idziesz .	Ubierz	1	Imp
- Tak , zadzwonię do Alexandra i zapytam .	zadzwonię	3	Ind
Przejdź w żółty , ale z bajerem .	Przejdź	0	Imp
ludzie , jak dostają coś takiego , w pierwszej chwili myślą , że źle policzyli zera .	policzyli	14	Ind
Znamy się od kilku lat , więc kiedy Krzysztof powiedział , że dostają klucze do własnego mieszkania na warszawskim Gocławiu , nie mieliśmy wątpliwości , że to właśnie my zajmiemy się aranżacją wnętrz .	zajmiemy	29	Ind
Pisał , że wszystko przyszło dla niego za późno .	Pisał	0	Ind
- Ucząc języka , jednocześnie budzimy w dzieciach intelekt , ciekawość świata .	budzimy	5	Ind
- Nie sypiasz od dawna , co się dzieje ?	sypiasz	2	Ind
Pocisk przeleciał na tyle blisko , że podmuch zatrzasnął mi klapę nad głową .	przeleciał	1	Ind
- Bezgranicznie jej ufał em .	ufał	3	Ind
Kobieta w tradycyjnym stroju przytrzymuje ręką białe futro na ramionach .	przytrzymuje	4	Ind
– Może napisz do niej .	napisz	2	Imp
Dlatego nie wymuszaj na siłę żadnych konkretnych rozwiązań , dbaj o własny wizerunek zawodowy , staraj się poznawać nowych ludzi w branży i czekaj na swój czas .	wymuszaj	2	Imp
- Prowadź mnie asan - i czknął mu w samą twarz .	Prowadź	1	Imp
Zaprojektował ją Franz Loibner .	Zaprojektował	0	Ind
- Czy firmy chętnie się godzą na podział budżetu ?	godzą	5	Ind
Zgłoś się …	Zgłoś	0	Imp
Ale Hatora też nie pilnowała się żadnego szlaku : rżnęła prosto - łozy nie łozy , błoto nie błoto , ruczaj nie ruczaj .	pilnowała	4	Ind
Stanowią ważne ostrzeżenie , nie mogą jednak bez dalszych badań być traktowane jako całkowicie wiarygodne [ patrz : Żywność Frankensteina ? , " WiŻ " nr 5/1999 ] .	patrz	16	Imp
Jeden z Agentów wytropił wiadomość ( 60546.fizjks@iftia.univ.gda.pl ) , w której J . Sikorski mówi : Właśnie o to chodzi .	wytropił	3	Ind
Wyglądały wręcz jak narzędzia wytwarzane przez Homo sapiens .	Wyglądały	0	Ind
Spędzali wspólnie wakacje , łowiła z nim motyle i modliszki , to on nauczył ją pływać .	łowiła	4	Ind
Zaproponowali , że przeproszą , i obiecali poprawę .	przeproszą	3	Ind
Odbyły się już spotkania .	Odbyły	0	Ind
- Siadaj .	Siadaj	1	Imp
W rozbite pojazdy uderzyła jeszcze jedna ciężarówka .	uderzyła	3	Ind
Wyraźnie za Basajewem nie przepadał .	przepadał	4	Ind
Pozmywaj i ogarnij kuchnię .	ogarnij	2	Imp
- Na rynku dostajemy za nasze diamenty , zależnie od jakości , o 13 - 35 proc . więcej niż płaci nam De Beers - twierdzi Leonid Guriewicz z Komitetu Metali i Kamieni Szlachetnych .	płaci	20	Ind
Seks z facetem , który po wszystkim założy spodnie i " czmychnie do partnerki " .	czmychnie	11	Ind
One zupełnie abstrahują od dokonującej się rewolucji informatycznej i od tego , że struktury decyzyjne w Unii Europejskiej wymagają odmiennych struktur organizacyjnych , ponieważ trzeba tam w ciągu tygodnia podejmować decyzje .	abstrahują	2	Ind
I oto w ONZ przemawia nowy prezydent Kwaśniewski .	przemawia	4	Ind
Mężczyźni i kobiety siedzą smutni , ale solidarni , bo jak się roześmieją , to z ekranu wyskoczy bestia i ich zje .	zje	21	Ind
Musieli się przebić przez ludzkie gromady idące w przeciwnym kierunku .	Musieli	0	Ind
- Pocałował em go .	Pocałował	1	Ind
Zapalono wszystkie lampy , ustawiono ruchome wieszadła , kelnerzy w oczekiwaniu gości spacerowali po korytarzach hotelowych .	ustawiono	4	Ind
- Rzadko nie znaczy wcale - ripostowali sędziowie .	ripostowali	6	Ind
Skinęła głową , przyciągnęła Istvana ku sobie , całowała w policzek .	przyciągnęła	3	Ind
Najwyraźniej przebiegł przez holo tej reklamy .	przebiegł	1	Ind
– nie opisuj tylko zjedz . .	zjedz	4	Imp
- Skaczesz , rozglądasz się i wracasz .	rozglądasz	3	Ind
Biedny ptak , z szeroko otwartym dziobem , zwisał głową w dół , niby ułamana z krzewu kiść .	zwisał	8	Ind
Wirował nad domami i zaczęło go trząść .	Wirował	0	Ind
Fasada pachnie jak sklep kolonialny , oficyna cuchnie jak dół z padliną .	pachnie	1	Ind
Zaprojektowano specjalną okazałą szafę z 205 boksami .	Zaprojektowano	0	Ind
Powróćmy do Krakowa .	Powróćmy	0	Imp
- Nie ucz dziada , jak charchać !	ucz	2	Imp
Kobiety już niosą dla nas prowiant !	niosą	2	Ind
Gdy na miejscu zjawili się policjanci z komisariatu kolejowego policji , schronisko znajdowało się w opłakanym stanie .	zjawili	3	Ind
1 . Załóż bieliznę , a potem wykonaj dla niego striptiz , kołysząc biodrami jak mieszkanka Karaibów .	wykonaj	7	Imp
- Coś nieprawdopodobnego ! - bulwersował się starszy mężczyzna , który to zobaczył .	bulwersował	5	Ind
Odczuł em zaraz lekki niepokój .	Odczuł	0	Ind
Nie jedzmy w nadmiarze trzech “ białych trucizn ” : cukru , mąki , soli .	jedzmy	1	Imp
Jeśli kiedykolwiek ćwiczyłeś jogę , tai chi lub inne techniki relaksująco - koncentrujące - powtórz je dziś .	powtórz	14	Imp
I zjechawszy na kolana gorzko zapłakał zapominając , że patrzą na niego ludzie .	zapłakał	5	Ind
W ostatniej minucie klęskę kolończyków przypieczętował Marcel Witeczek .	przypieczętował	5	Ind
Patrz przed siebie i czytaj w brodzie .	Patrz	0	Imp
Konia by powaliło .	powaliło	2	Ind
I wojna światowa strąciła nam z głowy te cudeńka .	strąciła	3	Ind
- Mój pies też aportuje - zaśmiał się pogardliwie - tylko mu trzeba rzucić . . .	aportuje	4	Ind
No , włóż szybko koszulę !	włóż	2	Imp
Przy podniesieniu w czasie mszy używa się według Antegnatiego solowego rejestru pryncypalnego o bardzo delikatnym brzmieniu .	używa	5	Ind
Zabił się na miejscu .	Zabił	0	Ind
Położyli na drabiniastym wozie .	Położyli	0	Ind
- Nie jedź do Jerozolimy !	jedź	2	Imp
Ten film zmusza do myślenia .	zmusza	2	Ind
Sesję zorganizował Zakład Słowianoznawstwa PAN .	zorganizował	1	Ind
Jednak herculesy będą stacjonowały w Powidzu i obecnie szkolą się do ich obsługi eksperci wojskowi .	stacjonowały	3	Ind
- Połóżmy się tu i odpocznijmy .	Połóżmy	1	Imp
– a do Dusznik jedziecie ?	jedziecie	4	Ind
– Czy jest osiągalna , słuchaj . . .	słuchaj	5	Imp
Jest więc oczywiste , że podejmując decyzje administracyjne będzie ulegał naciskom politycznym .	ulegał	9	Ind
Idź lepiej na podwórze , pobiegaj !	pobiegaj	5	Imp
Degraduję cię ! - rozdarł się zwykle łagodny Jasio .	Degraduję	0	Ind
- A trafisz ?	trafisz	2	Ind
- Biegnij ! - krzyknął .	Biegnij	1	Imp
Tego naprawdę nie widzi się codziennie , więc jeśli chcecie obejrzeć kolejną część , to łapki w górę i lajkujcie .	lajkujcie	19	Imp
Dawaj , bo zarzygasz .	Dawaj	0	Imp
- Obrzuciła go karcącym spojrzeniem .	Obrzuciła	1	Ind
Rozmawiał em z nim wczoraj o tym .	Rozmawiał	0	Ind
Przenieść ilościowo do kolby pomiarowej o pojemnosci 250 lub 500 ml ( patrz tabela ) .	patrz	12	Imp
Robią tu pamiątkowe zdjęcia i kupują drobiazgi .	Robią	0	Ind
MILENA : Będę musiała wrócić ; Michał , zrozum , zostawiłam męża i dziecko !	zrozum	8	Imp
Cagliostro krzyknął z bólu .	krzyknął	1	Ind
- Myślisz ?	Myślisz	1	Ind
- Są dwa wyjścia , albo usunąć ten znak , ponieważ tylko dezorientuje kierowców , albo postawić jeszcze jeden znak , który sygnalizowałby o tym , iż na ulicy jest ruch dwukierunkowy - powiedział .	dezorientuje	12	Ind
PRZYGOTUJ SIĘ .	PRZYGOTUJ	0	Imp
Zwycięzcy gratulujemy !	gratulujemy	1	Ind
W swoim Zeszycie wpisz tytuł " Jestem słoniem - skala zadowolenia z siebie " przerysuj skalę i po każdym etapie przypisz sobie odpowiednią ocenę .	przerysuj	14	Imp
Kompromitowali nie tylko siebie , ale i Polskę .	Kompromitowali	0	Ind
Bank obniżył kredyty hipoteczne denominowane w dolarach o 2 proc . na okres pierwszych dwóch lat .	obniżył	1	Ind
- Idź , już idź - popychała w stronę drzwi .	popychała	6	Ind
- Teraz nadszedł czas , by śmy się moralnie zrewanżowali .	zrewanżowali	9	Ind
Wiem , że tu przyjdziecie .	przyjdziecie	4	Ind
Nie sądź , a nie będziesz sądzony , uspokoiła się .	sądź	1	Imp
Francuzi nadal atakowali w tradycyjny sposób i wystawiali się na rzeź , nie zbliżywszy się nawet do angielskich szeregów .	atakowali	2	Ind
Przypomnijmy , że przed laty Jelcyn nie wysiadł na spotkanie z irlandzkimi władzami .	wysiadł	7	Ind
Weźmy jako przykład zagadnienie pejzażu .	Weźmy	0	Imp
Bogu zawierzam i w Bogu pokładam nadzieję .	zawierzam	1	Ind
Zwodujcie Wałęsę .	Zwodujcie	0	Imp
W nowej stodole założę elektryczność .	założę	3	Ind
- Odpocznijmy - odezwał się z tyłu .	Odpocznijmy	1	Imp
Zatrzymał dwa konie rycerza , jako gwarancję jego powrotu , a w zamian dał mu ich równowartość w gotówce .	Zatrzymał	0	Ind
Postarajmy się wyśledzić je od początku .	Postarajmy	0	Imp
MARIA : - Przepraszam , że przerywam , ale zaszło jakieś nieporozumienie .	przerywam	6	Ind
Przy stoliku zaległa cisza .	zaległa	2	Ind
Jeśli w sercu pojawi się niepewność , nie dramatyzuj .	dramatyzuj	8	Imp
Próbowała raz uciec ; nie udało się .	Próbowała	0	Ind
Reanimowali Piotra .	Reanimowali	0	Ind
Słone przekleństwa dolatywały aż do ostatniego wozu .	dolatywały	2	Ind
Mrok starł z jej ramion i piersi śliczną pozłocistość .	starł	1	Ind
Bez trudu ripostował wszystkie argumenty szefów magistratu .	ripostował	2	Ind
- Może lepiej nam się poszczęści .	poszczęści	5	Ind
Walka w hotelu Grand MGM musiała rozczarować tych miłośników pięściarstwa , którzy oczekiwali czystego , arcyciekawego pojedynku .	oczekiwali	12	Ind
Od niego dowiem się najlepiej .	dowiem	2	Ind
- Powtórz .	Powtórz	1	Imp
Niektórzy okażą się rzeczywiście sprawni i fachowi .	okażą	1	Ind
Powiedzmy , oglądam program w telewizji i wrzucam uwagę , że jest zajebisty , a powiedzmy , Monika Olejnik czy Krzysztof Ibisz odpisują mi na żywo , że fajny ze mnie kolo .	powiedzmy	15	Imp
Poruszyły się wskaźniki na podświetlanych zegarach .	Poruszyły	0	Ind
Chętnie porozmawiam na ten temat .	porozmawiam	1	Ind
Wzrasta temperatura rozmów o prawyborach w AWS .	Wzrasta	0	Ind
Czym ukoimy skołatane nerwy , co wypijemy na pocieszenie zgnębionych serc , a przede wszystkim na czym oprzemy narodową tożsamość ?	oprzemy	17	Ind
Nie sądzi pan , że te kłamstwa kompromitują naukę scientologiczną ?	kompromitują	7	Ind
Dwa czarne psy wskakują do basenu , w którym pływa gumowa zabawka .	wskakują	3	Ind
Biadoli , że Trzęsionka doniesie im o naszym pijaństwie .	Biadoli	0	Ind
Nie pozwól , by ścigali cię na oko .	pozwól	1	Imp
- Witaj , synu Arana .	Witaj	1	Imp
Złote lata się skończyły .	skończyły	3	Ind
Postarajmy się wyśledzić je od początku .	Postarajmy	0	Imp
Kiedyś myślała o zmianie pracy - wtedy dano jej podwyżkę .	dano	7	Ind
Unikaj słów o podwójnym znaczeniu .	Unikaj	0	Imp
Druhowie usunęli starą boazerię , gipsowali i malowali ściany , zamontowali drabinki do ćwiczeń i lampy oświetleniowe .	zamontowali	10	Ind
Opodal trenowali skoki chłopcy na deskorolkach .	trenowali	1	Ind
Parasolki raczej zostawcie w domu , bo wysłaliśmy specjalne zamówienie do zaklinaczy pogody w Kamerunie .	zostawcie	2	Imp
Dlatego nie wymuszaj na siłę żadnych konkretnych rozwiązań , dbaj o własny wizerunek zawodowy , staraj się poznawać nowych ludzi w branży i czekaj na swój czas .	czekaj	23	Imp
- To panu w Komitecie nic nie mówili ? - wykrztusił Batura :	wykrztusił	10	Ind
Ciagnę tradycje rodzinne i asymiluję je z tradycjami rodzinnymi tych , którzy stali się udziałem wspólnych teraz naszych rodzinnych zwyczajów .	asymiluję	4	Ind
W Wielkopolsce na nową maturę zdecydowało się 522 abiturientów .	zdecydowało	5	Ind
Idę na przystanek autobusowy .	Idę	0	Ind
Dyrektor wymienia imprezy , które zorganizował .	zorganizował	5	Ind
Do określenia procentu ziarna , które w całości lub częściowo utraciło szklistość , wykorzystuje się jedynie część próbki .	utraciło	10	Ind
Psychiatra przysuwa krzesło do leżanki i siada obok Bartodzieja z notesem w ręku .	przysuwa	1	Ind
Prezesa Naczelnego Urzędu Cenzury powołuje Sejm .	powołuje	4	Ind
Nie chcę , by jakoś specjalnie się mną opiekowano czy głaskano .	głaskano	10	Ind
Bądź w kontakcie z nauczycielami swoich dzieci – dowiedz się , jak sprawują się w szkole , na ile ich zachowania w klasie są podobne do tych w domu .	dowiedz	8	Imp
Przejrzyj akta pracowników banku i dojdź do odcisków faceta nazwiskiem Ipkiss . . .	dojdź	5	Imp
Powiedzmy , że jak pójdę wieczorem fasować koniak dla pana , to kiedy magazynier odejdzie gdzieś na stronę , zwędzę mu puszkę tytoniu z półki .	odejdzie	14	Ind
Mały podyrdał , nie oglądając się na wybawicielkę .	podyrdał	1	Ind
Strzeż się , Segubie !	Strzeż	0	Imp
No i nie przejadajmy się .	przejadajmy	3	Imp
Tymczasem słońce podniosło się wyżej .	podniosło	2	Ind
- Chyba nie sięgną .	sięgną	3	Ind
Wszystko zniechęca do prowadzenia dziennika .	zniechęca	1	Ind
- Pracuje pan w teatrze od 50 lat .	Pracuje	1	Ind
Nie strasz klientów .	strasz	1	Imp
– Czy używasz prezerwatyw ?	używasz	2	Ind
Uroczystość uświetniły popisowe interpretacje fragmentów znanych dzieł literackich oraz występy wokalno - muzyczne .	uświetniły	1	Ind
- Prawda - szepnęła Karolcia - ale dlaczego ja widzę ciebie , a ty widzisz mnie ?	szepnęła	3	Ind
- Już się o ciebie nie martwię .	martwię	6	Ind
Menachem prosił , żebym ci to dostarczyła .	dostarczyła	6	Ind
Miał swoją szansę , a mimo to wynajął jakiegoś pieprzonego samca , żeby zrobił jej krzywdę .	wynajął	7	Ind
( Wojska chemiczne nie działają na pierwszej linii frontu . )	działają	4	Ind
- Do sypialni Polaków coraz częściej wchodzą istoty posiadające zdolność przenikania przez ściany .	wchodzą	6	Ind
Witam , Mam do zaoferowania prezentację maturalną " Zanalizuj język reklamy telewizyjnej i prasowej na wybranych przykładach " .	Zanalizuj	8	Imp
Rola Komisji ogranicza się do sprawdzania , czy w definicji nie ma rażącego błędu .	ogranicza	2	Ind
- Przypominam , że w dniu wczorajszym Sejm wysłuchał sprawozdania przedstawionego przez pana posła Janusza Szymańskiego , przeprowadził dyskusję oraz wysłuchał wyjaśnień przedstawionych przez podsekretarza stanu w Ministerstwie Spraw Zagranicznych pana Roberta Mroziewicza .	wysłuchał	20	Ind
Jaskier jęknął i pobiegł .	jęknął	1	Ind
O tym , czy odejdzie , zadecyduje premier .	odejdzie	4	Ind
- Legnij !	Legnij	1	Imp
Powycinajmy im nerki , sprzedajmy je na czarnym rynku	sprzedajmy	4	Imp
Może ekolodzy zainteresowali by się tą sprawą .	zainteresowali	2	Ind
- Dziś w miejscu " Mody Polskiej " przy placu Centralnym jest szmateks - informował .	informował	14	Ind
Po latach widzimy jaśniej - zarówno wtedy jak i dzisiaj satyra sprawia , że blaknie fascynacja złem : - Tak , to zbrodniarz , ale geniusz , geniusz !	blaknie	14	Ind
Program ten nie jest standardowo instalowany wraz z systemem , należy go zainstalować używając modułu Panelu Sterowania " Dodaj / Usuń programy " .	Usuń	20	Imp
Pomyśl też o innej możliwości .	Pomyśl	0	Imp
Często śniło się jej , że biegnie za oderwaną ręką i nie może jej dogonić .	śniło	1	Ind
Na płytkiej wodzie chwyć deskę oburącz ( jak " kozła " na szkolnej lekcji WF ) i powoli się podciągaj .	podciągaj	19	Imp
Z czasem przeprowadzą się na Plewiska .	przeprowadzą	2	Ind
Przekaż jej moje . . .	Przekaż	0	Imp
Kto zawiódł ?	zawiódł	1	Ind
Wyłącz ten cholerny mecz i chodź tu !	Wyłącz	0	Imp
Rozwój naszych stosunków z parlamentami w krajach trzecich stanowił również główną kwestię we wszystkich naszych działaniach .	stanowił	8	Ind
Pozwól , by inni dowiedzieli się , że potrzebujesz wsparcia .	Pozwól	0	Imp
W dniu tym wystartują również bobsleiści .	wystartują	3	Ind
Studiował zaocznie prawo .	Studiował	0	Ind
W 1991 dokonano kolejnych zmian administracyjnych .	dokonano	2	Ind
Mamo , proszę , zgódź się , tylko tym razem .	zgódź	4	Imp
Ale jak płacimy , to się okaże na końcu - igra sobie Pan Marek z domysłami wątpiących .	igra	10	Ind
Obejrzała się .	Obejrzała	0	Ind
- Pogaaaniaaaj !	Pogaaaniaaaj	1	Imp
Dzwonimy do Centrum Wolontariatu .	Dzwonimy	0	Ind
Dzieci się uczą na pamięć długości rzek , głębokości jezior . . .	uczą	2	Ind
Na pożywce pokazanej mi grafiki oraz słów Mirka wykiełkował w mojej wyobraźni obraz nieszablonowej strategii niosącej ze sobą kilka nowych , dobrych pomysłów oraz czerpiącej garściami z kosza wartości wypracowanych latami przez krakowskie studio .	wykiełkował	8	Ind
Zwał jak zwał , ale człowieka , którego skroją z komórki / pobiją wygoleni osobnicy typu 4x4 nie będzie obchodziło do jakiej grupy się zaliczają .	pobiją	12	Ind
— Nie kłam , nie kłam — ripostował Potockiemu stojący z tyłu Mariusz Kamiński z PiS .	kłam	2	Imp
Powinna pilnować dzieci - wściekał się Marcin ( 36 l . ) , który stał w tłumie gapiów przed blokiem .	Powinna	0	Ind
Witały ich entuzjastyczne oklaski .	Witały	0	Ind
Suche składniki rozkrusz w moździerzu lub młynku do kawy .	rozkrusz	2	Imp
Nie patrz tak .	patrz	1	Imp
Celem jest coś , co nazywamy świńskim rajem .	nazywamy	5	Ind
Powodzenie ubiegłorocznego przedsięwzięcia , kiedy widzowie nie mieścili się w sali kinowej , a niektórzy wręcz leżeli pod ekranem , zdecydowało że teraz projekcje odbędą się w trzech miejscach .	zdecydowało	20	Ind
Schyla się matka ciężko i podnosi .	Schyla	0	Ind
Wysyła się ich do najgorszej roboty .	Wysyła	0	Ind
- Patrz .	Patrz	1	Imp
Komu zawyżają oceny ?	zawyżają	1	Ind
- Dlatego popieram stanowisko Komisji Praw Człowieka i Praworządności w tym zakresie i będę za nim głosował .	głosował	16	Ind
– Może napisz do niej .	napisz	2	Imp
Choć , jak słyszę , oderwał em się od swej przeszłości i zgoła o niej zapomniał em .	oderwał	5	Ind
Na podstawie tego dokumentu powołani przez gminę eksperci wykonają analizę porównawczą obu inwestycji .	wykonają	8	Ind
Papieża uznaje za „ przywódcę rzymskiej wiary ” , ale nie wierzy w jego nieomylność , nie nazwie go „ ojcem świętym ” , bo to określenie przypisane jest Bogu .	nazwie	17	Ind
Dołączę się i ja do głosu Mathiasrexa , bez owijania w bawełnę : rodzice Lucpola powinni beknąć za to , że takie bzdury smarkacz wypisuje .	wypisuje	24	Ind
Starszy pan kiwnął głową , aprobując gestem zwierzchnika respektowanie zasad konspiracji .	kiwnął	2	Ind
Stwórz coś własnego , zamiast żyć z kupowania i sprzedawania cudzego .	Stwórz	0	Imp
- Napijmy się .	Napijmy	1	Imp
- To do kogo chodzić ? - wypytywały doktora Monczaka panie z sali .	wypytywały	7	Ind
nie strofujcie go .	strofujcie	1	Imp
Wszystkie te rzeczy zjadał Józio z Hańdzią , gdyż matka żywiła się raczej kiszoną kapustą .	zjadał	3	Ind
– Mama gładzi dłoń Dziadka .	gładzi	2	Ind
Zgłosiły się trzy panie .	Zgłosiły	0	Ind
W kopiach anonimizowane są dane osobowe innych pokrzywdzonych lub innych osób , prócz tych , które bezpośrednio na nas donosiły - „ zbierały lub oceniały dane ” o nas .	oceniały	24	Ind
Dobrze zacząłeś , ale o Rosji to ci zupełnie nie wyszło - właśnie takie postawy antagonizowały nas z innymi Słowianami i później braliśmy od nich w dupę zamiast wsparcia . . .	antagonizowały	15	Ind
Obydwu sprowadź natychmiast do sztabu !	sprowadź	1	Imp
Jej program układał radca handlowy ambasady RP w Rzymie .	układał	2	Ind
– nie dała ci ?	dała	2	Ind
Ok . 1506 roku rozpoczął działalność jako malarz ; wiadomo , że iluminował rękopisy , malował obrazy sztalugowe , jak i ścienne .	iluminował	12	Ind
- No to dorzuć panią Rodríguez , panią Salcedo , panią García . . .	dorzuć	3	Imp
Rodzice ze wzruszeniem prezentowali dziennikarzom swoje maleństwa i dziękowali za pomoc .	dziękowali	8	Ind
Uprzejmie proszę tych , którzy zdecydują się słuchać , by wytrzymali dłużej niż dwa , trzy dźwięki - tu nie wystarczy stwierdzenie , jakie jest tempo .	wytrzymali	10	Ind
- Różne rzeczy się czasem zwidują - mruczał komendant garnizonu .	mruczał	7	Ind
Od samotności niepoczytalnej i obłędu uchroń nas , Panie .	uchroń	5	Imp
I koniecznie zabierz ze sobą jakąś książkę .	zabierz	2	Imp
W pierwszej kolumnie kroczą woje Chrobrego .	kroczą	3	Ind
Zastanówmy się nad tym jeszcze przez chwilę .	Zastanówmy	0	Imp
– Modlił się .	Modlił	1	Ind
- Pan wyłudza pieniądze , pan defrauduje pieniądze ( . . . ) - atakował Roman Kozioł radnego Struzika .	defrauduje	6	Ind
Twierdził , że ma w samochodzie półtorej tony ładunków wybuchowych .	Twierdził	0	Ind
We własnym pokoju rzuciła się na łóżko i prędko zasnęła .	zasnęła	9	Ind
Mówmy o czymś przyjemniejszym .	Mówmy	0	Imp
nie przejmuj się . .	przejmuj	1	Imp
Nie karz mnie swoją nieobecnością , błagam " .	karz	1	Imp
Do drugiego badania włączono 46 dzieci w wieku od 4 do 12 lat , które stosowały dietę z kontrolowanym poziomem fenyloalaniny .	stosowały	15	Ind
Nie cenzuruje nas wrogi urzędnik , ale towarzysz partyjny " .	cenzuruje	1	Ind
Znajomość karate pomińmy . . .	pomińmy	2	Imp
już rozpoczynam .	rozpoczynam	1	Ind
Nie łudźmy się , że będziemy pierwsi .	łudźmy	1	Imp
Wieczorem wymykają się z hoteliku , by spojrzeć na ulubioną maszynę i pocałować ją na dobranoc .	wymykają	1	Ind
Bóg jeden wie , czym się kierował premier Miller w doborze kolejnych ministrów .	kierował	6	Ind
Bohatera anegdotki chełpiącego się przed znajomymi : – Stać mnie na to , żeby mój zięć nic nie robił , tylko chodził po pokoju .	chodził	21	Ind
Takie obniżenie wartości bilansowych kwalifikuje się tak jak odpisy aktualizujące z tytułu utraty wartości pojedynczych składników aktywów i ujmuje się zgodnie z paragrafem 60 .	kwalifikuje	4	Ind
A potem całą siłą woli oderwała się od posągu i ruszyła dalej nawą , popatrując z perspektywy na białą piramidę , coraz ciemniejszą .	oderwała	5	Ind
Nie patrzyła już na mnie .	patrzyła	1	Ind
To nie komentuj , bo nie ma co .	komentuj	2	Imp
I wyrzucano .	wyrzucano	1	Ind
Kąśliwe maksymy , sentencje , aforyzmy są takim właśnie zabójczym zwierciadłem podsuniętym ludzkości : patrzcie , jak wyglądacie .	patrzcie	14	Imp
- Chciałbym , aby wreszcie w Polsce obowiązywało prawo - uzasadniał Lepper .	obowiązywało	7	Ind
W 1935 roku brytyjski informatyk Alan Mathison Turing wymyślił abstrakcyjną maszynę .	wymyślił	8	Ind
- Odwieziesz mnie - poprosiła - teraz poczułam się zmęczona .	Odwieziesz	1	Ind
Przyszedł do nas po kolędzie .	Przyszedł	0	Ind
- Kochasz mnie ?	Kochasz	1	Ind
Mocno akcentuje swoją samowystarczalność , niezależność i to , że doskonale wie , czego chce .	akcentuje	1	Ind
Zabrała butelkę przyjaciółce i pociągnęła łyk , od którego wszystko w przedziale pojaśniało , a obrazek zawieszony nad kozetką , przedstawiający jakiś smętny , brzozowy i rosyjski krajobraz , od razu poweselał .	pojaśniało	12	Ind
Jeżeli nie zmaksymalizujemy energii i możliwości każdego kraju , wszyscy w końcu stracimy .	zmaksymalizujemy	2	Ind
Słuchała napomnień jak ptasiego szczebiotu , który do niczego nie obowiązuje , gdyż nic ludzkiego nie oznacza .	Słuchała	0	Ind
Owocuje to eksplozją pomysłów i niespożytą energią niezbędną do ich realizacji .	Owocuje	0	Ind
Równocześnie wznoszono nowoczesne dzielnice mieszkaniowe .	wznoszono	1	Ind
Przede wszystkim zaś od lat gromadzi broń masowego rażenia ( BMR ) , którą może im przekazać albo użyć przeciw USA .	gromadzi	5	Ind
Wytrzymaj , Natalio .	Wytrzymaj	0	Imp
Mów , co ś załatwił .	załatwił	4	Ind
Krzysztof : - Skieruj to do określonych osób !	Skieruj	3	Imp
Jest to szczególnie atrakcyjne dla dzieci , które same proszą rodziców , aby mogły wziąć do rączki te piękne stworzenia .	proszą	9	Ind
31-letnia Karina Hoffman - Birkhead rozwiodła się w ubiegłym roku .	rozwiodła	5	Ind
- Łzy spływały jej po policzkach kropla po kropli , zbierając się w miejscu , gdzie łagodny owal twarzy nagłym uskokiem przechodzi w szyję , i wsiąkały w golf .	wsiąkały	26	Ind
Oczy powlekła biaława szklistość , co wzmogło tajemnicę spojrzenia .	wzmogło	6	Ind
I koniecznie zabierz ze sobą jakąś książkę .	zabierz	2	Imp
W pewnej chwili na małym ekranie ukazuje się plansza : " Przepraszamy za zakłócenia " .	ukazuje	6	Ind
- Jak utrwalacie wyniki kuracji po trzech miesiącach ?	utrwalacie	2	Ind
Nie sprzeciwiaj mi się , dobrze ? . . .	sprzeciwiaj	1	Imp
A wystarczyłoby gdyby uczniowie posprzątali i zgrabili liście wokół swojej szkoły , posadzili kwiaty i zbudowali zimą karmniki , albo pozbierali i oddali do skupu aluminiowe puszki po napojach .	pozbierali	20	Ind
Na twarzy Marii zgasł uśmiech .	zgasł	3	Ind
- Machnęła m ręką .	Machnęła	1	Ind
Część komentatorów mówi : " nie bójmy się , bo nic z tego nie wyjdzie " .	bójmy	6	Imp
Mówmy , że ktoś nieśmiały jest też bardziej wrażliwy , milszy .	Mówmy	0	Imp
Głowa jego chwiała się bezwładnie na ramieniu Dziadzi .	chwiała	2	Ind
I nagle telefon od komitetu bankietowego : " przyjdziemy o wpół do dziesiątej " .	przyjdziemy	8	Ind
Pocałuj ją , a zobaczysz , że tylko krok dzieli cię od najważniejszego .	Pocałuj	0	Imp
W przypadku braku decyzji kolejnym krokiem jest decyzja Rady , a jeśli ta również nie może zostać podjęta , wniosek wraca do Komisji , która podejmuje ostateczną decyzję .	podejmuje	25	Ind
Dosiadł się do nich , napełnił talerz zupą pomidorową .	Dosiadł	0	Ind
Możliwe jest jednak dokonanie oceny potencjalnych maksymalnych korzyści dla ochrony środowiska , które mogłyby zostać osiągnięte , gdyby wszystkie produkty w danej grupie spełniały kryteria oznakowania ekologicznego .	spełniały	23	Ind
Król zaatakował pierwszy .	zaatakował	1	Ind
Zamek chętnie zwiedzają cudzoziemcy .	zwiedzają	2	Ind
Poznali śmy się w okolicznościach osobliwych .	Poznali	0	Ind
– dobrze napij się limoniady .	napij	2	Imp
- To musi być pomyłka - zaprotestowała Halina .	zaprotestowała	6	Ind
Jednak “ walka rasowa ” posuwa się dalej : już 7 kwietnia 1933 roku rząd Rzeszy wprowadza zakaz wykonywania zawodu przez urzędników żydowskich oraz osób krytycznych wobec reżimu .	posuwa	5	Ind
- Uprzedził pan nasze myśli .	Uprzedził	1	Ind
Dominika krzyczy , zatrzymaj się , Edyta wymiotuje na tylnym siedzeniu , a Jagienka śpiewa , wyrwij murom zęby krat .	zatrzymaj	3	Imp
Wyłamali się m.in . Krzysztof Kaczmarek i Tomasz Kowalski , którzy zrobili film i Agnieszka Dróżdż , która swoje piłki mozolnie wydziergała szydełkiem .	wydziergała	21	Ind
Biegał za nią od kuchni do pokoju , przystając tylko na moment , gdy ustawiała półmiski .	ustawiała	14	Ind
Oznacz wszystkie pola ze skarbami .	Oznacz	0	Imp
Etylen jako gaz z łatwością wnika do rośliny , a z racji , że należy on do hormonów roślinnych , może wywołań tu różne uszkodzenia .	wnika	5	Ind
Odwiozę tylko psy do brata i już jestem .	Odwiozę	0	Ind
- Pan jako inicjator poprawki mówi tym , którzy mieli kontakty służbowe z cenzurą : piszcie , że nie współpracowaliście ?	piszcie	15	Imp
Nazywa się Topp .	Nazywa	0	Ind
To , jak urywał się z zajęć na Politechnice Petersburskiej , żeby zdążyć na treningi tajskiego boksu i jak na jeden z nich przyszedł Wiktor - zawodowy promotor w walkach bez reguł .	urywał	3	Ind
Jednocześnie jedynie co dziesiąty katolik uczestniczy regularnie w niedzielnej mszy , a co drugi wyjawia , że nie znajduje w Kościele odpowiedzi na nurtujące go pytania .	uczestniczy	5	Ind
Znajdź i natychmiast mnie z nim połącz .	połącz	6	Imp
Nagle zauważam , że balkon chwieje się i pęka .	pęka	8	Ind
Wieczorem działki otuliły się dymem .	otuliły	2	Ind
Otworzyła m radio i słuchała m muzyki .	słuchała	4	Ind
- Wolfgang przestawił swoje krzesełko w cień .	przestawił	2	Ind
- Się nie martw .	martw	3	Imp
Jeśli nie chcesz biegać , pływać czy grać w piłkę - umyj okna , skoś trawę na działce , posprzątaj piwnicę .	posprzątaj	19	Imp
A jednak animowała czytelników do podróżowania po nieznanych lądach , odkrywania coraz to nowych pokładów własnej osobowości .	animowała	2	Ind
Media utrzymywały , że niechętnie odnosiła się do związku wnuka z rozwódką Parker Bowles .	utrzymywały	1	Ind
- Samochody stoją na ulicach , blokują przejazd , są zatoczki , ale potrzeba więcej parkingów z prawdziwego zdarzenia .	blokują	6	Ind
Trochę mnie zatkało i zastanowiło , czy on czasami nie jest aktualny obecnie ?	zastanowiło	4	Ind
- Zaczekaj , zaraz , ja wyjaśnię .	Zaczekaj	1	Imp
Podwyżka zmniejszy ponoszone przez spółkę straty .	zmniejszy	1	Ind
To dla niej , niby-pies , aportuje ulubioną myszkę , to na jej kolana gramoli się , kiedy nadchodzi godzina pieszczot .	aportuje	6	Ind
Pod koniec roku 1977 chór liczył już 32 osoby .	liczył	5	Ind
Trąb , pan dyrektor prosi .	Trąb	0	Imp
Pocałuj mnie .	Pocałuj	0	Imp
Poszerzył em uśmiech , unosząc puste dłonie .	Poszerzył	0	Ind
Ja oczywiście nie będę głosował na Jaruzelskiego i w ogóle nie wiem , na kogo mam głosować .	głosował	4	Ind
Otrzymasz zasiłek i ubezpieczenie zdrowotne .	Otrzymasz	0	Ind
- Nie wyobrażam sobie piękniejszej śmierci .	wyobrażam	2	Ind
Uczciwie zarabiaj na chleb .	zarabiaj	1	Imp
Nie powtórzył tego już więcej , pełen na poły świadomej obawy , że kogoś spłoszy , coś zapeszy .	spłoszy	14	Ind
Lud żąda odsłonięcia .	żąda	1	Ind
– Nie twierdzę , że działamy najlepiej i nie popełniamy błędów .	działamy	5	Ind
Wyłączył autopilota i przez chwilę korygował położenie samolotu .	korygował	5	Ind
Zamiast listka dla początkujących chcę graficzny znak ręki z uniesionym środkowym palcem – spierdalaj , jestem niebezpieczna .	spierdalaj	13	Imp
Nie gniewaj się . . .	gniewaj	1	Imp
Teraz składamy paskowy patchwork , ocieplenie i podszewkę , zszywamy wzdłuż prostego brzegu i obszywamy lamówką .	obszywamy	14	Ind
Polscy i czechosłowaccy antystalinowcy winni szukać porozumienia tylko w najszerszej , lecz i zasadniczej płaszczyźnie .	winni	4	Ind
Błagam , nie chorujcie i żadnych kłopotów nie miejcie !	miejcie	8	Imp
- Ach , więc to tak ! - krzyczała Grochulska - śpicie sobie w najlepsze !	śpicie	11	Ind
- Tylko mi nie wyjeżdżaj z animą !	wyjeżdżaj	4	Imp
- Zbądź obawy , ojcze .	Zbądź	1	Imp
Andrew dodatkowo zażyczył sobie jajecznicę na boczku , bo stwierdził , że po tak cienkim śniadanku nie dotrwał by do obiadu .	zażyczył	2	Ind
Koty przerwały brutalnie moje panowanie nad światem .	przerwały	1	Ind
Pod żadnym pozorem nie zgadzaj się na pozostanie w domu w przyszły weekend .	zgadzaj	4	Imp
Przywitajmy ją serdecznie .	Przywitajmy	0	Imp
- Przyniosła ś .	Przyniosła	1	Ind
Wezwał mnichów i kapłanów do współpracy .	Wezwał	0	Ind
Pewien brytyjski rolnik leczył swą chorą krowę piwem .	leczył	3	Ind
Jego dryfujący jacht " Mathilde " w nocy z 3 na 4 maja odnaleźli polscy naukowcy na morzu na wysokości Sarbinowa .	odnaleźli	13	Ind
Uśmiecha się do podchodzącego lekarza .	Uśmiecha	0	Ind
Zupełnie nie udał się start naszej pięciobojowej młodzieży w mistrzostwach świata w czwórboju nowoczesnym kobiet i mężczyzn w szwedzkiej Uppsali .	udał	2	Ind
Gdy przyszedł Dzień Pojednania , deliberowali , jak powinni go świętować .	deliberowali	5	Ind
Uklęknijcie . . .	Uklęknijcie	0	Imp
Sylwetki mechaników wchłonęło po chwili czarne wnętrze hangaru .	wchłonęło	2	Ind
W Krakowie symbolizowały je deski .	symbolizowały	2	Ind
- Podpłyń tam - poprosiłem .	Podpłyń	1	Imp
Michał Koniecpolski wił się jak piskorz , bladł jak papier , czerwieniał jak burak , bredził jak Piekarski na mękach .	bladł	7	Ind
- Nie gniewaj się , pomyśl , zrobili śmy im taką przyjemność .	gniewaj	2	Imp
Mówił nam , żebyśmy nie narażali się na zbłąkanie tutaj .	narażali	5	Ind
Dobrze , rozwesel się , duży chłopczyku .	rozwesel	2	Imp
Jedyne co toleruję jako dodatek , to wszelkie postacie czekolady ( polewy , wiórki , kawałki czekolady w ciasteczkach itp . ) .	toleruję	2	Ind
Podporucznik Stryjek zamknął okno .	zamknął	2	Ind
Bo krzyż zdążono już umieścić na ścianie katedry górującej nad miastem .	zdążono	2	Ind
Zauważ , że sporo firm handluje dzisiaj z Rosją - oni nie potrzebują rusycystów , oni potrzebują pracowników ze znajomością rosyjskiego .	Zauważ	0	Imp
- Zejdźcie mi z oczu - wyszeptał .	wyszeptał	6	Ind
- Skąd się dowiemy , gdy już będzie ?	dowiemy	3	Ind
Mylisz dreszcz po przejściu przez skrzypiący most z miłością .	Mylisz	0	Ind
Unikaj słów o podwójnym znaczeniu .	Unikaj	0	Imp
- Kolega namawia Cię na wódkę : " Nie zaprzeczaj , nie zaprzeczaj , przecież widzę po twoich oczach , że marzysz po prostu o jednym głębszym , a twoje oczy nigdy nie kłamią .	marzysz	21	Ind
Prezydent Starogardu Gd . Edmund Stachowicz wręczył nagrody laureatom eliminacji miejskich X edycji Ogólnopolskiego Konkursu Plastycznego dla dzieci i młodzieży pod hasłem " 112 w trudnej sprawie - nie używaj przy zabawie " .	wręczył	6	Ind
Są moim błogosławieństwem , nie dotykajcie ich !	dotykajcie	5	Imp
Pan uśmiechnął się z zadowoleniem , ale Puzon i Torba nie zauważyli tego , bo złapały ich jakieś dziwne drgawki .	zauważyli	11	Ind
I przestań wreszcie chlapać po stole .	przestań	1	Imp
Koniecznie zadzwoń i przeproś za zwłokę .	przeproś	3	Imp
Dokonawszy tego dzieła , uznali wyspę za swoją własność i postanowili pilnować , żeby wiadomość o jej istnieniu nie przedostała się do obcych .	przedostała	19	Ind
Lubisz sensacje .	Lubisz	0	Ind
Z rodziną bawili się w ciuciubabkę .	bawili	2	Ind
Chciałaby zapisać w testamencie majątek , naprawdę niemały , swoim kotom i obawia się , że po jej śmierci rodzina to zakwestionuje .	zakwestionuje	21	Ind
Uratujcie wierzącego chrześcijanina Walerego Marczenkę !	Uratujcie	0	Imp
Ewakuujcie się na drugą stronę rzeki .	Ewakuujcie	0	Imp
Nikomu nie postawiono zarzutów .	postawiono	2	Ind
Rodzice wciąż pracują .	pracują	2	Ind
Unikajmy toreb foliowych - szybko się drą i trzeba je będzie wyrzucić .	Unikajmy	0	Imp
Zrozumcie - mówi przepraszająco .	Zrozumcie	0	Imp
Jak twierdzi mama Joasi , drzwi nie były zamknięte w momencie , gdy winda samoczynnie ruszyła .	ruszyła	15	Ind
Nadchodzi zima .	Nadchodzi	0	Ind
– Miałem w kieszeni radiotelefon , w którym cały czas odzywały się policyjne komunikaty .	odzywały	10	Ind
A po ocknięciu się z kamienia osiągnął em jeszcze dwie , straszne w swej prostocie , myśli .	osiągnął	6	Ind
Publiczność uprasza się o wcześniejsze zajmowanie miejsc .	uprasza	1	Ind
Kochajcie się , bądźcie parą w pytkę !	Kochajcie	0	Imp
Stworzył obraźliwe żydowskie stereotypy jak te w " Der Sturmer " .	Stworzył	0	Ind
Poprawimy się !	Poprawimy	0	Ind
Kochają go za tę doskonałą bezinteresowność .	Kochają	0	Ind
Zapomnij też o wszelkich środkach uśmierzających ból .	Zapomnij	0	Imp
