- Mam przy sobie sztylecik .	sztylecik	4	Masc3
Aż siedem kraks spowodowali motocykliści .	motocykliści	4	Masc1
W ostatniej sekundzie uniknął zderzenia z mercedesem .	mercedesem	6	Masc2
Pani Alicja w sklepie sprzedaje , mąż dowozi jej towar .	towar	9	Masc3
Czasem przyjeżdżają do Nataszy z Polski rodzice .	rodzice	6	Masc1
Według Zofii Staśkiewicz z Dworu Artusa , artyści bardzo chętnie godzą się na koncerty w Toruniu .	artyści	7	Masc1
Portal Wirtualna Polska gościł wczoraj premiera Jerzego Buzka .	Portal	0	Masc3
Przy stoliku stał kelner .	kelner	3	Masc1
Ma on być gościem prezydenta Saragata .	gościem	3	Masc1
Ale mogą służyć do celów rekreacyjnych .	celów	4	Masc3
- Maniek Zieniuk jest dalej komendantem w Nowym Mieście ?	komendantem	5	Masc1
- Czy firmy chętnie się godzą na podział budżetu ?	budżetu	8	Masc3
Ten bóg nazywa się Leszek Miller .	bóg	1	Masc1
Podwórko pachniało cytrusami .	cytrusami	2	Masc2
I od tamtej pory czekam , żeby wskazal PAn róznice .	PAn	8	Masc1
- A może podać kieliszki ?	kieliszki	4	Masc3
- Wygląda na to , że piłka nożna seniorów w Występie przestanie istnieć .	seniorów	8	Masc1
- Proszę , panie pośle .	pośle	4	Masc1
- Oczy bankiera wyrażały życzliwość i zaciekawienie .	bankiera	2	Masc1
– Przepraszam , ale nie widziała m powodu …	powodu	7	Masc3
Prokuratura nie przedstawiła mu zarzutów .	zarzutów	4	Masc3
Na wyróżnienie trenera zasłużył także Mathias Sammer , który pełnił funkcję motoru napędowego reprezentacji .	trenera	2	Masc1
- Nie układa się jej pod rynkowego konkurenta , ale warto wiedzieć , w co on gra .	konkurenta	7	Masc1
Społeczeństwo i państwo nie może dłużej tolerować swobody wywrotowców , wichrzycieli i awanturników .	wichrzycieli	10	Masc1
Geje robią wokół siebie szum , żeby tylko się wypromować .	Geje	0	Masc1
Ogień trzaskał w ciszy , dzieci wybiegły na dwór przestraszone .	Ogień	0	Masc3
Magister podreptał ukosem przez podwórzec , nikły , żałosny w swej czarnej sukni .	Magister	0	Masc1
Kapitan wzrusza ramionami .	Kapitan	0	Masc1
Musiał em wyglądać na niezgorszego gwałciciela .	gwałciciela	5	Masc1
jakich zmysłow nam brakuje ?	zmysłow	1	Masc3
W rozdrażnieniu Pierre chwycił go silnie zębami .	zębami	6	Masc3
Małżonka krewnego przezornie schowała się do skrzyni i to ją uratowało .	krewnego	1	Masc1
Nieuchronne podziały pogłębił niski poziom politycznych dyskusji .	podziały	1	Masc3
Wówczas jego kobieta szuka takich koziołków jak ty .	koziołków	5	Masc2
Druga wiodła wprost do zamku .	zamku	4	Masc3
Dlaczego w banku za bohaterów uważają hitlerowców ?	bohaterów	4	Masc1
Sławny pianista utracił dłonie w wypadku , ale przeszczepiono mu ręce straconego mordercy .	mordercy	12	Masc1
Popyt tworzy marketing .	marketing	2	Masc3
Dlatego Marek z kartonem stał teraz na poboczu , czekając na Grzesia i jego półciężarówkę .	kartonem	3	Masc3
Zderzyły się tam dwa polonezy .	polonezy	4	Masc2
Machała m mu fartuchem , żeby lądował na łące pod lasem , ale ten chłopak chyba się przestraszył , że zawadzi o druty .	lasem	10	Masc3
Ułożył je ks. Wawrzyniec Beniok w 1707 roku .	ks.	2	Masc1
Za co tak Semaka nie lubią partyjni towarzysze ?	towarzysze	7	Masc1
A potem po jakimś czasie zaczęło się nawet przyzywanie szatana .	szatana	9	Masc2
Powierzchnię morza pruły statki , oczekujące pojawienia się ostatniego członu rakiety .	członu	9	Masc3
Następnym mówcą będzie pan poseł Jan Kulas .	mówcą	1	Masc1
- Czy księdzu wolno publicznie krytykować przełożonych ?	księdzu	2	Masc1
Przywołał żołnierza niosącego wiadro .	żołnierza	1	Masc1
Wioślarzom AZS przybył nowy konkurent .	konkurent	4	Masc1
Wtajemniczeni hipnotyzerzy nie przekazują zresztą swej wiedzy niepewnym osobom .	hipnotyzerzy	1	Masc1
Niech żyje generał Judenicz !	generał	2	Masc1
Zatrudnia 1100 dziennikarzy i 2000 współpracowników .	współpracowników	5	Masc1
Z głębin morza dalekich a z bełku przepadłego powrócił , żeby u stopy braterskiej jasne czoło położyć .	bełku	6	Masc3
Papa był na dopingu .	Papa	0	Masc1
Szewardnadze zgubił kraj .	kraj	2	Masc3
Z piętra wyżej zszedł dystyngowany sąsiad z chartem na białej smyczy .	sąsiad	5	Masc1
Przez całe epoki piwo było napojem do śniadania , piło się piwo z serem .	serem	13	Masc3
W Warszawie pada śnieg .	śnieg	3	Masc3
Robotnik spadł na leżący pod drabiną gruz .	Robotnik	0	Masc1
A potem dwupłatowiec wniknął w nasz bombowiec niczym duch .	duch	8	Masc2
Niezwyciężony lęk przed dziwem w każdym momencie serca przychodniów przeszywał .	przychodniów	8	Masc1
Podpułkownik Krabel zarządził strzelanie na garnizonowej strzelnicy .	Podpułkownik	0	Masc1
Obstępują solenizanta , śpiewają sto lat , a maluchy wręczają kolorowe paczki .	maluchy	8	Masc2
Bał em się , że pożar przejdzie też na moją stodołę .	pożar	5	Masc3
Kocham polskich chłopów hodujących polską brukselkę . . .	chłopów	2	Masc1
Policjanci odpowiedzieli strzałami .	strzałami	2	Masc3
Uroczystego otwarcia imprezy dokonał wojewoda nowosądecki Marek Oleksiński .	wojewoda	4	Masc1
Równie dobrze mogł em gadać do słupa .	słupa	6	Masc3
Jak zwykle nie było noszowych .	noszowych	4	Masc1
Popyt tworzy marketing .	Popyt	0	Masc3
Obok klatek z dorosłymi ptakami krążyły dwa małe kazuary , grzebiąc w odpadkach w poszukiwaniu pożywienia .	kazuary	8	Masc2
Następnie Aleksander Zawadzki dokonał otwarcia muzeum w dziesiątym Pawilonie .	Pawilonie	8	Masc3
Satelita miał badać promienie kosmiczne i mikrometeoryty .	mikrometeoryty	6	Masc3
Konia by powaliło .	Konia	0	Masc2
Wtedy czytelnikowi tekst wydaje się bardziej wiarygodny .	czytelnikowi	1	Masc1
Przeciętne świadczenie emeryta , rencisty wzrośnie o 33 zł .	emeryta	2	Masc1
Miał tyle rozsądku , że nieraz potrafił porównać siebie z ojcem i uniknąć jego gwałtowności .	rozsądku	2	Masc3
Magwer zrobił kolejny krok .	krok	3	Masc3
Słońce , rozgrzewające żołądek Gregora Smidda , rozgrzało i granat .	granat	9	Masc3
Marynarze niemieccy spostrzegli go .	Marynarze	0	Masc1
Mundurowi nie chcą zdradzać parametrów technicznych maszyn , by nie ułatwiać życia drogowym piratom .	Mundurowi	0	Masc1
Od czasu do czasu słychać było głosy pierwszych ptaków , brzmiące świeżo i przenikliwie .	ptaków	8	Masc2
A jeszcze wczoraj zdawało mu się , że rozpozna każdą sztachetę w płocie .	płocie	12	Masc3
Podczas ceremonii otwarcia Spływu organizatorzy przyznali liczne odznaczenia zasłużonym kajakarzom .	Spływu	3	Masc3
Za wprowadzenie czytelników w błąd przepraszamy .	czytelników	2	Masc1
Blady strach na wieś padał , kiedy Hanke pojawiał się z tym aparatem .	aparatem	12	Masc3
Policjanci pojechali do domu ucznia i odkryli , że granat pochodzi z kolekcji tatusia .	tatusia	13	Masc1
Wieczorny mrok gęstniał coraz bardziej w drobnym i dokuczliwym deszczu .	mrok	1	Masc3
Z wykształcenia jest historykiem .	historykiem	3	Masc1
Warszawscy radiowcy okazali się trudnymi rywalami .	radiowcy	1	Masc1
Podczas poprzedniej wojny dowodził własnym batalionem i , jak zapewniał , miał jeńców na tuziny .	batalionem	5	Masc3
Mam ochotę na blondyna .	blondyna	3	Masc1
- Będzie rosół z piachem .	piachem	4	Masc3
A320 jest prekursorem wśród odrzutowców liniowych .	odrzutowców	4	Masc3
W Paryżu , grając na giełdzie , majątek podobno podwoił .	majątek	7	Masc3
Małe zeugle nie są niebezpieczne .	zeugle	1	Masc2
Pracownik zwalnia się często podczas pracy dla załatwienia spraw osobistych .	Pracownik	0	Masc1
Zaczaja się na zebry , hieny i szakale .	szakale	7	Masc2
Myślę , że są to po prostu dobre kompozycje i świetne teksty .	teksty	11	Masc3
- Dziękuję bardzo , Pani Senator .	Senator	5	Masc1
W tym roku stołeczni stróże prawa odkryli na Mazowszu już osiem takich fabryk .	stróże	4	Masc1
Zaczął em pracować w kibucu .	kibucu	4	Masc3
Dowódca sił amerykańskich w Afganistanie generał Tommy Franks zapowiedział kolejne operacje lądowe .	Dowódca	0	Masc1
Umyślił teraz opowiedzieć to zdarzenie choremu wnuczkowi .	wnuczkowi	6	Masc1
Motor Stefana zatrzymał się na podjeździe .	podjeździe	5	Masc3
Czy bez Marka Pola w rządzie miał by pan pełnomocnika do spraw kobiet albo pomysły autostradowo - winietowe ?	pełnomocnika	9	Masc1
– Dziennikarze wmówili sądowi i ludziom , że Róża musi wrócić do biologicznych rodziców .	sądowi	3	Masc3
Pozostali ministranci postanowili dalej pełnić służbę ministrancką .	ministranci	1	Masc1
Poznali się na weselu brata Edyty .	brata	4	Masc1
Naokoło rozchodził się zapach grochówki i kiełbasek z grilla .	grilla	8	Masc3
Uczymy ich na kursach ogólnych i specjalistycznych .	kursach	3	Masc3
– Mock wstał , a jego twarz nabrzmiała z gniewu .	gniewu	9	Masc3
Poszedł żuraw obrażony .	żuraw	1	Masc2
- Ewelinko , czy pamiętasz jakiś wiersz ?	wiersz	6	Masc3
Serwal to rzadko spotykany w polskich ogrodach drapieżnik z rodziny kotów .	Serwal	0	Masc2
- Z naszych danych wynika , że przybywa kontraktów denominowanych w złotych .	kontraktów	8	Masc3
Panie Prezesie , w ten sposób nie pomoże Pan ani Pana ugrupowaniu , ani działkowcom .	działkowcom	14	Masc1
Powiedzieli mi , że ojciec popełnił samobójstwo .	ojciec	4	Masc1
Milicjant i ratownik zaczynają od powrzaskiwań i epitetów .	ratownik	2	Masc1
Przesiadują pod dachem gołębie .	gołębie	3	Masc2
Na piątym był ostatni etap .	etap	4	Masc3
W ostatnim cyklu Schuberta znajduje się pewna pieśń .	cyklu	2	Masc3
Powrót odbywa się w tempie przyspieszonym .	Powrót	0	Masc3
Od zbłąkanych misjonarzy uchroń nas , Panie .	misjonarzy	2	Masc1
Klasztor fundacji Gaszynów posiada sklepione cele i korytarze komunikacyjne .	Klasztor	0	Masc3
Mana wypiła łapczywie kilka łyków .	łyków	4	Masc3
Ruch jest najważniejszy .	Ruch	0	Masc3
Niedawno urodziły mu się bliźniaki .	bliźniaki	4	Masc2
Na Siemiradzkiego wybrzydzali krytycy , ale publiczność uwielbiała jego obrazy .	krytycy	3	Masc1
Jej niewinny wygląd nie zmylił policjantów .	wygląd	2	Masc3
Polska wreszcie przełamała zły los , a Andrzej Wajda otrzymał Oscara .	Oscara	10	Masc2
Malarz uspokoił się .	Malarz	0	Masc1
Poszkodowany do dnia dzisiejszego nie otrzymał zakupionego telefonu .	Poszkodowany	0	Masc1
Pieniędzy nie odzyskano do dziś .	Pieniędzy	0	Masc3
Przedsiębiorcę z Barda niepokoi , że w obrocie gospodarczym brakuje pieniędzy .	obrocie	7	Masc3
Tak toczy się światek .	światek	3	Masc3
Nad każdym , nawet najkrótszym tekstem medytuję .	tekstem	5	Masc3
Jakim prawem ojciec tak mówi ?	ojciec	2	Masc1
Chodzi o przedsiębiorstwo z tradycjami , założone jeszcze przez ojca pana Piotra .	ojca	9	Masc1
Brat śmiał się z niego , że nie ma dziewczyny .	Brat	0	Masc1
Okazało się również , że motocyklista nawet nie hamował przed uderzeniem .	motocyklista	5	Masc1
Dyrektor wymienia imprezy , które zorganizował .	Dyrektor	0	Masc1
Dzięki wysiłkowi lekarzy udało się uratować mu życie .	lekarzy	2	Masc1
Kelner ucieszył się .	Kelner	0	Masc1
Pojawił się milicjant i kierował samochody w boczne ulice .	samochody	5	Masc3
Na niebie nie latały talerze .	talerze	4	Masc3
- Szanowna księżniczka już dawno ze żłobka wyszła .	żłobka	6	Masc3
Machnął ręką i zabrał się do swoich urzędowych papierów .	papierów	8	Masc3
W pomieszczeniu tym będzie mogło korzystać z noclegów czterdziestu turystów .	turystów	9	Masc1
Jerzy nie mógł dobrnąć do ostatniego stempla , chociaż odznaczał się sprytem Merkurego .	sprytem	11	Masc3
- Mój ojciec pracuje w BRH , biurze radcy handlowego .	ojciec	2	Masc1
W ZUS nie ukrywają , że lekarzom trudno udowodnić , iż nadużywają swych kompetencji .	lekarzom	6	Masc1
Jesteś umarlak !	umarlak	1	Masc2
Do tego czasu kierowcy muszą liczyć się z poważnymi utrudnieniami w ruchu .	ruchu	11	Masc3
Nie tylko on uległ czarowi tego zakątka .	czarowi	4	Masc3
Karol nie chce tego pawlacza rozdwoić ?	pawlacza	4	Masc3
Nauczyciel szybko uporał się z zakupami i , nie powracając już do poprzedniego tematu , z widoczną ulgą pożegnał chałupniczkę .	Nauczyciel	0	Masc1
- Będzie się Pan opierał na betonie ?	betonie	6	Masc3
Od sierpnia strzelił Pan dla Borussii 12 goli .	goli	7	Masc2
Obrazy cyfrowe składają się z połączonych ze sobą pikseli o różnych barwach lub tonach .	Obrazy	0	Masc3
- Kierowca otworzył drzwi i kazał mi wsiadać .	Kierowca	1	Masc1
Wyznaczeni posłowie zajęli miejsca .	posłowie	1	Masc1
Ona poprzez lasy przerąbała pierwszą drogę dla cichego apostolstwa synów bożych .	lasy	2	Masc3
Śpiewała także na dworze szacha , w czasie przyjęcia dyplomatycznego .	dworze	3	Masc3
Przybiegła Dorota z mężem i synem .	synem	5	Masc1
Ładnie pachnie ten twój sweter i drapie tak przyjemnie .	sweter	4	Masc3
Zatrudnia zaledwie 60 urzędników , wśród nich tylko czterech księży .	urzędników	3	Masc1
- Zamykaj buzię , bo ci świecący ptak do niej wleci .	ptak	7	Masc2
- Będę musiał poprosić panów o dokumenty .	panów	4	Masc1
Przed tygodniem wicestarosta Hrycyna podczas wyjazdu do Gdańska uzyskał przychylność tamtejszych środowisk żydowskich .	wicestarosta	2	Masc1
Przed snem pornole oglądać , laski kręcić .	pornole	2	Masc2
Przechodnie patrzyli obojętnie na nieszczęśliwe zwierzę .	Przechodnie	0	Masc1
Wyszedł em na spacer z nietresowalnym bassetem .	bassetem	6	Masc2
Zareagowali na to sędziowie Trybunału .	sędziowie	3	Masc1
Bo przecież ci , co przeciągnęli druty , zabili ich brata .	druty	6	Masc3
W kościele mariackim w Radomiu o północy mszę święto odprawił biskup senior Edward Materski .	senior	11	Masc1
W garażu jest miejsce na 53 samochody .	samochody	6	Masc3
Ulice były jeszcze zapełnione ludźmi i pojazdami .	pojazdami	6	Masc3
Człowiek staje się wyleniałym tygrysem .	tygrysem	4	Masc2
W ciszy zapadającego wieczoru głos się roznosił i każde słowo słychać było z daleka .	głos	4	Masc3
Inni tylko gadają .	Inni	0	Masc1
Opodal trenowali skoki chłopcy na deskorolkach .	chłopcy	3	Masc1
Dziadek zamknął drzwi i przesunął korbę .	Dziadek	0	Masc1
W godzinę później złożyli wizytę gubernatorowi .	gubernatorowi	5	Masc1
Pies przekrzywiał głowę , jakby słuchał .	Pies	0	Masc2
Dynamiczny spektakl przyciągnął uwagę przechodniów .	przechodniów	4	Masc1
Czy potrafię być silniejszy od jej rozpaczy i gniewu ?	gniewu	8	Masc3
Pomysł wynalazcy został opatentowany .	wynalazcy	1	Masc1
W końcu znalazł się w Lesznie .	końcu	1	Masc3
I są dobrymi gospodarzami .	gospodarzami	3	Masc1
Woły stąpały ospale , skrzypiały jarzma .	Woły	0	Masc2
Nikt nie zatrzyma rozwoju medycyny .	rozwoju	3	Masc3
Nie będzie mi Prosiaczek wchodził w duszę buciorami .	Prosiaczek	3	Masc2
Zaprószono ogień i wybuchł poważny pożar na górnych piętrach .	pożar	5	Masc3
Jest to jedyny taki obiekt w gminie .	obiekt	4	Masc3
Administrator nic nie powiedział .	Administrator	0	Masc1
Lecz protektor w niebieskiej bluzie poklepał go po ramieniu .	protektor	1	Masc1
- Spotkali śmy się , towarzyszu rektorze . . .	rektorze	6	Masc1
Proboszcz klepnął się dłońmi w kolana .	Proboszcz	0	Masc1
- Czy firmy chętnie się godzą na podział budżetu ?	podział	7	Masc3
Często jednak dociekliwość pracowników straży powoduje , że za kratki trafiają groźni przestępcy .	przestępcy	12	Masc1
Oznacza to , że nie przetworzone przez przemysł produkty mają największe walory .	walory	11	Masc3
– i takie akordeony kupują zawodowi akordeoniści ?	akordeoniści	6	Masc1
Nikt poza bratem i ojcem nie wiedział .	bratem	2	Masc1
Czy bywasz czasami tygryskiem ?	tygryskiem	3	Masc2
Kleks kapnął na stenogram Lewina .	Kleks	0	Masc2
Odsłonili jednak tyły i kolejną bramkę zdobyli lechici .	tyły	2	Masc3
Wtedy wyciąga zawieruszony w pomiętej pościeli telefon komórkowy , by wszystkie je po kolei załatwić .	telefon	6	Masc3
Jakże mam Panu dziękować ?	Panu	2	Masc1
Niestety , niektórzy czytelnicy wierzą , że mogła m takie głupawe wierszydło napisać .	czytelnicy	3	Masc1
Niebo było pokryte białymi barankami .	barankami	4	Masc2
Przedsiębiorca wpadł w długi .	Przedsiębiorca	0	Masc1
A może w grę też wchodził rak ?	rak	6	Masc2
Padają pierwsi zabici .	zabici	2	Masc1
I wszystkim obalonym zwyczajom wrócono ich dobre imię .	zwyczajom	3	Masc3
Powstawały robotnicze kolonie przyfabryczne wiążące pracobiorcę z pracodawcą .	pracodawcą	7	Masc1
Obecni byli posłowie Pękała i Witaszczyk , ale nie przemawiali .	posłowie	2	Masc1
no s strasznie podobno pił ten facet . .	facet	6	Masc1
W akcji ratunkowej uczestniczyło ok. 20 ratowników .	ratowników	6	Masc1
W ten sposób Rumuni wystąpili w roli głównego mediatora pomiędzy Moskwą a Pekinem .	mediatora	8	Masc1
Ale ciągle trzymał ich dom i meble .	meble	6	Masc3
Lis już stał przed swoją norą .	Lis	0	Masc2
Mówi monotonnie , bez składniowych harców , przeskoków , dygresji .	przeskoków	7	Masc3
- Żeby być przyjętym na Uniwersytet w Cambridge , trzeba mieć 45 punktów .	punktów	12	Masc3
Powołana przez burmistrza komisja dokonała kontroli w Ośrodku .	Ośrodku	7	Masc3
- A ruskie są ?	ruskie	2	Masc2
Motywy jego tragicznego wypadku nie są znane .	Motywy	0	Masc3
Mieszka pod Warszawą , a w swoim pięciohektarowym gospodarstwie , oprócz dwudziestu psów , hoduje także konie i kozy .	psów	12	Masc2
Kardynał przewodniczy tam uroczystościom liturgicznym .	Kardynał	0	Masc1
Obowiązywać będzie od połowy maja .	maja	4	Masc3
Sprawdź dokumenty osoby zbierającej datki .	datki	4	Masc3
- Nie przyprowadzimy go , senior .	senior	5	Masc1
Weszli do lodowatej rzeki , by ratować zwierzaka .	zwierzaka	7	Masc2
Konkurentów mu nie brakuje .	Konkurentów	0	Masc1
- Czy w zaświatach dalej puszczasz się z żydowskimi demonami ?	demonami	9	Masc2
Powołujesz się na intelektualnego i emocjonalneog kastrata , ale czego innego mogł em się po Tobie spodziewać ?	kastrata	6	Masc1
Pora rozstać się z Hehem i chłopakami .	chłopakami	6	Masc1
Dzieci leżą w oddziale noworodków , ale mamy mogą je odwiedzać .	noworodków	4	Masc2
- Gdyby m jeszcze raz miał objąć funkcję prezesa , na pewno wiele rzeczy zrobił by m inaczej .	prezesa	8	Masc1
Zdradzisz nam sekrety urody Cosmodziewczyny ?	sekrety	2	Masc3
Od tamtego dnia boi się wyjść za próg domu .	dnia	2	Masc3
Głos nikł i stawał się coraz cichszy .	Głos	0	Masc3
Mogli by wówczas sprzedawać nie za dolara , ale za 95 centów i wygrywali by cenowo z konkurentami .	konkurentami	17	Masc1
W Piszu bracia Laudańscy już czekają .	bracia	2	Masc1
Dlaczego ZUS nie zrobił tego za jednym razem ?	razem	7	Masc3
Mundek zasiadł jak zwykle przy pianinie , Czesiek kiwał się przy kontrabasie .	kontrabasie	11	Masc3
Człowiek czuje się jak niewidzialny . . .	Człowiek	0	Masc1
- Trawianka azjatycka w Wiśle miała nie wytrzymać sezonu .	sezonu	8	Masc3
Na torze pod Kielcami odbyty się pierwsze wyścigi samochodowe .	torze	1	Masc3
Skrzypnęły drzwi i Liść wszedł do środka .	środka	6	Masc3
I jeszcze raz dziękuję za figurkę !	raz	2	Masc3
Ukląkł em przy Mateuszu i szybko wcisnął em mu woreczek do ręki .	woreczek	9	Masc3
Opublikowano też felieton pułkownika Bosaka .	felieton	2	Masc3
Likwidacja okazuje się dla wielu wyborców bolesna .	wyborców	5	Masc1
- Wiele złudzeń padło przez te dwa czy trzy lata .	lata	9	Masc3
Anatom Worobjew i biochemik Zbarski mieli ten zamysł wcielić w życie .	zamysł	7	Masc3
Lewicki wystartował spod lexusa , aby pomóc jej nieść bagaże .	lexusa	3	Masc2
Wydeptuję schody , duszę dzwonki .	dzwonki	4	Masc3
Czym te kontrakty się różnią poza wielkością dostaw ?	kontrakty	2	Masc3
Przedstawiciele Stalexportu zapewniają , że banki chcą dalej finansować holding .	banki	5	Masc3
Od tego czasu Tusk z nią nie rozmawiał .	czasu	2	Masc3
Dlatego uniknęli śmy krwawej dyzenterii lub tyfusu .	tyfusu	6	Masc3
Zalało perony na dworcu kolejowym .	dworcu	3	Masc3
Wiedźmin biegł za nim , licząc , że potwory rozciągną się w pościgu .	potwory	8	Masc2
Co w takim razie robić z takimi nadliczbowymi zarodkami ?	zarodkami	8	Masc3
Nowość polegała na tym , że nauczyciele chrześcijańscy wykazywali , iż w osobie Jezusa Chrystusa wypełniły się wszystkie przepowiednie proroków .	nauczyciele	6	Masc1
Luksusowego forda explorera nieznani sprawcy skradli wczoraj w Warszawie generałowi rosyjskiej milicji .	explorera	2	Masc2
Prace regulacyjne doprowadziły by do zniszczenia siedliska bobrów i do przepędzenia ich w nieznane .	bobrów	7	Masc2
To fakt .	fakt	1	Masc3
Raz w miesiącu , w niedzielę miał em dwie , trzy godziny wolne .	Raz	0	Masc3
– Ewelinka , zamknęła ś się od środka ? !	środka	7	Masc3
Od pól wiało melancholią października .	października	4	Masc3
Papierosy bez polskiej akcyzy miały trafić do Niemiec .	Papierosy	0	Masc2
- Wszystko było już w ogniu .	ogniu	5	Masc3
- Wsadzili mnie na takiego trupa , bracie .	trupa	5	Masc2
Utrzymuje Pan kontakt ze znajomymi ze studiów ?	znajomymi	4	Masc1
Trzeba ocenić system i ukarać konkretnych winnych .	system	2	Masc3
Na pewno też wywołał by protesty spowodowane dalszym naruszaniem stabilności sytuacji podatników .	podatników	11	Masc1
Rozpruła go zębami .	zębami	2	Masc3
Ludzie rozsunęli się natychmiast , robiąc szpaler aż do drzwi plebanii .	Ludzie	0	Masc1
Również państwo bardzo się starało , żeby księża wzięli swoje .	księża	7	Masc1
- Człowiek jest omylny , ale dusza jest nieomylna .	Człowiek	1	Masc1
Przez godzinę z boiska wiało nudą , a piłkarze prezentowali futbol plażowy .	futbol	10	Masc3
Maluchy i starsza młodzież spędzały tam czas po lekcjach , ucząc się i bawiąc .	Maluchy	0	Masc2
Przez wiele lat uchodził za radykalnego antykomunistę .	antykomunistę	6	Masc1
Tam kierowca forda , wymijając volkswagena golfa , uderzył w niego .	volkswagena	5	Masc2
Duże urozmaicenie wprowadzają do tegorocznej wystawy fotomontaże .	fotomontaże	6	Masc3
Cela była wesoła , to byli komuniści przyzwyczajeni do defensywy .	komuniści	6	Masc1
Przyniósł mu kiedyś steward nieświeży kotlet .	steward	3	Masc1
Przyjechawszy do Paryża latem Sołomin odszukał ich adres .	adres	7	Masc3
Hakerzy zaatakowali stronę internetową Watykanu .	Hakerzy	0	Masc1
- Coś mi się w motorze zepsuło .	motorze	5	Masc3
Teraz opowiem wam , jak został em królem .	królem	7	Masc1
Prowadzący śledztwo oskarżył o spowodowanie wypadku polskiego kierowcę .	kierowcę	7	Masc1
Mało brakowało , a miłość do zajączka Kamil przypłacił by życiem .	zajączka	6	Masc2
Błogosławieństwa nowożeńcom udzielił ks. kanonik Wesołowski .	nowożeńcom	1	Masc1
Tymczasem w bufecie panna Tola czyściła koszyki do chleba .	chleba	8	Masc3
W przypadku kręgowców naszej strefy klimatycznej były by to zależności zbyt uproszczone .	kręgowców	2	Masc2
Jak się okazało , na apel odpowiadają także mieszkańcy Warszawy i Krakowa .	apel	5	Masc3
Ponad 1600 osób wzięło wczoraj udział w 24 . maratonie ulicznym we Wrocławiu .	maratonie	9	Masc3
Co lubią maturzyści ?	maturzyści	2	Masc1
Gonią mnie potwory .	potwory	2	Masc2
Czterech ludzi nie żyło prawie na pewno .	ludzi	1	Masc1
Milicjant , krostowaty młokos , długo spisywał jej zeznanie .	Milicjant	0	Masc1
Dotyczy ta ballada przygody filozoficznej chłopka-roztropka .	chłopka-roztropka	5	Masc1
Świniak ten jest kumplem Ałganowa .	Świniak	0	Masc2
W lasach pasły się krowy i owce , czasem ozwał się poryk niedźwiedzia lub gniewne parsknięcie rysia .	rysia	16	Masc2
Taboret upadł z dramatycznym łoskotem , a on , wierzgając nogami , zawisł niczym gotowy do wypatroszenia wieprz .	wieprz	17	Masc2
Trumna tonie w kwiatach .	kwiatach	3	Masc3
Zbliżali się oplem do mostu na kanale .	kanale	6	Masc3
Dziesięciu jeźdźców pokonuje trasę z Torunia do Pucka .	jeźdźców	1	Masc1
Luiza słyszała nad sobą kroki Weelsa .	kroki	4	Masc3
Pani Rylicka odchyliła się do tyłu .	tyłu	5	Masc3
otworzę kanały elektryczne i niech wlezie tam . .	kanały	1	Masc3
Mimo że prostowała m to w prasie , wiersz w pewnych kręgach nadal cieszy się powodzeniem .	wiersz	8	Masc3
Chorąży Nałęcz - Komornicki wydawał swoim moździerzystom komendy spokojnie i prawie beznamiętnie .	moździerzystom	6	Masc1
Widzicie , lyrijski orzeł czarny i rivskie rauty czerwone .	orzeł	3	Masc2
Mieszkał z ojcem i nie chciał , żeby ktoś wiedział , że płaci takie duże rachunki .	ojcem	2	Masc1
Ślepi niewidomych prowadzą w dół .	Ślepi	0	Masc1
Przygotowanie takiej paczki nie stanowi problemu finansowego dla wielu ludzi .	ludzi	9	Masc1
Nic nie wiem o tym , by po moim aresztowaniu pan mecenas doradzał Barbarze .	mecenas	11	Masc1
Przy kościele spoczywają powstańcy z 1831 i 1848 .	powstańcy	3	Masc1
Czeka koń z furą .	koń	1	Masc2
Hotel posiadać będzie trzydzieści stylowo umeblowanych pokojów .	Hotel	0	Masc3
Ten pstrąg zajeżdżał mułem głębinowym , to wszystko .	mułem	3	Masc3
Dla niej był em jedynym chłopcem .	chłopcem	5	Masc1
Papier wydaje mi się ciepły .	Papier	0	Masc3
Andrzej Kowerski pozostawał w jej cieniu i nie wiadomo , jak to znosił .	cieniu	5	Masc3
Na świecie żyje 18 cichociemnych .	cichociemnych	4	Masc1
Zdjęła materiał z palca i wsadziła do kieszeni kurtki .	materiał	1	Masc3
Finansowo wspiera Trutnia Gminny Ośrodek Kultury w Rabie Wyżnej , a także skawiańscy biznesmeni z Polski i Chicago .	Trutnia	2	Masc2
Na czwartym rogu Żelaznej wywrócili kiosk z papierosami , jako przeszkodę , papierosy się posypały .	rogu	2	Masc3
Wykształciuchy bronią się przed premierem .	Wykształciuchy	0	Masc2
O godzinie dziewiątej rewiry były już zapchane .	rewiry	3	Masc3
Projekt nie wykracza poza gminy .	Projekt	0	Masc3
Prezes ma całkowitą kontrolę nad swoją firmą , a bezpośrednia władza premiera kończy się na progu jego sekretariatu .	sekretariatu	17	Masc3
– ale to były tereny polskie w okresie międzywojennym . .	tereny	4	Masc3
Po odparciu ataku i ujęciu 10 terrorystów zawrócono konwój do bazy w Al Kut .	ataku	2	Masc3
– Ehm , nie wiem tak naprawdę , Komediancie .	Komediancie	8	Masc1
Wynikła awantura , ale w duchu przyznano bosmanowi rację .	duchu	5	Masc2
Żeby opłacić dziennikarza , przeciętne warszawskie osiedle musiało by się złożyć po 10 groszy .	dziennikarza	2	Masc1
Razem z mętami w Bornem Sulinowie pojawiły się klechy .	mętami	2	Masc2
Kielich stał się obmierzły dla wargi .	Kielich	0	Masc3
– Dziadek zagrzmiał swoim głosem basowym .	Dziadek	1	Masc1
Wróg może się czaić za węgłem domu , może stać przy każdej latarni .	Wróg	0	Masc1
Człowiek przecie nie będzie całą dobę siedział i poprawiał .	Człowiek	0	Masc1
A gdzie szukać szamponu , który myje ?	szamponu	3	Masc3
Bzykali śmy się na boczku , na kogutka , na suczkę , na peryskop .	kogutka	7	Masc2
Wioślarzom AZS przybył nowy konkurent .	Wioślarzom	0	Masc1
Arnim von Colbatz przyjechał do was .	von	1	Masc1
Pomimo upałów pracował prezydent Lech Aleksander Kaczyński .	upałów	1	Masc3
Piątkowy program przewiduje także cztery mecze hokejowe .	program	1	Masc3
Lekarz i taksówkarz nie przyznają się do winy .	Lekarz	0	Masc1
To nauczyciele muszą się do nich dostosować .	nauczyciele	1	Masc1
U ludów słowiańskich rodzina miała charakter patriarchalny , a przewodził jej ojciec .	ludów	1	Masc3
- Brak nam jeszcze wielu umów z gospodarzami indywidualnymi . . .	gospodarzami	7	Masc1
Czym zapełnić dziurę w budżecie ?	budżecie	4	Masc3
Te wszystkie rogi zostały zdemontowane i wywiezione do Szczecina .	rogi	2	Masc3
W kierunku zachodnim przewożono ich mercedesem .	mercedesem	5	Masc2
Dotychczas za kratkami znalazło się sześciu egzaminatorów i pośredników .	pośredników	8	Masc1
Bo chciały uratować zaskrońca , ale teraz są w kropce .	zaskrońca	3	Masc2
Wyciągnęli z płomieni mężczyznę .	mężczyznę	3	Masc1
Rodzice kondorka trochę się pospieszyli .	kondorka	1	Masc2
Wiedziała ruda dziewczynka z warkoczykami i piegowatym noskiem .	noskiem	7	Masc3
Ma białego słuchać !	białego	1	Masc1
Człowiek jest omylny .	Człowiek	0	Masc1
Potrawy były oceniane przez 110 niezależnych sędziów .	sędziów	6	Masc1
Gdyby producenci podpatrywali świat oczami artystów , mieli by ciekawą ofertę handlową .	producenci	1	Masc1
" Powiem ci w sekrecie , że oni są małżeństwem .	sekrecie	4	Masc3
Nie mam wyboru , pomyślał Tadeusz .	wyboru	2	Masc3
- Pan inżynier rosołku by nie popił ?	rosołku	3	Masc3
— Nie mogę , muszę napisać raport .	raport	6	Masc3
Dodatkowym zabezpieczeniem będzie unikanie kwiatowych deseni .	deseni	5	Masc3
Wracajcie pod szyb po ludzi , siekiery i kilofy .	kilofy	8	Masc3
- Tydzień temu koń go stratował i też tak mówił .	Tydzień	1	Masc3
Księżyc stoi w zenicie .	zenicie	3	Masc3
Rumieniec buchnął na policzki Janka .	policzki	3	Masc3
To był cios między oczy .	cios	2	Masc3
Dziękuję , Panie Inspektorze .	Inspektorze	3	Masc1
Artyści poprowadzą biesiadę śląsko - bawarską .	Artyści	0	Masc1
- Bo nasz kot dezerterem okazał sia . . .	dezerterem	4	Masc1
Byli to bracia Borkowscy .	bracia	2	Masc1
Opiekę sprawuje opiekun .	opiekun	2	Masc1
Nie składają donosów do prokuratury , nie przejmują się całodobowym uśmiercaniem poczętych ?	donosów	2	Masc3
Przed oczyma Angusa przesuwały się obrazy z przebytej epopei .	obrazy	5	Masc3
Ten pstrąg zajeżdżał mułem głębinowym , to wszystko .	pstrąg	1	Masc2
Uniewinnienie przełożonych ich synów wstrząsnęło zbolałymi kobietami .	synów	3	Masc1
Trwa dobra passa piłkarzy mieszkowickiego Mieszka .	piłkarzy	3	Masc1
Tylko nie strzelać bez rozkazu .	rozkazu	4	Masc3
Zaatakował chłopak .	chłopak	1	Masc1
Obu szwedzkim dyplomatom zarzucono też działalność wykraczającą poza ich oficjalny status .	dyplomatom	2	Masc1
Siedział ponury na przedzie tramwaju , pod plastykowym dachem .	przedzie	3	Masc3
Zza ciemniejących pni drzew wyłonił się strzelec .	strzelec	6	Masc1
Ashram w Magliano Sabina to ośrodek dla małych dzieci Sahaja Yoginów .	ośrodek	5	Masc3
- Pan kapral musi jeszcze zostać .	kapral	2	Masc1
Krzysiek musiał wziąć kredyt z banku .	kredyt	3	Masc3
Pani Ania , na przykład , mówi , że chce coś jeszcze w życiu zrobić dla ludzi .	przykład	4	Masc3
W niedzielę w nocy anonimowy rozmówca zawiadomił dyżurnego policji , że w banku znajdują się ludzie .	rozmówca	5	Masc1
Okazał się pan Wielkim Człowiekiem w tym szambie .	Człowiekiem	4	Masc1
Nosi własny elementarz .	elementarz	2	Masc3
Sprawdzili śmy u dealerów , jakie auta spełniają ZUS-owskie marzenia .	dealerów	3	Masc1
Rozładował ją na brzegu , a ona cisnęła naboje do wody .	naboje	8	Masc3
Ptak ten nie ma takich zdolności jak albatros czy sokół .	sokół	9	Masc2
Tam przejął mnie wywiad angielsko - amerykański .	wywiad	3	Masc3
- Katolik nie musi wierzyć w cuda ?	cuda	6	Masc3
Chart nie raczył nawet mnie obwąchać .	Chart	0	Masc2
Obok wspomnianych przedmiotów ścisłych lubi biologię , przykłada się do angielskiego .	przedmiotów	2	Masc3
Wyrok znów był niekorzystny , ale emeryt się nie poddaje .	emeryt	6	Masc1
Samorządowcy zorganizowali spotkanie w tej sprawie .	Samorządowcy	0	Masc1
W milczeniu spożywali zimną konsolację , szczękały sztućce , dworscy w ciemnych surdutach sprawnie zmieniali misy .	surdutach	12	Masc3
Siła uderzenia wbiła renaulta w innego tira .	tira	6	Masc2
Tymczasem smutny urzędnik konsulatu zajął się moim bagażem .	urzędnik	2	Masc1
Pan hrabia nawet przez moment nie miał nas za szpiegów , inaczej nie udzielił by nam tak dogłębnych wyjaśnień .	hrabia	1	Masc1
Wśród uciekinierów jest 40-latek z Radomia oraz pięciu nieletnich .	uciekinierów	1	Masc1
Z jakiego powodu tak zaskoczyło ono paleoantropologów ?	paleoantropologów	6	Masc1
Z niepokojem spoglądają oni na pochmurne niebo i termometr , śledząc przy tym pilnie prognozy meteorologiczne .	termometr	8	Masc3
Uczciwie mówiąc , miał nieco stracha .	stracha	5	Masc2
Frajer odjedzie .	Frajer	0	Masc1
Wiatry słabe z kierunków zmiennych .	Wiatry	0	Masc3
Jeszcze w 1576 , jak wspominają akta wizytacyjne , mieszkali tu wolni Prusowie .	akta	6	Masc3
Ale ja go rozumiem i wszystkich dziennikarzy proszę o to samo .	dziennikarzy	6	Masc1
Zaraz skonam z głodu .	głodu	3	Masc3
- Czy ma Pan sportowego idola ?	idola	5	Masc1
- Jak mam nie wierzyć w swoich zawodników ?	zawodników	7	Masc1
- A ja mówię panu profesorowi , że nie pójdę .	profesorowi	5	Masc1
- Czy twój bóg zapewnił cię o tym ?	bóg	3	Masc1
Reżyser nastawia ucha .	Reżyser	0	Masc1
Posłowie udzielili też rządowi absolutorium z wykonania ubiegłorocznego budżetu .	rządowi	3	Masc3
tam są różne różki .	różki	3	Masc2
Prawnik powoli , mocno trzymając się liny , przeszedł na koniec trapu .	Prawnik	0	Masc1
Powstał rynek pracy dla przewodników , tropicieli i strażników .	przewodników	4	Masc1
Tekst wyszedł spod srebrzystych parkerów Colina Rowe'a i Roberta Slutzky'ego .	Tekst	0	Masc3
W dorożce siedział rozparty chirurg Tamten .	chirurg	4	Masc1
Jeńcami dowodził młody podporucznik .	podporucznik	3	Masc1
Zasypiam , ssąc chrupką skórkę przy migoczącym w telewizji Człowieku z żelaza .	Człowieku	9	Masc1
W takich warunkach wielu duchownych decydowało się na organizowanie katakumbowego życia religijnego .	duchownych	4	Masc1
Działacze liczą , że związek nie będzie ścigany z całą surowością .	związek	4	Masc3
Dzięki poradnikowi dowiadujemy się , że roczną deklarację oznaczają cyfry 01 .	poradnikowi	1	Masc3
Piszę o tym za zgodą kapitana Domejki .	kapitana	5	Masc1
Oprócz słuchania Steczkowskiej delegaci zajmowali się dyskusją o strajku generalnym .	delegaci	3	Masc1
- Chory ożywił się i odłożył różaniec .	różaniec	6	Masc3
Dach przypomina fale morskie , które często zdobią japońskie drzeworyty .	Dach	0	Masc3
Premier Józef Cyrankiewicz przyjął wicepremiera Rumunii George Radalescu .	wicepremiera	4	Masc1
W Nowym Tomyślu wiatr zerwał dach urzędu skarbowego i pasażu handlowego .	urzędu	6	Masc3
Preferujesz moralnośc opartą na miłosci bliźniego ?	bliźniego	5	Masc1
Bez przesady , nie jestem już tym , co wycierał się na Mazurach w pomarańczowy ręcznik .	ręcznik	15	Masc3
Oprócz Polaków odpływali na tę wyprawę także i cudzoziemcy , wszyscy spod znaku republikańskiego .	znaku	12	Masc3
W sidła oszustów - pośredników oferujących pracę Polacy wpadają także w Hiszpanii .	pośredników	4	Masc1
Ugryzienia osy , pszczoły , trzmiela i szerszenia mogą być niebezpieczne .	szerszenia	7	Masc2
Ekolodzy zaopatrzyli młodszych kolegów w worki na śmieci i rękawiczki .	kolegów	3	Masc1
Okazało się , że 22-latek jest żołnierzem służby czynnej .	żołnierzem	6	Masc1
Podlewajcie kwiaty .	kwiaty	1	Masc3
Na licytację wystawione zostaną prace uczniów i szkolnego plastyka Romana Waszko .	uczniów	5	Masc1
Zbliżali się oplem do mostu na kanale .	oplem	2	Masc2
Braków wtenczas nawet poeci nie wypuszczali .	poeci	3	Masc1
Nie przebierali w środkach .	środkach	3	Masc3
Profesorze , ja nie myślała m o jego życiu .	Profesorze	0	Masc1
Dziadem był eś , dziadem będziesz !	Dziadem	0	Masc1
- Nie siedem sympatycznych krasnali tu mieszka .	krasnali	4	Masc2
Nie chciał też podjąć się roli obrońcy ani sędziego .	obrońcy	6	Masc1
Ciężko poranili kilkunastu policjantów .	policjantów	3	Masc1
Tata musiał pojechać do domu .	Tata	0	Masc1
Oprócz okradania opolan eseldziaki kantowały również kumpli w interesach .	eseldziaki	3	Masc2
Na dziobie , bodącym niebo , przerzucony przez poręcz wisiał mister Dawid Lingslay .	mister	10	Masc1
Mogła m sprawdzić dokładnie ten link przed napisaniem posta .	posta	8	Masc2
Ja wszelako nie piszę w imieniu przegranych polityków .	polityków	7	Masc1
- Wasza gazeta od dawna robi świetne przewodniki dla poszukujących pracy w Irlandii .	przewodniki	7	Masc3
Zaangażowała się w Teatrze Dramatycznym kierowanym wówczas przez Gustawa Holoubka .	Teatrze	3	Masc3
Po lewej mam kościół , ludzie z niego wychodzą i do niego wchodzą .	kościół	3	Masc3
Do skomplikowanych wzorów używamy deski przywiązanej do sznurka .	sznurka	7	Masc3
Magister podreptał ukosem przez podwórzec , nikły , żałosny w swej czarnej sukni .	ukosem	2	Masc3
O zawilgoceniu gruntu i budynków informowali jedynie archeolodzy prowadzący wykopaliska na starówce .	archeolodzy	7	Masc1
W lasach pasły się krowy i owce , czasem ozwał się poryk niedźwiedzia lub gniewne parsknięcie rysia .	lasach	1	Masc3
- Jeżeli ćwiczący źle dobiorą rakiety , piloci nie zniszczą przeciwnika .	przeciwnika	10	Masc1
Orzeczenie separacji nie oznacza , że w przyszłości nie można wystąpić o rozwód .	rozwód	12	Masc3
Trzeba się spieszyć , bo lada moment pojawią się posłowie IV kadencji .	posłowie	9	Masc1
Nad Odrą stoi obrońca .	obrońca	3	Masc1
- Co powie twój mąż ?	mąż	4	Masc1
W Technikum Mechanicznym wszystkie osoby zaliczyły pierwszy etap .	etap	7	Masc3
Tłum domaga się wydania zbiega .	zbiega	4	Masc1
Jak wyglądają twoje obowiązki ?	obowiązki	3	Masc3
Najlepszy polski tyczkarz Janusz Gronowski przebywa obecnie w Finlandii .	tyczkarz	2	Masc1
Niech wejdzie lis Chmura w świetny stan , górników polskich stan .	stan	6	Masc3
Szczep nie zazieleni się więcej .	Szczep	0	Masc3
Rozpoczyna się teraz emocjonujący wyścig ze zbliżającą się burzą .	wyścig	4	Masc3
Co panią łączy z panem prezydentem Kaczyńskim ?	panem	4	Masc1
Niech zstąpi Duch Twój !	Duch	2	Masc2
Przez kolejne szeroko otwarte drzwi widział dziewczynę już od progu .	progu	9	Masc3
Pozbył się balastu , nim ten balast odebrała mu zamieć historii .	balastu	2	Masc3
Cieszymy się , że ojciec przybył , brakuje nam ludzi .	ojciec	4	Masc1
Czarne mają znaczną przewagę , a Biały Hetman jest atakowany .	Hetman	7	Masc2
W pewnej chwili otworzył em oczy , wyrwany z gorączkowej drzemki jakimś ruchem .	ruchem	12	Masc3
Przy wypełnianiu zeznania podatnik powinien się trzymać ustawy i rozporządzeń wykonawczych .	podatnik	3	Masc1
Państwu to nic nie mówi ?	Państwu	0	Masc1
Partie polityczne oraz reprezentujący ich politycy stanęli w wyborcze szranki .	politycy	5	Masc1
Przed drzwiami sali rozpraw siedzieli uzbrojeni antyterroryści .	antyterroryści	6	Masc1
Ma też w planach rozwinięcie swojej działalności w naszym kraju .	planach	3	Masc3
Warto by zażądać wojskowego konsultanta .	konsultanta	4	Masc1
Mówi , że za komuny było lepiej , bo można było iść do sekretarza partii .	sekretarza	13	Masc1
Zapomnij też o wszelkich środkach uśmierzających ból .	środkach	4	Masc3
- Może zresztą sam zostaniesz ambasadorem ?	ambasadorem	5	Masc1
W tajnym głosowaniu żaden z pretendentów nie uzyskał wymaganej większości .	pretendentów	5	Masc1
Ofiarę udusili paskiem i dobili kamieniami .	paskiem	2	Masc3
Rozdali kilofy i łomy .	kilofy	1	Masc3
– Zagrajmy w pokera .	pokera	3	Masc2
Serwal to rzadko spotykany w polskich ogrodach drapieżnik z rodziny kotów .	kotów	10	Masc2
Artysta odleciał do Egiptu , gdzie wystąpi na dwóch koncertach .	Artysta	0	Masc1
Poranione potłuczoną butelką zwierzę trafiło do weterynarza .	weterynarza	6	Masc1
Pili śmy wtedy koniak z literatek .	koniak	3	Masc3
We wtorek w Annopolu , gdzie Wisła przekroczyła stan alarmowy o 34 cm , ogłoszono alarm przeciwpowodziowy .	alarm	15	Masc3
W Fundacji można też uzyskać wyczerpujące informacje na temat fachowej opieki nad kotami domowymi .	kotami	12	Masc2
Nikt tu nie krzyczał , nikt nie wzywał ratunku .	ratunku	8	Masc3
Zazwyczaj młodym kobietom z zagranicy , zwabionym i przymuszanym do nierządu , sutenerzy odbierają paszporty .	nierządu	10	Masc3
Dzieciak zaczął drzeć się wniebogłosy .	Dzieciak	0	Masc2
- Wsadzili mnie na takiego trupa , bracie .	bracie	7	Masc1
Klasztor fundacji Gaszynów posiada sklepione cele i korytarze komunikacyjne .	korytarze	7	Masc3
Ta grupa w części pewnie będzie się składać z dawnego elektoratu SLD .	elektoratu	10	Masc3
W czwartek rano na terenie stoczni utonął 60-letni pracownik Gdańskiej Stoczni Remontowej .	pracownik	8	Masc1
Nagrody i poczęstunek był dla wszystkich , a najlepsi zawodnicy otrzymali ponadto puchary .	poczęstunek	2	Masc3
Przeklęty widok przed oczy wystawił .	widok	1	Masc3
Wąż w kieszeni go uratował .	Wąż	0	Masc2
Na moście zatrzymują się kolejne samochody .	moście	1	Masc3
Steve zaklina się , że po każdym dyżurze szykuje ekstra posiłek czworonożnemu ratownikowi .	ratownikowi	12	Masc1
Idę płakać nad moim losem .	losem	4	Masc3
Zdaniem konkurentów , wyznaczył kanon radiowej prowokacji w warunkach polskich .	konkurentów	1	Masc1
Nasz przyjaciel Taban zamilkł .	przyjaciel	1	Masc1
Ten futszak wszedł do jej domu .	futszak	1	Masc2
- Nie jestem typowym jazzmanem , choć tak bywam oceniany .	jazzmanem	4	Masc1
Numer drugi mrugał zachęcająco .	Numer	0	Masc3
Jakie są główne zarzuty rzecznika ?	zarzuty	3	Masc3
Za co lekarze domagają się tak wielkich sum ?	lekarze	2	Masc1
Takich zysków nie przyniosła żadna inna lokata giełdowa .	zysków	1	Masc3
Czy pan hrabia ceni jego wyroby ?	wyroby	5	Masc3
Papa był na dopingu .	dopingu	3	Masc3
- Tydzień temu koń go stratował i też tak mówił .	koń	3	Masc2
Sięgnął em dłonią do jej policzka .	policzka	5	Masc3
W tym momencie znowu usłyszał szelest .	momencie	2	Masc3
To jakiś dziwak albo pomylony .	pomylony	4	Masc1
Pięcioletnia dziewczynka , porwana wczoraj przez 65-letniego mężczyznę w Chorzowie na Śląsku , odzyskała wieczorem przytomność .	mężczyznę	7	Masc1
Ksiądz Tadeusz ma już adwokata .	Ksiądz	0	Masc1
Grób Pikusia i Miśka rozświetlają znicze .	Grób	0	Masc3
Miał rasowego ogiera .	ogiera	2	Masc2
Tutaj wyraźnie widać wrażliwe , skłonne do ufności i entuzjazmu oblicze eseisty .	entuzjazmu	9	Masc3
Po zetknięciu z ziemią maszyna wybuchła , a siła eksplozji wyrzuciła dwóch słowackich mechaników i Marka Panasia .	mechaników	13	Masc1
Rzeczywiście , nie jest to film jak inne filmy i to z kilku powodów .	filmy	8	Masc3
Demon wchodzi bez pukania . . .	Demon	0	Masc2
Siedzimy naprzeciw siebie , pijemy herbatę , jemy piernik domowego wypieku .	wypieku	10	Masc3
Jadąc fordem escortem nie ustąpiła pierwszeństwa karetce pogotowia .	escortem	2	Masc2
Wykluczenie alergenu z otoczenia chorego jest trudne .	chorego	4	Masc1
Radiotelegrafista skłonił się z uszanowaniem .	Radiotelegrafista	0	Masc1
Ogolić jaja na skina ?	skina	3	Masc1
– bo ja tylko pamiętam uniwersal . .	uniwersal	5	Masc3
Do drugiego wypadku doszło wieczorem na przejściu dla pieszych koło poczty .	wieczorem	4	Masc3
- Dokąd się panowie wybierają ?	panowie	3	Masc1
Adres niech dobrodziej spisze z dowodu osobistego .	dowodu	5	Masc3
W kolejnych rzędach stali niewidomi , część z psami - przewodnikami , a także niesłyszący i niemi .	niewidomi	4	Masc1
Demokracja nie gwarantuje sukcesu i nawet nie gwarantuje sama siebie .	sukcesu	3	Masc3
Mieszkańcy zaczęli przestępować z nogi na nogę i pomruk przeszedł nad głowami .	pomruk	8	Masc3
Ale ci politycy z kolei nie gwarantują przeprowadzenia koniecznych reform gospodarczych .	politycy	2	Masc1
Ubrani w białe koszule uczniowie ustawiają się na zbiórce w parku naprzeciwko gimnazjum .	uczniowie	4	Masc1
Poza Centralną Komisją Wyborczą głosy liczy także LADO .	głosy	4	Masc3
Krakowskich melomanów czeka jeszcze jedna atrakcja .	melomanów	1	Masc1
Właścicielom wystarcza kino domowe , a bogate panie nie potrafią docenić kunsztu Anny Jaxy - Chamiec .	Właścicielom	0	Masc1
Kruk krukowi oka nie wykole .	krukowi	1	Masc2
Ktoś wysiadł z tramwaju ?	tramwaju	3	Masc3
Błogosławieństwa nowożeńcom udzielił ks. kanonik Wesołowski .	kanonik	4	Masc1
– Rodzice i twój brat wrócili do domu .	Rodzice	1	Masc1
Zenek prosił kolegów , żeby nic nie mówili mamie , gdyby go przysypało .	kolegów	2	Masc1
Czasem starczyło wstać i wskazać palcem , inni natychmiast chwytali za drągi .	drągi	11	Masc3
Huragan wyrządził także znaczne szkody materialne .	Huragan	0	Masc3
- Słyszał em kiedyś , Aniołek tu lubiał śpiewać , ale nie pamiętam detalicznie .	Aniołek	5	Masc2
- Nasi urzędnicy przyjrzą się drodze .	urzędnicy	2	Masc1
Dotarli śmy wreszcie pod szczyt Mnicha .	szczyt	4	Masc3
Na ścianach wisiały pamiątkowe fotografie i adresy gratulacyjne .	adresy	6	Masc3
Borys Conrad , syn znakomitego pisarza Józefa Conrada - Korzeniowskiego przybył do Warszawy .	pisarza	5	Masc1
Trzecie miejsce przypadło Zakładowi Poprawczemu z Kcyni .	Zakładowi	3	Masc3
Takiemu psiakowi nie umknie zapewne żaden zapach .	psiakowi	1	Masc2
Ben Menasse porwał straszydło za ramię , ale przybysz nie zdawał się zważać na ponaglanie .	przybysz	8	Masc1
Wiem tylko , że jego żona jeszcze w Nowym Jorku zdecydowała się wrócić z synem do kraju .	synem	14	Masc1
Zerkała na czarno - biały obraz i pogryzała słone paluszki .	paluszki	9	Masc2
Powierzchnię morza pruły statki , oczekujące pojawienia się ostatniego członu rakiety .	statki	3	Masc3
I szedł em przez te stygnące odchody coraz bardziej markotny , a przygnębienia przybywało mi z każdym krokiem .	krokiem	17	Masc3
- Oczywiście , przecież nie robię filmów dla siebie .	filmów	6	Masc3
Po chwili znika w tłumie .	tłumie	4	Masc3
Związkowcy nie mają łatwego życia w policji .	Związkowcy	0	Masc1
Przed światłami kierujący ruchem zatrzymał tira , a za nim stanęła skoda .	ruchem	3	Masc3
W ten sposób wzrasta częstotliwość sygnałów .	sygnałów	5	Masc3
– Ojciec Benedykt służył tutaj ?	Ojciec	1	Masc1
Projekt był omawiany dwukrotnie .	Projekt	0	Masc3
Rozumiał brata .	brata	1	Masc1
Stary pierścionek z rautami zaświecił nikło .	rautami	3	Masc3
Halina Auderska we wszystkich książkach każe swoim bohaterom szukać tożsamości .	bohaterom	7	Masc1
Generalnie jestem optymistą .	optymistą	2	Masc1
Hinduska nie zdradza męża .	męża	3	Masc1
Dymkę oczyścić i pokroić na kawałki .	kawałki	5	Masc3
- Nie bądź krnąbrna , to grzech .	grzech	6	Masc3
Śpieszyli za swoim sztygarem .	sztygarem	3	Masc1
Ręką wskazał mi fotel .	fotel	3	Masc3
– ja chciał by m trochę z boku jakby podejść .	boku	7	Masc3
Furorę robili sygnaliści z Tucholi .	sygnaliści	2	Masc1
Prawdopodobnie wkrótce straci immunitet .	immunitet	3	Masc3
Księżyc staje się jakby natrętnym partnerem .	partnerem	5	Masc1
Większość to uciekinierzy i ich potomkowie .	potomkowie	5	Masc1
Zapał poszedł na marne .	Zapał	0	Masc3
Brakowało jakiegoś rysu dawnego Jeffa .	rysu	2	Masc3
Po drugie , wkraczali śmy na wyjątkowo niewdzięczny teren .	teren	8	Masc3
Zresztą , to już zaczyna przypominać jakiś nałóg .	nałóg	7	Masc3
Burmistrz , Zbigniew Grzesiak , wyjaśnił , że są trudności w porozumieniu się z Urzędem Rejonowym .	Burmistrz	0	Masc1
Nie chciał em być niczym , nawet anarchistą .	anarchistą	7	Masc1
Co chwila dzwonili towarzysze z różnych instancji i coś Pomianowiczowi delikatnie sugerowali .	towarzysze	3	Masc1
Trudno też spotkać krajalnice do serów twardych .	serów	5	Masc3
Krew spryskała bok mierzynka .	mierzynka	3	Masc2
Celnicy podejmują decyzje o bardzo dużych kwotach .	Celnicy	0	Masc1
Adwent ma dla Pasierba szczególne znaczenie .	Pasierba	3	Masc1
W czasach uczelnianego wyścigu szczurów i masowego bezrobocia pełni często rolę bezpłatnej terapii .	szczurów	4	Masc2
A Kwaśniewski poparł system parlamentarno - gabinetowy .	system	3	Masc3
- Co to kułacy ?	kułacy	3	Masc1
Najbliżsi rywale Orfe także nie rezygnują z przejęcia kolejnych mniejszych dystrybutorów .	rywale	1	Masc1
Siedzi w nim dwóch ludzi .	ludzi	4	Masc1
Wypadek nie przyniósł groźniejszych konsekwencji .	Wypadek	0	Masc3
Pomidory pokroić w ćwiartki .	Pomidory	0	Masc2
Bar powoli zaczął się zapełniać .	Bar	0	Masc3
Niech wejdzie lis Chmura w świetny stan , górników polskich stan .	stan	10	Masc3
Kobiety w więzieniu doskonale łagodzą obyczaje .	obyczaje	5	Masc3
W lasach pasły się krowy i owce , czasem ozwał się poryk niedźwiedzia lub gniewne parsknięcie rysia .	niedźwiedzia	12	Masc2
Za wprowadzenie czytelników w błąd przepraszamy .	błąd	4	Masc3
Pan asesor zamilkł i więcej już do końca sądu nie otworzył ust swoich .	asesor	1	Masc1
Woziły im posiłki na wózkach .	wózkach	4	Masc3
Najlepszy księgowy województwa śląskiego to rybniczanin .	księgowy	1	Masc1
Miał em zapas na dole wózka .	zapas	2	Masc3
Do tej pory ani kurator oświaty , ani powiat nie przekazywali pieniędzy na to zadanie .	kurator	4	Masc1
W forcie więziono również Rosjan , Francuzów i Jugosłowian i niemieckich antyfaszystów .	antyfaszystów	11	Masc1
Przybysze z najnowszej fali na ogół stronią od polonijnych organizacji społecznych .	Przybysze	0	Masc1
Pozostawiamy ją bez komentarza . . .	komentarza	3	Masc3
- Nie ma wrzątku bez ognia , a ognia nie ma bez drew !	ognia	5	Masc3
Czyżby teraz przepuściła okazję , mając tuż obok przystojnego młodego mężczyznę ?	mężczyznę	10	Masc1
- Panie przodowniku , jak pragnę wolności , to same równe chłopaki .	przodowniku	2	Masc1
Idiotka Zuzia zapomniała zrobić w banku blokadę i całą forsę zajęli na długi .	banku	5	Masc3
Nigdy nie zostanie rusałką ta , która pokalała swój wianek .	wianek	9	Masc3
Tymczasem w bufecie panna Tola czyściła koszyki do chleba .	bufecie	2	Masc3
Blish jest przede wszystkim marzycielem- propagandzistą .	propagandzistą	5	Masc1
Olbrzymy zazwyczaj są barwy czerwonej .	Olbrzymy	0	Masc2
Tam kierowca forda , wymijając volkswagena golfa , uderzył w niego .	forda	2	Masc2
23--letni rolnik jechał ciągnikiem z rozdrabniarką do gałęzi .	rolnik	1	Masc1
Głosowało 364 posłów .	posłów	2	Masc1
- Bo nie mam dwóch przodów .	przodów	5	Masc3
Ochmistrz , grubasek i smakosz , spuścił oczy w milczeniu .	Ochmistrz	0	Masc1
Mężczyzna z sumiastymi wąsami nazwany kawalerem wyraźnie się speszył .	wąsami	3	Masc3
Ciągle też nie wiadomo , jaki będzie pełny skład rady PRKCh .	skład	8	Masc3
- Zawsze chciał em być artystą .	artystą	5	Masc1
Gdzie diabeł nie może ?	diabeł	1	Masc2
Laserów raczej nie ominie .	Laserów	0	Masc3
Zapowiedzieli , że lekarzom nie należą się zaległe pieniądze , bo prawo nie działa wstecz .	lekarzom	3	Masc1
Architekci opracowujący rysunki robocze są zazwyczaj wieloletnimi praktykami .	Architekci	0	Masc1
Oni są w rogu .	rogu	3	Masc3
Krew ciągle płynęła mu z nosa .	nosa	5	Masc3
Na zegarze kościelnym wybiła północ .	zegarze	1	Masc3
Zwiększono nakład , objętość , pojawiły się nawet honoraria .	nakład	1	Masc3
Wiele pociągów odwołano .	pociągów	1	Masc3
- Znam teczkę brata i przyjaciela .	przyjaciela	5	Masc1
Trzeba się dostać na posiedzenie Komitetu i po prostu głośno to wszystko powiedzieć .	Komitetu	5	Masc3
Jedyna różnica to rozmiar .	rozmiar	3	Masc3
Przed obecnymi na spotkaniu wystąpili dzisiejsi uczniowie szkoły .	uczniowie	6	Masc1
Po zranieniu żony , napastnik zbiegł .	napastnik	4	Masc1
Za nim podreptał wiotki młodzieniec z magnetofonem na ramieniu .	młodzieniec	4	Masc1
Akcje funduszy jak najszybciej mają być wprowadzane na giełdę .	funduszy	1	Masc3
Ale menażer klubu z Mannheim nalegał , aby do transferu doszło już teraz .	transferu	9	Masc3
Do poradni chirurgicznej i pogotowia ratunkowego napływali poszkodowani piesi .	piesi	8	Masc1
Dwa duże statki zostały zatopione przez powstańców .	statki	2	Masc3
Trzeba się spieszyć , bo lada moment pojawią się posłowie IV kadencji .	moment	6	Masc3
Szukając zysku , musiały ryzykować .	zysku	1	Masc3
Jest cieślą , zna się na tym .	cieślą	1	Masc1
Zapraszam wszystkich chętnych .	chętnych	2	Masc1
Przyjaciele mówią , że towarzysko jest miły , ale bywa bardzo złośliwy .	Przyjaciele	0	Masc1
Dociekał , czy lubi seks , bo on w tym względzie ma duże doświadczenie .	seks	4	Masc3
Tak robią wandale na wikipedii .	wandale	2	Masc1
Pokazano w tym filmie wieś spółdzielczą w skrócie . . .	filmie	3	Masc3
Sygnał dźwięku wielokanałowego możemy wyprowadzić tylko przez cyfrowe złącze optyczne , ale kabla , niestety , nie znajdziemy w pudełku .	kabla	12	Masc3
Proszę zobaczyć , ilu posłów AWS nie głosowało .	posłów	4	Masc1
Oficer nalegał .	Oficer	0	Masc1
Te dwa epizody , oba w słońcu , były początkiem i końcem .	epizody	2	Masc3
W tym domu rola korepetytora była bardzo delikatna .	korepetytora	4	Masc1
Przyniósł mu kiedyś steward nieświeży kotlet .	kotlet	5	Masc3
Milicjant , krostowaty młokos , długo spisywał jej zeznanie .	młokos	3	Masc1
– Zawrzyj pokój z samą sobą .	pokój	2	Masc3
Prócz akcji upowszechniania czytelnictwa wśród dzieci Warszawy , podjęła prace o charakterze ogólnym , często prekursorskim .	charakterze	11	Masc3
Od tego czasu sprawa czekała na wyznaczenie terminu .	terminu	7	Masc3
- Chciał em porozmawiać z panem Luboratem .	panem	5	Masc1
Dwunastościan foremny miał symbolizować ład kosmiczny .	ład	4	Masc3
Ciało Gwieździka znaleziono przypadkiem .	przypadkiem	3	Masc3
Po 20 minutach helikopter ląduje na dachu szpitala .	helikopter	3	Masc3
Stwierdzono , że stosunkowo wysokie zarobki mają pielęgniarki bloku operacyjnego .	zarobki	5	Masc3
Reagując na stan zaspokojenia tych potrzeb , przeżywa emocje .	stan	2	Masc3
W jego koszyku znalazło się aż 125 dorodnych prawdziwków .	prawdziwków	8	Masc2
Adres niech dobrodziej spisze z dowodu osobistego .	dobrodziej	2	Masc1
Sąsiadka opiekuje się mocno starszym panem .	panem	5	Masc1
Różnice w dochodach w USA zdecydowanie rosną .	dochodach	2	Masc3
Przyjadą VIP-y . . .	VIP-y	1	Masc2
Na parkingu do samochodu Kosińskiego dosiadł się Osiński .	parkingu	1	Masc3
Ale pech przyniósł im szczęście .	pech	1	Masc2
Zdaniem dyrekcji nie można zlokalizować magazynów poza obszarem fabryki , gdyż zwiększyło by to koszty produkcji .	magazynów	5	Masc3
Zastygła m z lekko przechylonym dzbankiem .	dzbankiem	5	Masc3
Uważają nas za moskalofilów , takich zaprzańców antyukraińskich , podczas gdy sami deklarują ukraiński patriotyzm .	zaprzańców	6	Masc1
Dzień później trener Bogdan Pamuła zabrał swoich podopiecznych , tym razem pod sztandarem juniorskim , na mecz do Przemyśla .	podopiecznych	7	Masc1
On będzie gospodarzem .	gospodarzem	2	Masc1
Wolał by m nie wchodzić w te szczegóły .	szczegóły	7	Masc3
Serwal to rzadko spotykany w polskich ogrodach drapieżnik z rodziny kotów .	drapieżnik	7	Masc2
- Do głosowania nad uchwałą Senatu przystąpimy jutro rano .	Senatu	5	Masc3
W zbiorach muzeum jest także sztandar straży ogniowej oraz wiele pamiątkowych zdjęć .	zbiorach	1	Masc3
- Nabywca był podstawiony przez nas .	Nabywca	1	Masc1
Ma Pan te dowody ?	dowody	3	Masc3
Kiedy nadejdzie cyklon ?	cyklon	2	Masc3
Bandytów nie złapano .	Bandytów	0	Masc1
Mostek na strumieniu został przez gminę odbudowany po ostatniej powodzi .	strumieniu	2	Masc3
w czwartek miał przyjechać samochód z tym .	czwartek	1	Masc3
Prezes SSN deklaruje , że w kolejnych etapach zatrudni niemal wszystkich pracowników produkcyjnych .	etapach	7	Masc3
śledztwo wykazało , że zapłon i pojemnik były produkcji zachodnioniemieckiej .	pojemnik	6	Masc3
Georges Mathieux w kostiumie szermierza dźga płótno pędzlem umieszczonym na szpadzie .	kostiumie	3	Masc3
TWARDZIEL 1 pokazuje legitymację służb specjalnych .	TWARDZIEL	0	Masc1
Kiedy sprawa się wydała , wyleciała z hukiem ze szpitala .	hukiem	7	Masc3
W ostatecznym rozrachunku triumfuje tradycyjnie Dior .	rozrachunku	2	Masc3
- Nie jestem przestępcą . . .	przestępcą	3	Masc1
Rycerzy głodno nie puszczą .	Rycerzy	0	Masc1
Śmierć nie uniemożliwia kontaktu .	kontaktu	3	Masc3
Błyskotliwy wykładowca - matematyk o mrocznej urodzie zafascynował młodą studentkę .	matematyk	3	Masc1
Od tego czasu gnębiony przez feudałów lud rumuński niejednokrotnie chwytał za broń .	feudałów	5	Masc1
A Rychtarski i Ziemiak uzyskali rezultaty lepsze niż trzeci senior .	rezultaty	5	Masc3
I na schodach też słyszała m tylko jej kroki .	kroki	8	Masc3
Nad ranem zobaczył em ostatnie w tej podróży tuńczyki .	tuńczyki	8	Masc2
Widział em rano , jak rozmawiała ś z tym sympatycznym młodzieńcem , Abibem Denisem .	młodzieńcem	10	Masc1
Rozejrzała się wokół siebie , ale pokój był pusty .	pokój	6	Masc3
Młodego dja , pochodzącego z Głogowa , wylansował dj Adamus .	dja	1	Masc1
Satelita miał badać promienie kosmiczne i mikrometeoryty .	Satelita	0	Masc2
Trzecioligowcy strzelili kontaktowego gola , ale w ostatnim kwadransie dwie bramki dla Lecha wypracował Remień .	Trzecioligowcy	0	Masc1
Sporządzając mi drinka , Pućka kończy wcześniej rozpoczętą kwestię .	drinka	2	Masc2
Brakowało też kapelana .	kapelana	2	Masc1
Ważył w dłoniach mały , srebrny aparacik .	aparacik	6	Masc3
Podczas ceremonii otwarcia Spływu organizatorzy przyznali liczne odznaczenia zasłużonym kajakarzom .	kajakarzom	9	Masc1
Tutaj jedynie pokrótce opiszemy ten standard i nieco uzupełnimy zaprezentowane w wymienionych artykułach informacje .	standard	5	Masc3
Dlatego też uważam , że najwłaściwsze były by gwarancje udzielone przez premiera .	premiera	11	Masc1
Aresztowanego na 48 godzin mistrza zwolniono po poręczeniu majątkowym .	mistrza	4	Masc1
Nas , kobiety , obyczaj ciągle jeszcze skazuje na bierne wyczekiwanie .	obyczaj	4	Masc3
- Wiele zależy jednak od przewodniczącego komisji .	przewodniczącego	5	Masc1
Równie interesujące były programy przygotowane przez uczniów z pozostałych miejscowości .	uczniów	6	Masc1
Od samotności niepoczytalnej i obłędu uchroń nas , Panie .	obłędu	4	Masc3
Nie ma przymusu .	przymusu	2	Masc3
to jest miks ?	miks	2	Masc3
Koncert odbędzie się w Warszawie .	Koncert	0	Masc3
Są też osobne wejścia dla pieszych i zaplecze sanitarne .	pieszych	5	Masc1
Stalowa linka była opuszczona , deskę umocowano do zaczepu i uniesiono do pionu .	zaczepu	8	Masc3
- Najbardziej cenię lata po rozwodzie .	rozwodzie	5	Masc3
W październiku podczas pierwszych tegorocznych mrozów zamarzły cztery osoby .	mrozów	5	Masc3
Proszę bardzo odczytać komunikat .	komunikat	3	Masc3
Za nic nie zrobię z siebie pajaca .	pajaca	6	Masc1
- Bierzemy hotel .	hotel	2	Masc3
Zapewne nazwisko niejednego znajomka znalazł by m na Bronkowej liście .	znajomka	3	Masc1
Podawali sobie z rąk do rąk legitymację podporucznika rezerwy .	podporucznika	7	Masc1
— W sprawie wywiadu moja sekretarka skontaktuje się z pańską sekretarką .	wywiadu	3	Masc3
— Dlaczego nie osądzono komunistów ?	komunistów	4	Masc1
- Był to trójnożny garnek z brązu .	garnek	4	Masc3
Ćwiczyli wojacy z 25 krajów .	wojacy	1	Masc1
Z tego powodu piosenkarka postanowiła pozwolić komputerowo zretuszować swój wygląd .	wygląd	9	Masc3
- Proszę bardzo , panie pośle .	pośle	5	Masc1
Jest unerwiona przez nerw trójdzielny .	nerw	3	Masc3
Małżonka dyplomaty przez 13 lat była nauczycielką w szkole podstawowej .	dyplomaty	1	Masc1
- Piotr Rokicki to twój ojciec ?	ojciec	5	Masc1
Po chwili przyjechał fotograf i wszystko stało się jasne .	fotograf	3	Masc1
Dramatem zakończyła się nocna kąpiel dwóch mieszkańców Białegostoku .	Dramatem	0	Masc3
Obok czterech żołnierzy kopało dół .	dół	4	Masc3
Ekonomiści dodają , że motorem owego progresu jest , mimo wysokiego kursu złotego , eksport .	złotego	12	Masc2
Świadkowie nagle stracili pamięć .	Świadkowie	0	Masc1
- Niech się pan skupi na swoich obowiązkach .	obowiązkach	7	Masc3
Powoli powracał rozsądek .	rozsądek	2	Masc3
- Bo są też , panie Gustawie , dziki inteligentne .	dziki	8	Masc2
Przypomina tego twojego pedała ze Służewa .	pedała	3	Masc1
Toż ja pisał em o monitorze komputera .	komputera	6	Masc3
Sąd lub organ umorzy postępowanie .	organ	2	Masc3
Generał za swoje publikowane w prasie artykuły nie przyjmuje honorariów .	Generał	0	Masc1
Pan nie jest synem ?	synem	3	Masc1
Tam kierowca forda , wymijając volkswagena golfa , uderzył w niego .	golfa	6	Masc2
Na miejscu zginął pasażer , kierowca z obrażeniami ciała trafił do szpitala .	kierowca	5	Masc1
Deser zostanie podany po sprzątnięciu talerza głównego .	talerza	5	Masc3
Koniec przedstawienia , teraz kretyni biją brawa i proszą o bisy . . .	kretyni	4	Masc1
Wyciągamy wnioski z przeszłości .	wnioski	1	Masc3
Zdjąć te cholerne obrazki po właścicielu .	właścicielu	5	Masc1
Jestem niepobożnym ministrantem z pazurami .	ministrantem	2	Masc1
Posłowie chcą , by wybierano tych przedstawicieli spośród członków rady Kasy Chorych .	Chorych	11	Masc1
Napis czeka na policję .	Napis	0	Masc3
Miał 43 lata , żonaty , dwóch synów .	synów	7	Masc1
wszyscy znajomi tam jadą . .	znajomi	1	Masc1
- Przy bramie leżał zabity doberman , który pilnował wejścia .	doberman	5	Masc2
Czy unici też zamierzają obradować do uzgodnienia kandydata ?	unici	1	Masc1
– Ale mecz przesunęli ście na następny dzień . . .	dzień	7	Masc3
Na tegorocznym inauguracyjnym balu tradycyjnego karnawału w Rio pracowały równolegle dwie komisje sędziowskie .	karnawału	5	Masc3
Mundurowi nie chcą zdradzać parametrów technicznych maszyn , by nie ułatwiać życia drogowym piratom .	piratom	13	Masc1
Policjant zaświecił lizakiem .	Policjant	0	Masc1
Zębiska o 2 cm mijają tętnicę .	cm	3	Masc3
Koledzy z zasadniczej górniczej patrzyli w niebo i czekali .	Koledzy	0	Masc1
Ktoś wyrwał sztachetę z płotu .	płotu	4	Masc3
Z lektury wybił ją klakson .	klakson	4	Masc3
Podszedł do aparatu i nakręcił numer .	aparatu	2	Masc3
Karolowi głowa pęka z bólu , całe ciało płonie .	bólu	4	Masc3
Dobroczynne działanie wina potwierdzają plantatorzy .	plantatorzy	4	Masc1
Występ charytatywny zaproponowały artystce władze zakładu karnego .	Występ	0	Masc3
Naczelnik ulicznych rzeźników wykrzywił twarz .	rzeźników	2	Masc1
W bramie spotkał podporucznika Samczyca .	podporucznika	3	Masc1
Niech pan pomyśli , jaką rodzice mieli by niespodziankę , gdyby pan ukończył siedem klas .	rodzice	5	Masc1
- Czy różnice interesów w koalicji nie przeszkodzą w kontynuowaniu reform ?	interesów	3	Masc3
Parę kontaktów się urwało .	kontaktów	1	Masc3
Każdy sędzia będzie miał pod pulpitem dwa guziki .	sędzia	1	Masc1
Czy mogę spocząć na ganeczku ?	ganeczku	4	Masc3
Klatkę z płazem postawili śmy na bufecie .	płazem	2	Masc2
Czeka na właściciela .	właściciela	2	Masc1
Inne stolemy wyniosły się dawno do zamorskich krajów i ludzie przestali się już bać , że padną ofiarą ich psot .	stolemy	1	Masc2
Zostawiły ją w krzakach i poszły .	krzakach	3	Masc3
Podejrzany nie przyznaje się do winy .	Podejrzany	0	Masc1
Durnia znalazł em .	Durnia	0	Masc1
Doświadczenia laboratoryjne wykazały , że gąsienice motyli monarchów , karmione transgeniczną żywnością , miały kłopoty ze zdrowiem .	monarchów	7	Masc2
Starem z przyczepą załadowaną piaskiem kierował kursant .	kursant	6	Masc1
- Synek ma zespół Downa .	Synek	1	Masc1
Psy od razu wyczuły papierosy .	razu	2	Masc3
Ubrani w białe koszule uczniowie ustawiają się na zbiórce w parku naprzeciwko gimnazjum .	parku	10	Masc3
Od sierpnia jest na emeryturze .	sierpnia	1	Masc3
Koty przerwały brutalnie moje panowanie nad światem .	światem	6	Masc3
- Ale jak rozwijać produkcję , skoro nie warto brać kredytów , bo się ich nie spłaci ?	kredytów	10	Masc3
Nieleczona choroba przerodziła się w złośliwego chłoniaka .	chłoniaka	6	Masc2
Chcemy też , by nasi gracze wzorowali się na najniebezpieczniejszej odmianie raptorsów - globoraptorach .	raptorsów	11	Masc2
No , wreszcie dzieciaki będą miały babcię .	dzieciaki	3	Masc2
W Europie początkowo kawę sprzedawali medycy , zalecając ją na smutki i przygnębienie .	medycy	5	Masc1
Ale tak się nasz naród rozprasza . . .	naród	4	Masc3
Jeszcze gorzej spisali się floreciści , zajmując piąte miejsce .	floreciści	4	Masc1
Olszak posadził pajacyka na tapczanie .	pajacyka	2	Masc2
Przyjechali popołudniowym pociągiem .	pociągiem	2	Masc3
Jak długo jeszcze trupy z esbeckich szaf będą nas straszyć ?	trupy	3	Masc2
Dzięki temu wyszło szydło z worka , ale czy ktoś za to odpowie głową ? ? ?	worka	5	Masc3
Z początkiem wojny przenosi się do dworku w Krzykawce .	dworku	6	Masc3
Do gabinetu weszła panna Wunsch i położyła na biurku Trentscha niebieski skoroszyt .	skoroszyt	11	Masc3
Chcemy odwiedzić kolegów .	kolegów	2	Masc1
Resa pośpieszyła do Ab-Rama , czekającego niecierpliwie w swoim namiocie .	namiocie	9	Masc3
Nic mądrzejszego ten naród nie potrafi wymyślić .	naród	3	Masc3
Pierwszy numer wyjdzie przed świętami .	numer	1	Masc3
Wszystko rozegra się w zaciszu ministerialnych gabinetów .	gabinetów	6	Masc3
Skąd wziąć 750 obrazów ?	obrazów	3	Masc3
Przyglądali śmy się różnym kształtom bakterii , glonów , pierwotniaków .	glonów	7	Masc3
Pieściła m się z chłopakiem w czasie moich dni płodnych .	chłopakiem	4	Masc1
Pięciu studentów aresztowano .	studentów	1	Masc1
Przygwożdżonemu ich argumentacją Mister O'Gorckowi zawsze pozostawało się wycofać .	Mister	3	Masc1
Sklepy były pozamykane .	Sklepy	0	Masc3
Sornicy będą nosić tradycyjne kozackie mundury .	mundury	5	Masc3
Muszę jak najszybciej opuścić jego apartament .	apartament	5	Masc3
Dzisiaj jeszcze nie może , niestety , zaproponować kontraktu , ale następnym razem będę miał pełną jasność .	kontraktu	8	Masc3
Znaleziono przy nich skradzione zegarki oraz pistolet - straszak .	zegarki	4	Masc3
W XVII wieku hikyaku , czyli kurierzy , doręczali przesyłki feudalnym władcom .	hikyaku	3	Masc1
Książę porwał żagiew z komina i podniósł ją wysoko .	Książę	0	Masc1
Wśród wyznawców nie widać tego .	wyznawców	1	Masc1
Górnicy i hutnicy kują naszą potęgę .	hutnicy	2	Masc1
Od dwu tygodni nie mam od ciebie listu !	tygodni	2	Masc3
Z zestawienia sporządzanego przez starostwo wynika , że podmioty gospodarcze działające w powiecie działdowskim dokonują rocznie ponad 6000 odpraw celnych .	podmioty	8	Masc3
Zginęło wielu ochotników z Wielkopolski , między nimi 68 uczniów gimnazjum w Trzemesznie .	uczniów	9	Masc1
Trzymaj , włóż to do tego swojego plecaczka .	plecaczka	7	Masc3
Spała , Wałcz czy Cetniewo są od dawna ośrodkami na najwyższym europejskim poziomie .	ośrodkami	8	Masc3
Haubica jest rodzajem działa artyleryjskiego o dużym kalibrze .	rodzajem	2	Masc3
W Małej Komorzy z tego powodu zapaliły się sadze .	powodu	5	Masc3
Czy komornik będzie chciał zająć jeszcze coś innego ?	komornik	1	Masc1
Jest to również fundament mojego życia .	fundament	3	Masc3
Kontrolerzy nie wzięli pogróżek poważnie , bo wiedzieli z doświadczenia , że w podobnej sytuacji prawie każdy podatnik powołuje się na możnego protektora . . .	Kontrolerzy	0	Masc1
– Nie przychodzicie razem z małym do Piaskownicy ?	małym	5	Masc1
Niech żyją okupanci .	okupanci	2	Masc1
Aby właściwie odebrać myśli autora , wskazane jest odpowiednie przygotowanie matematyczne .	autora	4	Masc1
Ptaki te chętnie korzystają z pokarmu wykładanego dla parkowych łabędzi .	łabędzi	9	Masc2
Bez dowództwa , bez rozkazów , nasze chłopaki zaczęły uciekać .	chłopaki	7	Masc2
Na cóż pogłębiać straszliwy kryzys ?	kryzys	4	Masc3
Mogli by wówczas sprzedawać nie za dolara , ale za 95 centów i wygrywali by cenowo z konkurentami .	centów	11	Masc2
W ludzkich osiedlach słonie szukają pożywienia .	słonie	3	Masc2
W kolejnych rzędach stali niewidomi , część z psami - przewodnikami , a także niesłyszący i niemi .	psami	8	Masc2
Teraz ma roczek i czasem bawimy sie w cienie na ścianie .	roczek	2	Masc3
Uczniowie od dawna wiedzą o agencji .	Uczniowie	0	Masc1
W innych przypadkach będą całkowicie bezużyteczne .	przypadkach	2	Masc3
Sprawca ten okazał się nie tylko złodziejem , ale i sadystą .	sadystą	10	Masc1
Dopiero dzisiaj w trędowatej kaplicy rozdzielili się na kata i ofiarę .	kata	8	Masc1
Znajdziemy inny symbol .	symbol	2	Masc3
Rodzice nie będą już mogli wmawiać swoim pociechom , że przynosi je bocian bądź znaleziono je w kapuście .	bocian	12	Masc2
Sędzia Rymarz przyznał , że telewizja miała prawo zatrzymać kasety Bubla .	Sędzia	0	Masc1
Nie było bezpośredniego kontaktu .	kontaktu	3	Masc3
Ciągnął je ukryty wewnątrz drewnianego pudła muł .	muł	6	Masc2
Oprócz okradania opolan eseldziaki kantowały również kumpli w interesach .	eseldziaki	3	Masc2
Cały teren splantowano , a niedługo zostanie wykonane nowe ogrodzenie .	teren	1	Masc3
Dotychczas za kratkami znalazło się sześciu egzaminatorów i pośredników .	egzaminatorów	6	Masc1
Tekst wyszedł spod srebrzystych parkerów Colina Rowe'a i Roberta Slutzky'ego .	parkerów	4	Masc2
O zawilgoceniu gruntu i budynków informowali jedynie archeolodzy prowadzący wykopaliska na starówce .	budynków	4	Masc3
Od dwóch lat Truteń przewodzi wśród kabaretów wiejskich .	Truteń	3	Masc2
Czy senator rzuci rękawicę wszechwładnemu przewodniczącemu ?	przewodniczącemu	5	Masc1
Był już dzień .	dzień	2	Masc3
- Czy nie widziała pani nigdy takiego pajacyka ?	pajacyka	7	Masc2
Obaj skrupulatnie przepisywali rezultaty kolejnych odcinków specjalnych , by w pokojach hotelowych dokładnie je przeanalizować .	odcinków	5	Masc3
Prócz kapitana wszyscy członkowie załogi są Polakami .	kapitana	1	Masc1
– Nie miał Pan Profesor zahamowań .	Profesor	4	Masc1
– kurde no mówisz z dzieciakiem .	dzieciakiem	5	Masc2
Czujesz bluesa ?	bluesa	1	Masc2
Mogli by wówczas sprzedawać nie za dolara , ale za 95 centów i wygrywali by cenowo z konkurentami .	dolara	6	Masc2
Inny facet postanowił , że postawi stację z gazem do samochodów przy ul. Warszawskiej .	samochodów	10	Masc3
Zwycięzca już na samym początku narzucił ogromne tempo .	Zwycięzca	0	Masc1
Przez zwały gruzów ulicami miasta przebija się z trudem wojskowy Willys .	Willys	10	Masc2
Można zatrudniać stewardów .	stewardów	2	Masc1
Nie znam przecież obyczajów panujących w jej kraju , nie interesowały mnie .	obyczajów	3	Masc3
Obecnie staramy się to maksymalnie uprościć i są już tego efekty .	efekty	10	Masc3
Nasze spółdzielnie produkcyjne powstały dzięki przykładowi kołchozów radzieckich .	przykładowi	5	Masc3
Tym razem głód został pokonany .	głód	2	Masc3
Złodzieje wykorzystali chwilową nieobecność pracownicy biura .	Złodzieje	0	Masc1
W ogólnym rozgardiaszu jedynie Kosiński i Gorczyca zachowywali się spokojnie .	rozgardiaszu	2	Masc3
Był to jego debiut w tak wysokich rozgrywkach ligowych .	debiut	3	Masc3
– zajączka nie mieli śmy .	zajączka	1	Masc2
Wchodzę do środka i natykam się na dozorcę .	środka	2	Masc3
Miał dwóch Norwegów przy boku .	boku	4	Masc3
- Ani ja , ani moi koledzy nie potwierdzają takich zarzutów .	zarzutów	10	Masc3
Na koniec zacieramy ślady .	ślady	3	Masc3
Głosić takie wywrotowe poglądy przed takim audytorium !	poglądy	3	Masc3
Radar emituje impulsy fal radiowych , rozchodzących się z prędkością światła .	impulsy	2	Masc3
Piękno w przyrodzie wydaje się ewolucyjnym luksusem .	luksusem	6	Masc3
Tiry wyjechały z Warszawy tydzień temu .	Tiry	0	Masc2
Nic nie wynika z faktu dosłownego ożywiania tekstu , skoro papier jest jego ostatnim powiernikiem .	powiernikiem	14	Masc1
- Sądy podchodzą do tajnych współpracowników bardzo liberalnie , nie eliminują z życia społecznego agentów .	agentów	14	Masc1
I w Ławrze palił em świeczki cienkie jak włos . . .	włos	8	Masc3
Przysiadł na oparciu fotela , objął mnie ramieniem .	fotela	3	Masc3
Milicjant i ratownik zaczynają od powrzaskiwań i epitetów .	Milicjant	0	Masc1
- Nie pozwolił jej skończyć , pocałował w usta , ale w tej chwili za oknem rozległ się dźwięk klaksonu , niespodziewany i głośny .	dźwięk	18	Masc3
Nacisnął em guzik , żeby wezwać wartownika .	wartownika	6	Masc1
Antyterroryści spuścili się po linach ze śmigłowca wprost pod drzwi gangstera .	gangstera	10	Masc1
Z autorem artykułu rozmawiała m dwukrotnie .	autorem	1	Masc1
Tomasz Gudzowaty poluje kamerą na lwy , gepardy , lamparty .	lamparty	9	Masc2
Chociaż faktem jest , że Hubal okropnie przeżył te zdarzenia .	faktem	1	Masc3
Około 300 eksponatów reprezentowało osiągnięcia 40 twórców .	eksponatów	2	Masc3
Markiz odłożył księgi .	Markiz	0	Masc1
Oklapł , opadły mu ramiona i tylko piwny brzuszek sterczał nad paskiem spodni .	paskiem	11	Masc3
Uniewinnienie przełożonych ich synów wstrząsnęło zbolałymi kobietami .	przełożonych	1	Masc1
Dlaczego nie mogę włożyć swetra Anki ?	swetra	4	Masc3
Trzecioligowcy strzelili kontaktowego gola , ale w ostatnim kwadransie dwie bramki dla Lecha wypracował Remień .	kwadransie	8	Masc3
Policja przypuszcza , że najnowszy ładunek został porzucony przez spłoszonego niedoświadczonego terrorystę .	terrorystę	11	Masc1
Cień ojca rysował się na szybie .	Cień	0	Masc3
Ale ona tylko skinęła na okrwawionego fenomulata .	fenomulata	6	Masc1
Z piętra wyżej zszedł dystyngowany sąsiad z chartem na białej smyczy .	chartem	7	Masc2
Witold poszedł w jego ślady i również poświęcił się dziennikarstwu .	ślady	4	Masc3
Przy ośrodkach będzie się prowadzić także punkty apteczne .	ośrodkach	1	Masc3
Jerzy nie mógł dobrnąć do ostatniego stempla , chociaż odznaczał się sprytem Merkurego .	stempla	6	Masc3
Ja mam ochotę przywalić komuś na koncercie .	koncercie	6	Masc3
Składem do Kołobrzegu pojechało 150 dzieci .	Składem	0	Masc3
W drugiej części czytelnik będzie mógł lepiej poznać cały pluton rotacyjny szeregowca Leńczyka .	szeregowca	11	Masc1
Kwota ta dotyczy wyłącznie teleskopu .	teleskopu	4	Masc3
Jej słowa wwiercają się w mózg , nie pozwalają zebrać myśli .	mózg	5	Masc3
Krzyczy na mnie tylko trochę , kiedy się biję ze starszym bratem .	bratem	11	Masc1
– no ukradł mi ten zbój ruski . .	zbój	5	Masc1
Szympansy uprawiają politykę .	Szympansy	0	Masc2
Już Pitagorejczycy znali podobno wszystkie najbardziej regularne wielościany nazywane foremnymi .	Pitagorejczycy	1	Masc1
Ale z drugiej strony nie chciał em , żeby moja przyjaciółka uznała mnie za wariata .	wariata	14	Masc1
Z ogromną prędkością przejechały przez nie dwa samochody osobowe .	samochody	7	Masc3
Chcemy też , by nasi gracze wzorowali się na najniebezpieczniejszej odmianie raptorsów - globoraptorach .	globoraptorach	13	Masc2
Chciał em zrobić ośrodek zimowy z prawdziwego zdarzenia .	ośrodek	3	Masc3
Jest bardzo silny fizycznie , chociaż mierzy tylko metr sześćdziesiąt osiem .	metr	8	Masc3
Ojciec nie uczył już w polskiej szkole .	Ojciec	0	Masc1
Na przykład z Australią łączył em się na dwudziestoletnim radiu mojego ojca .	ojca	11	Masc1
Pan Janusz zmarł przed sześciu laty .	laty	5	Masc3
To byli rodzice Bogumiła Niechcica .	rodzice	2	Masc1
Wyróżniały się głosy dyrektora Suchanka , byłego wojewody oraz lekarza dyżurnego .	wojewody	7	Masc1
– Dziadek mi kazał .	Dziadek	1	Masc1
Alibi było , ale przy okazji sfotografowano tego wysokiego , przystojnego mężczyznę .	mężczyznę	11	Masc1
Patrzył em , jak zasnuwały horyzont .	horyzont	5	Masc3
Ale wydaje mi się , że Lech , Czech i Rus musieli bardzo długo pędzić za jeleniem , dzikiem i niedźwiedziem .	dzikiem	18	Masc2
Prawdopodobnie wkrótce straci immunitet .	immunitet	3	Masc3
Jest lekarzem w klasztorze albertynów .	albertynów	4	Masc1
W jego koszyku znalazło się aż 125 dorodnych prawdziwków .	koszyku	2	Masc3
Niektórzy didżeje wpisują sobie występ w Pieksie do CV .	didżeje	1	Masc1
Megane oddał synowi , pracownikowi dydaktycznemu warszawskiej uczelni .	pracownikowi	4	Masc1
Taniec i słońce to były dwie rzeczy , które kochała .	Taniec	0	Masc3
Poseł Andrzej Pęczak musiał się z powodu zarzutów Nowaka tłumaczyć w prokuraturze .	zarzutów	7	Masc3
Poprosił ekspedientkę o dostęp do telefonu , tłumacząc , że musi zadzwonić do swojego wspólnika .	wspólnika	14	Masc1
Członkowie nakielskiego stowarzyszenia podczas spotkania omówili główne cele swojej działalności .	Członkowie	0	Masc1
Do najciekawszych należą parki w Wierzonce i Owińskach .	parki	3	Masc3
Pracował z trudem , mozolił się nad każdym słowem .	trudem	2	Masc3
Podporucznik Kowalik oddał pług oraczowi .	oraczowi	4	Masc1
Nie można wtedy wykryć wirusa .	wirusa	4	Masc2
- Kapitan zniknął w mrocznym korytarzu .	Kapitan	1	Masc1
Rękaw pięknie wyszywanego fraka prędko nasiąkł krwią .	Rękaw	0	Masc3
Wśród poszkodowanych jest 20 uczniów i 16 dorosłych .	dorosłych	7	Masc1
Po incydentach w meczu derbowym ukarali ście Cracovię zamknięciem stadionu na dwa mecze .	incydentach	1	Masc3
Świadek zeznawał by w procesach pozostałych członków gangu .	procesach	4	Masc3
Okna przysłonięto żałobnym kirem .	kirem	3	Masc3
Właścicielom wystarcza kino domowe , a bogate panie nie potrafią docenić kunsztu Anny Jaxy - Chamiec .	kunsztu	11	Masc3
Nie jesteś już młodzieńcem i lepszej kariery nie zrobisz .	młodzieńcem	3	Masc1
Przyjechało wielu ciekawskich , ale też kupujących .	kupujących	6	Masc1
Anioł zadowolony śmieje się z diabła .	diabła	5	Masc2
Na pozostałym oleju podsmażyć mięso z roztartym na miazgę czosnkiem .	oleju	2	Masc3
Trzech mężczyzn postanowiło wczoraj wzbogacić się tanim kosztem .	kosztem	7	Masc3
Oskarżony nie przyznaje się .	Oskarżony	0	Masc1
Udzielam głosu pierwszemu mówcy , senatorowi Czai .	mówcy	3	Masc1
Asystent już podawał chirurgowi fartuch .	Asystent	0	Masc1
Adwokat jest od tego , żeby bronić .	Adwokat	0	Masc1
W niegłupich oczach był dziecinny tragizm .	tragizm	5	Masc3
– Nie rozumiesz , telefon dołączył em do magnetofonu i nagrywa mi , no .	magnetofonu	8	Masc3
Polonia zagrała bez trzech piłkarzy z podstawowego składu .	składu	7	Masc3
Zaczynał em rozumieć , że radość z własnego rozumu też może być ograniczona .	rozumu	8	Masc3
Hmmm ja mam ochotę na kebaba .	kebaba	5	Masc2
A odkąd Kaziński wydał wojnę właścicielom psów , jest jeszcze trudniej .	psów	6	Masc2
W 1972 r. wraz z kolegami wpadł podczas rozlepiania ulotek na mieście .	kolegami	5	Masc1
Ostatecznym celem był garnizon w Greifswaldzie na Pomorzu .	celem	1	Masc3
Poirytowani posłowie - projektodawcy sprawdzili te informacje .	posłowie	1	Masc1
Jakże naiwny był Józef , kolejny raz ufając obietnicom białych !	białych	9	Masc1
NBP OBNIŻYŁ o 4 punkty procentowe stopę swoich kredytów .	kredytów	8	Masc3
Do wytworzenia pary i utrzymywania ognia we właściwej temperaturze służy oddzielny palnik gazowy .	ognia	5	Masc3
I fiat palio weekend został zatrzymany .	fiat	1	Masc2
Wykąpiemy się na golasa .	golasa	3	Masc1
Był to ostatni ze zgłoszonych mówców .	mówców	5	Masc1
W demokratycznym państwie powinny one stanowić kanony niepodważalne .	kanony	6	Masc3
Drżeli i bledli , z ust oratorów dobywał się bełkot .	oratorów	6	Masc1
Opony delahaye jednostajnie szumią po asfalcie .	asfalcie	5	Masc3
Doświadczenia laboratoryjne wykazały , że gąsienice motyli monarchów , karmione transgeniczną żywnością , miały kłopoty ze zdrowiem .	motyli	6	Masc2
na nartach nie połamali się natomiast się połamali w Sylwestra . .	Sylwestra	9	Masc2
- Czy jest pan anarchistą ?	anarchistą	4	Masc1
- W Krzyczkach leży jeszcze kilkadziesiąt zakopanych psów .	psów	7	Masc2
– Chcesz żyć z zabójcą ?	zabójcą	4	Masc1
Oskarżano nas , że w Bielicznej sprzedali śmy prywatnemu nabywcy kilkaset hektarów wraz z cmentarzem i cerkwią .	cmentarzem	14	Masc3
Piękne i mądre są nasze dzieciaki .	dzieciaki	5	Masc2
Uwolniono też polskiego ambasadora w Jemenie .	ambasadora	3	Masc1
Blish jest przede wszystkim marzycielem- propagandzistą .	marzycielem-	4	Masc1
Ale szybki zysk bywa celem nawet najpotężniejszych magnatów finansowych , bo rynki są wolatylne .	celem	4	Masc3
Teraz włodarze klubu mają zamiar iść jeszcze dalej .	włodarze	1	Masc1
Prezes SSN deklaruje , że w kolejnych etapach zatrudni niemal wszystkich pracowników produkcyjnych .	Prezes	0	Masc1
Żaden uczony nie dokonuje wynalazków po to , by wyrządzić człowiekowi krzywdę .	uczony	1	Masc1
Marzec przyniósł 6 zagranicznych delegacji .	Marzec	0	Masc3
Posłużono się amerykańską zastawką doktora Starra .	doktora	4	Masc1
- Nie mogę jednak zawieść swoich pacjentów .	pacjentów	6	Masc1
Znów będzie płaz i przeklinanie nas .	płaz	2	Masc2
U małych pacjentów lekarze stwierdzali najczęściej anginę i nieżyt górnych dróg oddechowych .	nieżyt	8	Masc3
Przeciętne świadczenie emeryta , rencisty wzrośnie o 33 zł .	rencisty	4	Masc1
Mówię w tej książce nie tylko o żywych .	żywych	7	Masc1
Widział eś kiedyś nienawidzącego swej ofiary drapieżnika ?	drapieżnika	6	Masc2
Klatkę z płazem postawili śmy na bufecie .	bufecie	6	Masc3
Chłopiec nalewa do drugiego kieliszka .	kieliszka	4	Masc3
Jaka była treść tego dokumentu ?	dokumentu	4	Masc3
Wprost na podłodze rozpościerał się siennik , a na nim leżał człowiek .	człowiek	11	Masc1
Z relacji świadków wynika , że 60-latek nagle upadł .	świadków	2	Masc1
Pociski te przebijają najgrubsze pancerze .	pancerze	4	Masc3
Wprowadza czytelników w błąd .	czytelników	1	Masc1
Najczęściej są to narkomani .	narkomani	3	Masc1
Oprócz okradania opolan eseldziaki kantowały również kumpli w interesach .	opolan	2	Masc1
Niech to diabli wezmą .	diabli	2	Masc2
- Józwa ma konika . . .	konika	3	Masc2
Architekci opracowujący rysunki robocze są zazwyczaj wieloletnimi praktykami .	praktykami	7	Masc1
Chciał by m skierować pytanie do pani posłanki sprawozdawcy .	sprawozdawcy	8	Masc1
– chłopaki zaśpiewają jakąś ckliwą melodię . .	chłopaki	1	Masc2
- Chłopaki z lubelskiego zespołu hiphopowego noszą takie krawaty .	Chłopaki	1	Masc2
O drugiej rozpoczął się dramat jak z kadrów sensacyjnego filmu .	dramat	4	Masc3
Piłkarze FC Porto zapewnili sobie wczoraj ponownie tytuł mistrzów Portugalii .	mistrzów	8	Masc1
Milcząco przywitał się z teściem i szorstko odprawił syna do odrabiania lekcji .	teściem	4	Masc1
Przebiegające pod miastem chodniki kopalni zalano wodą , a wzgórze zgniło i zapadło się w ziemię jak przydeptane .	chodniki	3	Masc3
Przecież były zawalone dachy w Polsce , Niemczech , Rosji , były też ofiary .	dachy	3	Masc3
To nie znaczy , że mężczyźni kobiety wypychają .	mężczyźni	5	Masc1
Na czwartym rogu Żelaznej wywrócili kiosk z papierosami , jako przeszkodę , papierosy się posypały .	papierosami	7	Masc2
To jeden z najdroższych sylwestrów na Mazowszu .	sylwestrów	4	Masc2
Ja na chłopców nie patrzę .	chłopców	2	Masc1
Wezwał mnichów i kapłanów do współpracy .	kapłanów	3	Masc1
To śmierć polityczna czołówki AWS i zwolenników Unii Wolności w Akcji .	zwolenników	6	Masc1
Pudel wabił się Oskar .	Pudel	0	Masc2
W każdej chwili mogę zostać szoferem w Prezydium Rady Ministrów .	szoferem	5	Masc1
Albo ubić faceta z wiecznie zadartym ornamencikiem w rozporku .	rozporku	8	Masc3
Orzechowe oczy garncarza wpatrzyły się badawczo w twarz Kaliasa .	garncarza	2	Masc1
Okazuje się , że właściciel mieszka za siatką .	właściciel	4	Masc1
Nie chciał też podjąć się roli obrońcy ani sędziego .	sędziego	8	Masc1
Zamiast złota , klejnotów i posiadłości składał się on z 200 rycerzy !	rycerzy	11	Masc1
Dziadkowie kochali bardzo wnuki i synową , ale ich majątek , Wysokie , gonił resztkami .	majątek	9	Masc3
Nagrody i poczęstunek był dla wszystkich , a najlepsi zawodnicy otrzymali ponadto puchary .	puchary	12	Masc3
Dwa samochody zderzyły się dachami .	dachami	4	Masc3
Na wschodzie niebo blednie .	wschodzie	1	Masc3
To już nie były nasze lasy .	lasy	5	Masc3
Spaceruję sobie wzrokiem po ścianach , suficie , meblach i przedmiotach .	meblach	8	Masc3
Taksówka czekała z zapalonym silnikiem , a ci od pomocy drogowej wkładali jeepa na podnośnik .	jeepa	12	Masc2
Radość rodzin porwanych znów ustąpiła niepokojowi i pesymizmowi .	niepokojowi	5	Masc3
Najpierw złapali śmy trzy dzikie delfiny .	delfiny	5	Masc2
Reszta tonie w nieprzeniknionym zmroku .	zmroku	4	Masc3
Samoloty rozrzucają ulotki wzywające powstańców do kapitulacji .	Samoloty	0	Masc3
Psy grzebały w śmietniku .	Psy	0	Masc2
Było ciemno , płonęły znicze .	znicze	4	Masc3
Czerń , ulubiona barwa , ostro podkreślała niezwykłą , niemal ascetyczną bladość oblicza emira .	emira	13	Masc1
Kierownik z Regnowa polecił nauczycielkom promować każdego niezależnie od wyników .	Kierownik	0	Masc1
W 1979 utworzono tu Szkołę Mistrzów Pszczelarskich .	Mistrzów	5	Masc1
Z danych wynika , że plan Marshalla wpływa coraz bardziej na pogorszenie się stanu ekonomicznego kraju .	plan	5	Masc3
Przełknął ślinę , patrząc trochę bezmyślnie na intruza .	intruza	7	Masc1
Rozebrał się , wszedł do rzeki , zanurkował przy urwistym brzegu .	brzegu	10	Masc3
Zatrzasnęła drzwi i zaalarmowała męża oraz sąsiadów , którzy wypłoszyli lamparta .	sąsiadów	6	Masc1
Tu latają cyklony , podejdą wyżej , będzie wiało od wyżu .	cyklony	2	Masc3
Przed tygodniem wicestarosta Hrycyna podczas wyjazdu do Gdańska uzyskał przychylność tamtejszych środowisk żydowskich .	wyjazdu	5	Masc3
– Co ojciec wie o miłości ?	ojciec	2	Masc1
Reagował jak ideowy socjalista .	socjalista	3	Masc1
Dwa samochody zderzyły się dachami .	samochody	1	Masc3
Przecież ja tatki prawie nie znam !	tatki	2	Masc1
W przypadku grożących gołoledzią opadów deszczu lub śniegu , komputer włącza ogrzewanie jezdni .	deszczu	5	Masc3
W grobie znaleziono szczątki kilku osób .	szczątki	3	Masc3
Zgodnie z ustaleniami nie udzielił żadnych wywiadów ani nie wydał żadnego oświadczenia politycznego .	wywiadów	6	Masc3
- Wybrał eś zawód aktora .	aktora	4	Masc1
Tutaj jedynie pokrótce opiszemy ten standard i nieco uzupełnimy zaprezentowane w wymienionych artykułach informacje .	artykułach	12	Masc3
Georges Mathieux w kostiumie szermierza dźga płótno pędzlem umieszczonym na szpadzie .	szermierza	4	Masc1
Czy kolega czytuje wcześniejsze posty ?	kolega	1	Masc1
Firmy reklamowe czasem robią taki numer .	numer	5	Masc3
Czy nie było by lepiej , gdyby on rozwijał naukę , kształcił uczniów , a uczelnią zajmował się specjalista od zarządzania ?	specjalista	18	Masc1
Po raz kolejny wystąpił pan niezgodnie z regulaminem .	regulaminem	7	Masc3
Oprócz okradania opolan eseldziaki kantowały również kumpli w interesach .	opolan	2	Masc1
Ból był straszliwy .	Ból	0	Masc3
- Wymknęło ci się , że przesadą było by zginąć za komunizm .	komunizm	11	Masc3
Biblioteka liczy około 950 tomów i ma charakter przeważnie naukowy .	tomów	4	Masc3
Na ekranie TV , na zatrzymanej stop-klatce Jurka Kilera idą napisy końcowe programu .	napisy	10	Masc3
Tam znajdują się dane o poszukiwanych przestępcach .	przestępcach	6	Masc1
Niech płaszczą się przed groźnym wieprzem !	wieprzem	5	Masc2
Radość rodzin porwanych znów ustąpiła niepokojowi i pesymizmowi .	porwanych	2	Masc1
W wakacje był em kilka razy u Wronka , jednak barykadę zobaczył em pierwszy raz .	raz	14	Masc3
Związek taki łączą nie tylko wspólni praprzodkowie .	praprzodkowie	6	Masc1
Na progu stał wysoki , zarośnięty mężczyzna .	progu	1	Masc3
Palestyńczycy będą mogli nawet sprowadzić czołg .	czołg	5	Masc3
Mam dwustronicowy artukuł , z którego muszę napisać recenzję .	artukuł	2	Masc3
Płacimy i idziemy na dworzec .	dworzec	4	Masc3
Mateo mieszka na Elbie , gdzie latem wynajmuje turystom motorówki .	turystom	8	Masc1
Ekonomiści dodają , że motorem owego progresu jest , mimo wysokiego kursu złotego , eksport .	Ekonomiści	0	Masc1
W XVII wieku hikyaku , czyli kurierzy , doręczali przesyłki feudalnym władcom .	kurierzy	6	Masc1
Przyjaciele użyczali jej chętnie .	Przyjaciele	0	Masc1
A diabeł siedział w panu .	diabeł	1	Masc2
Czasem cisnę spust , a ten diabeł uprze się i nie wystrzeli .	spust	2	Masc3
Minął luty , nadszedł marzec .	marzec	4	Masc3
Zastąpił go ks. Antoni Dunajski .	ks.	2	Masc1
Książę porwał żagiew z komina i podniósł ją wysoko .	komina	4	Masc3
Nasze siły odpowiedziały ogniem .	ogniem	3	Masc3
Pokazują go swoim gościom .	gościom	3	Masc1
Saperzy polscy i radzieccy poszukują min i niewypałów .	Saperzy	0	Masc1
Krzyki były snem .	Krzyki	0	Masc3
Zbyt szybkie tempo życia doprowadza zwykle do zmęczenia i bałaganu .	bałaganu	9	Masc3
Biedny ptak , z szeroko otwartym dziobem , zwisał głową w dół , niby ułamana z krzewu kiść .	ptak	1	Masc2
Nie boisz się wilków ?	wilków	3	Masc2
Gdzieś daleko leniwie poszczekiwał pies .	pies	4	Masc2
Maszynista nie miał szans na zatrzymanie rozpędzonego elektrowozu .	Maszynista	0	Masc1
Żadna ze stron procesu nie odwoływała się od wyroku .	procesu	3	Masc3
Przecież jest to fakt historyczny .	fakt	3	Masc3
Ochmistrz , grubasek i smakosz , spuścił oczy w milczeniu .	smakosz	4	Masc1
Pozwolą Państwo , że coś przypomnę .	Państwo	1	Masc1
Prezydenci Polski , Ukrainy i Rumunii spotkali się na roboczych rozmowach w Bukareszcie .	Prezydenci	0	Masc1
- Zresztą to małe , niegroźne pieski .	pieski	6	Masc2
Miejscowy , brodaty duchowny czekał już przy ołtarzu .	duchowny	3	Masc1
Chłopi nie obsiali wiosną pól .	Chłopi	0	Masc1
Drżeli i bledli , z ust oratorów dobywał się bełkot .	bełkot	9	Masc3
Beacie towarzyszył mój starszy kuzyn , inżynier Wacław Straszyński .	inżynier	6	Masc1
Panie pośle , czy wolno dawać łapówki ?	pośle	1	Masc1
Dotknęła brudnego bandaża , którym owijała opornik .	bandaża	2	Masc3
– no już ciotka wysłała totka .	totka	5	Masc2
Można wysłać SMS-a , e-maila lub połączyć się z Internetem .	e-maila	4	Masc2
Jesteś sierotą z potencjałem .	potencjałem	3	Masc3
Możliwych jest wiele scenariuszy .	scenariuszy	3	Masc3
- Ty jesteś łobuz !	łobuz	3	Masc1
Nie mamy z nią żadnych problemów .	problemów	5	Masc3
Profesor z dużym sceptycyzmem spogląda w przyszłość .	sceptycyzmem	3	Masc3
Do oficjalnych transportów robotnicy dorzucali swoje ładunki .	robotnicy	3	Masc1
Polacy pokonali 28 zespołów z całego świata i po raz pierwszy zdobyli puchar .	puchar	12	Masc3
Pewnie zmarzł eś , biedaku !	biedaku	4	Masc1
Dotyczy to tylko pracowników na kontraktach , a nie na etacie .	kontraktach	5	Masc3
Poznał kosmetyczkę i przybory toaletowe .	przybory	3	Masc3
W zgodnej opinii sztabu szkoleniowego radomian , wszyscy mają równe szanse .	radomian	5	Masc1
Wiece i akademie odbyły się również w Sofii , Damaszku , Kabulu , Surabai i innych miastach .	Wiece	0	Masc3
Kuglarze i prestidigitatorzy zdemaskowali swoje sztuczki .	Kuglarze	0	Masc1
Pobity kijem bejsbolowym mężczyzna trafił z licznymi obrażeniami do szpitala .	kijem	1	Masc3
Nagle zauważam , że balkon chwieje się i pęka .	balkon	4	Masc3
Długiego stażu małżeńskiego gratulował poseł Tadeusz Cymański .	poseł	4	Masc1
Po czwartkowej wizycie w ratuszu zmienił jednak zdanie .	ratuszu	4	Masc3
Po rozwodzie przyjaźń z transseksualistą zmieniła się w związek .	transseksualistą	4	Masc1
Zatrudnia zaledwie 60 urzędników , wśród nich tylko czterech księży .	księży	9	Masc1
Goście podeszli do słupa , obejrzeli się .	Goście	0	Masc1
Dymek w tym czasie ekspanderem przymocował otwartą klapę .	ekspanderem	4	Masc3
- Człowieku , ten nowy też już zdążył się zestarzeć .	Człowieku	1	Masc1
Martha Kosicky ma blond włosy i dziadka z Polski .	dziadka	6	Masc1
Oprócz okradania opolan eseldziaki kantowały również kumpli w interesach .	kumpli	6	Masc1
Po spełnieniu toastu świeżo upieczeni małżonkowie rzucają za siebie kieliszki .	małżonkowie	5	Masc1
W pierwszej kolumnie kroczą woje Chrobrego .	woje	4	Masc1
Można też utworzyć na takie pliki specjalny folder na pulpicie .	folder	7	Masc3
Teraz mam osiem hektarów .	hektarów	3	Masc3
Poznali śmy też nowych drugoligowców .	drugoligowców	4	Masc1
Jadąc fordem escortem nie ustąpiła pierwszeństwa karetce pogotowia .	fordem	1	Masc2
Inwestor chce wystartować za kilka miesięcy .	Inwestor	0	Masc1
Psy od razu wyczuły papierosy .	Psy	0	Masc2
Jerzy Gruza wydaje się nieubłagany w swoim perfekcjonizmie .	perfekcjonizmie	7	Masc3
Nad pozostałymi obszarami dominują układy wyżowe .	obszarami	2	Masc3
Jak się mówi potocznie o facecie z małymi jajami ?	facecie	5	Masc1
Ostatnio któryś z proboszczów przegrał samochód .	proboszczów	3	Masc1
Klub przeniósł się do osiedlowych garaży pod blokami .	garaży	5	Masc3
Anioł zadowolony śmieje się z diabła .	Anioł	0	Masc2
Dlaczego euro przez ostatnie trzy miesiące wbrew prognozom osłabło ?	miesiące	5	Masc3
Z kilkunastu zeszytów powstała książka .	zeszytów	2	Masc3
Zapomniał eś dodać okultyzm Ojca Pio i Katarzyny Neuman .	okultyzm	3	Masc3
Na kontynencie afrykańskim dominują ssaki .	ssaki	4	Masc2
Alona wybierała produkty ze straganów , a pan Jeffrey nosił za nią koszyk .	straganów	4	Masc3
Pan dyrektor mówił .	dyrektor	1	Masc1
Dzięki wysiłkowi lekarzy udało się uratować mu życie .	wysiłkowi	1	Masc3
Na dodatek pod koniec dekady zaczęło rosnąć bezrobocie , zwłaszcza wśród kobiet i młodzieży .	dodatek	1	Masc3
Podniosły głowy ratuszowe lwy .	lwy	3	Masc2
Wśród tradycjonalistów muzułmańskich z państw Półwyspu Arabskiego wywołało ono szok .	tradycjonalistów	1	Masc1
- Witaj , synu Arana .	synu	3	Masc1
Przedostatni figuruje Artur Balazs , poseł i minister rolnictwa , a zamyka ją Stefan Oleszczuk z UPR-u , starosta kamieński .	starosta	18	Masc1
Ranną przetransportowano śmigłowcem do zakopiańskiego szpitala .	śmigłowcem	2	Masc3
Nie jest typem działacza , ideologa , politykiera .	ideologa	5	Masc1
Zdjęła materiał z palca i wsadziła do kieszeni kurtki .	palca	3	Masc3
Dowódca sił amerykańskich w Afganistanie generał Tommy Franks zapowiedział kolejne operacje lądowe .	generał	5	Masc1
Poza pracą zawodową inżynier Tadeusz Wróblewski zasłużył się również w organizowaniu życia sportowego .	inżynier	3	Masc1
Zrobiła to , bo skazany jest wzorowym więźniem .	więźniem	7	Masc1
Potem przemawiali inni mówcy i debata ciągnęła się przez następną godzinę .	mówcy	3	Masc1
I głos mi wyregulować na jakiś górny ton !	ton	7	Masc3
Oprócz okradania opolan eseldziaki kantowały również kumpli w interesach .	eseldziaki	3	Masc2
Próbował bronić swej dyktatury , Osi , paktu z Hitlerem .	paktu	7	Masc3
- Strachy lubią głębokie wody .	Strachy	1	Masc2
Około jedenastej śniadania się kończyły , zamawiano czarne kawy , herbaty i kapucyny .	kapucyny	12	Masc2
Wrócił do apartamentu .	apartamentu	2	Masc3
Wśród uciekinierów jest 40-latek z Radomia oraz pięciu nieletnich .	40-latek	3	Masc1
W dwunastu wypadkach kandydatury wojewodów miały być uzgodnione .	wypadkach	2	Masc3
Podstawowym problemem jest to , że na tym terenie mieszkają 2 rodziny .	problemem	1	Masc3
Wykonano ją chałupniczo , ale nie powstydził by się ich żaden fachowiec .	fachowiec	11	Masc1
Każdy sędzia będzie miał pod pulpitem dwa guziki .	guziki	7	Masc3
Komentarz do wyniku jest chyba zbyteczny .	wyniku	2	Masc3
Na wschodzie majaczą szczyty Tynioka , Ganczerki , a tam dalej , już niewidoczna , bardziej na północ , jest Barania .	szczyty	3	Masc3
Dzięki niej komuniści z PKK mogą działać właściwie bez przeszkód .	komuniści	2	Masc1
I te bilety uśmierzyły wzburzone umysły golibrody i wynalazcy .	wynalazcy	8	Masc1
Przed światłami kierujący ruchem zatrzymał tira , a za nim stanęła skoda .	tira	5	Masc2
To hymn .	hymn	1	Masc3
Pracodawca musi też płacić wszelkie podatki i ubezpieczenia .	Pracodawca	0	Masc1
Przy bardzo silnych wiatrach zawodnicy zakładają na płozy specjalne obciążenia .	wiatrach	3	Masc3
Frajerów kroić !	Frajerów	0	Masc1
Podał em dokument .	dokument	2	Masc3
Trzeba było przekonać prokuratora , aby wniósł sprawę z urzędu .	prokuratora	3	Masc1
– zajączka nie ruszali ście ?	zajączka	1	Masc2
Kiwnął em na barmana , żeby zapłacić .	barmana	3	Masc1
Rzeczywiście , dodzwonić się do dyrektora było szalenie trudno .	dyrektora	5	Masc1
- Co polski Kościół wniesie do Europy narodów ?	narodów	7	Masc3
Od 1964 do Poznania docierają pociągi elektryczne z Warszawy .	pociągi	5	Masc3
Ściany skalne zbliżają się w tym miejscu i dalsza droga prowadzi w ciasnym wąwozie .	wąwozie	13	Masc3
Do końca nie wydała żadnego ze swych wspólników .	wspólników	7	Masc1
Listy od widzów czyta i niszczy .	widzów	2	Masc1
Rabi Eleazar ben Cwi nie szemrze .	Rabi	0	Masc1
Borys Conrad , syn znakomitego pisarza Józefa Conrada - Korzeniowskiego przybył do Warszawy .	syn	3	Masc1
Tomasz Gudzowaty poluje kamerą na lwy , gepardy , lamparty .	lwy	5	Masc2
Kołdra i ściągnięte z materaca prześcieradło dziwaczną draperią zwisało z łóżka .	materaca	4	Masc3
Mordercy udało się zbiec .	Mordercy	0	Masc1
Tomasz Gudzowaty poluje kamerą na lwy , gepardy , lamparty .	gepardy	7	Masc2
Czasem cisnę spust , a ten diabeł uprze się i nie wystrzeli .	diabeł	6	Masc2
Dostrzegł pędzącego byka .	byka	2	Masc2
– Mama gładzi dłoń Dziadka .	Dziadka	4	Masc1
Mój ojciec Mosze urodził się w Biłgoraju .	ojciec	1	Masc1
Jej mąż stał bezradny w kącie , tulił synka .	mąż	1	Masc1
Zdaniem fachowców urządzenie spisywało się dobrze .	fachowców	1	Masc1
Wobec tego mąż delikatnie informuje o tym żonę .	mąż	2	Masc1
Do 13 tygodni to nie dziecko , tylko płód .	tygodni	2	Masc3
Syk łosia umilkł .	łosia	1	Masc2
Sprawność podczas akcji i umiejętności ratowników oceniali sędziowie .	ratowników	5	Masc1
Nie jest to dramat ani wielki kryzys .	dramat	3	Masc3
Dziś w biznesowej działalności wspiera młodzieńca mamusia .	młodzieńca	5	Masc1
W czasie weekendu dorodny lampart spacerował ulicami stolicy Indii , Delhi .	lampart	4	Masc2
Po parku z miniaturowym ogrodem zoologicznym snują się gromadnie dzieci .	ogrodem	4	Masc3
Nie jest to zaleta , którą można by w dniu jubileuszu pominąć .	jubileuszu	10	Masc3
Kolega Jamrozik został zaproszony na pogrzeb .	Kolega	0	Masc1
Znał Andrzeja Zawadę i innych polskich himalaistów .	himalaistów	6	Masc1
Ptak ten nie ma takich zdolności jak albatros czy sokół .	albatros	7	Masc2
O co Ci chodzi tym razem ? ? ?	razem	5	Masc3
Polskiej biedzie akademickiej potrzeba pieniędzy , a nie podzielników .	podzielników	8	Masc3
Dwaj wędkarze wpadli do wody , gdy wieloryb zaatakował ich łódź u południowo - wschodnich wybrzeży Australii .	wieloryb	7	Masc2
- Popełnili by śmy ciężki grzech twierdząc , że te obrazy nas nie interesują .	obrazy	10	Masc3
Wtedy zapytała m pierwszego z brzegu rajcę , czy pozwoli tak zmienić swój dom .	rajcę	6	Masc1
Zatrudnia 1100 dziennikarzy i 2000 współpracowników .	dziennikarzy	2	Masc1
Luksusowego forda explorera nieznani sprawcy skradli wczoraj w Warszawie generałowi rosyjskiej milicji .	forda	1	Masc2
- Sądy podchodzą do tajnych współpracowników bardzo liberalnie , nie eliminują z życia społecznego agentów .	Sądy	1	Masc3
Francuz jest jak ślimak .	ślimak	3	Masc2
Chciał by m , aby w Czeczenii był pokój .	pokój	8	Masc3
Dziadkowie kochali bardzo wnuki i synową , ale ich majątek , Wysokie , gonił resztkami .	wnuki	3	Masc2
– Bywa , że rolnicy jeszcze przynoszą pisma .	rolnicy	4	Masc1
Czytanie jest u kalwinów powinnością religijną , obowiązkiem wierzącego .	obowiązkiem	7	Masc3
- Venderk to prawnik .	prawnik	3	Masc1
U Bosmana rosły srebrzyste świerki , ale ktoś wykopał .	świerki	4	Masc3
Na ekranie TV , na zatrzymanej stop-klatce Jurka Kilera idą napisy końcowe programu .	programu	12	Masc3
Nie wprowadzono prywatnej własności ziemi , nie zniszczono feudalnego imperium dyrektorów kołchozów .	dyrektorów	10	Masc1
- Sierżant stuknął służbiście obcasami i zasalutował .	Sierżant	1	Masc1
- Jakub oddychał z trudem .	trudem	4	Masc3
I szukał tych swoich hitlerowców po lasach .	hitlerowców	4	Masc1
Skarżyskie Muzeum Orła Białego to perełka na mapie województwa .	Orła	2	Masc2
Wszyscy trzej byli pisarzami .	pisarzami	3	Masc1
- Wojna wzbudziła we mnie ogromny lęk .	lęk	6	Masc3
Bo rodzice będą wymyślać kary za złe stopnie .	rodzice	1	Masc1
- Poszedł pod kościół .	kościół	3	Masc3
Zakaz nic nie mówi o tasakach lub półmetrowych nożach kuchennych . . .	Zakaz	0	Masc3
Koty przerwały brutalnie moje panowanie nad światem .	Koty	0	Masc2
Tiry wyjechały z Warszawy tydzień temu .	tydzień	4	Masc3
Bo jest byłym gliną ?	gliną	3	Masc2
Nie miał czasy na głupstwa , z takim ciężarem na karku .	ciężarem	8	Masc3
Robol ma fart .	fart	2	Masc3
Ten kierownik to ma chyba fioła .	fioła	5	Masc2
- Kto jest sukcesorem prawnym pana naczelnika ?	sukcesorem	3	Masc1
W lasach pasły się krowy i owce , czasem ozwał się poryk niedźwiedzia lub gniewne parsknięcie rysia .	poryk	11	Masc3
Przychodzą kibice .	kibice	1	Masc1
Tym kobylim synom chodzi o to , by Francja dostała guzik .	synom	2	Masc1
Sprawdzamy wyrostki kolczyste i łuki kręgów .	kręgów	5	Masc3
- Jutro drugi klucz będzie panu magistrowi oddany .	magistrowi	6	Masc1
Na czele stoi król - Ashantehene , otoczony radą starszych .	król	3	Masc1
Niech pan Piskorski sam idzie demonstrować do parku na Agrykoli .	parku	7	Masc3
Mój czcigodny ojciec wielce poważał tego mistrza .	mistrza	6	Masc1
Ale niedługo potem dyrektor widzi Karola na mszy .	dyrektor	3	Masc1
Na diagramie Hertzsprunga - Russella olbrzymy znajdują się ponad ciągiem głównym .	olbrzymy	5	Masc2
Ptaki te chętnie korzystają z pokarmu wykładanego dla parkowych łabędzi .	Ptaki	0	Masc2
Szafę zamykamy na klucz i obiecujemy sobie otworzyć ją dopiero po egzaminach .	egzaminach	11	Masc3
Biernacki może liczyć na poparcie polityków koalicji .	polityków	5	Masc1
Do konkursu stanęło piętnastu traktorzystów .	traktorzystów	4	Masc1
Trupy wrzucono do Gopła .	Trupy	0	Masc2
Proszowiccy strażacy wyjeżdżali w ostatnim czasie do dwóch pożarów , spowodowanych prawdopodobnie przez podpalaczy .	podpalaczy	13	Masc1
Ciągle jeszcze wybieramy naszych bohaterów i ich losy z miarką społeczną .	bohaterów	4	Masc1
Jedynie Sermak starał się strzelać z dystansu .	dystansu	6	Masc3
Ewa ma klucze .	klucze	2	Masc3
Gospodarze odpowiedzieli dwoma golami Ralfa Hauptmanna i Austriaka Tony Polstera .	golami	3	Masc2
200 z nich chronionych jest jako zabytki architektury ogrodniczej .	zabytki	6	Masc3
To jest wspaniały sport , a w życiu warto spróbować wszystkiego .	sport	3	Masc3
Nawet moje złe duchy odwróciły się do mnie plecami .	duchy	3	Masc2
Siano chrzęści w zębach wołów , słychać tylko chrupot i głębokie oddechy zwierząt .	zębach	3	Masc3
Dopiero ze składów rozwozić go będą wozacy .	składów	2	Masc3
Kilka dni temu na oddział trafiła prątkująca absolwentka gimnazjum .	oddział	4	Masc3
Aparaturę filmową obsługuje instruktor terenowy PDK Czesław Fudala .	instruktor	3	Masc1
Skoro pogrąża się w rozpaczy i gniewie .	gniewie	6	Masc3
Tęsknota ogarniała chłopców .	chłopców	2	Masc1
Panie marszałku , jakiego wyniku pan oczekuje ?	wyniku	4	Masc3
Niedługo po tym apelu Kamiński , Wołek i Jurek spotkali się na podwieczorku u krzywdzonego Pinocheta .	podwieczorku	12	Masc3
Wiatry słabe z kierunków zmiennych .	kierunków	3	Masc3
Lucynka spojżała w okno i zobaczyła wielkiego , kudłatego zwierzaka .	zwierzaka	9	Masc2
Uczniowie są tym przedsięwzięciem bardzo zainteresowani .	Uczniowie	0	Masc1
W załzawionym świecie jeden diabeł posiadał kontury ostre i wyraźne .	diabeł	4	Masc2
Przy wspólnym stole jadają tu studenci izraelscy i palestyńscy .	studenci	5	Masc1
- Myślał em , że rano komary nie gryzą .	komary	6	Masc2
Czym latają nasze VIP-y ?	VIP-y	3	Masc2
Może po przeczytaniu tego artykułu więcej kotów znajdzie swe domy ?	artykułu	4	Masc3
Zaciągnął w kąt grubego , jowialnego Skwarskiego .	kąt	2	Masc3
Wtedy przypomnieli śmy sobie , że synek kasjerki hoduje zaskrońca .	zaskrońca	9	Masc2
O doktorze Mylo chyba nikt dziś nie pamięta .	doktorze	1	Masc1
Faceci wyglądają na prawdziwych twardzieli .	twardzieli	4	Masc1
Skupieni operatorzy delikatnie manipulowali skomplikowanymi urządzeniami odbioru przekazywanej informacji .	operatorzy	1	Masc1
Od kolebki , od małych lat jestem tu wychowany , na tym placu .	placu	12	Masc3
Chcesz przez to powiedzieć , że Mendelejew musiał udowodnić , że istnieją nieznane pierwiastki .	pierwiastki	13	Masc3
Wszarz pchnął go opierając o pień w półmroku .	Wszarz	0	Masc1
Niestety , dalszy ciąg też nie ma pokrycia .	ciąg	3	Masc3
Bo znacznie mniejszy grzyb jest .	grzyb	3	Masc2
Pokazuje nam odpowiedni dokument panamski i dwa zaświadczenia .	dokument	3	Masc3
Straciła w powstaniu dwóch synów i męża .	męża	6	Masc1
- Dużo o tym pisał Antoni Słonimski , mój stryj .	stryj	9	Masc1
O ziemię zastukały ciężkie buty .	buty	4	Masc3
Bawi się Pan w kolejnego kundelka UPR-u ?	kundelka	5	Masc2
Leżeli śmy przez chwilę w milczeniu , wsłuchując się we własne oddechy .	oddechy	11	Masc3
Ale dzieciaki i tak odbijają piłki o ściany pod oknami .	dzieciaki	1	Masc2
Uratujcie wierzącego chrześcijanina Walerego Marczenkę !	chrześcijanina	2	Masc1
Wszarz pchnął go opierając o pień w półmroku .	półmroku	7	Masc3
Tymczasem moi wspólnicy mieli zgarniać forsę .	wspólnicy	2	Masc1
Z głośników popłyną rytmy soul i disco .	głośników	1	Masc3
Skazany przebywa na terytorium kraju swojego domicylu .	Skazany	0	Masc1
Ksiądz Gaenswein nie zawiódł .	Ksiądz	0	Masc1
Pod koniec gotowania dodajemy sos sojowy i na kilka minut pozostawiamy pod przykryciem .	sos	4	Masc3
Był to straszliwy bląd polityczny .	bląd	3	Masc3
I miał też inne gusty .	gusty	4	Masc3
W kinie , na ostatnim filmie Allena , zasnęła m .	filmie	5	Masc3
Jej mąż stał bezradny w kącie , tulił synka .	synka	8	Masc1
asai to jest ta borówka amerykańska ?	asai	0	Masc3
– nie macie murarza . .	murarza	3	Masc1
W październiku zeszłego roku w Warszawie odzyskano skradzionego opla .	opla	8	Masc2
Do jej udzielenia namawiał wiceprezydent Ciechanowa Jacek Kaczorowski .	wiceprezydent	4	Masc1
Rebecca Romijn - Stamos dzieli się z nami sekretami swojej urody .	sekretami	8	Masc3
Stary pierścionek z rautami zaświecił nikło .	pierścionek	1	Masc3
Wymaga to zainstalowania odpowiednich zbiorników .	zbiorników	4	Masc3
Wyszedł em od nich pod wieczór zupełnie wybity z czasu i z epoki .	wieczór	5	Masc3
Jego łupem padały głównie radioodtwarzacze i głośniki .	radioodtwarzacze	4	Masc3
Głównym jego prześladowcą był malarz , majster Gileta .	prześladowcą	2	Masc1
Szwedzi , biedny naród , nie znają zapachu piekarni , świeżego , prawdziwego chlebka .	naród	3	Masc3
Bo przecież ci , co przeciągnęli druty , zabili ich brata .	brata	10	Masc1
Mszy przewodniczył prymas Józef Glemp .	prymas	2	Masc1
Zlitujcie się nad sędziami .	sędziami	3	Masc1
Tymczasem byk już był przy nim .	byk	1	Masc2
Przestraszona Zosia schowała się za wózek .	wózek	5	Masc3
Ze wszystkimi w lokalu działo się coś podobnego .	lokalu	3	Masc3
Kontrolerzy nie wzięli pogróżek poważnie , bo wiedzieli z doświadczenia , że w podobnej sytuacji prawie każdy podatnik powołuje się na możnego protektora . . .	podatnik	17	Masc1
Cipkę sygnowała dodatkowo autografem .	autografem	3	Masc3
Jechało im się dobrze , na szosie po przedpołudniowym deszczu nie było kurzu , ale jezdnia nie była już mokra .	deszczu	9	Masc3
Nietschke myślał chwilę o samotnym , smutnym ptaku .	ptaku	7	Masc2
W USA rozpyla się na przykład streptomycynę i tetracyklinę na drzewa owocowe i pola ziemniaków .	przykład	5	Masc3
Ale niestety wyobraźnia działa i już powoli wyobrażała m sobie siebie z wózkiem za 9 miesięcy . .	wózkiem	12	Masc3
W innym przypadku nastąpi natychmiastowe spożycie powodujące zwiększenie siły lub ochłodzenie robota .	przypadku	2	Masc3
Jeżeli rząd chce wprowadzać swoje reformatorskie projekty , musi porozumiewać się z prezydentem .	projekty	6	Masc3
Komara wyprodukowała brytyjska firma Compound Security .	Komara	0	Masc2
Prototypy powinny odznaczać się światowym standardem .	Prototypy	0	Masc3
Mam minę debila .	debila	2	Masc1
Takie wyznanie należy wśród wspomnień hibakuszi do rzadkości .	hibakuszi	5	Masc1
I wcześniej Smolański gwałtownie manifestował swoje poglądy .	poglądy	6	Masc3
Został obezwładniony przez policjantów .	policjantów	3	Masc1
- Chciała m z panem zamienić jeszcze parę słów .	panem	4	Masc1
Docierają pracodawcy .	pracodawcy	1	Masc1
Stalowa linka była opuszczona , deskę umocowano do zaczepu i uniesiono do pionu .	pionu	12	Masc3
W stacji na etatach pracuje dziś 17 osób .	etatach	3	Masc3
Przez godzinę z boiska wiało nudą , a piłkarze prezentowali futbol plażowy .	piłkarze	8	Masc1
Przy obecnych upałach takie opady wyparowują w kilkanaście minut .	upałach	2	Masc3
Wyróżniały się głosy dyrektora Suchanka , byłego wojewody oraz lekarza dyżurnego .	dyrektora	3	Masc1
Do obozu pozostało jeszcze parę kilometrów .	kilometrów	5	Masc3
Postarajmy się wyśledzić je od początku .	początku	5	Masc3
Na parterze remonty trwały w najlepsze .	remonty	2	Masc3
Najchętniej jada golonkę z piwem i staropolskiego schabowego z kostką .	schabowego	7	Masc2
Po kolejnych 30 minutach lekarze stwierdzają śmierć kolarza .	kolarza	7	Masc1
Jest lekarzem w klasztorze albertynów .	lekarzem	1	Masc1
Widzę stąd , z tego nowego miejsca , nogi siwka .	siwka	9	Masc2
Kobieta otworzyła drzwi , wpuściła do środka czarnowłosego mężczyznę .	środka	6	Masc3
Tym razem rzucił granat zaczepny , walcowaty .	granat	3	Masc3
Mężczyzna próbował prosić w ratuszu o upust lub rozłożenie na raty należności .	upust	6	Masc3
Luksusowego forda explorera nieznani sprawcy skradli wczoraj w Warszawie generałowi rosyjskiej milicji .	sprawcy	4	Masc1
Beczący głos uciszył sprzysiężonych .	sprzysiężonych	3	Masc1
Znaleziono go w grobowcu Ramzesa III .	grobowcu	3	Masc3
- Macie rację , tylko Hiszpanie mogli wymyślić barok .	barok	8	Masc3
Gdzieś daleko warczał motor niewidzialnego samolotu .	motor	3	Masc3
Akcji przyglądały się władze powiatu i gminy .	powiatu	4	Masc3
Rysiek dziękował Bogu , że nie wręczył prezesowi dolara w parku , bo by wtedy nie miał czego szukać .	dolara	8	Masc2
Wieczorem działki otuliły się dymem .	dymem	4	Masc3
Wańkowicze wrośli już w tutejszy teren i próbowali się utrzymać .	teren	5	Masc3
Kolejny pijany policjant straci pracę .	policjant	2	Masc1
- Odezwał się po chwili zmartwionym głosem Tomaszewski .	głosem	6	Masc3
Kręciło się tu kilku żołnierzy i dwóch sanitariuszy , nie było lekarza .	lekarza	11	Masc1
Tam były winnice i gąszcz , wszędzie się roiło od królików .	królików	10	Masc2
Czy każdy zmarły tak wygląda ?	zmarły	2	Masc1
Po mszy świętej wyruszyła z bazyliki katedralnej i okrążyła Stary Rynek .	Rynek	10	Masc3
Zgłosiło się siedmiu kandydatów .	kandydatów	3	Masc1
I szukał tych swoich hitlerowców po lasach .	lasach	6	Masc3
Witam wszystkich klubowiczów ! ! !	klubowiczów	2	Masc1
- Na jarmarku w Ostrowcu konie biedaka stratowały .	jarmarku	2	Masc3
Wielu wywiadów nie udzielam .	wywiadów	1	Masc3
- Komar to żywa istota .	Komar	1	Masc2
Izrael zagroził wczoraj , że wkroczy zbrojnie na tereny Autonomii , jeśli Arafat nie zapanuje nad terrorem .	tereny	8	Masc3
Wychodził do pracy świtem , wracał w ciemności .	świtem	3	Masc3
Głos zabrał towarzysz Korntopf od nauki .	towarzysz	2	Masc1
– Spojrzała pytająco na męża , ale zbył ją milczeniem .	męża	4	Masc1
Chociaż i tym zdarza się nie przestrzegać niektórych paragrafów prawa pracy .	paragrafów	8	Masc3
Teraz wszystko jest świetliste jak łabędź .	łabędź	5	Masc2
Rzecznik praw obywatelskich poprosił o wyjaśnienia Ministerstwo Zdrowia .	Rzecznik	0	Masc1
Wcześniej inni poszli dużo dalej .	inni	1	Masc1
Mag osunął się bezwładnie .	Mag	0	Masc1
– bo on tak się zwraca do kolegów i koleżanek . .	kolegów	7	Masc1
Znam ten ból .	ból	2	Masc3
- Lud musi być z nami !	Lud	1	Masc3
Narrator zaczyna w końcu rozumieć , że to jest telefon do niego .	Narrator	0	Masc1
Dodany został nowy § 3 .	§	3	Masc3
Zatrzasnęła drzwi i zaalarmowała męża oraz sąsiadów , którzy wypłoszyli lamparta .	lamparta	10	Masc2
– Edek wydął z pogardą wargi , a ja natychmiast pożałował em , że to tylko kuzyn .	kuzyn	16	Masc1
Każdy upływający dzień przejmował go strachem .	strachem	5	Masc3
- Zbądź obawy , ojcze .	ojcze	4	Masc1
Kto wręczał Panu wypowiedzenie ?	Panu	2	Masc1
Jestem raperem , jeżdżę rowerem .	raperem	1	Masc1
Sierżant spojrzał niepewnie na reportera .	reportera	4	Masc1
Facet był skruszony .	Facet	0	Masc1
- Nie twierdzę , że jesteśmy bez winy , ale w zasadzie zarzut ten mógł by dotyczyć strony państwowej .	zarzut	12	Masc3
Dlaczego posłowie nie powinni płacić mandatów w postępowaniu mandatowym ?	posłowie	1	Masc1
Siano chrzęści w zębach wołów , słychać tylko chrupot i głębokie oddechy zwierząt .	wołów	4	Masc2
Przymykali śmy oko na jego wybryki , ale zaczął przeginać .	wybryki	5	Masc3
może wpadnę do Gumy po pieróg .	pieróg	5	Masc3
Gładkie oblicze strzygonia stężało , alabastrowa skóra napięła się , jakby miała zaraz pęknąć .	strzygonia	2	Masc2
Mam gotowy scenariusz filmowy .	scenariusz	2	Masc3
- Co powiedzą robotnicy ?	robotnicy	3	Masc1
Rydzyki marynuje się tak .	Rydzyki	0	Masc2
Używając pożyczonych magnetofonów szpulowych połączył em dźwięki suity z fragmentami poematu Wergilego .	dźwięki	6	Masc3
Do skomplikowanych wzorów używamy deski przywiązanej do sznurka .	wzorów	2	Masc3
Zaliczmy banana do żywotnych i nie będzie wyjątku . . .	banana	1	Masc2
Żeby w szpitalu dostać zawału !	zawału	4	Masc3
Pozdrawia cię przez moje usta stryj twój , Ab - Raham .	stryj	5	Masc1
Z autorem artykułu rozmawiała m dwukrotnie .	artykułu	2	Masc3
- Jeżeli ćwiczący źle dobiorą rakiety , piloci nie zniszczą przeciwnika .	piloci	7	Masc1
Mnie duchy nie interesują .	duchy	1	Masc2
- Raport o stanie państwa nie został ogłoszony przed Wigilią na osobisty wniosek premiera .	premiera	13	Masc1
To były też takie lata , że nie wypadało nie mieć pieniądza .	pieniądza	11	Masc3
Uhonorowani zostali także inni muzycy .	muzycy	4	Masc1
Kot usiadł obok i znowu miauknął .	Kot	0	Masc2
Od sześciu lat jest wiceprzewodniczącym czeskiego PEN Clubu .	wiceprzewodniczącym	4	Masc1
Naoczny świadek stwierdził , że samolot leciał nisko .	świadek	1	Masc1
Gdzie się rozgrywa pierwowzór ?	pierwowzór	3	Masc3
- Pan inżynier rosołku by nie popił ?	inżynier	2	Masc1
Rzecznik armii powiedział , iż na miejscu dokonano aresztowań .	Rzecznik	0	Masc1
Alkoholu jeszcze nie podano , popielniczki błyszczały czyste i nie skażone .	Alkoholu	0	Masc3
Ale ten argument opozycji nie przekonuje .	argument	2	Masc3
Pierwsze i jedyne auto zatrzymało się przy nich dopiero po kilku kwadransach !	kwadransach	11	Masc3
Oprócz okradania opolan eseldziaki kantowały również kumpli w interesach .	eseldziaki	3	Masc2
Za nimi Toyotą syn Doroty wiezie Marcina .	syn	3	Masc1
Zamordował ją konkubent , do którego przeniosła się z córką .	konkubent	2	Masc1
Jednocześnie zmienia się jego skład chemiczny i ubytek ciężaru właściwego .	ciężaru	8	Masc3
Maluch jest zdrowym chłopcem .	chłopcem	3	Masc1
Odziedziczyła ona po bracie majątek w Galicji , uprzemysłowiony i dający duże profity .	bracie	3	Masc1
Chmury rozsunęły się na moment , odsłaniając wytarty miedziak słońca .	miedziak	8	Masc2
A może były gdzieś błędy ?	błędy	4	Masc3
Na cmentarzu w Koniku Nowym leży ponad 100 psów , pięć kotów i jeden chomik .	kotów	11	Masc2
- Z syna zrobili bandziora .	bandziora	4	Masc1
Ale motylem tym też ja sam był em .	motylem	1	Masc2
Tym razem milicjanci interweniowali natychmiast .	milicjanci	2	Masc1
Taty już nie ma .	Taty	0	Masc1
- Robi z siebie baranka .	baranka	4	Masc2
Dlaczego w banku za bohaterów uważają hitlerowców ?	hitlerowców	6	Masc1
Grożąc bonią wepchnęli go do citroena i odjechali .	citroena	5	Masc2
A on tak spał na dworze .	dworze	5	Masc3
Ze stara wyciekał olej i płyn chłodzący , a przyczepa miała zdemontowany hamulec awaryjny .	płyn	5	Masc3
Masowy powrót przyniósł by doraźne korzyści budżetowi .	powrót	1	Masc3
– pokryte mają wszystkie języki . .	języki	4	Masc3
Najstarszy prawnuk ma 21 lat ; gdyby założył rodzinę , jubilaci zostali by prapradziadkami .	prawnuk	1	Masc1
Dopiero następnego dnia wieczorem ruszył w powrotną drogę .	wieczorem	3	Masc3
Stopniowo dół się sam zasypie śmieciami .	dół	1	Masc3
Czy Energa mogła by się zainteresować swoim majątkiem ?	majątkiem	7	Masc3
Co znów wyrwało z kręgu tej kultury wielu intelektualistów .	intelektualistów	8	Masc1
Węże są zwierzętami mało poznanymi , niezwykłymi i fascynującymi .	Węże	0	Masc2
– i co miał eś na egzaminie ?	egzaminie	6	Masc3
Poza nimi na ławie siedziało jeszcze pięciu podsądnych .	podsądnych	7	Masc1
Nie cenzuruje nas wrogi urzędnik , ale towarzysz partyjny " .	urzędnik	4	Masc1
Może zdam się na panów ?	panów	4	Masc1
W młodości stuprocentowy reakcjonista , antysemita , obecnie uważa się za liberała .	antysemita	5	Masc1
Państwo Książkowie zajmują się produkcją roślinną .	Państwo	0	Masc1
Wieprzek zatrzymał się nie przestając kwiczeć .	Wieprzek	0	Masc2
Rodzice Agnieszki nie motywowali jej do nauki .	Rodzice	0	Masc1
Rodzice ze wzruszeniem prezentowali dziennikarzom swoje maleństwa i dziękowali za pomoc .	dziennikarzom	4	Masc1
Wydawcy kłaniają się w pas .	Wydawcy	0	Masc1
Trzeba rozstawić gmachy ministerstw w różnych punktach miasta , również na Pradze .	gmachy	2	Masc3
Przy końcu alei stał świeżo wkopany słup , pomalowany na jasnoniebieski kolor .	końcu	1	Masc3
Dzieciak wymazał litery .	Dzieciak	0	Masc2
Tylko współlokatorka nie rokowała przyjemnego pobytu . . .	pobytu	5	Masc3
Nawet jej głos nie drgnął .	głos	2	Masc3
Za najważniejszych nazistowskich zbrodniarzy powszechnie uznawano Hitlera , Himmlera i Goebbelsa .	zbrodniarzy	3	Masc1
- Nie zorganizowano zawodów na odpowiednim poziomie , na przykład w skokach do wody czy siatkówce , bo Zimbabwe nie spodziewa się w tych dyscyplinach osiągnięć .	skokach	11	Masc3
Ja nawet premiera Oleksego lubię " .	premiera	2	Masc1
Struś nic nie szczerzy .	Struś	0	Masc2
Nie znaczy to , że rezygnuję ze sportu .	sportu	7	Masc3
Dzieciak długo spał .	Dzieciak	0	Masc1
W USA jest szpital , który chce Łukasza ratować .	szpital	3	Masc3
Czykier został ukarany za niesportowy tryb życia , zaś Gierejkiewicz stracił zaufanie szkoleniowca .	szkoleniowca	12	Masc1
Wykaz obejmował 33 rasy psów wymagających rejestracji i szkolenia .	Wykaz	0	Masc3
Przez dwie godziny w miniony piątek nie pracowali technicy elektroradiologii .	technicy	8	Masc1
Tryb przedstawił em .	Tryb	0	Masc3
Używając pożyczonych magnetofonów szpulowych połączył em dźwięki suity z fragmentami poematu Wergilego .	magnetofonów	2	Masc3
Maluch jest zdrowym chłopcem .	Maluch	0	Masc1
- Mieszkał doktor Fechner .	doktor	2	Masc1
– to mnie się skojarzyło z kumplem . .	kumplem	6	Masc1
Nie tylko we Włoszech przestępcy wykorzystują polskich pracowników .	przestępcy	4	Masc1
Uważają nas za moskalofilów , takich zaprzańców antyukraińskich , podczas gdy sami deklarują ukraiński patriotyzm .	patriotyzm	14	Masc3
Nie czuł em zmęczenia i wesoło przeskakiwał em ze stopnia na stopień .	stopnia	9	Masc3
Afgańczycy nie uznawali ani wiecznych wrogów , ani wiecznych przyjaciół .	wrogów	5	Masc1
Obok klatek z dorosłymi ptakami krążyły dwa małe kazuary , grzebiąc w odpadkach w poszukiwaniu pożywienia .	ptakami	4	Masc2
Poważne poparcie zapewnić mu mogą tylko inni arbitrzy .	arbitrzy	7	Masc1
Szwagierka prowadzi z subiektem .	subiektem	3	Masc1
Może sanepid na ich terenie był bardziej zdyscyplinowany .	sanepid	1	Masc3
Nad wszystkim czuwać będzie trzech lekarzy i personel pielęgniarski .	lekarzy	5	Masc1
Były już trzy kółka ze starszych robotników .	robotników	6	Masc1
Odtąd oba oddziały działały wspólnie .	oddziały	2	Masc3
Znalazła m z trudem jakieś zdjęcia .	trudem	3	Masc3
Krzywulą wędrowca podwajał stare swe kroki .	kroki	5	Masc3
W dwunastu wypadkach kandydatury wojewodów miały być uzgodnione .	wojewodów	4	Masc1
Kilka dni po ukazaniu się ogłoszenia telefon dzwonił 24 godziny na dobę .	telefon	6	Masc3
Miał tylko dobre porywy .	porywy	3	Masc3
Kim jest strażnik łowiecki ?	strażnik	2	Masc1
W sobotę podporucznik Ziemba przeniósł swoje łóżko do kuchni , rowery wstawiono do pokoju podporucznika Kowalika .	podporucznik	2	Masc1
Rozładował ją na brzegu , a ona cisnęła naboje do wody .	brzegu	3	Masc3
Oprócz okradania opolan eseldziaki kantowały również kumpli w interesach .	opolan	2	Masc1
Decyzja zapadła , mimo że szefowie tajnych służb ostrzegli , iż Palestyńczycy wyjdą na ulice .	szefowie	5	Masc1
Najbliżsi rywale Orfe także nie rezygnują z przejęcia kolejnych mniejszych dystrybutorów .	dystrybutorów	10	Masc1
Po raz drugi w tym wieku możemy decydować o własnym losie .	losie	10	Masc3
Doświadczył tego na sobie mecenas Jan Murasz .	mecenas	4	Masc1
Nieznani sprawcy ostrzelali jego samochód zaparkowany przed sklepem .	sklepem	7	Masc3
Nauczyciele wymienili spojrzenia .	Nauczyciele	0	Masc1
no gdzie jest ten dżentelmen ?	dżentelmen	4	Masc1
Zaatakowano go bezpośrednim ogniem .	ogniem	3	Masc3
My katolicy chodzimy w niedzielę do kościołów .	katolicy	1	Masc1
- Czyli grozi nam rozłam w Kościele ?	Kościele	6	Masc3
Policjanci znaleźli zabójcę we Wrocławiu .	zabójcę	2	Masc1
Panuję nad negatywnymi nastrojami .	nastrojami	3	Masc3
Sześć cebul kupiła na kiermaszu zorganizowanym w pobliskiej szkole .	kiermaszu	4	Masc3
Nie jestem piratem drogowym .	piratem	2	Masc1
Naukowcy i wynalazcy nie powinni mieć kompleksów .	wynalazcy	2	Masc1
Z urzędów i różnych instytucji ginie nawet papier toaletowy .	papier	7	Masc3
- Czy księdzu wolno publicznie krytykować przełożonych ?	przełożonych	6	Masc1
Nie mieli śmy żadnych propozycji dla robotników .	robotników	6	Masc1
Publiczność przyjęła ją entuzjastycznie , ale krytycy nazwali królową kiczu .	krytycy	6	Masc1
Zatrzymany jest przesłuchiwany .	Zatrzymany	0	Masc1
Chłopczyk z miejsca się budzi .	Chłopczyk	0	Masc1
Jednocześnie sąd zdecydował o odebraniu mu pozostałych dwóch koni .	koni	8	Masc2
A to pewnie był akurat chwyt zamierzony przez autora i głęboko uzasadniony .	autora	8	Masc1
To będzie najpewniejszy dowód .	dowód	3	Masc3
Kupuje tu nie tylko brytyjska Polonia , ale i rodowici londyńczycy .	londyńczycy	10	Masc1
Czynią tak wspomniani starościna i starosta .	starosta	5	Masc1
Podczas obchodu można było się przekonać , że nastąpiły gruntowne zmiany w pomieszczeniach CSiK .	obchodu	1	Masc3
Poirytowani posłowie - projektodawcy sprawdzili te informacje .	projektodawcy	3	Masc1
Od kilku lat w górnej szufladzie mojego biurka leży biały zeszyt .	zeszyt	10	Masc3
lubisz jogurty ?	jogurty	1	Masc3
Przyjęcie odbywało się w starym pałacu cesarza .	pałacu	5	Masc3
Sięgnął po słuchawkę , wybrał numer wewnętrzny sekretariatu , ale odezwała się tylko sprzątaczka .	numer	5	Masc3
Narkotyki stają się coraz większą plagą wśród czeskiej młodzieży .	Narkotyki	0	Masc3
Kręciło się tu kilku żołnierzy i dwóch sanitariuszy , nie było lekarza .	sanitariuszy	7	Masc1
W samej Warszawie w Internecie swoje auta eksponuje już kilkadziesiąt komisów .	komisów	10	Masc3
Trza mu spokoju .	spokoju	2	Masc3
Wczoraj kolegium Instytutu usiłowało wyłonić nowego kandydata na prezesa .	kandydata	6	Masc1
- Katolik nie musi wierzyć w cuda ?	Katolik	1	Masc1
Był by znakomitym pedagogiem uwielbianym przez studentów .	pedagogiem	3	Masc1
Motyl , który drzemie przysiadłszy na dzwonie .	Motyl	0	Masc2
W ubiegłym roku bracia Lunelli osiągnęli kolejny pułap .	bracia	3	Masc1
Z radia dobiegały ostatnie tony walca Brahmsa .	walca	5	Masc2
Przybiegła Dorota z mężem i synem .	mężem	3	Masc1
Nie chcąc zaskoczyć krywów , starał się wywołać jak największy hałas .	krywów	3	Masc1
Tom Spencer posiadał przy sobie pisma pornograficzne i kasety video dla homoseksualistów oraz marihuanę .	homoseksualistów	11	Masc1
Starczy tego rzępolenia , łajzy !	łajzy	4	Masc2
Ksiądz Korniłowicz odmawiał brewiarz , chodząc tutaj po ścieżkach .	Ksiądz	0	Masc1
Posiada ok. 150 ciekawych i zróżnicowanych egzemplarzy .	egzemplarzy	6	Masc3
Kondukt zatrzymuje się przy alei Zasłużonych .	Zasłużonych	5	Masc1
W Nowym Tomyślu wiatr zerwał dach urzędu skarbowego i pasażu handlowego .	pasażu	9	Masc3
Tam gdzie nie mogą dotrzeć karetki pogotowia , idą pielęgniarki i lekarze .	lekarze	11	Masc1
- Znam teczkę brata i przyjaciela .	brata	3	Masc1
Gdzie podział się mój przyjaciel ?	przyjaciel	4	Masc2
Zarządca komisaryczny przestał pełnić ją dopiero po ostatnich wyborach samorządowych .	Zarządca	0	Masc1
Porad rolnikom udziela w nim Janina Zielińska .	rolnikom	1	Masc1
Jego stałym zastępcą jest oficer G3 .	oficer	4	Masc1
Świniak ten jest kumplem Ałganowa .	kumplem	3	Masc1
W Betlejem zupełnie utracili ducha dociekliwości , z punktu widzenia intelektualisty zachowali się nadzwyczaj pokornie .	intelektualisty	10	Masc1
Kazał Paoli przynieść sobie drinka .	drinka	4	Masc2
Inspirował się także muzyką klasyczną i rockiem .	rockiem	6	Masc2
Palce starca bez przerwy gmerały w medalikach .	medalikach	6	Masc3
Dziadek kupił sobie cukrownię , automobil i wielki dom .	automobil	5	Masc3
ŻYCIE przedstawiło w sądzie świadków , którzy widzieli Kwaśniewskiego w Cetniewie .	sądzie	3	Masc3
Spotkanie w urzędzie wywarło na wszystkich jego uczestnikach niesamowite wrażenie .	uczestnikach	7	Masc1
To pochlebia facetom .	facetom	2	Masc1
Usmaż jeszcze kiedyś faworki , błagam .	faworki	3	Masc2
Ktoś poprosił w radiu , by słuchacze przysyłali swoje teksty o godności .	słuchacze	6	Masc1
- Nie sądzę , by tu były ghule .	ghule	7	Masc2
Słońce prażyło niemiłosiernie , a na domiar złego wykończyły się zapasy żywności i wody .	zapasy	10	Masc3
Aż 192 z nich to nieletni .	nieletni	5	Masc1
W Boskiej Rzeczywistości problemy nie istnieją .	problemy	3	Masc3
zmienia pokoje .	pokoje	1	Masc3
Wykaz obejmował 33 rasy psów wymagających rejestracji i szkolenia .	psów	4	Masc2
– Powiedz mi na koniec naszego miesiąca . . .	miesiąca	6	Masc3
- Dokumenty dotyczące wyroku białostockiego sądu jeszcze nie trafiły do ministerstwa .	wyroku	3	Masc3
Jest Pan jeszcze rektorem wyższej uczelni .	rektorem	3	Masc1
Ból rósł .	Ból	0	Masc3
Psy grzebały w śmietniku .	śmietniku	3	Masc3
Ugryzienia osy , pszczoły , trzmiela i szerszenia mogą być niebezpieczne .	trzmiela	5	Masc2
Opór tylko go rozochocił .	Opór	0	Masc3
Rozbity samochód trafił na policyjny parking .	parking	5	Masc3
Teraz kmieci zamieniono w niewolników .	kmieci	1	Masc1
Wczoraj o incydencie szeroko informowała rosyjska prasa .	incydencie	2	Masc3
Ochmistrz , grubasek i smakosz , spuścił oczy w milczeniu .	grubasek	2	Masc1
Anglosasi sądzą , że czas jest ich sprzymierzeńcem .	sprzymierzeńcem	7	Masc1
- Posłannictwo lekarzy nie może być realizowane bez pieniędzy .	lekarzy	2	Masc1
- Myślała m , że ktoś w szkodę wlazł sąsiadowi .	sąsiadowi	9	Masc1
Nie pamiętam szczegółów , ale coś podobnego już zaszło .	szczegółów	2	Masc3
- Na stole rozłożył odbitki kserograficzne stron Rocznika Statystycznego .	Rocznika	7	Masc3
Mocne łuki brwi jakby nastroszyły się .	łuki	1	Masc3
– Joanna z lekkim wyrzutem spojrzała na młodą koleżankę .	wyrzutem	4	Masc3
Różnicę pokazał em w poście , na który odpowiadasz .	poście	4	Masc3
Taksówkarz wezwał policję i pogotowie .	Taksówkarz	0	Masc1
Co docierało do ludzi ?	ludzi	3	Masc1
Ilu prezesów pani przetrzymała ?	prezesów	1	Masc1
I nie tracić czujności , bo wtedy , kiedy wierzysz , że szczęście jest blisko , tak jak teraz , pojawia się archanioł z mieczem .	archanioł	22	Masc1
Przed tygodniem pisali śmy o rozboju w Rabce .	tygodniem	1	Masc3
Rywale prowadzili już wtedy dwoma bramkami i Polak nie zdołał zmienić losu meczu .	Rywale	0	Masc1
tak się kroi go i tak się macza w tym sosie .	sosie	10	Masc3
Robotnicy tylko wtedy poprą reformę , jeśli będą mieli jakieś zabezpieczenie .	Robotnicy	0	Masc1
Wszelki mrok rozpływa się niczym mgła w promieniach porannego słońca .	mrok	1	Masc3
Ze stara wyciekał olej i płyn chłodzący , a przyczepa miała zdemontowany hamulec awaryjny .	olej	3	Masc3
Z relacji dziecka wynika , że sąsiad zaprosił je do domu .	sąsiad	6	Masc1
Podeszły do lady i zaczęły zabierać kosmetyki i odzież .	kosmetyki	6	Masc3
Przepraszam , panie pośle .	pośle	3	Masc1
Potem roztworem chemicznym starannie spryskano bezcenne posągi i stare mozaiki .	posągi	6	Masc3
Proboszcz wzniósł oczy w sufit i westchnął o świętą cierpliwość .	sufit	4	Masc3
Obydwu sprowadź natychmiast do sztabu !	sztabu	4	Masc3
Psychiatrzy orzekli , że nie był w pełni poczytalny .	Psychiatrzy	0	Masc1
Zdecydowano także zdjąć z programu salwę honorową .	programu	4	Masc3
Oficer wyszedł , rencistka odkręciła gaz .	Oficer	0	Masc1
11-latek przyniósł do szkoły w Studziankach granat .	11-latek	0	Masc1
Z głośników popłyną rytmy soul i disco .	rytmy	3	Masc3
Lepper spotkał się wczoraj z rolnikami w Malechowie w województwie zachodniopomorskim .	rolnikami	5	Masc1
Pierwszym wojewodą zostaje były naczelnik Zakopanego , Lech Bafia .	naczelnik	4	Masc1
Samochód był w pełni ubezpieczony w Hestii .	Samochód	0	Masc3
( A odpisze mi koleżanka na priva jeszcze ? )	priva	6	Masc2
Kwiaty otrzymali nauczyciele , którzy przed laty kształcili kolejarskich specjalistów .	nauczyciele	2	Masc1
" Równość obywateli przyniosła ze sobą wyłączenie od niej niewolników " .	niewolników	9	Masc1
O szczegóły poprosimy porucznika Achselringa .	porucznika	3	Masc1
Miała za sobą ciężki dzień .	dzień	4	Masc3
W półmroku stała jakaś postać .	półmroku	1	Masc3
Prokuratorzy chodzili na rzęsach .	Prokuratorzy	0	Masc1
Trzeba będzie sprawiedliwie podzielić maszyny , rzeczy , meble .	meble	8	Masc3
jaką funkcję pełnią w organizmie ?	organizmie	4	Masc3
Około północy nadciągnął sztorm i śnieżyca .	sztorm	3	Masc3
Majowe weekendy zapowiadają się naprawdę ładnie !	weekendy	1	Masc3
Porozmawiajmy o ludziach .	ludziach	2	Masc1
Zapada mrok , bierze lekki przymrozek .	mrok	1	Masc3
Cukier puder podać w osobnym naczyniu .	Cukier	0	Masc3
Dodatkowe połączenia D dopełniają charakter układu .	układu	5	Masc3
O tym , że dzieci przeżywają koszmar , dorośli dowiadują się najczęściej przypadkiem .	dorośli	8	Masc1
Gospodarz żachnął się .	Gospodarz	0	Masc1
Pięciu marynarzy niszczyciela poniosło śmierć a dwóch odniosło ciężkie rany .	niszczyciela	2	Masc2
Jednak sam chipset nie stanowi jeszcze o atrakcyjności danej płyty dla użytkownika .	użytkownika	11	Masc1
Myśli Pani , że jestem odosobnionym egzemplarzem ?	egzemplarzem	6	Masc3
Na twarzy tłumacza odmalowało się zdumienie .	tłumacza	2	Masc1
Oczywiście nad brzegiem wykopu stoi babka z dzieckiem .	brzegiem	2	Masc3
Pan Kozłowski sprzedawał dolary na tą cegielnię . . .	dolary	3	Masc2
I nie usłyszy , bo inżynier nie powtarza zarzutów .	inżynier	5	Masc1
Masowy powrót przyniósł by doraźne korzyści budżetowi .	budżetowi	6	Masc3
Psy od razu wyczuły papierosy .	papierosy	4	Masc2
Henryk przystąpił do działalności rewolucyjnej z dużym rozmachem .	rozmachem	7	Masc3
Do głównych ich upraw należy rzepak .	rzepak	5	Masc3
Odpowiada za utrzymanie maszyn produkcyjnych w ruchu .	ruchu	6	Masc3
Głównym jego prześladowcą był malarz , majster Gileta .	malarz	4	Masc1
Warszawscy radiowcy okazali się trudnymi rywalami .	rywalami	5	Masc1
- Tu jest pewien problem .	problem	4	Masc3
Ale nie pamiętam pierwszego seksu .	seksu	4	Masc3
Dlaczego marszałek Małachowski milczy wobec antyreligijnych wypowiedzi niektórych posłów ?	posłów	8	Masc1
Chodziło oczywiście o kontakty ściśle naukowe , ale umożliwiły one później wysłanie jezuity , astronoma , do Chin .	astronoma	14	Masc1
Mieszkańcy zaczęli przestępować z nogi na nogę i pomruk przeszedł nad głowami .	Mieszkańcy	0	Masc1
W drzwiach pojawił się sympatyczny mężczyzna , górnik z Borynii .	górnik	7	Masc1
Wśród podhalańskich Cyganów z bezwzględności słynie jego współpracownik , współoskarżony w Oświęcimiu , Stanisław Kamiński z Czarnej Góry .	współoskarżony	9	Masc1
nie była ś w pokoikach ?	pokoikach	4	Masc3
Wyjątek stanowiły niedziele .	Wyjątek	0	Masc3
Najciekawsza rozmowa zaczęła się przypadkiem na jednym z rautów .	rautów	8	Masc3
Strażnik oddalił się .	Strażnik	0	Masc1
Mister O'Goreck schował się do jakiejś sieni .	Mister	0	Masc1
Władza w tym okresie nie chciała ośmieszać się tak prymitywną propagandą .	okresie	3	Masc3
jak skorzystać z usług akwizytora , a jednocześnie nie paść ofiarą przestępstwa ?	akwizytora	4	Masc1
Przez uczony wywód autorki przewijają się dzieła współczesnych filozofów , od Ricoeura po Levinasa .	filozofów	8	Masc1
Do tego doszła rada od organizatora Wiesława Szczygielskiego .	organizatora	5	Masc1
Eskadra bierze kurs na cel .	kurs	2	Masc3
Jest to kilkaset kilometrów .	kilometrów	3	Masc3
A ogrzewania wyłączyć nie możemy , bo to zaszkodzi świeżo zakonserwowanym freskom w obu synagogach .	freskom	11	Masc3
Zazwyczaj młodym kobietom z zagranicy , zwabionym i przymuszanym do nierządu , sutenerzy odbierają paszporty .	sutenerzy	12	Masc1
Osadza się na odzieży oraz trwałych nieprzepuszczalnych powierzchniach takich jak beton czy asfalt .	beton	10	Masc3
Kardynał padrone szedł już na spotkanie .	Kardynał	0	Masc1
Polski lud w nic nie wierzy .	lud	1	Masc3
Podobny spis już istnieje .	spis	1	Masc3
- Czy w szkołach pobliskich pracują nauczyciele z mniejszości ?	nauczyciele	6	Masc1
" Obywatelu Bukowiński , proponujemy wam repatriację do Polskiej Republiki Ludowej " .	Obywatelu	1	Masc1
W zamyśle ludzi zaplecza pana premiera to dwie oddzielne inicjatywy .	premiera	5	Masc1
- Ucieszył się celowniczy .	celowniczy	3	Masc1
Dopiero po miesiącu mógł założyć specjalny procesor i uczyć się nowych dźwięków .	dźwięków	11	Masc3
Budynek ma być niebawem remontowany , dlatego lokatorzy go opuścili .	lokatorzy	7	Masc1
Facet musiał wyłączyć silnik .	silnik	3	Masc3
- Twój nosorożec jest teraz nagi i bezbronny .	nosorożec	2	Masc2
21-latek ostrzelał z broni ostrej mieszkanie w centrum Skarżyska .	21-latek	0	Masc1
A tragarzy nie słuchaj .	tragarzy	1	Masc1
Listonosz Perez pokręcił z niedowierzaniem głową .	Listonosz	0	Masc1
Mechanizm okazał się bardziej trwały od człowieka .	Mechanizm	0	Masc3
Wyrwał mu skrzypce , roztrzaskać je o bruk .	bruk	7	Masc3
Jego winę przejmują dzieci , wnuki .	wnuki	5	Masc2
Pomimo dokuczliwego zimna cieszyły się one dużym zainteresowaniem sportowców wiejskich .	sportowców	8	Masc1
Piszemy potem w stukocie remontów , jakby szewcy Witkacego mnie odwiedzili .	szewcy	7	Masc1
Wpłynęło 148 projektów .	projektów	2	Masc3
Ostatnim punktem ćwiczeń było gaszenie pożaru .	punktem	1	Masc3
W zakładzie wszyscy współczują dyrektorowi Szwonderowi .	dyrektorowi	4	Masc1
Czy to nie jest stawianie wozu przed koniem ?	koniem	7	Masc2
Zebranych powitał burmistrz Bogdan Małecki , on też wygłosił okolicznościowe przemówienie .	burmistrz	2	Masc1
Rodzice wciąż pracują .	Rodzice	0	Masc1
Po przerwie przeważali gospodarze , którzy trzykrotnie mieli okazję na podwyższenie wyniku .	gospodarze	3	Masc1
Uległ wzruszeniu stary pedagog i zajął się wdowim synem z całą życzliwością .	pedagog	3	Masc1
Ostatkiem sił wyciągnął em go na brzeg i przycisnął em do serca .	Ostatkiem	0	Masc3
Głównym jego prześladowcą był malarz , majster Gileta .	majster	6	Masc1
W tym czasie moim serdecznym przyjacielem stał się koń .	koń	8	Masc2
Stanęła w progu , ręce oparła na biodrach .	progu	2	Masc3
Niech wejdzie lis Chmura w świetny stan , górników polskich stan .	lis	2	Masc1
Obaj 23-letni starogardzianie trafili do policyjnego aresztu .	starogardzianie	2	Masc1
Megane oddał synowi , pracownikowi dydaktycznemu warszawskiej uczelni .	synowi	2	Masc1
Zdaje się , że konduktor grasuje w wagonie .	konduktor	4	Masc1
Przez całą niedzielę sprawdzano każdy wątek i potencjalnych sprawców .	sprawców	8	Masc1
Hipermarkety zmieniają swoich właścicieli .	właścicieli	3	Masc1
Siła uderzenia wbiła renaulta w innego tira .	renaulta	3	Masc2
Idziemy z mieszkańcem Sławogóry Starej po gruntowej drodze .	mieszkańcem	2	Masc1
Wśród wielu przysmaków polskiej kuchni ryba morska zajmuje coraz ważniejszą pozycję .	przysmaków	2	Masc3
Że nie potrafi kupić żadnego piłkarza do Legii .	piłkarza	5	Masc1
Nie może doznać ciosu od rozróbkarzy .	ciosu	3	Masc3
Czy ghule biją się lepiej od maruderów ?	ghule	1	Masc2
Wczoraj kolegium Instytutu usiłowało wyłonić nowego kandydata na prezesa .	prezesa	8	Masc1
Pokrzepiła mnie tym na duchu .	duchu	4	Masc2
Wessie je mózg , wątroba , rurką pępowiny popłyną do Poli .	mózg	2	Masc3
Żaden z generałów nie podał nazwy pocisku , ani jego charakterystyki .	generałów	2	Masc1
W ostatnim momencie chwytam w dłonie jakiś kabel .	momencie	2	Masc3
Następnie zabierze głos pan poseł Jerzy Jaskiernia .	poseł	4	Masc1
Hindusi i ja wybrali śmy się na zielone gołębie .	gołębie	8	Masc2
Psy darły jamy , ziemia sypała się za ogonami .	Psy	0	Masc2
Ale ja nie uważam Cię za wieloryba .	wieloryba	6	Masc2
Pamiętam swego pierwszego dużego bolenia .	bolenia	4	Masc2
- Za jakiś miesiąc należało by spenetrować wysypisko , najlepiej z psami .	psami	11	Masc2
Generał za swoje publikowane w prasie artykuły nie przyjmuje honorariów .	artykuły	6	Masc3
Do zbrodni przyznał się 22-letni mieszkaniec tego miasta .	mieszkaniec	5	Masc1
Czytanie jest u kalwinów powinnością religijną , obowiązkiem wierzącego .	wierzącego	8	Masc1
Ale rozumiem , że do ślubu , prędzej czy później , dojdzie ?	ślubu	5	Masc3
Kruk krukowi oka nie wykole .	Kruk	0	Masc2
W czasie wojny okazało się , że sektę założył niemiecki cwaniak dla celów szpiegowskich .	celów	12	Masc3
Profesor z dużym sceptycyzmem spogląda w przyszłość .	Profesor	0	Masc1
Młodzi modele krakowskiej ASP pozują , zdaniem Marty , przede wszystkim z powodów finansowych .	powodów	12	Masc3
Ślubu nie będzie ?	Ślubu	0	Masc3
Niektórzy z idiotów tylko onanizując się zaspokajają swoje potrzeby seksualne .	idiotów	2	Masc1
Dorota ma żółtą skórę i ostre łokcie .	łokcie	6	Masc3
Przypomnijmy , że podczas strzelaniny w Warszawie policja i prokuratura uznały , że funkcjonariusz słusznie sięgnął po broń .	funkcjonariusz	13	Masc1
- Panie przodowniku , jak pragnę wolności , to same równe chłopaki .	chłopaki	11	Masc2
Za to , że wrócił bez pieniędzy , gość zapłaci życiem .	gość	8	Masc1
Kłamią , skurwysyny .	skurwysyny	2	Masc2
Daj przepis na faworki .	faworki	3	Masc2
Ostatnie tony koncertu umilkły .	koncertu	2	Masc3
Wiadomo , że w tym roku uczniowie będą zdawać albo starą , albo nową maturę .	uczniowie	6	Masc1
Sprawą zajmują się policjanci z 6 komisariatu na Górnej .	komisariatu	6	Masc3
Jak ksiądz biskup ocenia bilans tego przejścia ?	biskup	2	Masc1
Zajrzał do środka budynku i w rogu zauważył zwęglone zwłoki .	rogu	6	Masc3
- Mów że składniej , frater !	frater	5	Masc1
– przebierze się za aniołka . .	aniołka	4	Masc2
Coraz mniej się dziwię , że tylu ludzi nas nie cierpi .	ludzi	7	Masc1
pan Wassermann powoduje konflikty .	konflikty	3	Masc3
Wsadził ją do schowka pod schodami .	schowka	3	Masc3
Kocham cię w kapeluszu i w berecie .	berecie	6	Masc3
Jeździł też mój kolo bankowiec .	bankowiec	4	Masc1
Poczuł em po raz kolejny przypalanie papierosami , wykręcanie rąk .	papierosami	6	Masc2
Może po przeczytaniu tego artykułu więcej kotów znajdzie swe domy ?	kotów	6	Masc2
W czasie obławy policjantom z Pieniężna udało się zatrzymać dwóch kłusowników .	policjantom	3	Masc1
Ludzie rozsunęli się natychmiast , robiąc szpaler aż do drzwi plebanii .	szpaler	6	Masc3
Ja podziwiam księży .	księży	2	Masc1
Przy dźwiękach marsza żałobnego rusza aleją cmentarza kondukt pogrzebowy .	cmentarza	6	Masc3
Matka - niematka wzięła urlop macierzyński .	urlop	4	Masc3
Mój czcigodny ojciec wielce poważał tego mistrza .	ojciec	2	Masc1
Warany cieszą się dużym zainteresowaniem kolekcjonerów , gdyż nie można ich kupić legalnie .	Warany	0	Masc2
- Mam pytanie , panie marszałku .	marszałku	5	Masc1
Prezes Bogdan Kościuczyk odesłał nas do dyrektor Anieli Kotowicz .	Prezes	0	Masc1
- Posłannictwo lekarzy nie może być realizowane bez pieniędzy .	pieniędzy	8	Masc3
Wódz rzymski podskoczył ku niemu i chwycił gwałtownie za szerokie bary .	Wódz	0	Masc1
On też będzie płacić długi upadłej jednostki .	długi	4	Masc3
Dwaj wędkarze wpadli do wody , gdy wieloryb zaatakował ich łódź u południowo - wschodnich wybrzeży Australii .	wędkarze	1	Masc1
W 90 % trzeba polegać tylko na sobie .	%	2	Masc3
Po tym wypadku jakby się otrząsnął .	wypadku	2	Masc3
Podeszła do samego brzegu .	brzegu	3	Masc3
Na niektórych targowiskach trzeba za nie płacić już po 4 zł za kilogram .	kilogram	12	Masc3
To Bronek , dwuletni gwarek .	gwarek	4	Masc2
Podróżujący pierwszą klasą będą odtąd mogli wypoczywać podczas lotu na rozkładanych podwójnych siedzeniach .	lotu	8	Masc3
Już na kilka dni przed nią obozowisko partyzanckie przedstawiało dziwny widok .	widok	10	Masc3
Zaczyna się znów , nie minęło parę dni i już nadchodzi następny sztorm .	dni	7	Masc3
Od którego tygodnia dołączyć teścia ?	teścia	4	Masc2
Ojciec zajrzał przez drzwi .	Ojciec	0	Masc1
Miliony ludzi straciło oszczędności całego życia .	ludzi	1	Masc1
Łoś podniósł łeb .	Łoś	0	Masc2
Dzięki temu kaci mogą zostać skazani nawet na dożywocie !	kaci	2	Masc1
Można pójść z nim do szkoły i zaznajomić się z jej atmosferą , zanim dziecko zostanie uczniem .	uczniem	16	Masc1
Wczoraj piłkarze z Taszkientu dwukrotnie ćwiczyli na stadionie .	piłkarze	1	Masc1
Pracodawcy nie przejmują się z reguły samopoczuciem swoich telepracowników .	Pracodawcy	0	Masc1
Posłowie udzielili też rządowi absolutorium z wykonania ubiegłorocznego budżetu .	Posłowie	0	Masc1
Gabor został przydzielony do grupy sturmbannführera Zeliga .	sturmbannführera	5	Masc1
Skąd masz granaty ?	granaty	2	Masc3
Nieoczekiwanie i bardzo mocno uderzył w piersi łysego , wąsatego mężczyznę .	mężczyznę	10	Masc1
Mariusz Łapiński nadal będzie ministrem zdrowia .	ministrem	4	Masc1
Na parterze remonty trwały w najlepsze .	parterze	1	Masc3
Postawicie nam ćwiartkę , a my już damy facetowi radę .	facetowi	8	Masc1
Będą pracować w Wilczycach i w rejonie Ćmielowa .	rejonie	6	Masc3
Dowiedziała m się , że mój rozmówca z powodu swojego wzrostu pracował na budowie .	wzrostu	10	Masc3
Rannymi cywilami zaopiekowali się najpierw amerykańscy sanitariusze z personelu naziemnego .	sanitariusze	6	Masc1
Opony delahaye jednostajnie szumią po asfalcie .	delahaye	1	Masc2
Ptak ten nie ma takich zdolności jak albatros czy sokół .	Ptak	0	Masc2
Ja i strażnik spojrzeli śmy na nią .	strażnik	2	Masc1
Konkurs organizuje stacja telewizyjna ABC .	Konkurs	0	Masc3
Na pastwisku w Uniszkach Gumowskich rolnik załadował na dwukółkę krowę .	rolnik	5	Masc1
Kłaniając się przepraszająco , opuścili śmy z panem Adamkiem zakład pogrzebowy .	panem	7	Masc1
Wszelki mrok rozpływa się niczym mgła w promieniach porannego słońca .	promieniach	7	Masc3
Ten pośpiech będzie teraz kosztował .	pośpiech	1	Masc3
Ja stoję w bruździe i w uniesionej ręce trzymam zapalony fanarek .	fanarek	10	Masc3
- Pan Ferenz nie lubi czeków .	czeków	5	Masc3
Infrastruktura teleinformacyjna nie może działać bez prądu .	prądu	6	Masc3
Obrazy cyfrowe składają się z połączonych ze sobą pikseli o różnych barwach lub tonach .	tonach	13	Masc3
Próżno pytać medyków o jej istotę .	medyków	2	Masc1
Żelazny kolos Żugajowi nie nabił nawet guza .	kolos	1	Masc2
Zarobki wszystkich nauczycieli będą rosły co rok .	nauczycieli	2	Masc1
Startować w nich mogą wszyscy chętni .	chętni	5	Masc1
Na cmentarzu w Koniku Nowym leży ponad 100 psów , pięć kotów i jeden chomik .	psów	8	Masc2
- Kto z nas dotknął trupa ?	trupa	5	Masc2
Uczą się i pomagają innym .	innym	4	Masc1
Należy starać się odnaleźć każdego postrzałka .	postrzałka	5	Masc2
Niosła się w obłoku , zakurzona .	obłoku	3	Masc3
Chwycił em teczkę i pobiegł em do sekretariatu .	sekretariatu	7	Masc3
Dla zdławienia partyzantów działających w górach rząd mobilizuje poważne siły zbrojne .	partyzantów	2	Masc1
Za linią lasu błysnęła w słońcu blacha na wieży kościoła .	lasu	2	Masc3
- Chcemy odsprzedać te wałachy .	wałachy	4	Masc2
Jakie priorytety wiążą się z mincerzami ?	priorytety	1	Masc3
Zatrzymali się na rogu Włodarzewskiej .	rogu	3	Masc3
Niedźwiedź broniąc się przed napastnikiem uciekł na drzewo .	Niedźwiedź	0	Masc2
Powrócili do rozmowy o sztuce , malarz zaprosił cudzoziemca , aby obejrzał jego obrazy .	cudzoziemca	8	Masc1
Po chwili na tyłach trafiki Krziwaniego pozostali jedynie Sorg i Smolorz .	tyłach	3	Masc3
Nieuchwytny pozostał też poeta rywal Willa .	poeta	3	Masc1
Japończycy z entuzjazmem przyjęli inicjatywę reżysera .	reżysera	5	Masc1
Specjaliści zapewniają , że lek na katar i przeziębienia pojawi się dopiero za kilka lat .	lek	4	Masc3
Jaki trunek do czego pasuje ?	trunek	1	Masc3
nie widziała m motyla . .	motyla	3	Masc2
Ten dialog został odtworzony w śledztwie bez trudu .	trudu	7	Masc3
Świadek zeznawał by w procesach pozostałych członków gangu .	Świadek	0	Masc1
- Wolę was niż mój rozsądek .	rozsądek	5	Masc3
Ale wydaje mi się , że Lech , Czech i Rus musieli bardzo długo pędzić za jeleniem , dzikiem i niedźwiedziem .	niedźwiedziem	20	Masc2
Nagle wzrok funkcjonariusza padł na pudło z płytami kompaktowymi bez hologramów .	funkcjonariusza	2	Masc1
– pan redaktor jest publicysta pedagogiem .	redaktor	2	Masc1
Do sotni przemawia pułkownik .	pułkownik	3	Masc1
Świadkowie twierdzą , że pieszy rzucił się pod koła rozmyślnie .	pieszy	4	Masc1
Przez takiego drania wpakowali nas wszystkich czterech na dwa dni do łóżek .	drania	2	Masc1
- Jego przodków uratował mój dziadek w czasie II wojny światowej .	dziadek	5	Masc1
Kilkaset wagonów z ładunkami przychodzi codziennie na stację kolejową w Lublinie .	ładunkami	3	Masc3
Resztę dopowiedzą polityczni konkurenci .	konkurenci	3	Masc1
Przejęli go demagodzy jak Gamsachurdia .	demagodzy	2	Masc1
Zawahała się na moment .	moment	3	Masc3
Było też paru oficerów z polskiej jednostki w Legnicy .	oficerów	3	Masc1
Kolejowi robotnicy prowadzili tam prace modernizacyjne .	robotnicy	1	Masc1
Zamienia je w klasie na dżiajdżoły .	dżiajdżoły	5	Masc2
Niech padnę trupem na miejscu .	trupem	2	Masc2
- Nie było to ustępstwo , tylko konsensus .	konsensus	7	Masc3
- Dziękuję bardzo , panie pośle .	pośle	5	Masc1
A i totolotek się zmienił .	totolotek	2	Masc2
Partnerami Ukraińców byli Szwajcarzy , czyli Duferco .	Partnerami	0	Masc1
Ale nawet najwięksi krytycy Rutkowskiego chwalą jego zdolności autoreklamiarskie .	krytycy	3	Masc1
Trwała dalej w bezruchu .	bezruchu	3	Masc3
U młodej dziewczyny psychiatra z Modusa rozpoznał początki choroby psychicznej , dziewczyna myśli o samobójstwie .	psychiatra	3	Masc1
Na czwartym rogu Żelaznej wywrócili kiosk z papierosami , jako przeszkodę , papierosy się posypały .	kiosk	5	Masc3
Gdy Cahirowi czupryna nieco mocniej przyschnie do czerepu , powędrujemy ku Toussaint .	czerepu	7	Masc3
Instruktor wykonuje fikołki .	fikołki	2	Masc2
Nawet trochę pomieszkać , może nawet popracować w kibucu .	kibucu	8	Masc3
Jadł pan obiad ?	obiad	2	Masc3
Muzeum homoseksualizmu otwierał nadburmistrz Berlina Klaus Wowereit .	nadburmistrz	3	Masc1
Równie dobrze mógł by m być chyba biologiem , geometrą .	geometrą	9	Masc1
Ale wydaje mi się , że Lech , Czech i Rus musieli bardzo długo pędzić za jeleniem , dzikiem i niedźwiedziem .	jeleniem	16	Masc2
- Czy ktoś ma tic-taki ?	tic-taki	4	Masc2
Muszę jechać do taty .	taty	3	Masc1
Naczelnik ulicznych rzeźników wykrzywił twarz .	Naczelnik	0	Masc1
Przyznał , że spodziewał się nieco lepszej postawy po młodszych od siebie zawodnikach .	zawodnikach	12	Masc1
Przyglądali śmy się różnym kształtom bakterii , glonów , pierwotniaków .	pierwotniaków	9	Masc2
Na cmentarzu w Koniku Nowym leży ponad 100 psów , pięć kotów i jeden chomik .	chomik	14	Masc2
Czy lekarz może leczyć pacjenta wbrew jego woli ?	pacjenta	4	Masc1
Seks z tobą to piekło !	Seks	0	Masc3
Razem z mętami w Bornem Sulinowie pojawiły się klechy .	klechy	8	Masc2
Ostatnim wysiłkiem naprowadza płonący samolot wprost na wieżyczkę u-boota .	u-boota	8	Masc2
W numerze wydanym przez Movex rzuca się w oczy kilkustronicowy wstępniak .	wstępniak	10	Masc3
Po incydentach w meczu derbowym ukarali ście Cracovię zamknięciem stadionu na dwa mecze .	stadionu	9	Masc3
Po odejściu Stasiaka w MSWiA będzie wakat .	wakat	6	Masc3
Położył pomarańczę na talerzu .	talerzu	3	Masc3
Aureliusz słuchał kątem ucha , odbierając teczkę z depozytu .	depozytu	8	Masc3
Na środku kolejnego ronda wyrósł murek z roślinami na szczycie .	murek	5	Masc3
Pomagają okłady z rumianku .	okłady	1	Masc3
Papieros sparzył mi palce , rzucił em go w śnieg .	palce	3	Masc3
W milczeniu spożywali zimną konsolację , szczękały sztućce , dworscy w ciemnych surdutach sprawnie zmieniali misy .	sztućce	7	Masc3
W krem wcisnąć osączone i pokrojone ananasy .	ananasy	6	Masc2
W kolejnych rzędach stali niewidomi , część z psami - przewodnikami , a także niesłyszący i niemi .	przewodnikami	10	Masc2
– Lekarz ogólny nie był by już nam wtedy potrzebny ?	Lekarz	1	Masc1
Kto był ich świadkiem ?	świadkiem	3	Masc1
To jest ważny moment .	moment	3	Masc3
Za mną stał szczupły , niewysoki brunet .	brunet	6	Masc1
ile płaciła ś za kurs ?	kurs	4	Masc3
- Na wiosenną wodę puszczał okręciki , żeby się popisać czymś niezwykłym .	okręciki	5	Masc3
- Trzymali nas w chlewiku . . .	chlewiku	4	Masc3
Przy wynoszeniu rannego w pojedynkę ujmujemy go oburącz pod ramiona .	rannego	2	Masc1
Wojskowy kandydat nie rozdawał ulotek ze swoim programem wyborczym .	kandydat	1	Masc1
– a to jest kolos . .	kolos	4	Masc2
Dzicy plakaciarze zaśmiecający miasto są bezkarni .	plakaciarze	1	Masc1
Po raz ostatni połączono się ze stacją w sobotę przed wieczorem .	wieczorem	10	Masc3
Przyjechano tylko raz .	raz	2	Masc3
Malarz chwycił go mocno za ramię .	Malarz	0	Masc1
Trzeba pousuwać z działek stojącą wodę i uporządkować strychy oraz piwnice .	strychy	8	Masc3
Łapcie się za portfele !	portfele	3	Masc3
Po wstępnych kieliszkach było przyjemnie .	kieliszkach	2	Masc3
- Zakłady i instytucje państwowe działają na podstawie decyzji urzędniczych .	Zakłady	1	Masc3
Pierwsze recenzje w Niemczech pojawiły się już dwa tygodnie po ukazaniu się książki w USA .	tygodnie	8	Masc3
Taka osoba ułatwiła by międzynarodowe kontakty .	kontakty	5	Masc3
Kurs zakończył się egzaminem .	Kurs	0	Masc3
Agencja chce pozbyć się ogierów , bo są schorowane .	ogierów	4	Masc2
Wizytator przeprosił kierownika i udał się z powrotem do klasy szóstej .	kierownika	2	Masc1
Następnie Aleksander Zawadzki dokonał otwarcia muzeum w dziesiątym Pawilonie .	Pawilonie	8	Masc3
Biznesmeni pakistańscy to ciągle pendżabscy latyfundyści .	latyfundyści	5	Masc1
Serio , taki gówniarz i prymityw przemówił wtedy we mnie .	prymityw	5	Masc1
- Niech Pan ześle anioła , by prowadził was w drodze .	anioła	4	Masc2
Odnalazł Jaskra , kibicującego łupiącym w gwinta krasnoludom .	gwinta	6	Masc2
Powstał i stanowczym krokiem podszedł do telefonu .	krokiem	3	Masc3
W poniedziałek naczelnik Jerzy Żemełko był na urlopie .	naczelnik	2	Masc1
Potem socjolog Włodzimierz Pańkow wywodził coś bardzo teoretycznie .	socjolog	1	Masc1
I uśmiechała się do tego chłopaka nawet na ulicy .	chłopaka	5	Masc1
Oficer SS wyznaczył żołnierzy do plutonu egzekucyjnego .	Oficer	0	Masc1
Rannymi cywilami zaopiekowali się najpierw amerykańscy sanitariusze z personelu naziemnego .	cywilami	1	Masc1
Takiego dziwoląga świat jeszcze nie widział !	dziwoląga	1	Masc2
Pojawił się milicjant i kierował samochody w boczne ulice .	milicjant	2	Masc1
Tematy prac rodzą się nagle .	Tematy	0	Masc3
„ Kiedy dojdzie do procesu Reinefahrta ” ?	procesu	4	Masc3
Meseńczycy , odwieczni wrogowie Sparty , zgodzili się przepuścić ich przez swoje terytorium .	wrogowie	3	Masc1
Jest legendarnym przywódcą związkowym .	przywódcą	2	Masc1
Motocyklista zmarł po przewiezieniu go do szpitala .	Motocyklista	0	Masc1
Taboret upadł z dramatycznym łoskotem , a on , wierzgając nogami , zawisł niczym gotowy do wypatroszenia wieprz .	Taboret	0	Masc3
Owa niezapomniana chwila zawierała nieprawdopodobny ładunek patosu .	patosu	6	Masc3
Do zebranych przemówił premier Fidel Castro .	zebranych	1	Masc1
Polędwicę pokroić w plastry , leciutko rozbić .	plastry	3	Masc3
Przewodniczący Vegów uśmiechnął się jakby z zakłopotaniem .	Przewodniczący	0	Masc1
Koncern nadal ma umowy licencyjne z producentami w Japonii , Włoszech , Afryce Południowej i na Filipinach .	producentami	6	Masc1
Manifestanci próbowali uniemożliwić policji zamykanie biur zdelegalizowanego ugrupowania .	Manifestanci	0	Masc1
Spomiędzy palców wypada mi papieros .	papieros	4	Masc2
De Gaulle jest stary .	De	0	Masc1
I to najwyraźniej rozwścieczyło sprawców .	sprawców	4	Masc1
Były najdłuższe dni roku .	dni	2	Masc3
Żelazny kolos Żugajowi nie nabił nawet guza .	guza	6	Masc2
Podobał mi się wygląd Geralta w komiksie .	komiksie	6	Masc3
Immunitetu zrzekła się sama .	Immunitetu	0	Masc3
W inscenizację umiejętnie wkomponowano wspomnienia nauczycieli i byłych uczniów .	nauczycieli	5	Masc1
Przecież jestem najsławniejszym gliną Federacji " .	gliną	3	Masc2
Szach musi odejść !	Szach	0	Masc1
Podłączyli śmy go do sztucznych komór , czekał na dawcę .	dawcę	9	Masc1
Kobietom odpowiadał uwodzicielsko nastrojony głos ukrytego w jakiejś dziupli wodzireja .	wodzireja	9	Masc1
W lesie zające występują raczej na pobrzeżach , w głąb idą tylko w silne mrozy .	zające	2	Masc2
No , kolego pośle , chyba pan w siebie wierzy albo nie wierzy .	pośle	3	Masc1
Starem z przyczepą załadowaną piaskiem kierował kursant .	Starem	0	Masc2
